domain,num_a_fail,rate_all,num_a_all,num_a_success,rate_a_fail
rq.r9t1.com,1184,4.31%,2317,1133,51.10%
optimizationguide-pa.googleapis.com,1102,4.01%,2181,1079,50.53%
asia.pool.ntp.org,1078,3.93%,2277,1199,47.34%
cn.pool.ntp.org,1062,3.87%,2313,1251,45.91%
big1.f5.lenovo.com.cn,831,3.03%,831,0,100.00%
big2.f5.lenovo.com.cn,831,3.03%,831,0,100.00%
liveupdate5.f5.lenovo.com.cn,414,1.51%,414,0,100.00%
safebrowsing.googleapis.com,319,1.16%,691,372,46.16%
browser.360.cn,295,1.07%,638,343,46.24%
clientservices.googleapis.com,251,0.91%,524,273,47.90%
update.googleapis.com,248,0.90%,413,165,60.05%
ns2.namebrightdns.com,224,0.82%,448,224,50.00%
clients1.google.com,221,0.80%,496,275,44.56%
ns1.namebrightdns.com,217,0.79%,434,217,50.00%
zyx.qq.com,190,0.69%,485,295,39.18%
data.bilibili.com,189,0.69%,405,216,46.67%
femetrics.grammarly.io,176,0.64%,381,205,46.19%
android.clients.google.com,172,0.63%,367,195,46.87%
pool.ntp.org,167,0.61%,320,153,52.19%
www.chinauos.com,166,0.60%,2810,2644,5.91%
d27xxe7juh1us6.cloudfront.net,157,0.57%,319,162,49.22%
www.taobao.com,143,0.52%,302,159,47.35%
ntp.sjtu.edu.cn,141,0.51%,141,0,100.00%
2.ubuntu.pool.ntp.org,128,0.47%,136,8,94.12%
0.ubuntu.pool.ntp.org,122,0.44%,130,8,93.85%
registry-1.docker.io,118,0.43%,131,13,90.08%
a1961.g2.akamai.net,115,0.42%,230,115,50.00%
3.ubuntu.pool.ntp.org,110,0.40%,113,3,97.35%
1.ubuntu.pool.ntp.org,109,0.40%,112,3,97.32%
hub5pn.v6.sandai.net,104,0.38%,104,0,100.00%
go.microsoft.com,102,0.37%,232,130,43.97%
eth.2miners.com,102,0.37%,102,0,100.00%
asia1.ethermine.org,100,0.36%,100,0,100.00%
us1.ethermine.org,100,0.36%,100,0,100.00%
eu1.ethermine.org,100,0.36%,100,0,100.00%
us2.ethermine.org,98,0.36%,98,0,100.00%
ipv6.msftconnecttest.com,96,0.35%,181,85,53.04%
gecko-bd.feishu.cn,89,0.32%,183,94,48.63%
ncsi.6-c-0003.c-msedge.net,88,0.32%,88,0,100.00%
gateway.fe.apple-dns.net,82,0.30%,195,113,42.05%
content-autofill.googleapis.com,81,0.30%,180,99,45.00%
dcldshlupt.alicdn.com,80,0.29%,159,79,50.31%
vconf.f.360.cn,78,0.28%,157,79,49.68%
honeycomb.wpscdn.cn,73,0.27%,154,81,47.40%
3.centos.pool.ntp.org,73,0.27%,73,0,100.00%
internal-api-lark-api.feishu.cn,70,0.25%,121,51,57.85%
2.centos.pool.ntp.org,69,0.25%,69,0,100.00%
nat.emule.org.cn,66,0.24%,68,2,97.06%
www.zhihu.com,63,0.23%,140,77,45.00%
1.centos.pool.ntp.org,62,0.23%,62,0,100.00%
0.centos.pool.ntp.org,61,0.22%,62,1,98.39%
ioshost.qtlcdn.com,60,0.22%,125,65,48.00%
mirrors.aliyun.com,60,0.22%,63,3,95.24%
beacons.gcp.gvt2.com,59,0.21%,126,67,46.83%
fs.microsoft.com,59,0.21%,74,15,79.73%
qurl.f.360.cn,58,0.21%,118,60,49.15%
init.push.apple.com,58,0.21%,115,57,50.43%
firefox.settings.services.mozilla.com,57,0.21%,105,48,54.29%
n-devs-sgw.tplinkcloud.com.cn,56,0.20%,120,64,46.67%
clients4.google.com,56,0.20%,118,62,47.46%
gateway.icloud.com,56,0.20%,123,67,45.53%
update.todesk.com,54,0.20%,121,67,44.63%
kv601.prod.do.dsp.mp.microsoft.com,53,0.19%,110,57,48.18%
www.apple.com,49,0.18%,119,70,41.18%
jtypkz2w.sched.d2.tdnsdp1.cn,47,0.17%,76,29,61.84%
e6858.e19.s.tl88.net,47,0.17%,107,60,43.93%
update1.sangfor.net,46,0.17%,98,52,46.94%
mcs-bd.feishu.cn,45,0.16%,92,47,48.91%
gateway.fe.apple-dns.cn,44,0.16%,134,90,32.84%
slardar-bd.feishu.cn,44,0.16%,82,38,53.66%
v6ncsi.msedge.net,44,0.16%,88,44,50.00%
treatment.grammarly.com,43,0.16%,96,53,44.79%
translate.google.cn,41,0.15%,78,37,52.56%
mesu.apple.com,41,0.15%,98,57,41.84%
1.openwrt.pool.ntp.org,41,0.15%,48,7,85.42%
api.docer.wpscdn.cn,40,0.15%,94,54,42.55%
accounts.google.com,40,0.15%,116,76,34.48%
df.cache.wpscdn.cn,40,0.15%,95,55,42.11%
client.dropbox.com,40,0.15%,80,40,50.00%
s.safe.360.cn,39,0.14%,98,59,39.80%
streamdot.douyucdn.cn,39,0.14%,91,52,42.86%
ts1.cn.mm.bing.net,39,0.14%,97,58,40.21%
2.openwrt.pool.ntp.org,39,0.14%,40,1,97.50%
assets.msn.com,39,0.14%,101,62,38.61%
play.googleapis.com,38,0.14%,92,54,41.30%
ts2.cn.mm.bing.net,38,0.14%,88,50,43.18%
service.fanxing.kugou.com,36,0.13%,80,44,45.00%
liveupdate2.drivergenius.com,36,0.13%,75,39,48.00%
0.openwrt.pool.ntp.org,36,0.13%,37,1,97.30%
stream.zotero.org,35,0.13%,88,53,39.77%
ini.update.360safe.com,35,0.13%,78,43,44.87%
play.google.com,35,0.13%,75,40,46.67%
outlook.ha.office365.com,34,0.12%,68,34,50.00%
pss.bdstatic.com,34,0.12%,73,39,46.58%
api.mathpix.com,34,0.12%,69,35,49.28%
3.openwrt.pool.ntp.org,34,0.12%,34,0,100.00%
gateway.icloud.com.cn,33,0.12%,93,60,35.48%
tracker.beeimg.com,33,0.12%,33,0,100.00%
config.i.duba.net,32,0.12%,60,28,53.33%
software-down.keniu.com,32,0.12%,65,33,49.23%
img-s-msn-com.akamaized.net,31,0.11%,84,53,36.90%
oneclient.sfx.ms,31,0.11%,70,39,44.29%
dss0.bdstatic.com,31,0.11%,67,36,46.27%
cdn-file.ludashi.com,30,0.11%,67,37,44.78%
docs.google.com,30,0.11%,72,42,41.67%
e10499.dsce9.akamaiedge.net,30,0.11%,60,30,50.00%
beacons.gvt2.com,30,0.11%,72,42,41.67%
pagead2.googlesyndication.com,29,0.11%,80,51,36.25%
datarouter.ol.epicgames.com,29,0.11%,60,31,48.33%
newtab.firefoxchina.cn,29,0.11%,58,29,50.00%
init.push-apple.com.akadns.net,29,0.11%,58,29,50.00%
opencdnmsdl1.jomodns.com,29,0.11%,63,34,46.03%
api.steampowered.com,29,0.11%,57,28,50.88%
mathpix.com,28,0.10%,62,34,45.16%
retracker.lanta-net.ru,28,0.10%,71,43,39.44%
us-v20.events.data.microsoft.com,28,0.10%,598,570,4.68%
download.windowsupdate.com.a.bdydns.com,27,0.10%,52,25,51.92%
hotfix.lenovo.com.cn,27,0.10%,60,33,45.00%
r4.res.office365.com,27,0.10%,61,34,44.26%
release-75570.gzc.vod.tencent-cloud.com,27,0.10%,58,31,46.55%
google.com,27,0.10%,76,49,35.53%
dataflow.biliapi.com,27,0.10%,59,32,45.76%
webrd01.is.autonavi.com,27,0.10%,56,29,48.21%
ipv6check-http.steamcontent.com,27,0.10%,27,0,100.00%
h.trace.qq.com,26,0.09%,58,32,44.83%
www.google.com.hk,26,0.09%,64,38,40.62%
download.windowsupdate.com,26,0.09%,60,34,43.33%
googleads.g.doubleclick.net,26,0.09%,62,36,41.94%
www.belkin.com,26,0.09%,52,26,50.00%
us.pool.ntp.org,26,0.09%,31,5,83.87%
checkip.amazonaws.com,26,0.09%,31,5,83.87%
masters1.feiyiproxy.com,25,0.09%,49,24,51.02%
wildcard.feishu.cn.bytedns1.com,25,0.09%,34,9,73.53%
cv.duba.net,25,0.09%,56,31,44.64%
webrd04.is.autonavi.com,25,0.09%,53,28,47.17%
kinesis.us-east-1.amazonaws.com,25,0.09%,54,29,46.30%
webrd02.is.autonavi.com,25,0.09%,53,28,47.17%
6-c-0003.c-msedge.net,24,0.09%,24,0,100.00%
sjy6.stream.qqmusic.qq.com,24,0.09%,55,31,43.64%
ss1.baidu.com,24,0.09%,57,33,42.11%
steamcdn-a.akamaihd.net,24,0.09%,42,18,57.14%
dss1.bdstatic.com,24,0.09%,56,32,42.86%
c.apple.news,24,0.09%,50,26,48.00%
e11290.dspg.akamaiedge.net,24,0.09%,51,27,47.06%
hub5pr.v6.phub.sandai.net,24,0.09%,46,22,52.17%
tracker.hama3.net,24,0.09%,45,21,53.33%
tracker.coalition.space,24,0.09%,45,21,53.33%
agt.p.qianxin.com,24,0.09%,24,0,100.00%
zlxx.v.lxcvc.com,24,0.09%,48,24,50.00%
api2.firefoxchina.cn,24,0.09%,48,24,50.00%
0.cn.pool.ntp.org,24,0.09%,34,10,70.59%
mask-api.icloud.com,24,0.09%,25,1,96.00%
tlu.dl.delivery.mp.microsoft.com.w.alikunlun.com,23,0.08%,46,23,50.00%
aapl-maps.qtlcdn.com,23,0.08%,46,23,50.00%
internal-api-lark-api.feishu.cn.bytedns1.com,23,0.08%,26,3,88.46%
cache.tv.qq.com,23,0.08%,49,26,46.94%
webrd03.is.autonavi.com,23,0.08%,49,26,46.94%
heartbeat.dm.origin.com,23,0.08%,52,29,44.23%
tr.skype.trafficmanager.net,23,0.08%,23,0,100.00%
3071995.dsp-dk.sched.dcloudstc.com,22,0.08%,44,22,50.00%
slardar-bd.feishu.cn.bytedns1.com,22,0.08%,24,2,91.67%
ss0.baidu.com,22,0.08%,53,31,41.51%
wxapp.tc.qq.com,22,0.08%,58,36,37.93%
video-hw-drcn.dbankcdn.cn,22,0.08%,52,30,42.31%
qzone.qq.com,22,0.08%,43,21,51.16%
sf-api.com,22,0.08%,22,0,100.00%
ntp1.tummy.com,22,0.08%,22,0,100.00%
http.ipv6check.akadns.net,22,0.08%,22,0,100.00%
gimg3.baidu.com,21,0.08%,47,26,44.68%
imap.gmail.com,21,0.08%,44,23,47.73%
pc.ximalaya.com,21,0.08%,44,23,47.73%
k128-mzstatic.gslb.ksyuncdn.com,20,0.07%,40,20,50.00%
kv501.prod.do.dsp.mp.microsoft.com,20,0.07%,47,27,42.55%
t8.baidu.com,20,0.07%,52,32,38.46%
ss2.baidu.com,20,0.07%,48,28,41.67%
1595096.sched.d0-dk.tdnsdp1.cn,20,0.07%,41,21,48.78%
e673.dsce9.akamaiedge.net,20,0.07%,40,20,50.00%
tracker.nitrix.me,20,0.07%,42,22,47.62%
cdn.jsdelivr.net,20,0.07%,41,21,48.78%
3.cn.pool.ntp.org,20,0.07%,25,5,80.00%
facebook.com,20,0.07%,39,19,51.28%
bds.snssdk.com,20,0.07%,60,40,33.33%
test.steampowered.com,20,0.07%,40,20,50.00%
ins-59d1h3tv.ias.tencent-cloud.net,19,0.07%,38,19,50.00%
nj.cschannel.anticheatexpert.com,19,0.07%,45,26,42.22%
api2.firefoxchina.cn.wswebpic.com,19,0.07%,38,19,50.00%
discovery-v6.syncthing.net,19,0.07%,19,0,100.00%
ssl.gstatic.com,18,0.07%,49,31,36.73%
mqtt-web.zhihu.com,18,0.07%,42,24,42.86%
zhanzhang.toutiao.com,18,0.07%,40,22,45.00%
tracker.birkenwald.de,18,0.07%,18,0,100.00%
plugins.jetbrains.com,18,0.07%,31,13,58.06%
cp601.prod.do.dsp.mp.microsoft.com,18,0.07%,35,17,51.43%
1.cn.pool.ntp.org,18,0.07%,26,8,69.23%
uk.pool.ntp.org,18,0.07%,23,5,78.26%
e13678.ca2.s.tl88.net,18,0.07%,48,30,37.50%
code.bdstatic.com,18,0.07%,35,17,51.43%
static.nvidiagrid.net,18,0.07%,21,3,85.71%
detail.alicdn.com,18,0.07%,36,18,50.00%
mainnet.infura.io,17,0.06%,34,17,50.00%
notifier-configs.airbrake.io,17,0.06%,37,20,45.95%
tracker.bt4g.com,17,0.06%,34,17,50.00%
t7.baidu.com,17,0.06%,42,25,40.48%
ss3.baidu.com,17,0.06%,43,26,39.53%
easylist-downloads.adblockplus.org,17,0.06%,36,19,47.22%
profile-avatar.csdnimg.cn,17,0.06%,37,20,45.95%
metrics.icloud.com,17,0.06%,39,22,43.59%
vweixinf.tc.qq.com,17,0.06%,40,23,42.50%
p0.qhimg.com,17,0.06%,35,18,48.57%
bt.nfshost.com,17,0.06%,17,0,100.00%
d2nxq2uap88usk.cloudfront.net,17,0.06%,33,16,51.52%
l5.gslb.ksyuncdn.com,17,0.06%,34,17,50.00%
drive.google.com,17,0.06%,36,19,47.22%
detectportal.firefox.com,16,0.06%,650,634,2.46%
HND-efz.ms-acdc.office.com,16,0.06%,32,16,50.00%
content-signature-2.cdn.mozilla.net,16,0.06%,38,22,42.11%
fa000000105.resources.office.net,16,0.06%,36,20,44.44%
tracker.ipv6tracker.ru,16,0.06%,16,0,100.00%
mon.zijieapi.com.dsa.dnsv1.com.cn,16,0.06%,32,16,50.00%
init-china.itunes-apple.com.akadns.net,16,0.06%,38,22,42.11%
down3.huorong.cn,16,0.06%,37,21,43.24%
e6913.dscx.akamaiedge.net,16,0.06%,32,16,50.00%
tracker.1337x.org,15,0.05%,292,277,5.14%
b.bdstatic.com,15,0.05%,40,25,37.50%
clients6.google.com,15,0.05%,30,15,50.00%
firebaselogging-pa.googleapis.com,15,0.05%,38,23,39.47%
bg-bg.facebook.com,15,0.05%,29,14,51.72%
pic1.zhimg.com,15,0.05%,34,19,44.12%
mubu.com,15,0.05%,34,19,44.12%
zh-cn.facebook.com,15,0.05%,29,14,51.72%
bifrost-v4.getpostman.com,15,0.05%,30,15,50.00%
broadcast.chat.bilibili.com,14,0.05%,43,29,32.56%
uz95.v.trpcdn.net,14,0.05%,32,18,43.75%
api.appcues.net,14,0.05%,28,14,50.00%
dl.360safe.com.dl.360qhcdn.com,14,0.05%,28,14,50.00%
ocsp.sca1b.amazontrust.com,14,0.05%,28,14,50.00%
fsigns.duba.net,14,0.05%,32,18,43.75%
docs.gtimg.com,14,0.05%,29,15,48.28%
upos-sz-mirrorcoso1.bilivideo.com,14,0.05%,36,22,38.89%
img-home.csdnimg.cn,14,0.05%,29,15,48.28%
dlassets-ssl.xboxlive.com,14,0.05%,26,12,53.85%
stocks-sparkline.apple.com,14,0.05%,30,16,46.67%
www.download.windowsupdate.com.download.ks-cdn.com,14,0.05%,28,14,50.00%
k256.gslb.ksyuncdn.com,14,0.05%,28,14,50.00%
ha-ng.facebook.com,14,0.05%,28,14,50.00%
ur-pk.facebook.com,14,0.05%,27,13,51.85%
sv-se.facebook.com,14,0.05%,27,13,51.85%
tg-tj.facebook.com,14,0.05%,27,13,51.85%
kn-in.facebook.com,14,0.05%,27,13,51.85%
data.bilicdn2.com,14,0.05%,27,13,51.85%
be01mr9s.sched.d2.tdnsdp1.cn,14,0.05%,24,10,58.33%
dtl.update.updrv.com,14,0.05%,33,19,42.42%
miserupdate.aliyun.com,14,0.05%,29,15,48.28%
optimize.duba.net,14,0.05%,26,12,53.85%
i2.hdslb.com,14,0.05%,37,23,37.84%
adservice.google.com,14,0.05%,38,24,36.84%
hangouts.google.com,14,0.05%,28,14,50.00%
lz4hlmtcf5.feishu.cn,14,0.05%,31,17,45.16%
gspe1-ssl.ls.apple.com,13,0.05%,22,9,59.09%
xp.apple.com,13,0.05%,34,21,38.24%
ssl-google-analytics.l.google.com,13,0.05%,26,13,50.00%
mon.zijieapi.com.bytedns1.com,13,0.05%,58,45,22.41%
f-log-extension.grammarly.io,13,0.05%,30,17,43.33%
www.cntv.cn,13,0.05%,36,23,36.11%
cp501.prod.do.dsp.mp.microsoft.com,13,0.05%,32,19,40.62%
www.googleapis.cn,13,0.05%,29,16,44.83%
www.sohu.com,13,0.05%,33,20,39.39%
docs2.gtimg.com,13,0.05%,27,14,48.15%
fonts.gstatic.com,13,0.05%,29,16,44.83%
csdnimg.cn,13,0.05%,32,19,40.62%
sb.scorecardresearch.com,13,0.05%,33,20,39.39%
ocsp.pki.goog,13,0.05%,28,15,46.43%
pull-flv-l13.douyincdn.com,13,0.05%,27,14,48.15%
pull-f5-vs.flive.douyincdn.com,13,0.05%,29,16,44.83%
pull-hls-f5-enc.flive.douyincdn.com,13,0.05%,29,16,44.83%
pull-f5-mptcp.flive.douyincdn.com,13,0.05%,29,16,44.83%
api1.origin.com,13,0.05%,31,18,41.94%
video-tx-drcn.dbankcdn.cn,13,0.05%,31,18,41.94%
update1.sangfor.net.cdn20.com,13,0.05%,56,43,23.21%
steamstore-a.akamaihd.net,13,0.05%,27,14,48.15%
pl-pl.facebook.com,13,0.05%,25,12,52.00%
szmmsns.qpic.cn,13,0.05%,36,23,36.11%
gamea.haydaygame.com,13,0.05%,25,12,52.00%
ff-ng.facebook.com,13,0.05%,25,12,52.00%
uz-uz.facebook.com,13,0.05%,26,13,50.00%
mt-mt.facebook.com,13,0.05%,25,12,52.00%
zz-tr.facebook.com,13,0.05%,25,12,52.00%
kk-kz.facebook.com,13,0.05%,25,12,52.00%
ja-jp.facebook.com,13,0.05%,25,12,52.00%
zh-tw.facebook.com,13,0.05%,25,12,52.00%
es-la.facebook.com,13,0.05%,25,12,52.00%
lo-la.facebook.com,13,0.05%,25,12,52.00%
e8652.dscx.akamaiedge.net,13,0.05%,26,13,50.00%
emupdate.avcdn.net,12,0.04%,24,12,50.00%
cwx.qlogo.cn,12,0.04%,24,12,50.00%
hub5u.v6.phub.sandai.net,12,0.04%,12,0,100.00%
safebrowsing.googleapis-cn.com,12,0.04%,33,21,36.36%
toblog.ctobsnssdk.com,12,0.04%,23,11,52.17%
beacons3.gvt2.com,12,0.04%,35,23,34.29%
mini.360.cn,12,0.04%,31,19,38.71%
inews.gtimg.com,12,0.04%,35,23,34.29%
www.ieee.org,12,0.04%,28,16,42.86%
pull-lls-spe-l3.douyincdn.com,12,0.04%,25,13,48.00%
dldir1v6.qq.com,12,0.04%,28,16,42.86%
api.segment.io,12,0.04%,24,12,50.00%
2.cn.pool.ntp.org,12,0.04%,18,6,66.67%
browser.360.cn.qh-cdn.com,12,0.04%,24,12,50.00%
clientconfig.akamai.steamstatic.com,12,0.04%,24,12,50.00%
et-ee.facebook.com,12,0.04%,24,12,50.00%
vi-vn.facebook.com,12,0.04%,24,12,50.00%
uk-ua.facebook.com,12,0.04%,24,12,50.00%
sr-rs.facebook.com,12,0.04%,23,11,52.17%
tt-ru.facebook.com,12,0.04%,24,12,50.00%
hy-am.facebook.com,12,0.04%,23,11,52.17%
tz-ma.facebook.com,12,0.04%,23,11,52.17%
gu-in.facebook.com,12,0.04%,24,12,50.00%
or-in.facebook.com,12,0.04%,23,11,52.17%
ne-np.facebook.com,12,0.04%,23,11,52.17%
te-in.facebook.com,12,0.04%,24,12,50.00%
ko-kr.facebook.com,12,0.04%,24,12,50.00%
zh-hk.facebook.com,12,0.04%,23,11,52.17%
ar-ar.facebook.com,12,0.04%,24,12,50.00%
km-kh.facebook.com,12,0.04%,23,11,52.17%
ja-ks.facebook.com,12,0.04%,22,10,54.55%
api.epicgames.dev,12,0.04%,25,13,48.00%
h5api.m.taobao.com,12,0.04%,25,13,48.00%
filedownload.lenovo.com,12,0.04%,32,20,37.50%
tp.m-team.cc,12,0.04%,24,12,50.00%
partner.googleadservices.com,12,0.04%,29,17,41.38%
app-measurement.com,12,0.04%,23,11,52.17%
signaler-pa.clients6.google.com,12,0.04%,24,12,50.00%
sw-ke.facebook.com,12,0.04%,24,12,50.00%
cb-iq.facebook.com,12,0.04%,23,11,52.17%
twitter.com,12,0.04%,27,15,44.44%
pa-in.facebook.com,12,0.04%,23,11,52.17%
ping.avast.com,12,0.04%,24,12,50.00%
omg.wtftrackr.pw,12,0.04%,24,12,50.00%
dl.360safe.com.qh-cdn.com,11,0.04%,22,11,50.00%
resources.jetbrains.com,11,0.04%,18,7,61.11%
g.alicdn.com,11,0.04%,25,14,44.00%
t12.baidu.com,11,0.04%,25,14,44.00%
t10.baidu.com,11,0.04%,22,11,50.00%
i.hhrspb7.top,11,0.04%,22,11,50.00%
pull-rtmp-f13.douyincdn.com,11,0.04%,23,12,47.83%
pull-rtmp-l11-cny.douyincdn.com,11,0.04%,23,12,47.83%
pull-rtmp-l26-cny.douyincdn.com,11,0.04%,23,12,47.83%
pull-f3-proxy.douyincdn.com,11,0.04%,23,12,47.83%
pull-hls-hs-f5-tsl.douyincdn.com,11,0.04%,23,12,47.83%
pull-rtmp-l13.douyincdn.com,11,0.04%,23,12,47.83%
pull-hls-spe-l26.douyincdn.com,11,0.04%,23,12,47.83%
pull-lls-l11.douyincdn.com,11,0.04%,23,12,47.83%
pull-rtmp-l29.douyincdn.com,11,0.04%,23,12,47.83%
pull-lls-f5.flive.douyincdn.com,11,0.04%,25,14,44.00%
pull-tsl-spe-l11.douyincdn.com,11,0.04%,23,12,47.83%
pull-f5-hot.flive.douyincdn.com,11,0.04%,24,13,45.83%
pull-tsl-spe-l26.douyincdn.com,11,0.04%,23,12,47.83%
pull-rtmp-l1-cny.douyincdn.com,11,0.04%,25,14,44.00%
s1.vip.wpscdn.cn,11,0.04%,23,12,47.83%
slb-p2p.vcloud.ks-live.com,11,0.04%,26,15,42.31%
valid.apple.com,11,0.04%,22,11,50.00%
stocks-data-service.apple.com,11,0.04%,24,13,45.83%
mesu-china.apple.com.akadns.net,11,0.04%,28,17,39.29%
bolt.dropbox.com,11,0.04%,22,11,50.00%
m801.music.126.net,11,0.04%,24,13,45.83%
be-by.facebook.com,11,0.04%,22,11,50.00%
ru-ru.facebook.com,11,0.04%,22,11,50.00%
ky-kg.facebook.com,11,0.04%,22,11,50.00%
sy-sy.facebook.com,11,0.04%,22,11,50.00%
am-et.facebook.com,11,0.04%,22,11,50.00%
hi-in.facebook.com,11,0.04%,22,11,50.00%
ml-in.facebook.com,11,0.04%,22,11,50.00%
th-th.facebook.com,11,0.04%,22,11,50.00%
he-il.facebook.com,11,0.04%,22,11,50.00%
my-mm.facebook.com,11,0.04%,22,11,50.00%
datarouter-weighted.ol.epicgames.com,11,0.04%,22,11,50.00%
beacons2.gvt2.com,11,0.04%,22,11,50.00%
me.apple-dns.net,11,0.04%,29,18,37.93%
broker.mina.mi.com,11,0.04%,25,14,44.00%
pancake.apple.com,11,0.04%,24,13,45.83%
redirector.gvt1.com,11,0.04%,23,12,47.83%
assets2.msn.com,11,0.04%,27,16,40.74%
fonts.googleapis.com,11,0.04%,29,18,37.93%
14.au.download.windowsupdate.com,11,0.04%,23,12,47.83%
m.ykimg.com,11,0.04%,22,11,50.00%
download.docker.com,11,0.04%,13,2,84.62%
si-lk.facebook.com,11,0.04%,21,10,52.38%
so-so.facebook.com,11,0.04%,21,10,52.38%
mg-mg.facebook.com,11,0.04%,21,10,52.38%
2.debian.pool.ntp.org,11,0.04%,24,13,45.83%
events.launchdarkly.com,11,0.04%,22,11,50.00%
googlehosted.l.googleusercontent.com,10,0.04%,20,10,50.00%
pull-tsl-l3.douyincdn.com,10,0.04%,21,11,47.62%
pull-hls-f26.douyincdn.com,10,0.04%,21,11,47.62%
frontier-im.douyin.com.w.cdngslb.com,10,0.04%,20,10,50.00%
y.qq.com,10,0.04%,20,10,50.00%
dsp.mbgcdn.lenovo.com.cn,10,0.04%,26,16,38.46%
bkssl.bdimg.com,10,0.04%,23,13,43.48%
SIN-efz.ms-acdc.office.com,10,0.04%,22,12,45.45%
smp-device-content.apple.com,10,0.04%,28,18,35.71%
vweixinthumb.tc.qq.com,10,0.04%,23,13,43.48%
ads.adecosystems.net,10,0.04%,10,0,100.00%
ieeexplore.ieee.org,10,0.04%,23,13,43.48%
inappcheck-lb.itunes-apple.com.akadns.net,10,0.04%,51,41,19.61%
www.bytedance.com,10,0.04%,21,11,47.62%
pull-rtmp-l1.ixigua.com,10,0.04%,20,10,50.00%
pull-flv-spe-l6.douyincdn.com,10,0.04%,21,11,47.62%
pull-f5-io.flive.douyincdn.com,10,0.04%,23,13,43.48%
pull-rtmp-l11.douyincdn.com,10,0.04%,20,10,50.00%
pull-rtmp-l6.douyincdn.com,10,0.04%,21,11,47.62%
pull-tsl-vr-l26.douyincdn.com,10,0.04%,21,11,47.62%
pull-flv-f13.douyincdn.com,10,0.04%,21,11,47.62%
pull-flv-vr-l6.douyincdn.com,10,0.04%,22,12,45.45%
pull-flv-f6.douyincdn.com,10,0.04%,20,10,50.00%
pull-flv-l6-source.douyincdn.com,10,0.04%,21,11,47.62%
pull-l3.douyincdn.com,10,0.04%,21,11,47.62%
pull-tsl-vr-l11.douyincdn.com,10,0.04%,21,11,47.62%
push-rtmp-f5-hs.pstatp.com,10,0.04%,23,13,43.48%
pull-rtmp-f6.douyincdn.com,10,0.04%,21,11,47.62%
pull-flv-f11.douyincdn.com,10,0.04%,21,11,47.62%
pull-flv-l6-cny.douyincdn.com,10,0.04%,21,11,47.62%
pull-spe-l3.douyincdn.com,10,0.04%,21,11,47.62%
pull-tsl-vr-l3.douyincdn.com,10,0.04%,20,10,50.00%
pull-vr-l3.douyincdn.com,10,0.04%,22,12,45.45%
pull-tsl-spe-l6.douyincdn.com,10,0.04%,21,11,47.62%
push-rtmp-f5.douyincdn.com,10,0.04%,23,13,43.48%
pull-lls-spe-l11.douyincdn.com,10,0.04%,23,13,43.48%
pull-flv-f1-proxy.douyincdn.com,10,0.04%,21,11,47.62%
pull-hls-f5-tsl.douyincdn.com,10,0.04%,21,11,47.62%
pull-rtmp-l6.ixigua.com,10,0.04%,21,11,47.62%
pull-f5-hs.flive.pstatp.com,10,0.04%,23,13,43.48%
pull-flv-l6.ixigua.com,10,0.04%,21,11,47.62%
pull-rtmp-f26.douyincdn.com,10,0.04%,21,11,47.62%
pull-rtmp-l1.douyincdn.com,10,0.04%,22,12,45.45%
vdn6.vzuu.com,10,0.04%,26,16,38.46%
gchat.qpic.cn,10,0.04%,20,10,50.00%
gecko-bd.feishu.cn.w.cdngslb.com,10,0.04%,20,10,50.00%
v1.go2yd.com,10,0.04%,24,14,41.67%
mam6.netease.com,10,0.04%,10,0,100.00%
msedge.b.tlu.dl.delivery.mp.microsoft.com,10,0.04%,24,14,41.67%
uz95.v.trpcdn.NET,10,0.04%,20,10,50.00%
clients.l.google.com,10,0.04%,20,10,50.00%
ps-af.facebook.com,10,0.04%,19,9,52.63%
all.feishu.cn.w.kunluncan.com,10,0.04%,20,10,50.00%
help.apple.com,10,0.04%,21,11,47.62%
e15275.g.akamaiedge.net,10,0.04%,20,10,50.00%
img.alicdn.com,10,0.04%,20,10,50.00%
atm-fp-direct.office.com,10,0.04%,21,11,47.62%
appdl-1-drcn.dbankcdn.com,10,0.04%,20,10,50.00%
download.visualstudio.microsoft.com,10,0.04%,21,11,47.62%
2.android.pool.ntp.org,10,0.04%,20,10,50.00%
s.cn.bing.net,10,0.04%,21,11,47.62%
pic3.zhimg.com,10,0.04%,24,14,41.67%
tpc.googlesyndication.com,10,0.04%,23,13,43.48%
0.debian.pool.ntp.org,10,0.04%,20,10,50.00%
mssdk-bu.bytedance.com,10,0.04%,20,10,50.00%
findermp.video.qq.com,10,0.04%,24,14,41.67%
ux70.v.trpcdn.NET,10,0.04%,24,14,41.67%
fa-ir.facebook.com,10,0.04%,20,10,50.00%
upload.docs.google.com,10,0.04%,21,11,47.62%
groups.google.com,10,0.04%,22,12,45.45%
tumblr.com,10,0.04%,22,12,45.45%
aka.ms,10,0.04%,20,10,50.00%
api.dropbox.com,10,0.04%,20,10,50.00%
android.l.google.com,9,0.03%,18,9,50.00%
k1.gslb.ksyuncdn.com,9,0.03%,20,11,45.00%
ocsp.apple.com.download.ks-cdn.com,9,0.03%,18,9,50.00%
stocks-sparkline-lb.apple.com.akadns.net,9,0.03%,18,9,50.00%
msedge.api.cdp.microsoft.com,9,0.03%,77,68,11.69%
iscas-itechs-kg.feishu.cn,9,0.03%,14,5,64.29%
gateway.bitrenren.com,9,0.03%,16,7,56.25%
inappcheck.itunes.apple.com,9,0.03%,43,34,20.93%
www.tm.ak.prd.aadg.trafficmanager.net,9,0.03%,18,9,50.00%
storecatalogrevocation.storequality.microsoft.com,9,0.03%,22,13,40.91%
ts4.cn.mm.bing.net,9,0.03%,28,19,32.14%
emoji.qpic.cn,9,0.03%,23,14,39.13%
pull-hls-f11.douyincdn.com,9,0.03%,19,10,47.37%
pull-flv-vr-l1.douyincdn.com,9,0.03%,18,9,50.00%
pull-hs-f5.flive.ihuoshanlive.com,9,0.03%,19,10,47.37%
pull-hls-vr-l26.douyincdn.com,9,0.03%,19,10,47.37%
pull-flv-vr-l26.douyincdn.com,9,0.03%,19,10,47.37%
pull-rtmp-l11-source.douyincdn.com,9,0.03%,19,10,47.37%
pull-rtmp-f1.douyincdn.com,9,0.03%,18,9,50.00%
pull-tsl-spe-l1.douyincdn.com,9,0.03%,19,10,47.37%
pull-flv-f11-proxy.douyincdn.com,9,0.03%,19,10,47.37%
pull-rtmp-f6-hs.pstatp.com,9,0.03%,19,10,47.37%
pull-flv-f26-proxy.douyincdn.com,9,0.03%,19,10,47.37%
push-rtmp-l1-cny.douyincdn.com,9,0.03%,19,10,47.37%
pull-flv-l6-enc.douyincdn.com,9,0.03%,19,10,47.37%
pull-flv-l11.douyincdn.com,9,0.03%,19,10,47.37%
pull-rtmp-l6-source.douyincdn.com,9,0.03%,19,10,47.37%
pull-flv-l1-cny.douyincdn.com,9,0.03%,19,10,47.37%
pull-flv-l6-encryption.douyincdn.com,9,0.03%,19,10,47.37%
pull-flv-f1.douyincdn.com,9,0.03%,19,10,47.37%
pull-flv-spe-l11.douyincdn.com,9,0.03%,19,10,47.37%
pull-flv-l1-source.douyincdn.com,9,0.03%,19,10,47.37%
pull-lls-spe-l1.douyincdn.com,9,0.03%,19,10,47.37%
pull-l3-cny.douyincdn.com,9,0.03%,19,10,47.37%
pull-flv-l6.douyincdn.com,9,0.03%,19,10,47.37%
pull-tsl-spe-l3.douyincdn.com,9,0.03%,19,10,47.37%
pull-rtmp-f11.douyincdn.com,9,0.03%,19,10,47.37%
pull-tsl-vr-l1.douyincdn.com,9,0.03%,19,10,47.37%
pull-flv-l1.douyincdn.com,9,0.03%,19,10,47.37%
pull-flv-l11-source.douyincdn.com,9,0.03%,19,10,47.37%
pull-tsl-hs-spe-f5.douyincdn.com,9,0.03%,18,9,50.00%
pull-flv-l1.ixigua.com,9,0.03%,19,10,47.37%
pull-f3.douyincdn.com,9,0.03%,18,9,50.00%
push-rtmp-l29.douyincdn.com,9,0.03%,19,10,47.37%
push-rtmp-l11-encryption.douyincdn.com,9,0.03%,19,10,47.37%
pull-hls-f96.douyincdn.com,9,0.03%,19,10,47.37%
pull-l3-source.douyincdn.com,9,0.03%,19,10,47.37%
pic4.zhimg.com,9,0.03%,25,16,36.00%
m701.music.126.net,9,0.03%,22,13,40.91%
img-blog.csdnimg.cn,9,0.03%,22,13,40.91%
res.u-tools.cn,9,0.03%,20,11,45.00%
m.qpic.cn,9,0.03%,22,13,40.91%
s.conf.wsm.360.cn,9,0.03%,20,11,45.00%
se.360.cn,9,0.03%,18,9,50.00%
img-prod-cms-rt-microsoft-com.akamaized.net,9,0.03%,18,9,50.00%
browser.360.cn.download.ks-cdn.com,9,0.03%,18,9,50.00%
a1992.dscd.akamai.net,9,0.03%,18,9,50.00%
fi-fi.facebook.com,9,0.03%,18,9,50.00%
upload-oss.vzuu.com,9,0.03%,18,9,50.00%
qzs.tc.qq.com,9,0.03%,18,9,50.00%
qzs.qq.com.sched.legopic2.tdnsv6.com,9,0.03%,18,9,50.00%
ipv6.china.qiniu.com.trpcdn.net,9,0.03%,18,9,50.00%
cipv6gn.v.trpcdn.net,9,0.03%,18,9,50.00%
play.itunes.apple.com,9,0.03%,21,12,42.86%
cdn.content.prod.cms.msn.com,9,0.03%,22,13,40.91%
appledownload.qtlcdn.com,9,0.03%,18,9,50.00%
webrtc.liveplay.myqcloud.com.sched.webrtc.tdnsv5.com,9,0.03%,18,9,50.00%
firebaseinstallations.googleapis.com,9,0.03%,18,9,50.00%
1.debian.pool.ntp.org,9,0.03%,18,9,50.00%
aladin.wxqcloud.qq.com,9,0.03%,16,7,56.25%
www.xilinx.com,9,0.03%,19,10,47.37%
res.ldmnq.com,9,0.03%,27,18,33.33%
r3.o.lencr.org,9,0.03%,20,11,45.00%
d0.baidupcs.com,9,0.03%,17,8,52.94%
upload.twitter.com,9,0.03%,20,11,45.00%
zhihu-pics-upload.zhimg.com,9,0.03%,18,9,50.00%
www.google.com.do,9,0.03%,21,12,42.86%
www.google.com.cy,9,0.03%,20,11,45.00%
search.yahoo.com,9,0.03%,20,11,45.00%
onenote.com,9,0.03%,17,8,52.94%
store.steampowered.com,9,0.03%,18,9,50.00%
package-search.services.jetbrains.com,8,0.03%,16,8,50.00%
d20wxjqjgi3st.cloudfront.net,8,0.03%,16,8,50.00%
ocsp.apple.com,8,0.03%,18,10,44.44%
push-rtmp-vr-l6.douyincdn.com,8,0.03%,17,9,47.06%
pull-rtmp-l6-hs.pstatp.com,8,0.03%,17,9,47.06%
pull-f5-hs.pstatp.com,8,0.03%,17,9,47.06%
api.kz.naruto.red,8,0.03%,16,8,50.00%
u.qurl.f.360.cn,8,0.03%,18,10,44.44%
acs.youku.com,8,0.03%,20,12,40.00%
baikebcs.bdimg.com,8,0.03%,15,7,53.33%
pic.rmb.bdstatic.com,8,0.03%,17,9,47.06%
gw.alipayobjects.com,8,0.03%,18,10,44.44%
userlink.alicdn.com,8,0.03%,18,10,44.44%
httpdns.alicdn.com,8,0.03%,24,16,33.33%
pull-flv-l3-enc.douyincdn.com,8,0.03%,17,9,47.06%
pull-flv-l3-encryption.douyincdn.com,8,0.03%,17,9,47.06%
pull-rtmp-f96.douyincdn.com,8,0.03%,17,9,47.06%
pull-rtmp-l1-hs.pstatp.com,8,0.03%,17,9,47.06%
push-rtmp-spe-l6.douyincdn.com,8,0.03%,17,9,47.06%
pull-hs-f5.flive.huoshanlive.com,8,0.03%,17,9,47.06%
pull-hls-vr-l1.douyincdn.com,8,0.03%,17,9,47.06%
push-rtmp-l6.ixigua.com,8,0.03%,17,9,47.06%
pull-hls-spe-l6.douyincdn.com,8,0.03%,17,9,47.06%
pull-f5.douyincdn.com,8,0.03%,17,9,47.06%
pull-hls-spe-l11.douyincdn.com,8,0.03%,17,9,47.06%
push-rtmp-l1.douyincdn.com,8,0.03%,17,9,47.06%
pull-rtmp-l1-source.douyincdn.com,8,0.03%,17,9,47.06%
pull-flv-l11-encryption.douyincdn.com,8,0.03%,17,9,47.06%
pull-flv-f96.douyincdn.com,8,0.03%,17,9,47.06%
pull-tsl-vr-l6.douyincdn.com,8,0.03%,17,9,47.06%
pull-l3-hs.pstatp.com,8,0.03%,16,8,50.00%
pull-flv-l26.douyincdn.com,8,0.03%,17,9,47.06%
push-rtmp-l3-cny.douyincdn.com,8,0.03%,17,9,47.06%
pull-hs-f5-encryption.flive.douyincdn.com,8,0.03%,17,9,47.06%
pull-hls-f6.douyincdn.com,8,0.03%,17,9,47.06%
pull-hls-f1.douyincdn.com,8,0.03%,18,10,44.44%
pull-hs-f5.flive.douyincdn.com,8,0.03%,17,9,47.06%
pull-tsl-l11.douyincdn.com,8,0.03%,17,9,47.06%
push-rtmp-l3.douyincdn.com,8,0.03%,17,9,47.06%
push-rtmp-spe-l26.douyincdn.com,8,0.03%,17,9,47.06%
pull-hls-spe-l1.douyincdn.com,8,0.03%,17,9,47.06%
pull-flv-spe-l1.douyincdn.com,8,0.03%,17,9,47.06%
push-rtmp-l6-encryption.douyincdn.com,8,0.03%,17,9,47.06%
pull-flv-l26-cny.douyincdn.com,8,0.03%,17,9,47.06%
push-rtmp-spe-l1.douyincdn.com,8,0.03%,17,9,47.06%
push-rtmp-l3-hs.pstatp.com,8,0.03%,17,9,47.06%
pull-hls-vr-l11.douyincdn.com,8,0.03%,17,9,47.06%
pull-lls-spe-l6.douyincdn.com,8,0.03%,17,9,47.06%
pull-flv-vr-l11.douyincdn.com,8,0.03%,17,9,47.06%
pull-flv-f29.douyincdn.com,8,0.03%,17,9,47.06%
pull-lls-l3.douyincdn.com,8,0.03%,17,9,47.06%
pull-flv-spe-l26.douyincdn.com,8,0.03%,17,9,47.06%
pull-hs-spe-f5.douyincdn.com,8,0.03%,17,9,47.06%
push-rtmp-l1-hs.pstatp.com,8,0.03%,17,9,47.06%
itunes.apple.com,8,0.03%,18,10,44.44%
wppkg.baidupcs.com,8,0.03%,17,9,47.06%
cm.g.doubleclick.net,8,0.03%,19,11,42.11%
whoami.akamai.net,8,0.03%,19,11,42.11%
v1-hwllqv.onewsvod.com,8,0.03%,19,11,42.11%
cipv6gn.v.trpcdn.NET,8,0.03%,16,8,50.00%
www.tm.a.prd.aadg.trafficmanager.net,8,0.03%,16,8,50.00%
a1843.g1.akamai.net,8,0.03%,16,8,50.00%
res.wx.qq.com.sched.legopic1.tdnsv6.com,8,0.03%,17,9,47.06%
dldir1.legao.sched.dcloudstc.com,8,0.03%,16,8,50.00%
gates.grammarly.com,8,0.03%,18,10,44.44%
code.bdstatic.com.a.bdydns.com,8,0.03%,16,8,50.00%
www.zhihu.com.dsa.dnsv1.com,8,0.03%,16,8,50.00%
gslb-dsa-tc.zhihu.com,8,0.03%,16,8,50.00%
e589fa51.zhihu.com.dsa.dnsv1.com,8,0.03%,16,8,50.00%
j1hqc7ee.sched.d0-dk.tdnsdp1.cn,8,0.03%,16,8,50.00%
opencdnglobal.jomodns.com,8,0.03%,16,8,50.00%
inz5jaqbqg.feishu.cn,8,0.03%,16,8,50.00%
qt010.china.line.qiniudns.com,8,0.03%,16,8,50.00%
datacenter.eastmoney.com,8,0.03%,18,10,44.44%
calendar.google.com,8,0.03%,18,10,44.44%
console.cloud.google.com,8,0.03%,20,12,40.00%
cd.huoying666.com,8,0.03%,14,6,57.14%
6qnz2sy8.sched.d2.tdnsdp1.cn,8,0.03%,16,8,50.00%
mcs-bd.feishu.cn.w.cdngslb.com,8,0.03%,16,8,50.00%
s6130-ml.gslb.ksyuncdn.com,8,0.03%,17,9,47.06%
e12919.dscd.akamaiedge.net,8,0.03%,15,7,53.33%
lupic.cdn.bcebos.com,8,0.03%,18,10,44.44%
stocks-data-service.lb-apple.com.akadns.net,8,0.03%,18,10,44.44%
storage.googleapis.com,8,0.03%,16,8,50.00%
d.dropbox.com,8,0.03%,16,8,50.00%
m.youtube.com,8,0.03%,16,8,50.00%
youtube.com,8,0.03%,16,8,50.00%
youtubei.googleapis.com,8,0.03%,15,7,53.33%
www.google.com.af,8,0.03%,19,11,42.11%
www.google.com.ag,8,0.03%,19,11,42.11%
www.google.com.bd,8,0.03%,19,11,42.11%
www.google.com.bh,8,0.03%,18,10,44.44%
www.google.com.bn,8,0.03%,18,10,44.44%
www.google.com.bo,8,0.03%,18,10,44.44%
www.google.com.bz,8,0.03%,19,11,42.11%
www.google.co.cr,8,0.03%,18,10,44.44%
www.google.com.cu,8,0.03%,19,11,42.11%
www.google.com.au,8,0.03%,18,10,44.44%
www.google.com.br,8,0.03%,18,10,44.44%
www.google.co.ck,8,0.03%,19,11,42.11%
www.google.com.co,8,0.03%,18,10,44.44%
plus.google.com,8,0.03%,18,10,44.44%
www.google.co.bw,8,0.03%,18,10,44.44%
www.google.com.ai,8,0.03%,19,11,42.11%
www.google.com.ar,8,0.03%,19,11,42.11%
dotplayer.coldlake1.com,8,0.03%,12,4,66.67%
es.f.360.cn,8,0.03%,17,9,47.06%
p4.music.126.net,8,0.03%,15,7,53.33%
conf.f.qh-lb.com,8,0.03%,16,8,50.00%
zjcdnl.pullcmcc.gslb.d.live.cdn.chinamobile.com,7,0.03%,14,7,50.00%
pull-hls-f11.douyincdn.com.tcdnlive.com,7,0.03%,15,8,46.67%
assets.msn.cn,7,0.03%,260,253,2.69%
qpic.y.qq.com,7,0.03%,13,6,53.85%
settings-bd.feishu.cn,7,0.03%,13,6,53.85%
safebrowsing.google.com,7,0.03%,19,12,36.84%
dmpstatic.cdn.bcebos.com,7,0.03%,15,8,46.67%
gss0.baidu.com,7,0.03%,13,6,53.85%
clients2.googleusercontent.com,7,0.03%,14,7,50.00%
disc801.prod.do.dsp.mp.microsoft.com,7,0.03%,15,8,46.67%
grs.dbankcloud.asia,7,0.03%,14,7,50.00%
zconfig.alibabausercontent.com,7,0.03%,19,12,36.84%
himg.bdimg.com,7,0.03%,17,10,41.18%
img-xlppc-zhan.xunlei.com,7,0.03%,25,18,28.00%
zhihu-web-analytics.zhihu.com,7,0.03%,46,39,15.22%
cdn.ynuf.aliapp.org,7,0.03%,15,8,46.67%
dl.kkdownload.com,7,0.03%,14,7,50.00%
push-rtmp-hs-spe-f5.douyincdn.com,7,0.03%,15,8,46.67%
push-rtmp-spe-l11.douyincdn.com,7,0.03%,15,8,46.67%
pull-flv-f6-hs.pstatp.com,7,0.03%,15,8,46.67%
push-rtmp-l26.douyincdn.com,7,0.03%,15,8,46.67%
push-rtmp-l6-hs.pstatp.com,7,0.03%,15,8,46.67%
push-rtmp-vr-l11.douyincdn.com,7,0.03%,15,8,46.67%
push-rtmp-l11.douyincdn.com,7,0.03%,15,8,46.67%
push-rtmp-l1.ixigua.com,7,0.03%,15,8,46.67%
push-rtmp-l13.douyincdn.com,7,0.03%,15,8,46.67%
push-rtmp-hs-f5.douyincdn.com,7,0.03%,15,8,46.67%
push-rtmp-vr-l26.douyincdn.com,7,0.03%,15,8,46.67%
push-rtmp-hs-vr-f5.douyincdn.com,7,0.03%,15,8,46.67%
push-rtmp-l3-enc.douyincdn.com,7,0.03%,15,8,46.67%
pull-flv-f1-hs.pstatp.com,7,0.03%,15,8,46.67%
pull-hls-f5-vs-tsl.douyincdn.com,7,0.03%,16,9,43.75%
pull-flv-l29.douyincdn.com,7,0.03%,17,10,41.18%
push-rtmp-f5-enc.douyincdn.com,7,0.03%,15,8,46.67%
sf3-fe-tos.pglstatp-toutiao.com,7,0.03%,15,8,46.67%
uci.cdn.office.net,7,0.03%,15,8,46.67%
upos-sz-mirrorcos.bilivideo.com,7,0.03%,20,13,35.00%
upos-sz-mirrorali.bilivideo.com,7,0.03%,19,12,36.84%
apps.mzstatic.com,7,0.03%,15,8,46.67%
android.googleapis.com,7,0.03%,15,8,46.67%
www.download.windowsupdate.com,7,0.03%,18,11,38.89%
entitlement-public-service-prod.ak.epicgames.com,7,0.03%,13,6,53.85%
pgpstatic.games.wanmei.com,7,0.03%,16,9,43.75%
normandy-cdn.services.mozilla.com,7,0.03%,14,7,50.00%
t11.baidu.com,7,0.03%,18,11,38.89%
go.microsoft.com.edgekey.net,7,0.03%,15,8,46.67%
honeycomb.wpscdn.cn.download.ks-cdn.com,7,0.03%,15,8,46.67%
public-treatment.prod-experimentation.grammarlyaws.com,7,0.03%,16,9,43.75%
datacenter.eastmoney.com.cdn.dnsv1.com,7,0.03%,14,7,50.00%
kjk3jf40.sched.sma-dk.tdnsstic1.cn,7,0.03%,14,7,50.00%
img.alicdn.com.danuoyi.alicdn.com,7,0.03%,14,7,50.00%
a2p-s01-drcn.xcm.xyx-xylo.com,7,0.03%,47,40,14.89%
tx.pull.yximgs.com,7,0.03%,13,6,53.85%
ks.pull.yximgs.com,7,0.03%,13,6,53.85%
ws.pull.yximgs.com,7,0.03%,13,6,53.85%
opencdnqiniustaticv6.jomodns.com,7,0.03%,14,7,50.00%
pull-hls-spe-l11.douyincdn.com.sched.l9.tdnsv5.com,7,0.03%,16,9,43.75%
pull-tsl-spe-l1.douyincdn.com.wsdvs.com,7,0.03%,14,7,50.00%
p0.meituan.net,7,0.03%,15,8,46.67%
valipl-vip-p1.cp31.ott.cibntv.net,7,0.03%,24,17,29.17%
s6110-ml.gslb.ksyuncdn.com,7,0.03%,16,9,43.75%
s03-ml.gslb.ksyuncdn.com,7,0.03%,15,8,46.67%
push-rtmp-l3-encryption.douyincdn.com.w.kunlunso.com,7,0.03%,15,8,46.67%
pull-flv-f1.douyincdn.com.gccdn.net,7,0.03%,16,9,43.75%
pull-flv-spe-l11.douyincdn.com.sched.l9.tdnsv5.com,7,0.03%,14,7,50.00%
2852517.sched.v1lego.tdnsvod1.cn,7,0.03%,14,7,50.00%
pull-flv-l1.douyincdn.com.gccdn.net,7,0.03%,14,7,50.00%
pull-hls-spe-l1.douyincdn.com.wsdvs.com,7,0.03%,14,7,50.00%
pull-flv-l1.ixigua.com.wsdvs.com,7,0.03%,14,7,50.00%
pull-flv-f1-proxy.douyincdn.com.wsdvs.com,7,0.03%,14,7,50.00%
erh4gbw3.sched.v1lego-dk.tdnsvod1.cn,7,0.03%,14,7,50.00%
pull-lls-l3.douyincdn.com.w.cdngslb.com,7,0.03%,14,7,50.00%
api.flash.cn,7,0.03%,17,10,41.18%
cu003.www.duba.net,7,0.03%,16,9,43.75%
ipv6.msftncsi.com,7,0.03%,11,4,63.64%
seraph.zijieapi.com,7,0.03%,14,7,50.00%
cp801.prod.do.dsp.mp.microsoft.com,7,0.03%,14,7,50.00%
sz-qiniu-all.volcgtm.com,7,0.03%,14,7,50.00%
sjy6.stream.qqmusic.qq.com.vdncache.com,7,0.03%,14,7,50.00%
miserupdate.aliyun.com.danuoyi.tbcache.com,7,0.03%,14,7,50.00%
bjacshow.kugou.com,7,0.03%,16,9,43.75%
pc-plugin-plg-wpscdn-cn-idvh11c.qiniudns.com,7,0.03%,10,3,70.00%
upload.youtube.com,7,0.03%,13,6,53.85%
dropbox.com,7,0.03%,16,9,43.75%
paper.dropbox.com,7,0.03%,16,9,43.75%
showcase.dropbox.com,7,0.03%,16,9,43.75%
sites.google.com,7,0.03%,16,9,43.75%
contacts.google.com,7,0.03%,14,7,50.00%
hcfy.app,7,0.03%,14,7,50.00%
ocsp.digicert.cn,7,0.03%,15,8,46.67%
gspe35-ssl.ls.apple.com.w.alikunlun.com,7,0.03%,14,7,50.00%
com,7,0.03%,14,7,50.00%
pull-flv-f1-hs.pstatp.com.wsdvs.com,6,0.02%,14,8,42.86%
static.mysmth.net,6,0.02%,14,8,42.86%
pull-flv-l3-encryption.douyincdn.com.w.alikunlun.net,6,0.02%,14,8,42.86%
pull-flv-l3-enc.douyincdn.com.w.alikunlun.net,6,0.02%,13,7,46.15%
pull-flv-vr-l1.douyincdn.com.wsdvs.com,6,0.02%,14,8,42.86%
push-rtmp-l6-enc.douyincdn.com.upvcloud.ks-cdn.com,6,0.02%,13,7,46.15%
g.y.qq.com,6,0.02%,12,6,50.00%
config.edge.skype.com,6,0.02%,273,267,2.20%
sdup.qihucdn.com,6,0.02%,14,8,42.86%
rinkeby.infura.io,6,0.02%,13,7,46.15%
library-service.live.use1a.on.epicgames.com,6,0.02%,12,6,50.00%
s.mzstatic.com,6,0.02%,12,6,50.00%
at.alicdn.com,6,0.02%,17,11,35.29%
gw.alicdn.com,6,0.02%,14,8,42.86%
ue.lenovomm.cn,6,0.02%,70,64,8.57%
ali2.a.yximgs.com,6,0.02%,14,8,42.86%
tracker.xfsub.com,6,0.02%,6,0,100.00%
dl.pinyin.sogou.com,6,0.02%,16,10,37.50%
www.emerald.com,6,0.02%,13,7,46.15%
cdn1.ime.sogou.com,6,0.02%,13,7,46.15%
push-rtmp-l6-enc.douyincdn.com,6,0.02%,13,7,46.15%
push-rtmp-l6.douyincdn.com,6,0.02%,13,7,46.15%
push-rtmp-hs-f5.huoshanlive.com,6,0.02%,13,7,46.15%
push-rtmp-l3-encryption.douyincdn.com,6,0.02%,13,7,46.15%
push-rtmp-l6-cny.douyincdn.com,6,0.02%,13,7,46.15%
push-rtmp-vr-l1.douyincdn.com,6,0.02%,13,7,46.15%
pull-f3-hs.pstatp.com,6,0.02%,13,7,46.15%
pull-flv-l1-hs.pstatp.com,6,0.02%,13,7,46.15%
pull-rtmp-f1-hs.pstatp.com,6,0.02%,13,7,46.15%
tangram-config.gdt.qq.com,6,0.02%,16,10,37.50%
ca.iadsdk.apple.com,6,0.02%,12,6,50.00%
as-tlx.3lift.com,6,0.02%,12,6,50.00%
cdn.cvws.apple-dns.net,6,0.02%,18,12,33.33%
wifi.vivo.com.cn,6,0.02%,18,12,33.33%
tracker.vanitycore.co,6,0.02%,12,6,50.00%
s.url.cn,6,0.02%,12,6,50.00%
puui.qpic.cn,6,0.02%,10,4,60.00%
v9-hwllqv.onewsvod.com,6,0.02%,14,8,42.86%
fundingchoicesmessages.google.com,6,0.02%,14,8,42.86%
down-30005.sz.gfp.tencent-cloud.com,6,0.02%,12,6,50.00%
cu010.www.duba.net,6,0.02%,15,9,40.00%
v6-2.nigirocloud.com,6,0.02%,6,0,100.00%
ins-diu1q33u.ias.tencent-cloud.net,6,0.02%,12,6,50.00%
us.sinaimg.cn.w.alikunlun.net,6,0.02%,14,8,42.86%
y.gtimg.cn.sched.ssd.tdnsv6.com,6,0.02%,15,9,40.00%
dbe610da.feishu.cn.dsa.dnsv1.com,6,0.02%,10,4,60.00%
zinwdptedg.feishu.cn,6,0.02%,12,6,50.00%
pub.idqqimg.com.sched.legopic1.tdnsv6.com,6,0.02%,12,6,50.00%
slardar-bd.feishu.cn.w.cdngslb.com,6,0.02%,12,6,50.00%
ow1.res.office365.com,6,0.02%,14,8,42.86%
tsbrowser.xiangtatech.com,6,0.02%,18,12,33.33%
appoptimize-drcn.dbankcdn.cn,6,0.02%,12,6,50.00%
hicloud.hiwifi.com,6,0.02%,12,6,50.00%
bd.pull.yximgs.com,6,0.02%,13,7,46.15%
pull-rtmp-l1-hs.pstatp.com.wsdvs.com,6,0.02%,14,8,42.86%
pull-flv-f11.douyincdn.com.sched.l8.tdnsv5.com,6,0.02%,14,8,42.86%
push-rtmp-spe-l6.douyincdn.com.upvcloud.ks-cdn.com,6,0.02%,13,7,46.15%
pull-hls-vr-l1.douyincdn.com.wsdvs.com,6,0.02%,14,8,42.86%
u01-ml.gslb.ksyuncdn.com,6,0.02%,16,10,37.50%
pull-hls-spe-l6.douyincdn.com.hlsvcloud.ks-cdn.com,6,0.02%,13,7,46.15%
pull-flv-vr-l26.douyincdn.com.c.cdnhwc3.com,6,0.02%,13,7,46.15%
u104-ml.gslb.ksyuncdn.com,6,0.02%,14,8,42.86%
pull-flv-spe-l6.douyincdn.com.hdlvcloud.ks-cdn.com,6,0.02%,13,7,46.15%
4532841.pack.tcdnlive.com,6,0.02%,14,8,42.86%
pull-rtmp-f1.douyincdn.com.wsdvs.com,6,0.02%,13,7,46.15%
pull-rtmp-l26-cny.douyincdn.com.c.cdnhwc3.com,6,0.02%,13,7,46.15%
pull-f3-proxy.douyincdn.com.w.alikunlun.net,6,0.02%,13,7,46.15%
pull-rtmp-l1-source.douyincdn.com.wsdvs.com,6,0.02%,13,7,46.15%
www.liebao.cn,6,0.02%,14,8,42.86%
2076077.sched.d0.tdnsdp1.cn,6,0.02%,8,2,75.00%
vdn6-1.vzuu.com,6,0.02%,16,10,37.50%
mdp-appconf-cn.heytapdownload.com,6,0.02%,16,10,37.50%
pic2.zhimg.com,6,0.02%,18,12,33.33%
p1.meituan.net,6,0.02%,14,8,42.86%
s1.url.cn,6,0.02%,12,6,50.00%
pull-flv-l11-encryption.douyincdn.com.tcdnlive.com,6,0.02%,14,8,42.86%
pull-tsl-vr-l6.douyincdn.com.hlsvcloud.ks-cdn.com,6,0.02%,13,7,46.15%
pull-l3-hs.pstatp.com.w.alikunlun.net,6,0.02%,14,8,42.86%
pull-tsl-l3.douyincdn.com.w.alikunlun.net,6,0.02%,13,7,46.15%
pull-flv-l6-enc.douyincdn.com.hdlvcloud.ks-cdn.com,6,0.02%,13,7,46.15%
pull-flv-f6.douyincdn.com.hdlvcloud.ks-cdn.com,6,0.02%,13,7,46.15%
push-rtmp-l3-cny.douyincdn.com.w.kunlunso.com,6,0.02%,14,8,42.86%
push-rtmp-vr-l11.douyincdn.com.tlivepush.com,6,0.02%,13,7,46.15%
pull-l3.douyincdn.com.w.alikunlun.net,6,0.02%,13,7,46.15%
pull-flv-l1-cny.douyincdn.com.wsdvs.com,6,0.02%,14,8,42.86%
pull-flv-l6-encryption.douyincdn.com.hdlvcloud.ks-cdn.com,6,0.02%,13,7,46.15%
48l6nsax.sched.v1lego-dk.tdnsvod1.cn,6,0.02%,14,8,42.86%
pull-hls-f6.douyincdn.com.hlsvcloud.ks-cdn.com,6,0.02%,13,7,46.15%
pull-flv-l1-source.douyincdn.com.wsdvs.com,6,0.02%,13,7,46.15%
pull-lls-spe-l1.douyincdn.com.wsdvs.com,6,0.02%,14,8,42.86%
pull-l3-cny.douyincdn.com.w.alikunlun.com,6,0.02%,14,8,42.86%
pull-hls-f1.douyincdn.com.wsdvs.com,6,0.02%,14,8,42.86%
pull-spe-l3.douyincdn.com.230b2a2545cfa773.queniucf.com,6,0.02%,13,7,46.15%
push-rtmp-vr-l1.douyincdn.com.wsdvs.com,6,0.02%,14,8,42.86%
push-rtmp-l3.douyincdn.com.w.kunlunso.com,6,0.02%,14,8,42.86%
pull-tsl-vr-l3.douyincdn.com.bytedns1.com,6,0.02%,13,7,46.15%
pull-tsl-vr-l1.douyincdn.com.wsdvs.com,6,0.02%,14,8,42.86%
push-rtmp-spe-l26.douyincdn.com.c.cdnhwc3.com,6,0.02%,14,8,42.86%
push-rtmp-l3-enc.douyincdn.com.w.kunlunso.com,6,0.02%,13,7,46.15%
pull-flv-spe-l1.douyincdn.com.wsdvs.com,6,0.02%,14,8,42.86%
push-rtmp-l6-encryption.douyincdn.com.upvcloud.ks-cdn.com,6,0.02%,13,7,46.15%
pull-tsl-hs-spe-f5.douyincdn.com.bytedns1.com,6,0.02%,13,7,46.15%
pull-f3.douyincdn.com.m.alikunlun.net,6,0.02%,13,7,46.15%
push-rtmp-l3-hs.pstatp.com.w.kunlunso.com,6,0.02%,13,7,46.15%
pull-hls-f5-vs-tsl.douyincdn.com.w.kunluncan.com,6,0.02%,14,8,42.86%
pull-tsl-spe-l26.douyincdn.com.51296c5e.c.cdnhwc1.com,6,0.02%,13,7,46.15%
pull-flv-l1-hs.pstatp.com.wsdvs.com,6,0.02%,14,8,42.86%
pull-lls-spe-l6.douyincdn.com.hdlvcloud.ks-cdn.com,6,0.02%,13,7,46.15%
pull-flv-vr-l11.douyincdn.com.tlivecdn.com,6,0.02%,13,7,46.15%
pull-rtmp-l1.douyincdn.com.wsdvs.com,6,0.02%,14,8,42.86%
pull-rtmp-f1-hs.pstatp.com.wsdvs.com,6,0.02%,14,8,42.86%
pull-l3-source.douyincdn.com.w.cdngslb.com,6,0.02%,13,7,46.15%
setup.icloud.com,6,0.02%,15,9,40.00%
img2.doubanio.com,6,0.02%,12,6,50.00%
bimp.hdslb.com,6,0.02%,16,10,37.50%
ldc-fast.lenovo.com.cn,6,0.02%,12,6,50.00%
pancake.cdn-apple.com.akadns.net,6,0.02%,12,6,50.00%
vconf.f.qh-lb.com,6,0.02%,12,6,50.00%
mesu-cdn.apple.com.akadns.net,6,0.02%,14,8,42.86%
internal-api-lark-api.feishu.cn.w.cdngslb.com,6,0.02%,12,6,50.00%
netty.yunduoketang.com,6,0.02%,12,6,50.00%
onedrive.live.com,6,0.02%,12,6,50.00%
v6-1.nigirocloud.com,6,0.02%,6,0,100.00%
1039909-9.chat.api.drift.com,6,0.02%,12,6,50.00%
ux70.v.trpcdn.net,6,0.02%,14,8,42.86%
bcefdyflvq.jomodns.com,6,0.02%,14,8,42.86%
bceliveup2.jomodns.com,6,0.02%,12,6,50.00%
pc001.download.wh.cmcm.com,6,0.02%,14,8,42.86%
googleads4.g.doubleclick.net,6,0.02%,12,6,50.00%
img-all.qiniu.com.volcgslb.com,6,0.02%,8,2,75.00%
cc.adingo.jp,6,0.02%,14,8,42.86%
disc501.prod.do.dsp.mp.microsoft.com,6,0.02%,15,9,40.00%
y.gtimg.cn,6,0.02%,13,7,46.15%
gecko-pangle-lf.snssdk.com,6,0.02%,11,5,54.55%
14.tlu.dl.delivery.mp.microsoft.com,6,0.02%,17,11,35.29%
p111-fmip.icloud.com,6,0.02%,6,0,100.00%
3.debian.pool.ntp.org,6,0.02%,13,7,46.15%
ipv6.www.so.com,6,0.02%,6,0,100.00%
up-q.qh-lb.com,6,0.02%,12,6,50.00%
vod-all.qiniu.com.volcgslb.com,6,0.02%,6,0,100.00%
partiality.itunes.apple.com,6,0.02%,12,6,50.00%
rhc.sonatype.com,6,0.02%,6,0,100.00%
javadl-esd-secure.oracle.com,6,0.02%,12,6,50.00%
e6987.a.akamaiedge.net,5,0.02%,10,5,50.00%
btrace.qq.com,5,0.02%,222,217,2.25%
push-rtmp-vr-l6.douyincdn.com.upvcloud.ks-cdn.com,5,0.02%,12,7,41.67%
u01.gslb.ksyuncdn.com,5,0.02%,10,5,50.00%
s107.gslb.ksyuncdn.com,5,0.02%,14,9,35.71%
pull-rtmp-f96.douyincdn.com.d.live.cdn.chinamobile.com,5,0.02%,10,5,50.00%
pull-hls-f26.douyincdn.com.c.cdnhwc1.com,5,0.02%,12,7,41.67%
bcelive.jomodns.com,5,0.02%,11,6,45.45%
api.msn.com,5,0.02%,121,116,4.13%
api2.gettoby.com,5,0.02%,13,8,38.46%
mss0.bdstatic.com,5,0.02%,9,4,55.56%
ipcdn.apple.com,5,0.02%,13,8,38.46%
v-fixedinpt1001.71edge.xyz,5,0.02%,7,2,71.43%
t2.xiaohongshu.com,5,0.02%,13,8,38.46%
journal.hep.com.cn,5,0.02%,15,10,33.33%
www.webofknowledge.com,5,0.02%,14,9,35.71%
conn5.coloros.com,5,0.02%,12,7,41.67%
ws-keyboard.shouji.sogou.com,5,0.02%,13,8,38.46%
upos-sz-mirrorhwo1.bilivideo.com,5,0.02%,12,7,41.67%
push-rtmp-f5.ihuoshanlive.com,5,0.02%,11,6,45.45%
unpkg.zhimg.com,5,0.02%,11,6,45.45%
aeu.alicdn.com,5,0.02%,12,7,41.67%
gfwsl.geforce.cn,5,0.02%,10,5,50.00%
api.twitter.com,5,0.02%,19,14,26.32%
pc-update-3.wpscdn.cn,5,0.02%,10,5,50.00%
midas.gtimg.cn,5,0.02%,10,5,50.00%
bag.itunes.apple.com,5,0.02%,63,58,7.94%
upos-sz-mirrorhw.bilivideo.com,5,0.02%,11,6,45.45%
api.weathercn.com,5,0.02%,12,7,41.67%
p26-be-pack-sign.pglstatp-toutiao.com.51296c5e.c.cdnhwc1.com,5,0.02%,10,5,50.00%
dl.google.com,5,0.02%,8,3,62.50%
index-cdn.jetbrains.com,5,0.02%,9,4,55.56%
apps-mzstatic-cdn.itunes-apple.com.akadns.net,5,0.02%,11,6,45.45%
fa000000005.resources.office.net,5,0.02%,12,7,41.67%
v3-be-pack.pglstatp-toutiao.com.w.cdngslb.com,5,0.02%,10,5,50.00%
clientlog.wanmei.com,5,0.02%,11,6,45.45%
a1768.g1.akamai.net,5,0.02%,10,5,50.00%
a1737.b.akamai.net,5,0.02%,10,5,50.00%
www.tm.ak.prd.aadg.akadns.net,5,0.02%,10,5,50.00%
live.primis.tech,5,0.02%,10,5,50.00%
sslhotpcs.jomodns.com,5,0.02%,10,5,50.00%
game.haydaygame.com,5,0.02%,10,5,50.00%
browser.360.cn.ucloudnaming.cn,5,0.02%,10,5,50.00%
sz-ucloud-ipv4.ucloudnaming.info,5,0.02%,10,5,50.00%
repo.zotero.org,5,0.02%,13,8,38.46%
tx-origin.pull.yximgs.com,5,0.02%,10,5,50.00%
smartdl.lenovo.com.cn,5,0.02%,12,7,41.67%
l2.hiwifi.com,5,0.02%,10,5,50.00%
appdl-drcn.dbankcdn.com,5,0.02%,11,6,45.45%
ws-adaptive.pull.yximgs.com,5,0.02%,10,5,50.00%
public.gdtimg.com,5,0.02%,10,5,50.00%
pull-hs-f5.flive.huoshanlive.com.c.volcfcdndvs.com,5,0.02%,12,7,41.67%
pull-hs-f5.flive.ihuoshanlive.com.c.volcfcdndvs.com,5,0.02%,13,8,38.46%
hcdnl.pulldyin.iptv.gslb.c.cdnhwc2.com,5,0.02%,10,5,50.00%
pull-f5.douyincdn.com.c.bytefcdn.com,5,0.02%,12,7,41.67%
pull-rtmp-l1.ixigua.com.wsdvs.com,5,0.02%,12,7,41.67%
bcedyflvq.jomodns.com,5,0.02%,10,5,50.00%
pull-rtmp-l11-cny.douyincdn.com.tcdnlive.com,5,0.02%,12,7,41.67%
push-rtmp-l1.douyincdn.com.wsdvs.com,5,0.02%,14,9,35.71%
pull-rtmp-l11.douyincdn.com.tcdnlive.com,5,0.02%,11,6,45.45%
bt2.archive.org,5,0.02%,14,9,35.71%
dotbeats.douyucdn.cn,5,0.02%,11,6,45.45%
vdn5-1.vzuu.com,5,0.02%,13,8,38.46%
vdn5.vzuu.com,5,0.02%,14,9,35.71%
tlu.dl.delivery.mp.microsoft.com,5,0.02%,11,6,45.45%
translate.googleapis.com,5,0.02%,12,7,41.67%
cdn2.ime.sogou.com,5,0.02%,13,8,38.46%
pull-f5-hs.pstatp.com.c.bytefcdn.com,5,0.02%,11,6,45.45%
pull-hls-vr-l26.douyincdn.com.c.cdnhwc3.com,5,0.02%,11,6,45.45%
push-rtmp-spe-l11.douyincdn.com.tlivepush.com,5,0.02%,12,7,41.67%
pull-flv-f11-proxy.douyincdn.com.tcdnlive.com,5,0.02%,11,6,45.45%
pull-hls-hs-f5-tsl.douyincdn.com.bytedns1.com,5,0.02%,12,7,41.67%
pull-tsl-vr-l26.douyincdn.com.51296c5e.c.cdnhwc1.com,5,0.02%,12,7,41.67%
push-rtmp-l26.douyincdn.com.c.cdnhwc3.com,5,0.02%,11,6,45.45%
push-rtmp-hs-f5.huoshanlive.com.c.volcfcdndvs.com,5,0.02%,12,7,41.67%
pull-flv-f26-proxy.douyincdn.com.c.cdnhwc3.com,5,0.02%,12,7,41.67%
push-rtmp-l1-cny.douyincdn.com.wsdvs.com,5,0.02%,14,9,35.71%
push-rtmp-l1.ixigua.com.wsdvs.com,5,0.02%,15,10,33.33%
push-rtmp-hs-f5.douyincdn.com.c.volcfcdndvs.com,5,0.02%,12,7,41.67%
push-rtmp-vr-l26.douyincdn.com.c.cdnhwc3.com,5,0.02%,11,6,45.45%
pull-hs-f5.flive.douyincdn.com.c.volcfcdndvs.com,5,0.02%,12,7,41.67%
pull-tsl-spe-l3.douyincdn.com.bytedns1.com,5,0.02%,11,6,45.45%
pull-rtmp-f11.douyincdn.com.tcdnlive.com,5,0.02%,12,7,41.67%
pull-tsl-spe-l6.douyincdn.com.hlsvcloud.ks-cdn.com,5,0.02%,12,7,41.67%
push-rtmp-hs-vr-f5.douyincdn.com.c.volcfcdndvs.com,5,0.02%,13,8,38.46%
pull-f3-hs.pstatp.com.w.alikunlun.net,5,0.02%,14,9,35.71%
push-rtmp-spe-l1.douyincdn.com.wsdvs.com,5,0.02%,14,9,35.71%
pull-hls-f5-tsl.douyincdn.com.w.cdngslb.com,5,0.02%,12,7,41.67%
s6120-ml.gslb.ksyuncdn.com,5,0.02%,12,7,41.67%
pull-lls-spe-l3.douyincdn.com.230b2a2545cfa773.queniucf.com,5,0.02%,11,6,45.45%
pull-flv-spe-l26.douyincdn.com.c.cdnhwc3.com,5,0.02%,12,7,41.67%
push-rtmp-l1-hs.pstatp.com.wsdvs.com,5,0.02%,13,8,38.46%
dl2.360safe.com,5,0.02%,12,7,41.67%
fc1tn.baidu.com,5,0.02%,15,10,33.33%
res.servicewechat.com,5,0.02%,12,7,41.67%
img9.doubanio.com,5,0.02%,10,5,50.00%
internal-api-space.feishu.cn,5,0.02%,10,5,50.00%
k128-inapp.gslb.ksyuncdn.com,5,0.02%,10,5,50.00%
boss.hdslb.com,5,0.02%,14,9,35.71%
path1.xtracloud.net,5,0.02%,10,5,50.00%
steam-chat.com,5,0.02%,9,4,55.56%
assets.msn.com.edgekey.net,5,0.02%,10,5,50.00%
e28578.d.akamaiedge.net,5,0.02%,10,5,50.00%
setup.fe.apple-dns.net,5,0.02%,11,6,45.45%
www.taobao.com.danuoyi.tbcache.com,5,0.02%,10,5,50.00%
feilian-staging.bytedance.com,5,0.02%,10,5,50.00%
vscode-sync-ase-01.azurewebsites.NET,5,0.02%,10,5,50.00%
v6-3.nigirocloud.com,5,0.02%,10,5,50.00%
bcedyrtmp.jomodns.com,5,0.02%,11,6,45.45%
hcdnl.push.gslb.c.cdnhwc2.com,5,0.02%,10,5,50.00%
webrtc.liveplay.myqcloud.com,5,0.02%,10,5,50.00%
jt.tlivepush3soct1douyin.tcdn.qq.com,5,0.02%,11,6,45.45%
push-fcdn-base.s.bytefcdn.com,5,0.02%,10,5,50.00%
play-dy.ulive.ugslb.com,5,0.02%,11,6,45.45%
cdn-file.ludashi.com.m.alikunlun.net,5,0.02%,10,5,50.00%
s1.cn.bing.net,5,0.02%,13,8,38.46%
ts2.cn.mm.bing.chinacache.net,5,0.02%,8,3,62.50%
ipv6.shuzilm.cn,5,0.02%,5,0,100.00%
ddplus.meituan.net,5,0.02%,12,7,41.67%
dl.delivery.mp.microsoft.com,5,0.02%,12,7,41.67%
s3.amazonaws.com,5,0.02%,10,5,50.00%
d2us8jqsezvhge.cloudfront.net,5,0.02%,5,0,100.00%
bsync3-normal-lf.zijieapi.com,5,0.02%,11,6,45.45%
help.origin-apple.com.akadns.net,5,0.02%,11,6,45.45%
ksn-file-geo.kaspersky-labs.com,5,0.02%,10,5,50.00%
east-asia.http.ipv6check.akadns.net,5,0.02%,5,0,100.00%
dl1.gj.qq.com,5,0.02%,7,2,71.43%
assets.msn.cn-c.edgekey.net.globalredir.akadns.net,5,0.02%,10,5,50.00%
e19240.ca.s.tl88.net,5,0.02%,10,5,50.00%
hudong.alicdn.com,5,0.02%,10,5,50.00%
socwxsns.video.qq.com,5,0.02%,10,5,50.00%
cf.iadsdk.apple.com,5,0.02%,10,5,50.00%
internal-api-lark-api.feishu.cn.dsa.dnsv1.com.cn,5,0.02%,8,3,62.50%
emdl.ws.microsoft.com,5,0.02%,10,5,50.00%
www.msftncsi.com,4,0.01%,661,657,0.61%
xp.itunes-apple.com.akadns.net,4,0.01%,10,6,40.00%
x.research.qq.com,4,0.01%,1223,1219,0.33%
static.mysmth.net.download.ks-cdn.com,4,0.01%,8,4,50.00%
e6603.g.akamaiedge.net,4,0.01%,8,4,50.00%
ocsp-lb.apple.com.akadns.net,4,0.01%,8,4,50.00%
hcdnl.pulldyin.hls.gslb.c.cdnhwc2.com,4,0.01%,8,4,50.00%
pull-rtmp-f13.douyincdn.com.a.bcelive.com,4,0.01%,8,4,50.00%
push-vol-base.s.volcfcdndvs.com,4,0.01%,8,4,50.00%
lcs-cops.adobe.io,4,0.01%,7,3,57.14%
smartdl.mbgcdn.lenovo.com.cn,4,0.01%,5,1,80.00%
clients2.google.com,4,0.01%,205,201,1.95%
internal-api.feishu.cn,4,0.01%,9,5,44.44%
login.live.com,4,0.01%,487,483,0.82%
f7.baidu.com,4,0.01%,10,6,40.00%
psstatic.cdn.bcebos.com,4,0.01%,6,2,66.67%
nv00.cdn.bcebos.com,4,0.01%,10,6,40.00%
vdse.bdstatic.com,4,0.01%,6,2,66.67%
mbdp02.bdstatic.com,4,0.01%,6,2,66.67%
wwc.alicdn.com,4,0.01%,12,8,33.33%
cs02-pps-drcn.dbankcdn.com,4,0.01%,8,4,50.00%
grs.platform.dbankcloud.ru,4,0.01%,8,4,50.00%
stats.g.doubleclick.net,4,0.01%,15,11,26.67%
img10.360buyimg.com,4,0.01%,9,5,44.44%
venus.douyucdn.cn,4,0.01%,8,4,50.00%
tnc3-aliec2.snssdk.com,4,0.01%,8,4,50.00%
api.m.jd.com,4,0.01%,9,5,44.44%
zmptxy.v.trpcdn.net,4,0.01%,8,4,50.00%
fc-ccimage.baidu.com,4,0.01%,12,8,33.33%
safebrowsing-re.aaplimg.com,4,0.01%,7,3,57.14%
s1.hdslb.com,4,0.01%,16,12,25.00%
ms.bdimg.com,4,0.01%,13,9,30.77%
updates.cdn-apple.com,4,0.01%,9,5,44.44%
bdimg.share.baidu.com,4,0.01%,8,4,50.00%
guide-acs.m.taobao.com,4,0.01%,8,4,50.00%
img.qwps.cn,4,0.01%,8,4,50.00%
sb-ssl.google.com,4,0.01%,8,4,50.00%
zttvad.v.bsgslb.com,4,0.01%,8,4,50.00%
v3-opensdkv.onewsvod.com,4,0.01%,8,4,50.00%
adl.windows.com,4,0.01%,8,4,50.00%
static-xl.a.88cdn.com,4,0.01%,10,6,40.00%
itunes-cdn.itunes-apple.com.akadns.net,4,0.01%,8,4,50.00%
se-edge.itunes-apple.com.akadns.net,4,0.01%,8,4,50.00%
amp-api-edge-lb-cn.itunes-apple.com.akadns.net,4,0.01%,8,4,50.00%
line1-log.biligame.net,4,0.01%,9,5,44.44%
cstaticdun.126.net,4,0.01%,9,5,44.44%
p0.qhimg.com.webcdn.360qhcdn.com,4,0.01%,8,4,50.00%
www3.l.google.com,4,0.01%,8,4,50.00%
account-public-service-prod.ak.epicgames.com,4,0.01%,8,4,50.00%
ak.epicgames.com.edgekey.net,4,0.01%,8,4,50.00%
e15203.dscb.akamaiedge.net,4,0.01%,8,4,50.00%
dcldshlupt.alicdn.com.danuoyi.tbcache.com,4,0.01%,8,4,50.00%
dailyupdate.wangwang.taobao.com,4,0.01%,8,4,50.00%
browser.360.cn.ucloud.com.cn,4,0.01%,8,4,50.00%
login.msa.msidentity.com,4,0.01%,10,6,40.00%
dotserver.douyucdn.cn,4,0.01%,10,6,40.00%
play-fe.googleapis.com,4,0.01%,9,5,44.44%
t8.dropbox.com,4,0.01%,8,4,50.00%
images.sohu.com,4,0.01%,8,4,50.00%
bd-origin.pull.yximgs.com,4,0.01%,8,4,50.00%
ws-origin.pull.yximgs.com,4,0.01%,9,5,44.44%
pull-fcdn-douyin-base.s.bytefcdn.com,4,0.01%,8,4,50.00%
pull-vol-base.s.volcfcdndvs.com,4,0.01%,8,4,50.00%
k5-toutiao-ipv6-ml.gslb.ksyuncdn.com,4,0.01%,8,4,50.00%
s03.gslb.ksyuncdn.com,4,0.01%,8,4,50.00%
pull-rtmp-l11.douyincdn.com.livecdn.liveplay.myqcloud.com,4,0.01%,8,4,50.00%
img0yjvjvvuvw.cdn.cache102.xyz,4,0.01%,8,4,50.00%
mqtt-web.zhihu.com.dsa.dnsv1.com,4,0.01%,4,0,100.00%
www.bit-hdtv.com,4,0.01%,30,26,13.33%
0.pool.ntp.org,4,0.01%,7,3,57.14%
kq438fobs8.feishu.cn,4,0.01%,6,2,66.67%
ldc-fast.mbgcdn.lenovo.com.cn,4,0.01%,6,2,66.67%
v1.douyinvod.com.wsdvs.com,4,0.01%,10,6,40.00%
img3.doubanio.com,4,0.01%,9,5,44.44%
apic.douyucdn.cn,4,0.01%,8,4,50.00%
dotcounter.douyucdn.cn,4,0.01%,8,4,50.00%
ocsp.globalsign.com,4,0.01%,9,5,44.44%
GOOGlE.coM,4,0.01%,5,1,80.00%
pull-rtmp-l13.douyincdn.com.a.bcelive.com,4,0.01%,8,4,50.00%
pull-hls-spe-l26.douyincdn.com.c.cdnhwc3.com,4,0.01%,10,6,40.00%
pull-flv-l26.douyincdn.com.c.cdnhwc3.com,4,0.01%,9,5,44.44%
pull-flv-l11.douyincdn.com.sched.l10.tdnsv5.com,4,0.01%,10,6,40.00%
pull-hs-f5-encryption.flive.douyincdn.com.c.volcfcdndvs.com,4,0.01%,11,7,36.36%
pull-rtmp-l29.douyincdn.com.ucloud.com.cn,4,0.01%,9,5,44.44%
pull-flv-l26-cny.douyincdn.com.c.cdnhwc3.com,4,0.01%,9,5,44.44%
push-rtmp-l29.douyincdn.com.ucloud.com.cn,4,0.01%,9,5,44.44%
push-rtmp-l11-encryption.douyincdn.com.tlivepush.com,4,0.01%,10,6,40.00%
pull-rtmp-f26.douyincdn.com.c.cdnhwc3.com,4,0.01%,10,6,40.00%
pull-hls-vr-l11.douyincdn.com.tlivecdn.com,4,0.01%,9,5,44.44%
crl.certum.pl,4,0.01%,9,5,44.44%
s.ssl.qhimg.com,4,0.01%,8,4,50.00%
updateleak.qihucdn.com,4,0.01%,10,6,40.00%
static.dataservices.hp.com,4,0.01%,8,4,50.00%
aop-pic-drcn.dbankcdn.com,4,0.01%,9,5,44.44%
picx.zhimg.com,4,0.01%,19,15,21.05%
static.yximgs.com,4,0.01%,9,5,44.44%
ali.pull.yximgs.com,4,0.01%,10,6,40.00%
ks-origin.pull.yximgs.com,4,0.01%,8,4,50.00%
tongji.flash.cn,4,0.01%,18,14,22.22%
upos-sz-staticcos-cmask.bilivideo.com,4,0.01%,12,8,33.33%
sslbaiduv6.jomodns.com,4,0.01%,8,4,50.00%
emres.dfcfw.com,4,0.01%,8,4,50.00%
d.adroll.com,4,0.01%,4,0,100.00%
cl3.apple.com,4,0.01%,9,5,44.44%
mam6.ntes53.netease.com,4,0.01%,4,0,100.00%
v6-be-pack.pglstatp-toutiao.com.download.ks-cdn.com,4,0.01%,8,4,50.00%
x8jlx54zyx.feishu.cn,4,0.01%,7,3,57.14%
v11.douyinvod.com,4,0.01%,9,5,44.44%
pic.cnblogs.com,4,0.01%,8,4,50.00%
zmptxy.v.trpcdn.NET,4,0.01%,8,4,50.00%
upload.jianshu.io,4,0.01%,10,6,40.00%
api.islide.cc,4,0.01%,7,3,57.14%
www.tm.a.prd.aadg.akadns.net,4,0.01%,8,4,50.00%
cdn.ark.qq.com,4,0.01%,7,3,57.14%
dl.pop.www.duba.net,4,0.01%,6,2,66.67%
appdl.lenovo.com.cn,4,0.01%,8,4,50.00%
gameplayapi.intel.com,4,0.01%,8,4,50.00%
15min.pcfg.cache.wpscdn.cn,4,0.01%,7,3,57.14%
e12437.d.akamaiedge.net,4,0.01%,8,4,50.00%
cl3-cdn.origin-apple.com.akadns.net,4,0.01%,8,4,50.00%
cdn.icloud-content.com,4,0.01%,8,4,50.00%
e11271.dscg.akamaiedge.net,4,0.01%,8,4,50.00%
scrootca2.ocsp.secomtrust.net,4,0.01%,8,4,50.00%
v6-4.nigirocloud.com,4,0.01%,4,0,100.00%
live.xhscdn.com,4,0.01%,9,5,44.44%
live-ali.xhscdn.com,4,0.01%,9,5,44.44%
33aef1e.ng.gladns.com,4,0.01%,8,4,50.00%
www.apple.com.edgekey.net.globalredir.akadns.net,4,0.01%,9,5,44.44%
hcdnv.zjv6.zjtd.c.cdnhwc2.com,4,0.01%,8,4,50.00%
pull-flv-vr-l6.douyincdn.com.hdlvcloud.ks-cdn.com,4,0.01%,8,4,50.00%
pull-fcdn-douyin-base3.s.bytefcdn.com,4,0.01%,8,4,50.00%
pull-vr-l3.douyincdn.com.230b2a2545cfa773.queniucf.com,4,0.01%,8,4,50.00%
pull-fcdn-douyin-base1.s.bytefcdn.com,4,0.01%,8,4,50.00%
push.ulive.ugslb.com,4,0.01%,10,6,40.00%
pull-rtmp-l1-cny.douyincdn.com.wsdvs.com,4,0.01%,8,4,50.00%
v1.douyinvod.com,4,0.01%,10,6,40.00%
cu004.www.duba.net,4,0.01%,8,4,50.00%
deff.nelreports.net,4,0.01%,11,7,36.36%
down.anticheatexpert.com,4,0.01%,9,5,44.44%
img.meituan.net,4,0.01%,16,12,25.00%
qcloud.dpfile.com,4,0.01%,9,5,44.44%
log-api.pangolin-sdk-toutiao-b.com,4,0.01%,8,4,50.00%
sslbaidu.jomodns.com,4,0.01%,8,4,50.00%
download.jetbrains.com.cn,4,0.01%,8,4,50.00%
msnzlxxglobal.v.lxcvc.com,4,0.01%,9,5,44.44%
layout.meituan.net,4,0.01%,8,4,50.00%
v5-colde.douyinvod.com,4,0.01%,10,6,40.00%
v5-j.douyinvod.com,4,0.01%,9,5,44.44%
p418.ssl.qhimgs4.com,4,0.01%,8,4,50.00%
p419.ssl.qhimgs4.com,4,0.01%,8,4,50.00%
p420.ssl.qhimgs4.com,4,0.01%,8,4,50.00%
m8.music.126.net.w.kunlungr.com,4,0.01%,7,3,57.14%
a1904.v.akamai.net,4,0.01%,8,4,50.00%
pgpstatic.games.wanmei.com.cdn.dnsv1.com,4,0.01%,8,4,50.00%
e4518.dscapi7.akamaiedge.net,4,0.01%,8,4,50.00%
v26-cold.douyinvod.com,4,0.01%,8,4,50.00%
conversions.appsflyer.com,4,0.01%,9,5,44.44%
ads3-normal-lf.zijieapi.com,4,0.01%,8,4,50.00%
file.drivergenius.com,4,0.01%,4,0,100.00%
priceengine-public-service-prod.ak.epicgames.com,4,0.01%,7,3,57.14%
helpx.adobe.com,4,0.01%,8,4,50.00%
cinema-pics-drcn.dbankcdn.com,4,0.01%,8,4,50.00%
gspe35-ssl.ls.apple.com.download.ks-cdn.com,4,0.01%,8,4,50.00%
i.glzip.com,4,0.01%,4,0,100.00%
www.nvidia.com,4,0.01%,10,6,40.00%
tracker.byr.pt,4,0.01%,4,0,100.00%
api.ghostery.net,4,0.01%,8,4,50.00%
cdn.ghostery.com,4,0.01%,8,4,50.00%
upload-cdn.orayimg.com,4,0.01%,8,4,50.00%
www.xunlei.com,4,0.01%,4,0,100.00%
prod-gateway.wdckeystone.com,4,0.01%,4,0,100.00%
tce.alicdn.com,4,0.01%,7,3,57.14%
p6-be-pack-sign.pglstatp-toutiao.com,4,0.01%,6,2,66.67%
valipl.cp31.ott.cibntv.net,4,0.01%,8,4,50.00%
dr-danmu.youku.com,4,0.01%,6,2,66.67%
s3plus-img.meituan.net,4,0.01%,4,0,100.00%
moiawsorigin.clo.footprintdns.com,4,0.01%,4,0,100.00%
wifi.weixin.qq.com,4,0.01%,4,0,100.00%
mon.zijieapi.com,3,0.01%,279,276,1.08%
v10.events.data.microsoft.com,3,0.01%,1312,1309,0.23%
odc-bl6pap004-meta-brs.onedrive.akadns.NET,3,0.01%,5,2,60.00%
pull-flv-f96.douyincdn.com.d.live.cdn.chinamobile.com,3,0.01%,7,4,42.86%
ocsp-cn-lb.apple.com.akadns.net,3,0.01%,6,3,50.00%
toutiao.rtmplive.ks-cdn.com,3,0.01%,6,3,50.00%
pull-hls-f11.douyincdn.com.sched.l8.tdnsv5.com,3,0.01%,6,3,50.00%
pcs-sdk-server.alibaba.com,3,0.01%,812,809,0.37%
switch.pcfg.cache.wpscdn.cn,3,0.01%,414,411,0.72%
dldir1.qq.com,3,0.01%,152,149,1.97%
qing.wps.cn,3,0.01%,201,198,1.49%
t-ruanjian.2345.cc,3,0.01%,8,5,37.50%
med-fe.cdn.bcebos.com,3,0.01%,6,3,50.00%
www.tmall.com,3,0.01%,8,5,37.50%
dldir1.qq.com.tcdn.qq.com,3,0.01%,21,18,14.29%
f12.baidu.com,3,0.01%,5,2,60.00%
mms-mis.cdn.bcebos.com,3,0.01%,4,1,75.00%
www.a.shifen.com,3,0.01%,67,64,4.48%
p4.a.yximgs.com,3,0.01%,8,5,37.50%
ebad288.nc.gladns.com,3,0.01%,7,4,42.86%
sls.update.microsoft.com,3,0.01%,36,33,8.33%
render.alipay.com,3,0.01%,7,4,42.86%
dm.video.weibocdn.com,3,0.01%,9,6,33.33%
vdata.amap.com,3,0.01%,7,4,42.86%
16.tlu.dl.delivery.mp.microsoft.com,3,0.01%,10,7,30.00%
img14.360buyimg.com,3,0.01%,8,5,37.50%
zz.bdstatic.com,3,0.01%,34,31,8.82%
a1961.g2.akamai.NET,3,0.01%,3,0,100.00%
cn-bing-com.cn.a-0001.a-msedge.NET,3,0.01%,5,2,60.00%
gss3.bdstatic.com,3,0.01%,7,4,42.86%
mms-static.cdn.bcebos.com,3,0.01%,7,4,42.86%
v11-cold1.douyinvod.com,3,0.01%,7,4,42.86%
e17437.dsct.akamaiedge.net,3,0.01%,6,3,50.00%
d2.a.kwimgs.com,3,0.01%,6,3,50.00%
d3.a.kwimgs.com,3,0.01%,6,3,50.00%
js2.a.kwimgs.com,3,0.01%,6,3,50.00%
tx-adaptive.pull.yximgs.com,3,0.01%,8,5,37.50%
ali-ad.a.yximgs.com,3,0.01%,8,5,37.50%
s2-10958.kwimgs.com,3,0.01%,6,3,50.00%
ali-p2p.pull.yximgs.com,3,0.01%,6,3,50.00%
txdwk.a.yximgs.com,3,0.01%,6,3,50.00%
p1.a.yximgs.com,3,0.01%,6,3,50.00%
tx.static.yximgs.com,3,0.01%,6,3,50.00%
captcha.gtimg.com,3,0.01%,8,5,37.50%
certs.apple.com,3,0.01%,8,5,37.50%
inappcheck.itunes.apple.com.w.alikunlun.com,3,0.01%,6,3,50.00%
shortv.cdp.qq.com,3,0.01%,6,3,50.00%
minipc.eastday.com,3,0.01%,7,4,42.86%
lqimg.dftoutiao.com,3,0.01%,6,3,50.00%
dfzximg02.dftoutiao.com,3,0.01%,7,4,42.86%
push.zhanzhang.baidu.com,3,0.01%,5,2,60.00%
acstatic-dun.126.net,3,0.01%,7,4,42.86%
prda.aadg.msidentity.com,3,0.01%,18,15,16.67%
pc-mon.snssdk.com.w.cdngslb.com,3,0.01%,6,3,50.00%
m801.music.126.net.163jiasu.com,3,0.01%,6,3,50.00%
p0.qhimg.com.qh-cdn.com,3,0.01%,6,3,50.00%
telemetry.dropbox.com,3,0.01%,6,3,50.00%
star.c10r.facebook.com,3,0.01%,6,3,50.00%
na61-na62.wagbridge.alibaba.alibaba.com,3,0.01%,27,24,11.11%
iduxzj9.qiniudns.com,3,0.01%,26,23,11.54%
b1.nel.goog,3,0.01%,6,3,50.00%
bl6pap004.storage.live.com,3,0.01%,26,23,11.54%
play-lh.googleusercontent.com,3,0.01%,7,4,42.86%
appdl-2-drcn.dbankcdn.com,3,0.01%,6,3,50.00%
dtapp-pub.dingtalk.com,3,0.01%,7,4,42.86%
static.youku.com,3,0.01%,6,3,50.00%
ali-proxy.pull.yximgs.com,3,0.01%,8,5,37.50%
ali-origin.pull.yximgs.com,3,0.01%,8,5,37.50%
ks-proxy.pull.yximgs.com,3,0.01%,8,5,37.50%
push-rtmp-l6.ixigua.com.upvcloud.ks-cdn.com,3,0.01%,6,3,50.00%
push-rtmp-l6.douyincdn.com.upvcloud.ks-cdn.com,3,0.01%,6,3,50.00%
7223175.l2.sched.dcloudlive.com,3,0.01%,6,3,50.00%
pull-fcdn-douyin-base2.s.bytefcdn.com,3,0.01%,6,3,50.00%
pull-f5-io.flive.douyincdn.com.c.bytefcdn.com,3,0.01%,6,3,50.00%
pull-flv-l13.douyincdn.com.a.bcelive.com,3,0.01%,7,4,42.86%
pull-rtmp-l11-cny.douyincdn.com.sched.l9.tdnsv5.com,3,0.01%,6,3,50.00%
yunlivepush.msf.tencent-cloud.com,3,0.01%,6,3,50.00%
pull-rtmp-l11.douyincdn.com.sched.l8.tdnsv5.com,3,0.01%,6,3,50.00%
monorepo-production-edge-alb-985829473.us-east-1.elb.amazonaws.com,3,0.01%,6,3,50.00%
yiyun.n.shifen.com,3,0.01%,49,46,6.12%
bl.client.cache.wpscdn.cn,3,0.01%,4,1,75.00%
1.pool.ntp.org,3,0.01%,5,2,60.00%
2.pool.ntp.org,3,0.01%,5,2,60.00%
3.pool.ntp.org,3,0.01%,5,2,60.00%
3.asia.pool.ntp.org,3,0.01%,5,2,60.00%
0.asia.pool.ntp.org,3,0.01%,5,2,60.00%
vdn.vzuu.com,3,0.01%,12,9,25.00%
gspe79-cn-ssl.ls.apple.com,3,0.01%,7,4,42.86%
wappass.bdimg.com,3,0.01%,5,2,60.00%
www.douyu.com,3,0.01%,6,3,50.00%
p3-sign.toutiaoimg.com,3,0.01%,6,3,50.00%
valipl10.cp31.ott.cibntv.net,3,0.01%,7,4,42.86%
smarthome-drcn.dbankcdn.com,3,0.01%,10,7,30.00%
push-rtmp-hs-spe-f5.douyincdn.com.c.volcfcdndvs.com,3,0.01%,10,7,30.00%
push-rtmp-f5.ihuoshanlive.com.c.volcfcdndvs.com,3,0.01%,9,6,33.33%
pull-flv-f13.douyincdn.com.a.bcelive.com,3,0.01%,7,4,42.86%
push-rtmp-l11.douyincdn.com.livepush.myqcloud.com,3,0.01%,7,4,42.86%
push-rtmp-l13.douyincdn.com.b.bcelive.com,3,0.01%,7,4,42.86%
pull-hls-f96.douyincdn.com.d.live.cdn.chinamobile.com,3,0.01%,7,4,42.86%
pull-flv-l29.douyincdn.com.ucloud.com.cn,3,0.01%,8,5,37.50%
push-rtmp-f5-enc.douyincdn.com.c.bytefcdn.com,3,0.01%,9,6,33.33%
pull-flv-f29.douyincdn.com.ucloud.com.cn,3,0.01%,8,5,37.50%
pull-hs-spe-f5.douyincdn.com.c.volcfcdndvs.com,3,0.01%,8,5,37.50%
s2.ssl.qhres2.com,3,0.01%,8,5,37.50%
jvod.300hu.com,3,0.01%,6,3,50.00%
v2.kwaicdn.com,3,0.01%,6,3,50.00%
sdkoptedge.chinanetcenter.com,3,0.01%,8,5,37.50%
ali-adaptive.pull.yximgs.com,3,0.01%,7,4,42.86%
bd-proxy.pull.yximgs.com,3,0.01%,8,5,37.50%
alicmmov.a.etoote.com,3,0.01%,6,3,50.00%
cmshow.gtimg.cn,3,0.01%,7,4,42.86%
prod-streaming-video-msn-com.akamaized.net,3,0.01%,6,3,50.00%
v3-cold2.douyinvod.com,3,0.01%,6,3,50.00%
sf3-cdn-tos.douyinstatic.com,3,0.01%,6,3,50.00%
gimg0.baidu.com,3,0.01%,6,3,50.00%
emcharts.eastmoney.com,3,0.01%,6,3,50.00%
emcharts.dftzj.com,3,0.01%,6,3,50.00%
s3gw.cmbimg.com,3,0.01%,6,3,50.00%
app.axure.cloud,3,0.01%,4,1,75.00%
baidubox-emoji.cdn.bcebos.com,3,0.01%,7,4,42.86%
v3-be-pack.pglstatp-toutiao.com,3,0.01%,6,3,50.00%
h5hosting.dbankcdn.com,3,0.01%,8,5,37.50%
optimus-ads.amap.com,3,0.01%,6,3,50.00%
hw.zuimeitianqi.com,3,0.01%,7,4,42.86%
cdn.jwplayer.com,3,0.01%,6,3,50.00%
tracker.pussytorrents.org,3,0.01%,8,5,37.50%
ykimg.alicdn.com,3,0.01%,6,3,50.00%
support.content.office.net,3,0.01%,7,4,42.86%
img-blog.csdn.net,3,0.01%,6,3,50.00%
hq.cjsc.com.cn,3,0.01%,3,0,100.00%
ocsp2.globalsign.com,3,0.01%,7,4,42.86%
p4.music.126.net.163jiasu.com,3,0.01%,6,3,50.00%
p3.music.126.net.163jiasu.com,3,0.01%,5,2,60.00%
img1.360buyimg.com,3,0.01%,6,3,50.00%
contentcenter-videovali-drcn.dbankcdn.cn,3,0.01%,6,3,50.00%
init.ess.apple.com,3,0.01%,6,3,50.00%
vasvip-pub.wpscdn.cn,3,0.01%,6,3,50.00%
e19240.ca.s.tl88.NET,3,0.01%,6,3,50.00%
a1091.dscb.akamai.net,3,0.01%,6,3,50.00%
beacons-handoff.gcp.gvt2.com,3,0.01%,6,3,50.00%
gce-beacons.gcp.gvt2.com,3,0.01%,6,3,50.00%
cname.api.origin.com,3,0.01%,6,3,50.00%
e4894.g.akamaiedge.net,3,0.01%,6,3,50.00%
pancake-cn.cdn-apple.com.akadns.net,3,0.01%,6,3,50.00%
c.apple.news.edgekey.net,3,0.01%,6,3,50.00%
htydhd.wmupd.com,3,0.01%,6,3,50.00%
htydhd.wmupd.com.w.kunluncan.com,3,0.01%,6,3,50.00%
dl-debug.dropbox.com,3,0.01%,6,3,50.00%
detectportal.prod.mozaws.NET,3,0.01%,6,3,50.00%
pull-flv-f11-proxy.douyincdn.com.sched.l8.tdnsv5.com,3,0.01%,6,3,50.00%
pull-rtmp-l6.douyincdn.com.rtmpvcloud.ks-cdn.com,3,0.01%,6,3,50.00%
pull-flv-f6-hs.pstatp.com.hdlvcloud.ks-cdn.com,3,0.01%,6,3,50.00%
pull-hls-hs-f5-tsl.douyincdn.com.w.cdngslb.com,3,0.01%,6,3,50.00%
pull-flv-l11-encryption.douyincdn.com.sched.l9.tdnsv5.com,3,0.01%,6,3,50.00%
pull-rtmp-f6-hs.pstatp.com.rtmpvcloud.ks-cdn.com,3,0.01%,6,3,50.00%
mt.lenovo.com.cn,3,0.01%,6,3,50.00%
toutiao.uplive.ks-cdn.com,3,0.01%,6,3,50.00%
hcdnl.pulldyin.gslb.c.cdnhwc2.com,3,0.01%,6,3,50.00%
pull-rtmp-l6-source.douyincdn.com.rtmpvcloud.ks-cdn.com,3,0.01%,6,3,50.00%
tlivepush3soct1douyin.tcdn.qq.com,3,0.01%,6,3,50.00%
pull-tsl-vr-l11.douyincdn.com.cdn.dnsv1.com,3,0.01%,6,3,50.00%
pull-f5-vs.flive.douyincdn.com.c.bytefcdn.com,3,0.01%,6,3,50.00%
hcdnl.pulldyin.f26.gslb.c.cdnhwc2.com,3,0.01%,6,3,50.00%
pull-rtmp-f6.douyincdn.com.rtmpvcloud.ks-cdn.com,3,0.01%,6,3,50.00%
pull-flv-spe-l11.douyincdn.com.tlivecdn.com,3,0.01%,6,3,50.00%
k5-toutiao-ml.gslb.ksyuncdn.com,3,0.01%,6,3,50.00%
pull-hls-f5-enc.flive.douyincdn.com.w.kunluncan.com,3,0.01%,6,3,50.00%
bcedyhls.jomodns.com,3,0.01%,6,3,50.00%
pull-tsl-spe-l3.douyincdn.com.230b2a2545cfa773.queniubg.com,3,0.01%,6,3,50.00%
pull-tsl-l11.douyincdn.com.cdn.dnsv1.com,3,0.01%,6,3,50.00%
pull-rtmp-f11.douyincdn.com.sched.l8.tdnsv5.com,3,0.01%,6,3,50.00%
pull-lls-f5.flive.douyincdn.com.c.bytefcdn.com,3,0.01%,6,3,50.00%
pull-fcdn-rts.s.bytefcdn.com,3,0.01%,6,3,50.00%
pull-tsl-vr-l3.douyincdn.com.230b2a2545cfa773.queniubg.com,3,0.01%,6,3,50.00%
pull-fcdn-mptcpdouyin.s.bytefcdn.com,3,0.01%,6,3,50.00%
pull-flv-l11-cny.douyincdn.com.sched.l9-dk.tdnsv5.com,3,0.01%,6,3,50.00%
pull-rtmp-l6.ixigua.com.rtmpvcloud.ks-cdn.com,3,0.01%,6,3,50.00%
pull-f5-hs.flive.pstatp.com.c.bytefcdn.com,3,0.01%,6,3,50.00%
pull-fcdn-huoshan-base.s.bytefcdn.com,3,0.01%,6,3,50.00%
pull-flv-l6.ixigua.com.hdlvcloud.ks-cdn.com,3,0.01%,6,3,50.00%
pull-hls-vr-l11.douyincdn.com.sched.l9.tdnsv5.com,3,0.01%,6,3,50.00%
pull-f5-hot.flive.douyincdn.com.c.bytefcdn.com,3,0.01%,6,3,50.00%
pull-fcdn-base.s.bytefcdn.com,3,0.01%,6,3,50.00%
pull-flv-vr-l11.douyincdn.com.sched.l9.tdnsv5.com,3,0.01%,6,3,50.00%
desktop.docker.com,3,0.01%,6,3,50.00%
v11.douyinvod.com.cdn.dnsv1.com,3,0.01%,6,3,50.00%
v11.sched.v4lego-dk.tdnsvod1.cn,3,0.01%,6,3,50.00%
lf3-config.bytetcc.com,3,0.01%,6,3,50.00%
smp-device-content.lb-apple.com.akadns.net,3,0.01%,6,3,50.00%
smp-device-content-cn.lb-apple.com.akadns.net,3,0.01%,6,3,50.00%
chinaweb292.china.line.qiniudns.com,3,0.01%,6,3,50.00%
v3-cold4.douyinvod.com,3,0.01%,6,3,50.00%
line3-h5-mobile-api.biligame.com,3,0.01%,8,5,37.50%
show.bilibili.com,3,0.01%,8,5,37.50%
sns-video-bd.xhscdn.com,3,0.01%,6,3,50.00%
baichuan-sdk.alicdn.com,3,0.01%,6,3,50.00%
mrn.meituan.net,3,0.01%,5,2,60.00%
dev,3,0.01%,3,0,100.00%
p7.itc.cn,3,0.01%,7,4,42.86%
opencdnbd.jomodns.com,3,0.01%,6,3,50.00%
static.hdslb.com,3,0.01%,9,6,33.33%
qzonestyle.gtimg.cn,3,0.01%,4,1,75.00%
pingjs.qq.com,3,0.01%,4,1,75.00%
v.qq.com,3,0.01%,4,1,75.00%
i0.hdslb.com.w.kunlunno.com,3,0.01%,6,3,50.00%
v3-default.365yg.com,3,0.01%,9,6,33.33%
v6-default.365yg.com,3,0.01%,7,4,42.86%
apd-af717b152965a30ab140455f8a8f6e67d6420ff9a7f7b03b.v.smtcdns.com,3,0.01%,3,0,100.00%
down4.7654.com,3,0.01%,6,3,50.00%
c.disquscdn.com,3,0.01%,4,1,75.00%
s0.meituan.net,3,0.01%,6,3,50.00%
m804.music.126.net,3,0.01%,6,3,50.00%
s.bdstatic.com,3,0.01%,6,3,50.00%
gdown.baidu.com,3,0.01%,6,3,50.00%
path3.xtracloud.net,3,0.01%,6,3,50.00%
path2.xtracloud.net,3,0.01%,6,3,50.00%
feed-image.baidu.com,3,0.01%,7,4,42.86%
api-access.pangolin-sdk-toutiao.com.w.cdngslb.com,3,0.01%,6,3,50.00%
toblog.ctobsnssdk.com.w.cdngslb.com,3,0.01%,6,3,50.00%
liveupdate7.drivergenius.com,3,0.01%,3,0,100.00%
steamcdn-a.akamaihd.net.edgesuite.net,3,0.01%,6,3,50.00%
s.safe.360.cn.qh-cdn.com,3,0.01%,6,3,50.00%
list3.ppstream.com.iqiyi.com,3,0.01%,6,3,50.00%
ts1.cn.mm.bing.chinacache.net,3,0.01%,6,3,50.00%
ts1.cn.mm.bing.net.lxcvc.com,3,0.01%,6,3,50.00%
ts2.cn.mm.bing.net.lxcvc.com,3,0.01%,6,3,50.00%
launcher-public-service-prod.ak.epicgames.com,3,0.01%,6,3,50.00%
e11.dsca.akamaiedge.net,3,0.01%,6,3,50.00%
web.sdk.qcloud.com,3,0.01%,7,4,42.86%
gOOgLe.coM,3,0.01%,3,0,100.00%
goOGLE.CoM,3,0.01%,3,0,100.00%
gooGLe.com,3,0.01%,3,0,100.00%
GoogLe.COm,3,0.01%,3,0,100.00%
gOOGlE.CoM,3,0.01%,3,0,100.00%
GOoglE.cOM,3,0.01%,3,0,100.00%
GOoglE.COM,3,0.01%,3,0,100.00%
GOoGle.coM,3,0.01%,3,0,100.00%
33aef1e.nb.gladns.com,3,0.01%,6,3,50.00%
eqdwjv3myb.feishu.cn,3,0.01%,3,0,100.00%
res-scanner.zhhainiao.com,3,0.01%,6,3,50.00%
s.pc.qq.com,3,0.01%,6,3,50.00%
jp04-vm0.entry.srthdw.art,3,0.01%,6,3,50.00%
lf3-orange.byteorge.com,3,0.01%,6,3,50.00%
mt.mbgcdn.lenovo.com.cn,3,0.01%,6,3,50.00%
u996.v.trpcdn.net,3,0.01%,6,3,50.00%
tnc3-bjlgy.zijieapi.com,3,0.01%,6,3,50.00%
sx-common-v4.volcgtm.com,3,0.01%,6,3,50.00%
cdn.wwads.cn,3,0.01%,9,6,33.33%
v3-cold.douyinvod.com,3,0.01%,6,3,50.00%
img0.baidu.com,3,0.01%,6,3,50.00%
img1.baidu.com,3,0.01%,6,3,50.00%
api3-normal-lf.fqnovel.com,3,0.01%,6,3,50.00%
dss2.bdstatic.com,3,0.01%,6,3,50.00%
adsmind.ugdtimg.com,3,0.01%,9,6,33.33%
d23iz4esrwkib6.cloudfront.net,3,0.01%,6,3,50.00%
crl.apple.com,3,0.01%,5,2,60.00%
d2lfklupjnai2b.cloudfront.cn,3,0.01%,6,3,50.00%
usage.projectcalico.org,3,0.01%,5,2,60.00%
public-cdn.cloud.unitychina.cn,3,0.01%,6,3,50.00%
rsg461l4.sched.d0.tdnsdp1.cn,3,0.01%,4,1,75.00%
fsigns.duba.net.scc.topgslb.com,3,0.01%,4,1,75.00%
GOoglE.coM,3,0.01%,3,0,100.00%
GOogle.COm,3,0.01%,3,0,100.00%
s3plus.meituan.net,3,0.01%,6,3,50.00%
s3.ssl.qhres2.com,3,0.01%,6,3,50.00%
hwucdn-drcn.dbankcdn.com,3,0.01%,3,0,100.00%
api3-eeft-imfile-lf.feishu.cn,3,0.01%,6,3,50.00%
addons-pa.clients6.google.com,3,0.01%,6,3,50.00%
discovery-v6-4.syncthing.net,3,0.01%,3,0,100.00%
erickson514-my.sharepoint.com,3,0.01%,6,3,50.00%
valipl-a10.cp31.ott.cibntv.net,3,0.01%,6,3,50.00%
appdl6-drcn.dbankcdn.cn,3,0.01%,6,3,50.00%
detectportal.prod.mozaws.net,2,0.01%,438,436,0.46%
init-p01st.push.apple.com,2,0.01%,4,2,50.00%
init-p01st-lb.push-apple.com.akadns.net,2,0.01%,4,2,50.00%
substrate.office.com,2,0.01%,109,107,1.83%
teredo.ipv6.microsoft.com,2,0.01%,2735,2733,0.07%
wu-fg-shim.trafficmanager.net,2,0.01%,4,2,50.00%
pc-mon.snssdk.com,2,0.01%,4,2,50.00%
oth.eve.mdt.qq.com,2,0.01%,476,474,0.42%
v6-gray.toutiaovod.com,2,0.01%,4,2,50.00%
drive.wps.cn,2,0.01%,187,185,1.07%
self.events.data.microsoft.com,2,0.01%,908,906,0.22%
cl.vd.f.360.cn,2,0.01%,174,172,1.15%
vortex.data.microsoft.com,2,0.01%,321,319,0.62%
cdn-ali-file-shc.shanhutech.cn,2,0.01%,4,2,50.00%
bt1.archive.org,2,0.01%,4,2,50.00%
www.msftconnecttest.com,2,0.01%,259,257,0.77%
n6750286mz.feishu.cn,2,0.01%,4,2,50.00%
download.tplinkcloud.com.cn,2,0.01%,2,0,100.00%
zhuanjia.cdn.bcebos.com,2,0.01%,5,3,40.00%
medical-cms.cdn.bcebos.com,2,0.01%,3,1,66.67%
medical-kg.cdn.bcebos.com,2,0.01%,3,1,66.67%
wx.qlogo.cn,2,0.01%,531,529,0.38%
visualstudio-devdiv-c2s.msedge.net,2,0.01%,54,52,3.70%
cdn.syndication.twimg.com,2,0.01%,4,2,50.00%
pull-f5.flive.douyincdn.com,2,0.01%,33,31,6.06%
pms-cdn.bdstatic.com,2,0.01%,3,1,66.67%
feedquic.jomodns.com,2,0.01%,2,0,100.00%
mmbiz.qpic.cn,2,0.01%,195,193,1.03%
wdl1.cache.wps.cn,2,0.01%,134,132,1.49%
livewebbs2.msstatic.com,2,0.01%,9,7,22.22%
cdn.wup.huya.com,2,0.01%,5,3,40.00%
otheve.beacon.qq.com,2,0.01%,62,60,3.23%
tfs.alipayobjects.com,2,0.01%,5,3,40.00%
browserr-drcn.dbankcdn.cn,2,0.01%,4,2,50.00%
contentcenter-drcn.dbankcdn.cn,2,0.01%,4,2,50.00%
down.qq.com,2,0.01%,11,9,18.18%
x1.c.lencr.org,2,0.01%,301,299,0.66%
apd-vodp2plogin.teg.tencent-cloud.net,2,0.01%,5,3,40.00%
pki-goog.l.google.com,2,0.01%,5,3,40.00%
img30.360buyimg.com,2,0.01%,5,3,40.00%
maponline3.bdimg.com,2,0.01%,5,3,40.00%
misc.360buyimg.com,2,0.01%,7,5,28.57%
img11.360buyimg.com,2,0.01%,5,3,40.00%
apidata.googleusercontent.com,2,0.01%,5,3,40.00%
m.toutiao.com,2,0.01%,4,2,50.00%
ms-ceintl.gallerycdn.azure.cn,2,0.01%,4,2,50.00%
inappcheck-cn.itunes-apple.com.akadns.net,2,0.01%,8,6,25.00%
m15.360buyimg.com,2,0.01%,4,2,50.00%
sensors.ibreader.com,2,0.01%,6,4,33.33%
selfpage-gips.cdn.bcebos.com,2,0.01%,6,4,33.33%
p3-shortvideo-sign.toutiaoimg.com,2,0.01%,4,2,50.00%
p6-shortvideo-sign.toutiaoimg.com,2,0.01%,4,2,50.00%
wxa.wxs.qq.com,2,0.01%,5,3,40.00%
token.safebrowsing.apple,2,0.01%,3,1,66.67%
wxsnsdy.wxs.qq.com,2,0.01%,5,3,40.00%
www.12377.cn,2,0.01%,6,4,33.33%
v1.oskwai.com,2,0.01%,5,3,40.00%
p4-live.a.yximgs.com,2,0.01%,5,3,40.00%
txdwkmov.a.kwimgs.com,2,0.01%,5,3,40.00%
txdwkmov.a.yximgs.com,2,0.01%,5,3,40.00%
jsqcmmov.a.etoote.com,2,0.01%,5,3,40.00%
ali2-course.video.yximgs.com,2,0.01%,5,3,40.00%
alicmvod.a.etoote.com,2,0.01%,5,3,40.00%
d2-magic.static.yximgs.com,2,0.01%,5,3,40.00%
d3-magic.static.yximgs.com,2,0.01%,5,3,40.00%
p2.eckwai.com,2,0.01%,5,3,40.00%
p2.adkwai.com,2,0.01%,6,4,33.33%
v2-mg07.kwaicdn.com,2,0.01%,5,3,40.00%
tx6.a.kwimgs.com,2,0.01%,5,3,40.00%
tx2.a.kwimgs.com,2,0.01%,4,2,50.00%
txqcmmov.a.etoote.com,2,0.01%,6,4,33.33%
d3-kkd.a.kspkg.com,2,0.01%,4,2,50.00%
p1-live.a.yximgs.com,2,0.01%,4,2,50.00%
d3-reco.a.kwimgs.com,2,0.01%,5,3,40.00%
v3-vod.kwaicdn.com,2,0.01%,4,2,50.00%
v5-skvod.kwaicdn.com,2,0.01%,4,2,50.00%
txcmvod.a.etoote.com,2,0.01%,5,3,40.00%
d1-push.static.yximgs.com,2,0.01%,5,3,40.00%
d1-kkd.a.kspkg.com,2,0.01%,5,3,40.00%
d1-ks.a.kwimgs.com,2,0.01%,5,3,40.00%
tx-p2p.pull.yximgs.com,2,0.01%,4,2,50.00%
cfg-2.pddpic.com,2,0.01%,4,2,50.00%
dl.static.iqiyi.com,2,0.01%,5,3,40.00%
a2047.dscb.akamai.net,2,0.01%,4,2,50.00%
publicassets.cdn-apple.com,2,0.01%,4,2,50.00%
vm.gtimg.cn,2,0.01%,55,53,3.64%
s0-img.huxiucdn.com,2,0.01%,4,2,50.00%
static.huxiucdn.com,2,0.01%,4,2,50.00%
img.huxiucdn.com,2,0.01%,4,2,50.00%
s1-static.huxiucdn.com,2,0.01%,4,2,50.00%
isee.weishi.qq.com,2,0.01%,4,2,50.00%
fc3tn.baidu.com,2,0.01%,5,3,40.00%
aliimg.a.yximgs.com,2,0.01%,5,3,40.00%
t1.dynamic.tiles.ditu.live.com,2,0.01%,5,3,40.00%
tips-p01-drcn.dbankcdn.com,2,0.01%,4,2,50.00%
err.taobao.com,2,0.01%,5,3,40.00%
error.taobao.com,2,0.01%,5,3,40.00%
t.khd.2345.cc,2,0.01%,201,199,1.00%
v27-a.douyinvod.com,2,0.01%,4,2,50.00%
v6-cold.douyinvod.com,2,0.01%,4,2,50.00%
www.gsd92gov.com,2,0.01%,16,14,12.50%
id.razer.com,2,0.01%,4,2,50.00%
l-ring.msedge.net,2,0.01%,12,10,16.67%
apd-bf858887be56629f5e8387983960b23dd6420ff9a7f7b03b.v.smtcdns.com,2,0.01%,2,0,100.00%
voipfinderliveplay.wxqcloud.qq.com,2,0.01%,4,2,50.00%
autopush.prod.mozaws.net,2,0.01%,4,2,50.00%
static.firefoxchina.cn,2,0.01%,4,2,50.00%
img.yiqikan8.com,2,0.01%,4,2,50.00%
0i4k7t9l.sched.sma-dk.tdnsstic1.cn,2,0.01%,5,3,40.00%
hcdnw101.gslb.c.cdnhwc2.com,2,0.01%,4,2,50.00%
eo91y88m.sched.sma.tdnsstic1.cn,2,0.01%,4,2,50.00%
hp.sched.legohp-dk.tdnsstic1.cn,2,0.01%,4,2,50.00%
download.game.yy.com,2,0.01%,5,3,40.00%
wprd03.is.autonavi.com,2,0.01%,4,2,50.00%
wprd02.is.autonavi.com,2,0.01%,4,2,50.00%
wprd01.is.autonavi.com,2,0.01%,4,2,50.00%
wprd04.is.autonavi.com,2,0.01%,4,2,50.00%
apd-6dc2592165268630e5e81885b161ea9094fb91d1cf4b7b4b.v.smtcdns.com,2,0.01%,2,0,100.00%
download.amd.com,2,0.01%,6,4,33.33%
3wabxy9b.sched.sma.tdnsstic1.cn,2,0.01%,5,3,40.00%
jkbxcx-static.yqgz.beijing.gov.cn,2,0.01%,3,1,66.67%
apd-7a3c059307d194c1953157782742893b1193182453d495c0.v.smtcdns.com,2,0.01%,2,0,100.00%
www-cdn.icloud.com.akadns.net,2,0.01%,30,28,6.67%
m.taobao.com,2,0.01%,4,2,50.00%
connector04.soc.wlaq.qianxin-inc.cn,2,0.01%,2,0,100.00%
fs-im-kefu.7moor.com,2,0.01%,4,2,50.00%
p1.adkwai.com,2,0.01%,5,3,40.00%
tx2.a.yximgs.com,2,0.01%,5,3,40.00%
steamstore-a.akamaihd.net.edgesuite.net,2,0.01%,4,2,50.00%
ags.privatelink.msidentity.com,2,0.01%,8,6,25.00%
m801.music.126.net.w.alikunlun.com,2,0.01%,4,2,50.00%
upload-oss.vzuu.com.w.kunlungr.com,2,0.01%,4,2,50.00%
odc-bl6pap004-meta-geo.onedrive.akadns.NET,2,0.01%,3,1,66.67%
iosapps-cn-lb.dl-apple.com.akadns.net,2,0.01%,4,2,50.00%
tx-proxy.pull.yximgs.com,2,0.01%,6,4,33.33%
cma.itunes.apple.com,2,0.01%,6,4,33.33%
app-site-association-cn-lb.cdn-apple.com.akadns.net,2,0.01%,4,2,50.00%
finder.video.qq.com,2,0.01%,6,4,33.33%
mcs.zijieapi.com,2,0.01%,4,2,50.00%
ks-adaptive.pull.yximgs.com,2,0.01%,6,4,33.33%
ks-livemate.pull.yximgs.com,2,0.01%,5,3,40.00%
downloads.upd.kaspersky.com,2,0.01%,4,2,50.00%
abmail.mail.hbo.com,2,0.01%,4,2,50.00%
mixv4-2.194610.xyz,2,0.01%,10,8,20.00%
download.iciba.com,2,0.01%,4,2,50.00%
ts2.cn.mm.bing.chinacache.NET,2,0.01%,2,0,100.00%
ts1.cn.mm.bing.chinacache.NET,2,0.01%,2,0,100.00%
cds.apple.com,2,0.01%,4,2,50.00%
ri94q1vx0c.feishu.cn,2,0.01%,2,0,100.00%
ztxdjj-my.sharepoint.com,2,0.01%,8,6,25.00%
bl.client.cache.wpscdn.cn.qiniudns.com,2,0.01%,2,0,100.00%
iduy64c.qiniudns.com,2,0.01%,2,0,100.00%
frontier-im.douyin.com,2,0.01%,4,2,50.00%
nsl.mbgcdn.lenovo.com.cn,2,0.01%,6,4,33.33%
f.c2r.ts.cdn.office.net,2,0.01%,7,5,28.57%
api2.amplitude.com,2,0.01%,8,6,25.00%
edge.api.myqnapcloud.cn,2,0.01%,6,4,33.33%
staticsns.cdn.bcebos.com,2,0.01%,3,1,66.67%
webconf.douyucdn.cn,2,0.01%,4,2,50.00%
apiv2.douyucdn.cn,2,0.01%,4,2,50.00%
capi.douyucdn.cn,2,0.01%,4,2,50.00%
gift.douyucdn.cn,2,0.01%,5,3,40.00%
mapm.douyucdn.cn,2,0.01%,4,2,50.00%
gfs-op.douyucdn.cn,2,0.01%,4,2,50.00%
apm.douyucdn.cn,2,0.01%,4,2,50.00%
rtbapi.douyucdn.cn,2,0.01%,4,2,50.00%
sta-op.douyucdn.cn,2,0.01%,4,2,50.00%
tx.liveplay.live.kugou.com,2,0.01%,4,2,50.00%
static.leetcode.cn,2,0.01%,4,2,50.00%
tx100.liveplay.live.kugou.com,2,0.01%,4,2,50.00%
aliyun4.liveplay.live.kugou.com,2,0.01%,4,2,50.00%
aliyun3.liveplay.live.kugou.com,2,0.01%,4,2,50.00%
aliyun.liveplay.live.kugou.com,2,0.01%,4,2,50.00%
lx.meituan.net,2,0.01%,4,2,50.00%
a1931.dscgi3.akamai.net,2,0.01%,4,2,50.00%
wvcfg.alicdn.com,2,0.01%,6,4,33.33%
mobile-gtalk.l.google.com,2,0.01%,6,4,33.33%
is5-ssl.mzstatic.com,2,0.01%,3,1,66.67%
v5-i.douyinvod.com.zjgslb.com,2,0.01%,4,2,50.00%
line3-realtime-api.biligame.net,2,0.01%,5,3,40.00%
line1-log.biligame.net.w.cdngslb.com,2,0.01%,4,2,50.00%
apd-vlive.apdcdn.tc.qq.com,2,0.01%,4,2,50.00%
storefs1.heytapdownload.com,2,0.01%,4,2,50.00%
alimov6.a.yximgs.com,2,0.01%,4,2,50.00%
alimov2.a.yximgs.com,2,0.01%,6,4,33.33%
txmov2.a.yximgs.com,2,0.01%,4,2,50.00%
tx-game.pull.yximgs.com,2,0.01%,6,4,33.33%
bd-adaptive.pull.yximgs.com,2,0.01%,7,5,28.57%
ali2.a.kwimgs.com,2,0.01%,4,2,50.00%
p3.eckwai.com,2,0.01%,4,2,50.00%
p3.adkwai.com,2,0.01%,4,2,50.00%
fanyi-cdn.cdn.bcebos.com,2,0.01%,5,3,40.00%
v5-coldc.douyinvod.com,2,0.01%,5,3,40.00%
t5.a.market.xiaomi.com,2,0.01%,4,2,50.00%
gameplus-platform.cdn.bcebos.com,2,0.01%,4,2,50.00%
gp-dev.cdn.bcebos.com,2,0.01%,4,2,50.00%
t13.baidu.com.a.bdydns.com,2,0.01%,4,2,50.00%
t14.baidu.com.a.bdydns.com,2,0.01%,4,2,50.00%
t8.baidu.com.a.bdydns.com,2,0.01%,4,2,50.00%
t7.baidu.com.a.bdydns.com,2,0.01%,4,2,50.00%
hectorstatic.baidu.com.a.bdydns.com,2,0.01%,4,2,50.00%
bcstobos.jomodns.com,2,0.01%,4,2,50.00%
mbdp01.bdstatic.com,2,0.01%,5,3,40.00%
emcharts.dfcfw.com,2,0.01%,6,4,33.33%
appinfocdn.cmbimg.com,2,0.01%,4,2,50.00%
cdn.orayimg.com,2,0.01%,5,3,40.00%
nv1.baidupcs.com,2,0.01%,4,2,50.00%
img1.pcfg.cache.wpscdn.cn,2,0.01%,5,3,40.00%
api-game.flash.cn,2,0.01%,4,2,50.00%
apd-2ff18d8c533b6c71309e9b084360f9ee2daa5b201ce1a95b.v.smtcdns.com,2,0.01%,2,0,100.00%
apd-bf4bf622660164946c9b3d949a013ccc6751373c355ddeac.v.smtcdns.com,2,0.01%,2,0,100.00%
apifc.flash.cn,2,0.01%,4,2,50.00%
apifcv2.flash.cn,2,0.01%,4,2,50.00%
v26.douyinvod.com,2,0.01%,4,2,50.00%
apd-05ace3e5be3ccfeb4cd6c4b264d896b1b4d7c42810ee4d50.v.smtcdns.com,2,0.01%,2,0,100.00%
apd-f54a02b4deb41d61066bebac717aaa296872e03e66079304.v.smtcdns.com,2,0.01%,2,0,100.00%
c.s.360.cn,2,0.01%,5,3,40.00%
desktop.postman.com,2,0.01%,4,2,50.00%
ipv6.torrent.centos.org,2,0.01%,2,0,100.00%
static.cnblogs.com,2,0.01%,4,2,50.00%
img2020.cnblogs.com,2,0.01%,4,2,50.00%
apd-126387a827c29b32acbd735ba8c082df93686f8d74a07da2.v.smtcdns.com,2,0.01%,2,0,100.00%
api.weather.com,2,0.01%,4,2,50.00%
sdk-static.mihoyo.com,2,0.01%,4,2,50.00%
api-static.mihoyo.com,2,0.01%,4,2,50.00%
ys.mihoyo.com,2,0.01%,4,2,50.00%
apd-d8e293bbd0ec700474ea78f11975a93435add3499c7989b7.v.smtcdns.com,2,0.01%,2,0,100.00%
appoptimize-drcn.dbankcdn.com,2,0.01%,2,0,100.00%
wework.qpic.cn,2,0.01%,4,2,50.00%
apd-8b1cfd726ba9ef1a0fcbd0cf7f43d30b1e573b1aeeb564ce.v.smtcdns.com,2,0.01%,2,0,100.00%
upload-images.jianshu.io,2,0.01%,5,3,40.00%
fp-as.azureedge.net,2,0.01%,5,3,40.00%
t-ring.msedge.net,2,0.01%,12,10,16.67%
firefox-settings-attachments.cdn.mozilla.net,2,0.01%,5,3,40.00%
connector07.soc.wlaq.qianxin-inc.cn,2,0.01%,2,0,100.00%
updatecdn.meeting.qq.com,2,0.01%,4,2,50.00%
cdn.meeting.tencent.com,2,0.01%,4,2,50.00%
oth.str.beacon.qq.com,2,0.01%,6,4,33.33%
s3a.pstatp.com,2,0.01%,7,5,28.57%
connector09.soc.wlaq.qianxin-inc.cn,2,0.01%,2,0,100.00%
connector05.soc.wlaq.qianxin-inc.cn,2,0.01%,2,0,100.00%
tnc11-alisc1.zijieapi.com,2,0.01%,4,2,50.00%
api5-normal-lf.toutiaoapi.com,2,0.01%,4,2,50.00%
cdn.cnbj1.fds.api.mi-img.com,2,0.01%,5,3,40.00%
storeedgefd.dsx.mp.microsoft.com,2,0.01%,4,2,50.00%
cxcs.microsoft.net,2,0.01%,5,3,40.00%
wxsnsdythumb.wxs.qq.com,2,0.01%,4,2,50.00%
edu-wenku.bdimg.com,2,0.01%,4,2,50.00%
wkbjcloudbos.bdimg.com,2,0.01%,4,2,50.00%
emres.eastmoney.com,2,0.01%,4,2,50.00%
cmsjs.eastmoney.com,2,0.01%,4,2,50.00%
datacenter-web.eastmoney.com,2,0.01%,4,2,50.00%
ocsp.dcocsp.cn,2,0.01%,4,2,50.00%
download.zotero.org,2,0.01%,6,4,33.33%
beacons5.gvt3.com,2,0.01%,6,4,33.33%
rc10-g6.oray.com,2,0.01%,4,2,50.00%
crl.pki.goog,2,0.01%,4,2,50.00%
tj.wifi.liebao.cn,2,0.01%,4,2,50.00%
img1.pcfg.cache.wps.cn,2,0.01%,4,2,50.00%
img1.pcfg.cache.wps.cn.cdn.dnsv1.com,2,0.01%,4,2,50.00%
3scpuqeq.sched.sma.tdnsstic1.cn,2,0.01%,4,2,50.00%
qt001.china.line.qiniudns.com,2,0.01%,4,2,50.00%
sjy.stream.qqmusic.qq.com.ctdns.cn,2,0.01%,16,14,12.50%
sjy6.stream.qqmusic.qq.com.cc0a7686.c.cdnhwc1.com,2,0.01%,4,2,50.00%
hcdnv.qqv6.music.c.cdnhwc2.com,2,0.01%,4,2,50.00%
adblock-yuanqicleaner-cdn.yuanqidesk.com,2,0.01%,4,2,50.00%
k128.gslb.ksyuncdn.com,2,0.01%,4,2,50.00%
resources.office.net.edgekey.net,2,0.01%,4,2,50.00%
estudy.cnki.net,2,0.01%,9,7,22.22%
pdf-file.pdfxd.com,2,0.01%,4,2,50.00%
bd-livemate.pull.yximgs.com,2,0.01%,5,3,40.00%
weread-1258476243.file.myqcloud.com,2,0.01%,6,4,33.33%
33aef1e.nh.gladns.com,2,0.01%,5,3,40.00%
filedownload.csw.lenovo.com,2,0.01%,5,3,40.00%
pull-flv-l11.douyincdn.com.sched.l10.tdnsv5.com.clive.vwnti.yrzhcloud.cn,2,0.01%,4,2,50.00%
pull-fcdn-douyin-base7.s.bytefcdn.com,2,0.01%,4,2,50.00%
skconf.f.qh-lb.com,2,0.01%,6,4,33.33%
v3-gray.toutiaovod.com,2,0.01%,4,2,50.00%
opencdnmsdl3.jomodns.com,2,0.01%,4,2,50.00%
m701.music.126.net.163jiasu.com,2,0.01%,3,1,66.67%
dcat-tlu-fg-shim.trafficmanager.net,2,0.01%,4,2,50.00%
tlu.dl.delivery.mp.microsoft.com.a.bdydns.com,2,0.01%,4,2,50.00%
v26-gray.toutiaovod.com,2,0.01%,4,2,50.00%
lf3-cdn-tos.bytegoofy.com,2,0.01%,4,2,50.00%
lf3-static.bytednsdoc.com,2,0.01%,4,2,50.00%
s0.2mdn.net,2,0.01%,4,2,50.00%
s0-2mdn-net.l.google.com,2,0.01%,4,2,50.00%
a1887.dscq.akamai.net,2,0.01%,4,2,50.00%
d.ns.facebook.com,2,0.01%,8,6,25.00%
img.infinitynewtab.com,2,0.01%,4,2,50.00%
1min.pcfg.cache.wpscdn.cn.qiniudns.com,2,0.01%,4,2,50.00%
tiny009.china.line.qiniudns.com,2,0.01%,4,2,50.00%
scrootca1.ocsp.secomtrust.net,2,0.01%,4,2,50.00%
icon-list.infinitynewtab.com,2,0.01%,4,2,50.00%
subca.crl.certum.pl,2,0.01%,6,4,33.33%
instantmessaging-pa.googleapis.com,2,0.01%,4,2,50.00%
ib.snssdk.com,2,0.01%,4,2,50.00%
support.apple.com,2,0.01%,4,2,50.00%
v1-x.douyinvod.com,2,0.01%,4,2,50.00%
www.adobe.com,2,0.01%,4,2,50.00%
v6-cold2.douyinvod.com,2,0.01%,5,3,40.00%
t1.a.market.xiaomi.com,2,0.01%,4,2,50.00%
ts3.cn.mm.bing.chinacache.net,2,0.01%,4,2,50.00%
discussionschinese-lb.apple.com.akadns.net,2,0.01%,4,2,50.00%
cdn-api-verify.mob.com,2,0.01%,4,2,50.00%
sns-video-hw.xhscdn.com,2,0.01%,5,3,40.00%
apd-01fe2cea10604cc0d5743de4947f01b13dccda98d5b74beb.v.smtcdns.com,2,0.01%,2,0,100.00%
vi.xiaohongshu.com,2,0.01%,4,2,50.00%
prod.ingestion-edge.prod.dataops.mozgcp.NET,2,0.01%,10,8,20.00%
sg.pool.ntp.org,2,0.01%,6,4,33.33%
www.dpfile.com,2,0.01%,5,3,40.00%
hcdnw.zjtd01.gslb.c.cdnhwc2.com,2,0.01%,4,2,50.00%
hcdndyn.zjtd01.gslb.c.cdnhwc2.com,2,0.01%,4,2,50.00%
l7-online-self-max.s.dsa.cdnbuild.net,2,0.01%,4,2,50.00%
lf-cdn-tos.bytescm.com,2,0.01%,4,2,50.00%
mssdk-bu.snssdk.com,2,0.01%,4,2,50.00%
update.reasonsecurity.com,2,0.01%,4,2,50.00%
search.sohu.com,2,0.01%,6,4,33.33%
cis.sohu.com,2,0.01%,5,3,40.00%
api.interaction.sohu.com,2,0.01%,5,3,40.00%
p9.itc.cn,2,0.01%,5,3,40.00%
poi-pic-gz.cdn.bcebos.com,2,0.01%,4,2,50.00%
map-mobile-resource.cdn.bcebos.com,2,0.01%,4,2,50.00%
opencdnglobalv6.jomodns.com,2,0.01%,4,2,50.00%
opencdnbdsimage.jomodns.com,2,0.01%,4,2,50.00%
zhanzhang.toutiao.com.w.cdngslb.com,2,0.01%,4,2,50.00%
kunpeng-sc.csdnimg.cn.w.cdngslb.com,2,0.01%,4,2,50.00%
wss.dida365.com,2,0.01%,4,2,50.00%
csi.gstatic.com,2,0.01%,6,4,33.33%
ra.gtimg.com,2,0.01%,2,0,100.00%
img1.gtimg.com,2,0.01%,2,0,100.00%
beacon.cdn.qq.com,2,0.01%,2,0,100.00%
ipv6.tracker.harry.lu,2,0.01%,2,0,100.00%
upos-sz-mirrorali.bilivideo.com.w.kunluncan.com,2,0.01%,6,4,33.33%
e6858.dscx.akamaiedge.net,2,0.01%,4,2,50.00%
juejin.cn,2,0.01%,4,2,50.00%
lf3-cdn-tos.bytescm.com,2,0.01%,4,2,50.00%
p1-juejin.byteimg.com,2,0.01%,4,2,50.00%
p9-passport.byteacctimg.com,2,0.01%,4,2,50.00%
search-operate.cdn.bcebos.com,2,0.01%,6,4,33.33%
16.au.download.windowsupdate.com,2,0.01%,4,2,50.00%
update-windows.grammarly.com,2,0.01%,4,2,50.00%
uci.edog.cdn.office.net,2,0.01%,5,3,40.00%
ss0.bdstatic.com,2,0.01%,6,4,33.33%
mmbiz.qpic.cn.sched.legopic1.tdnsv6.com,2,0.01%,8,6,25.00%
bcp.crwdcntrl.net,2,0.01%,6,4,33.33%
adsfs.heytapimage.com,2,0.01%,4,2,50.00%
paimgcdn-feed.baidu.com,2,0.01%,4,2,50.00%
secure.globalsign.com,2,0.01%,4,2,50.00%
www.vod.lxdns.com,2,0.01%,4,2,50.00%
lh5.googleusercontent.com,2,0.01%,5,3,40.00%
00000000000000000000000000000000000000000000000000000000000022a.rui77.com,2,0.01%,4,2,50.00%
adi6u4riy2.feishu.cn,2,0.01%,4,2,50.00%
rc10-g4.oray.com,2,0.01%,4,2,50.00%
vthumb.ykimg.com,2,0.01%,5,3,40.00%
settings-bd.feishu.cn.w.cdngslb.com,2,0.01%,4,2,50.00%
api.docer.wpscdn.cn.qiniudns.com,2,0.01%,4,2,50.00%
api.docer.wpscdn.china.line.qiniudns.com,2,0.01%,4,2,50.00%
sundayrx.lanzouq.com,2,0.01%,4,2,50.00%
alldomain.lanzouq.com.a.bdydns.com,2,0.01%,4,2,50.00%
opencdnspy.jomodns.com,2,0.01%,4,2,50.00%
dotplayer.coldlake1.com.w.cdngslb.com,2,0.01%,4,2,50.00%
a1834.dscg2.akamai.net,2,0.01%,4,2,50.00%
ldc-fast.lenovo.com.cn.trpcdn.net,2,0.01%,4,2,50.00%
agsupdate.adobe.com,2,0.01%,4,2,50.00%
settings-prod-wjp-1.japanwest.cloudapp.azure.com,2,0.01%,12,10,16.67%
o3cf2jk38u.feishu.cn,2,0.01%,4,2,50.00%
v19.stream.tencentmusic.com,2,0.01%,4,2,50.00%
u.zhugeapi.net,2,0.01%,4,2,50.00%
cdnpcwallpaper.zhhainiao.com,2,0.01%,8,6,25.00%
t2.tiles.ditu.live.com,2,0.01%,4,2,50.00%
7674c24fe6aa40ac8b924a7f4b96f593.fp.measure.office.com,2,0.01%,2,0,100.00%
wmgp-update.wmupd.com,2,0.01%,4,2,50.00%
wmgp-update.wmupd.com.w.alikunlun.com,2,0.01%,4,2,50.00%
dsp.lenovo.com.cn.trpcdn.net,2,0.01%,4,2,50.00%
mt.lenovo.com.cn.trpcdn.net,2,0.01%,4,2,50.00%
sqimg.qq.com.cloud.tcdn.qq.com,2,0.01%,4,2,50.00%
oneclient.sfx.ms.edgekey.net,2,0.01%,4,2,50.00%
e9659.dspg.akamaiedge.net,2,0.01%,4,2,50.00%
hcdnl.pulldouyincmccssp.gslb.d.live.cdn.chinamobile.com,2,0.01%,4,2,50.00%
s6110-flv-ml.gslb.ksyuncdn.com,2,0.01%,4,2,50.00%
push-rtmp-l6-cny.douyincdn.com.upvcloud.ks-cdn.com,2,0.01%,4,2,50.00%
pull-flv-l6-source.douyincdn.com.hdlvcloud.ks-cdn.com,2,0.01%,4,2,50.00%
push-rtmp-f5-hs.pstatp.com.c.bytefcdn.com,2,0.01%,4,2,50.00%
pull-flv-f11.douyincdn.com.live.qcloudcdn.com,2,0.01%,4,2,50.00%
pull-flv-l6-cny.douyincdn.com.hdlvcloud.ks-cdn.com,2,0.01%,4,2,50.00%
pull-flv-l6.douyincdn.com.hdlvcloud.ks-cdn.com,2,0.01%,4,2,50.00%
push-rtmp-f5.douyincdn.com.c.bytefcdn.com,2,0.01%,4,2,50.00%
pull-tsl-spe-l11.douyincdn.com.cdn.dnsv1.com,2,0.01%,4,2,50.00%
pull-fcdn-douyin-hot3.s.bytefcdn.com,2,0.01%,4,2,50.00%
www.inoreader.com,2,0.01%,7,5,28.57%
iknow-pic.cdn.bcebos.com.a.bdydns.com,2,0.01%,4,2,50.00%
kessel-ws.parsec.app,2,0.01%,4,2,50.00%
s3.pstatp.com,2,0.01%,4,2,50.00%
client-api.itunes.apple.com,2,0.01%,5,3,40.00%
v11-x.douyinvod.com,2,0.01%,5,3,40.00%
v13-a.douyinvod.com,2,0.01%,4,2,50.00%
img2.baidu.com,2,0.01%,4,2,50.00%
cambrian-images.cdn.bcebos.com,2,0.01%,5,3,40.00%
cdn.sm.cn,2,0.01%,4,2,50.00%
huichuan-mc.sm.cn,2,0.01%,4,2,50.00%
s2.zimgs.cn,2,0.01%,4,2,50.00%
rtlog5-applog-lf.fqnovel.com,2,0.01%,4,2,50.00%
pc-store-lb.lenovomm.cn,2,0.01%,15,13,13.33%
office-fg-geo.trafficmanager.net,2,0.01%,2,0,100.00%
v18.toutiaovod.com,2,0.01%,4,2,50.00%
k1-ipv6.gslb.ksyuncdn.com,2,0.01%,6,4,33.33%
p26-be-pack-sign.pglstatp-toutiao.com,2,0.01%,4,2,50.00%
iadsdk.qtlcdn.com,2,0.01%,4,2,50.00%
tam.cdn-go.cn,2,0.01%,6,4,33.33%
exp-new.bdstatic.com,2,0.01%,4,2,50.00%
statics.itc.cn,2,0.01%,5,3,40.00%
catalog-public-service-prod.ak.epicgames.com,2,0.01%,4,2,50.00%
dsp.lenovo.com.cn.trpcdn.NET,2,0.01%,4,2,50.00%
news-img.lsttnews.com,2,0.01%,3,1,66.67%
datarouter-prod.ak.epicgames.com,2,0.01%,4,2,50.00%
play2.cp21.ott.cibntv.net,2,0.01%,4,2,50.00%
sqimg.qq.com,2,0.01%,4,2,50.00%
sqimg.qq.com.sched.legopic2.tdnsv6.com,2,0.01%,4,2,50.00%
visualstudio.download.prss.trafficmanager.net,2,0.01%,4,2,50.00%
download.visualstudio.microsoft.com.mwcname.com,2,0.01%,4,2,50.00%
www.apple.com.edgekey.net,2,0.01%,4,2,50.00%
download.mcafee.com,2,0.01%,4,2,50.00%
e7695.dscg.akamaiedge.net,2,0.01%,4,2,50.00%
game.clashofclans.com,2,0.01%,4,2,50.00%
star.facebook.com,2,0.01%,4,2,50.00%
cdn.content.prod.cms.msn.com.edgekey.net,2,0.01%,4,2,50.00%
e10663.dscg.akamaiedge.net,2,0.01%,4,2,50.00%
iadsdk.apple.com,2,0.01%,4,2,50.00%
pc.ximalaya.com.dsa.dnsv1.com.cn,2,0.01%,2,0,100.00%
v26.bdxiguavod.com,2,0.01%,4,2,50.00%
cdn.mysql.com,2,0.01%,5,3,40.00%
awsdns-20.com,2,0.01%,2,0,100.00%
aistudio.baidu.com,2,0.01%,4,2,50.00%
f-log-mac-extension.grammarly.io,2,0.01%,6,4,33.33%
33aef1e.nd.gladns.com,2,0.01%,3,1,66.67%
33aef1e.na.gladns.com,2,0.01%,2,0,100.00%
33aef1e.nc.gladns.com,2,0.01%,4,2,50.00%
vweixinf.tcdn.qq.com,2,0.01%,4,2,50.00%
beacons6.gvt2.com,2,0.01%,4,2,50.00%
sjy.stream.qqmusic.qq.com.cc0a7686.c.cdnhwc1.com,2,0.01%,4,2,50.00%
hcdnv.qq.music.c.cdnhwc2.com,2,0.01%,4,2,50.00%
v5-j.douyinvod.com.zjgslb.com,2,0.01%,4,2,50.00%
dy-vod-j.bytegslb.com,2,0.01%,4,2,50.00%
v5-colde.douyinvod.com.yangyi19.com,2,0.01%,4,2,50.00%
dy-vod-colde.bytegslb.com,2,0.01%,4,2,50.00%
oauthaccountmanager.googleapis.com,2,0.01%,4,2,50.00%
b.ns.facebook.com,2,0.01%,8,6,25.00%
c.ns.facebook.com,2,0.01%,8,6,25.00%
a.ns.facebook.com,2,0.01%,8,6,25.00%
check.torproject.org,2,0.01%,8,6,25.00%
www.biztorrents.com,2,0.01%,6,4,33.33%
b1477563.iavs9x.u.avast.com,2,0.01%,4,2,50.00%
b3156325.iavs9x.u.avast.com,2,0.01%,4,2,50.00%
s-iavs9x.avcdn.net,2,0.01%,4,2,50.00%
j4501229.iavs9x.u.avast.com,2,0.01%,4,2,50.00%
k9290131.iavs9x.u.avast.com,2,0.01%,4,2,50.00%
t7758057.iavs9x.u.avast.com,2,0.01%,4,2,50.00%
s2.cn.bing.net,2,0.01%,5,3,40.00%
txpic.dpfile.com,2,0.01%,4,2,50.00%
qzonestyle.gtimg.cn.sched.legopic2.tdnsv6.com,2,0.01%,7,5,28.57%
dss3.baidu.com,2,0.01%,4,2,50.00%
static.geetest.com,2,0.01%,5,3,40.00%
i9.taou.com,2,0.01%,4,2,50.00%
s4.ssl.qhres2.com,2,0.01%,4,2,50.00%
security.feishu.cn,2,0.01%,4,2,50.00%
img2018.cnblogs.com,2,0.01%,4,2,50.00%
a5.behance.net,2,0.01%,4,2,50.00%
css.ykimg.com,2,0.01%,4,2,50.00%
g4.ykimg.com,2,0.01%,4,2,50.00%
p3-zeus.byteimg.com,2,0.01%,4,2,50.00%
www.yisu.com,2,0.01%,4,2,50.00%
g1.ykimg.com,2,0.01%,4,2,50.00%
osx.dianping.com,2,0.01%,4,2,50.00%
osx.dpfile.com,2,0.01%,4,2,50.00%
osp.meituan.net,2,0.01%,4,2,50.00%
taboola-supply-partners.tremorhub.com,2,0.01%,4,2,50.00%
ns4.netim.net,2,0.01%,2,0,100.00%
ns5.netim.net,2,0.01%,2,0,100.00%
ocsp.rootg2.amazontrust.com,2,0.01%,4,2,50.00%
graphql.sketch.cloud,2,0.01%,4,2,50.00%
s.safe.360.cn.webcdn.360qhcdn.com,2,0.01%,4,2,50.00%
hcdnd101.gslb.c.cdnhwc2.com,2,0.01%,4,2,50.00%
down7.huorong.cn,2,0.01%,4,2,50.00%
down7.huorong.cn.volcgslb.com,2,0.01%,4,2,50.00%
odc-commonafdrk-geo.onedrive.akadns.NET,2,0.01%,4,2,50.00%
odc-commonafdrk-brs.onedrive.akadns.NET,2,0.01%,4,2,50.00%
platform.twitter.com,2,0.01%,4,2,50.00%
www.appleiphonecell.com,2,0.01%,4,2,50.00%
fsigns.duba.net.spdydns.com,2,0.01%,2,0,100.00%
photocdn.hd.sohu.com,2,0.01%,4,2,50.00%
hcdnw.bili.c.cdnhwc2.com,2,0.01%,4,2,50.00%
pc001.update.lbmini.cmcm.com,2,0.01%,4,2,50.00%
s7.huoying666.com,2,0.01%,4,2,50.00%
pm.myapp.com,2,0.01%,2,0,100.00%
u7.iqiyipic.com,2,0.01%,4,2,50.00%
le3-api.game.bilibili.com,2,0.01%,4,2,50.00%
p0.pipi.cn,2,0.01%,2,0,100.00%
filter.appstore.vivo.com.cn,2,0.01%,3,1,66.67%
5b0988e595225.cdn.sohucs.com,2,0.01%,4,2,50.00%
p4.itc.cn,2,0.01%,4,2,50.00%
p0.itc.cn,2,0.01%,4,2,50.00%
appdl-11-drcn.dbankcdn.com,2,0.01%,4,2,50.00%
appdl-12-drcn.dbankcdn.com,2,0.01%,4,2,50.00%
appdl-3-drcn.dbankcdn.com,2,0.01%,4,2,50.00%
quantcast.mgr.consensu.org,2,0.01%,2,0,100.00%
i2.sinaimg.cn,2,0.01%,4,2,50.00%
8.au.download.windowsupdate.com,2,0.01%,3,1,66.67%
epicgames.com,2,0.01%,2,0,100.00%
cdn.u1.huluxia.com,2,0.01%,4,2,50.00%
tcloud.tim.qq.com,2,0.01%,2,0,100.00%
client05.pdl.wow.battlenet.com.cn,2,0.01%,4,2,50.00%
aladin.wxqcloud.mid.tdnsv6.com,2,0.01%,2,0,100.00%
login.im.qcloud.com,1,0.00%,16,15,6.25%
pull-hls-vr-l6.douyincdn.com.hlsvcloud.ks-cdn.com,1,0.00%,13,12,7.69%
download.skype.com.edgekey.net,1,0.00%,2,1,50.00%
ping.pinyin.sogou.com,1,0.00%,471,470,0.21%
default.exp-tas.com,1,0.00%,387,386,0.26%
outlook.office365.com,1,0.00%,144,143,0.69%
outlook.ms-acdc.office.com,1,0.00%,44,43,2.27%
settings-win.data.microsoft.com,1,0.00%,1769,1768,0.06%
broadcast.chat.biliapi.com,1,0.00%,2,1,50.00%
ldc.lenovo.com.cn,1,0.00%,174,173,0.57%
www.baidu.com,1,0.00%,7131,7130,0.01%
incoming.telemetry.mozilla.org,1,0.00%,206,205,0.49%
px.owneriq.net,1,0.00%,3,2,33.33%
wildcard.owneriq.net.edgekey.net,1,0.00%,2,1,50.00%
e11294.g.akamaiedge.net,1,0.00%,2,1,50.00%
musicps.p2p.qq.com,1,0.00%,153,152,0.65%
weather-data.apple.com,1,0.00%,109,108,0.92%
v20.events.data.microsoft.com,1,0.00%,362,361,0.28%
updatem.360safe.com,1,0.00%,149,148,0.67%
alhadaafsport.online,1,0.00%,1,0,100.00%
d.skconf.f.360.cn,1,0.00%,214,213,0.47%
jh123-qzg.azureedge.net,1,0.00%,2,1,50.00%
jh123-qzg.akstd.azureedge.net,1,0.00%,2,1,50.00%
a1879.dscw14.akamai.net,1,0.00%,2,1,50.00%
slapi.oray.net,1,0.00%,305,304,0.33%
config-edge-skype.l-0007.l-msedge.net,1,0.00%,22,21,4.55%
dl.360safe.com,1,0.00%,52,51,1.92%
1min.pcfg.cache.wpscdn.cn,1,0.00%,123,122,0.81%
config.pinyin.sogou.com,1,0.00%,688,687,0.15%
b-ring.msedge.net,1,0.00%,10,9,10.00%
isure.stream.qqmusic.qq.com,1,0.00%,56,55,1.79%
sjy.stream.qqmusic.qq.com,1,0.00%,54,53,1.85%
aqqmusic.tc.qq.com,1,0.00%,57,56,1.75%
isure6.stream.qqmusic.qq.com,1,0.00%,58,57,1.72%
pconf.f.360.cn,1,0.00%,179,178,0.56%
tconf2.f.360.cn,1,0.00%,191,190,0.52%
sconf.f.360.cn,1,0.00%,122,121,0.82%
www.mvgroup.org,1,0.00%,22,21,4.55%
normandy.cdn.mozilla.net,1,0.00%,34,33,2.94%
mvgforumtracker.mvgroup.org,1,0.00%,63,62,1.59%
arc.msn.com,1,0.00%,203,202,0.49%
init.itunes.apple.com,1,0.00%,88,87,1.14%
ic.wps.cn,1,0.00%,76,75,1.32%
t-safe.2345.cc,1,0.00%,4,3,25.00%
ris.api.iris.microsoft.com,1,0.00%,130,129,0.77%
tracker1.myporn.club,1,0.00%,2,1,50.00%
onedscolprdwus04.westus.cloudapp.azure.com,1,0.00%,8,7,12.50%
ip.42.pl,1,0.00%,352,351,0.28%
res.wx.qq.com,1,0.00%,83,82,1.20%
t14.baidu.com,1,0.00%,40,39,2.50%
t15.baidu.com,1,0.00%,26,25,3.85%
gimg4.baidu.com,1,0.00%,16,15,6.25%
hpd.baidu.com,1,0.00%,53,52,1.89%
client.wns.windows.com,1,0.00%,404,403,0.25%
w.wwwww.wtf,1,0.00%,30,29,3.33%
live.github.com,1,0.00%,25,24,4.00%
www.ifeng.com,1,0.00%,2,1,50.00%
wpad.www.tendawifi.com,1,0.00%,24,23,4.17%
bnz07pap001.storage.live.com,1,0.00%,6,5,16.67%
cn.bing.com,1,0.00%,227,226,0.44%
videopic.bdstatic.com,1,0.00%,2,1,50.00%
pics1.baidu.com,1,0.00%,2,1,50.00%
pics0.baidu.com,1,0.00%,2,1,50.00%
yinbo-flv.bdvideo.bdstatic.com,1,0.00%,1,0,100.00%
flv-lemon.baidu.com,1,0.00%,1,0,100.00%
flv.liveshow.lss-user.baidubce.com,1,0.00%,1,0,100.00%
baoyun-play-flv.baidu.com,1,0.00%,1,0,100.00%
flv.haokan.bdstatic.com,1,0.00%,1,0,100.00%
flv.quanmin.bdstatic.com,1,0.00%,1,0,100.00%
playala.baidu.com,1,0.00%,1,0,100.00%
spcsz.cdn.bcebos.com,1,0.00%,2,1,50.00%
f11.baidu.com,1,0.00%,1,0,100.00%
mbdcdn.bdstatic.com,1,0.00%,1,0,100.00%
mms-voice.cdn.bcebos.com,1,0.00%,1,0,100.00%
nmtest.bdstatic.com,1,0.00%,1,0,100.00%
mstatic.cdn.bcebos.com,1,0.00%,1,0,100.00%
flpc.bdstatic.com,1,0.00%,1,0,100.00%
course-bj.cache.iciba.com,1,0.00%,1,0,100.00%
docer.wps.cn,1,0.00%,79,78,1.27%
home.wps.cn,1,0.00%,63,62,1.59%
account.wps.cn,1,0.00%,81,80,1.23%
kdocs.cn,1,0.00%,67,66,1.49%
liveng.alicdn.com,1,0.00%,3,2,33.33%
i0.hdslb.com,1,0.00%,50,49,2.00%
infoc2.duba.net,1,0.00%,92,91,1.09%
dsp.lenovo.com.cn,1,0.00%,114,113,0.88%
music.qq.com,1,0.00%,2,1,50.00%
njc-download.weiyun.com,1,0.00%,2,1,50.00%
sns.m.taobao.com,1,0.00%,2,1,50.00%
appdownload.alicdn.com,1,0.00%,2,1,50.00%
update.wps.cn,1,0.00%,272,271,0.37%
page.cainiao.com,1,0.00%,3,2,33.33%
cn.alicdn.com,1,0.00%,2,1,50.00%
zres.alicdn.com,1,0.00%,2,1,50.00%
event.csdn.net,1,0.00%,49,48,2.04%
gss0.bdstatic.com,1,0.00%,7,6,14.29%
p3.a.yximgs.com,1,0.00%,3,2,33.33%
ynuf.aliapp.org,1,0.00%,18,17,5.56%
baidu-cn-north-00001.bj-a.bcebos.com,1,0.00%,16,15,6.25%
quality-cdn.shouji.sogou.com,1,0.00%,3,2,33.33%
rc10-g5.oray.com,1,0.00%,3,2,33.33%
c.bing.com,1,0.00%,40,39,2.50%
ecn.dev.ditu.live.com,1,0.00%,48,47,2.08%
api.weibo.cn,1,0.00%,26,25,3.85%
th.bing.com,1,0.00%,29,28,3.45%
f.video.weibocdn.com,1,0.00%,20,19,5.00%
a.amap.com,1,0.00%,3,2,33.33%
p5.a.yximgs.com,1,0.00%,4,3,25.00%
ads-video-al.xhscdn.com,1,0.00%,3,2,33.33%
store.is.autonavi.com,1,0.00%,3,2,33.33%
maponline2.bdimg.com,1,0.00%,4,3,25.00%
maponline0.bdimg.com,1,0.00%,4,3,25.00%
maponline1.bdimg.com,1,0.00%,4,3,25.00%
img12.360buyimg.com,1,0.00%,3,2,33.33%
img13.360buyimg.com,1,0.00%,3,2,33.33%
wl.jd.com,1,0.00%,3,2,33.33%
post.ksosoft.com,1,0.00%,101,100,0.99%
client.mail.163.com,1,0.00%,56,55,1.79%
p2-v6-ml.gslb.ksyuncdn.com,1,0.00%,2,1,50.00%
init-p01md.apple.com,1,0.00%,2,1,50.00%
phonedeviceverification-pa.googleapis.com,1,0.00%,4,3,25.00%
zh.m.wikipedia.org,1,0.00%,4,3,25.00%
ts3.cn.mm.bing.net,1,0.00%,27,26,3.70%
info.wps.cn,1,0.00%,56,55,1.79%
aweme.snssdk.com,1,0.00%,2,1,50.00%
secure.gravatar.com,1,0.00%,4,3,25.00%
graph.facebook.com,1,0.00%,2,1,50.00%
static.meiqia.com,1,0.00%,2,1,50.00%
www-googletagmanager.l.google.com,1,0.00%,2,1,50.00%
lf.snssdk.com,1,0.00%,2,1,50.00%
aeis.alicdn.com,1,0.00%,2,1,50.00%
saascdn.mbgcdn.lenovo.com.cn,1,0.00%,2,1,50.00%
saascdn.lenovo.com.cn.trpcdn.net,1,0.00%,2,1,50.00%
cc.f.360.cn,1,0.00%,10,9,10.00%
www.163.com,1,0.00%,14266,14265,0.01%
www.msftncsi.com.edgesuite.NET,1,0.00%,1,0,100.00%
china.bing123.com,1,0.00%,18,17,5.56%
hjd2048.com,1,0.00%,2,1,50.00%
apd-ef1d4e4c1ea9898e441fef0017ad517108632f5a868c5ce6.v.smtcdns.com,1,0.00%,1,0,100.00%
swscan.apple.com,1,0.00%,5,4,20.00%
swdist.apple.com,1,0.00%,5,4,20.00%
pgdt.gtimg.cn,1,0.00%,6,5,16.67%
configuration.apple.com,1,0.00%,22,21,4.55%
api.amemv.com,1,0.00%,4,3,25.00%
ws-p2p.pull.yximgs.com,1,0.00%,4,3,25.00%
d1-reco.a.kwimgs.com,1,0.00%,3,2,33.33%
v1-dwkvod.kwaicdn.com,1,0.00%,3,2,33.33%
static.inkuai.com,1,0.00%,3,2,33.33%
yximgs-webrtc.liveplay.myqcloud.com,1,0.00%,3,2,33.33%
tx.push.yximgs.com,1,0.00%,3,2,33.33%
gsearch.vivo.com.cn,1,0.00%,2,1,50.00%
u1.120askimages.com,1,0.00%,2,1,50.00%
p1-dy.bytexservice.com,1,0.00%,2,1,50.00%
api.game.360.cn,1,0.00%,2,1,50.00%
ecs.office.com,1,0.00%,161,160,0.62%
upos-sz-mirrorhwb.bilivideo.com,1,0.00%,2,1,50.00%
update-khd.2345.cc,1,0.00%,42,41,2.38%
music.163.com,1,0.00%,43,42,2.33%
tracker.publicbt.com,1,0.00%,6,5,16.67%
s1-www.huxiucdn.com,1,0.00%,2,1,50.00%
bytedance.feishu.cn,1,0.00%,2,1,50.00%
fc4tn.baidu.com,1,0.00%,4,3,25.00%
fc5tn.baidu.com,1,0.00%,5,4,20.00%
updates.cdn-apple.com.w.kunlunca.com,1,0.00%,2,1,50.00%
help-tower.2345.cc,1,0.00%,48,47,2.08%
www.81.cn,1,0.00%,2,1,50.00%
fullscreen-detail.alicdn.com,1,0.00%,2,1,50.00%
update2.sangfor.net,1,0.00%,1,0,100.00%
fscdn.zto.com,1,0.00%,2,1,50.00%
t0.dynamic.tiles.ditu.live.com,1,0.00%,3,2,33.33%
downtime.mendeley.com,1,0.00%,2,1,50.00%
ss1.bdstatic.com,1,0.00%,19,18,5.26%
fc-transvideo.baidu.com,1,0.00%,2,1,50.00%
static.bshare.cn,1,0.00%,2,1,50.00%
www.icloud.com,1,0.00%,32,31,3.12%
userlink.alicdn.com.danuoyi.tbcache.com,1,0.00%,2,1,50.00%
t2-xhs-new-vpc-ipv6-2022140793.cn-north-1.elb.amazonaws.com.cn,1,0.00%,2,1,50.00%
ase.autodesk.com,1,0.00%,2,1,50.00%
js.live.net,1,0.00%,2,1,50.00%
e4478.dscb.akamaiedge.net,1,0.00%,2,1,50.00%
zip.update.360safe.com,1,0.00%,3,2,33.33%
tracking.firefox.com.cn,1,0.00%,3,2,33.33%
tracking.firefox.com.cn.wswebpic.com,1,0.00%,3,2,33.33%
addons.g-fox.cn,1,0.00%,2,1,50.00%
addons.g-fox.cn.w.kunlunca.com,1,0.00%,2,1,50.00%
prod.ingestion-edge.prod.dataops.mozgcp.net,1,0.00%,14,13,7.14%
bookmarks-ssl.firefoxchina.cn,1,0.00%,2,1,50.00%
p0.qhimgs4.com.webcdn.360qhcdn.com,1,0.00%,2,1,50.00%
offlintab.firefoxchina.cn,1,0.00%,3,2,33.33%
offlintab.firefoxchina.cn.wscdns.com,1,0.00%,2,1,50.00%
fa000000043.resources.office.net,1,0.00%,3,2,33.33%
urswebzj.nosdn.127.net,1,0.00%,2,1,50.00%
officecdn.microsoft.com,1,0.00%,3,2,33.33%
cbjs.baidu.com,1,0.00%,2,1,50.00%
srv.carbonads.net,1,0.00%,2,1,50.00%
image.shutterstock.com,1,0.00%,4,3,25.00%
static.arxiv.org,1,0.00%,4,3,25.00%
configuration.apple.com.akadns.net,1,0.00%,25,24,4.00%
arxivcu.containers.piwik.pro,1,0.00%,1,0,100.00%
pull-flv-f6-xg.bytecdn.cn,1,0.00%,2,1,50.00%
pull-rtmp-hs-l6-xg.ixigua.com,1,0.00%,2,1,50.00%
pull-f3-xg.bytecdn.cn,1,0.00%,2,1,50.00%
pull-rtmp-l6-xg.ixigua.com,1,0.00%,2,1,50.00%
pull-hs-f5-xg.flive.ixigua.com,1,0.00%,2,1,50.00%
pull-rtmp-l1-xg.bytecdn.cn,1,0.00%,2,1,50.00%
pull-flv-f1-xg.bytecdn.cn,1,0.00%,2,1,50.00%
pull-hs-l3-xg.ixigua.com,1,0.00%,2,1,50.00%
pull-flv-l11.ixigua.com,1,0.00%,2,1,50.00%
pull-rtmp-hs-l1-xg.ixigua.com,1,0.00%,2,1,50.00%
pull-rtmp-l1-xg.ixigua.com,1,0.00%,2,1,50.00%
pull-flv-l6-xg.ixigua.com,1,0.00%,2,1,50.00%
pull-rtmp-l11.ixigua.com,1,0.00%,2,1,50.00%
pull-flv-l1-xg.bytecdn.cn,1,0.00%,2,1,50.00%
pull-l3-xg.ixigua.com,1,0.00%,2,1,50.00%
pull-flv-hs-l6-xg.ixigua.com,1,0.00%,2,1,50.00%
pull-rtmp-f6-xg.bytecdn.cn,1,0.00%,2,1,50.00%
pull-flv-l1-xg.ixigua.com,1,0.00%,2,1,50.00%
pull-flv-hs-l1-xg.ixigua.com,1,0.00%,2,1,50.00%
pull-rtmp-f1-xg.bytecdn.cn,1,0.00%,2,1,50.00%
pull-f5-xg.ixigua.com,1,0.00%,2,1,50.00%
pull-f5-xg.flive.ixigua.com,1,0.00%,2,1,50.00%
css.66law.cn,1,0.00%,4,3,25.00%
hm.hualv.com,1,0.00%,4,3,25.00%
fs-im-kefu.7moor-fs1.com,1,0.00%,2,1,50.00%
settings-prod-wus2-2.westus2.cloudapp.azure.com,1,0.00%,8,7,12.50%
wd-prod-ss-as-southeast-1-fe.southeastasia.cloudapp.azure.com,1,0.00%,22,21,4.55%
na1e-acc.services.adobe.com,1,0.00%,2,1,50.00%
fg.download.windowsupdate.com.mwcname.com,1,0.00%,2,1,50.00%
update.code.visualstudio.com,1,0.00%,144,143,0.69%
ns3-38.azure-dns.org,1,0.00%,18,17,5.56%
outlook.live.com,1,0.00%,88,87,1.14%
and.game.coc.qq.com,1,0.00%,23,22,4.35%
s2-11583.ssrcdn.com,1,0.00%,2,1,50.00%
common-afdrk.fe.1drv.com,1,0.00%,22,21,4.55%
outlook.office.com,1,0.00%,52,51,1.92%
iris-de-prod-azsc-eas-b.eastasia.cloudapp.azure.com,1,0.00%,14,13,7.14%
appsforoffice.microsoft.com,1,0.00%,2,1,50.00%
e2682.g.akamaiedge.net,1,0.00%,2,1,50.00%
bookkeeper.itunes.apple.com,1,0.00%,2,1,50.00%
bookkeeper-cdn.itunes-apple.com.akadns.net,1,0.00%,2,1,50.00%
pub.idqqimg.com.tc.qq.com,1,0.00%,14,13,7.14%
dailyupdate.wangwang.taobao.com.danuoyi.tbcache.com,1,0.00%,2,1,50.00%
ali-ky.static.yximgs.com,1,0.00%,2,1,50.00%
up.f.360.cn,1,0.00%,11,10,9.09%
onedscolprdcus04.centralus.cloudapp.azure.com,1,0.00%,8,7,12.50%
i-lq.snssdk.com,1,0.00%,3,2,33.33%
cdn.exp.xiaomi.com,1,0.00%,2,1,50.00%
pc-store.lenovomm.cn,1,0.00%,19,18,5.26%
xsweb.gdt.qq.com,1,0.00%,2,1,50.00%
tx-rwk.pull.etoote.com,1,0.00%,3,2,33.33%
swupmf.adobe.com,1,0.00%,2,1,50.00%
3.au.download.windowsupdate.com,1,0.00%,2,1,50.00%
sso.foxitreader.cn,1,0.00%,2,1,50.00%
driverupdate.lenovo.com.cn,1,0.00%,2,1,50.00%
jsqmt.qq.com,1,0.00%,1,0,100.00%
item.taobao.com,1,0.00%,2,1,50.00%
history.sohu.com,1,0.00%,2,1,50.00%
video.donglin.org,1,0.00%,4,3,25.00%
msg.qy.net,1,0.00%,45,44,2.22%
policy.video.iqiyi.com,1,0.00%,12,11,8.33%
v10.vortex-win.data.microsoft.com,1,0.00%,36,35,2.78%
bd-pclivemate.pull.yximgs.com,1,0.00%,3,2,33.33%
ks-pclivemate.pull.yximgs.com,1,0.00%,4,3,25.00%
cdnimg.3g.qq.com,1,0.00%,4,3,25.00%
cdnimg.3g.qq.com.sched.legopic2.tdnsv6.com.tpic.vwnti.yrzhcloud.cn,1,0.00%,2,1,50.00%
i.gtimg.cn.sched.legopic2.tdnsv6.com.tpic.vwnti.yrzhcloud.cn,1,0.00%,4,3,25.00%
lyrics.kugou.com,1,0.00%,4,3,25.00%
aproximapizzaria.online,1,0.00%,1,0,100.00%
accountingguidance.com,1,0.00%,1,0,100.00%
qiniustaticopencdn.jomodns.com,1,0.00%,2,1,50.00%
dlied6.qq.com.yyb.sched.dcloudstc.com,1,0.00%,2,1,50.00%
bt.okmp3.ru,1,0.00%,10,9,10.00%
www2.autoimg.cn,1,0.00%,2,1,50.00%
cstat.apple.com,1,0.00%,2,1,50.00%
translate.google.com,1,0.00%,19,18,5.26%
v6.douyinvod.com,1,0.00%,3,2,33.33%
only-806527-124-16-137-194.nstool.321fenx.com,1,0.00%,1,0,100.00%
mqtt.zhihu.com,1,0.00%,6,5,16.67%
ichannel.snssdk.com,1,0.00%,3,2,33.33%
yun-hl.3g.qq.com,1,0.00%,22,21,4.55%
lf-webcast-gr-sourcecdn.bytegecko.com,1,0.00%,2,1,50.00%
lf3-short.bytegoofy.com,1,0.00%,2,1,50.00%
lf3-cdn-tos.bytescm.com.w.alikunlun.com,1,0.00%,2,1,50.00%
p3-webcast.douyinpic.com,1,0.00%,2,1,50.00%
uz91.v.bsgslb.com,1,0.00%,4,3,25.00%
iphone-ld.apple.com,1,0.00%,32,31,3.12%
ocsp.entrust.net,1,0.00%,79,78,1.27%
api.amplitude.com,1,0.00%,4,3,25.00%
q-ring.q-9999.q-msedge.net,1,0.00%,1,0,100.00%
portrait.jomodns.com,1,0.00%,1,0,100.00%
weather.noaa.gov,1,0.00%,1,0,100.00%
playclient.douyucdn.cn,1,0.00%,2,1,50.00%
rpic.douyucdn.cn,1,0.00%,3,2,33.33%
yuba.douyu.com,1,0.00%,3,2,33.33%
mmbiz.qpic.tc.qq.com,1,0.00%,2,1,50.00%
video.leetcode-cn.com,1,0.00%,2,1,50.00%
uc-avatar-cn.heytapimage.com,1,0.00%,2,1,50.00%
fg.download.windowsupdate.com.c.footprint.net,1,0.00%,2,1,50.00%
google.com.hk,1,0.00%,2,1,50.00%
p3-sign.toutiaoimg.com.w.alikunlun.com,1,0.00%,2,1,50.00%
globalsign.com.w.kunlunar.com,1,0.00%,2,1,50.00%
new-service.biliapi.net,1,0.00%,2,1,50.00%
api.tutu-studio.com,1,0.00%,2,1,50.00%
upos-sz-static.bilivideo.com,1,0.00%,1,0,100.00%
conf.95516.com,1,0.00%,2,1,50.00%
update.dbankcdn.com,1,0.00%,2,1,50.00%
img.bq233.com,1,0.00%,2,1,50.00%
wwW.VOd.LxDns.cOm,1,0.00%,2,1,50.00%
minipkg.dingtalk.com,1,0.00%,2,1,50.00%
package.dingtalk.com,1,0.00%,2,1,50.00%
wow.uc.cn,1,0.00%,2,1,50.00%
js.stripe.com,1,0.00%,4,3,25.00%
issuecdn.baidupcs.com,1,0.00%,2,1,50.00%
securitymgmt.unifiedapis.mcafee.com,1,0.00%,2,1,50.00%
gw.alicdn.com.danuoyi.tbcache.com,1,0.00%,2,1,50.00%
p3.ssl.qhimgs0.com,1,0.00%,3,2,33.33%
appdl-1-drcn.dbankcdn.cn,1,0.00%,2,1,50.00%
services.googleapis.cn,1,0.00%,4,3,25.00%
csdn.log-global.aliyuncs.com,1,0.00%,6,5,16.67%
vd3.bdstatic.com,1,0.00%,2,1,50.00%
new.qq.com,1,0.00%,4,3,25.00%
mat1.gtimg.com,1,0.00%,8,7,12.50%
js.aq.qq.com,1,0.00%,8,7,12.50%
h5.ssp.qq.com,1,0.00%,6,5,16.67%
v3.oskwai.com,1,0.00%,3,2,33.33%
v2.oskwai.com,1,0.00%,3,2,33.33%
txmov6.a.yximgs.com,1,0.00%,3,2,33.33%
hdns.ksyun.com,1,0.00%,3,2,33.33%
v4.kwaicdn.com,1,0.00%,3,2,33.33%
v4.oskwai.com,1,0.00%,3,2,33.33%
v3.kwaicdn.com,1,0.00%,3,2,33.33%
txmov6.a.kwimgs.com,1,0.00%,3,2,33.33%
jsmov2.a.yximgs.com,1,0.00%,3,2,33.33%
v3-ot01.kwaicdn.com,1,0.00%,5,4,20.00%
v3-ot02.kwaicdn.com,1,0.00%,3,2,33.33%
hw-adaptive.pull.yximgs.com,1,0.00%,3,2,33.33%
hw-origin.pull.yximgs.com,1,0.00%,3,2,33.33%
d1.a.kwimgs.com,1,0.00%,3,2,33.33%
txcmmov.a.etoote.com,1,0.00%,3,2,33.33%
p2.a.yximgs.com,1,0.00%,3,2,33.33%
p5-live.a.yximgs.com,1,0.00%,4,3,25.00%
p3-live.a.yximgs.com,1,0.00%,3,2,33.33%
aliqcmmov.a.etoote.com,1,0.00%,3,2,33.33%
txdwkvod.a.etoote.com,1,0.00%,3,2,33.33%
tx-ad.a.yximgs.com,1,0.00%,3,2,33.33%
p1.eckwai.com,1,0.00%,4,3,25.00%
d1-magic.static.yximgs.com,1,0.00%,3,2,33.33%
ali.static.yximgs.com,1,0.00%,4,3,25.00%
d4-magic.a.kwimgs.com,1,0.00%,3,2,33.33%
d1-yoda.a.kwimgs.com,1,0.00%,2,1,50.00%
d2-ks.a.kwimgs.com,1,0.00%,2,1,50.00%
d2-reco.a.kwimgs.com,1,0.00%,2,1,50.00%
d2-push.static.yximgs.com,1,0.00%,2,1,50.00%
d3-yoda.a.kwimgs.com,1,0.00%,3,2,33.33%
d4-ks.a.kwimgs.com,1,0.00%,2,1,50.00%
bd-p2p.pull.yximgs.com,1,0.00%,3,2,33.33%
bd.push.yximgs.com,1,0.00%,3,2,33.33%
d1-ec.a.kwimgs.com,1,0.00%,3,2,33.33%
d2-kkd.a.kspkg.com,1,0.00%,4,3,25.00%
ks-p2p.pull.yximgs.com,1,0.00%,2,1,50.00%
v2-cty05.kwaicdn.com,1,0.00%,2,1,50.00%
img-s.msn.cn,1,0.00%,3,2,33.33%
appldnld.apple.com,1,0.00%,2,1,50.00%
cm-cn-central-00001.albatross.10086.cn,1,0.00%,5,4,20.00%
gh.bdstatic.com,1,0.00%,3,2,33.33%
t4.a.market.xiaomi.com,1,0.00%,2,1,50.00%
t2.a.market.xiaomi.com,1,0.00%,2,1,50.00%
ntes53v6.mail.yeah.NET,1,0.00%,2,1,50.00%
appdown.baidu.com,1,0.00%,2,1,50.00%
gamedelivery.cdn.bcebos.com,1,0.00%,2,1,50.00%
t15.baidu.com.a.bdydns.com,1,0.00%,2,1,50.00%
t9.baidu.com.a.bdydns.com,1,0.00%,2,1,50.00%
pic.rmb.bdstatic.com.a.bdydns.com,1,0.00%,3,2,33.33%
pics7.baidu.com,1,0.00%,2,1,50.00%
pics3.baidu.com,1,0.00%,3,2,33.33%
t11.baidu.com.a.bdydns.com,1,0.00%,2,1,50.00%
t12.baidu.com.a.bdydns.com,1,0.00%,2,1,50.00%
t10.baidu.com.a.bdydns.com,1,0.00%,2,1,50.00%
data.eastmoney.com,1,0.00%,2,1,50.00%
g1.dfcfw.com,1,0.00%,2,1,50.00%
yscres.dfcfw.com,1,0.00%,2,1,50.00%
gbcdn.dfcfw.com,1,0.00%,2,1,50.00%
zhishubao.1234567.com.cn,1,0.00%,2,1,50.00%
securepubads.g.doubleclick.net,1,0.00%,18,17,5.56%
fundact.eastmoney.com,1,0.00%,2,1,50.00%
topic.1234567.com.cn,1,0.00%,2,1,50.00%
premiumcdn.eastmoney.com,1,0.00%,2,1,50.00%
apd-55aa056d36dd2a21510c7aba402054b61c3d0af5f3be64c2.v.smtcdns.com,1,0.00%,1,0,100.00%
identity.nel.measure.office.net,1,0.00%,2,1,50.00%
common.cnblogs.com,1,0.00%,7,6,14.29%
img2022.cnblogs.com,1,0.00%,2,1,50.00%
soft.flash.cn,1,0.00%,2,1,50.00%
static.ffzww.com,1,0.00%,2,1,50.00%
gecko-pangle-lq.snssdk.com,1,0.00%,2,1,50.00%
stlib.qbb6.com,1,0.00%,2,1,50.00%
apd-8a3283388c9bfd480603732ee18cc09b3d9e120b00d43d9b.v.smtcdns.com,1,0.00%,1,0,100.00%
sporthealth-drcn.dbankcdn.com.cdn.dnsv1.com,1,0.00%,2,1,50.00%
sporthealth-drcn.dbankcdn.com.c.cdnhwc1.com,1,0.00%,2,1,50.00%
gspe79-ssl.ls.apple.com,1,0.00%,4,3,25.00%
onedriveclucprodbn20014.blob.core.windows.net,1,0.00%,8,7,12.50%
pc.lenovomm.cn,1,0.00%,4,3,25.00%
vd6.l.qq.com,1,0.00%,15,14,6.67%
cdn.onenote.net,1,0.00%,23,22,4.35%
scc.bytedance.com,1,0.00%,2,1,50.00%
apis.map.qq.com,1,0.00%,16,15,6.25%
img.4hou.com,1,0.00%,2,1,50.00%
aos-cdn-image.amap.com,1,0.00%,2,1,50.00%
cache.amap.com,1,0.00%,2,1,50.00%
c3.amap.com,1,0.00%,2,1,50.00%
appimg.dbankcdn.com,1,0.00%,6,5,16.67%
hagmanagerres-drcn.dbankcdn.com,1,0.00%,2,1,50.00%
render-oss-cdn.amap.com,1,0.00%,2,1,50.00%
cu005.www.duba.net,1,0.00%,2,1,50.00%
apd-5679f85509396b2c5d5aa087705f383bd0feef74a3e4f5dc.v.smtcdns.com,1,0.00%,1,0,100.00%
duba-config-cdn.duba.net,1,0.00%,3,2,33.33%
p211-keyvalueservice-china.icloud.com,1,0.00%,2,1,50.00%
gboperation.eastmoney.com,1,0.00%,4,3,25.00%
dl4.weshineapp.com,1,0.00%,2,1,50.00%
vdse.bdstatic.com.a.bdydns.com,1,0.00%,2,1,50.00%
connector03.soc.wlaq.qianxin-inc.cn,1,0.00%,1,0,100.00%
connector06.soc.wlaq.qianxin-inc.cn,1,0.00%,1,0,100.00%
cdn2.jianshu.io,1,0.00%,5,4,20.00%
conn1.oppomobile.com,1,0.00%,2,1,50.00%
fp-as-nocache.azureedge.net,1,0.00%,5,4,20.00%
honeycomb.wps.cn,1,0.00%,27,26,3.70%
mpvideo.qpic.cn,1,0.00%,6,5,16.67%
connector02.soc.wlaq.qianxin-inc.cn,1,0.00%,1,0,100.00%
tracker.vectahosting.eu,1,0.00%,5,4,20.00%
connector01.soc.wlaq.qianxin-inc.cn,1,0.00%,1,0,100.00%
wa.qq.com,1,0.00%,4,3,25.00%
connector08.soc.wlaq.qianxin-inc.cn,1,0.00%,1,0,100.00%
xykstatic.cc.cmbimg.com,1,0.00%,2,1,50.00%
3gimg.qq.com,1,0.00%,3,2,33.33%
activity.hdslb.com,1,0.00%,2,1,50.00%
crl.microsoft.com,1,0.00%,2,1,50.00%
xapi.dida365.com,1,0.00%,2,1,50.00%
feeds-drcn.dbankcdn.cn,1,0.00%,2,1,50.00%
codown.youdao.com,1,0.00%,2,1,50.00%
tnc11-aliec2.zijieapi.com,1,0.00%,2,1,50.00%
cdn.cnbj0.fds.api.mi-img.com,1,0.00%,2,1,50.00%
px.ads.linkedin.cn,1,0.00%,5,4,20.00%
webcdn.m.qq.com,1,0.00%,2,1,50.00%
pc1.gtimg.com,1,0.00%,2,1,50.00%
pc2.gtimg.com,1,0.00%,2,1,50.00%
canvas-cdn-prod.azureedge.net,1,0.00%,2,1,50.00%
vhs.wwstat.com,1,0.00%,2,1,50.00%
ddzhw.nalrer.cn,1,0.00%,2,1,50.00%
qmmj-hw.tytuyoo.com,1,0.00%,2,1,50.00%
img7.file.cache.docer.com,1,0.00%,3,2,33.33%
img8.file.cache.docer.com,1,0.00%,3,2,33.33%
wkretype.bdimg.com,1,0.00%,2,1,50.00%
wkstatic.bdimg.com,1,0.00%,2,1,50.00%
wkimg.bdimg.com,1,0.00%,2,1,50.00%
www.wenshubang.com,1,0.00%,2,1,50.00%
p.9136.com,1,0.00%,2,1,50.00%
www.ruiwen.com,1,0.00%,2,1,50.00%
5jwrcdlteg.execute-api.us-east-1.amazonaws.com,1,0.00%,2,1,50.00%
cpt.9136.com,1,0.00%,2,1,50.00%
acdc-direct.office.com,1,0.00%,12,11,8.33%
www2.public-trust.com,1,0.00%,6,5,16.67%
login.feishu.cn,1,0.00%,3,2,33.33%
outlook-com.olc.protection.outlook.com,1,0.00%,2,1,50.00%
u1-000.ecukwai.com,1,0.00%,2,1,50.00%
js-ec.static.yximgs.com,1,0.00%,2,1,50.00%
u2-000.ecukwai.com,1,0.00%,2,1,50.00%
rc10-g3.oray.com,1,0.00%,2,1,50.00%
sadownload.mcafee.com,1,0.00%,39,38,2.56%
sjy6.stream.qqmusic.qq.com.ctdns.cn,1,0.00%,16,15,6.25%
ea2.com.edgekey.net,1,0.00%,2,1,50.00%
publicassets.lb-apple.com.akadns.net,1,0.00%,2,1,50.00%
publicassets-cn.lb-apple.com.akadns.net,1,0.00%,2,1,50.00%
publicassets.cdn-apple.com.download.ks-cdn.com,1,0.00%,2,1,50.00%
config.i.duba.net.w.kunlunar.com,1,0.00%,2,1,50.00%
e16126.dscg.akamaiedge.net,1,0.00%,2,1,50.00%
hub5u.sandai.net,1,0.00%,26,25,3.85%
g.api.mega.co.nz,1,0.00%,4,3,25.00%
eyesguard-cdn.cmcm.com,1,0.00%,4,3,25.00%
onedscolprdneu04.northeurope.cloudapp.azure.com,1,0.00%,4,3,25.00%
onedscolprdaus00.australiasoutheast.cloudapp.azure.com,1,0.00%,6,5,16.67%
clientconfig.passport.net,1,0.00%,2,1,50.00%
api3-eeft-gateway-lf.feishu.cn.w.cdngslb.com,1,0.00%,2,1,50.00%
api3-eeft-imfile-lf.feishu.cn.w.cdngslb.com,1,0.00%,2,1,50.00%
a1851.dscg2.akamai.NET,1,0.00%,2,1,50.00%
ee15ba61-wschat-wschatalb-6fcf-2062696737.us-east-1.elb.amazonaws.com,1,0.00%,2,1,50.00%
android.apis.google.com,1,0.00%,3,2,33.33%
oss.weread.qq.com,1,0.00%,9,8,11.11%
sbc.firefox.com.cn,1,0.00%,1,0,100.00%
tx-kmpaudio.pull.yximgs.com,1,0.00%,3,2,33.33%
tx-dwk.pull.yximgs.com,1,0.00%,3,2,33.33%
tx-livemate.pull.yximgs.com,1,0.00%,3,2,33.33%
tx-pclivemate.pull.yximgs.com,1,0.00%,3,2,33.33%
gmscompliance-pa.googleapis.com,1,0.00%,4,3,25.00%
ali-livemate.pull.yximgs.com,1,0.00%,3,2,33.33%
ali-kmpaudio.pull.yximgs.com,1,0.00%,3,2,33.33%
push-fcdn-base3.s.bytefcdn.com,1,0.00%,2,1,50.00%
pull-fcdn-douyin-hot2.s.bytefcdn.com,1,0.00%,2,1,50.00%
ingestion-edge.prod.dataops.mozgcp.net,1,0.00%,2,1,50.00%
v5-coldc.douyinvod.com.zjgslb.com,1,0.00%,2,1,50.00%
ups.ksmobile.net,1,0.00%,8,7,12.50%
dy-vod-coldc.bytegslb.com,1,0.00%,2,1,50.00%
m701.music.126.net.w.alikunlun.com,1,0.00%,2,1,50.00%
www.chengzijianzhan.cc,1,0.00%,2,1,50.00%
p3-orange.byteorge.com,1,0.00%,2,1,50.00%
lf1-cdn2-tos.bytegoofy.com,1,0.00%,2,1,50.00%
lf3-short.bytetos.com,1,0.00%,2,1,50.00%
clue.oceanengine.com,1,0.00%,2,1,50.00%
lf1-cdn-tos.bytescm.com,1,0.00%,2,1,50.00%
verify.snssdk.com,1,0.00%,2,1,50.00%
sync.extend.tv,1,0.00%,2,1,50.00%
ade.googlesyndication.com,1,0.00%,2,1,50.00%
e7479.g.akamaiedge.net,1,0.00%,2,1,50.00%
ctest.cdn.nintendo.net,1,0.00%,2,1,50.00%
ctest.cdn.nintendo.net.akamaized.net,1,0.00%,2,1,50.00%
a1456.g1.akamai.net,1,0.00%,2,1,50.00%
broker.lp1.npns.srv.nintendo.net,1,0.00%,2,1,50.00%
baidengyi.com,1,0.00%,1,0,100.00%
orcrane.com,1,0.00%,1,0,100.00%
bilijun.com,1,0.00%,1,0,100.00%
ipcdn-lb.apple.com.akadns.net,1,0.00%,2,1,50.00%
jtypkz2w.sched.d2.tdnsdp1.cn.cjt.vwnti.yrzhcloud.cn,1,0.00%,2,1,50.00%
wppkg.baidupcs.com.a.bdydns.com,1,0.00%,2,1,50.00%
opencdnv6.jomodns.com,1,0.00%,2,1,50.00%
m801.music.126.net.ctdns.cn,1,0.00%,2,1,50.00%
1610340737.D4EE073396E8.device.hiwifi.com,1,0.00%,1,0,100.00%
1610340758.D4EE073396E8.device.hiwifi.com,1,0.00%,1,0,100.00%
1610340779.D4EE073396E8.device.hiwifi.com,1,0.00%,1,0,100.00%
bnz07pcor001-meta.fe.1drv.com,1,0.00%,2,1,50.00%
e10198.b.akamaiedge.NET,1,0.00%,2,1,50.00%
v6.douyinvod.com.download.ks-cdn.com,1,0.00%,2,1,50.00%
ieeexplore.demdex.net,1,0.00%,2,1,50.00%
1year.pcfg.cache.wpscdn.cn,1,0.00%,2,1,50.00%
lf5-article.toutiaostatic.com,1,0.00%,2,1,50.00%
getsupport.apple.com,1,0.00%,2,1,50.00%
yun.tim.qq.com,1,0.00%,5,4,20.00%
sv.symcb.com,1,0.00%,11,10,9.09%
is1-ssl.mzstatic.com,1,0.00%,3,2,33.33%
is3-ssl.mzstatic.com,1,0.00%,3,2,33.33%
is2-ssl.mzstatic.com,1,0.00%,3,2,33.33%
e4649.a.akamaiedge.net,1,0.00%,2,1,50.00%
appleid.cdn-apple.com,1,0.00%,2,1,50.00%
appleid.cdn-apple.com.w.kunluncan.com,1,0.00%,2,1,50.00%
down.pandora.qq.com,1,0.00%,2,1,50.00%
m702.music.126.net,1,0.00%,2,1,50.00%
upos-sz-staticcos.bilivideo.com,1,0.00%,3,2,33.33%
ts4.cn.mm.bing.chinacache.net,1,0.00%,2,1,50.00%
aefd.nelreports.net.akamaized.net,1,0.00%,2,1,50.00%
mapsp0.bdimg.com,1,0.00%,2,1,50.00%
d2-toutiao-ipv6-ml.gslb.ksyuncdn.com,1,0.00%,2,1,50.00%
v.xiaohongshu.com,1,0.00%,3,2,33.33%
store.xiaohongshu.com,1,0.00%,4,3,25.00%
settings-ssl.xboxlive.com,1,0.00%,3,2,33.33%
se4.360simg.com,1,0.00%,3,2,33.33%
dlied6.qq.com.tcdn.qq.com,1,0.00%,2,1,50.00%
www.iqiyi.com,1,0.00%,6,5,16.67%
p63-caldav.icloud.com,1,0.00%,2,1,50.00%
p3-be-pack-sign.pglstatp-toutiao.com,1,0.00%,2,1,50.00%
sync.srv.stackadapt.com,1,0.00%,2,1,50.00%
xsts.auth.xboxlive.com,1,0.00%,10,9,10.00%
rescdn.qqmail.com,1,0.00%,2,1,50.00%
restest.mail.tc.qq.com,1,0.00%,2,1,50.00%
v5.kwaicdn.com,1,0.00%,2,1,50.00%
p2-live.a.yximgs.com,1,0.00%,2,1,50.00%
gateway.sogou.com,1,0.00%,2,1,50.00%
p2.itc.cn,1,0.00%,2,1,50.00%
taojin-his.cdn.bcebos.com,1,0.00%,3,2,33.33%
poi-pic.cdn.bcebos.com,1,0.00%,3,2,33.33%
opencdnbdcharon.jomodns.com,1,0.00%,2,1,50.00%
opencdnbdimgtn.jomodns.com,1,0.00%,2,1,50.00%
dart.l.doubleclick.net,1,0.00%,3,2,33.33%
video.market.xiaomi.com,1,0.00%,2,1,50.00%
js-ad.a.yximgs.com,1,0.00%,2,1,50.00%
bimp.hdslb.com.w.cdngslb.com,1,0.00%,2,1,50.00%
k1-global.gslb.ksyuncdn.com,1,0.00%,2,1,50.00%
trace.qq.com,1,0.00%,2,1,50.00%
news.ssp.qq.com,1,0.00%,2,1,50.00%
pacaio.match.qq.com,1,0.00%,2,1,50.00%
whitelist.trustedservices.intel.com,1,0.00%,2,1,50.00%
mirrorcoso1.acglego-dk.sched.tdnsv2.com,1,0.00%,2,1,50.00%
apd-b701c984eb510c61fccb849afda812752d35cb4386286a96.v.smtcdns.com,1,0.00%,1,0,100.00%
page.coral.qq.com,1,0.00%,2,1,50.00%
wfqqreader-1252317822.image.myqcloud.com,1,0.00%,4,3,25.00%
entitlement.auth.adobe.com,1,0.00%,2,1,50.00%
steamcommunity.com,1,0.00%,4,3,25.00%
msg.csw.lenovo.com,1,0.00%,4,3,25.00%
peoplehub.xboxlive.com,1,0.00%,2,1,50.00%
apd-d620662384bfa659a4ddcf61b25545de329185f90ef5d08b.v.smtcdns.com,1,0.00%,1,0,100.00%
retracker.hotplug.ru,1,0.00%,1,0,100.00%
api.juejin.cn,1,0.00%,2,1,50.00%
abtestvm.bytedance.com,1,0.00%,2,1,50.00%
p1-jj.byteimg.com,1,0.00%,2,1,50.00%
p3-juejin.byteimg.com,1,0.00%,2,1,50.00%
p6-juejin.byteimg.com,1,0.00%,2,1,50.00%
p9-juejin.byteimg.com,1,0.00%,2,1,50.00%
unpkg.byted-static.com,1,0.00%,2,1,50.00%
xxbg.snssdk.com,1,0.00%,2,1,50.00%
webim.kefu.easemob.com,1,0.00%,2,1,50.00%
apd-83e227dc2d2a11bc0ca6924a38d3b7840a5b70880ef92862.v.smtcdns.com,1,0.00%,1,0,100.00%
pics5.baidu.com,1,0.00%,3,2,33.33%
cdn.heapanalytics.com,1,0.00%,2,1,50.00%
v1.addthisedge.com,1,0.00%,2,1,50.00%
streaming.split.io,1,0.00%,2,1,50.00%
ardownload3.adobe.com,1,0.00%,2,1,50.00%
se2.itunes.apple.com,1,0.00%,2,1,50.00%
tracker.cyberia.is,1,0.00%,1,0,100.00%
dldir2.qq.com,1,0.00%,4,3,25.00%
365ms.vip,1,0.00%,1,0,100.00%
apd-738b53236655db2f446e1397e6fbe275a2cf1eedd8965283.v.smtcdns.com,1,0.00%,1,0,100.00%
support.mozilla.org,1,0.00%,5,4,20.00%
services.addons.mozilla.org,1,0.00%,6,5,16.67%
contextual.media.net,1,0.00%,2,1,50.00%
mrn-backup.meituan.net,1,0.00%,2,1,50.00%
iv6.gtimg.cn,1,0.00%,2,1,50.00%
cdn-go.cn,1,0.00%,2,1,50.00%
storage.360buyimg.com,1,0.00%,2,1,50.00%
caldav.fe.apple-dns.net,1,0.00%,2,1,50.00%
vod.300hu.com,1,0.00%,2,1,50.00%
plus-static.jd.com,1,0.00%,2,1,50.00%
amp-api.apps.apple.com,1,0.00%,2,1,50.00%
storage.360buyimg.com.s.galileo.jcloud-cdn.com,1,0.00%,2,1,50.00%
search3-search-hl.toutiaoapi.com,1,0.00%,2,1,50.00%
img-1.pddpic.com,1,0.00%,2,1,50.00%
avatar2-1.pddpic.com,1,0.00%,2,1,50.00%
dl-2.pddpic.com,1,0.00%,2,1,50.00%
static-1.pddpic.com,1,0.00%,2,1,50.00%
m10.music.126.net,1,0.00%,6,5,16.67%
api.cesium.com,1,0.00%,2,1,50.00%
cesium.com,1,0.00%,2,1,50.00%
ecn.t1.tiles.virtualearth.net,1,0.00%,2,1,50.00%
ecn.t2.tiles.virtualearth.net,1,0.00%,2,1,50.00%
d4.music.126.net,1,0.00%,3,2,33.33%
picb.zhimg.com,1,0.00%,2,1,50.00%
v3-web.douyinvod.com.w.alikunlun.com,1,0.00%,2,1,50.00%
v3-ipv6.douyinvod.com,1,0.00%,2,1,50.00%
v5-ipv6.douyinvod.com,1,0.00%,2,1,50.00%
v27-ipv6.douyinvod.com,1,0.00%,2,1,50.00%
v6-ipv6.douyinvod.com,1,0.00%,2,1,50.00%
mqtt-internal-public.zhihu.com,1,0.00%,3,2,33.33%
pp.myapp.com,1,0.00%,2,1,50.00%
i5.res.meizu.com,1,0.00%,2,1,50.00%
2408-874d-300-1-8000-0-b00-99.volcsiriusbd.com,1,0.00%,1,0,100.00%
safe-apk.mzres.com,1,0.00%,2,1,50.00%
onemind.res.meizu.com,1,0.00%,2,1,50.00%
hmcdn.baidu.com,1,0.00%,2,1,50.00%
1251524319.vod2.myqcloud.com,1,0.00%,2,1,50.00%
dl.ijinshan.com,1,0.00%,4,3,25.00%
bifrost.vivaldi.com,1,0.00%,2,1,50.00%
abcjie.com,1,0.00%,1,0,100.00%
c.amap.com,1,0.00%,2,1,50.00%
e11408.d.akamaiedge.net,1,0.00%,2,1,50.00%
dsm01pap007.storage.live.com,1,0.00%,6,5,16.67%
ipv6.china.qiniu.com.trpcdn.NET,1,0.00%,2,1,50.00%
ldc-fast.lenovo.com.cn.trpcdn.NET,1,0.00%,2,1,50.00%
infoc2.duba.NET,1,0.00%,2,1,50.00%
s2.ssl.qhres2.com.qh-cdn.com,1,0.00%,2,1,50.00%
s.ssl.qhimg.com.qh-cdn.com,1,0.00%,2,1,50.00%
s2.ssl.qhres2.com.webcdn.360qhcdn.com,1,0.00%,2,1,50.00%
s.ssl.qhimg.com.webcdn.360qhcdn.com,1,0.00%,2,1,50.00%
p418.ssl.qhimgs4.com.qh-cdn.com,1,0.00%,2,1,50.00%
p419.ssl.qhimgs4.com.qh-cdn.com,1,0.00%,2,1,50.00%
p418.ssl.qhimgs4.com.webcdn.360qhcdn.com,1,0.00%,2,1,50.00%
p419.ssl.qhimgs4.com.webcdn.360qhcdn.com,1,0.00%,2,1,50.00%
p.ssl.qhimg.com.webcdn.360qhcdn.com,1,0.00%,2,1,50.00%
p420.ssl.qhimgs4.com.qh-cdn.com,1,0.00%,2,1,50.00%
qurl.qh-lb.com,1,0.00%,2,1,50.00%
p420.ssl.qhimgs4.com.webcdn.360qhcdn.com,1,0.00%,2,1,50.00%
p3.ssl.qhimgs0.com.qh-cdn.com,1,0.00%,2,1,50.00%
p3.ssl.qhimgs0.com.webcdn.360qhcdn.com,1,0.00%,2,1,50.00%
onedscolprdwus12.westus.cloudapp.azure.com,1,0.00%,12,11,8.33%
6qnz2sy8.sched.d2.tdnsdp1.cn.cjt.vwnti.yrzhcloud.cn,1,0.00%,2,1,50.00%
cma-china.itunes-apple.com.akadns.net,1,0.00%,2,1,50.00%
cma-china-cdn.itunes-apple.com.akadns.net,1,0.00%,2,1,50.00%
ecs.office.trafficmanager.net,1,0.00%,10,9,10.00%
wcdn.servyou.com.cn,1,0.00%,2,1,50.00%
wcdn.17win.com,1,0.00%,2,1,50.00%
accounts.logi.com,1,0.00%,2,1,50.00%
pc.wangpan.xycdn.n0808.com,1,0.00%,2,1,50.00%
api.stellarplayer.com,1,0.00%,2,1,50.00%
s1.biz.xunlei.com,1,0.00%,3,2,33.33%
sn.webrootcloudav.com,1,0.00%,2,1,50.00%
down1.xinshuru.com,1,0.00%,3,2,33.33%
pcmgr.lenovo.com.cn,1,0.00%,2,1,50.00%
ccdn.pddpic.com,1,0.00%,2,1,50.00%
v6-cold1.douyinvod.com,1,0.00%,2,1,50.00%
v6-cold1.douyinvod.com.download.ks-cdn.com,1,0.00%,2,1,50.00%
k2-dy-cold1-ml.gslb.ksyuncdn.com,1,0.00%,2,1,50.00%
v3-cold1.douyinvod.com,1,0.00%,2,1,50.00%
v3-cold1.douyinvod.com.w.kunluncan.com,1,0.00%,2,1,50.00%
scholar.l.google.com,1,0.00%,2,1,50.00%
y.gtimg.cn.tc.qq.com,1,0.00%,2,1,50.00%
ghs.googlehosted.com,1,0.00%,2,1,50.00%
v6-cold2.douyinvod.com.download.ks-cdn.com,1,0.00%,2,1,50.00%
k2-dy-cold2-ml.gslb.ksyuncdn.com,1,0.00%,2,1,50.00%
smartdl.lenovo.com.cn.trpcdn.net,1,0.00%,2,1,50.00%
v26-cold.douyinvod.com.c.cdnhwc1.com,1,0.00%,3,2,33.33%
hcdnv.zjtd04.v6.c.cdnhwc1.com,1,0.00%,2,1,50.00%
lf3-article.toutiaostatic.com,1,0.00%,2,1,50.00%
reading.snssdk.com,1,0.00%,2,1,50.00%
tnc3-aliec2.snssdk.com.w.cdngslb.com,1,0.00%,2,1,50.00%
pull-hls-hs-f5-tsl.douyincdn.com.yangyi19.com,1,0.00%,2,1,50.00%
bdns-dy-vod.bytegslb.com,1,0.00%,2,1,50.00%
pull-fcdn-douyin-base5.s.bytefcdn.com,1,0.00%,2,1,50.00%
wx-love-img.afunapp.com,1,0.00%,2,1,50.00%
wx-love-img.afunapp.com.w.alikunlun.com,1,0.00%,2,1,50.00%
v11-cold1.douyinvod.com.cdn.dnsv1.com,1,0.00%,2,1,50.00%
v11-cold1.sched.v4lego-dk.tdnsvod1.cn,1,0.00%,2,1,50.00%
pull-tsl-hs-spe-f5.douyincdn.com.volcgslb.com,1,0.00%,2,1,50.00%
v27.douyinvod.com,1,0.00%,2,1,50.00%
v27.douyinvod.com.vod.galileo.jcloud-cdn.com,1,0.00%,2,1,50.00%
tt-vod-sched.jcloudimg.com,1,0.00%,2,1,50.00%
v3-cold4.douyinvod.com.w.kunluncan.com,1,0.00%,2,1,50.00%
p9-tt-video-sprite-sign.byteimg.com,1,0.00%,2,1,50.00%
v6-x.toutiaovod.com,1,0.00%,2,1,50.00%
k53mrtd2.eia0.net,1,0.00%,2,1,50.00%
37darwms.eia0.net,1,0.00%,2,1,50.00%
lamguage-study.net,1,0.00%,1,0,100.00%
ims-prod06.adobelogin.com,1,0.00%,2,1,50.00%
adobelogin-origin.prod.ims.adobejanus.com,1,0.00%,2,1,50.00%
download.cntv.cn,1,0.00%,2,1,50.00%
qtx4xi8lzc.feishu.cn,1,0.00%,2,1,50.00%
gimg3.baidu.com.a.bdydns.com,1,0.00%,2,1,50.00%
pss.bdstatic.com.a.bdydns.com,1,0.00%,2,1,50.00%
m-vali.cp31.ott.cibntv.net,1,0.00%,2,1,50.00%
0.datadog.pool.ntp.org,1,0.00%,2,1,50.00%
firebaseremoteconfig.googleapis.com,1,0.00%,2,1,50.00%
sf6-cdn-tos.douyinstatic.com,1,0.00%,2,1,50.00%
v5-cold.douyinvod.com,1,0.00%,4,3,25.00%
playweb.douyu.com,1,0.00%,2,1,50.00%
dyp2p-hw.douyucdn.cn,1,0.00%,2,1,50.00%
dotab.douyucdn.cn,1,0.00%,2,1,50.00%
v86-b.douyinvod.com,1,0.00%,2,1,50.00%
download-cdn.jetbrains.com,1,0.00%,2,1,50.00%
opencdnmbdstatic.jomodns.com,1,0.00%,2,1,50.00%
gstaticadssl.l.google.com,1,0.00%,2,1,50.00%
mmsns.qpic.cn,1,0.00%,2,1,50.00%
vpic.video.qq.com,1,0.00%,2,1,50.00%
s4.cn.bing.net,1,0.00%,3,2,33.33%
img2.bosszhipin.com,1,0.00%,2,1,50.00%
pages.xiaohongshu.com,1,0.00%,2,1,50.00%
license.vod2.myqcloud.com,1,0.00%,2,1,50.00%
unpkg.zhimg.com.w.kunlunar.com,1,0.00%,2,1,50.00%
gspe19-cn-ssl.ls.apple.com,1,0.00%,2,1,50.00%
dss3.bdstatic.com,1,0.00%,2,1,50.00%
pcvideoaliyun.titan.mgtv.com.w.kunlunea.com,1,0.00%,2,1,50.00%
v5-h.douyinvod.com.zjgslb.com,1,0.00%,2,1,50.00%
v83-016.douyinvod.com.w.cdngslb.com,1,0.00%,3,2,33.33%
v5-cold.douyinvod.com.zjgslb.com,1,0.00%,2,1,50.00%
sf6-cdn-tos.douyinstatic.com.download.ks-cdn.com,1,0.00%,2,1,50.00%
img.bosszhipin.com,1,0.00%,2,1,50.00%
officecdnmac.microsoft.com,1,0.00%,2,1,50.00%
e4805.dsca.akamaiedge.net,1,0.00%,2,1,50.00%
partiality.itunes-apple.com.akadns.net,1,0.00%,3,2,33.33%
e14868.dsce9.akamaiedge.net,1,0.00%,2,1,50.00%
ah.yd01.paopaocloud.cyou,1,0.00%,2,1,50.00%
c56bo58f0a.feishu.cn,1,0.00%,2,1,50.00%
sam-material-online-1302115363.file.myqcloud.com,1,0.00%,2,1,50.00%
bnz05pap002.storage.live.com,1,0.00%,2,1,50.00%
bnz05pcor002-meta.fe.1drv.com,1,0.00%,2,1,50.00%
rtlog3-applog-lf.fqnovel.com,1,0.00%,2,1,50.00%
ascdn.baidu.com,1,0.00%,2,1,50.00%
pn.baidu.com,1,0.00%,2,1,50.00%
static-online.cdn.bcebos.com,1,0.00%,2,1,50.00%
www.oracle.com,1,0.00%,1,0,100.00%
nr-op.elemecdn.com,1,0.00%,2,1,50.00%
experiments.apple.com,1,0.00%,3,2,33.33%
v5-h.douyinvod.com,1,0.00%,2,1,50.00%
cdn.apifox.cn,1,0.00%,4,3,25.00%
mambap2pvodmobile.8686c.com,1,0.00%,2,1,50.00%
api26-normal-hl.toutiaoapi.com,1,0.00%,2,1,50.00%
abtest3-misc-hl.zijieapi.com,1,0.00%,2,1,50.00%
athena-api.oceanengine.com,1,0.00%,2,1,50.00%
vdn6.vzuu.com.v1.ksydns.com,1,0.00%,1,0,100.00%
v9-default.365yg.com,1,0.00%,4,3,25.00%
su.ff.avast.com,1,0.00%,5,4,20.00%
amp-api.media.apple.com,1,0.00%,3,2,33.33%
a1887.dscq.akamai.net.0.1.cn.akamaitech.net,1,0.00%,2,1,50.00%
h5hosting-drcn.dbankcdn.cn,1,0.00%,3,2,33.33%
pcdownaliyun.titan.mgtv.com,1,0.00%,2,1,50.00%
yunres.feidee.com,1,0.00%,2,1,50.00%
backstage-img-ssl.a.88cdn.com,1,0.00%,2,1,50.00%
ifeng3.yylady.cn,1,0.00%,2,1,50.00%
static.hamu.site,1,0.00%,2,1,50.00%
api.ithome.com,1,0.00%,2,1,50.00%
cmshow.gtimg.cn.sched.legopic2.tdnsv6.com.tpic.vwnti.yrzhcloud.cn,1,0.00%,2,1,50.00%
assets.leetcode-cn.com,1,0.00%,2,1,50.00%
mask.icloud.com,1,0.00%,2,1,50.00%
mask.apple-dns.net,1,0.00%,2,1,50.00%
ec.razer.com,1,0.00%,2,1,50.00%
pbs9fbvz.sched.skalego-dk.tdnsstic1.cn,1,0.00%,2,1,50.00%
static.leetcode-cn.com,1,0.00%,2,1,50.00%
assets.leetcode.cn,1,0.00%,2,1,50.00%
cdn-ali-file-shfront.shanhutech.cn,1,0.00%,2,1,50.00%
cdn-ali-img-shstaticbz.shanhutech.cn,1,0.00%,2,1,50.00%
shcdn-wp.shanhutech.cn,1,0.00%,2,1,50.00%
passwordsleakcheck-pa.googleapis.com,1,0.00%,2,1,50.00%
map-mobile-static.cdn.bcebos.com,1,0.00%,3,2,33.33%
webmap1.bdimg.com,1,0.00%,3,2,33.33%
webmap0.bdimg.com,1,0.00%,3,2,33.33%
map-mobile-opnimg.cdn.bcebos.com,1,0.00%,3,2,33.33%
www.googletagmanager.com,1,0.00%,4,3,25.00%
fex.bdstatic.com,1,0.00%,4,3,25.00%
opencdnzhihustatic.jomodns.com,1,0.00%,2,1,50.00%
exp-picture.cdn.bcebos.com,1,0.00%,4,3,25.00%
liveplay04.pddpic.com,1,0.00%,2,1,50.00%
liveplay.pddpic.com,1,0.00%,2,1,50.00%
live11-adapt.pddpic.com,1,0.00%,2,1,50.00%
t16img.yangkeduo.com,1,0.00%,2,1,50.00%
s3a.pstatp.com.w.kunlungr.com,1,0.00%,2,1,50.00%
sslzz.jomodns.com,1,0.00%,2,1,50.00%
l5-global.gslb.ksyuncdn.com,1,0.00%,2,1,50.00%
partnerad.l.doubleclick.net,1,0.00%,2,1,50.00%
digitalassetlinks.googleapis.com,1,0.00%,2,1,50.00%
cdn.ap.bittorrent.com,1,0.00%,2,1,50.00%
cn.gme.qcloud.com,1,0.00%,2,1,50.00%
tbm.snssdk.com,1,0.00%,2,1,50.00%
ldc-open.lenovo.com.cn,1,0.00%,2,1,50.00%
abtest.volceapplog.com,1,0.00%,2,1,50.00%
downloadnonchinacdnenabled.mcafee.com.edgekey.net,1,0.00%,2,1,50.00%
e2820.g.akamaiedge.net,1,0.00%,2,1,50.00%
dl.pop.www.duba.net.w.kunlunar.com,1,0.00%,2,1,50.00%
clock.cuhk.edu.hk,1,0.00%,1,0,100.00%
hotfix.lenovo.com.cn.trpcdn.net,1,0.00%,2,1,50.00%
gamea.clashofclans.com,1,0.00%,2,1,50.00%
youtube-ui.l.google.com,1,0.00%,2,1,50.00%
zhihu-pics-upload.zhimg.com.w.cdngslb.com,1,0.00%,2,1,50.00%
cdn.ark.qq.com.cloud.tc.qq.com,1,0.00%,2,1,50.00%
cdn.ark.qq.com.sched.legopic1.tdnsv6.com,1,0.00%,2,1,50.00%
fm.dl.126.net.w.cdngslb.com,1,0.00%,2,1,50.00%
iadsdk.apple.com.akadns.net,1,0.00%,2,1,50.00%
e7248.dscb.akamaiedge.net,1,0.00%,2,1,50.00%
etutorials.org,1,0.00%,2,1,50.00%
safebrowsing.clients.google.com,1,0.00%,2,1,50.00%
f-log-win-extension.grammarly.io,1,0.00%,2,1,50.00%
a1449.dscg2.akamai.NET,1,0.00%,2,1,50.00%
www.centbrowser.cn,1,0.00%,2,1,50.00%
su.itunes.apple.com,1,0.00%,2,1,50.00%
GoOgLe.cOm,1,0.00%,1,0,100.00%
3.rhel.pool.ntp.org,1,0.00%,1,0,100.00%
cu-cn-north00002.gala.convection.cn,1,0.00%,2,1,50.00%
ad-static-xg.tagtic.cn,1,0.00%,2,1,50.00%
df.cache.wpscdn.cn.qiniudns.com,1,0.00%,2,1,50.00%
chinaweb119.china.line.qiniudns.com,1,0.00%,2,1,50.00%
mssdk-bu.bytedance.com.w.cdngslb.com,1,0.00%,2,1,50.00%
api-access.pangolin-sdk-toutiao.com.bytedns1.com,1,0.00%,2,1,50.00%
log-api.pangolin-sdk-toutiao-b.com.bytedns1.com,1,0.00%,2,1,50.00%
log-api.pangolin-sdk-toutiao-b.com.51296c5e.c.cdnhwc1.com,1,0.00%,2,1,50.00%
ocsp.dcocsp.cn.w.kunlunar.com,1,0.00%,2,1,50.00%
toblog.ctobsnssdk.com.bytedns1.com,1,0.00%,2,1,50.00%
toblog.ctobsnssdk.com.c.dsa.cdnbuild.net,1,0.00%,2,1,50.00%
lf26-orange.byteorge.com,1,0.00%,2,1,50.00%
s.mzstatic.itunes-apple.com.akadns.net,1,0.00%,2,1,50.00%
s-china.mzstatic.itunes-apple.com.akadns.net,1,0.00%,2,1,50.00%
play-cdn.itunes-apple.com.akadns.net,1,0.00%,2,1,50.00%
play-china.itunes-apple.com.akadns.net,1,0.00%,2,1,50.00%
v5-coldb.douyinvod.com,1,0.00%,2,1,50.00%
v5-coldb.douyinvod.com.yangyi19.com,1,0.00%,2,1,50.00%
dy-vod-coldb.bytegslb.com,1,0.00%,2,1,50.00%
v3-cold2.douyinvod.com.w.kunluncan.com,1,0.00%,2,1,50.00%
analytics.oceanengine.com,1,0.00%,2,1,50.00%
summitpoint.com,1,0.00%,1,0,100.00%
xn--72cg4azcf7f5a.com,1,0.00%,1,0,100.00%
xn--tqq08gotrj03a29q3mh.com,1,0.00%,1,0,100.00%
xn--ekr37f11ht71a46cyv0dzig.com,1,0.00%,1,0,100.00%
ns2.freeparking.co.nz,1,0.00%,4,3,25.00%
jwsk-mmc.net,1,0.00%,1,0,100.00%
jwskmmc.net,1,0.00%,1,0,100.00%
candothekiwi.com,1,0.00%,1,0,100.00%
img.www.duba.net,1,0.00%,4,3,25.00%
download.mozilla.org,1,0.00%,2,1,50.00%
download-installer.cdn.mozilla.net,1,0.00%,2,1,50.00%
open.xxtor.com,1,0.00%,2,1,50.00%
paimgcdn.baidu.com,1,0.00%,2,1,50.00%
partners.tremorhub.com,1,0.00%,2,1,50.00%
d9.flashtalking.com,1,0.00%,2,1,50.00%
secure.flashtalking.com,1,0.00%,2,1,50.00%
ebad288.na.gladns.com,1,0.00%,2,1,50.00%
youjia-image.cdn.bcebos.com,1,0.00%,2,1,50.00%
youjia.cdn.bcebos.com,1,0.00%,2,1,50.00%
opencdnpicrmb.jomodns.com,1,0.00%,2,1,50.00%
all.lv2.qnydns.com,1,0.00%,2,1,50.00%
cu001.www.duba.net,1,0.00%,2,1,50.00%
archive.org,1,0.00%,4,3,25.00%
api.gitkraken.com,1,0.00%,2,1,50.00%
ilce.alicdn.com,1,0.00%,3,2,33.33%
s1.bdstatic.com,1,0.00%,3,2,33.33%
cdn.tiny.cloud,1,0.00%,2,1,50.00%
any.cdn-go.cn.sched.legopic1-dk.tdnsv6.com,1,0.00%,4,3,25.00%
lf3-baike.searchpstatp.com.w.kunluncan.com,1,0.00%,2,1,50.00%
mamasearchad.cloudvideocdn.taobao.com,1,0.00%,3,2,33.33%
s2.hdslb.com,1,0.00%,4,3,25.00%
fc6tn.baidu.com,1,0.00%,2,1,50.00%
fc2tn.baidu.com,1,0.00%,2,1,50.00%
l.sharethis.com,1,0.00%,2,1,50.00%
ws.sharethis.com,1,0.00%,2,1,50.00%
t.sharethis.com,1,0.00%,2,1,50.00%
sync.sharethis.com,1,0.00%,2,1,50.00%
s.taou.com,1,0.00%,2,1,50.00%
selfpage-voice.cdn.bcebos.com,1,0.00%,2,1,50.00%
dss2.baidu.com,1,0.00%,2,1,50.00%
dss0.baidu.com,1,0.00%,2,1,50.00%
dss1.baidu.com,1,0.00%,2,1,50.00%
p4.music.126.net.w.alikunlun.com,1,0.00%,1,0,100.00%
api5-normal-hl.toutiaoapi.com,1,0.00%,2,1,50.00%
zhstatic.zhihu.com,1,0.00%,2,1,50.00%
wallpaper-redirect-api.cqttech.com,1,0.00%,3,2,33.33%
services.arcgisonline.com,1,0.00%,2,1,50.00%
photocdn.tv.sohu.com,1,0.00%,2,1,50.00%
photocdn.sohu.com,1,0.00%,2,1,50.00%
contentcenter-drcn.dbankcdn.com,1,0.00%,3,2,33.33%
lookup-api.apple.com.edgekey.net,1,0.00%,2,1,50.00%
qzs.gdtimg.com,1,0.00%,2,1,50.00%
mail-online.nosdn.127.net,1,0.00%,2,1,50.00%
g.whatsapp.net,1,0.00%,4,3,25.00%
image.mybank.icbc.com.cn,1,0.00%,2,1,50.00%
funimg-2.pddpic.com,1,0.00%,2,1,50.00%
cd-sycdn.kuwo.cn,1,0.00%,2,1,50.00%
sf1-dycdn-tos.pstatp.com,1,0.00%,3,2,33.33%
www.gov.cn,1,0.00%,2,1,50.00%
e16991.b.akamaiedge.net,1,0.00%,2,1,50.00%
pic1.ajkimg.com,1,0.00%,2,1,50.00%
awp-assets.meituan.net,1,0.00%,2,1,50.00%
unmc.cdn.bcebos.com,1,0.00%,2,1,50.00%
ads.stickyadstv.com,1,0.00%,2,1,50.00%
ad.lkqd.net,1,0.00%,2,1,50.00%
contentstack-cdn.blzstatic.cn,1,0.00%,2,1,50.00%
vod-settings.volcvod.com,1,0.00%,2,1,50.00%
ybfcnl.com,1,0.00%,1,0,100.00%
firebase-settings.crashlytics.com,1,0.00%,2,1,50.00%
d3.music.126.net,1,0.00%,2,1,50.00%
crt.trust-provider.cn,1,0.00%,2,1,50.00%
albedozero.razerapi.com,1,0.00%,2,1,50.00%
api2.music.163.com,1,0.00%,2,1,50.00%
st.music.163.com,1,0.00%,2,1,50.00%
api3-eeft-gateway-lf.feishu.cn,1,0.00%,2,1,50.00%
imgconvert.csdnimg.cn,1,0.00%,3,2,33.33%
d3jjw9zwciori9.cloudfront.net,1,0.00%,2,1,50.00%
down3.huorong.cn.c.cdnhwc1.com,1,0.00%,2,1,50.00%
onedscolprdcus01.centralus.cloudapp.azure.com,1,0.00%,16,15,6.25%
static.realtime-bid.com,1,0.00%,2,1,50.00%
realtime-bid.xs.ak-is2.net,1,0.00%,2,1,50.00%
r2z5g8w6.stackpathcdn.com,1,0.00%,2,1,50.00%
newtab.firefoxchina.cn.lxcvc.com,1,0.00%,2,1,50.00%
p65-acsegateway.icloud.com,1,0.00%,2,1,50.00%
acsegateway.fe.apple-dns.net,1,0.00%,2,1,50.00%
mask-api.fe.apple-dns.net,1,0.00%,2,1,50.00%
deb988512c93126029cf6e22d2e49b86.dlied1.cdntips.net.tztc.cdn.qshyy.cn,1,0.00%,2,1,50.00%
sub0btw.v4672.top,1,0.00%,2,1,50.00%
settings.xboxlive.com,1,0.00%,2,1,50.00%
remotedesktop-pa.googleapis.com,1,0.00%,2,1,50.00%
vscode-update-sea.azurewebsites.NET,1,0.00%,2,1,50.00%
telemetry.influxdata.com,1,0.00%,2,1,50.00%
prod.detectportal.prod.cloudops.mozgcp.NET,1,0.00%,2,1,50.00%
wwcdn.weixin.qq.com,1,0.00%,2,1,50.00%
v3.bdxiguavod.com,1,0.00%,2,1,50.00%
lf6-vccdn.ndcpp.com,1,0.00%,2,1,50.00%
lf9-vccdn.ndcpp.com,1,0.00%,2,1,50.00%
is-lq.snssdk.com,1,0.00%,2,1,50.00%
archive.kylinos.cn,1,0.00%,2,1,50.00%
archive2.kylinos.cn,1,0.00%,2,1,50.00%
ditu.baidu.com,1,0.00%,5,4,20.00%
e2875.d.akamaiedge.net,1,0.00%,2,1,50.00%
r6ssbd3d42.feishu.cn,1,0.00%,2,1,50.00%
status.geotrust.com,1,0.00%,2,1,50.00%
torrent.fedoraproject.org,1,0.00%,2,1,50.00%
images.cnblogs.com,1,0.00%,2,1,50.00%
js.ykimg.com,1,0.00%,2,1,50.00%
gtd.alicdn.com,1,0.00%,2,1,50.00%
auth.docker.io,1,0.00%,2,1,50.00%
ocsp.digicert.cn.w.cdngslb.com,1,0.00%,2,1,50.00%
v11-x.douyinvod.com.cdn.dnsv1.com,1,0.00%,2,1,50.00%
v11-x.sched.v4lego-dk.tdnsvod1.cn,1,0.00%,2,1,50.00%
pull-hls-spe-l11.douyincdn.com.tlivecdn.com,1,0.00%,2,1,50.00%
any.cdn-go.cn.cloud.tc.qq.com,1,0.00%,2,1,50.00%
any.cdn-go.cn.mid.tdnsv6.com,1,0.00%,2,1,50.00%
pull-flv-l11.douyincdn.com.live.qcloudcdn.com,1,0.00%,2,1,50.00%
pull-fcdn-douyin-b1.b.bytefcdn.com,1,0.00%,2,1,50.00%
push-fcdn-base1.s.bytefcdn.com,1,0.00%,2,1,50.00%
pull-tsl-hs-spe-f5.douyincdn.com.230b2a2545cfa773.queniubg.com,1,0.00%,2,1,50.00%
pull-fcdn-douyin-hot1.s.bytefcdn.com,1,0.00%,2,1,50.00%
captcha.gtimg.com.cloud.tc.qq.com,1,0.00%,2,1,50.00%
captcha.gtimg.com.sched.legopic1.tdnsv6.com,1,0.00%,2,1,50.00%
cdn.doubleverify.com,1,0.00%,2,1,50.00%
akacdn.doubleverify.com.edgekey.net,1,0.00%,2,1,50.00%
j.mrpdata.net,1,0.00%,2,1,50.00%
ns.freeparking.co.nz,1,0.00%,4,3,25.00%
amixn.com,1,0.00%,1,0,100.00%
zmz22.com,1,0.00%,1,0,100.00%
d11.baidupcs.com,1,0.00%,2,1,50.00%
dsm01pcor007-meta.fe.1drv.com,1,0.00%,2,1,50.00%
o4175vz27.qnssl.com,1,0.00%,2,1,50.00%
config.officeapps.live.com,1,0.00%,2,1,50.00%
tracker.msm8916.com,1,0.00%,2,1,50.00%
e7695.g.akamaiedge.net,1,0.00%,2,1,50.00%
appdl-2-drcn.dbankcdn.com.cdn.dnsv1.com,1,0.00%,2,1,50.00%
appimg.dbankcdn.com.cdn.dnsv1.com,1,0.00%,2,1,50.00%
appdl6-drcn.dbankcdn.80800000.globalsign.c.cdnhwc1.cn,1,0.00%,2,1,50.00%
cdn.e-sscard.com,1,0.00%,2,1,50.00%
static.wecity.qq.com,1,0.00%,2,1,50.00%
weatherapi.vivo.com.cn,1,0.00%,2,1,50.00%
nbsdk-baichuan.alicdn.com,1,0.00%,2,1,50.00%
liangcang-material.alicdn.com,1,0.00%,2,1,50.00%
gecko-pangle-hl.snssdk.com,1,0.00%,2,1,50.00%
dmd-ilp-hd.youku.com,1,0.00%,2,1,50.00%
image.uczzd.cn,1,0.00%,2,1,50.00%
dorangesource.alicdn.com,1,0.00%,2,1,50.00%
f-vali.cp31.ott.cibntv.net,1,0.00%,2,1,50.00%
vali.cp31.ott.cibntv.net,1,0.00%,2,1,50.00%
un-acs.youku.com,1,0.00%,2,1,50.00%
valipl-vip.cp31.ott.cibntv.net,1,0.00%,2,1,50.00%
image.9xsecndns.cn,1,0.00%,2,1,50.00%
ipaddr.host,1,0.00%,1,0,100.00%
res-danmu.youku.com,1,0.00%,2,1,50.00%
www.mathworks.com,1,0.00%,2,1,50.00%
udc-service.mathworks.com,1,0.00%,2,1,50.00%
match.prod.bidr.io,1,0.00%,2,1,50.00%
GOOgLE.cOm,1,0.00%,2,1,50.00%
lf26-cdn-saveu-experiment2.bytetos.com,1,0.00%,2,1,50.00%
q-9999.q.dns.azurefd.net,1,0.00%,1,0,100.00%
msstestdn.sankuai.com,1,0.00%,1,0,100.00%
druid.if.qidian.com,1,0.00%,3,2,33.33%
druidv6.if.qidian.com,1,0.00%,3,2,33.33%
qdreaderpic-1252317822.picsh.myqcloud.com,1,0.00%,3,2,33.33%
bossaudioandcomic-1252317822.image.myqcloud.com,1,0.00%,3,2,33.33%
qdstatic-1252317822.file.myqcloud.com,1,0.00%,3,2,33.33%
public-1252317822.image.myqcloud.com,1,0.00%,3,2,33.33%
qdreaderpic-1252317822.file.myqcloud.com,1,0.00%,3,2,33.33%
bookcover.yuewen.com,1,0.00%,3,2,33.33%
pctest.v6.shub.sandai.net,1,0.00%,1,0,100.00%
detection.v6.shub.sandai.net,1,0.00%,1,0,100.00%
router.bittorrent.com,1,0.00%,3,2,33.33%
unitelogreport.reader.qq.com,1,0.00%,2,1,50.00%
img-pinyin.2345cdn.net,1,0.00%,2,1,50.00%
643108e7617ef.cdn.sohucs.com,1,0.00%,2,1,50.00%
GOOGle.cOM,1,0.00%,1,0,100.00%
www.youlai.cn,1,0.00%,2,1,50.00%
static.youlai.cn,1,0.00%,2,1,50.00%
static.cnkang.com,1,0.00%,2,1,50.00%
static.mediav.com,1,0.00%,2,1,50.00%
file.youlai.cn,1,0.00%,2,1,50.00%
hm.youlai.cn,1,0.00%,2,1,50.00%
pic1.58cdn.com.cn,1,0.00%,2,1,50.00%
api.feelgood.cn,1,0.00%,2,1,50.00%
edge-mqtt.facebook.com,1,0.00%,2,1,50.00%
p5.qhimg.com,1,0.00%,2,1,50.00%
analytics.meituan.net,1,0.00%,2,1,50.00%
p0.meituan.net.cdn.dnsv1.com,1,0.00%,2,1,50.00%
dl.dropbox.com,1,0.00%,2,1,50.00%
b1.bdstatic.com,1,0.00%,2,1,50.00%
i7.baidu.com,1,0.00%,2,1,50.00%
i9.baidu.com,1,0.00%,2,1,50.00%
i8.baidu.com,1,0.00%,2,1,50.00%
ss.bdimg.com,1,0.00%,2,1,50.00%
qimg.xiaohongshu.com,1,0.00%,2,1,50.00%
p0.qhmsg.com,1,0.00%,2,1,50.00%
2465841.sched.skalego-dk.tdnsstic1.cn,1,0.00%,2,1,50.00%
fundgz.1234567.com.cn,1,0.00%,2,1,50.00%
1251413404.vod2.myqcloud.com,1,0.00%,2,1,50.00%
assets.giocdn.com,1,0.00%,2,1,50.00%
extie.sogoucdn.com,1,0.00%,2,1,50.00%
qcloud.dpfile.com.cdn.dnsv1.com,1,0.00%,2,1,50.00%
staticiot.cdn.bcebos.com,1,0.00%,2,1,50.00%
nd-static.bdstatic.com,1,0.00%,2,1,50.00%
staticwx.cdn.bcebos.com,1,0.00%,2,1,50.00%
apd-4327a0d2a91173334cdc19e1e8456d41d6420ff9a7f7b03b.v.smtcdns.com,1,0.00%,1,0,100.00%
dgss0.bdstatic.com,1,0.00%,2,1,50.00%
tongji.xinmin.cn,1,0.00%,2,1,50.00%
rules.quantcount.com,1,0.00%,2,1,50.00%
chrome.google.com,1,0.00%,2,1,50.00%
pxl.qccerttest.com,1,0.00%,2,1,50.00%
ns-1404.awsdns-47.org,1,0.00%,2,1,50.00%
cd001.www.duba.net,1,0.00%,2,1,50.00%
sf0.market.xiaomi.com,1,0.00%,2,1,50.00%
cdnauth1.hpplay.cn,1,0.00%,2,1,50.00%
ts.market.mi-img.com,1,0.00%,2,1,50.00%
p6-open.byteimg.com,1,0.00%,2,1,50.00%
t4.market.mi-img.com,1,0.00%,2,1,50.00%
p3-open-sign.byteimg.com,1,0.00%,2,1,50.00%
nadvideo2.baidu.com,1,0.00%,2,1,50.00%
p1-open.byteimg.com,1,0.00%,2,1,50.00%
p6-open-sign.byteimg.com,1,0.00%,2,1,50.00%
imeres.baidu.com,1,0.00%,2,1,50.00%
www.flash.cn,1,0.00%,2,1,50.00%
tvaweibo.gslb.sinaedge.com,1,0.00%,2,1,50.00%
sthree-moa.sec.test.sankuai.com,1,0.00%,1,0,100.00%
offlinebeijing-bj.test.vip.sankuai.com,1,0.00%,1,0,100.00%
sec_edr_proc_win.dreport.sankuai.com,1,0.00%,1,0,100.00%
leopard.vip.sankuai.com,1,0.00%,1,0,100.00%
p9-open-sign.byteimg.com,1,0.00%,2,1,50.00%
p3-open.byteimg.com,1,0.00%,2,1,50.00%
alpha.alicdn.com,1,0.00%,2,1,50.00%
adt.cpatrk.net,1,0.00%,2,1,50.00%
cs02-pps-drcn.dbankcdn.cn,1,0.00%,2,1,50.00%
web.static.zhangyue01.com,1,0.00%,2,1,50.00%
book.d.ireader.com,1,0.00%,2,1,50.00%
sdx.microsoft.com,1,0.00%,2,1,50.00%
cdnauth2.hpplay.cn,1,0.00%,2,1,50.00%
ossgw.alicdn.com,1,0.00%,2,1,50.00%
china-img.soulapp.cn,1,0.00%,2,1,50.00%
game-infoc.biligame.com,1,0.00%,2,1,50.00%
webstatic.mihoyo.com,1,0.00%,2,1,50.00%
line3-s2-ios-fate.bilibiligame.net,1,0.00%,2,1,50.00%
p.biligame.com,1,0.00%,2,1,50.00%
autopatchcn.yuanshen.com,1,0.00%,2,1,50.00%
webimg.ziroom.com,1,0.00%,2,1,50.00%
epicgames-download1-1251447533.file.myqcloud.com,1,0.00%,2,1,50.00%
static-assets-prod-ue-1251447533.file.myqcloud.com,1,0.00%,2,1,50.00%
s6.music.126.net,1,0.00%,2,1,50.00%
mp.music.163.com,1,0.00%,2,1,50.00%
s7.music.126.net,1,0.00%,2,1,50.00%
p6.music.126.net,1,0.00%,2,1,50.00%
xosytser.com,1,0.00%,1,0,100.00%
ns02.000webhost.com,1,0.00%,4,3,25.00%
ns01.000webhost.com,1,0.00%,4,3,25.00%
xn--kcrxzt9yk5w.com,1,0.00%,1,0,100.00%
fanyiapp.cdn.bcebos.com,1,0.00%,2,1,50.00%
xn--5krr65a46v.com,1,0.00%,1,0,100.00%
cp801.prod.do.dsp.mp.microsoft.com.edgekey.net,1,0.00%,2,1,50.00%
e12358.g.akamaiedge.net,1,0.00%,2,1,50.00%
file.cmbimg.com,1,0.00%,2,1,50.00%
file.cmbimg.com.c.cdnhwc1.com,1,0.00%,2,1,50.00%
hcdnw120.global.c.cdnhwc6.com,1,0.00%,2,1,50.00%
cdn.pcsoftconfig.eastmoney.com,1,0.00%,2,1,50.00%
cdn.pcsoftconfig.eastmoney.com.w.kunlunpi.com,1,0.00%,2,1,50.00%
api.webtest.net.edgekey.net,1,0.00%,2,1,50.00%
down.anticheatexpert.com.wsdvs.com,1,0.00%,2,1,50.00%
updateleak.qihucdn.com.qh-cdn.com,1,0.00%,2,1,50.00%
updateleak.qihucdn.com.dl.360qhcdn.com,1,0.00%,2,1,50.00%
gspe79-cn-ssl.ls-apple.com.akadns.net,1,0.00%,2,1,50.00%
gspe79-cn-ssl.ls.apple.com.download.ks-cdn.com,1,0.00%,2,1,50.00%
k128-gspe.gslb.ksyuncdn.com,1,0.00%,2,1,50.00%
library-service.beee.live.use1a.on.epicgames.com,1,0.00%,2,1,50.00%
prod.fus.aws.intellij.net,1,0.00%,2,1,50.00%
inews.gtimg.com.sched.legopic2.tdnsv6.com,1,0.00%,2,1,50.00%
valid.origin-apple.com.akadns.net,1,0.00%,2,1,50.00%
valid-cn.origin-apple.com.akadns.net,1,0.00%,2,1,50.00%
1608223790.D4EE071FA772.device.hiwifi.com,1,0.00%,1,0,100.00%
regeneron.com,1,0.00%,2,1,50.00%
GOOGLe.CoM,1,0.00%,1,0,100.00%
download.wireguard.com,1,0.00%,4,3,25.00%
gOOglE.cOM,1,0.00%,1,0,100.00%
platformcn.maps.glbdns2.microsoft.com,1,0.00%,2,1,50.00%
0bfc822c.islide.cc.0bfc822c.c.cdnhwc1.com,1,0.00%,2,1,50.00%
hcdnwsad.gslb.c.cdnhwc2.com,1,0.00%,2,1,50.00%
ib-lq.snssdk.com,1,0.00%,2,1,50.00%
odc-dm2305-meta-geo.onedrive.akadns.NET,1,0.00%,2,1,50.00%
odc-dm2305-meta-brs.onedrive.akadns.NET,1,0.00%,2,1,50.00%
lf3-vccdn.ndcpp.com,1,0.00%,2,1,50.00%
stat.microvirt.com,1,0.00%,2,1,50.00%
file2.foxitreader.cn,1,0.00%,2,1,50.00%
tongji.foxitreader.cn,1,0.00%,2,1,50.00%
b.6sc.co,1,0.00%,2,1,50.00%
updates.devmate.com,1,0.00%,2,1,50.00%
s3-us-west-2.amazonaws.com,1,0.00%,2,1,50.00%
discovery-v6.verysync.cn,1,0.00%,1,0,100.00%
acm-prod.disqus.com,1,0.00%,2,1,50.00%
images2015.cnblogs.com,1,0.00%,2,1,50.00%
fireworks.eu.org,1,0.00%,2,1,50.00%
tracker.bitsearch.to,1,0.00%,3,2,33.33%
opentracker.acgnx.se,1,0.00%,4,3,25.00%
cds-temp.apple.com.akadns.net,1,0.00%,2,1,50.00%
ap1-ipv6.agora.io,1,0.00%,1,0,100.00%
api.vc.bilibili.com,0,0.00%,574,574,0.00%
api.github.com,0,0.00%,127,127,0.00%
www-www.bing.com.trafficmanager.net,0,0.00%,41,41,0.00%
prod.msgsearch.trafficmanager.net,0,0.00%,2,2,0.00%
get.skype.com,0,0.00%,2,2,0.00%
ios.rqd.qq.com,0,0.00%,28,28,0.00%
mozilla.org,0,0.00%,2,2,0.00%
cn-bing-com.cn.a-0001.a-msedge.net,0,0.00%,22,22,0.00%
ins-8y4ghcjp.ias.tencent-cloud.net,0,0.00%,6,6,0.00%
prod.detectportal.prod.cloudops.mozgcp.net,0,0.00%,426,426,0.00%
s-0001.s-msedge.net,0,0.00%,10,10,0.00%
home.hicloud.com,0,0.00%,338,338,0.00%
ns3-201.azure-dns.org,0,0.00%,12,12,0.00%
sa2-prod-msgsearch-1.cloudapp.net,0,0.00%,2,2,0.00%
openmsf.msf.tencent-cloud.com,0,0.00%,4,4,0.00%
livegetwesteurope.cloudapp.net,0,0.00%,2,2,0.00%
wwfile.work.weixin.qq.com,0,0.00%,160,160,0.00%
ntp.ubuntu.com,0,0.00%,8335,8335,0.00%
edge.microsoft.com,0,0.00%,901,901,0.00%
dns.msftncsi.com,0,0.00%,2859,2859,0.00%
alfred.ixiacom.com,0,0.00%,154,154,0.00%
fe2cr.update.microsoft.com,0,0.00%,57,57,0.00%
fe2cr.update.msft.com.trafficmanager.net,0,0.00%,14,14,0.00%
hdweb.mail.split.netease.com,0,0.00%,20,20,0.00%
iplc-ji.mielink-dns2.com,0,0.00%,68,68,0.00%
load-balancing-system.cmy-dns.com,0,0.00%,68,68,0.00%
gtm-sg-6wr2n62gk0f.gtm-i1d1.com,0,0.00%,60,60,0.00%
wd-prod-ss.trafficmanager.net,0,0.00%,32,32,0.00%
wd-prod-ss-as-southeast-3-fe.southeastasia.cloudapp.azure.com,0,0.00%,12,12,0.00%
k-ring.msedge.net,0,0.00%,14,14,0.00%
people.skype.com,0,0.00%,4,4,0.00%
edge-skype-com.s-0001.s-msedge.net,0,0.00%,6,6,0.00%
k-ring.k-9999.k-msedge.net,0,0.00%,4,4,0.00%
k-9999.k-msedge.net,0,0.00%,4,4,0.00%
people-service-prod-asse-arm-a.southeastasia.cloudapp.azure.com,0,0.00%,4,4,0.00%
omgup1.xiaojukeji.com,0,0.00%,48,48,0.00%
hna-router-omg-v6.xiaojukeji.com,0,0.00%,48,48,0.00%
info.pinyin.sogou.com,0,0.00%,321,321,0.00%
s-ring.msedge.net,0,0.00%,13,13,0.00%
s-ring.s-9999.s-msedge.net,0,0.00%,2,2,0.00%
s-9999.s-msedge.net,0,0.00%,2,2,0.00%
16.courier-push-apple.com.akadns.net,0,0.00%,2,2,0.00%
global.asimov.events.data.trafficmanager.net,0,0.00%,112,112,0.00%
onedscolprdcus12.centralus.cloudapp.azure.com,0,0.00%,4,4,0.00%
ns8-34.azure-dns.info,0,0.00%,8,8,0.00%
azeus1-client-s.gateway.messenger.live.com,0,0.00%,4,4,0.00%
azeus1-client-s.msnmessenger.msn.com.akadns.net,0,0.00%,2,2,0.00%
pan.baidu.com,0,0.00%,756,756,0.00%
ip.azeus1-client-s.msnmessenger.msn.com.akadns.net,0,0.00%,2,2,0.00%
4.perf.msedge.net,0,0.00%,6,6,0.00%
b-0008.b-msedge.net,0,0.00%,6,6,0.00%
www.msftncsi.com.edgesuite.net,0,0.00%,180,180,0.00%
ios.now163.com,0,0.00%,26,26,0.00%
smartscreen-prod.microsoft.com,0,0.00%,516,516,0.00%
wd-prod-ss-as-southeast-4-fe.southeastasia.cloudapp.azure.com,0,0.00%,12,12,0.00%
api.aps.skype.com,0,0.00%,4,4,0.00%
api-aps-teams.trafficmanager.net,0,0.00%,4,4,0.00%
b-aps-asea-01-skype.cloudapp.net,0,0.00%,4,4,0.00%
a.w.bilicdn1.com,0,0.00%,76,76,0.00%
bsg.w.bilicdn1.com,0,0.00%,76,76,0.00%
onetag-sys.com,0,0.00%,42,42,0.00%
pbjs.e-planning.net,0,0.00%,24,24,0.00%
connectivity-check.ubuntu.com,0,0.00%,1429,1429,0.00%
flbgpi.meiquankongjian.com,0,0.00%,26,26,0.00%
hw-web-player-tracker.biliapi.net,0,0.00%,15,15,0.00%
tm2.dns-tm.com,0,0.00%,52,52,0.00%
pico.gtm.eset.com,0,0.00%,98,98,0.00%
usa4.666670.xyz,0,0.00%,50,50,0.00%
contile.services.mozilla.com,0,0.00%,347,347,0.00%
onedscolprduks03.uksouth.cloudapp.azure.com,0,0.00%,8,8,0.00%
cn-sdyt-cu-01-26.bilivideo.com,0,0.00%,2,2,0.00%
c.tmyzer.com,0,0.00%,67,67,0.00%
weather.kjjs.360.cn,0,0.00%,24,24,0.00%
dl.min.io,0,0.00%,498,498,0.00%
tsfe.trafficmanager.net,0,0.00%,6,6,0.00%
api.opensubtitles.com,0,0.00%,4,4,0.00%
array509.prod.do.dsp.mp.microsoft.com,0,0.00%,9,9,0.00%
ns1-06.azure-dns.com,0,0.00%,2,2,0.00%
dispatch.integrate.updrv.com,0,0.00%,385,385,0.00%
a0.nic.io,0,0.00%,42,42,0.00%
az764295.vo.msecnd.net,0,0.00%,466,466,0.00%
dual-a-0036.a-msedge.net,0,0.00%,74,74,0.00%
gsas.apple.com,0,0.00%,12,12,0.00%
update-drcn.platform.hicloud.com,0,0.00%,69,69,0.00%
umwatson.events.data.microsoft.com,0,0.00%,246,246,0.00%
api.miwifi.com,0,0.00%,1063,1063,0.00%
daisy.ubuntu.com,0,0.00%,1154,1154,0.00%
dav.qq.com,0,0.00%,28,28,0.00%
browser.pipe.aria.microsoft.com,0,0.00%,8,8,0.00%
browser.events.data.trafficmanager.net,0,0.00%,4,4,0.00%
onedscolprdwus06.westus.cloudapp.azure.com,0,0.00%,6,6,0.00%
high-frequency-gray.zhhainiao.com,0,0.00%,82,82,0.00%
rq.upgrade.cmpc.cmcm.com,0,0.00%,258,258,0.00%
ocsp.digicert.com,0,0.00%,161,161,0.00%
www.mysmth.net,0,0.00%,8,8,0.00%
t.captcha.qq.com,0,0.00%,8,8,0.00%
ins-2n7ixenz.ias.tencent-cloud.net,0,0.00%,6,6,0.00%
token.rubiconproject.com,0,0.00%,4,4,0.00%
pixel.rubiconproject.net.akadns.net,0,0.00%,4,4,0.00%
dsum-sec.casalemedia.com,0,0.00%,21,21,0.00%
dsum-sec.casalemedia.com.cdn.cloudflare.net,0,0.00%,6,6,0.00%
ic3.events.data.microsoft.com,0,0.00%,4,4,0.00%
teams-events-data.trafficmanager.net,0,0.00%,2,2,0.00%
onedscolprdwus09.westus.cloudapp.azure.com,0,0.00%,4,4,0.00%
onedscolprdeus12.eastus.cloudapp.azure.com,0,0.00%,2,2,0.00%
ads.pubmatic.com,0,0.00%,8,8,0.00%
watson.telemetry.microsoft.com,0,0.00%,374,374,0.00%
dns.weixin.qq.com.cn,0,0.00%,500,500,0.00%
update100.sangfor.com.cn,0,0.00%,93,93,0.00%
rq.wpscct.cloud.duba.net,0,0.00%,14,14,0.00%
nexus.officeapps.live.com,0,0.00%,90,90,0.00%
prod-w.nexus.live.com.akadns.net,0,0.00%,14,14,0.00%
u.y.qq.com,0,0.00%,100,100,0.00%
win10.ipv6.microsoft.com,0,0.00%,523,523,0.00%
cn.patch.battle.net,0,0.00%,14,14,0.00%
mv.music.tc.qq.com,0,0.00%,99,99,0.00%
8744550.pack.tcdn.qq.com,0,0.00%,38,38,0.00%
telemetry-in.battlenet.com.cn,0,0.00%,45,45,0.00%
alb-fqpg5b5fb7n0izq8et.cn-hangzhou.alb.aliyuncs.com,0,0.00%,18,18,0.00%
weather-data.apple.com.akadns.net,0,0.00%,45,45,0.00%
github.com,0,0.00%,189,189,0.00%
ocsp2-lb.apple.com.akadns.net,0,0.00%,68,68,0.00%
ocsp2-cn-lb.apple.com.akadns.net,0,0.00%,24,24,0.00%
bluedot.is.autonavi.com.gds.alibabadns.com,0,0.00%,47,47,0.00%
m.hotmail.com,0,0.00%,16,16,0.00%
eas.outlook.com,0,0.00%,24,24,0.00%
push-rtmp-vr-f5.s.bytefcdn.com,0,0.00%,14,14,0.00%
ns1.darrellnettles.com,0,0.00%,2,2,0.00%
ns-cloud-d3.googledomains.com,0,0.00%,372,372,0.00%
cns1.hostcocoa.com,0,0.00%,4,4,0.00%
ns2.wordpress.com,0,0.00%,84,84,0.00%
ns-cloud-b4.googledomains.com,0,0.00%,344,344,0.00%
ns73.domaincontrol.com,0,0.00%,208,208,0.00%
ns04.domaincontrol.com,0,0.00%,208,208,0.00%
ns47.domaincontrol.com,0,0.00%,216,216,0.00%
perla.ns.cloudflare.com,0,0.00%,72,72,0.00%
ns2.dothome.co.kr,0,0.00%,8,8,0.00%
nsbd1.hostseba.com,0,0.00%,2,2,0.00%
anahi.ns.cloudflare.com,0,0.00%,4,4,0.00%
ns74.domaincontrol.com,0,0.00%,212,212,0.00%
cns2.hostcocoa.com,0,0.00%,4,4,0.00%
ns-cloud-b3.googledomains.com,0,0.00%,350,350,0.00%
ns48.domaincontrol.com,0,0.00%,206,206,0.00%
dns1.p01.nsone.net,0,0.00%,30,30,0.00%
ns1018.ui-dns.com,0,0.00%,12,12,0.00%
salvador.porkbun.com,0,0.00%,114,114,0.00%
ns35.domaincontrol.com,0,0.00%,373,373,0.00%
ns1.parkingcrew.net,0,0.00%,346,346,0.00%
ns07.domaincontrol.com,0,0.00%,216,216,0.00%
ns-cloud-d2.googledomains.com,0,0.00%,364,364,0.00%
steven.ns.cloudflare.com,0,0.00%,18,18,0.00%
ns1.dynadot.com,0,0.00%,168,168,0.00%
ns2.parkingcrew.net,0,0.00%,338,338,0.00%
cns3.hostcocoa.com,0,0.00%,4,4,0.00%
ns01.one.com,0,0.00%,42,42,0.00%
ns1039.ui-dns.de,0,0.00%,10,10,0.00%
ns4.a2hosting.com,0,0.00%,20,20,0.00%
sg3.webrserver.com,0,0.00%,2,2,0.00%
ns36.domaincontrol.com,0,0.00%,376,376,0.00%
curitiba.porkbun.com,0,0.00%,118,118,0.00%
ns08.domaincontrol.com,0,0.00%,226,226,0.00%
dns2.namecheaphosting.com,0,0.00%,288,288,0.00%
ns3.regery.net,0,0.00%,6,6,0.00%
ns-cloud-d4.googledomains.com,0,0.00%,366,366,0.00%
cns4.hostcocoa.com,0,0.00%,2,2,0.00%
a.gtld-servers.net,0,0.00%,4572,4572,0.00%
ns2.dynadot.com,0,0.00%,172,172,0.00%
ns02.one.com,0,0.00%,44,44,0.00%
ns3.a2hosting.com,0,0.00%,22,22,0.00%
ns1024.ui-dns.biz,0,0.00%,8,8,0.00%
dns1.powerdnsserver.com,0,0.00%,37,37,0.00%
dns1.registrar-servers.com,0,0.00%,2274,2274,0.00%
ns2.dns-parking.com,0,0.00%,562,562,0.00%
ns4.fornex.com,0,0.00%,2,2,0.00%
ns.udag.de,0,0.00%,40,40,0.00%
ns2.crazydomains.com,0,0.00%,132,132,0.00%
ns-a1.cloudnetvn.com,0,0.00%,12,12,0.00%
ns23.domaincontrol.com,0,0.00%,164,164,0.00%
dns23.hichina.com,0,0.00%,48,48,0.00%
ns50.worldnic.com,0,0.00%,6,6,0.00%
ns2.openprovider.be,0,0.00%,100,100,0.00%
ns1.dns-parking.com,0,0.00%,560,560,0.00%
ns2.orion.servidor.net.br,0,0.00%,2,2,0.00%
ns-cloud-b1.googledomains.com,0,0.00%,346,346,0.00%
ns54.domaincontrol.com,0,0.00%,128,128,0.00%
ns76.worldnic.com,0,0.00%,6,6,0.00%
ns75.worldnic.com,0,0.00%,6,6,0.00%
ns14.domaincontrol.com,0,0.00%,230,230,0.00%
ns15.wixdns.net,0,0.00%,70,70,0.00%
fg2628.online,0,0.00%,2,2,0.00%
jen.ns.cloudflare.com,0,0.00%,6,6,0.00%
ns2.matbao.com,0,0.00%,30,30,0.00%
ns3.openprovider.eu,0,0.00%,100,100,0.00%
ns-a3.cloudnetvn.com,0,0.00%,12,12,0.00%
ns3.fornex.com,0,0.00%,2,2,0.00%
ns2.fguia.com,0,0.00%,2,2,0.00%
dns2.registrar-servers.com,0,0.00%,2263,2263,0.00%
ns.udag.org,0,0.00%,38,38,0.00%
nsn1.mijndomein.nl,0,0.00%,34,34,0.00%
ns02.domaincontrol.com,0,0.00%,126,126,0.00%
ns1.crazydomains.com,0,0.00%,122,122,0.00%
eu.dnsenable.com,0,0.00%,77,77,0.00%
ns1.openprovider.nl,0,0.00%,96,96,0.00%
ns1.matbao.com,0,0.00%,30,30,0.00%
ns69.worldnic.com,0,0.00%,8,8,0.00%
triangle.dnspod.net,0,0.00%,2,2,0.00%
nsn2.mijndomein.nl,0,0.00%,32,32,0.00%
ns79.worldnic.com,0,0.00%,14,14,0.00%
ns.udag.net,0,0.00%,30,30,0.00%
ns20.worldnic.com,0,0.00%,6,6,0.00%
ns19.worldnic.com,0,0.00%,6,6,0.00%
ns2.reg.ru,0,0.00%,54,54,0.00%
ns0.centralnic.net,0,0.00%,414,414,0.00%
ns53.domaincontrol.com,0,0.00%,122,122,0.00%
fg2831.online,0,0.00%,2,2,0.00%
nsn3.mijndomein.nl,0,0.00%,34,34,0.00%
ns83.worldnic.com,0,0.00%,8,8,0.00%
ns1.hosting.reg.ru,0,0.00%,30,30,0.00%
ns-a1.tenten.vn,0,0.00%,58,58,0.00%
ns70.worldnic.com,0,0.00%,14,14,0.00%
ns4.byet.org,0,0.00%,4,4,0.00%
ns.zxcs.nl,0,0.00%,24,24,0.00%
ns2.fornex.com,0,0.00%,2,2,0.00%
dns2.powerdnsserver.com,0,0.00%,32,32,0.00%
jessica.ns.cloudflare.com,0,0.00%,16,16,0.00%
ns84.worldnic.com,0,0.00%,10,10,0.00%
ns1.hyp.net,0,0.00%,30,30,0.00%
ns.forpsi.it,0,0.00%,6,6,0.00%
ns1.vercel-dns.com,0,0.00%,6,6,0.00%
fortaleza.porkbun.com,0,0.00%,110,110,0.00%
ns10.worldnic.com,0,0.00%,10,10,0.00%
ns98.worldnic.com,0,0.00%,6,6,0.00%
item.dnspod.net,0,0.00%,4,4,0.00%
syeef.ns.cloudflare.com,0,0.00%,4,4,0.00%
ns2.hyp.net,0,0.00%,28,28,0.00%
ns2.vercel-dns.com,0,0.00%,4,4,0.00%
hkg4.edgehelper.com,0,0.00%,5,5,0.00%
thaddeus.ns.cloudflare.com,0,0.00%,10,10,0.00%
ns2.digitalocean.com,0,0.00%,44,44,0.00%
ns3.hyp.net,0,0.00%,26,26,0.00%
ns.forpsi.net,0,0.00%,6,6,0.00%
fg2832.online,0,0.00%,2,2,0.00%
ns9.worldnic.com,0,0.00%,8,8,0.00%
ns02.hostnet.nl,0,0.00%,20,20,0.00%
ns2.sagaming88.online,0,0.00%,2,2,0.00%
us.dnsenable.com,0,0.00%,80,80,0.00%
ns1.smartape.ru,0,0.00%,4,4,0.00%
ns7.wixdns.net,0,0.00%,86,86,0.00%
02.dnsv.jp,0,0.00%,94,94,0.00%
ns1.hubpgslot.online,0,0.00%,2,2,0.00%
nszero1.axc.nl,0,0.00%,2,2,0.00%
tr.dnsenable.com,0,0.00%,74,74,0.00%
ns2.smartape.ru,0,0.00%,4,4,0.00%
nsbak.pavietnam.net,0,0.00%,6,6,0.00%
ns1.reg.ru,0,0.00%,60,60,0.00%
ns3.dreamhost.com,0,0.00%,94,94,0.00%
ns6.wixdns.net,0,0.00%,88,88,0.00%
ns97.worldnic.com,0,0.00%,4,4,0.00%
ns26.domaincontrol.com,0,0.00%,130,130,0.00%
dns31.hichina.com,0,0.00%,44,44,0.00%
ns1.dan.com,0,0.00%,382,382,0.00%
ns01.domaincontrol.com,0,0.00%,122,122,0.00%
ns1.pavietnam.vn,0,0.00%,8,8,0.00%
fg2830.online,0,0.00%,2,2,0.00%
ns1.dondominio.com,0,0.00%,26,26,0.00%
ns3.digitalocean.com,0,0.00%,44,44,0.00%
ns51.worldnic.com,0,0.00%,4,4,0.00%
docks20.rzone.de,0,0.00%,14,14,0.00%
ns2.dondominio.com,0,0.00%,26,26,0.00%
ns2.dan.com,0,0.00%,384,384,0.00%
ns38.worldnic.com,0,0.00%,12,12,0.00%
aleena.ns.cloudflare.com,0,0.00%,4,4,0.00%
dns1.hichina.com,0,0.00%,32,32,0.00%
ns2.hosting.reg.ru,0,0.00%,20,20,0.00%
ns3-suspended.zxcs.de,0,0.00%,6,6,0.00%
ns2.pavietnam.vn,0,0.00%,8,8,0.00%
ns37.worldnic.com,0,0.00%,14,14,0.00%
jason.ns.cloudflare.com,0,0.00%,6,6,0.00%
ns3.vibore.com,0,0.00%,2,2,0.00%
ns-a2.conoha.io,0,0.00%,62,62,0.00%
ns52.worldnic.com,0,0.00%,4,4,0.00%
ns77.worldnic.com,0,0.00%,4,4,0.00%
ns47.worldnic.com,0,0.00%,10,10,0.00%
ns1-suspended.zxcs.nl,0,0.00%,4,4,0.00%
fg2829.online,0,0.00%,2,2,0.00%
ns80.worldnic.com,0,0.00%,14,14,0.00%
ns2.emailverification.info,0,0.00%,20,20,0.00%
ns11.worldnic.com,0,0.00%,8,8,0.00%
ns-a3.conoha.io,0,0.00%,66,66,0.00%
bingo.ns.cloudflare.com,0,0.00%,6,6,0.00%
define.dnspod.net,0,0.00%,2,2,0.00%
dns2.hichina.com,0,0.00%,32,32,0.00%
jim.ns.cloudflare.com,0,0.00%,10,10,0.00%
ns17.domaincontrol.com,0,0.00%,100,100,0.00%
ns4.xserver.jp,0,0.00%,92,92,0.00%
shades05.rzone.de,0,0.00%,6,6,0.00%
chip.ns.cloudflare.com,0,0.00%,6,6,0.00%
freejobalert2022odisha.online,0,0.00%,2,2,0.00%
cdns1.main-hosting.eu,0,0.00%,22,22,0.00%
ns1.natrohost.com,0,0.00%,88,88,0.00%
ns1115.ui-dns.org,0,0.00%,4,4,0.00%
cdns2.main-hosting.eu,0,0.00%,20,20,0.00%
ns14.worldnic.com,0,0.00%,12,12,0.00%
ns2.natrohost.com,0,0.00%,88,88,0.00%
ns60.domaincontrol.com,0,0.00%,6,6,0.00%
ns2-suspended.zxcs.be,0,0.00%,4,4,0.00%
ns119.inhostedns.com,0,0.00%,4,4,0.00%
aryanna.ns.cloudflare.com,0,0.00%,6,6,0.00%
ns7114.banahosting.com,0,0.00%,2,2,0.00%
ns1.gamepgslot.online,0,0.00%,2,2,0.00%
ns1.bluehost.com,0,0.00%,194,194,0.00%
ns1075.ui-dns.com,0,0.00%,2,2,0.00%
ns2.bluehost.com,0,0.00%,190,190,0.00%
ns93.worldnic.com,0,0.00%,8,8,0.00%
ns94.worldnic.com,0,0.00%,8,8,0.00%
ns-a3.tenten.vn,0,0.00%,56,56,0.00%
ns99.worldnic.com,0,0.00%,4,4,0.00%
ns219.inhostedns.net,0,0.00%,4,4,0.00%
dave.ns.cloudflare.com,0,0.00%,6,6,0.00%
ns-a2.tenten.vn,0,0.00%,56,56,0.00%
ns1069.ui-dns.de,0,0.00%,4,4,0.00%
sonia.ns.cloudflare.com,0,0.00%,6,6,0.00%
rose.ns.cloudflare.com,0,0.00%,6,6,0.00%
ns2.gamepgslot.online,0,0.00%,2,2,0.00%
ns14.wixdns.net,0,0.00%,67,67,0.00%
ns21.guzelhosting.com,0,0.00%,2,2,0.00%
ns319.inhostedns.org,0,0.00%,4,4,0.00%
nszero2.axc.nl,0,0.00%,2,2,0.00%
dns.pub,0,0.00%,86,86,0.00%
dns.rubyfish.cn,0,0.00%,104,104,0.00%
ns12.guzelhosting.com,0,0.00%,24,24,0.00%
darwin.ns.cloudflare.com,0,0.00%,4,4,0.00%
ns11.guzelhosting.com,0,0.00%,18,18,0.00%
ines.ns.cloudflare.com,0,0.00%,2,2,0.00%
ns1.guzelhosting.com,0,0.00%,22,22,0.00%
whsmarthome.hwcloudtest.cn,0,0.00%,303,303,0.00%
ns2.tld-ns.com,0,0.00%,4,4,0.00%
ns3.tld-ns.net,0,0.00%,4,4,0.00%
ns4.tld-ns.com,0,0.00%,4,4,0.00%
ns1.tld-ns.net,0,0.00%,4,4,0.00%
ns1.fguia.com,0,0.00%,2,2,0.00%
pdns03.domaincontrol.com,0,0.00%,14,14,0.00%
pdns04.domaincontrol.com,0,0.00%,14,14,0.00%
ns88.worldnic.com,0,0.00%,8,8,0.00%
dd.browser.360.cn,0,0.00%,137,137,0.00%
grafana.com,0,0.00%,89,89,0.00%
ns25.domaincontrol.com,0,0.00%,126,126,0.00%
dns2.onamae.com,0,0.00%,44,44,0.00%
ns.otherdns.com,0,0.00%,12,12,0.00%
ns6.myhostadmin.net,0,0.00%,14,14,0.00%
beth.ns.cloudflare.com,0,0.00%,14,14,0.00%
git.rancher.io,0,0.00%,1049,1049,0.00%
ns72.domaincontrol.com,0,0.00%,196,196,0.00%
ns4.worldnic.com,0,0.00%,6,6,0.00%
ns67.worldnic.com,0,0.00%,12,12,0.00%
ns92.worldnic.com,0,0.00%,12,12,0.00%
ns6.worldnic.com,0,0.00%,12,12,0.00%
ns24.domaincontrol.com,0,0.00%,164,164,0.00%
ns3.worldnic.com,0,0.00%,6,6,0.00%
ns2.myhostadmin.net,0,0.00%,16,16,0.00%
alfa.ns.active24.cz,0,0.00%,2,2,0.00%
ns22.worldnic.com,0,0.00%,12,12,0.00%
ns1.emailverification.info,0,0.00%,14,14,0.00%
ns68.worldnic.com,0,0.00%,12,12,0.00%
ns3.myhostadmin.net,0,0.00%,18,18,0.00%
ns5.xserver.jp,0,0.00%,92,92,0.00%
beta.ns.active24.cz,0,0.00%,2,2,0.00%
dns2.node-srv.com,0,0.00%,2,2,0.00%
vivienne.ns.cloudflare.com,0,0.00%,4,4,0.00%
ns3.contabo.net,0,0.00%,6,6,0.00%
dns4.bigrock.in,0,0.00%,6,6,0.00%
gama.ns.active24.sk,0,0.00%,2,2,0.00%
ns4.myhostadmin.net,0,0.00%,18,18,0.00%
ns5.worldnic.com,0,0.00%,10,10,0.00%
lady.ns.cloudflare.com,0,0.00%,8,8,0.00%
ns-cloud-d1.googledomains.com,0,0.00%,376,376,0.00%
ns18.domaincontrol.com,0,0.00%,104,104,0.00%
ns-530.awsdns-02.net,0,0.00%,2,2,0.00%
ns-a5.cloudnetvn.com,0,0.00%,6,6,0.00%
dns2.bigrock.in,0,0.00%,8,8,0.00%
ns1.a2phosting.com,0,0.00%,8,8,0.00%
ns5.myhostadmin.net,0,0.00%,14,14,0.00%
ns1.digitalocean.com,0,0.00%,40,40,0.00%
dina.ns.cloudflare.com,0,0.00%,4,4,0.00%
ns311.banahosting.com,0,0.00%,2,2,0.00%
ns13.domaincontrol.com,0,0.00%,222,222,0.00%
ns54.worldnic.com,0,0.00%,8,8,0.00%
ns2.contabo.net,0,0.00%,6,6,0.00%
ns2.a2phosting.com,0,0.00%,8,8,0.00%
andy.ns.cloudflare.com,0,0.00%,70,70,0.00%
ns2.aftermarket.pl,0,0.00%,12,12,0.00%
ns82.worldnic.com,0,0.00%,10,10,0.00%
ns310.banahosting.com,0,0.00%,2,2,0.00%
dns3.bigrock.in,0,0.00%,6,6,0.00%
ns59.domaincontrol.com,0,0.00%,4,4,0.00%
ns2kry.name.com,0,0.00%,16,16,0.00%
ns28.worldnic.com,0,0.00%,14,14,0.00%
corizon.online,0,0.00%,2,2,0.00%
convertitnow.online,0,0.00%,2,2,0.00%
ns1.zonedns.vn,0,0.00%,16,16,0.00%
ns4jpz.name.com,0,0.00%,6,6,0.00%
ustc-edu-cn.mirror.aliyuncs.com,0,0.00%,43,43,0.00%
ns2.jupiter.servidor.net.br,0,0.00%,2,2,0.00%
ns27.worldnic.com,0,0.00%,12,12,0.00%
melody.ns.cloudflare.com,0,0.00%,8,8,0.00%
dns1.node-srv.com,0,0.00%,2,2,0.00%
major.ns.cloudflare.com,0,0.00%,6,6,0.00%
ns3cna.name.com,0,0.00%,46,46,0.00%
mike.ns.cloudflare.com,0,0.00%,10,10,0.00%
nile.ns.cloudflare.com,0,0.00%,16,16,0.00%
ns61.worldnic.com,0,0.00%,6,6,0.00%
ns4.zonedns.vn,0,0.00%,14,14,0.00%
ns1.register.it,0,0.00%,32,32,0.00%
ns115.inhostedns.com,0,0.00%,4,4,0.00%
03.dnsv.jp,0,0.00%,96,96,0.00%
cartman.ns.cloudflare.com,0,0.00%,14,14,0.00%
dns1.onamae.com,0,0.00%,46,46,0.00%
ns62.worldnic.com,0,0.00%,6,6,0.00%
ns1.loopia.se,0,0.00%,46,46,0.00%
penny.ns.cloudflare.com,0,0.00%,2,2,0.00%
ns2.zonedns.vn,0,0.00%,16,16,0.00%
ns2.masterhost.ru,0,0.00%,2,2,0.00%
verification-acbqn49u.ns3.dan.hosting,0,0.00%,2,2,0.00%
ns81.worldnic.com,0,0.00%,10,10,0.00%
dns1.namecheaphosting.com,0,0.00%,288,288,0.00%
hayes.ns.cloudflare.com,0,0.00%,8,8,0.00%
europe-61.banahosting.com,0,0.00%,2,2,0.00%
ns12.worldnic.com,0,0.00%,6,6,0.00%
dns1.sered.net,0,0.00%,8,8,0.00%
ns71.domaincontrol.com,0,0.00%,190,190,0.00%
ns1.masterhost.ru,0,0.00%,2,2,0.00%
ns.zxcs.eu,0,0.00%,26,26,0.00%
vera.ns.cloudflare.com,0,0.00%,6,6,0.00%
ns3.stratoserver.net,0,0.00%,8,8,0.00%
lewis.ns.cloudflare.com,0,0.00%,2,2,0.00%
ns185149112215.a2dns.com,0,0.00%,2,2,0.00%
ns1108.ui-dns.biz,0,0.00%,4,4,0.00%
ns4.nic.ru,0,0.00%,14,14,0.00%
ns215.inhostedns.net,0,0.00%,4,4,0.00%
ns8.nic.ru,0,0.00%,14,14,0.00%
ns4.stratoserver.net,0,0.00%,6,6,0.00%
ns29.worldnic.com,0,0.00%,4,4,0.00%
ns.zxcs.be,0,0.00%,24,24,0.00%
ns1.value-domain.com,0,0.00%,44,44,0.00%
ns86.worldnic.com,0,0.00%,10,10,0.00%
ns1.justhost.com,0,0.00%,6,6,0.00%
alaric.ns.cloudflare.com,0,0.00%,6,6,0.00%
ns1.xserver.jp,0,0.00%,92,92,0.00%
bearishtrader.online,0,0.00%,2,2,0.00%
ns1djs.name.com,0,0.00%,4,4,0.00%
ns1.jupiter.servidor.net.br,0,0.00%,2,2,0.00%
ns36.worldnic.com,0,0.00%,6,6,0.00%
ns1.keyweb.vn,0,0.00%,2,2,0.00%
ns30.worldnic.com,0,0.00%,4,4,0.00%
ns1121.ui-dns.de,0,0.00%,2,2,0.00%
ns59.worldnic.com,0,0.00%,6,6,0.00%
ns2.sedoparking.com,0,0.00%,112,112,0.00%
ns76.domaincontrol.com,0,0.00%,226,226,0.00%
ns85.worldnic.com,0,0.00%,10,10,0.00%
ns35.worldnic.com,0,0.00%,6,6,0.00%
ns2.keyweb.vn,0,0.00%,2,2,0.00%
04.dnsv.jp,0,0.00%,96,96,0.00%
braelyn.ns.cloudflare.com,0,0.00%,6,6,0.00%
ns21.worldnic.com,0,0.00%,10,10,0.00%
ns13.worldnic.com,0,0.00%,12,12,0.00%
ns16.worldnic.com,0,0.00%,6,6,0.00%
ns01.hostnet.nl,0,0.00%,22,22,0.00%
ns2.dreamhost.com,0,0.00%,100,100,0.00%
ns1053.ui-dns.com,0,0.00%,8,8,0.00%
ns3.nic.ru,0,0.00%,14,14,0.00%
ns3npv.name.com,0,0.00%,4,4,0.00%
ns24.worldnic.com,0,0.00%,4,4,0.00%
dns28.hichina.com,0,0.00%,24,24,0.00%
ina3.registrar.eu,0,0.00%,12,12,0.00%
ns2.xserver.jp,0,0.00%,92,92,0.00%
ns15.worldnic.com,0,0.00%,6,6,0.00%
ns1121.ui-dns.org,0,0.00%,4,4,0.00%
ns1.baccarat1688s.online,0,0.00%,2,2,0.00%
ns12.inhostedns.com,0,0.00%,2,2,0.00%
ns315.inhostedns.org,0,0.00%,4,4,0.00%
ns23.worldnic.com,0,0.00%,4,4,0.00%
ns82.hostgator.com.br,0,0.00%,2,2,0.00%
ns1.dreamhost.com,0,0.00%,100,100,0.00%
ns2.cpanelhost.cl,0,0.00%,2,2,0.00%
ns41.worldnic.com,0,0.00%,12,12,0.00%
hugh.ns.cloudflare.com,0,0.00%,4,4,0.00%
ns1.youcan.shop,0,0.00%,12,12,0.00%
ns42.worldnic.com,0,0.00%,10,10,0.00%
ns1.dnsowl.com,0,0.00%,146,146,0.00%
ns2.inet.vn,0,0.00%,34,34,0.00%
ns04.domaincntrol.com,0,0.00%,22,22,0.00%
ns51.domaincontrol.com,0,0.00%,4,4,0.00%
ns1.worldnic.com,0,0.00%,8,8,0.00%
01.dnsv.jp,0,0.00%,88,88,0.00%
ns2.youcan.shop,0,0.00%,10,10,0.00%
ns1cvw.name.com,0,0.00%,26,26,0.00%
ns2.dnsowl.com,0,0.00%,146,146,0.00%
docks04.rzone.de,0,0.00%,10,10,0.00%
ns03.domaincntrol.com,0,0.00%,21,21,0.00%
ns1052.ui-dns.biz,0,0.00%,4,4,0.00%
ns52.domaincontrol.com,0,0.00%,6,6,0.00%
ns1.niagahoster.com,0,0.00%,48,48,0.00%
seupdate.360qhcdn.com,0,0.00%,12,12,0.00%
ns3022.mochahost.com,0,0.00%,2,2,0.00%
logan.ns.cloudflare.com,0,0.00%,12,12,0.00%
ns2.worldnic.com,0,0.00%,8,8,0.00%
ns1.cpanelhost.cl,0,0.00%,2,2,0.00%
ns2.kvservers.com,0,0.00%,2,2,0.00%
ns1.atomicat.pro,0,0.00%,2,2,0.00%
ns40.worldnic.com,0,0.00%,8,8,0.00%
ns4022.mochahost.com,0,0.00%,2,2,0.00%
docks16.rzone.de,0,0.00%,2,2,0.00%
ns2.atomicat.pro,0,0.00%,2,2,0.00%
d1gitech.online,0,0.00%,2,2,0.00%
shades11.rzone.de,0,0.00%,4,4,0.00%
ns1.digitalaakashsir.in,0,0.00%,2,2,0.00%
ns4.niagahoster.com,0,0.00%,2,2,0.00%
jean.ns.cloudflare.com,0,0.00%,12,12,0.00%
ns1.goviralhost.in,0,0.00%,2,2,0.00%
ns3.hostmar.com,0,0.00%,10,10,0.00%
shades04.rzone.de,0,0.00%,12,12,0.00%
rosa.ns.cloudflare.com,0,0.00%,8,8,0.00%
ns4.hostmar.com,0,0.00%,10,10,0.00%
ns1.bodis.com,0,0.00%,414,414,0.00%
ns87.worldnic.com,0,0.00%,6,6,0.00%
lilith.ns.cloudflare.com,0,0.00%,6,6,0.00%
ns1.amenworld.com,0,0.00%,12,12,0.00%
toby.ns.cloudflare.com,0,0.00%,10,10,0.00%
ns58.worldnic.com,0,0.00%,4,4,0.00%
ns2.jetorbit.net,0,0.00%,2,2,0.00%
ns3.inwx.eu,0,0.00%,8,8,0.00%
ns2.amenworld.com,0,0.00%,12,12,0.00%
ns1.siteground.net,0,0.00%,172,172,0.00%
vin.ns.cloudflare.com,0,0.00%,10,10,0.00%
ns2.dominios.uol.com.br,0,0.00%,24,24,0.00%
elliot.ns.cloudflare.com,0,0.00%,10,10,0.00%
ns8542.hostgator.com,0,0.00%,2,2,0.00%
ns7.chosting.dk,0,0.00%,2,2,0.00%
pns4.cloudns.net,0,0.00%,2,2,0.00%
ns2.inwx.de,0,0.00%,6,6,0.00%
ns2.siteground.net,0,0.00%,170,170,0.00%
ns2gtx.name.com,0,0.00%,4,4,0.00%
ns1.jetorbit.net,0,0.00%,2,2,0.00%
ns49.worldnic.com,0,0.00%,4,4,0.00%
ns.inwx.de,0,0.00%,8,8,0.00%
ns2.goviralhost.in,0,0.00%,2,2,0.00%
ns1.systemdns.com,0,0.00%,38,38,0.00%
seamus.ns.cloudflare.com,0,0.00%,4,4,0.00%
pns3.cloudns.net,0,0.00%,2,2,0.00%
ns3jkl.name.com,0,0.00%,2,2,0.00%
ns10.wixdns.net,0,0.00%,102,102,0.00%
ns34.worldnic.com,0,0.00%,8,8,0.00%
tricia.ns.cloudflare.com,0,0.00%,4,4,0.00%
ina2.registrar.eu,0,0.00%,12,12,0.00%
ns33.worldnic.com,0,0.00%,8,8,0.00%
ns4sxy.name.com,0,0.00%,4,4,0.00%
tori.ns.cloudflare.com,0,0.00%,6,6,0.00%
maceio.porkbun.com,0,0.00%,116,116,0.00%
ns4.dollarhosting.top,0,0.00%,2,2,0.00%
yew.ns.cloudflare.com,0,0.00%,6,6,0.00%
harleigh.ns.cloudflare.com,0,0.00%,2,2,0.00%
ns.forpsi.cz,0,0.00%,6,6,0.00%
ns32.worldnic.com,0,0.00%,8,8,0.00%
ns11.wixdns.net,0,0.00%,95,95,0.00%
ns31.worldnic.com,0,0.00%,6,6,0.00%
ns53.worldnic.com,0,0.00%,6,6,0.00%
ns48.worldnic.com,0,0.00%,8,8,0.00%
ns2.hostinginterface.eu,0,0.00%,2,2,0.00%
ns1.wafbone.com,0,0.00%,2,2,0.00%
ns83.hostgator.com.br,0,0.00%,2,2,0.00%
ns2.bitcoin-dns.com,0,0.00%,6,6,0.00%
bxrop.online,0,0.00%,2,2,0.00%
ns8950.banahosting.com,0,0.00%,2,2,0.00%
ns4.vibore.com,0,0.00%,2,2,0.00%
ns8951.banahosting.com,0,0.00%,2,2,0.00%
ns.dns1.co.za,0,0.00%,12,12,0.00%
ns.otherdns.net,0,0.00%,10,10,0.00%
ns.dns2.co.za,0,0.00%,12,12,0.00%
blob.dm2prdstr05a.store.core.windows.NET,0,0.00%,2,2,0.00%
ns3.dollarhosting.top,0,0.00%,2,2,0.00%
dopamineforum.online,0,0.00%,2,2,0.00%
shuc-pc-hunt.ksord.com,0,0.00%,483,483,0.00%
osfsr.lenovomm.com,0,0.00%,436,436,0.00%
ns46.worldnic.com,0,0.00%,8,8,0.00%
ns45.worldnic.com,0,0.00%,10,10,0.00%
verification-dad939df.ns3.dan.hosting,0,0.00%,2,2,0.00%
ns91.worldnic.com,0,0.00%,8,8,0.00%
doh.pub,0,0.00%,160,160,0.00%
dns.google,0,0.00%,1027,1027,0.00%
jm1.dns.com,0,0.00%,1492,1492,0.00%
jm2.dns.com,0,0.00%,1500,1500,0.00%
ns9.wixdns.net,0,0.00%,86,86,0.00%
plateau.dnspod.net,0,0.00%,2,2,0.00%
ns1.sexygamingvip.network,0,0.00%,2,2,0.00%
ns-cloud-a3.googledomains.com,0,0.00%,372,372,0.00%
sns5.hostgator.in,0,0.00%,4,4,0.00%
gabe.ns.cloudflare.com,0,0.00%,6,6,0.00%
ns-cloud-e4.googledomains.com,0,0.00%,330,330,0.00%
ns1.sedoparking.com,0,0.00%,114,114,0.00%
ns3.frienddns.net,0,0.00%,2,2,0.00%
ns5.lwsdns.com,0,0.00%,28,28,0.00%
sns6.hostgator.in,0,0.00%,4,4,0.00%
ns6.lwsdns.com,0,0.00%,28,28,0.00%
ns67.hostgator.mx,0,0.00%,2,2,0.00%
redbusprimarydns.virtualcells.net,0,0.00%,2,2,0.00%
ns-cloud-c2.googledomains.com,0,0.00%,332,332,0.00%
www.data5u.com,0,0.00%,26,26,0.00%
dns4.name-services.com,0,0.00%,56,56,0.00%
ns66.hostgator.mx,0,0.00%,2,2,0.00%
ns1.contabo.net,0,0.00%,4,4,0.00%
dns1.name-services.com,0,0.00%,56,56,0.00%
ns7.lwsdns.com,0,0.00%,26,26,0.00%
elaine.ns.cloudflare.com,0,0.00%,6,6,0.00%
ns-b.dns.versio.eu,0,0.00%,2,2,0.00%
zariyah.ns.cloudflare.com,0,0.00%,60,60,0.00%
ns2.register.it,0,0.00%,36,36,0.00%
ns4lrt.name.com,0,0.00%,4,4,0.00%
algaea.online,0,0.00%,2,2,0.00%
ns8.lwsdns.com,0,0.00%,26,26,0.00%
dns3.name-services.com,0,0.00%,60,60,0.00%
dns4.p07.nsone.net,0,0.00%,34,34,0.00%
ns37.domaincontrol.com,0,0.00%,10,10,0.00%
dns5.name-services.com,0,0.00%,62,62,0.00%
ns38.domaincontrol.com,0,0.00%,10,10,0.00%
ns-cloud-e1.googledomains.com,0,0.00%,324,324,0.00%
ns11.domaincontrol.com,0,0.00%,198,198,0.00%
ns2.niagahoster.com,0,0.00%,46,46,0.00%
broccoli.dnspod.net,0,0.00%,2,2,0.00%
ns74.worldnic.com,0,0.00%,2,2,0.00%
dns2.name-services.com,0,0.00%,54,54,0.00%
ina1.registrar.eu,0,0.00%,12,12,0.00%
ns-cloud-e2.googledomains.com,0,0.00%,340,340,0.00%
nelci.ns.cloudflare.com,0,0.00%,2,2,0.00%
ns2.hosting.co.kr,0,0.00%,18,18,0.00%
arvind.ns.cloudflare.com,0,0.00%,4,4,0.00%
sterling.ns.cloudflare.com,0,0.00%,10,10,0.00%
NS4.IRANDNS.COM,0,0.00%,2,2,0.00%
lina.ns.cloudflare.com,0,0.00%,6,6,0.00%
ns4.bestnodes.com,0,0.00%,2,2,0.00%
ns941.hostgator.com.br,0,0.00%,2,2,0.00%
ns940.hostgator.com.br,0,0.00%,2,2,0.00%
aurainnovation.online,0,0.00%,2,2,0.00%
ns2.loopia.se,0,0.00%,42,42,0.00%
nsr1.domeny.com,0,0.00%,6,6,0.00%
canal.dnspod.net,0,0.00%,2,2,0.00%
ns11.net,0,0.00%,6,6,0.00%
ns-cloud-a4.googledomains.com,0,0.00%,376,376,0.00%
raegan.ns.cloudflare.com,0,0.00%,10,10,0.00%
ns1.wordpress.com,0,0.00%,80,80,0.00%
west.ns.cloudflare.com,0,0.00%,14,14,0.00%
ns3.wordpress.com,0,0.00%,88,88,0.00%
ns2.bh-7.webhostbox.net,0,0.00%,2,2,0.00%
ns3.valueserver.com.br,0,0.00%,2,2,0.00%
addyson.ns.cloudflare.com,0,0.00%,2,2,0.00%
ns586.hostgator.com.br,0,0.00%,2,2,0.00%
apotekjatifarma.online,0,0.00%,2,2,0.00%
ns4.valueserver.com.br,0,0.00%,2,2,0.00%
ns1.bh-7.webhostbox.net,0,0.00%,2,2,0.00%
ns-1270.awsdns-30.org,0,0.00%,2,2,0.00%
ns1.valueserver.com.br,0,0.00%,2,2,0.00%
ns-149.awsdns-18.com,0,0.00%,2,2,0.00%
ns-1981.awsdns-55.co.uk,0,0.00%,2,2,0.00%
ns95.worldnic.com,0,0.00%,2,2,0.00%
ns-607.awsdns-11.net,0,0.00%,2,2,0.00%
ns96.worldnic.com,0,0.00%,2,2,0.00%
dns8.hichina.com,0,0.00%,42,42,0.00%
st.todesk.com,0,0.00%,59,59,0.00%
verification-z64rzrdh.ns3.dan.hosting,0,0.00%,2,2,0.00%
c.y.qq.com,0,0.00%,64,64,0.00%
ns-cloud-a2.googledomains.com,0,0.00%,376,376,0.00%
ns587.hostgator.com.br,0,0.00%,2,2,0.00%
cpanel53a.lws-hosting.com,0,0.00%,2,2,0.00%
ns-1543.awsdns-00.co.uk,0,0.00%,2,2,0.00%
ns-1732.awsdns-24.co.uk,0,0.00%,2,2,0.00%
ns1.netfirms.com,0,0.00%,16,16,0.00%
ns-190.awsdns-23.com,0,0.00%,2,2,0.00%
ns-678.awsdns-20.net,0,0.00%,4,4,0.00%
terin.ns.cloudflare.com,0,0.00%,14,14,0.00%
pdns2.registrar-servers.com,0,0.00%,54,54,0.00%
ns1.hover.com,0,0.00%,70,70,0.00%
ns2.netfirms.com,0,0.00%,18,18,0.00%
ns3.jino.ru,0,0.00%,6,6,0.00%
ns4.jino.ru,0,0.00%,6,6,0.00%
ns0.nl,0,0.00%,6,6,0.00%
ns1.jino.ru,0,0.00%,6,6,0.00%
ns1.huaweicloud-dns.com,0,0.00%,30,30,0.00%
ns2.jino.ru,0,0.00%,4,4,0.00%
garret.ns.cloudflare.com,0,0.00%,12,12,0.00%
jade.ns.cloudflare.com,0,0.00%,38,38,0.00%
ns2.gname.net,0,0.00%,4980,4980,0.00%
ns-cloud-c3.googledomains.com,0,0.00%,334,334,0.00%
dm1.dns.com,0,0.00%,762,762,0.00%
dm2.dns.com,0,0.00%,770,770,0.00%
ns-cloud-c4.googledomains.com,0,0.00%,334,334,0.00%
ns45.domaincontrol.com,0,0.00%,112,112,0.00%
ns1.maff.com,0,0.00%,72,72,0.00%
ns65.domaincontrol.com,0,0.00%,76,76,0.00%
ns2.livedns.co.uk,0,0.00%,22,22,0.00%
ns46.domaincontrol.com,0,0.00%,112,112,0.00%
ns2.maff.com,0,0.00%,70,70,0.00%
ns66.domaincontrol.com,0,0.00%,74,74,0.00%
ns1.dnsnw.com,0,0.00%,84,84,0.00%
ns1.gname.net,0,0.00%,4953,4953,0.00%
ns1.livedns.co.uk,0,0.00%,20,20,0.00%
ns2.dnsnw.com,0,0.00%,90,90,0.00%
ns3.livedns.co.uk,0,0.00%,22,22,0.00%
ns1.domain.com,0,0.00%,83,83,0.00%
es-cn-0pp1l8f1v001204h1.public.elasticsearch.aliyuncs.com,0,0.00%,542,542,0.00%
ns2.cp-in-19.bigrockservers.com,0,0.00%,2,2,0.00%
ns1.cp-in-19.bigrockservers.com,0,0.00%,2,2,0.00%
ns1.eftydns.com,0,0.00%,26,26,0.00%
ns2.parktons.com,0,0.00%,139,139,0.00%
ns2.eftydns.com,0,0.00%,30,30,0.00%
ninjasultan.com,0,0.00%,2,2,0.00%
ipv4only.arpa,0,0.00%,448,448,0.00%
example.org,0,0.00%,147,147,0.00%
ns3.xserver.jp,0,0.00%,88,88,0.00%
marketplace.visualstudio.com,0,0.00%,23,23,0.00%
ns3.bdm.microsoftonline.com,0,0.00%,16,16,0.00%
ns4.bdm.microsoftonline.com,0,0.00%,18,18,0.00%
localhost,0,0.00%,287,287,0.00%
localhost.localdomain,0,0.00%,7,7,0.00%
ns.parktons.com,0,0.00%,136,136,0.00%
ns3.afternic.com,0,0.00%,90,90,0.00%
ns4.afternic.com,0,0.00%,88,88,0.00%
ns0.wixdns.net,0,0.00%,74,74,0.00%
ns1.wixdns.net,0,0.00%,80,80,0.00%
x8.x9.client.api.vpngate2.jp,0,0.00%,4,4,0.00%
ns49.domaincontrol.com,0,0.00%,116,116,0.00%
ns50.domaincontrol.com,0,0.00%,116,116,0.00%
ns05.gpdns.net,0,0.00%,130,130,0.00%
ns06.gpdns.net,0,0.00%,126,126,0.00%
ctldl.windowsupdate.com,0,0.00%,877,877,0.00%
ns1043.ui-dns.com,0,0.00%,6,6,0.00%
ns1044.ui-dns.de,0,0.00%,6,6,0.00%
ns1026.ui-dns.biz,0,0.00%,4,4,0.00%
query.hicloud.com,0,0.00%,2342,2342,0.00%
ns1081.ui-dns.org,0,0.00%,4,4,0.00%
natualy.com,0,0.00%,2,2,0.00%
ns55.domaincontrol.com,0,0.00%,74,74,0.00%
ns56.domaincontrol.com,0,0.00%,76,76,0.00%
ns4.rumahweb.net,0,0.00%,22,22,0.00%
ns3.rumahweb.net,0,0.00%,24,24,0.00%
ns1.rumahweb.com,0,0.00%,20,20,0.00%
ns2.rumahweb.com,0,0.00%,24,24,0.00%
ns67.domaincontrol.com,0,0.00%,202,202,0.00%
ns68.domaincontrol.com,0,0.00%,196,196,0.00%
authds.todesk.com,0,0.00%,126,126,0.00%
v1s2.xundns.com,0,0.00%,248,248,0.00%
p2pupgrade.gamedl.qq.com,0,0.00%,65,65,0.00%
dlied6.qq.com,0,0.00%,116,116,0.00%
connc.gj.qq.com,0,0.00%,127,127,0.00%
zod.ns.cloudflare.com,0,0.00%,56,56,0.00%
anuj.ns.cloudflare.com,0,0.00%,4,4,0.00%
rachel.ns.cloudflare.com,0,0.00%,12,12,0.00%
dns1.p08.nsone.net,0,0.00%,38,38,0.00%
dns2.p08.nsone.net,0,0.00%,40,40,0.00%
dns3.p08.nsone.net,0,0.00%,38,38,0.00%
archer.ns.cloudflare.com,0,0.00%,10,10,0.00%
dns4.p08.nsone.net,0,0.00%,38,38,0.00%
pam.ns.cloudflare.com,0,0.00%,18,18,0.00%
config.gamedl.qq.com,0,0.00%,64,64,0.00%
stat.gamedl.qq.com,0,0.00%,68,68,0.00%
bjorn.ns.cloudflare.com,0,0.00%,6,6,0.00%
ns11.ns365.net,0,0.00%,2,2,0.00%
ps2.gamedl.qq.com,0,0.00%,60,60,0.00%
stun.qqlive.qq.com,0,0.00%,62,62,0.00%
meiling.ns.cloudflare.com,0,0.00%,8,8,0.00%
p2pupdate.gamedl.qq.com,0,0.00%,57,57,0.00%
plesk2.config-panel.com,0,0.00%,2,2,0.00%
duke.ns.cloudflare.com,0,0.00%,6,6,0.00%
ns9.ns365.net,0,0.00%,2,2,0.00%
ns13.truehostdns.com,0,0.00%,2,2,0.00%
ns6590.hostgator.com,0,0.00%,2,2,0.00%
bob.ns.cloudflare.com,0,0.00%,6,6,0.00%
edna.ns.cloudflare.com,0,0.00%,4,4,0.00%
ns10.ns365.net,0,0.00%,2,2,0.00%
ns6589.hostgator.com,0,0.00%,2,2,0.00%
docks07.rzone.de,0,0.00%,8,8,0.00%
faye.ns.cloudflare.com,0,0.00%,2,2,0.00%
gy2.brnt.fun,0,0.00%,115,115,0.00%
ns12.ns365.net,0,0.00%,2,2,0.00%
ns2.above.com,0,0.00%,264,264,0.00%
ns-cloud-c1.googledomains.com,0,0.00%,334,334,0.00%
ns21018.ztomy.com,0,0.00%,10,10,0.00%
win50.irandns.com,0,0.00%,2,2,0.00%
ns1.uniregistrymarket.link,0,0.00%,40,40,0.00%
ns1.panamans.com,0,0.00%,306,306,0.00%
brett.ns.cloudflare.com,0,0.00%,30,30,0.00%
ns2.panamans.com,0,0.00%,308,308,0.00%
ns2.zhaimandns.com,0,0.00%,162,162,0.00%
ns1.technogleam.in,0,0.00%,2,2,0.00%
ns1.zhaimandns.com,0,0.00%,162,162,0.00%
ns2.uniregistrymarket.link,0,0.00%,40,40,0.00%
ns11018.ztomy.com,0,0.00%,10,10,0.00%
ns5.here.ro,0,0.00%,8,8,0.00%
ns2.technogleam.in,0,0.00%,2,2,0.00%
win51.irandns.com,0,0.00%,2,2,0.00%
audrey.ns.cloudflare.com,0,0.00%,6,6,0.00%
chris.ns.cloudflare.com,0,0.00%,6,6,0.00%
ns12.wixdns.net,0,0.00%,42,42,0.00%
memphis.ns.cloudflare.com,0,0.00%,2,2,0.00%
verify-contact-details.namecheap.com,0,0.00%,81,81,0.00%
ns13.wixdns.net,0,0.00%,46,46,0.00%
ns6.here.ro,0,0.00%,8,8,0.00%
v1s1.xundns.com,0,0.00%,248,248,0.00%
ns12.domaincontrol.com,0,0.00%,202,202,0.00%
ns1.hostpapa.com,0,0.00%,10,10,0.00%
ns1.myhostadmin.net,0,0.00%,14,14,0.00%
ns-cloud-e3.googledomains.com,0,0.00%,328,328,0.00%
ns-114-a.gandi.net,0,0.00%,2,2,0.00%
ns2.hostpapa.com,0,0.00%,10,10,0.00%
ns-6-c.gandi.net,0,0.00%,4,4,0.00%
ns2.serverbos.com,0,0.00%,2,2,0.00%
ns-cloud-a1.googledomains.com,0,0.00%,386,386,0.00%
dns9.hichina.com,0,0.00%,18,18,0.00%
ns-159-b.gandi.net,0,0.00%,2,2,0.00%
ns2.squadhelp.com,0,0.00%,34,34,0.00%
dns10.hichina.com,0,0.00%,16,16,0.00%
ns1.serverbos.com,0,0.00%,2,2,0.00%
ns1051.ui-dns.biz,0,0.00%,4,4,0.00%
tennis.dnspod.net,0,0.00%,4,4,0.00%
ns1.squadhelp.com,0,0.00%,32,32,0.00%
magnolia.ns.cloudflare.com,0,0.00%,4,4,0.00%
a.root-servers.net,0,0.00%,1310,1310,0.00%
watson.ns.cloudflare.com,0,0.00%,6,6,0.00%
ns1705.websitewelcome.com,0,0.00%,2,2,0.00%
ns6.hawkhost.com,0,0.00%,10,10,0.00%
ns1706.websitewelcome.com,0,0.00%,2,2,0.00%
ns31.domaincontrol.com,0,0.00%,166,166,0.00%
ns5.hawkhost.com,0,0.00%,10,10,0.00%
ns32.domaincontrol.com,0,0.00%,168,168,0.00%
vip4.zndns.com,0,0.00%,2,2,0.00%
joan.dnspod.net,0,0.00%,10,10,0.00%
ns3.dnsowl.com,0,0.00%,140,140,0.00%
ns1.farbdenker.net,0,0.00%,2,2,0.00%
ns3.farbdenker.net,0,0.00%,2,2,0.00%
gitea.com,0,0.00%,4,4,0.00%
gitee.com,0,0.00%,66,66,0.00%
api.apple-cloudkit.fe.apple-dns.net,0,0.00%,67,67,0.00%
us-sandbox-courier-4.push-apple.com.akadns.net,0,0.00%,65,65,0.00%
time.apple.com,0,0.00%,190,190,0.00%
ns-1345.awsdns-40.org,0,0.00%,4,4,0.00%
ns-155.awsdns-19.com,0,0.00%,2,2,0.00%
mobile.events.data.microsoft.com,0,0.00%,288,288,0.00%
ns-1821.awsdns-35.co.uk,0,0.00%,4,4,0.00%
ns-874.awsdns-45.net,0,0.00%,2,2,0.00%
ns4.epik.com,0,0.00%,50,50,0.00%
dns11.hichina.com,0,0.00%,26,26,0.00%
ns77.domaincontrol.com,0,0.00%,128,128,0.00%
ns2.cargocollective.com,0,0.00%,22,22,0.00%
dns12.hichina.com,0,0.00%,28,28,0.00%
ns1.cargocollective.com,0,0.00%,22,22,0.00%
failed-whois-verification.namecheap.com,0,0.00%,90,90,0.00%
ns78.domaincontrol.com,0,0.00%,126,126,0.00%
ns1.inmotionhosting.com,0,0.00%,116,116,0.00%
ns1.virtono.com,0,0.00%,4,4,0.00%
nsb1.hostnet.com.br,0,0.00%,2,2,0.00%
maleah.ns.cloudflare.com,0,0.00%,18,18,0.00%
ns1.22.cn,0,0.00%,29,29,0.00%
nsb2.hostnet.com.br,0,0.00%,2,2,0.00%
ns2.22.cn,0,0.00%,30,30,0.00%
mitchell.ns.cloudflare.com,0,0.00%,22,22,0.00%
vip3.zndns.com,0,0.00%,2,2,0.00%
dns111.ovh.net,0,0.00%,128,128,0.00%
ns1094.ui-dns.de,0,0.00%,6,6,0.00%
nsb6.hostnet.com.br,0,0.00%,2,2,0.00%
ns1.inet.vn,0,0.00%,36,36,0.00%
ns1.irandns.com,0,0.00%,14,14,0.00%
ns111.ovh.net,0,0.00%,118,118,0.00%
ns-cloud-b2.googledomains.com,0,0.00%,348,348,0.00%
lucaseduquadros.com,0,0.00%,2,2,0.00%
ns2.irandns.com,0,0.00%,14,14,0.00%
christian.ns.cloudflare.com,0,0.00%,26,26,0.00%
cypress.dnspod.net,0,0.00%,2,2,0.00%
kanye.ns.cloudflare.com,0,0.00%,6,6,0.00%
nsb4.hostnet.com.br,0,0.00%,2,2,0.00%
ns4.domainnamedns.com,0,0.00%,28,28,0.00%
meilani.ns.cloudflare.com,0,0.00%,16,16,0.00%
ns1.wpx.net,0,0.00%,4,4,0.00%
ns3.faxdns.net,0,0.00%,4,4,0.00%
ns3.wixdns.net,0,0.00%,74,74,0.00%
ns2.wixdns.net,0,0.00%,74,74,0.00%
ns4.faxdns.net,0,0.00%,4,4,0.00%
ns1.undeveloped.com,0,0.00%,30,30,0.00%
verification-5t9ef88w.ns3.dan.hosting,0,0.00%,2,2,0.00%
ns3.wpx.net,0,0.00%,4,4,0.00%
ns2.undeveloped.com,0,0.00%,32,32,0.00%
donovan.ns.cloudflare.com,0,0.00%,42,42,0.00%
ns2.wpx.net,0,0.00%,4,4,0.00%
ns1.liquidweb.com,0,0.00%,4,4,0.00%
nsb3.hostnet.com.br,0,0.00%,2,2,0.00%
verification-e4d900f2.ns3.dan.hosting,0,0.00%,38,38,0.00%
dns1.p02.nsone.net,0,0.00%,48,48,0.00%
melany.ns.cloudflare.com,0,0.00%,42,42,0.00%
ns4.simply.com,0,0.00%,14,14,0.00%
alan.ns.cloudflare.com,0,0.00%,6,6,0.00%
ns.liquidweb.com,0,0.00%,6,6,0.00%
ns1.domain.io,0,0.00%,8,8,0.00%
ns2.domain.io,0,0.00%,8,8,0.00%
dns22.hichina.com,0,0.00%,32,32,0.00%
apple.com,0,0.00%,191,191,0.00%
api.apple-cloudkit.com,0,0.00%,95,95,0.00%
1-courier.push.apple.com,0,0.00%,86,86,0.00%
1-courier.sandbox.push.apple.com,0,0.00%,74,74,0.00%
bugly.qq.com,0,0.00%,87,87,0.00%
mail.cstnet.cn,0,0.00%,225,225,0.00%
www.microsoft.com,0,0.00%,177,177,0.00%
kallie.ns.cloudflare.com,0,0.00%,4,4,0.00%
dns3.p02.nsone.net,0,0.00%,40,40,0.00%
ns42.domaincontrol.com,0,0.00%,242,242,0.00%
dns4.p02.nsone.net,0,0.00%,42,42,0.00%
dns21.hichina.com,0,0.00%,30,30,0.00%
ns4.he.net,0,0.00%,10,10,0.00%
nsb5.hostnet.com.br,0,0.00%,2,2,0.00%
marty.ns.cloudflare.com,0,0.00%,6,6,0.00%
ns3.he.net,0,0.00%,10,10,0.00%
ns-uk.topdns.com,0,0.00%,24,24,0.00%
dns101.register.com,0,0.00%,12,12,0.00%
dns7.hichina.com,0,0.00%,42,42,0.00%
dns102.register.com,0,0.00%,12,12,0.00%
ns2.alastyr.com,0,0.00%,8,8,0.00%
ns5.he.net,0,0.00%,10,10,0.00%
ns-usa.topdns.com,0,0.00%,24,24,0.00%
ns8.wixdns.net,0,0.00%,84,84,0.00%
forward.dnstool.net,0,0.00%,4,4,0.00%
ns1.trdns.com,0,0.00%,2,2,0.00%
ns-canada.topdns.com,0,0.00%,24,24,0.00%
ns2.he.net,0,0.00%,10,10,0.00%
sandy.ns.cloudflare.com,0,0.00%,6,6,0.00%
ns3.dns.com,0,0.00%,16,16,0.00%
aisha.ns.cloudflare.com,0,0.00%,32,32,0.00%
ns10.hawkhost.com,0,0.00%,10,10,0.00%
ns3.zonedns.vn,0,0.00%,14,14,0.00%
ns1.he.net,0,0.00%,10,10,0.00%
ns2021.websiteservername.com,0,0.00%,2,2,0.00%
ns4.dns.com,0,0.00%,16,16,0.00%
ns9.hawkhost.com,0,0.00%,8,8,0.00%
john.ns.cloudflare.com,0,0.00%,14,14,0.00%
ns4.koryfi.com,0,0.00%,2,2,0.00%
iris.ns.cloudflare.com,0,0.00%,6,6,0.00%
ns1050.hostgator.com.br,0,0.00%,2,2,0.00%
salvador.ns.cloudflare.com,0,0.00%,34,34,0.00%
ns2.domain.com,0,0.00%,82,82,0.00%
tia.ns.cloudflare.com,0,0.00%,10,10,0.00%
ns3.koryfi.com,0,0.00%,2,2,0.00%
alexis.ns.cloudflare.com,0,0.00%,18,18,0.00%
ns1028.ui-dns.org,0,0.00%,6,6,0.00%
terry.ns.cloudflare.com,0,0.00%,6,6,0.00%
plesk1.config-panel.com,0,0.00%,2,2,0.00%
ns3.second-ns.de,0,0.00%,14,14,0.00%
raquel.ns.cloudflare.com,0,0.00%,18,18,0.00%
ns1097.ui-dns.de,0,0.00%,2,2,0.00%
ns.second-ns.com,0,0.00%,14,14,0.00%
ns2022.websiteservername.com,0,0.00%,2,2,0.00%
ns1117.ui-dns.biz,0,0.00%,2,2,0.00%
ns1.your-server.de,0,0.00%,14,14,0.00%
ns2.dotvndns.vn,0,0.00%,2,2,0.00%
ns7.cnmsn.net,0,0.00%,6,6,0.00%
ns1055.ui-dns.com,0,0.00%,8,8,0.00%
ns1065.hostgator.com.br,0,0.00%,2,2,0.00%
ns1064.hostgator.com.br,0,0.00%,2,2,0.00%
ns8.cnmsn.net,0,0.00%,8,8,0.00%
ns1.above.com,0,0.00%,268,268,0.00%
ns2.inmotionhosting.com,0,0.00%,118,118,0.00%
boyd.ns.cloudflare.com,0,0.00%,8,8,0.00%
nola.ns.cloudflare.com,0,0.00%,8,8,0.00%
ns1.mixhost.jp,0,0.00%,22,22,0.00%
ns2.mixhost.jp,0,0.00%,22,22,0.00%
dns15.hichina.com,0,0.00%,34,34,0.00%
now1.dns.com,0,0.00%,70,70,0.00%
now2.dns.com,0,0.00%,68,68,0.00%
ns1.mywahosting.com,0,0.00%,10,10,0.00%
dns16.hichina.com,0,0.00%,36,36,0.00%
ns2.mywahosting.com,0,0.00%,10,10,0.00%
gannon.ns.cloudflare.com,0,0.00%,2,2,0.00%
joan.ns.cloudflare.com,0,0.00%,6,6,0.00%
ns25.dnsdhs.com,0,0.00%,2,2,0.00%
natasha.ns.cloudflare.com,0,0.00%,6,6,0.00%
khalid.ns.cloudflare.com,0,0.00%,8,8,0.00%
ns41.domaincontrol.com,0,0.00%,242,242,0.00%
casey.ns.cloudflare.com,0,0.00%,8,8,0.00%
ns1.supercp.com,0,0.00%,10,10,0.00%
monovm.mars.orderbox-dns.com,0,0.00%,22,22,0.00%
alberto.ns.cloudflare.com,0,0.00%,6,6,0.00%
ns2.bodis.com,0,0.00%,412,412,0.00%
meera.ns.cloudflare.com,0,0.00%,10,10,0.00%
millie.ns.cloudflare.com,0,0.00%,6,6,0.00%
monovm.earth.orderbox-dns.com,0,0.00%,22,22,0.00%
ns1.simply.com,0,0.00%,16,16,0.00%
ns26.dnsdhs.com,0,0.00%,2,2,0.00%
monovm.mercury.orderbox-dns.com,0,0.00%,22,22,0.00%
ns3.simply.com,0,0.00%,16,16,0.00%
monovm.venus.orderbox-dns.com,0,0.00%,22,22,0.00%
ns1.ecpage.com,0,0.00%,22,22,0.00%
bruce.dnspod.net,0,0.00%,2,2,0.00%
kellen.ns.cloudflare.com,0,0.00%,16,16,0.00%
ns-1360.awsdns-42.org,0,0.00%,2,2,0.00%
ns2.ecpage.com,0,0.00%,24,24,0.00%
duba-defend.zhhainiao.com,0,0.00%,342,342,0.00%
herbert.dnspod.net,0,0.00%,2,2,0.00%
selah.ns.cloudflare.com,0,0.00%,24,24,0.00%
ns-375.awsdns-46.com,0,0.00%,2,2,0.00%
ns-777.awsdns-33.net,0,0.00%,2,2,0.00%
indie.ns.cloudflare.com,0,0.00%,4,4,0.00%
dns1.p04.nsone.net,0,0.00%,32,32,0.00%
dns2.p04.nsone.net,0,0.00%,28,28,0.00%
ns1.dianadns.com,0,0.00%,2,2,0.00%
ns3.dianadns.com,0,0.00%,2,2,0.00%
ns3.zonedata.net,0,0.00%,2,2,0.00%
ns16.hostlab.net.tr,0,0.00%,2,2,0.00%
celeste.ns.cloudflare.com,0,0.00%,54,54,0.00%
dns4.p04.nsone.net,0,0.00%,30,30,0.00%
ns15.hostlab.net.tr,0,0.00%,2,2,0.00%
ns2.nakroteck.net,0,0.00%,2,2,0.00%
ns-772.awsdns-32.net,0,0.00%,4,4,0.00%
ns-1735.awsdns-24.co.uk,0,0.00%,2,2,0.00%
ns10.dnshoster.net,0,0.00%,3,3,0.00%
ns-347.awsdns-43.com,0,0.00%,2,2,0.00%
ns1.6688dns.com,0,0.00%,14,14,0.00%
gloria.ns.cloudflare.com,0,0.00%,6,6,0.00%
irma.ns.cloudflare.com,0,0.00%,8,8,0.00%
ns2.6688dns.com,0,0.00%,14,14,0.00%
nameserver01.mi.com.co,0,0.00%,2,2,0.00%
rohin.ns.cloudflare.com,0,0.00%,8,8,0.00%
konnor.ns.cloudflare.com,0,0.00%,18,18,0.00%
nameserver03.mi.com.co,0,0.00%,2,2,0.00%
ns1.nakroteck.net,0,0.00%,2,2,0.00%
ns5.wixdns.net,0,0.00%,74,74,0.00%
nameserver02.mi.com.co,0,0.00%,2,2,0.00%
ns4.nakroteck.net,0,0.00%,2,2,0.00%
ns4.wixdns.net,0,0.00%,76,76,0.00%
nameserver04.mi.com.co,0,0.00%,2,2,0.00%
ns1.linuxreseller.in,0,0.00%,2,2,0.00%
ns4.dnsv2.com,0,0.00%,4,4,0.00%
ns3.nakroteck.net,0,0.00%,2,2,0.00%
ns2.linuxreseller.in,0,0.00%,2,2,0.00%
dns1.hostgator.com.br,0,0.00%,16,16,0.00%
ns3.nazwa.pl,0,0.00%,4,4,0.00%
dns2.hostgator.com.br,0,0.00%,16,16,0.00%
ns2.zone.ee,0,0.00%,2,2,0.00%
ns1.nazwa.pl,0,0.00%,2,2,0.00%
ns.zone.eu,0,0.00%,2,2,0.00%
ns2.nazwa.pl,0,0.00%,2,2,0.00%
blob.bnz10prdstr19a.store.core.windows.NET,0,0.00%,2,2,0.00%
p.f.360.cn,0,0.00%,66,66,0.00%
vipapi.wps.cn,0,0.00%,145,145,0.00%
21-courier.push.apple.com,0,0.00%,18,18,0.00%
27-courier.push.apple.com,0,0.00%,18,18,0.00%
rq.upgrade.drivergenius.com,0,0.00%,86,86,0.00%
www.tp-link.com,0,0.00%,34,34,0.00%
34-courier.push.apple.com,0,0.00%,12,12,0.00%
clock.fmt.he.net,0,0.00%,25,25,0.00%
edragent.sangfor.com.cn,0,0.00%,702,702,0.00%
40-courier.push.apple.com,0,0.00%,16,16,0.00%
datacluster4.cipsup.cn,0,0.00%,4,4,0.00%
www.youngzsoft.com,0,0.00%,26,26,0.00%
sf.symcb.com,0,0.00%,14,14,0.00%
www.qq.com,0,0.00%,2866,2866,0.00%
note.youdao.com,0,0.00%,760,760,0.00%
softbus-device.wps.cn,0,0.00%,47,47,0.00%
shuc-other.ksord.com,0,0.00%,35,35,0.00%
task.browser.360.cn,0,0.00%,71,71,0.00%
wup.browser.qq.com,0,0.00%,115,115,0.00%
s.360.cn,0,0.00%,137,137,0.00%
p3p.sogou.com,0,0.00%,211,211,0.00%
slp2p-east-std18.oray.net,0,0.00%,1,1,0.00%
sl-log.oray.net,0,0.00%,58,58,0.00%
win8.ipv6.microsoft.com,0,0.00%,141,141,0.00%
88dsf5l.003.1.mclqp.link,0,0.00%,94,94,0.00%
www.edusahoo.com,0,0.00%,22,22,0.00%
pub.idqqimg.com,0,0.00%,180,180,0.00%
ncc.avast.com,0,0.00%,35,35,0.00%
us04.19910501.xyz,0,0.00%,4,4,0.00%
jp.tiarap.org,0,0.00%,21,21,0.00%
tw01.19910501.xyz,0,0.00%,4,4,0.00%
tw02.19910501.xyz,0,0.00%,3,3,0.00%
kr01.19910501.xyz,0,0.00%,4,4,0.00%
us01.19910501.xyz,0,0.00%,4,4,0.00%
sg02.19910501.xyz,0,0.00%,4,4,0.00%
hk07.19910501.xyz,0,0.00%,4,4,0.00%
pk01.19910501.xyz,0,0.00%,4,4,0.00%
hk03.19910501.xyz,0,0.00%,4,4,0.00%
hk04.19910501.xyz,0,0.00%,4,4,0.00%
hk06.19910501.xyz,0,0.00%,8,8,0.00%
hk01.19910501.xyz,0,0.00%,4,4,0.00%
kns.duba.net,0,0.00%,44,44,0.00%
tw04.19910501.xyz,0,0.00%,4,4,0.00%
www.jd.com,0,0.00%,552,552,0.00%
sg01.19910501.xyz,0,0.00%,6,6,0.00%
ind01.19910501.xyz,0,0.00%,4,4,0.00%
sl-tk.oray.com,0,0.00%,542,542,0.00%
nl01.19910501.xyz,0,0.00%,4,4,0.00%
th01.19910501.xyz,0,0.00%,4,4,0.00%
ars.19910501.xyz,0,0.00%,4,4,0.00%
us05.19910501.xyz,0,0.00%,4,4,0.00%
jp01.19910501.xyz,0,0.00%,4,4,0.00%
apd-pcdnwxstat.teg.tencent-cloud.net,0,0.00%,73,73,0.00%
stat.y.qq.com,0,0.00%,99,99,0.00%
client-api.oray.com,0,0.00%,43,43,0.00%
6ahddutb1ucc3cp.ru,0,0.00%,149,149,0.00%
im.eulix.xyz,0,0.00%,122,122,0.00%
qingcenter.wps.cn,0,0.00%,289,289,0.00%
www.csdn.net,0,0.00%,398,398,0.00%
jp02.19910501.xyz,0,0.00%,4,4,0.00%
jp03.19910501.xyz,0,0.00%,4,4,0.00%
jp04.19910501.xyz,0,0.00%,4,4,0.00%
frenchofengland.ace.fordham.edu,0,0.00%,1,1,0.00%
api.cloud.tenda.com.cn,0,0.00%,88,88,0.00%
hkb.cloudnnnn.com,0,0.00%,176,176,0.00%
c.pcs.baidu.com,0,0.00%,14,14,0.00%
lp.open.weixin.qq.com,0,0.00%,29,29,0.00%
gsp64-ssl.ls.apple.com,0,0.00%,46,46,0.00%
i.163.com,0,0.00%,22,22,0.00%
bash.givemexyz.in,0,0.00%,243,243,0.00%
api.distill.io,0,0.00%,32,32,0.00%
tile-service.weather.microsoft.com,0,0.00%,264,264,0.00%
shdf01-iopq.cgroads.com,0,0.00%,45,45,0.00%
i.y.qq.com,0,0.00%,20,20,0.00%
pingfore.qq.com,0,0.00%,18,18,0.00%
stat6.y.qq.com,0,0.00%,26,26,0.00%
tmead.y.qq.com,0,0.00%,10,10,0.00%
adstats.tencentmusic.com,0,0.00%,12,12,0.00%
fp.msedge.net,0,0.00%,20,20,0.00%
wp.safe.360.cn,0,0.00%,464,464,0.00%
dd.mse.360.cn,0,0.00%,8,8,0.00%
socm.dmp.360.cn,0,0.00%,81,81,0.00%
nleditor.osi.office.net,0,0.00%,29,29,0.00%
apd-pcdnwxlogin.teg.tencent-cloud.net,0,0.00%,65,65,0.00%
t.kite.com,0,0.00%,25,25,0.00%
puv.tt.browser.360.cn,0,0.00%,106,106,0.00%
szextshort.weixin.qq.com,0,0.00%,84,84,0.00%
fm.dl.126.net,0,0.00%,8,8,0.00%
notice.bigbigwork.com,0,0.00%,1,1,0.00%
deault-exp-tas-com.e-0014.e-msedge.net,0,0.00%,64,64,0.00%
h5.qzone.qq.com,0,0.00%,514,514,0.00%
uapi.mp.360.cn,0,0.00%,60,60,0.00%
stat.sd.360.cn,0,0.00%,12,12,0.00%
api.aliyundrive.com,0,0.00%,27,27,0.00%
gm.gds.mmstat.com,0,0.00%,6,6,0.00%
repo.hortonworks.com,0,0.00%,19,19,0.00%
gameplay.intel.com,0,0.00%,47,47,0.00%
rq.upgrade.lbmini.cmcm.com,0,0.00%,66,66,0.00%
catalog-public-service-prod06.ol.epicgames.com,0,0.00%,7,7,0.00%
st.p.360.cn,0,0.00%,28,28,0.00%
agd2.p.360.cn,0,0.00%,51,51,0.00%
inisdup.qihucdn.com,0,0.00%,12,12,0.00%
tr.p.360.cn,0,0.00%,47,47,0.00%
agt.p.360.cn,0,0.00%,49,49,0.00%
priceengine-public-service-ecomprod01.ol.epicgames.com,0,0.00%,4,4,0.00%
v2.get.sogou.com,0,0.00%,69,69,0.00%
music.migu.cn,0,0.00%,3,3,0.00%
api.blockcypher.com,0,0.00%,13,13,0.00%
www.weiyun.com,0,0.00%,45,45,0.00%
ssl.ptlogin2.qq.com,0,0.00%,13,13,0.00%
report.huatuo.qq.com,0,0.00%,8,8,0.00%
aegis.qq.com,0,0.00%,51,51,0.00%
p.bigbigwork.com,0,0.00%,8,8,0.00%
www.bigbigwork.com,0,0.00%,7,7,0.00%
api.safe.360.cn,0,0.00%,100,100,0.00%
www6.53kf.com,0,0.00%,18,18,0.00%
accwww6.53kf.com,0,0.00%,18,18,0.00%
update.pan.baidu.com,0,0.00%,121,121,0.00%
ceea167a5a36dedd.jijifun.com,0,0.00%,30,30,0.00%
edifice.opencityapps.org,0,0.00%,1,1,0.00%
db.local.clamav.net,0,0.00%,103,103,0.00%
get.sogou.com,0,0.00%,534,534,0.00%
update.ydxz.com,0,0.00%,6,6,0.00%
time.nist.gov,0,0.00%,27,27,0.00%
mini.wps.cn,0,0.00%,4,4,0.00%
counter.ksosoft.com,0,0.00%,6,6,0.00%
remotedev.oa.com,0,0.00%,6,6,0.00%
slb-browser-traffic.mbgcdn.lenovo.com.cn,0,0.00%,10,10,0.00%
cloudrest.mbgcdn.lenovo.com.cn,0,0.00%,10,10,0.00%
p3n9w31.cloud,0,0.00%,16,16,0.00%
imap.mail.yahoo.com,0,0.00%,9,9,0.00%
catalog.gamepass.com,0,0.00%,289,289,0.00%
minorshort.weixin.qq.com,0,0.00%,97,97,0.00%
api.snapcraft.io,0,0.00%,85,85,0.00%
rq.wh.cmcm.com,0,0.00%,448,448,0.00%
al04.bb.wdpdk.link,0,0.00%,12,12,0.00%
sos.x-rcs.com,0,0.00%,2,2,0.00%
conf.wsm.360.cn,0,0.00%,69,69,0.00%
s.f.360.cn,0,0.00%,741,741,0.00%
apd-pcdnwxnat.teg.tencent-cloud.net,0,0.00%,78,78,0.00%
array507.prod.do.dsp.mp.microsoft.com,0,0.00%,8,8,0.00%
shortconn.im.qcloud.com,0,0.00%,114,114,0.00%
www.megatorrents.kg,0,0.00%,4,4,0.00%
tracker.moeblog.cn,0,0.00%,2,2,0.00%
launcher-public-service-prod06.ol.epicgames.com,0,0.00%,10,10,0.00%
szdx.txddns.cn,0,0.00%,10,10,0.00%
us08.graniterapids.com,0,0.00%,1,1,0.00%
classify-client.services.mozilla.com,0,0.00%,32,32,0.00%
t.acg.rip,0,0.00%,5,5,0.00%
hub5p.sandai.net,0,0.00%,770,770,0.00%
retracker.mgts.by,0,0.00%,80,80,0.00%
channel-account-ssl.xunlei.com,0,0.00%,7,7,0.00%
www.yahoo.com,0,0.00%,74,74,0.00%
adse.ximalaya.com,0,0.00%,8,8,0.00%
hk.tcpbbr.net,0,0.00%,14,14,0.00%
static-pcs-sdk-server.alibaba.com,0,0.00%,14,14,0.00%
clock.isc.org,0,0.00%,10,10,0.00%
jrebel.npegeek.com,0,0.00%,23,23,0.00%
k8s.gcr.io,0,0.00%,277,277,0.00%
itunes.com,0,0.00%,6,6,0.00%
time.g.aaplimg.com,0,0.00%,119,119,0.00%
time.windows.com,0,0.00%,73,73,0.00%
bl6pap003.storage.live.com,0,0.00%,9,9,0.00%
onedriveclucprodbn20039.blob.core.windows.net,0,0.00%,5,5,0.00%
az700632.vo.msecnd.net,0,0.00%,51,51,0.00%
h-adashx.ut.taobao.com,0,0.00%,278,278,0.00%
extshort.weixin.qq.com,0,0.00%,137,137,0.00%
pc-plugin-plg.wpscdn.cn,0,0.00%,198,198,0.00%
ins-qw3q8ofk.ias.tencent-cloud.NET,0,0.00%,16,16,0.00%
www.google.com,0,0.00%,373,373,0.00%
p218-quota.icloud.com.cn,0,0.00%,3,3,0.00%
edgedl.me.gvt1.com,0,0.00%,61,61,0.00%
checkappexec.microsoft.com,0,0.00%,170,170,0.00%
analysis-acc-ssl.xunlei.com,0,0.00%,14,14,0.00%
api.cloud.huawei.com,0,0.00%,16,16,0.00%
oauth-login-drcn.platform.dbankcloud.com,0,0.00%,39,39,0.00%
hwid-drcn.platform.hicloud.com,0,0.00%,43,43,0.00%
hivoice-drcn.emui.dbankcloud.com,0,0.00%,10,10,0.00%
c2.pcs.baidu.com,0,0.00%,27,27,0.00%
metrics1-drcn.dt.dbankcloud.cn,0,0.00%,45,45,0.00%
nexusrules.officeapps.live.com,0,0.00%,368,368,0.00%
tconf.f.360.cn,0,0.00%,174,174,0.00%
gtm-djjs.2345.com,0,0.00%,6,6,0.00%
activity.windows.com,0,0.00%,73,73,0.00%
continuum.dds.microsoft.com,0,0.00%,18,18,0.00%
short.weixin.qq.com,0,0.00%,65,65,0.00%
fb98ab9159f51fd0.jijifun.com,0,0.00%,36,36,0.00%
7a37563370ded05f.jijifun.com,0,0.00%,12,12,0.00%
broadcast2.distill.io,0,0.00%,28,28,0.00%
www.jetbrains.com,0,0.00%,64,64,0.00%
account.jetbrains.com,0,0.00%,40,40,0.00%
qdun-data.qq.com,0,0.00%,40,40,0.00%
qd-update.qq.com,0,0.00%,32,32,0.00%
wcjs.sbj.cnipa.gov.cn,0,0.00%,8,8,0.00%
ue.mbgstore.lenovo.com.cn,0,0.00%,12,12,0.00%
hub5sr.v6.shub.sandai.net,0,0.00%,10,10,0.00%
plus.wps.cn,0,0.00%,24,24,0.00%
cidian.youdao.com,0,0.00%,14,14,0.00%
t2.pow7.com,0,0.00%,20,20,0.00%
0d.kebhana.mx,0,0.00%,6,6,0.00%
tracker.nanoha.org,0,0.00%,6,6,0.00%
www.tvnihon.com,0,0.00%,29,29,0.00%
www.yuwabits.net,0,0.00%,15,15,0.00%
www.googleapis.com,0,0.00%,99,99,0.00%
ww62.uatracker.net,0,0.00%,16,16,0.00%
all4nothin.net,0,0.00%,2,2,0.00%
public.dns.iij.jp,0,0.00%,152,152,0.00%
dns.twnic.tw,0,0.00%,74,74,0.00%
hao.lenovo.com.cn,0,0.00%,22,22,0.00%
cloud-rest.lenovomm.com,0,0.00%,34,34,0.00%
public1.114dns.com,0,0.00%,27,27,0.00%
ip-info.ff.avast.com,0,0.00%,12,12,0.00%
analytics.ff.avast.com,0,0.00%,8,8,0.00%
upd.sangfor.com.cn,0,0.00%,244,244,0.00%
auth2.sangfor.com.cn,0,0.00%,11,11,0.00%
hb-b.services.vnc.com,0,0.00%,70,70,0.00%
hb-a.services.vnc.com,0,0.00%,74,74,0.00%
hb-c.services.vnc.com,0,0.00%,79,79,0.00%
fclick.baidu.com,0,0.00%,46,46,0.00%
xgpolardb.mysql.polardb.rds.aliyuncs.com,0,0.00%,2226,2226,0.00%
openbenchmarking.org,0,0.00%,48,48,0.00%
skydrive.wns.windows.com,0,0.00%,65,65,0.00%
assets.contentstack.io,0,0.00%,438,438,0.00%
c.hljzfkyy.com,0,0.00%,463,463,0.00%
tt.browser.360.cn,0,0.00%,63,63,0.00%
cloud.browser.360.cn,0,0.00%,182,182,0.00%
mini.browser.360.cn,0,0.00%,138,138,0.00%
mbsug.ssl.so.com,0,0.00%,20,20,0.00%
app.huabao.360.cn,0,0.00%,56,56,0.00%
map.baidu.com,0,0.00%,71,71,0.00%
online.s.xzdesktop.cqttech.com,0,0.00%,30,30,0.00%
pico.eset.com,0,0.00%,17,17,0.00%
sp1.baidu.com,0,0.00%,75,75,0.00%
conn-service-cn-04.allawntech.com,0,0.00%,19,19,0.00%
pscan.f.360.cn,0,0.00%,4,4,0.00%
dc1.ksn.kaspersky-labs.com,0,0.00%,40,40,0.00%
open.weixin.qq.com,0,0.00%,22,22,0.00%
broker.miwifi.com,0,0.00%,174,174,0.00%
tim.qq.com,0,0.00%,10,10,0.00%
t13.baidu.com,0,0.00%,36,36,0.00%
hectorstatic.baidu.com,0,0.00%,81,81,0.00%
hector.baidu.com,0,0.00%,31,31,0.00%
ug.baidu.com,0,0.00%,48,48,0.00%
auth.grammarly.com,0,0.00%,8,8,0.00%
gza.edge.boom.skin,0,0.00%,12,12,0.00%
info.lenovo.com.cn,0,0.00%,26,26,0.00%
array608.prod.do.dsp.mp.microsoft.com,0,0.00%,6,6,0.00%
az667904.vo.msecnd.net,0,0.00%,61,61,0.00%
nexus-websocket-a.intercom.io,0,0.00%,10,10,0.00%
www.21cn.com,0,0.00%,4,4,0.00%
www.phoronix-test-suite.com,0,0.00%,24,24,0.00%
data.grammarly.com,0,0.00%,9,9,0.00%
www.letv.com,0,0.00%,5,5,0.00%
packages.deepin.com,0,0.00%,140,140,0.00%
notify3.note.youdao.com,0,0.00%,7,7,0.00%
array504.prod.do.dsp.mp.microsoft.com,0,0.00%,28,28,0.00%
www.update.microsoft.com,0,0.00%,7,7,0.00%
maps.windows.com,0,0.00%,8,8,0.00%
tracker-public.tjupt.org,0,0.00%,12,12,0.00%
m.baidu.com,0,0.00%,50,50,0.00%
t9.baidu.com,0,0.00%,56,56,0.00%
mobile.events.data.trafficmanager.net,0,0.00%,48,48,0.00%
swh.app,0,0.00%,18,18,0.00%
rubyfish.cn,0,0.00%,52,52,0.00%
fe2.update.microsoft.com,0,0.00%,54,54,0.00%
ntemp20.boom.skin,0,0.00%,37,37,0.00%
array603.prod.do.dsp.mp.microsoft.com,0,0.00%,3,3,0.00%
e44ee7b.pf.gladns.com,0,0.00%,2,2,0.00%
e44ee7b.pd.gladns.com,0,0.00%,6,6,0.00%
e44ee7b.pg.gladns.com,0,0.00%,4,4,0.00%
e44ee7b.pe.gladns.com,0,0.00%,2,2,0.00%
iots03-g3.oray.net,0,0.00%,2,2,0.00%
user-switcher.com,0,0.00%,2,2,0.00%
tsfe.trafficshaping.dsp.mp.microsoft.com,0,0.00%,126,126,0.00%
metrics1.data.hicloud.com,0,0.00%,85,85,0.00%
caldav.163.com,0,0.00%,64,64,0.00%
tv.sohu.com,0,0.00%,2,2,0.00%
sourcegraph.com,0,0.00%,45,45,0.00%
geover.prod.do.dsp.mp.microsoft.com,0,0.00%,68,68,0.00%
www.chinaz.com,0,0.00%,2,2,0.00%
api.onedrive.com,0,0.00%,83,83,0.00%
cnac.account.xiaomi.com,0,0.00%,4,4,0.00%
app.bilibili.com,0,0.00%,24,24,0.00%
phonecallapi.micloud.xiaomi.net,0,0.00%,2,2,0.00%
dsm01pap006.storage.live.com,0,0.00%,8,8,0.00%
geo.prod.do.dsp.mp.microsoft.com,0,0.00%,96,96,0.00%
configuration.ls.apple.com,0,0.00%,70,70,0.00%
bl3301.storage.live.com,0,0.00%,2,2,0.00%
www.126.com,0,0.00%,2,2,0.00%
dispatcher.is.autonavi.com,0,0.00%,30,30,0.00%
any.edge.bing.com,0,0.00%,2,2,0.00%
es.proj217.app.kdsec.org,0,0.00%,201,201,0.00%
i-resv.meituan.com,0,0.00%,10,10,0.00%
mail.lois.cn,0,0.00%,2,2,0.00%
d2gatte9o95jao.cloudfront.net,0,0.00%,6,6,0.00%
imap.sina.com,0,0.00%,39,39,0.00%
yapi.kdsec.org,0,0.00%,959,959,0.00%
www.youku.com,0,0.00%,16,16,0.00%
news.qq.com,0,0.00%,4,4,0.00%
www.bing.com,0,0.00%,343,343,0.00%
au.download.windowsupdate.com,0,0.00%,174,174,0.00%
aloc-control-plus.amap.com,0,0.00%,9,9,0.00%
onrt-stsdk.vivo.com.cn,0,0.00%,16,16,0.00%
www.ximalaya.com,0,0.00%,23,23,0.00%
onedriveclucprodbn20016.blob.core.windows.net,0,0.00%,6,6,0.00%
manjaro.moson.eu,0,0.00%,2,2,0.00%
dr.cs3.duba.net,0,0.00%,26,26,0.00%
dns.cloudflare.com,0,0.00%,31,31,0.00%
healthdata.hicloud.com,0,0.00%,25,25,0.00%
hihealthbase-drcn.things.hicloud.com,0,0.00%,2,2,0.00%
dig.feishu.cn,0,0.00%,8,8,0.00%
rs1.qq.com,0,0.00%,177,177,0.00%
ts1.qq.com,0,0.00%,174,174,0.00%
rs2.qq.com,0,0.00%,170,170,0.00%
ts2.qq.com,0,0.00%,167,167,0.00%
tp-b.pinduoduo.com,0,0.00%,8,8,0.00%
udpolimenew.baidu.com,0,0.00%,23,23,0.00%
searchrecommend.kugou.com,0,0.00%,26,26,0.00%
long.iwifi.360.cn,0,0.00%,13,13,0.00%
dns.weixin.qq.com,0,0.00%,132,132,0.00%
c9b086079795c442.jijifun.com,0,0.00%,28,28,0.00%
cos.ap-shanghai.myqcloud.com,0,0.00%,2,2,0.00%
intf-pc.ludashi.com,0,0.00%,5,5,0.00%
poll.exmail.qq.com,0,0.00%,39,39,0.00%
wu-bg-shim.trafficmanager.net,0,0.00%,50,50,0.00%
i.gtimg.cn,0,0.00%,9,9,0.00%
s.ludashi.com,0,0.00%,42,42,0.00%
oaagent.baidu.com,0,0.00%,26,26,0.00%
clientlog3.music.163.com,0,0.00%,12,12,0.00%
clientlog.music.163.com,0,0.00%,9,9,0.00%
onedscolprdwus05.westus.cloudapp.azure.com,0,0.00%,14,14,0.00%
event.wedobest.com.cn,0,0.00%,4,4,0.00%
grpc.biliapi.net,0,0.00%,20,20,0.00%
www.bilibili.com,0,0.00%,47,47,0.00%
crl4.digicert.com,0,0.00%,88,88,0.00%
lcznqafr.nodelist.xyz,0,0.00%,32,32,0.00%
stun1.douyucdn.cn,0,0.00%,42,42,0.00%
bn1305.storage.live.com,0,0.00%,8,8,0.00%
vsk.cnode.xyz,0,0.00%,125,125,0.00%
c.xzhwdz.com,0,0.00%,86,86,0.00%
pcrec.baidu.com,0,0.00%,39,39,0.00%
baike.baidu.com,0,0.00%,58,58,0.00%
clientnotification-userprodscus1-0.servicebus.windows.net,0,0.00%,10,10,0.00%
kln.grid.sinaedge.com,0,0.00%,4,4,0.00%
gsp85-cn-ssl.ls.apple.com,0,0.00%,70,70,0.00%
captive.apple.com,0,0.00%,51,51,0.00%
m.weibo.cn,0,0.00%,27,27,0.00%
safebrowsing.urlsec.qq.com,0,0.00%,50,50,0.00%
6-courier.push.apple.com,0,0.00%,14,14,0.00%
sofire.baidu.com,0,0.00%,4,4,0.00%
ecmb.bdimg.com,0,0.00%,3,3,0.00%
mbd.baidu.com,0,0.00%,23,23,0.00%
hmma.baidu.com,0,0.00%,1,1,0.00%
bdbus-turbonet.baidu.com,0,0.00%,1,1,0.00%
ffapi.baidu.com,0,0.00%,1,1,0.00%
minipro.baidu.com,0,0.00%,4,4,0.00%
d.pcs.baidu.com,0,0.00%,50,50,0.00%
sa5.tuisong.baidu.com,0,0.00%,1,1,0.00%
voice.baidu.com,0,0.00%,3,3,0.00%
afdconf.baidu.com,0,0.00%,2,2,0.00%
userident.baidu.com,0,0.00%,1,1,0.00%
bgg.baidu.com,0,0.00%,1,1,0.00%
wap.cmpassport.com,0,0.00%,2,2,0.00%
h2tcbox.baidu.com,0,0.00%,1,1,0.00%
ef-dongfeng.tanx.com,0,0.00%,8,8,0.00%
als.baidu.com,0,0.00%,16,16,0.00%
df.tanx.com,0,0.00%,1,1,0.00%
c3.pcs.baidu.com,0,0.00%,57,57,0.00%
sptest.baidu.com,0,0.00%,1,1,0.00%
qm-h3.baidu.com,0,0.00%,1,1,0.00%
dlswbr.baidu.com,0,0.00%,33,33,0.00%
ada.baidu.com,0,0.00%,16,16,0.00%
browserkernel.baidu.com,0,0.00%,3,3,0.00%
collector.dcdn.baidu.com,0,0.00%,2,2,0.00%
puncher.dcdn.n.shifen.com,0,0.00%,2,2,0.00%
miao.baidu.com,0,0.00%,44,44,0.00%
feed.baidu.com,0,0.00%,3,3,0.00%
utoken.umeng.com,0,0.00%,3,3,0.00%
app.chat.xiaomi.net,0,0.00%,1,1,0.00%
oxford.iciba.com,0,0.00%,1,1,0.00%
dict-mobile.iciba.com,0,0.00%,1,1,0.00%
dw-online.ksosoft.com,0,0.00%,55,55,0.00%
ulogs.umeng.com,0,0.00%,35,35,0.00%
zixun.iciba.com,0,0.00%,1,1,0.00%
service.iciba.com,0,0.00%,1,1,0.00%
api.xmpush.xiaomi.com,0,0.00%,1,1,0.00%
activity.iciba.com,0,0.00%,1,1,0.00%
user.iciba.com,0,0.00%,1,1,0.00%
shuc-ios.ksord.com,0,0.00%,1,1,0.00%
refine.iciba.com,0,0.00%,1,1,0.00%
ms-www.iciba.com,0,0.00%,1,1,0.00%
report.iciba.com,0,0.00%,1,1,0.00%
dict.iciba.com,0,0.00%,1,1,0.00%
report2.iciba.com,0,0.00%,1,1,0.00%
ifanyi.iciba.com,0,0.00%,3,3,0.00%
errlog.umeng.com,0,0.00%,5,5,0.00%
message.bilibili.com,0,0.00%,36,36,0.00%
ocsp.verisign.com,0,0.00%,24,24,0.00%
tw-gx-1.dnspro.icu,0,0.00%,10,10,0.00%
policy.jd.com,0,0.00%,11,11,0.00%
jpushsc.m.jd.com,0,0.00%,17,17,0.00%
p33-contacts.icloud.com,0,0.00%,2,2,0.00%
hk4.v2u9.top,0,0.00%,23,23,0.00%
kikyo-rest.app.kdsec.org,0,0.00%,24,24,0.00%
badjs.weixinbridge.com,0,0.00%,91,91,0.00%
mp.weixin.qq.com,0,0.00%,105,105,0.00%
bkimg.cdn.bcebos.com,0,0.00%,15,15,0.00%
reports.baidu.com,0,0.00%,16,16,0.00%
baikebcs.cdn.bcebos.com,0,0.00%,13,13,0.00%
pcapp.youku.com,0,0.00%,11,11,0.00%
dispatch.s.xzdesktop.cqttech.com,0,0.00%,42,42,0.00%
nsclick.baidu.com,0,0.00%,44,44,0.00%
crl.verisign.com,0,0.00%,90,90,0.00%
msgsrv01.oray.net,0,0.00%,6,6,0.00%
pgw-tel-cld-sl.alicdn.com,0,0.00%,24,24,0.00%
zhidao.baidu.com,0,0.00%,121,121,0.00%
doh.buzz,0,0.00%,16,16,0.00%
cloudflare-dns.com,0,0.00%,62,62,0.00%
acp-ss-an1.adobe.io,0,0.00%,14,14,0.00%
c.urs.microsoft.com,0,0.00%,18,18,0.00%
cu1pehnswss01.servicebus.windows.net,0,0.00%,4,4,0.00%
adashx.m.taobao.com,0,0.00%,19,19,0.00%
pull-hls-l1.douyincdn.com,0,0.00%,7,7,0.00%
gm.mmstat.com,0,0.00%,18,18,0.00%
cn-shtele.lfk5s2.ccddn4.icu,0,0.00%,7,7,0.00%
3f9b0ab8cc0700d09fc3b75957898284.dl.txcdns.com,0,0.00%,2,2,0.00%
weixin.qq.com,0,0.00%,8,8,0.00%
iosapps.itunes.apple.com,0,0.00%,2,2,0.00%
api.goco.io,0,0.00%,61,61,0.00%
applog.uc.cn,0,0.00%,12,12,0.00%
dyn.wps.cn,0,0.00%,74,74,0.00%
geo.wps.cn,0,0.00%,63,63,0.00%
iaas.wps.cn,0,0.00%,52,52,0.00%
docer.kdocs.cn,0,0.00%,51,51,0.00%
docer-api.kdocs.cn,0,0.00%,56,56,0.00%
avatar.qwps.cn,0,0.00%,52,52,0.00%
vip.wps.cn,0,0.00%,62,62,0.00%
lucky.wps.cn,0,0.00%,59,59,0.00%
le.wps.cn,0,0.00%,54,54,0.00%
notice.wps.cn,0,0.00%,61,61,0.00%
qr.wps.cn,0,0.00%,58,58,0.00%
sms.wps.cn,0,0.00%,55,55,0.00%
roaming.wps.cn,0,0.00%,72,72,0.00%
pay.wps.cn,0,0.00%,202,202,0.00%
vasapi.wps.cn,0,0.00%,68,68,0.00%
www.kdocs.cn,0,0.00%,78,78,0.00%
wdl1.file.cache.docer.com,0,0.00%,64,64,0.00%
dl.vas.wpscdn.cn,0,0.00%,69,69,0.00%
zt.wps.cn,0,0.00%,54,54,0.00%
zj-roaming.wps.cn,0,0.00%,63,63,0.00%
zw-roaming.wps.cn,0,0.00%,62,62,0.00%
tj.psvr.wps.cn,0,0.00%,6,6,0.00%
js1.pcfg.cache.wpscdn.cn,0,0.00%,35,35,0.00%
cn-hangzhou.axt.aliyun.com,0,0.00%,14,14,0.00%
pop.cstnet.cn,0,0.00%,9,9,0.00%
acd.op.hicloud.com,0,0.00%,15,15,0.00%
bn02pap001.storage.live.com,0,0.00%,2,2,0.00%
windows.kite.com,0,0.00%,19,19,0.00%
vcode-od.vivo.com.cn,0,0.00%,41,41,0.00%
mime.baidu.com,0,0.00%,32,32,0.00%
vcode-api.vivo.com.cn,0,0.00%,6,6,0.00%
sdkserver-drcn.op.dbankcloud.cn,0,0.00%,20,20,0.00%
time-macos.apple.com,0,0.00%,3,3,0.00%
1.courier-sandbox-push-apple.com.akadns.net,0,0.00%,6,6,0.00%
www.microsoft.com-c-3.edgekey.net,0,0.00%,14,14,0.00%
1.courier-push-apple.com.akadns.net,0,0.00%,37,37,0.00%
cn-qingdao.axt.aliyun.com,0,0.00%,16,16,0.00%
array606.prod.do.dsp.mp.microsoft.com,0,0.00%,22,22,0.00%
748049e45d87b8c7.jijifun.com,0,0.00%,4,4,0.00%
u.wwwww.wtf,0,0.00%,18,18,0.00%
autoupdater.updrv.com,0,0.00%,96,96,0.00%
aps.amap.com,0,0.00%,89,89,0.00%
loc.map.baidu.com,0,0.00%,81,81,0.00%
conna.gj.qq.com,0,0.00%,63,63,0.00%
cn-beijing.axt.aliyun.com,0,0.00%,18,18,0.00%
grs.dbankcloud.com,0,0.00%,48,48,0.00%
support.weixin.qq.com,0,0.00%,21,21,0.00%
api.bilibili.com,0,0.00%,55,55,0.00%
cm.bilibili.com,0,0.00%,44,44,0.00%
sep.ucas.ac.cn,0,0.00%,14,14,0.00%
dup.baidustatic.com,0,0.00%,29,29,0.00%
q.soft.360.cn,0,0.00%,30,30,0.00%
api.live.bilibili.com,0,0.00%,41,41,0.00%
bili-dyn-sched.jcloud-cdn.com,0,0.00%,40,40,0.00%
mail.163.com,0,0.00%,55,55,0.00%
norma-external-collect.meizu.com,0,0.00%,7,7,0.00%
array809.prod.do.dsp.mp.microsoft.com,0,0.00%,19,19,0.00%
array806.prod.do.dsp.mp.microsoft.com,0,0.00%,22,22,0.00%
ping.cloud.tencent.com,0,0.00%,3,3,0.00%
arms-retcode.aliyuncs.com,0,0.00%,6,6,0.00%
hm.baidu.com,0,0.00%,129,129,0.00%
sensors.cloud.tencent.com,0,0.00%,3,3,0.00%
cn-zhangjiakou.axt.aliyun.com,0,0.00%,18,18,0.00%
api.vstsusers.visualstudio.com,0,0.00%,9,9,0.00%
pgyapi.oray.net,0,0.00%,4,4,0.00%
android.bugly.qq.com,0,0.00%,16,16,0.00%
rmonitor.qq.com,0,0.00%,22,22,0.00%
visualstudio-devdiv-c2s-msedge-net.e-0009.e-msedge.net,0,0.00%,13,13,0.00%
obus-dc20123-cn.heytapmobi.com,0,0.00%,8,8,0.00%
api.1e2ea27c13e7d7dff999bc904d79a0a8.pw,0,0.00%,7,7,0.00%
doh.dns.apple.com,0,0.00%,4,4,0.00%
e-0014.e-msedge.net,0,0.00%,44,44,0.00%
api.ad.xiaomi.com,0,0.00%,41,41,0.00%
update.360safe.com,0,0.00%,94,94,0.00%
ocsp.usertrust.com,0,0.00%,9,9,0.00%
stat.music.qq.com,0,0.00%,2,2,0.00%
ocsp.sectigo.com,0,0.00%,6,6,0.00%
biociclo.agri.cl,0,0.00%,1,1,0.00%
322fbb17aa371817ba7415b59f5ecea9.dlied1.cdntips.net,0,0.00%,4,4,0.00%
4e3fbc91775832759f33b21e514bb29c.dlied1.cdntips.net,0,0.00%,6,6,0.00%
gzc-download.weiyun.com,0,0.00%,2,2,0.00%
thirdqq.qlogo.cn,0,0.00%,5,5,0.00%
tjc-download.weiyun.com,0,0.00%,2,2,0.00%
grs.dbankcloud.cn,0,0.00%,20,20,0.00%
grs.dbankcloud.eu,0,0.00%,6,6,0.00%
qqdata.ab.qq.com,0,0.00%,15,15,0.00%
static.asm.skype.com,0,0.00%,34,34,0.00%
static-asm.secure.skypeassets.com,0,0.00%,32,32,0.00%
wdcp.microsoft.com,0,0.00%,24,24,0.00%
metrics-drcn.dt.hicloud.com,0,0.00%,8,8,0.00%
api.zotero.org,0,0.00%,32,32,0.00%
docs.joern.io,0,0.00%,2,2,0.00%
onedscolprdcus03.centralus.cloudapp.azure.com,0,0.00%,8,8,0.00%
rq.cct.cloud.duba.net,0,0.00%,91,91,0.00%
event.stat.wedobest.com.cn,0,0.00%,2,2,0.00%
terms-drcn.platform.dbankcloud.cn,0,0.00%,12,12,0.00%
browsercfg-drcn.cloud.dbankcloud.cn,0,0.00%,8,8,0.00%
service-cn.hwccpc.com,0,0.00%,11,11,0.00%
httpdns.huaweicloud.com,0,0.00%,5,5,0.00%
abtest.alibaba.com,0,0.00%,5,5,0.00%
mdap.alipay.com,0,0.00%,12,12,0.00%
www.sangfor.com,0,0.00%,69,69,0.00%
store-drcn.hispace.dbankcloud.cn,0,0.00%,33,33,0.00%
bubble.ic.ksosoft.com,0,0.00%,52,52,0.00%
open.qurl.f.360.cn,0,0.00%,4,4,0.00%
feeds-drcn.cloud.huawei.com.cn,0,0.00%,6,6,0.00%
cl4-cn.apple.com,0,0.00%,15,15,0.00%
cn-hongkong.axt.aliyun.com,0,0.00%,18,18,0.00%
cc-api-data.adobe.io,0,0.00%,40,40,0.00%
jgw-drcn.jos.dbankcloud.cn,0,0.00%,10,10,0.00%
sdk-open-phone.getui.com,0,0.00%,25,25,0.00%
cainiao-app-logs.cn-zhangjiakou.log.aliyuncs.com,0,0.00%,4,4,0.00%
account.cloud.huawei.com,0,0.00%,4,4,0.00%
login.microsoftonline.com,0,0.00%,78,78,0.00%
slscr.update.microsoft.com,0,0.00%,83,83,0.00%
cgi.ark.qq.com,0,0.00%,7,7,0.00%
sl-collection.oray.net,0,0.00%,53,53,0.00%
eu-west-1.axt.aliyun.com,0,0.00%,23,23,0.00%
p.youku.com,0,0.00%,4,4,0.00%
uz99.v.bsclink.cn,0,0.00%,5,5,0.00%
api.account.xiaomi.com,0,0.00%,13,13,0.00%
mpush-api.aliyun.com,0,0.00%,5,5,0.00%
app.vssps.visualstudio.com,0,0.00%,9,9,0.00%
licensing.mp.microsoft.com,0,0.00%,90,90,0.00%
probe.icloud.com,0,0.00%,1,1,0.00%
blog.csdn.net,0,0.00%,39,39,0.00%
g.csdnimg.cn,0,0.00%,44,44,0.00%
iknowpc.bdimg.com,0,0.00%,2,2,0.00%
iknow-pic.cdn.bcebos.com,0,0.00%,3,3,0.00%
nav-edge.smartscreen.microsoft.com,0,0.00%,85,85,0.00%
profile.csdnimg.cn,0,0.00%,25,25,0.00%
ext.immomo.com,0,0.00%,2,2,0.00%
silkroad.csdn.net,0,0.00%,22,22,0.00%
kunpeng.csdn.net,0,0.00%,26,26,0.00%
position.csdnimg.cn,0,0.00%,26,26,0.00%
msg.csdn.net,0,0.00%,21,21,0.00%
31-courier.push.apple.com,0,0.00%,21,21,0.00%
tietie.momocdn.com,0,0.00%,2,2,0.00%
apikey.map.qq.com,0,0.00%,3,3,0.00%
overseactrl.map.qq.com,0,0.00%,3,3,0.00%
confinfo.map.qq.com,0,0.00%,3,3,0.00%
statistic.csdn.net,0,0.00%,23,23,0.00%
sdkgw.map.qq.com,0,0.00%,5,5,0.00%
sp0.baidu.com,0,0.00%,69,69,0.00%
vectorsdk.map.qq.com,0,0.00%,3,3,0.00%
gsp0.baidu.com,0,0.00%,26,26,0.00%
redisdatarecall.csdn.net,0,0.00%,29,29,0.00%
capi.grammarly.com,0,0.00%,14,14,0.00%
cpro.baidustatic.com,0,0.00%,41,41,0.00%
pos.baidu.com,0,0.00%,57,57,0.00%
kstj.baidu.com,0,0.00%,6,6,0.00%
iecvlist.microsoft.com,0,0.00%,3,3,0.00%
ime.sogou.com,0,0.00%,61,61,0.00%
zhannei-dm.csdn.net,0,0.00%,23,23,0.00%
beacon.tingyun.com,0,0.00%,29,29,0.00%
passport.escience.cn,0,0.00%,36,36,0.00%
wn.pos.baidu.com,0,0.00%,38,38,0.00%
wxa.weixin.qq.com,0,0.00%,6,6,0.00%
www.kuaishou.com,0,0.00%,2,2,0.00%
v4-vod.kwaicdn.com,0,0.00%,2,2,0.00%
sns-avatar-qc.xhscdn.com,0,0.00%,15,15,0.00%
imap.qq.com,0,0.00%,143,143,0.00%
sns-img-hw.xhscdn.com,0,0.00%,11,11,0.00%
eclick.baidu.com,0,0.00%,23,23,0.00%
ocsp2.apple.com,0,0.00%,94,94,0.00%
as.xiaohongshu.com,0,0.00%,22,22,0.00%
hq.sinajs.cn,0,0.00%,11,11,0.00%
pis-pcdn.youku.com,0,0.00%,22,22,0.00%
ebad288.nf.gladns.com,0,0.00%,5,5,0.00%
ebad288.nb.gladns.com,0,0.00%,5,5,0.00%
ebad288.nh.gladns.com,0,0.00%,5,5,0.00%
ws-ios.shouji.sogou.com,0,0.00%,1,1,0.00%
get.shouji.sogou.com,0,0.00%,3,3,0.00%
tiebapic.baidu.com,0,0.00%,1,1,0.00%
ping.manjaro.org,0,0.00%,49,49,0.00%
szminorshort.weixin.qq.com,0,0.00%,21,21,0.00%
c2shb.one-mobile-prod.aws.oath.cloud,0,0.00%,4,4,0.00%
sg.bls.mdt.qq.com,0,0.00%,3,3,0.00%
apd-pcdnvodstat.teg.tencent-cloud.net,0,0.00%,7,7,0.00%
www.deepl.com,0,0.00%,7,7,0.00%
healthsession.things.dbankcloud.com,0,0.00%,13,13,0.00%
vimsky.com,0,0.00%,2,2,0.00%
sh.jd.com,0,0.00%,9,9,0.00%
appdownload.deepl.com,0,0.00%,10,10,0.00%
hag-drcn.op.hicloud.com,0,0.00%,9,9,0.00%
v5-colda.douyinvod.com,0,0.00%,2,2,0.00%
geo-eu-us-sticky.delivery-prod-sas.akadns.net,0,0.00%,4,4,0.00%
store.heytapimage.com,0,0.00%,1,1,0.00%
gslb-cn.cdo.heytapmobi.com,0,0.00%,1,1,0.00%
pcapp-update.youku.com,0,0.00%,25,25,0.00%
epoch-cn.cdo.heytapmobi.com,0,0.00%,1,1,0.00%
ac-mqgidvz-shard-00-00.nmmxpgl.mongodb.net,0,0.00%,1,1,0.00%
ac-mqgidvz-shard-00-01.nmmxpgl.mongodb.net,0,0.00%,1,1,0.00%
ac-mqgidvz-shard-00-02.nmmxpgl.mongodb.net,0,0.00%,1,1,0.00%
tracker2.torrentino.com,0,0.00%,1,1,0.00%
seeds-open.xycdn.com,0,0.00%,2,2,0.00%
genuine.adobe.com,0,0.00%,7,7,0.00%
www.kernel.org,0,0.00%,2,2,0.00%
mail.realliferpg.de,0,0.00%,15,15,0.00%
server1.9sheng.cn,0,0.00%,1,1,0.00%
windows.msn.cn,0,0.00%,66,66,0.00%
tracker1.itzmx.com,0,0.00%,9,9,0.00%
nav.smartscreen.microsoft.com,0,0.00%,17,17,0.00%
cmmsns.qpic.cn,0,0.00%,1,1,0.00%
pr.map.qq.com,0,0.00%,6,6,0.00%
audid-api.taobao.com,0,0.00%,18,18,0.00%
api.im.qcloud.com,0,0.00%,54,54,0.00%
www.gstatic.com,0,0.00%,42,42,0.00%
zn_0pxrmhobblncaad-hpsupport.siteintercept.qualtrics.com,0,0.00%,1,1,0.00%
udc-neb.kampyle.com,0,0.00%,1,1,0.00%
siteintercept.qualtrics.com,0,0.00%,1,1,0.00%
c.msn.cn,0,0.00%,27,27,0.00%
c.go-mpulse.net,0,0.00%,74,74,0.00%
amdc.alipay.com,0,0.00%,10,10,0.00%
pubsub02.oray.net,0,0.00%,163,163,0.00%
developers.google.cn,0,0.00%,7,7,0.00%
conn2.oppomobile.com,0,0.00%,1,1,0.00%
sina.cn,0,0.00%,5,5,0.00%
n23.boom.skin,0,0.00%,16,16,0.00%
browser.events.data.msn.cn,0,0.00%,25,25,0.00%
www.sogou.com,0,0.00%,117,117,0.00%
input.shouji.sogou.com,0,0.00%,43,43,0.00%
a6f5288.pc.gladns.com,0,0.00%,6,6,0.00%
configsvr.msf.3g.qq.com,0,0.00%,33,33,0.00%
gw.alipayobjects.com.danuoyi.tbcache.com,0,0.00%,1,1,0.00%
imgcps.jd.com,0,0.00%,1,1,0.00%
surl.amap.com,0,0.00%,1,1,0.00%
eddie4.nl,0,0.00%,1,1,0.00%
shadowshq.yi.org,0,0.00%,1,1,0.00%
i3.c.eset.com,0,0.00%,7,7,0.00%
wx1.sinaimg.cn,0,0.00%,30,30,0.00%
wx2.sinaimg.cn,0,0.00%,20,20,0.00%
g.live.com,0,0.00%,76,76,0.00%
wx4.sinaimg.cn,0,0.00%,18,18,0.00%
h5.sinaimg.cn,0,0.00%,14,14,0.00%
vip.storage.weibo.com,0,0.00%,13,13,0.00%
wx3.sinaimg.cn,0,0.00%,28,28,0.00%
tvax2.sinaimg.cn,0,0.00%,25,25,0.00%
tvax1.sinaimg.cn,0,0.00%,27,27,0.00%
tvax4.sinaimg.cn,0,0.00%,25,25,0.00%
webapi.amap.com,0,0.00%,7,7,0.00%
stun.douyucdn.cn,0,0.00%,3,3,0.00%
log.mmstat.com,0,0.00%,13,13,0.00%
restapi.amap.com,0,0.00%,15,15,0.00%
vdata01.amap.com,0,0.00%,1,1,0.00%
vdata02.amap.com,0,0.00%,1,1,0.00%
diskapi.baidu.com,0,0.00%,187,187,0.00%
w.cnzz.com,0,0.00%,5,5,0.00%
fourier.taobao.com,0,0.00%,1,1,0.00%
i5df1.tdum.alibaba.com,0,0.00%,1,1,0.00%
i1.hdslb.com,0,0.00%,36,36,0.00%
vdata03.amap.com,0,0.00%,1,1,0.00%
vdata04.amap.com,0,0.00%,1,1,0.00%
graph.microsoft.com,0,0.00%,67,67,0.00%
www.xiaohongshu.com,0,0.00%,12,12,0.00%
crash.xiaohongshu.com,0,0.00%,12,12,0.00%
lng.xiaohongshu.com,0,0.00%,17,17,0.00%
adashxgc.ut.taobao.com,0,0.00%,7,7,0.00%
apppush-sh5.xiaohongshu.com,0,0.00%,11,11,0.00%
link.springer.com,0,0.00%,14,14,0.00%
www.engineeringvillage.com,0,0.00%,14,14,0.00%
www.sciencedirect.com,0,0.00%,19,19,0.00%
apabi.las.ac.cn,0,0.00%,15,15,0.00%
www.cnki.net,0,0.00%,15,15,0.00%
bjvip.las.ac.cn,0,0.00%,15,15,0.00%
www.las.ac.cn,0,0.00%,14,14,0.00%
gpd.las.ac.cn,0,0.00%,15,15,0.00%
dl.acm.org,0,0.00%,19,19,0.00%
hcdnv.v6.xhs.c.cdnhwc2.com.c.cdnhwc2.com,0,0.00%,1,1,0.00%
www.overleaf.com,0,0.00%,13,13,0.00%
zttvp.v.bsgslb.com,0,0.00%,1,1,0.00%
gorgon.youdao.com,0,0.00%,9,9,0.00%
conn4.coloros.com,0,0.00%,10,10,0.00%
oimagec1.ydstatic.com,0,0.00%,1,1,0.00%
apm3.music.163.com,0,0.00%,1,1,0.00%
interface3.music.163.com.163jiasu.com,0,0.00%,11,11,0.00%
dsp-impr2.youdao.com,0,0.00%,5,5,0.00%
doh.zjurl.cn,0,0.00%,36,36,0.00%
conn3.coloros.com,0,0.00%,9,9,0.00%
10-courier.push.apple.com,0,0.00%,18,18,0.00%
st.pinyin.sogou.com,0,0.00%,13,13,0.00%
sns-video-qc.xhscdn.com,0,0.00%,5,5,0.00%
sns-img-qc.xhscdn.com,0,0.00%,7,7,0.00%
api.didialift.com,0,0.00%,1,1,0.00%
hey-video-qn.xhscdn.com,0,0.00%,2,2,0.00%
lion.didialift.com,0,0.00%,1,1,0.00%
prepush-valipl.cp31.ott.cibntv.net,0,0.00%,3,3,0.00%
img.t.sinajs.cn,0,0.00%,7,7,0.00%
smp-device-content.g.aaplimg.com,0,0.00%,1,1,0.00%
www.notion.so,0,0.00%,57,57,0.00%
update.pan.n.shifen.com,0,0.00%,3,3,0.00%
data.hicloud.com,0,0.00%,45,45,0.00%
mercury.jd.com,0,0.00%,1,1,0.00%
cd.jd.com,0,0.00%,1,1,0.00%
club.jd.com,0,0.00%,3,3,0.00%
question.jd.com,0,0.00%,1,1,0.00%
wlog.ksapisrv.com,0,0.00%,3,3,0.00%
fts.jd.com,0,0.00%,1,1,0.00%
rn-resource-app.xiaohongshu.com,0,0.00%,7,7,0.00%
adashbc.ut.taobao.com,0,0.00%,25,25,0.00%
bt.mp4ba.com,0,0.00%,1,1,0.00%
app.market.xiaomi.com,0,0.00%,3,3,0.00%
www.iie.cas.cn,0,0.00%,1,1,0.00%
www.cas.cn,0,0.00%,9,9,0.00%
tracking.miui.com,0,0.00%,53,53,0.00%
api.tw06.xlmc.sec.miui.com,0,0.00%,3,3,0.00%
hub5u.wap.sandai.net,0,0.00%,1,1,0.00%
hub5pn.wap.sandai.net,0,0.00%,1,1,0.00%
master.wap.dphub.sandai.net,0,0.00%,1,1,0.00%
iie.arp.cn,0,0.00%,1,1,0.00%
idx.m.hub.sandai.net,0,0.00%,1,1,0.00%
pbg0.market.xiaomi.com,0,0.00%,1,1,0.00%
pushbos.baidu.com,0,0.00%,1,1,0.00%
wup.imtt.qq.com,0,0.00%,31,31,0.00%
newtab.browser.qq.com,0,0.00%,3,3,0.00%
wedocare.com,0,0.00%,1,1,0.00%
api.map.baidu.com,0,0.00%,10,10,0.00%
web-img.oss.aliyuncs.com,0,0.00%,1,1,0.00%
web-img.oss-cn-hangzhou.aliyuncs.com,0,0.00%,1,1,0.00%
mobile-img.oss.aliyuncs.com,0,0.00%,1,1,0.00%
connectivitycheck.platform.hicloud.com,0,0.00%,113,113,0.00%
map-img.oss.aliyuncs.com,0,0.00%,1,1,0.00%
pr.m.hub.sandai.net,0,0.00%,1,1,0.00%
sr.m.hub.sandai.net,0,0.00%,1,1,0.00%
newvpn.arp.cn,0,0.00%,14,14,0.00%
pss.alicdn.com,0,0.00%,26,26,0.00%
www.telecommandsvc.microsoft.com,0,0.00%,7,7,0.00%
max-l.mediav.com,0,0.00%,21,21,0.00%
ssxd.mediav.com,0,0.00%,14,14,0.00%
bj-a.bcebos.com,0,0.00%,3,3,0.00%
mall.jd.com,0,0.00%,2,2,0.00%
gia.jd.com,0,0.00%,1,1,0.00%
chat1.jd.com,0,0.00%,1,1,0.00%
passport.jd.com,0,0.00%,1,1,0.00%
jscss.360buyimg.com,0,0.00%,1,1,0.00%
prod.roaming1.live.com.akadns.net,0,0.00%,3,3,0.00%
h5.360buyimg.com,0,0.00%,1,1,0.00%
gias.jd.com,0,0.00%,1,1,0.00%
img20.360buyimg.com,0,0.00%,1,1,0.00%
cds.3.cn,0,0.00%,3,3,0.00%
blackhole-m.m.jd.com,0,0.00%,1,1,0.00%
f-mall.jd.com,0,0.00%,1,1,0.00%
module-jshop.jd.com,0,0.00%,1,1,0.00%
contacts.fe.apple-dns.cn,0,0.00%,23,23,0.00%
jscss.jd.com,0,0.00%,1,1,0.00%
cart.jd.com,0,0.00%,3,3,0.00%
static.360buyimg.com,0,0.00%,3,3,0.00%
qrimg.jd.com,0,0.00%,1,1,0.00%
www.octotree.io,0,0.00%,1,1,0.00%
pop.sina.com,0,0.00%,7,7,0.00%
glb-db52c2cf8be544.github.com,0,0.00%,1,1,0.00%
log1.cmpassport.com,0,0.00%,5,5,0.00%
tracker.iriseden.eu,0,0.00%,17,17,0.00%
cloud.safe.360.cn,0,0.00%,28,28,0.00%
report.uchiha.ltd,0,0.00%,32,32,0.00%
c.skconf.f.360.cn,0,0.00%,38,38,0.00%
www.google.cn,0,0.00%,34,34,0.00%
conf-darwin.xycdn.com,0,0.00%,21,21,0.00%
dig.bdurl.net,0,0.00%,37,37,0.00%
push-rtmp-hs-f5-encryption.douyincdn.com,0,0.00%,11,11,0.00%
push-rtmp-vr-f5.douyincdn.com,0,0.00%,11,11,0.00%
pull-rtmp-l27.douyincdn.com,0,0.00%,22,22,0.00%
push-rtmp-f5-vs.douyincdn.com,0,0.00%,15,15,0.00%
push-rtmp-l11-cny.douyincdn.com,0,0.00%,14,14,0.00%
push-rtmp-l27.douyincdn.com,0,0.00%,15,15,0.00%
push-rtmp-l26-cny.douyincdn.com,0,0.00%,15,15,0.00%
pull-lls-l26.douyincdn.com,0,0.00%,28,28,0.00%
push-rtmp-f5-io.flive.douyincdn.com,0,0.00%,21,21,0.00%
pull-rtmp-l6-cny.douyincdn.com,0,0.00%,22,22,0.00%
pull-flv-f26.douyincdn.com,0,0.00%,17,17,0.00%
push-rtmp-l95.douyincdn.com,0,0.00%,15,15,0.00%
pull-flv-l27.douyincdn.com,0,0.00%,21,21,0.00%
pull-flv-l95.douyincdn.com,0,0.00%,19,19,0.00%
pull-hls-f13.douyincdn.com,0,0.00%,23,23,0.00%
pull-hls-f29.douyincdn.com,0,0.00%,19,19,0.00%
push-rtmp-f5-cny.douyincdn.com,0,0.00%,17,17,0.00%
pull-rtmp-l95.douyincdn.com,0,0.00%,19,19,0.00%
pull-flv-l11-cny.douyincdn.com,0,0.00%,15,15,0.00%
pull-hls-vr-l6.douyincdn.com,0,0.00%,17,17,0.00%
pull-flv-l6-hs.pstatp.com,0,0.00%,15,15,0.00%
pull-lls-spe-l26.douyincdn.com,0,0.00%,21,21,0.00%
ttxyajs.data.kuiniuca.com,0,0.00%,4,4,0.00%
push-rtmp-spe-l3.douyincdn.com,0,0.00%,17,17,0.00%
pull-flv-f5-enc.flive.douyincdn.com,0,0.00%,23,23,0.00%
pull-rtmp-f29.douyincdn.com,0,0.00%,19,19,0.00%
push-rtmp-vr-l3.douyincdn.com,0,0.00%,15,15,0.00%
cgicol.amap.com,0,0.00%,72,72,0.00%
pica.zhimg.com,0,0.00%,35,35,0.00%
update.bjca.org.cn,0,0.00%,4,4,0.00%
api.zhihu.com,0,0.00%,21,21,0.00%
video.zhihu.com,0,0.00%,4,4,0.00%
fanyi-bfe.n.shifen.com,0,0.00%,2,2,0.00%
clk.lenovo.com.cn,0,0.00%,8,8,0.00%
inf.safe.360.cn,0,0.00%,14,14,0.00%
kt-prod.ess.apple.com,0,0.00%,21,21,0.00%
long.weixin.qq.com,0,0.00%,78,78,0.00%
cn-zjk-ali-r001.router.teamviewer.cn,0,0.00%,4,4,0.00%
onedscolprdfrc01.francecentral.cloudapp.azure.com,0,0.00%,10,10,0.00%
www.wjx.cn,0,0.00%,4,4,0.00%
messaging.engagement.office.com,0,0.00%,23,23,0.00%
countly.mail.163.com,0,0.00%,8,8,0.00%
windows.policies.live.net,0,0.00%,17,17,0.00%
ksopush.kdocs.cn,0,0.00%,4,4,0.00%
pay.weixin.qq.com,0,0.00%,12,12,0.00%
rules.emergingthreats.net,0,0.00%,2,2,0.00%
wx.tenpay.com,0,0.00%,8,8,0.00%
game.weixin.qq.com,0,0.00%,14,14,0.00%
fems.wps.cn,0,0.00%,12,12,0.00%
spinfo.wps.cn,0,0.00%,20,20,0.00%
cf.aliyun.com,0,0.00%,8,8,0.00%
onedscolprdcus13.centralus.cloudapp.azure.com,0,0.00%,12,12,0.00%
sdk.open.talk.getui.com,0,0.00%,15,15,0.00%
ykdc.hzyoka.com,0,0.00%,2,2,0.00%
eco.taobao.com,0,0.00%,13,13,0.00%
gfwsl.geforce.com,0,0.00%,10,10,0.00%
api-access.pangolin-sdk-toutiao.com,0,0.00%,26,26,0.00%
a1.easemob.com,0,0.00%,2,2,0.00%
hnyd.817777.xyz,0,0.00%,14,14,0.00%
api.atlassian.com,0,0.00%,12,12,0.00%
cm-10-39.getui.com,0,0.00%,2,2,0.00%
ios.bugly.qq.com,0,0.00%,15,15,0.00%
thetracker.org,0,0.00%,12,12,0.00%
cstm.baidu.com,0,0.00%,29,29,0.00%
ta.trs.cn,0,0.00%,2,2,0.00%
download.pinyin.sogou.com,0,0.00%,29,29,0.00%
lens.zhihu.com,0,0.00%,43,43,0.00%
api.murder-mystery.cn,0,0.00%,2,2,0.00%
r.bing.com,0,0.00%,4,4,0.00%
c-hzgt2.getui.com,0,0.00%,4,4,0.00%
v1.kwaicdn.com,0,0.00%,6,6,0.00%
galaxy.safe.360.cn,0,0.00%,60,60,0.00%
events.gfe.nvidia.com,0,0.00%,418,418,0.00%
pcmgrmonitor.3g.qq.com,0,0.00%,16,16,0.00%
array615.prod.do.dsp.mp.microsoft.com,0,0.00%,36,36,0.00%
accounts.firefox.com,0,0.00%,2,2,0.00%
location.services.mozilla.com,0,0.00%,56,56,0.00%
vscode-sync.trafficmanager.net,0,0.00%,87,87,0.00%
5.rlb.router.teamviewer.cn,0,0.00%,12,12,0.00%
rc09-fc01.oray.com,0,0.00%,7,7,0.00%
api.accounts.firefox.com,0,0.00%,4,4,0.00%
note-skin.coloros.com,0,0.00%,2,2,0.00%
t.weixue100.com,0,0.00%,6,6,0.00%
oss.weixueyibai.com,0,0.00%,6,6,0.00%
appconf.mail.163.com,0,0.00%,38,38,0.00%
doh.opendns.com,0,0.00%,24,24,0.00%
profile.accounts.firefox.com,0,0.00%,8,8,0.00%
tracker-cdn.moeking.me,0,0.00%,23,23,0.00%
acs.m.taobao.com,0,0.00%,13,13,0.00%
dualstack-logs.amap.com,0,0.00%,10,10,0.00%
dualstack-restios.amap.com,0,0.00%,3,3,0.00%
socket.pan.baidu.com,0,0.00%,6,6,0.00%
search.ecnu.cf,0,0.00%,2,2,0.00%
vortex-win.data.microsoft.com,0,0.00%,12,12,0.00%
nt2.ele.me,0,0.00%,5,5,0.00%
adashx.ut.hzshudian.com,0,0.00%,2,2,0.00%
tracker1.torrentino.com,0,0.00%,2,2,0.00%
cs.dds.microsoft.com,0,0.00%,38,38,0.00%
b1h.zemanta.com,0,0.00%,11,11,0.00%
tagged-by.rubiconproject.net.akadns.net,0,0.00%,2,2,0.00%
ib.sin1.geoadnxs.com,0,0.00%,8,8,0.00%
c2shb.ssp.yahoo.com,0,0.00%,11,11,0.00%
ads.themoneytizer.com,0,0.00%,13,13,0.00%
sync-1-us-west1-g.sync.services.mozilla.com,0,0.00%,3,3,0.00%
click.luojilab.com,0,0.00%,8,8,0.00%
go.ie.sogou.com,0,0.00%,36,36,0.00%
helpcmcn1.ksmobile.com,0,0.00%,2,2,0.00%
common.docer.wps.cn,0,0.00%,13,13,0.00%
oss.weixue100.com,0,0.00%,4,4,0.00%
edge-api.meiqia.com,0,0.00%,2,2,0.00%
api-cn.store.heytapmobi.com,0,0.00%,2,2,0.00%
array808.prod.do.dsp.mp.microsoft.com,0,0.00%,18,18,0.00%
dragate.dc.oppomobile.com,0,0.00%,12,12,0.00%
new-api.meiqia.com,0,0.00%,2,2,0.00%
camorope-client-a.meiqia.com,0,0.00%,5,5,0.00%
tconf.b.qianxin.com,0,0.00%,21,21,0.00%
mobilegw.alipay.com,0,0.00%,17,17,0.00%
sec.sginput.qq.com,0,0.00%,4,4,0.00%
openapp.wpscdn.cn,0,0.00%,36,36,0.00%
pcfg.wps.cn,0,0.00%,61,61,0.00%
learning.u.wpscdn.cn,0,0.00%,14,14,0.00%
log.avlyun.com,0,0.00%,2,2,0.00%
aaid.umeng.com,0,0.00%,8,8,0.00%
cm-beha.ksmobile.com,0,0.00%,2,2,0.00%
plus-cmpoints.cmcm.com,0,0.00%,2,2,0.00%
array506.prod.do.dsp.mp.microsoft.com,0,0.00%,19,19,0.00%
apple-finance.query.yahoo.com,0,0.00%,19,19,0.00%
akn.safe.360.cn,0,0.00%,87,87,0.00%
tracker3.torrentino.com,0,0.00%,3,3,0.00%
fastonrt-stsdk.vivo.com.cn,0,0.00%,2,2,0.00%
hiboardng.hicloud.com,0,0.00%,13,13,0.00%
anisaishuu.de,0,0.00%,2,2,0.00%
adash.man.aliyuncs.com,0,0.00%,6,6,0.00%
ccflbs.m.jd.com,0,0.00%,8,8,0.00%
anti-sdk-report.m.jd.com,0,0.00%,7,7,0.00%
mars.jd.com,0,0.00%,13,13,0.00%
blackhole.m.jd.com,0,0.00%,11,11,0.00%
lbs.map.qq.com,0,0.00%,15,15,0.00%
supl.bd-caict.com,0,0.00%,14,14,0.00%
geo-drcn.platform.hicloud.com,0,0.00%,13,13,0.00%
connb.gj.qq.com,0,0.00%,55,55,0.00%
auth.alipay.com,0,0.00%,2,2,0.00%
lbsgw.m.jd.com,0,0.00%,6,6,0.00%
tracker.imgoingto.icu,0,0.00%,16,16,0.00%
push2.eastmoney.com,0,0.00%,24,24,0.00%
m.360buyimg.com,0,0.00%,6,6,0.00%
im-x.jd.com,0,0.00%,8,8,0.00%
q.qlogo.cn,0,0.00%,2,2,0.00%
astat.bugly.qq.com,0,0.00%,5,5,0.00%
delegation.a.shifen.com,0,0.00%,2,2,0.00%
1266287590.rsc.cdn77.org,0,0.00%,2,2,0.00%
is.snssdk.com,0,0.00%,16,16,0.00%
images.ppa030cjklwmlkkluiiah3nddnc.com,0,0.00%,1,1,0.00%
clock.nyc.he.net,0,0.00%,24,24,0.00%
dnkeeper.platform.dbankcloud.cn,0,0.00%,37,37,0.00%
datacluster3.cipsup.cn,0,0.00%,8,8,0.00%
ddns.gnway.com,0,0.00%,6,6,0.00%
datacluster2.cipsup.cn,0,0.00%,6,6,0.00%
cgicol.amap.com.gds.alibabadns.com,0,0.00%,2,2,0.00%
static.ppa030cjklwmlkkluiiah3nddnc.com,0,0.00%,1,1,0.00%
www.bt.cn,0,0.00%,8,8,0.00%
ins-gk5vby51.ias.tencent-cloud.net,0,0.00%,8,8,0.00%
clock.sjc.he.net,0,0.00%,24,24,0.00%
asia.roaming1.live.com.akadns.net,0,0.00%,2,2,0.00%
eugen-rx0.pwndns.pw,0,0.00%,17,17,0.00%
gimg1.baidu.com,0,0.00%,1,1,0.00%
xtrapath2.izatcloud.net,0,0.00%,1,1,0.00%
router12.teamviewer.com,0,0.00%,24,24,0.00%
seal-inner.bytedance.net,0,0.00%,10,10,0.00%
boot-01.net.anydesk.com,0,0.00%,14,14,0.00%
www.scumall.com,0,0.00%,3,3,0.00%
c61s4.jamjams3.net,0,0.00%,7,7,0.00%
lx0.meituan.com,0,0.00%,9,9,0.00%
update.nsfocus.com,0,0.00%,3,3,0.00%
update.api.nsfocus.com,0,0.00%,4,4,0.00%
portal.nsfocus.com,0,0.00%,6,6,0.00%
reputation.api.nsfocus.com,0,0.00%,4,4,0.00%
espp.api.nsfocus.com,0,0.00%,3,3,0.00%
33-courier.push.apple.com,0,0.00%,22,22,0.00%
o1.d.meituan.net,0,0.00%,5,5,0.00%
service.dg.wps.cn,0,0.00%,8,8,0.00%
push.ynote.youdao.com,0,0.00%,5,5,0.00%
p1k05ba99n.feishu.cn,0,0.00%,1,1,0.00%
www.ixigua.com,0,0.00%,4,4,0.00%
receive-lp1.dg.srv.nintendo.net,0,0.00%,6,6,0.00%
client.sms.miui.com,0,0.00%,4,4,0.00%
hao.360.com,0,0.00%,4,4,0.00%
log-sdk.clickwifi.net,0,0.00%,2,2,0.00%
linux.kite.com,0,0.00%,1,1,0.00%
www.meituan.com,0,0.00%,20,20,0.00%
imap.163.com,0,0.00%,43,43,0.00%
xiaoyouxi.360.cn,0,0.00%,2,2,0.00%
p2.img.360kuai.com,0,0.00%,1,1,0.00%
p9.img.360kuai.com,0,0.00%,5,5,0.00%
imap.yeah.net,0,0.00%,2,2,0.00%
stappupgrade.vivo.com.cn,0,0.00%,3,3,0.00%
objects.githubusercontent.com,0,0.00%,2,2,0.00%
h5.gdt.qq.com,0,0.00%,4,4,0.00%
xj.gtimg.cn,0,0.00%,1,1,0.00%
xjfile.qq.com,0,0.00%,1,1,0.00%
qcloud.gregchan.cn,0,0.00%,2,2,0.00%
mail.nanoctr.cn,0,0.00%,4,4,0.00%
softm.update.360safe.com,0,0.00%,31,31,0.00%
t.urs.microsoft.com,0,0.00%,2,2,0.00%
udpcache.gnvip.net,0,0.00%,10,10,0.00%
rm.api.weibo.com,0,0.00%,16,16,0.00%
xcx.www.gov.cn,0,0.00%,3,3,0.00%
t.vip.com,0,0.00%,1,1,0.00%
ms.vipstatic.com,0,0.00%,1,1,0.00%
quotes.sina.cn,0,0.00%,2,2,0.00%
mar.vip.com,0,0.00%,2,2,0.00%
www.vip.com,0,0.00%,3,3,0.00%
captcha.vip.com,0,0.00%,2,2,0.00%
shop.vipstatic.com,0,0.00%,1,1,0.00%
bootstrap.vipstatic.com,0,0.00%,2,2,0.00%
a.vpimg1.com,0,0.00%,1,1,0.00%
d.vpimg1.com,0,0.00%,1,1,0.00%
c.vpimg1.com,0,0.00%,1,1,0.00%
ncnet.mars.baofeng.net,0,0.00%,2,2,0.00%
common.vip.com,0,0.00%,2,2,0.00%
sc.appvipshop.com,0,0.00%,1,1,0.00%
a.vpimg2.com,0,0.00%,1,1,0.00%
mapi.vip.com,0,0.00%,3,3,0.00%
gsp-ssl.ls.apple.com,0,0.00%,5,5,0.00%
gdmf.apple.com,0,0.00%,12,12,0.00%
cart.vip.com,0,0.00%,2,2,0.00%
acs.vip.com,0,0.00%,1,1,0.00%
blog.vip.com,0,0.00%,1,1,0.00%
detail.vip.com,0,0.00%,1,1,0.00%
fav.vip.com,0,0.00%,2,2,0.00%
h5rsc.vip.com,0,0.00%,1,1,0.00%
help.vip.com,0,0.00%,1,1,0.00%
iclub.vip.com,0,0.00%,1,1,0.00%
ips.corp.vipshop.com,0,0.00%,1,1,0.00%
m.vip.com,0,0.00%,1,1,0.00%
order.vip.com,0,0.00%,1,1,0.00%
search.smzdm.com,0,0.00%,2,2,0.00%
myi.vip.com,0,0.00%,2,2,0.00%
swallow.apple.com,0,0.00%,16,16,0.00%
b.appsimg.com,0,0.00%,1,1,0.00%
mst.vip.com,0,0.00%,2,2,0.00%
h2.appsimg.com,0,0.00%,1,1,0.00%
list.vip.com,0,0.00%,2,2,0.00%
skin.se.360.cn,0,0.00%,4,4,0.00%
mapi.dianping.com,0,0.00%,10,10,0.00%
urs.microsoft.com,0,0.00%,7,7,0.00%
y.zdmimg.com,0,0.00%,1,1,0.00%
qny.smzdm.com,0,0.00%,2,2,0.00%
zhiyou.smzdm.com,0,0.00%,1,1,0.00%
vpn.maskvpn.org,0,0.00%,3,3,0.00%
pcapi.vip.com,0,0.00%,1,1,0.00%
s2.vipstatic.com,0,0.00%,1,1,0.00%
jr.vip.com,0,0.00%,1,1,0.00%
myvpal.vip.com,0,0.00%,1,1,0.00%
passport.vip.com,0,0.00%,1,1,0.00%
category.vip.com,0,0.00%,1,1,0.00%
shence-import.smzdm.com,0,0.00%,1,1,0.00%
feedback.vip.com,0,0.00%,2,2,0.00%
smzdm.soboten.com,0,0.00%,1,1,0.00%
stun.services.mozilla.com,0,0.00%,32,32,0.00%
listen1.myradio24.com,0,0.00%,61,61,0.00%
tools.google.com,0,0.00%,8,8,0.00%
amazon.com,0,0.00%,486,486,0.00%
s2.zdmimg.com,0,0.00%,1,1,0.00%
res.smzdm.com,0,0.00%,2,2,0.00%
www.smzdm.com,0,0.00%,1,1,0.00%
os2-3.nigirocloud.com,0,0.00%,17,17,0.00%
a.zdmimg.com,0,0.00%,1,1,0.00%
avatarimg.smzdm.com,0,0.00%,2,2,0.00%
3ba0c177-1b23-42a6-be9d-a8bdf1c2bb22.hk.node.touhou.earth,0,0.00%,2,2,0.00%
eimg.smzdm.com,0,0.00%,1,1,0.00%
qneimg.smzdm.com,0,0.00%,1,1,0.00%
stackoverflow.com,0,0.00%,2,2,0.00%
odin.adobe.com,0,0.00%,5,5,0.00%
boot-02.net.anydesk.com,0,0.00%,10,10,0.00%
emp-api.baidu.com,0,0.00%,6,6,0.00%
a.safe.360.cn,0,0.00%,30,30,0.00%
logs-api.smzdm.com,0,0.00%,1,1,0.00%
commerce.safe.360.cn,0,0.00%,24,24,0.00%
p214-contacts.icloud.com.cn,0,0.00%,3,3,0.00%
beian.miit.gov.cn,0,0.00%,8,8,0.00%
ir.vip.com,0,0.00%,1,1,0.00%
job.vip.com,0,0.00%,1,1,0.00%
lapp.corp.vipshop.com,0,0.00%,2,2,0.00%
xyt.xinchacha.com,0,0.00%,2,2,0.00%
rule.vip.com,0,0.00%,2,2,0.00%
ss.knet.cn,0,0.00%,2,2,0.00%
vis.vip.com,0,0.00%,2,2,0.00%
www.beian.gov.cn,0,0.00%,6,6,0.00%
weiquan.vip.com,0,0.00%,1,1,0.00%
www.gdjubao.cn,0,0.00%,1,1,0.00%
www.vipglobal.hk,0,0.00%,1,1,0.00%
wxfans.meituan.com,0,0.00%,2,2,0.00%
guzzoni.apple.com,0,0.00%,29,29,0.00%
stocknews.cj.sina.cn,0,0.00%,1,1,0.00%
wappass.n.shifen.com,0,0.00%,2,2,0.00%
12c9a852-rh8cg0-rhaxi1-e1rs.pccw.alrihla.net,0,0.00%,1,1,0.00%
analytics-api.smzdm.com,0,0.00%,1,1,0.00%
i.meituan.com,0,0.00%,1,1,0.00%
npay.meituan.com,0,0.00%,1,1,0.00%
statistic.live.126.net,0,0.00%,4,4,0.00%
shmmsns.qpic.cn,0,0.00%,80,80,0.00%
security.ubuntu.com,0,0.00%,251,251,0.00%
archive.ubuntu.com,0,0.00%,4,4,0.00%
gs-loc-cn.apple.com,0,0.00%,41,41,0.00%
officeclient.microsoft.com,0,0.00%,58,58,0.00%
ali-bj-pcdn-09.biliapi.net,0,0.00%,2,2,0.00%
telemetry-in.battle.net,0,0.00%,15,15,0.00%
stock.vip.com,0,0.00%,1,1,0.00%
radio.itunes.apple.com,0,0.00%,1,1,0.00%
h5charity.vip.com,0,0.00%,2,2,0.00%
400.vip.com,0,0.00%,1,1,0.00%
mmbiz.qlogo.cn,0,0.00%,39,39,0.00%
wx.mail.qq.com,0,0.00%,11,11,0.00%
bvc.bilivideo.com,0,0.00%,24,24,0.00%
www.w3.org,0,0.00%,30279,30279,0.00%
bs-origin.pull.yximgs.com,0,0.00%,5,5,0.00%
cny-pro.kwd.inkuai.com,0,0.00%,5,5,0.00%
ec.kwd.inkuai.com,0,0.00%,3,3,0.00%
imgx.kwd.inkuai.com,0,0.00%,3,3,0.00%
js-im.xxpkg.com,0,0.00%,4,4,0.00%
hybrid.kwd.inkuai.com,0,0.00%,4,4,0.00%
kkd.kwd.inkuai.com,0,0.00%,4,4,0.00%
v2-cty01.kwaicdn.com,0,0.00%,4,4,0.00%
v2-cty04.kwaicdn.com,0,0.00%,3,3,0.00%
v22.kwaicdn.com,0,0.00%,4,4,0.00%
v6-gdvod.kwaicdn.com,0,0.00%,3,3,0.00%
v6.kwaicdn.com,0,0.00%,4,4,0.00%
ws.push.yximgs.com,0,0.00%,3,3,0.00%
zt-sup.kwd.inkuai.com,0,0.00%,3,3,0.00%
newclient.map.baidu.com,0,0.00%,9,9,0.00%
resource-api.vivo.com.cn,0,0.00%,2,2,0.00%
monitor-stsdk.vivo.com.cn,0,0.00%,9,9,0.00%
content-libstatic.vivo.com.cn,0,0.00%,2,2,0.00%
meta-shb1.pinduoduo.com,0,0.00%,2,2,0.00%
router15.teamviewer.com,0,0.00%,28,28,0.00%
relay-b8d08ecc.net.anydesk.com,0,0.00%,5,5,0.00%
184-15-25-249.dr01.chtn.wv.frontiernet.net,0,0.00%,2,2,0.00%
site.browser.360.cn,0,0.00%,4,4,0.00%
open.u-tools.cn,0,0.00%,6,6,0.00%
t1.leech.ie,0,0.00%,21,21,0.00%
flux.hcdn.qiyi.com,0,0.00%,14,14,0.00%
data6.video.iqiyi.com,0,0.00%,12,12,0.00%
i5.weather.oppomobile.com,0,0.00%,8,8,0.00%
conf.cipsup.cn,0,0.00%,4,4,0.00%
t2.leech.ie,0,0.00%,19,19,0.00%
mail.google.com,0,0.00%,72,72,0.00%
apd-vodp2pnat.teg.tencent-cloud.net,0,0.00%,6,6,0.00%
sug.so.360.cn,0,0.00%,6,6,0.00%
graph.qq.com,0,0.00%,50,50,0.00%
maxineapi.razersynapse.com,0,0.00%,2,2,0.00%
vibe.sleepyinternetfun.xyz,0,0.00%,4,4,0.00%
hubble.netease.com,0,0.00%,3,3,0.00%
www.torrent.eu.org,0,0.00%,2,2,0.00%
releases.obsidian.md,0,0.00%,4,4,0.00%
raw.githubusercontent.com,0,0.00%,52,52,0.00%
static.vifird.com,0,0.00%,2,2,0.00%
drive.kdocs.cn,0,0.00%,7,7,0.00%
1337.abcvg.info,0,0.00%,18,18,0.00%
rt.tace.ru,0,0.00%,18,18,0.00%
tracker.anirena.com,0,0.00%,20,20,0.00%
vtmhz.ys7.com,0,0.00%,4,4,0.00%
log.ys7.com,0,0.00%,6,6,0.00%
tieba.baidu.com,0,0.00%,58,58,0.00%
ad-c2s.fengmanginfo.com,0,0.00%,2,2,0.00%
t.nyaatracker.com,0,0.00%,8,8,0.00%
overleaf.cipsup.cn,0,0.00%,2,2,0.00%
tracker.shkinev.me,0,0.00%,10,10,0.00%
tracker.tfile.co,0,0.00%,17,17,0.00%
gsa.apple.com,0,0.00%,18,18,0.00%
cgedataservice.jd.com,0,0.00%,4,4,0.00%
server.reverse.ac.cn,0,0.00%,99,99,0.00%
tracker.ds.is,0,0.00%,3,3,0.00%
trk.publictracker.xyz,0,0.00%,13,13,0.00%
tracker.lilithraws.cf,0,0.00%,22,22,0.00%
weibo.com,0,0.00%,85,85,0.00%
speedup.vivo.com.cn,0,0.00%,2,2,0.00%
finance.sina.com.cn,0,0.00%,12,12,0.00%
roaming.officeapps.live.com,0,0.00%,56,56,0.00%
yyb.eve.mdt.qq.com,0,0.00%,9,9,0.00%
discord.heihachi.pw,0,0.00%,19,19,0.00%
shu6.y.qq.com,0,0.00%,2,2,0.00%
tracker.zerobytes.xyz,0,0.00%,16,16,0.00%
oases.baidu.com,0,0.00%,2,2,0.00%
www.huxiu.com,0,0.00%,2,2,0.00%
ad-sdk.huxiu.com,0,0.00%,2,2,0.00%
www-api.huxiu.com,0,0.00%,2,2,0.00%
api-article.huxiu.com,0,0.00%,2,2,0.00%
exodus.desync.com,0,0.00%,6,6,0.00%
free.publictracker.xyz,0,0.00%,14,14,0.00%
baichuan-api.huxiu.com,0,0.00%,2,2,0.00%
message-api.huxiu.com,0,0.00%,2,2,0.00%
etax.shenzhen.chinatax.gov.cn,0,0.00%,4,4,0.00%
node.video.qq.com,0,0.00%,34,34,0.00%
open.demonii.com,0,0.00%,2,2,0.00%
log-api-mn.huxiu.com,0,0.00%,2,2,0.00%
log-api.huxiu.com,0,0.00%,2,2,0.00%
comment-api.huxiu.com,0,0.00%,2,2,0.00%
api-ad-product.huxiu.com,0,0.00%,2,2,0.00%
opentracker.i2p.rocks,0,0.00%,4,4,0.00%
retracker.netbynet.ru,0,0.00%,17,17,0.00%
comtrade.un.org,0,0.00%,2,2,0.00%
video.yidianzixun.com,0,0.00%,18,18,0.00%
www.m9ynqi6d.com,0,0.00%,24,24,0.00%
ratings-wrs.norton.com,0,0.00%,2,2,0.00%
favicon.yandex.net,0,0.00%,2,2,0.00%
us06.mellanox.info,0,0.00%,2,2,0.00%
vdwmto3.bdstatic.com,0,0.00%,16,16,0.00%
cloudservice22.kingsoft-office-service.com,0,0.00%,8,8,0.00%
connect.rom.miui.com,0,0.00%,74,74,0.00%
www.expressapisv2.net,0,0.00%,64,64,0.00%
nzk.woqu365.com,0,0.00%,4,4,0.00%
xui.ptlogin2.qq.com,0,0.00%,49,49,0.00%
ftp.hp.com,0,0.00%,6,6,0.00%
ftp.ext.hp.com,0,0.00%,4,4,0.00%
oss.hpconnected.com,0,0.00%,16,16,0.00%
u.zyinfotech.com,0,0.00%,2,2,0.00%
vamd.cnode.xyz,0,0.00%,2,2,0.00%
tk2.taou.com,0,0.00%,6,6,0.00%
interface3.music.163.com,0,0.00%,13,13,0.00%
apiv2.fangcloud.com,0,0.00%,2,2,0.00%
api.msn.cn,0,0.00%,6,6,0.00%
uplog.qbox.me,0,0.00%,4,4,0.00%
maimai.cn,0,0.00%,4,4,0.00%
api.taou.com,0,0.00%,6,6,0.00%
tracker.files.fm,0,0.00%,12,12,0.00%
open.taou.com,0,0.00%,6,6,0.00%
push.gifshow.com,0,0.00%,2,2,0.00%
windows.msn.com,0,0.00%,4,4,0.00%
video-bd-drcn.dbankcdn.cn,0,0.00%,40,40,0.00%
mixv4-5.194610.xyz,0,0.00%,2,2,0.00%
s3m6.fenxi.com,0,0.00%,7,7,0.00%
api.wcc.best,0,0.00%,8,8,0.00%
router16.teamviewer.com,0,0.00%,24,24,0.00%
plussvr.wps.cn,0,0.00%,18,18,0.00%
qat05.virtual-strike.com,0,0.00%,2,2,0.00%
api.network.apm.miwifi.com,0,0.00%,5,5,0.00%
ssl.look.360.cn,0,0.00%,27,27,0.00%
m.jrj.com.cn,0,0.00%,4,4,0.00%
mp.360.cn,0,0.00%,6,6,0.00%
t7z.cupid.iqiyi.com,0,0.00%,12,12,0.00%
pic8.iqiyipic.com,0,0.00%,4,4,0.00%
szlong.weixin.qq.com,0,0.00%,22,22,0.00%
ins-r23tsuuf.ias.tencent-cloud.net,0,0.00%,23,23,0.00%
8-courier.push.apple.com,0,0.00%,19,19,0.00%
hkbn2.tcpbbr.net,0,0.00%,2,2,0.00%
cloudtips.1360.com,0,0.00%,2,2,0.00%
atoken.m.taobao.com,0,0.00%,2,2,0.00%
msgacs.m.taobao.com,0,0.00%,3,3,0.00%
apoll.m.taobao.com,0,0.00%,2,2,0.00%
asst-api.ksord.com,0,0.00%,3,3,0.00%
wiki.winehq.org,0,0.00%,2,2,0.00%
msgcenter.wps.cn,0,0.00%,15,15,0.00%
api.aquamedian.com,0,0.00%,61,61,0.00%
baijiahao.baidu.com,0,0.00%,5,5,0.00%
log.u.wps.cn,0,0.00%,3,3,0.00%
asst-stat.ksord.com,0,0.00%,7,7,0.00%
p218-caldav.icloud.com.cn,0,0.00%,8,8,0.00%
doh.360.cn,0,0.00%,10,10,0.00%
vcode-or.vivo.com.cn,0,0.00%,7,7,0.00%
api.pinduoduo.com,0,0.00%,14,14,0.00%
tracker.v6speed.org,0,0.00%,6,6,0.00%
vpn.maskvpn.cc,0,0.00%,1,1,0.00%
onrt.stsdk.vivo.com.cn,0,0.00%,2,2,0.00%
aidc.apple.com,0,0.00%,2,2,0.00%
qdyn.wps.cn,0,0.00%,41,41,0.00%
cmgz.10242018.xyz,0,0.00%,4,4,0.00%
xabjs3.icloud-content.com.cn,0,0.00%,6,6,0.00%
wspeed.qq.com,0,0.00%,10,10,0.00%
kgb-ifs.tanx.com,0,0.00%,4,4,0.00%
edge.ivideo.sina.com.cn,0,0.00%,31,31,0.00%
dev.ditu.live.com,0,0.00%,71,71,0.00%
m-flare.bokecc.com,0,0.00%,4,4,0.00%
update3.sangfor.net,0,0.00%,1,1,0.00%
ts.qq.com,0,0.00%,67,67,0.00%
bingciservice.koreasouth.cloudapp.azure.com,0,0.00%,22,22,0.00%
www.zto.com,0,0.00%,3,3,0.00%
uedcdn.zto.com,0,0.00%,2,2,0.00%
q.zto.com,0,0.00%,4,4,0.00%
hdgateway.zto.com,0,0.00%,4,4,0.00%
ad-putting.gw.zt-express.com,0,0.00%,4,4,0.00%
zcat-pc.zto.com,0,0.00%,4,4,0.00%
realtimeweb01.fangcloud.com,0,0.00%,4,4,0.00%
api.mendeley.com,0,0.00%,2,2,0.00%
aeventlog.beacon.qq.com,0,0.00%,12,12,0.00%
mapi.zto.com,0,0.00%,4,4,0.00%
pis.alicdn.com,0,0.00%,6,6,0.00%
pptsgs.officeapps.live.com,0,0.00%,3,3,0.00%
shasta-rrs.norton.com,0,0.00%,2,2,0.00%
snowflake.qq.com,0,0.00%,4,4,0.00%
imgcache.qq.com,0,0.00%,42,42,0.00%
cn.fflogs.com,0,0.00%,1,1,0.00%
o1075689.ingest.sentry.io,0,0.00%,2,2,0.00%
appservice.qq.com,0,0.00%,2,2,0.00%
www.mendeley.com,0,0.00%,2,2,0.00%
log.tbs.qq.com,0,0.00%,8,8,0.00%
smtp.cstnet.cn,0,0.00%,2,2,0.00%
sp2.baidu.com,0,0.00%,29,29,0.00%
hovv.yilanvaas.com,0,0.00%,21,21,0.00%
netapm.music.163.com,0,0.00%,2,2,0.00%
passport.baidu.com,0,0.00%,54,54,0.00%
loggw-ex.alipay.com,0,0.00%,9,9,0.00%
mtalk.google.com,0,0.00%,202,202,0.00%
iepl-tunnel.global-idc.net,0,0.00%,2,2,0.00%
api.yiban.io,0,0.00%,1,1,0.00%
displaycatalog.mp.microsoft.com,0,0.00%,16,16,0.00%
oneocsp.microsoft.com,0,0.00%,12,12,0.00%
online.b.api.cqttech.com,0,0.00%,3,3,0.00%
interface.music.163.com,0,0.00%,13,13,0.00%
hsk-embed.oray.com,0,0.00%,630,630,0.00%
onedriveclucprodbn20047.blob.core.windows.net,0,0.00%,8,8,0.00%
onedriveclucproddm20046.blob.core.windows.net,0,0.00%,8,8,0.00%
event.games.laohu.com,0,0.00%,5,5,0.00%
browser5.qhimg.com,0,0.00%,6,6,0.00%
browser6.qhimg.com,0,0.00%,9,9,0.00%
suggestion.baidu.com,0,0.00%,6,6,0.00%
pcapp-data-collect.youku.com,0,0.00%,13,13,0.00%
mcafee-sustainability.azurewebsites.net,0,0.00%,143,143,0.00%
mrodevicemgr.officeapps.live.com,0,0.00%,40,40,0.00%
link.csdn.net,0,0.00%,6,6,0.00%
router2.teamviewer.com,0,0.00%,25,25,0.00%
recruitprod.azurefd.net,0,0.00%,2,2,0.00%
dr.ime.baidu.com,0,0.00%,103,103,0.00%
dict.youdao.com,0,0.00%,42,42,0.00%
recruit.microsoft.com,0,0.00%,2,2,0.00%
outlookmobile-office365-tas.msedge.net,0,0.00%,7,7,0.00%
mobile.pipe.aria.microsoft.com,0,0.00%,43,43,0.00%
vpn.smartdot.com.cn,0,0.00%,3,3,0.00%
openreview.net,0,0.00%,4,4,0.00%
js.monitor.azure.com,0,0.00%,4,4,0.00%
rq.lbcct.cloud.duba.net,0,0.00%,56,56,0.00%
array605.prod.do.dsp.mp.microsoft.com,0,0.00%,36,36,0.00%
openlocation-drcn.platform.dbankcloud.com,0,0.00%,51,51,0.00%
control.aps.amap.com,0,0.00%,6,6,0.00%
mscareers.b2clogin.com,0,0.00%,2,2,0.00%
wcpstatic.microsoft.com,0,0.00%,2,2,0.00%
time.asia.apple.com,0,0.00%,48,48,0.00%
guzzoni-apple-com.v.aaplimg.com,0,0.00%,25,25,0.00%
libs.baidu.com,0,0.00%,2,2,0.00%
helpdubaclient.ksmobile.com,0,0.00%,59,59,0.00%
config.mobile.kugou.com,0,0.00%,16,16,0.00%
connect.unity.cn,0,0.00%,40,40,0.00%
p.api.pc120.com,0,0.00%,4,4,0.00%
apd-d0abb49c9eefbf000b7a6e2a3e1fcbf2.v.smtcdns.com,0,0.00%,2,2,0.00%
onedriveclucprodbn20044.blob.core.windows.net,0,0.00%,4,4,0.00%
tuna05.mcddns01.com,0,0.00%,50,50,0.00%
fe3cr.delivery.mp.microsoft.com,0,0.00%,131,131,0.00%
uclient.yonyou.com,0,0.00%,2,2,0.00%
recruitapi.microsoft.com,0,0.00%,2,2,0.00%
acs-ui.azureedge.net,0,0.00%,2,2,0.00%
apis-mix-pub.maxhub.vip,0,0.00%,18,18,0.00%
www.zhipin.com,0,0.00%,32,32,0.00%
modao.cc,0,0.00%,22,22,0.00%
www.hotels.cn,0,0.00%,4,4,0.00%
aaai.org,0,0.00%,2,2,0.00%
report.51nwt.com,0,0.00%,2,2,0.00%
router1.teamviewer.com,0,0.00%,32,32,0.00%
www.bangkokbank.com,0,0.00%,1,1,0.00%
d33vwaa6rdensn.cloudfront.net,0,0.00%,1,1,0.00%
consentreceiverfd-prod.azurefd.net,0,0.00%,2,2,0.00%
api.ivideo.sina.com.cn,0,0.00%,28,28,0.00%
ff-ip4-mx-vip1.prodigy.net,0,0.00%,6,6,0.00%
data.mistat.xiaomi.com,0,0.00%,16,16,0.00%
contentsec.ac.cn,0,0.00%,101,101,0.00%
vcheck.f.360.cn,0,0.00%,20,20,0.00%
spo-ring.msedge.net,0,0.00%,16,16,0.00%
1c9354e2776eb4e1037e601c7ce05f7e.nrb.footprintdns.com,0,0.00%,1,1,0.00%
fp-vs.azureedge.net,0,0.00%,4,4,0.00%
42-courier.push.apple.com,0,0.00%,12,12,0.00%
portal.arp.cn,0,0.00%,2,2,0.00%
www.amazon.co,0,0.00%,1,1,0.00%
iscas.arp.cn,0,0.00%,2,2,0.00%
data.osdknw.com,0,0.00%,2,2,0.00%
report.url.cn,0,0.00%,97,97,0.00%
mail.126.com,0,0.00%,30,30,0.00%
822e67d7d35f8dabf29abf7d79f104ce.nrb.footprintdns.com,0,0.00%,1,1,0.00%
popsimu.azchcdnk.com,0,0.00%,2,2,0.00%
static-ecst.licdn.com,0,0.00%,4,4,0.00%
cloudconfig.jetbrains.com,0,0.00%,15,15,0.00%
afdxtest.z01.azurefd.net,0,0.00%,2,2,0.00%
schemastore.org,0,0.00%,8,8,0.00%
www.schemastore.org,0,0.00%,5,5,0.00%
router10.teamviewer.com,0,0.00%,20,20,0.00%
s.bbm0v.cn,0,0.00%,5,5,0.00%
t.helper.2345.cc,0,0.00%,16,16,0.00%
www.baiduyiyi.com,0,0.00%,2,2,0.00%
careers.microsoft.com,0,0.00%,2,2,0.00%
inappcheck.itunes.apple.com.download.ks-cdn.com,0,0.00%,8,8,0.00%
news.qhstatic.com,0,0.00%,12,12,0.00%
y2eziy020513cf52.aliyunddos1026.com,0,0.00%,2,2,0.00%
alog.iclick.com.cn,0,0.00%,3,3,0.00%
paradromic.info,0,0.00%,10,10,0.00%
stat.download.xunlei.com,0,0.00%,2,2,0.00%
ci.xiaohongshu.com,0,0.00%,4,4,0.00%
hiya.browser.360.cn,0,0.00%,19,19,0.00%
mapi.alipay.com,0,0.00%,2,2,0.00%
unitradeadapter.alipay.com,0,0.00%,2,2,0.00%
app.alipay.com,0,0.00%,2,2,0.00%
cashier.alipay.com,0,0.00%,2,2,0.00%
shenghuo.alipay.com,0,0.00%,2,2,0.00%
ad-monitor.sh9130.com,0,0.00%,8,8,0.00%
up-hl.3g.qq.com,0,0.00%,7,7,0.00%
push.khd.2345.cc,0,0.00%,27,27,0.00%
apps.arp.cn,0,0.00%,8,8,0.00%
app.jianguoyun.com,0,0.00%,23,23,0.00%
mcs.snssdk.com,0,0.00%,21,21,0.00%
rq.drcct.cloud.duba.net,0,0.00%,110,110,0.00%
pc-api.300624.com,0,0.00%,24,24,0.00%
www.codota.com,0,0.00%,18,18,0.00%
gtm-sg-6wr2u201t05.gtm-i2d4.com,0,0.00%,45,45,0.00%
home.firefoxchina.cn,0,0.00%,4,4,0.00%
home.firefoxchina.cn.wswebpic.com,0,0.00%,4,4,0.00%
push.services.mozilla.com,0,0.00%,28,28,0.00%
cl2-cn.apple.com,0,0.00%,15,15,0.00%
bookmarks-ssl.firefoxchina.cn.wswebpic.com,0,0.00%,2,2,0.00%
hm.e.shifen.com,0,0.00%,23,23,0.00%
p0.qhimgs4.com,0,0.00%,2,2,0.00%
k-static.xsfaya.com,0,0.00%,4,4,0.00%
k-static.xsfaya.com.wswebcdn.com,0,0.00%,4,4,0.00%
infoc0.duba.net,0,0.00%,24,24,0.00%
info.52pcfree.com,0,0.00%,25,25,0.00%
yj.52pcfree.com,0,0.00%,8,8,0.00%
mhxzxhd.wmupd.com,0,0.00%,8,8,0.00%
adu.g-fox.cn,0,0.00%,4,4,0.00%
ldapi.ldmnq.com,0,0.00%,19,19,0.00%
jslog.jss.com.cn,0,0.00%,2,2,0.00%
prt.jss.com.cn,0,0.00%,12,12,0.00%
offline.aps.amap.com,0,0.00%,21,21,0.00%
i.snssdk.com,0,0.00%,5,5,0.00%
img1.wywyx.com,0,0.00%,2,2,0.00%
img1.wywyx.com.w.kunlunca.com,0,0.00%,2,2,0.00%
ac2.dcloud.net.cn,0,0.00%,2,2,0.00%
sdk.api.oaid.wocloud.cn,0,0.00%,1,1,0.00%
metrics1.data.dbankcloud.cn,0,0.00%,6,6,0.00%
events-drcn.op.dbankcloud.cn,0,0.00%,29,29,0.00%
sdk.open.talk.getui.net,0,0.00%,10,10,0.00%
sdk.open.talk.gepush.com,0,0.00%,10,10,0.00%
cm-10-135.getui.com,0,0.00%,2,2,0.00%
cqs-drcn.emui.dbankcloud.cn,0,0.00%,2,2,0.00%
oauth.hrsoft.com.cn,0,0.00%,2,2,0.00%
s1.dcloud.net.cn,0,0.00%,2,2,0.00%
events.op.hicloud.com,0,0.00%,8,8,0.00%
i.youdao.com,0,0.00%,2,2,0.00%
write.youdao.com,0,0.00%,2,2,0.00%
www.youdao.com,0,0.00%,4,4,0.00%
px.ads.linkedin.com,0,0.00%,6,6,0.00%
trans.hiido.com,0,0.00%,6,6,0.00%
yeconfig.game.yy.com,0,0.00%,5,5,0.00%
config.hiido.com,0,0.00%,5,5,0.00%
ylog.hiido.com,0,0.00%,6,6,0.00%
router5.teamviewer.com,0,0.00%,26,26,0.00%
service.alljournals.cn,0,0.00%,4,4,0.00%
yxdt.game.keniub.com,0,0.00%,4,4,0.00%
home.360game.360.cn,0,0.00%,2,2,0.00%
v5.360game.360.cn,0,0.00%,2,2,0.00%
dualstack-a.apilocate.amap.com,0,0.00%,6,6,0.00%
docs.python.org,0,0.00%,2,2,0.00%
pandas.pydata.org,0,0.00%,2,2,0.00%
webvpn.bit.edu.cn,0,0.00%,2,2,0.00%
yangzhangalmo.github.io,0,0.00%,4,4,0.00%
cispa-de.zoom.us,0,0.00%,3,3,0.00%
zoom.us,0,0.00%,2,2,0.00%
stat.game.yy.com,0,0.00%,6,6,0.00%
res.qhupdate.com,0,0.00%,6,6,0.00%
prod-classifyclient.normandy.prod.cloudops.mozgcp.net,0,0.00%,16,16,0.00%
todolist.redirect.xzdesktop.cqttech.com,0,0.00%,18,18,0.00%
api2.openreview.net,0,0.00%,2,2,0.00%
sp3.baidu.com,0,0.00%,7,7,0.00%
api.wallpaper.xzdesktop.cqttech.com,0,0.00%,2,2,0.00%
ins-mfa9hirw.ias.tencent-cloud.net,0,0.00%,43,43,0.00%
push.zhihu.com,0,0.00%,5,5,0.00%
dualstack-cgicol.amap.com,0,0.00%,2,2,0.00%
www.amss.cas.cn,0,0.00%,4,4,0.00%
recruit.nimte.ac.cn,0,0.00%,4,4,0.00%
23a72c571eab6919.cdn.jiashule.com,0,0.00%,2,2,0.00%
i3.ytimg.com,0,0.00%,4,4,0.00%
i0.hdslb.com.04f6a54d.c.cdnhwc1.com,0,0.00%,10,10,0.00%
dns.nextdns.io,0,0.00%,2,2,0.00%
kuaikan.netmon.360safe.com,0,0.00%,8,8,0.00%
assets.activity.windows.com,0,0.00%,2,2,0.00%
kfcs.csc.com.cn,0,0.00%,28,28,0.00%
doh.mullvad.net,0,0.00%,4,4,0.00%
s3.nzbdw.com,0,0.00%,8,8,0.00%
onedriveclucproddm20040.blob.core.windows.net,0,0.00%,11,11,0.00%
cuiauth.lenovo.com.cn,0,0.00%,2,2,0.00%
cui.lenovo.com.cn,0,0.00%,2,2,0.00%
cuiapi.lenovo.com.cn,0,0.00%,2,2,0.00%
dsm01pap005.storage.live.com,0,0.00%,8,8,0.00%
arxiv.org,0,0.00%,10,10,0.00%
config.teams.microsoft.com,0,0.00%,57,57,0.00%
onedriveclucprodbn20023.blob.core.windows.net,0,0.00%,2,2,0.00%
code.jquery.com,0,0.00%,9,9,0.00%
arxiv-org.atlassian.net,0,0.00%,6,6,0.00%
mobilebackup.fe.apple-dns.cn,0,0.00%,2,2,0.00%
gsp10-ssl-cn.ls.apple.com,0,0.00%,11,11,0.00%
gspe35-ssl.ls.apple.com,0,0.00%,20,20,0.00%
m.huohua.cn,0,0.00%,2,2,0.00%
m.qq.com,0,0.00%,1,1,0.00%
m.jd.com,0,0.00%,1,1,0.00%
lookup.nextcloud.com,0,0.00%,72,72,0.00%
vv.video.qq.com,0,0.00%,29,29,0.00%
28-courier.push.apple.com,0,0.00%,12,12,0.00%
ns2.web.com.ph,0,0.00%,2,2,0.00%
rq.upgrade.cloud.duba.net,0,0.00%,66,66,0.00%
dns1.supremepanel.com,0,0.00%,4,4,0.00%
dns1.p06.nsone.net,0,0.00%,40,40,0.00%
carter.ns.cloudflare.com,0,0.00%,16,16,0.00%
us3-6.nigirocloud.com,0,0.00%,14,14,0.00%
ns2.dnsnuts.com,0,0.00%,12,12,0.00%
ns4.web.com.ph,0,0.00%,2,2,0.00%
jm1.alidns.com,0,0.00%,96,96,0.00%
ns2.domainnamedns.com,0,0.00%,26,26,0.00%
sara.ns.cloudflare.com,0,0.00%,22,22,0.00%
ns1.web.com.ph,0,0.00%,2,2,0.00%
ns-1192.awsdns-21.org,0,0.00%,2,2,0.00%
ns2.hover.com,0,0.00%,74,74,0.00%
ns03.domaincontrol.com,0,0.00%,216,216,0.00%
ns-1635.awsdns-12.co.uk,0,0.00%,2,2,0.00%
ns1.dns.com,0,0.00%,256,256,0.00%
ns-480.awsdns-60.com,0,0.00%,2,2,0.00%
ns1.taoa.com,0,0.00%,168,168,0.00%
ns2.dns.com,0,0.00%,256,256,0.00%
dns2.supremepanel.com,0,0.00%,4,4,0.00%
ns-518.awsdns-00.net,0,0.00%,2,2,0.00%
verification-pkasopq9.ns3.dan.hosting,0,0.00%,2,2,0.00%
ns2.taoa.com,0,0.00%,162,162,0.00%
pdns02.domaincontrol.com,0,0.00%,14,14,0.00%
ns1bqx.name.com,0,0.00%,12,12,0.00%
dns.home.pl,0,0.00%,6,6,0.00%
pdns01.domaincontrol.com,0,0.00%,14,14,0.00%
dns101.registrar-servers.com,0,0.00%,634,634,0.00%
hk04-vm5.entry.hsrtd.club,0,0.00%,6,6,0.00%
ns1.domainhasexpired.com,0,0.00%,16,16,0.00%
ns1.gocheapweb.com,0,0.00%,64,64,0.00%
adrian.ns.cloudflare.com,0,0.00%,8,8,0.00%
ns2.domainhasexpired.com,0,0.00%,14,14,0.00%
ns2.gocheapweb.com,0,0.00%,62,62,0.00%
kayden.ns.cloudflare.com,0,0.00%,8,8,0.00%
dns102.registrar-servers.com,0,0.00%,630,630,0.00%
greg.ns.cloudflare.com,0,0.00%,28,28,0.00%
rajeev.ns.cloudflare.com,0,0.00%,4,4,0.00%
magali.ns.cloudflare.com,0,0.00%,6,6,0.00%
ns63.domaincontrol.com,0,0.00%,132,132,0.00%
vth238.ruk-com.in.th,0,0.00%,4,4,0.00%
ns1.parklogic.com,0,0.00%,44,44,0.00%
ns64.domaincontrol.com,0,0.00%,128,128,0.00%
th238.ruk-com.in.th,0,0.00%,4,4,0.00%
ns2.parklogic.com,0,0.00%,44,44,0.00%
ns8106.hostgator.com,0,0.00%,2,2,0.00%
ns3.domainnamedns.com,0,0.00%,28,28,0.00%
ns2.c020jp4418.info,0,0.00%,2,2,0.00%
ns2.easyhost.be,0,0.00%,6,6,0.00%
ns5.afternic.com,0,0.00%,50,50,0.00%
ns3.easyhost.be,0,0.00%,6,6,0.00%
ns6.afternic.com,0,0.00%,46,46,0.00%
ns1.c020jp4418.info,0,0.00%,2,2,0.00%
ns2.interwebserver.com,0,0.00%,2,2,0.00%
ns19.domaincontrol.com,0,0.00%,238,238,0.00%
ns1.whc.ca,0,0.00%,2,2,0.00%
ns20.domaincontrol.com,0,0.00%,240,240,0.00%
ns2626.ztomy.com,0,0.00%,82,82,0.00%
ns1.itofficialchannel.com,0,0.00%,2,2,0.00%
ns1626.ztomy.com,0,0.00%,80,80,0.00%
dns2.p01.nsone.net,0,0.00%,30,30,0.00%
ns2.whc.ca,0,0.00%,2,2,0.00%
ns1.r4l.com,0,0.00%,8,8,0.00%
ns1.huaweicloud-dns.cn,0,0.00%,28,28,0.00%
alexa.ns.cloudflare.com,0,0.00%,4,4,0.00%
us3-7.nigirocloud.com,0,0.00%,14,14,0.00%
ns4233.hostgator.com,0,0.00%,30,30,0.00%
ns1.huaweicloud-dns.org,0,0.00%,30,30,0.00%
ns3.itofficialchannel.com,0,0.00%,2,2,0.00%
ns15.domaincontrol.com,0,0.00%,68,68,0.00%
ns75.domaincontrol.com,0,0.00%,224,224,0.00%
ns2.r4l.com,0,0.00%,6,6,0.00%
kia.ns.cloudflare.com,0,0.00%,6,6,0.00%
ns16.domaincontrol.com,0,0.00%,70,70,0.00%
ns14.hostgator.com.br,0,0.00%,2,2,0.00%
ns15.hostgator.com.br,0,0.00%,2,2,0.00%
stella.ns.cloudflare.com,0,0.00%,16,16,0.00%
dns.technorail.com,0,0.00%,44,44,0.00%
ayli510668.mercury.orderbox-dns.com,0,0.00%,2,2,0.00%
jm2.alidns.com,0,0.00%,98,98,0.00%
dns3.arubadns.net,0,0.00%,42,42,0.00%
ns2.itofficialchannel.com,0,0.00%,2,2,0.00%
ayli510668.venus.orderbox-dns.com,0,0.00%,2,2,0.00%
stxyxp.com,0,0.00%,2,2,0.00%
ayli510668.mars.orderbox-dns.com,0,0.00%,2,2,0.00%
ns1.bh-in-32.webhostbox.net,0,0.00%,2,2,0.00%
study.163.com,0,0.00%,2,2,0.00%
ns2.yongldns.com,0,0.00%,2,2,0.00%
ns311.easyhost.pk,0,0.00%,2,2,0.00%
ns48.sohosted.net,0,0.00%,2,2,0.00%
ns4232.hostgator.com,0,0.00%,10,10,0.00%
ns4.itofficialchannel.com,0,0.00%,2,2,0.00%
dns4.arubadns.cz,0,0.00%,48,48,0.00%
ty1-2.nigirocloud.com,0,0.00%,14,14,0.00%
ty1-1.nigirocloud.com,0,0.00%,14,14,0.00%
us3-8.nigirocloud.com,0,0.00%,14,14,0.00%
ns1021.ui-dns.org,0,0.00%,4,4,0.00%
ns312.easyhost.pk,0,0.00%,2,2,0.00%
bugreport.huorong.cn,0,0.00%,41,41,0.00%
verification-360e6dea.ns3.dan.hosting,0,0.00%,2,2,0.00%
ns1.seodnss.com,0,0.00%,10,10,0.00%
ns1102.ui-dns.biz,0,0.00%,4,4,0.00%
ty1-3.nigirocloud.com,0,0.00%,14,14,0.00%
ty1-4.nigirocloud.com,0,0.00%,14,14,0.00%
123.sogou.com,0,0.00%,15,15,0.00%
ns48.sohosted.com,0,0.00%,2,2,0.00%
ty2-2.nigirocloud.com,0,0.00%,14,14,0.00%
download.comodo.com,0,0.00%,4,4,0.00%
ntp4.aliyun.com,0,0.00%,18,18,0.00%
www.amap.com,0,0.00%,2,2,0.00%
ty2-3.nigirocloud.com,0,0.00%,14,14,0.00%
adi.ns.cloudflare.com,0,0.00%,8,8,0.00%
ty2-4.nigirocloud.com,0,0.00%,14,14,0.00%
hunts.ns.cloudflare.com,0,0.00%,4,4,0.00%
ns1.estibotmarket.com,0,0.00%,2,2,0.00%
ns2.mtavdns.com,0,0.00%,40,40,0.00%
ns2.c007jp6769.info,0,0.00%,2,2,0.00%
directupdates.f-prot.net,0,0.00%,4,4,0.00%
cdn.download.comodo.com,0,0.00%,4,4,0.00%
doh-de.blahdns.com,0,0.00%,4,4,0.00%
ns2.c026jp1855.info,0,0.00%,2,2,0.00%
prod-sav-park-lb01-1919960993.us-east-2.elb.amazonaws.com,0,0.00%,142,142,0.00%
ty2-5.nigirocloud.com,0,0.00%,14,14,0.00%
ns1.c026jp1855.info,0,0.00%,2,2,0.00%
f1g1ns1.dnspod.net,0,0.00%,66,66,0.00%
ns1.mtavdns.com,0,0.00%,38,38,0.00%
ty2-6.nigirocloud.com,0,0.00%,14,14,0.00%
ty2-7.nigirocloud.com,0,0.00%,14,14,0.00%
ns2.estibotmarket.com,0,0.00%,2,2,0.00%
ty2-8.nigirocloud.com,0,0.00%,14,14,0.00%
amit.ns.cloudflare.com,0,0.00%,4,4,0.00%
os1-2.nigirocloud.com,0,0.00%,14,14,0.00%
os1-1.nigirocloud.com,0,0.00%,14,14,0.00%
ns58.tr.dnsowner.com,0,0.00%,4,4,0.00%
verification-moqhhtk0.ns3.dan.hosting,0,0.00%,2,2,0.00%
ns1029.ui-dns.com,0,0.00%,4,4,0.00%
ns59.tr.dnsowner.com,0,0.00%,4,4,0.00%
os1-3.nigirocloud.com,0,0.00%,14,14,0.00%
ns200.anycast.me,0,0.00%,28,28,0.00%
a.mb.cn,0,0.00%,4,4,0.00%
dns26.hichina.com,0,0.00%,36,36,0.00%
os1-4.nigirocloud.com,0,0.00%,14,14,0.00%
cns6001.bigrock.com,0,0.00%,2,2,0.00%
ns1069.ui-dns.org,0,0.00%,4,4,0.00%
ns1018.ui-dns.de,0,0.00%,8,8,0.00%
cns6002.bigrock.com,0,0.00%,2,2,0.00%
ns1040.ui-dns.de,0,0.00%,6,6,0.00%
ns1113.ui-dns.biz,0,0.00%,6,6,0.00%
ns1030.ui-dns.com,0,0.00%,2,2,0.00%
os1-5.nigirocloud.com,0,0.00%,14,14,0.00%
os1-6.nigirocloud.com,0,0.00%,14,14,0.00%
os1-7.nigirocloud.com,0,0.00%,14,14,0.00%
anycast02.scalabledns.com,0,0.00%,2,2,0.00%
ns1125.ui-dns.biz,0,0.00%,2,2,0.00%
ns2.heroxhost.com,0,0.00%,2,2,0.00%
ns1.heroxhost.com,0,0.00%,2,2,0.00%
os1-8.nigirocloud.com,0,0.00%,14,14,0.00%
ns2.lebodns.com,0,0.00%,26,26,0.00%
ns4231.hostgator.com,0,0.00%,8,8,0.00%
dns3.p01.nsone.net,0,0.00%,34,34,0.00%
dns4.p01.nsone.net,0,0.00%,32,32,0.00%
os2-1.nigirocloud.com,0,0.00%,14,14,0.00%
dns1.catsi.org,0,0.00%,2,2,0.00%
os2-2.nigirocloud.com,0,0.00%,14,14,0.00%
ns01.squarespacedns.com,0,0.00%,42,42,0.00%
ns02.squarespacedns.com,0,0.00%,38,38,0.00%
ns03.squarespacedns.com,0,0.00%,40,40,0.00%
ns04.squarespacedns.com,0,0.00%,40,40,0.00%
rc10-fc03.oray.com,0,0.00%,2,2,0.00%
www.66law.cn,0,0.00%,2,2,0.00%
dns2.catsi.org,0,0.00%,2,2,0.00%
os2-4.nigirocloud.com,0,0.00%,14,14,0.00%
os2-5.nigirocloud.com,0,0.00%,14,14,0.00%
os2-6.nigirocloud.com,0,0.00%,14,14,0.00%
anycast01.scalabledns.com,0,0.00%,2,2,0.00%
cdn.66law.cn,0,0.00%,2,2,0.00%
cache.66law.cn,0,0.00%,2,2,0.00%
g.66law.cn,0,0.00%,2,2,0.00%
imga.66law.cn,0,0.00%,2,2,0.00%
imgf.66law.cn,0,0.00%,2,2,0.00%
imgt.66law.cn,0,0.00%,4,4,0.00%
imgp.66law.cn,0,0.00%,4,4,0.00%
j.66law.cn,0,0.00%,2,2,0.00%
login.66law.cn,0,0.00%,4,4,0.00%
imgr.66law.cn,0,0.00%,4,4,0.00%
os2-7.nigirocloud.com,0,0.00%,14,14,0.00%
os2-8.nigirocloud.com,0,0.00%,14,14,0.00%
www.64365.com,0,0.00%,2,2,0.00%
j.map.baidu.com,0,0.00%,5,5,0.00%
lawyers.66law.cn,0,0.00%,2,2,0.00%
m.66law.cn,0,0.00%,2,2,0.00%
news.66law.cn,0,0.00%,2,2,0.00%
wpa.qq.com,0,0.00%,4,4,0.00%
ykf-webchat.7moor.com,0,0.00%,2,2,0.00%
image.64365.com,0,0.00%,2,2,0.00%
p.64365.com,0,0.00%,2,2,0.00%
login.64365.com,0,0.00%,2,2,0.00%
wenji.64365.com,0,0.00%,2,2,0.00%
nl1-1.nigirocloud.com,0,0.00%,14,14,0.00%
hgc3.edgehelper.com,0,0.00%,7,7,0.00%
ykf-uba.7moor.com,0,0.00%,2,2,0.00%
mam.ntes53.netease.com,0,0.00%,6,6,0.00%
nl1-2.nigirocloud.com,0,0.00%,14,14,0.00%
nl1-3.nigirocloud.com,0,0.00%,14,14,0.00%
api.share.baidu.com,0,0.00%,9,9,0.00%
nl1-4.nigirocloud.com,0,0.00%,14,14,0.00%
c.dun.163.com,0,0.00%,9,9,0.00%
nl1-5.nigirocloud.com,0,0.00%,14,14,0.00%
captive-cidr.origin-apple.com.akadns.net,0,0.00%,4,4,0.00%
nl1-6.nigirocloud.com,0,0.00%,14,14,0.00%
nl1-7.nigirocloud.com,0,0.00%,10,10,0.00%
ac.dun.163.com,0,0.00%,28,28,0.00%
22bcc25a6f606eb5.jijifun.com,0,0.00%,7,7,0.00%
nl1-8.nigirocloud.com,0,0.00%,14,14,0.00%
nl3-1.nigirocloud.com,0,0.00%,14,14,0.00%
nl3-2.nigirocloud.com,0,0.00%,14,14,0.00%
nl3-3.nigirocloud.com,0,0.00%,14,14,0.00%
nl3-4.nigirocloud.com,0,0.00%,14,14,0.00%
nl3-5.nigirocloud.com,0,0.00%,14,14,0.00%
nl3-6.nigirocloud.com,0,0.00%,14,14,0.00%
ns1.yeyehaidns.com,0,0.00%,58,58,0.00%
nl3-7.nigirocloud.com,0,0.00%,14,14,0.00%
ns2.yeyehaidns.com,0,0.00%,56,56,0.00%
ns2.seodnss.com,0,0.00%,8,8,0.00%
ns2.domesticmodern.com,0,0.00%,2,2,0.00%
ns0.parkdomainwithait.com,0,0.00%,4,4,0.00%
ns6581.hostgator.com,0,0.00%,4,4,0.00%
ns3.panelbox.net,0,0.00%,4,4,0.00%
ns1.panelbox.net,0,0.00%,4,4,0.00%
ns1100.ui-dns.biz,0,0.00%,4,4,0.00%
ns4.panelbox.net,0,0.00%,4,4,0.00%
bromo.cloudhost.id,0,0.00%,2,2,0.00%
ns1.parkdomainwithait.com,0,0.00%,4,4,0.00%
ns1.lebodns.com,0,0.00%,26,26,0.00%
dns2.p02.nsone.net,0,0.00%,38,38,0.00%
security.ie.sogou.com,0,0.00%,4,4,0.00%
ns1.dominios.uol.com.br,0,0.00%,22,22,0.00%
shades03.rzone.de,0,0.00%,6,6,0.00%
39-courier.push.apple.com,0,0.00%,16,16,0.00%
ns6582.hostgator.com,0,0.00%,4,4,0.00%
ns2.c016jp9160.info,0,0.00%,2,2,0.00%
darl.ns.cloudflare.com,0,0.00%,6,6,0.00%
nl3-8.nigirocloud.com,0,0.00%,14,14,0.00%
mina.ns.cloudflare.com,0,0.00%,4,4,0.00%
ns1026.ui-dns.org,0,0.00%,4,4,0.00%
ns1074.ui-dns.com,0,0.00%,2,2,0.00%
ns2.ipage.com,0,0.00%,22,22,0.00%
ns1.ipage.com,0,0.00%,22,22,0.00%
ns1056.ui-dns.de,0,0.00%,14,14,0.00%
alfred.ns.cloudflare.com,0,0.00%,2,2,0.00%
dns200.anycast.me,0,0.00%,24,24,0.00%
ns2.guzelhosting.com,0,0.00%,16,16,0.00%
ns1104.ui-dns.de,0,0.00%,2,2,0.00%
tessa.ns.cloudflare.com,0,0.00%,4,4,0.00%
ns2.panelbox.net,0,0.00%,2,2,0.00%
margaret.ns.cloudflare.com,0,0.00%,2,2,0.00%
ns2.bluehost.in,0,0.00%,8,8,0.00%
trevor.ns.cloudflare.com,0,0.00%,2,2,0.00%
ns1016.ui-dns.com,0,0.00%,2,2,0.00%
blob.bnz13prdstr09a.store.core.windows.NET,0,0.00%,2,2,0.00%
ns2.hostex.lt,0,0.00%,2,2,0.00%
dns2.p06.nsone.net,0,0.00%,36,36,0.00%
ns1038.ui-dns.biz,0,0.00%,2,2,0.00%
dns3.p06.nsone.net,0,0.00%,38,38,0.00%
dns4.p06.nsone.net,0,0.00%,38,38,0.00%
jo.ns.cloudflare.com,0,0.00%,10,10,0.00%
ns4.hostex.lt,0,0.00%,2,2,0.00%
uk1-1.nigirocloud.com,0,0.00%,14,14,0.00%
ns1.domainnamedns.com,0,0.00%,28,28,0.00%
uk1-2.nigirocloud.com,0,0.00%,12,12,0.00%
ip.sb,0,0.00%,40,40,0.00%
ns3.hostex.lt,0,0.00%,2,2,0.00%
uk1-3.nigirocloud.com,0,0.00%,14,14,0.00%
uk1-4.nigirocloud.com,0,0.00%,14,14,0.00%
ns1.hostex.lt,0,0.00%,2,2,0.00%
ns1.namefind.com,0,0.00%,10,10,0.00%
num0.17986.net,0,0.00%,2,2,0.00%
ns1.cp-13.bigrockservers.com,0,0.00%,2,2,0.00%
ns2.brandbucket.com,0,0.00%,14,14,0.00%
chaolianshop.com,0,0.00%,2,2,0.00%
clark.ns.cloudflare.com,0,0.00%,12,12,0.00%
ns2.cp-13.bigrockservers.com,0,0.00%,2,2,0.00%
ns1.brandbucket.com,0,0.00%,14,14,0.00%
craig.ns.cloudflare.com,0,0.00%,2,2,0.00%
alex.ns.cloudflare.com,0,0.00%,18,18,0.00%
mariah.ns.cloudflare.com,0,0.00%,4,4,0.00%
ns1049.ui-dns.biz,0,0.00%,2,2,0.00%
ns8105.hostgator.com,0,0.00%,2,2,0.00%
debby.dnspod.net,0,0.00%,2,2,0.00%
roan.ns.cloudflare.com,0,0.00%,10,10,0.00%
ns6163.hostgator.com,0,0.00%,2,2,0.00%
erin.ns.cloudflare.com,0,0.00%,12,12,0.00%
oyster.dnspod.net,0,0.00%,2,2,0.00%
kenneth.ns.cloudflare.com,0,0.00%,4,4,0.00%
docks15.rzone.de,0,0.00%,8,8,0.00%
ollie.ns.cloudflare.com,0,0.00%,4,4,0.00%
ns1126.ui-dns.de,0,0.00%,4,4,0.00%
dns.down7906.com,0,0.00%,2,2,0.00%
ns4235.hostgator.com,0,0.00%,2,2,0.00%
ns12.xincache.com,0,0.00%,72,72,0.00%
ns11.xincache.com,0,0.00%,70,70,0.00%
ns-3-b.gandi.net,0,0.00%,2,2,0.00%
ns1057.ui-dns.com,0,0.00%,2,2,0.00%
shades18.rzone.de,0,0.00%,6,6,0.00%
ns1.alidns.com,0,0.00%,26,26,0.00%
armando.ns.cloudflare.com,0,0.00%,10,10,0.00%
ns3.site4now.net,0,0.00%,10,10,0.00%
jiuyingnongye.com,0,0.00%,2,2,0.00%
ns2.alidns.com,0,0.00%,26,26,0.00%
syzs.qq.com,0,0.00%,6,6,0.00%
in.appcenter.ms,0,0.00%,50,50,0.00%
p209-contacts.icloud.com.cn,0,0.00%,2,2,0.00%
onedscolprdcus00.centralus.cloudapp.azure.com,0,0.00%,20,20,0.00%
ns1-39.azure-dns.com,0,0.00%,4,4,0.00%
fsrcn.lenovomm.com,0,0.00%,22,22,0.00%
push.thanos.ams.eulix.xyz,0,0.00%,64,64,0.00%
cs-geo-dds.trafficmanager.net,0,0.00%,6,6,0.00%
www.tm.lg.prod.aadmsa.trafficmanager.net,0,0.00%,6,6,0.00%
tm1.edgedns-tm.info,0,0.00%,42,42,0.00%
jp04.v2netapp.com,0,0.00%,56,56,0.00%
ns-os1.qq.com,0,0.00%,18,18,0.00%
wd-prod-cp.trafficmanager.net,0,0.00%,2,2,0.00%
wd-prod-cp-as-southeast-3-fe.southeastasia.cloudapp.azure.com,0,0.00%,2,2,0.00%
vtnt.cnode.xyz,0,0.00%,56,56,0.00%
www.microsoft.com-c-3.edgekey.net.globalredir.akadns.net,0,0.00%,6,6,0.00%
arc.trafficmanager.net,0,0.00%,24,24,0.00%
ris-prod.trafficmanager.net,0,0.00%,10,10,0.00%
asf-ris-prod-easia-azsc.eastasia.cloudapp.azure.com,0,0.00%,12,12,0.00%
pantheon-systems.map.fastly.net,0,0.00%,28,28,0.00%
auth.sangfor.com.cn,0,0.00%,559,559,0.00%
n1.ofidc.com,0,0.00%,22,22,0.00%
ins-qw3q8ofk.ias.tencent-cloud.net,0,0.00%,56,56,0.00%
vscode-sync-ase-01.azurewebsites.net,0,0.00%,32,32,0.00%
waws-prod-sg1-051.sip.azurewebsites.windows.net,0,0.00%,32,32,0.00%
waws-prod-sg1-051.cloudapp.net,0,0.00%,32,32,0.00%
46.courier-push-apple.com.akadns.net,0,0.00%,10,10,0.00%
apac-china-courier-4.push-apple.com.akadns.net,0,0.00%,72,72,0.00%
auth.sangfor.com,0,0.00%,8,8,0.00%
cn.archive.ubuntu.com,0,0.00%,279,279,0.00%
keyvalueservice.fe.apple-dns.cn,0,0.00%,58,58,0.00%
collab.dingtalk.com,0,0.00%,6,6,0.00%
crteam.cn,0,0.00%,10,10,0.00%
asimov.vortex.data.trafficmanager.net,0,0.00%,22,22,0.00%
tm1.dns-tm.com,0,0.00%,42,42,0.00%
ns3-09.azure-dns.org,0,0.00%,14,14,0.00%
disc601.prod.do.dsp.mp.microsoft.com,0,0.00%,34,34,0.00%
login.wpscdn.cn,0,0.00%,18,18,0.00%
logintcp.wps.cn,0,0.00%,16,16,0.00%
slack.com,0,0.00%,8,8,0.00%
iguvmbs.roygxe.xyz,0,0.00%,64,64,0.00%
sentry.eulix.xyz,0,0.00%,22,22,0.00%
loki.ams.eulix.xyz,0,0.00%,54,54,0.00%
hashcloud.cz,0,0.00%,22,22,0.00%
ts.eset.com,0,0.00%,32,32,0.00%
ts.gtm.eset.com,0,0.00%,40,40,0.00%
uploader.shimo.im,0,0.00%,14,14,0.00%
dns1.wscloudcdn.org,0,0.00%,2,2,0.00%
vscode-update.trafficmanager.net,0,0.00%,4,4,0.00%
vscode-update-sea.azurewebsites.net,0,0.00%,4,4,0.00%
waws-prod-sg1-057.sip.azurewebsites.windows.net,0,0.00%,4,4,0.00%
waws-prod-sg1-057-feea.southeastasia.cloudapp.azure.com,0,0.00%,4,4,0.00%
d9caa6e02c990b0a.jijifun.com,0,0.00%,56,56,0.00%
edge-microsoft-com.dual-a-0036.a-msedge.net,0,0.00%,36,36,0.00%
vvb.228.mclqp.link,0,0.00%,10,10,0.00%
functional.events.data.microsoft.com,0,0.00%,119,119,0.00%
notify.adobe.io,0,0.00%,33,33,0.00%
alert-cn.battlenet.com.cn,0,0.00%,34,34,0.00%
time-ios.g.aaplimg.com,0,0.00%,45,45,0.00%
app.slack.com,0,0.00%,4,4,0.00%
guard.sec.xiaojukeji.com,0,0.00%,14,14,0.00%
hnb-router-pb-v6.diditaxi.com.cn,0,0.00%,14,14,0.00%
inner-all.toutiao-internal-all-v3.lf.bytelb.net,0,0.00%,16,16,0.00%
e627b5de-rh6hs0-0-1k3xp.us.pyboard.vip,0,0.00%,4,4,0.00%
spec.pdfxd.com,0,0.00%,6,6,0.00%
apis.pdfxd.com,0,0.00%,6,6,0.00%
v11.kwaicdn.com,0,0.00%,5,5,0.00%
ns3-39.azure-dns.org,0,0.00%,6,6,0.00%
new-fp-shed.wg1.b.yahoo.com,0,0.00%,40,40,0.00%
sohu.com,0,0.00%,20,20,0.00%
aloha.maxhub.vip.wsglb0.com,0,0.00%,82,82,0.00%
ftp.cn.debian.cdnet.in,0,0.00%,8,8,0.00%
www.tm.prd.ags.trafficmanager.net,0,0.00%,4,4,0.00%
gbapi.eastmoney.com,0,0.00%,36,36,0.00%
6fe97759aa27a0c9.jijifun.com,0,0.00%,46,46,0.00%
3463d06de0ca9a15.jijifun.com,0,0.00%,10,10,0.00%
115.lingdiany.com,0,0.00%,24,24,0.00%
api.ys7.com,0,0.00%,2,2,0.00%
ak.privatelink.msidentity.com,0,0.00%,16,16,0.00%
tycloud.hpccube.com,0,0.00%,4,4,0.00%
swdlcdn.eastmoney.com.w.cdngslb.com,0,0.00%,6,6,0.00%
a-0001.a-msedge.net,0,0.00%,8,8,0.00%
v1conf.darwin.kuiniuca.com,0,0.00%,14,14,0.00%
seeds-darwin.xycdn.com,0,0.00%,8,8,0.00%
seeds.darwin.kuiniuca.com,0,0.00%,12,12,0.00%
mumu.nie.netease.com,0,0.00%,82,82,0.00%
crl.sectigo.com,0,0.00%,5,5,0.00%
crl.comodoca.com.cdn.cloudflare.net,0,0.00%,6,6,0.00%
www.surge-activation.com,0,0.00%,6,6,0.00%
nsdkxyajs.data.kuiniuca.com,0,0.00%,14,14,0.00%
ns1.n.shifen.com,0,0.00%,32,32,0.00%
ns3.n.shifen.com,0,0.00%,38,38,0.00%
ns4.n.shifen.com,0,0.00%,34,34,0.00%
onedscolprdwus08.westus.cloudapp.azure.com,0,0.00%,6,6,0.00%
24-courier.push.apple.com,0,0.00%,19,19,0.00%
24.courier-push-apple.com.akadns.net,0,0.00%,2,2,0.00%
api.my-ip.io,0,0.00%,6,6,0.00%
onedscolprdjpe04.japaneast.cloudapp.azure.com,0,0.00%,2,2,0.00%
ocsp05.actalis.it,0,0.00%,12,12,0.00%
ns3.lacnic.net,0,0.00%,2,2,0.00%
static-asm-skype.trafficmanager.net,0,0.00%,16,16,0.00%
sa1-authgw.cloudapp.net,0,0.00%,16,16,0.00%
1180c.wpc.azureedge.net,0,0.00%,16,16,0.00%
1180c.ec.azureedge.net,0,0.00%,16,16,0.00%
ns4.edgecastdns.net,0,0.00%,4,4,0.00%
ns3.edgecastdns.net,0,0.00%,2,2,0.00%
lb.apr-1180c.edgecastdns.net,0,0.00%,16,16,0.00%
speedtest.snape3058.info,0,0.00%,40,40,0.00%
p218-contacts.icloud.com.cn,0,0.00%,4,4,0.00%
e57895b9-rh6hs0-rink2v-1d9xe.pccw.alrihla.net,0,0.00%,14,14,0.00%
swdlcdn.eastmoney.com,0,0.00%,9,9,0.00%
mpv6.weixin.qq.com,0,0.00%,12,12,0.00%
ns2-04.azure-dns.net,0,0.00%,4,4,0.00%
reswx.tc.qq.com,0,0.00%,14,14,0.00%
devicereg.ruijienetworks.com,0,0.00%,4,4,0.00%
dauth-lp1.ndas.srv.nintendo.net,0,0.00%,4,4,0.00%
aoufnebg.dayugslb.com,0,0.00%,20,20,0.00%
dldir1.qq.com.mid.dcloudstc.com,0,0.00%,18,18,0.00%
self-events-data.trafficmanager.net,0,0.00%,60,60,0.00%
onedscolprdwus10.westus.cloudapp.azure.com,0,0.00%,6,6,0.00%
iris-de-ppe-azsc-eas.eastasia.cloudapp.azure.com,0,0.00%,4,4,0.00%
locprod2-elb-us-west-2.prod.mozaws.net,0,0.00%,127,127,0.00%
fedoraproject.org,0,0.00%,59,59,0.00%
i3.cwip.eset.com,0,0.00%,8,8,0.00%
image.baidu.com,0,0.00%,40,40,0.00%
wenku.baidu.com,0,0.00%,64,64,0.00%
wk.baidu.com,0,0.00%,42,42,0.00%
www.so.com,0,0.00%,80,80,0.00%
news.so.com,0,0.00%,48,48,0.00%
video.so.com,0,0.00%,46,46,0.00%
mail.aliyun.com,0,0.00%,46,46,0.00%
mail.yeah.net,0,0.00%,42,42,0.00%
t12hz.mail.yeah.net,0,0.00%,40,40,0.00%
t7hz.mail.yeah.net,0,0.00%,42,42,0.00%
mail.qq.com,0,0.00%,58,58,0.00%
szup.btfs.mail.ftn.qq.com,0,0.00%,48,48,0.00%
baike.sogou.com,0,0.00%,36,36,0.00%
wenwen.sogou.com,0,0.00%,40,40,0.00%
user.weiyun.com,0,0.00%,57,57,0.00%
upload.weiyun.com,0,0.00%,48,48,0.00%
zhuanlan.zhihu.com,0,0.00%,103,103,0.00%
upload.zhihu.com,0,0.00%,48,48,0.00%
www.qzone.qq.com,0,0.00%,34,34,0.00%
user.qzone.qq.com,0,0.00%,34,34,0.00%
photo.qzone.qq.com,0,0.00%,36,36,0.00%
www.douban.com,0,0.00%,55,55,0.00%
club.kdslife.com,0,0.00%,32,32,0.00%
picupload.weibo.com,0,0.00%,83,83,0.00%
api.cdp.microsoft.com,0,0.00%,10,10,0.00%
glb.api.prod.dcat.dsp.trafficmanager.net,0,0.00%,10,10,0.00%
config.edge.skype.com.trafficmanager.net,0,0.00%,38,38,0.00%
l-0007.l-msedge.net,0,0.00%,26,26,0.00%
atm-settingsfe-prod-geo2.trafficmanager.net,0,0.00%,100,100,0.00%
settings-prod-scus-1.southcentralus.cloudapp.azure.com,0,0.00%,18,18,0.00%
docs.wps.cn,0,0.00%,3,3,0.00%
doc.wps.cn,0,0.00%,3,3,0.00%
docerad.wps.cn,0,0.00%,3,3,0.00%
pan.wps.cn,0,0.00%,3,3,0.00%
array811.prod.do.dsp.mp.microsoft.com,0,0.00%,24,24,0.00%
app.wpscdn.cn,0,0.00%,13,13,0.00%
pook.com,0,0.00%,19,19,0.00%
auth.collab.reuters.net,0,0.00%,23,23,0.00%
im.collab.reuters.net,0,0.00%,21,21,0.00%
server2.yoics.net,0,0.00%,21,21,0.00%
garenaconnect.com,0,0.00%,21,21,0.00%
opera-mini.net,0,0.00%,17,17,0.00%
www.letou8.com,0,0.00%,19,19,0.00%
server3.yoics.net,0,0.00%,21,21,0.00%
sdxl.wanmeilink.com,0,0.00%,19,19,0.00%
yl.qq.com,0,0.00%,33,33,0.00%
uulogin02.com,0,0.00%,13,13,0.00%
uulogin01.com,0,0.00%,15,15,0.00%
v1.baidupcs.com,0,0.00%,21,21,0.00%
qiao.e.shifen.com,0,0.00%,10,10,0.00%
ns1.e.shifen.com,0,0.00%,12,12,0.00%
ns2.e.shifen.com,0,0.00%,10,10,0.00%
ns4.e.shifen.com,0,0.00%,12,12,0.00%
ns3.e.shifen.com,0,0.00%,12,12,0.00%
sslpcsnb2.jomodns.com,0,0.00%,10,10,0.00%
sogovpn.com,0,0.00%,21,21,0.00%
ns5.e.shifen.com,0,0.00%,8,8,0.00%
hxce.cn,0,0.00%,19,19,0.00%
sip.reuters.net,0,0.00%,25,25,0.00%
gamec.boombeachgame.com,0,0.00%,37,37,0.00%
ios.game.coc.qq.com,0,0.00%,21,21,0.00%
gamec.clashroyaleapp.com,0,0.00%,35,35,0.00%
meeting.huaweicloud.com,0,0.00%,19,19,0.00%
i.work.weixin.qq.com,0,0.00%,25,25,0.00%
teams.office.com,0,0.00%,18,18,0.00%
auth-collab.platform.refinitiv.com,0,0.00%,10,10,0.00%
im-collab.platform.refinitiv.com,0,0.00%,10,10,0.00%
yl.qq.com.cloud.tc.qq.com,0,0.00%,16,16,0.00%
ns-cdn2.qq.com,0,0.00%,8,8,0.00%
link-ro5m7bg7.gaapqcloud.com.cn,0,0.00%,8,8,0.00%
vzuu.com,0,0.00%,27,27,0.00%
game.bb.qq.com,0,0.00%,18,18,0.00%
bj.pcsdownload.n.shifen.com,0,0.00%,12,12,0.00%
game.cr.qq.com,0,0.00%,18,18,0.00%
im.welink.huaweicloud.com,0,0.00%,23,23,0.00%
ns2.n.shifen.com,0,0.00%,24,24,0.00%
game.brawlstars.cn,0,0.00%,27,27,0.00%
www.facebook.com,0,0.00%,23,23,0.00%
teams-mira-afd.trafficmanager.net,0,0.00%,20,20,0.00%
photo.tianya.cn,0,0.00%,20,20,0.00%
blog.tianya.cn,0,0.00%,17,17,0.00%
wireless.tianya.cn,0,0.00%,23,23,0.00%
yl.qq.com.x2v6.sched.dcloudstc.com,0,0.00%,18,18,0.00%
my.tianya.cn,0,0.00%,23,23,0.00%
3g.tianya.cn,0,0.00%,18,18,0.00%
teams-office-com.s-0005.s-msedge.net,0,0.00%,8,8,0.00%
m.tianya.cn,0,0.00%,21,21,0.00%
bbs.tianya.cn,0,0.00%,20,20,0.00%
link-q89r7hhv.gaapqcloud.com,0,0.00%,18,18,0.00%
link-6tm8io8v.gaapqcloud.com.cn,0,0.00%,18,18,0.00%
gslb-dsa.zhihu.com,0,0.00%,16,16,0.00%
cache.tianya.cn,0,0.00%,4,4,0.00%
s-0005.s-msedge.net,0,0.00%,18,18,0.00%
premium.eastmoney.com,0,0.00%,2,2,0.00%
dns.baidu.com,0,0.00%,29,29,0.00%
uwewe.com,0,0.00%,20,20,0.00%
webex.com,0,0.00%,28,28,0.00%
zhumu.me,0,0.00%,32,32,0.00%
picupload.service.weibo.com,0,0.00%,36,36,0.00%
ali.picupload.weibo.com,0,0.00%,14,14,0.00%
bjali.picupload.weibo.com,0,0.00%,16,16,0.00%
gz.picupload.weibo.com,0,0.00%,14,14,0.00%
shx.picupload.weibo.com,0,0.00%,16,16,0.00%
video.weibocdn.com,0,0.00%,39,39,0.00%
videoweibocdn.gslb.sinaedge.com,0,0.00%,14,14,0.00%
us.grid.sinaedge.com,0,0.00%,14,14,0.00%
odc-commonafdrk-geo.onedrive.akadns.net,0,0.00%,18,18,0.00%
odc-commonafdrk-brs.onedrive.akadns.net,0,0.00%,18,18,0.00%
common.be.1drv.com.l-0003.dc-msedge.net.l-0003.l-msedge.net,0,0.00%,12,12,0.00%
p45-mailws.icloud.com,0,0.00%,38,38,0.00%
d.ns.apple.com,0,0.00%,4,4,0.00%
p45-mailws.icloud.com.akadns.net,0,0.00%,14,14,0.00%
pv-mailws.icloud.com.akadns.net,0,0.00%,14,14,0.00%
p45-contentws.icloud.com,0,0.00%,33,33,0.00%
contentws.v.aaplimg.com,0,0.00%,14,14,0.00%
a1b8892e-4b87-43c6-a00b-79fd18fb15e6.apple.com.v.aaplimg.com,0,0.00%,4,4,0.00%
a.privatelink.msidentity.com,0,0.00%,12,12,0.00%
dataflow.biliapi.com.dy.galileo.jcloud-cdn.com,0,0.00%,19,19,0.00%
i5.cwip.eset.com,0,0.00%,90,90,0.00%
code.eulix.xyz,0,0.00%,10,10,0.00%
onedscolprdwus03.westus.cloudapp.azure.com,0,0.00%,8,8,0.00%
bl6pcor003-meta.fe.1drv.com,0,0.00%,4,4,0.00%
odc-bl6pap003-meta-geo.onedrive.akadns.net,0,0.00%,4,4,0.00%
odc-bl6pap003-meta-brs.onedrive.akadns.net,0,0.00%,4,4,0.00%
bl6pcor003-meta.be.1drv.com.l-0003.dc-msedge.net.l-0003.l-msedge.net,0,0.00%,4,4,0.00%
onedriveclucproddm20037.blob.core.windows.net,0,0.00%,2,2,0.00%
blob.dsm07prdstr09a.store.core.windows.net,0,0.00%,2,2,0.00%
jsdelivr.map.fastly.net,0,0.00%,4,4,0.00%
onedscolprdfrc03.francecentral.cloudapp.azure.com,0,0.00%,6,6,0.00%
ldc.lenovo.com.cn.trpcdn.net,0,0.00%,14,14,0.00%
init-cdn.itunes-apple.com.akadns.net,0,0.00%,7,7,0.00%
client-office365-tas.msedge.net,0,0.00%,18,18,0.00%
afdo-tas-offload.trafficmanager.net,0,0.00%,12,12,0.00%
e-0009.e-msedge.net,0,0.00%,18,18,0.00%
na61-na62.wagbridge.alibaba.alibaba.com.gds.alibabadns.com,0,0.00%,38,38,0.00%
0.t.dancevalidator.io,0,0.00%,40,40,0.00%
onedscolprdjpw00.japanwest.cloudapp.azure.com,0,0.00%,5,5,0.00%
settings-prod-eus2-2.eastus2.cloudapp.azure.com,0,0.00%,12,12,0.00%
update.huorong.cn,0,0.00%,42,42,0.00%
show.re.taobao.com,0,0.00%,44,44,0.00%
media.ptmi.gitv.tv,0,0.00%,10,10,0.00%
wx1.qq.com,0,0.00%,22,22,0.00%
122.t.keepitpumpin.io,0,0.00%,2,2,0.00%
wns.notify.trafficmanager.net,0,0.00%,20,20,0.00%
color.docer.wps.cn,0,0.00%,49,49,0.00%
avcloud.e5.sk,0,0.00%,8,8,0.00%
www.cnic.cn,0,0.00%,14,14,0.00%
onedscolprdeus02.eastus.cloudapp.azure.com,0,0.00%,6,6,0.00%
time-ios.apple.com,0,0.00%,11,11,0.00%
api.axbc.xyz,0,0.00%,2,2,0.00%
rc.kite.com,0,0.00%,15,15,0.00%
feilian-staging.bytedance.com.w.cdngslb.com,0,0.00%,6,6,0.00%
havfw69955.lithium.com,0,0.00%,14,14,0.00%
d28139t0r7hg1k.cloudfront.net,0,0.00%,14,14,0.00%
prod.configsvc1.live.com.akadns.net,0,0.00%,4,4,0.00%
asia.configsvc1.live.com.akadns.net,0,0.00%,4,4,0.00%
oneocsp-microsoft-com.a-0003.a-msedge.net,0,0.00%,2,2,0.00%
a-0003.a-msedge.net,0,0.00%,4,4,0.00%
onedscolprdeus10.eastus.cloudapp.azure.com,0,0.00%,6,6,0.00%
rttf.citrix.com,0,0.00%,2,2,0.00%
astat-bugly-tgw4l.mig.tencent-cloud.net,0,0.00%,26,26,0.00%
tw13.clashcloud.tech,0,0.00%,4,4,0.00%
repo.zabbix.com,0,0.00%,4,4,0.00%
esm.ubuntu.com,0,0.00%,2,2,0.00%
us.archive.ubuntu.com,0,0.00%,2,2,0.00%
pmpcdn1.wmupd.com,0,0.00%,6,6,0.00%
pmpcdn1.wmupd.com.cdn.dnsv1.com,0,0.00%,6,6,0.00%
k53k6ler.sched.sma.tdnsstic1.cn,0,0.00%,6,6,0.00%
ns-open3.qq.com,0,0.00%,22,22,0.00%
bbs.pku.edu.cn,0,0.00%,14,14,0.00%
22.courier-push-apple.com.akadns.net,0,0.00%,6,6,0.00%
dr.f.360.cn,0,0.00%,20,20,0.00%
s.f.qh-lb.com,0,0.00%,42,42,0.00%
unionsug.baidu.com,0,0.00%,23,23,0.00%
msg.video.dns.iqiyi.com,0,0.00%,11,11,0.00%
4005f8da13f42943.jijifun.com,0,0.00%,12,12,0.00%
ns1-201.azure-dns.com,0,0.00%,14,14,0.00%
ns4-201.azure-dns.info,0,0.00%,4,4,0.00%
2csvr-basic.wpsdns.com,0,0.00%,2,2,0.00%
www.oschina.net,0,0.00%,22,22,0.00%
expressapisv2.net,0,0.00%,18,18,0.00%
cdn.fwupd.org,0,0.00%,36,36,0.00%
c5bd3904-rh6hs0-rv95kx-1ishw.pccw.alrihla.net,0,0.00%,9,9,0.00%
skydrivesync.policies.live.net,0,0.00%,17,17,0.00%
docs.live.net,0,0.00%,15,15,0.00%
extensions.gnome.org,0,0.00%,4,4,0.00%
edgeassetservice.azureedge.net,0,0.00%,9,9,0.00%
onedriveclucprodbn20002.blob.core.windows.net,0,0.00%,8,8,0.00%
bi-track.hypergryph.com,0,0.00%,10,10,0.00%
time.ys7.com,0,0.00%,7,7,0.00%
evoke-windowsservices-tas.msedge.net,0,0.00%,26,26,0.00%
ocws.officeapps.live.com,0,0.00%,23,23,0.00%
wildcard.weather.microsoft.com.edgekey.net,0,0.00%,12,12,0.00%
settings-prod-eus2-1.eastus2.cloudapp.azure.com,0,0.00%,10,10,0.00%
nj.t.bcsp2p.baidu.com,0,0.00%,72,72,0.00%
apponline.research.qq.com,0,0.00%,36,36,0.00%
odrs.gnome.org,0,0.00%,7,7,0.00%
XSP-efz.ms-acdc.office.com,0,0.00%,12,12,0.00%
hub.upyun.com,0,0.00%,94,94,0.00%
smtp.qq.com,0,0.00%,87,87,0.00%
www.dadiyouhui01.cn,0,0.00%,46,46,0.00%
teredo-debian.remlab.net,0,0.00%,29,29,0.00%
log.tailscale.io,0,0.00%,64,64,0.00%
newvip.duba.net,0,0.00%,28,28,0.00%
access.video.qq.com,0,0.00%,39,39,0.00%
ieonlinews.microsoft.com,0,0.00%,44,44,0.00%
f8ed5d21a44b0e58.jijifun.com,0,0.00%,6,6,0.00%
dl-ovh01.amna.shop,0,0.00%,22,22,0.00%
vip.foxitreader.cn,0,0.00%,25,25,0.00%
alpha-cloud-log.cn-hangzhou.log.aliyuncs.com,0,0.00%,58,58,0.00%
configuration-server-lb-1105093370.us-east-1.elb.amazonaws.com,0,0.00%,4,4,0.00%
rum.h5.weibo.cn,0,0.00%,13,13,0.00%
controlplane.tailscale.com,0,0.00%,8,8,0.00%
time1.cloud.tencent.com,0,0.00%,17,17,0.00%
edu.ntp.org.cn,0,0.00%,12,12,0.00%
ntp1.aliyun.com,0,0.00%,33,33,0.00%
cn.ntp.org.cn,0,0.00%,21,21,0.00%
usercount.dockernb.com,0,0.00%,43,43,0.00%
yungw.taobao.com,0,0.00%,33,33,0.00%
ovo.cn2.llsmall.com,0,0.00%,24,24,0.00%
gateway.lianjia.com,0,0.00%,15,15,0.00%
dig.lianjia.com,0,0.00%,20,20,0.00%
mail.iie.ac.cn,0,0.00%,55,55,0.00%
proxy.client.163.com,0,0.00%,38,38,0.00%
eeth9boh.nodedata.net,0,0.00%,33,33,0.00%
arpha.taobao.com,0,0.00%,3,3,0.00%
dns.alidns.com,0,0.00%,45,45,0.00%
comet.jianguoyun.com,0,0.00%,63,63,0.00%
softcenter-all.os.nfschina.com,0,0.00%,21,21,0.00%
www.msn.cn,0,0.00%,99,99,0.00%
www.clarity.ms,0,0.00%,19,19,0.00%
httpdns.n.netease.com,0,0.00%,12,12,0.00%
mail.pnpitalia.it,0,0.00%,61,61,0.00%
migration-geo-filter-prd.stargate.cse.ss-inf.net,0,0.00%,5,5,0.00%
connpm.gj.qq.com,0,0.00%,10,10,0.00%
connps.gj.qq.com,0,0.00%,10,10,0.00%
dgapi.zhhainiao.com,0,0.00%,12,12,0.00%
w.isoleader.com.tw,0,0.00%,61,61,0.00%
compsvc.delivery.autodesk.com,0,0.00%,1,1,0.00%
array812.prod.do.dsp.mp.microsoft.com,0,0.00%,6,6,0.00%
ssl.ptlogin2.graph.qq.com,0,0.00%,37,37,0.00%
cn.patch.battlenet.com.cn,0,0.00%,5,5,0.00%
api.dida365.com,0,0.00%,50,50,0.00%
app.terra-master.com,0,0.00%,1,1,0.00%
account-public-service-prod03.ol.epicgames.com,0,0.00%,26,26,0.00%
analytics.yinxiang.com,0,0.00%,84,84,0.00%
feelchat2.virbox.com,0,0.00%,9,9,0.00%
ex.qq.com,0,0.00%,16,16,0.00%
haiwenzhang.github.io,0,0.00%,61,61,0.00%
ce571486-i.andns.co,0,0.00%,24,24,0.00%
www.wodaywo100001.com,0,0.00%,104,104,0.00%
kmd.antpool.com,0,0.00%,100,100,0.00%
sg.minexmr.com,0,0.00%,104,104,0.00%
verushash.mine.zergpool.com,0,0.00%,104,104,0.00%
sbtc.uupool.cn,0,0.00%,102,102,0.00%
pool.minexmr.com,0,0.00%,104,104,0.00%
donate.ssl.xmrig.com,0,0.00%,104,104,0.00%
awsmx.f2pool.com,0,0.00%,106,106,0.00%
store-us-uat.motorola.com,0,0.00%,29,29,0.00%
data-vef.xboxlive.com,0,0.00%,6,6,0.00%
wolf.sh,0,0.00%,8,8,0.00%
fliplc.getxlx.com,0,0.00%,94,94,0.00%
tracker.opentrackr.org,0,0.00%,14,14,0.00%
ns41.hashvault.pro,0,0.00%,102,102,0.00%
api.mymonero.com,0,0.00%,100,100,0.00%
fr.minexmr.com,0,0.00%,104,104,0.00%
toa.mygametoa.com,0,0.00%,102,102,0.00%
donate.v2.xmrig.com,0,0.00%,102,102,0.00%
nhmws.nicehash.com,0,0.00%,102,102,0.00%
zec.uupool.cn,0,0.00%,104,104,0.00%
sea.wafflepool.com,0,0.00%,104,104,0.00%
de.minexmr.com,0,0.00%,102,102,0.00%
btc.f2pool.com,0,0.00%,98,98,0.00%
dcr.f2pool.com,0,0.00%,100,100,0.00%
penef6f8f734.slushpool.com,0,0.00%,96,96,0.00%
www.fullskystar.top,0,0.00%,102,102,0.00%
asia2.ethermine.org,0,0.00%,104,104,0.00%
stratum.okpool.me,0,0.00%,102,102,0.00%
k8s.entrypoint.ops.sparkpool.com,0,0.00%,104,104,0.00%
xmr.flooder.org,0,0.00%,104,104,0.00%
pool-fr.supportxmr.com,0,0.00%,104,104,0.00%
eth.f2pool.com,0,0.00%,104,104,0.00%
asia1.ethpool.org,0,0.00%,100,100,0.00%
btw.uupool.cn,0,0.00%,102,102,0.00%
b4c.f2pool.com,0,0.00%,108,108,0.00%
ss.antpool.com,0,0.00%,102,102,0.00%
cn.sparkpool.com,0,0.00%,98,98,0.00%
docs.nicehash.com,0,0.00%,102,102,0.00%
pool.hashvault.pro,0,0.00%,102,102,0.00%
turtlecoin.herominers.com,0,0.00%,100,100,0.00%
us1.ethpool.org,0,0.00%,102,102,0.00%
du.testjj.com,0,0.00%,104,104,0.00%
ns11.hashvault.pro,0,0.00%,100,100,0.00%
mailer.nicehash.com,0,0.00%,102,102,0.00%
btm.f2pool.com,0,0.00%,104,104,0.00%
rx.thegov.win,0,0.00%,988,988,0.00%
pool.supportxmr.com,0,0.00%,106,106,0.00%
etc.f2pool.com,0,0.00%,100,100,0.00%
pool.flooder.org,0,0.00%,102,102,0.00%
eth.ss.poolin.com,0,0.00%,102,102,0.00%
eth.antpool.com,0,0.00%,100,100,0.00%
miner.nicehash.com,0,0.00%,106,106,0.00%
raven.f2pool.com,0,0.00%,104,104,0.00%
monerohash.com,0,0.00%,100,100,0.00%
pool.minergate.com,0,0.00%,104,104,0.00%
blog.nicehash.com,0,0.00%,100,100,0.00%
www.jvmonline.com,0,0.00%,98,98,0.00%
smtp.nicehash.com,0,0.00%,102,102,0.00%
eth.uupool.cn,0,0.00%,102,102,0.00%
edge-microsoft-com.dual-a-0036.a-msedge.NET,0,0.00%,10,10,0.00%
rq.kpcct.cloud.duba.net,0,0.00%,8,8,0.00%
ca.minexmr.com,0,0.00%,104,104,0.00%
test.nicehash.com,0,0.00%,98,98,0.00%
ar.hpool.com,0,0.00%,98,98,0.00%
ckb.antpool.com,0,0.00%,102,102,0.00%
jp.sparkpool.com,0,0.00%,100,100,0.00%
api.nicehash.com,0,0.00%,100,100,0.00%
mail.nicehash.com,0,0.00%,100,100,0.00%
dcr.uupool.cn,0,0.00%,98,98,0.00%
telemetry.sonarsource.com,0,0.00%,4,4,0.00%
gitlab.com,0,0.00%,29,29,0.00%
node-470.kr.stars.run,0,0.00%,4,4,0.00%
services.gfe.nvidia.com,0,0.00%,11,11,0.00%
client.teamviewer.com,0,0.00%,31,31,0.00%
wss.im.qcloud.com,0,0.00%,4,4,0.00%
data.pendo.io,0,0.00%,5,5,0.00%
rt-p.kugou.com,0,0.00%,4,4,0.00%
directconfig.ab.qq.com,0,0.00%,15,15,0.00%
xmr.remuser.win,0,0.00%,1314,1314,0.00%
anv.duba.net,0,0.00%,5,5,0.00%
kr02.krmanxj.club,0,0.00%,22,22,0.00%
www.youtube.com,0,0.00%,56,56,0.00%
sources.openembedded.org,0,0.00%,5821,5821,0.00%
data.gharchive.org,0,0.00%,19,19,0.00%
ws-std01.sunlogin.oray.com,0,0.00%,56,56,0.00%
mirror.iscas.ac.cn,0,0.00%,58,58,0.00%
metok.sys.miui.com,0,0.00%,15,15,0.00%
mirrors.163.com,0,0.00%,8,8,0.00%
update.cs2c.com.cn,0,0.00%,2,2,0.00%
bbs-api.mihoyo.com,0,0.00%,7,7,0.00%
imap-mail.outlook.com,0,0.00%,23,23,0.00%
wspri.coinall.ltd,0,0.00%,28,28,0.00%
zhushou.huihui.cn,0,0.00%,11,11,0.00%
yd-02.paofunlink.com,0,0.00%,4,4,0.00%
socc2022.hotcrp.com,0,0.00%,8,8,0.00%
alive.github.com,0,0.00%,88,88,0.00%
tunnel.cfw.trustedsource.org,0,0.00%,190,190,0.00%
pushtrs.push.hicloud.com,0,0.00%,162,162,0.00%
p204-fmipmobile.icloud.com.cn,0,0.00%,6,6,0.00%
gsa.idms-apple.com.akadns.net,0,0.00%,6,6,0.00%
api.smoot.apple.cn,0,0.00%,9,9,0.00%
bag-smoot.v.aaplimg.com,0,0.00%,6,6,0.00%
kt-prod.v.aaplimg.com,0,0.00%,6,6,0.00%
47-courier.push.apple.com,0,0.00%,21,21,0.00%
jx.cdn.qhstatic.com,0,0.00%,4,4,0.00%
yybadaccess.3g.qq.com,0,0.00%,92,92,0.00%
configserver.hicloud.com,0,0.00%,42,42,0.00%
helpdesktop1.ksmobile.com,0,0.00%,30,30,0.00%
wpvip.duba.net,0,0.00%,14,14,0.00%
array610.prod.do.dsp.mp.microsoft.com,0,0.00%,33,33,0.00%
gsp10-ssl.ls-apple.com.akadns.net,0,0.00%,6,6,0.00%
gsp10-ssl.apple.com,0,0.00%,16,16,0.00%
list.wallpaper.cloud.duba.net,0,0.00%,48,48,0.00%
dmd.metaservices.microsoft.com,0,0.00%,12,12,0.00%
uf-api6-client.ksord.com,0,0.00%,20,20,0.00%
p.qlogo.cn,0,0.00%,13,13,0.00%
dba22f7d541340fe885b2a8a618c0602.fp.measure.office.com,0,0.00%,4,4,0.00%
upload.fp.measure.office.com,0,0.00%,44,44,0.00%
usa1v2.jsssline.top,0,0.00%,147,147,0.00%
pypi.org,0,0.00%,11360,11360,0.00%
sh.madagent.tm,0,0.00%,17,17,0.00%
7902f652-rh7400-rix76f-nu3o.pccw.alrihla.net,0,0.00%,11,11,0.00%
1671aab.nc.gladns.com,0,0.00%,4,4,0.00%
browser-api.2345.cc,0,0.00%,30,30,0.00%
analysis.sangfor.com.cn,0,0.00%,89,89,0.00%
allall01.baidupcs.com,0,0.00%,31,31,0.00%
beacon-api.aliyuncs.com,0,0.00%,6,6,0.00%
33aef1e.ne.gladns.com,0,0.00%,8,8,0.00%
adash-emas.cn-hangzhou.aliyuncs.com,0,0.00%,4,4,0.00%
centertime.ksyun.com,0,0.00%,2,2,0.00%
websv.aliyundrive.com,0,0.00%,86,86,0.00%
sg02.ipv2.xyz,0,0.00%,41,41,0.00%
api.kingdata.ksyun.com,0,0.00%,2,2,0.00%
y.yynote.cn,0,0.00%,4,4,0.00%
data.unistream.io,0,0.00%,7,7,0.00%
shop.darickpay.com,0,0.00%,1,1,0.00%
bitbucket.bidinte.top,0,0.00%,42,42,0.00%
content.rconfig.qq.com,0,0.00%,2,2,0.00%
au.qq.com,0,0.00%,2,2,0.00%
dp3.qq.com,0,0.00%,10,10,0.00%
tangram.e.qq.com,0,0.00%,2,2,0.00%
connect-drcn.dbankcloud.cn,0,0.00%,8,8,0.00%
sp.sangfor.com.cn,0,0.00%,96,96,0.00%
goldengate.grammarly.com,0,0.00%,55,55,0.00%
r.release.qq.com,0,0.00%,2,2,0.00%
fmf.fe.apple-dns.cn,0,0.00%,10,10,0.00%
stdtime.gov.hk,0,0.00%,16,16,0.00%
mx.cstnet.cn,0,0.00%,12,12,0.00%
chpm.sangfor.com.cn,0,0.00%,76,76,0.00%
gfe.nvidia.com,0,0.00%,25,25,0.00%
mail.dingtalk.com,0,0.00%,14,14,0.00%
ispip.clang.cn,0,0.00%,2,2,0.00%
nsl.lenovo.com.cn,0,0.00%,22,22,0.00%
cbs-u.sports.cctv.com,0,0.00%,19,19,0.00%
dispatch.ts.api.xiangtatech.com,0,0.00%,10,10,0.00%
cbs-i.sports.cctv.com,0,0.00%,19,19,0.00%
mirrors.huaweicloud.com,0,0.00%,4,4,0.00%
p71-buy.itunes-apple.com.akadns.net,0,0.00%,4,4,0.00%
jira.bidinte.top,0,0.00%,22,22,0.00%
cx.soft.360.cn,0,0.00%,43,43,0.00%
hicall-enhance-drcn.emui.dbankcloud.com,0,0.00%,12,12,0.00%
kms.03k.org,0,0.00%,2,2,0.00%
node2.ayden.icu,0,0.00%,28,28,0.00%
confluence.bidinte.top,0,0.00%,25,25,0.00%
sub.paasmi.com,0,0.00%,2,2,0.00%
i62hmnztfpzwrhjg34m6ruxem5oe36nulzmxcgbdbkiaceubprkta7ad.tor2web.it,0,0.00%,2,2,0.00%
pus3-collabhubrtc.officeapps.live.com,0,0.00%,2,2,0.00%
fcmconnection.googleapis.com,0,0.00%,2,2,0.00%
cmtw.pinduoduo.com,0,0.00%,4,4,0.00%
pmmtk.pinduoduo.com,0,0.00%,6,6,0.00%
www.sinfors.com.cn,0,0.00%,50,50,0.00%
datacollector-drcn.dt.hicloud.com,0,0.00%,12,12,0.00%
appdlc-drcn.hispace.dbankcloud.cn,0,0.00%,24,24,0.00%
jxs-drcn.jos.dbankcloud.cn,0,0.00%,2,2,0.00%
uc-drcn.hispace.dbankcloud.cn,0,0.00%,4,4,0.00%
gs-drcn.game.dbankcloud.com,0,0.00%,8,8,0.00%
msch.f.360.cn,0,0.00%,7,7,0.00%
restlbs.map.qq.com,0,0.00%,6,6,0.00%
www.sinfors.com,0,0.00%,20,20,0.00%
12-courier.push.apple.com,0,0.00%,17,17,0.00%
stun-h5.qvb.qcloud.com,0,0.00%,14,14,0.00%
intelligence.sangfor.com.cn,0,0.00%,7,7,0.00%
clt.sangfor.com.cn,0,0.00%,7,7,0.00%
blog.163.com,0,0.00%,2,2,0.00%
tiantang.mogencloud.com,0,0.00%,2,2,0.00%
notify.sangfor.com.cn,0,0.00%,7,7,0.00%
sdkconfig.ad.xiaomi.com,0,0.00%,15,15,0.00%
tw302.sagittarius-link.com,0,0.00%,9,9,0.00%
im.dingtalk.com,0,0.00%,7,7,0.00%
rs-cn.rustdesk.com,0,0.00%,5,5,0.00%
secclientgw.alipay.com,0,0.00%,11,11,0.00%
yccc.123nat.com,0,0.00%,3,3,0.00%
m.iqiyi.com,0,0.00%,2,2,0.00%
iphone-ld.origin-apple.com.akadns.net,0,0.00%,6,6,0.00%
omgmta.qq.com,0,0.00%,2,2,0.00%
u.l.qq.com,0,0.00%,2,2,0.00%
tui.gtimg.com,0,0.00%,2,2,0.00%
xg.pinduoduo.com,0,0.00%,6,6,0.00%
desktop.youku.com,0,0.00%,1,1,0.00%
extension.maxthon.cn,0,0.00%,2,2,0.00%
urchin.lstat.youku.com,0,0.00%,2,2,0.00%
static.atm.youku.com,0,0.00%,2,2,0.00%
wildcard46.go-mpulse.net.edgekey.net,0,0.00%,4,4,0.00%
n.sinaimg.cn,0,0.00%,10,10,0.00%
int.dpool.sina.com.cn,0,0.00%,6,6,0.00%
config.edge.skype.com.trafficmanager.NET,0,0.00%,2,2,0.00%
blades.aliyun.com,0,0.00%,18,18,0.00%
dm2306.storage.live.com,0,0.00%,2,2,0.00%
ipservice.163.com,0,0.00%,1,1,0.00%
i.match.qq.com,0,0.00%,1,1,0.00%
onedriveclucproddm20009.blob.core.windows.net,0,0.00%,1,1,0.00%
cloud.google.com,0,0.00%,9,9,0.00%
outlook.gogo66.cloud,0,0.00%,13,13,0.00%
list.letv.com,0,0.00%,2,2,0.00%
tv.letv.com,0,0.00%,2,2,0.00%
my.letv.com,0,0.00%,2,2,0.00%
mobile.youku.com,0,0.00%,1,1,0.00%
tech.youku.com,0,0.00%,1,1,0.00%
tv.youku.com,0,0.00%,1,1,0.00%
movie.youku.com,0,0.00%,1,1,0.00%
ding.youku.com,0,0.00%,2,2,0.00%
i.youku.com,0,0.00%,2,2,0.00%
v.youku.com,0,0.00%,6,6,0.00%
quan.jd.com,0,0.00%,2,2,0.00%
coupon.jd.com,0,0.00%,2,2,0.00%
cashier.jd.com,0,0.00%,2,2,0.00%
baitiao.jd.com,0,0.00%,2,2,0.00%
trade.jd.com,0,0.00%,2,2,0.00%
re.jd.com,0,0.00%,2,2,0.00%
shop.jd.com,0,0.00%,2,2,0.00%
click.jd.com,0,0.00%,2,2,0.00%
order.jd.com,0,0.00%,2,2,0.00%
sale.jd.com,0,0.00%,1,1,0.00%
list.jd.com,0,0.00%,2,2,0.00%
search.jd.com,0,0.00%,2,2,0.00%
item.jd.com,0,0.00%,4,4,0.00%
china.taobao.com,0,0.00%,2,2,0.00%
list.taobao.com,0,0.00%,2,2,0.00%
buy.taobao.com,0,0.00%,2,2,0.00%
world.taobao.com,0,0.00%,1,1,0.00%
s.taobao.com,0,0.00%,1,1,0.00%
bbs.taobao.com,0,0.00%,2,2,0.00%
quan.sohu.com,0,0.00%,2,2,0.00%
it.sohu.com,0,0.00%,2,2,0.00%
blog.sohu.com,0,0.00%,2,2,0.00%
yule.sohu.com,0,0.00%,2,2,0.00%
mt.sohu.com,0,0.00%,2,2,0.00%
stock.sohu.com,0,0.00%,2,2,0.00%
business.sohu.com,0,0.00%,2,2,0.00%
mil.sohu.com,0,0.00%,1,1,0.00%
auto.sohu.com,0,0.00%,2,2,0.00%
sports.sohu.com,0,0.00%,2,2,0.00%
ieonlinews.trafficmanager.NET,0,0.00%,2,2,0.00%
sports.sina.com.cn,0,0.00%,6,6,0.00%
xiaoyou.qq.com,0,0.00%,2,2,0.00%
login.psvr.wps.cn,0,0.00%,7,7,0.00%
t.qq.com,0,0.00%,2,2,0.00%
cloudnet.h3c.com,0,0.00%,1,1,0.00%
petropluvialis.apple.com,0,0.00%,2,2,0.00%
pmmtk-a.pinduoduo.com,0,0.00%,13,13,0.00%
liveheart.video.iqiyi.com,0,0.00%,4,4,0.00%
p2pupdate.inter.iqiyi.com,0,0.00%,2,2,0.00%
livenet.video.iqiyi.com,0,0.00%,4,4,0.00%
www.mi.com,0,0.00%,17,17,0.00%
win10-trt.msedge.net,0,0.00%,15,15,0.00%
f15598d38d5c48e7ba139c28fdac7e1d.fp.measure.office.com,0,0.00%,1,1,0.00%
waconafd.officeapps.live.com,0,0.00%,8,8,0.00%
wu-bg-shim.trafficmanager.NET,0,0.00%,4,4,0.00%
b29f269.pg.gladns.com,0,0.00%,12,12,0.00%
vpn.oceanum.cn,0,0.00%,32,32,0.00%
a.passcloud.xyz,0,0.00%,12,12,0.00%
ws-livemate.pull.yximgs.com,0,0.00%,4,4,0.00%
ws-rwk.pull.etoote.com,0,0.00%,6,6,0.00%
js-rwk.pull.etoote.com,0,0.00%,2,2,0.00%
ali-pclivemate.pull.yximgs.com,0,0.00%,6,6,0.00%
ali-rwk.pull.etoote.com,0,0.00%,5,5,0.00%
www.macpaw.com,0,0.00%,11,11,0.00%
b29f269.ts.cloudflare.systems,0,0.00%,8,8,0.00%
b29f269.pd.gladns.com,0,0.00%,14,14,0.00%
b29f269.v8.gladns.com,0,0.00%,6,6,0.00%
b29f269.pe.gladns.com,0,0.00%,11,11,0.00%
www.gstatic.cn,0,0.00%,14,14,0.00%
b29f269.ph.gladns.com,0,0.00%,13,13,0.00%
b29f269.pf.gladns.com,0,0.00%,13,13,0.00%
b29f269.v5.gladns.com,0,0.00%,8,8,0.00%
b29f269.v6.gladns.com,0,0.00%,7,7,0.00%
b29f269.v9.gladns.com,0,0.00%,11,11,0.00%
b29f269.v4.gladns.com,0,0.00%,6,6,0.00%
b29f269.v7.gladns.com,0,0.00%,8,8,0.00%
ws01.pull.yximgs.com,0,0.00%,6,6,0.00%
device.sangfor.com.cn,0,0.00%,27,27,0.00%
hk1-7.nigirocloud.com,0,0.00%,24,24,0.00%
t1.dcloud.net.cn,0,0.00%,2,2,0.00%
mims.icbc.com.cn,0,0.00%,2,2,0.00%
oisc.icbc.com.cn,0,0.00%,2,2,0.00%
aedns.weixin.qq.com,0,0.00%,6,6,0.00%
access.toggle.qq.com,0,0.00%,30,30,0.00%
data.ab.qq.com,0,0.00%,9,9,0.00%
iosqqdata.ab.qq.com,0,0.00%,3,3,0.00%
event.toggle.qq.com,0,0.00%,12,12,0.00%
astrategy.beacon.qq.com,0,0.00%,2,2,0.00%
ws-proxy.pull.yximgs.com,0,0.00%,8,8,0.00%
ipv4.gdt.qq.com,0,0.00%,4,4,0.00%
is3.mzstatic.com,0,0.00%,1,1,0.00%
gateway.kugou.com,0,0.00%,10,10,0.00%
qapm.baidu.com,0,0.00%,3,3,0.00%
h-adashx.dingtalkapps.com,0,0.00%,2,2,0.00%
h-adashx.ut.taobao.com.gds.alibabadns.com,0,0.00%,8,8,0.00%
h-adashx-internal.ut.taobao.com,0,0.00%,12,12,0.00%
h-adashx-internal.ut.taobao.com.gds.alibabadns.com,0,0.00%,6,6,0.00%
pull-rtmp-l27.douyincdn.com.live-play.galileo.jcloud-cdn.com,0,0.00%,6,6,0.00%
live-df-sched.jcloudimg.com,0,0.00%,20,20,0.00%
p4-gdmgknw2leoey-43h5anlkzty335p5-146801-i1-bogus-dnssec-vd.gexperiments2.com,0,0.00%,1,1,0.00%
p4-gdmgknw2leoey-43h5anlkzty335p5-146801-i2-bogus-dnssec-bd.gexperiments3.com,0,0.00%,1,1,0.00%
00000000000000000000000000000000000000000000000000000000000015a.rui77.com,0,0.00%,14,14,0.00%
dida365.com,0,0.00%,6,6,0.00%
ns1.veridyen.com,0,0.00%,4,4,0.00%
cortney.ns.cloudflare.com,0,0.00%,12,12,0.00%
dns5.hostitbro.com,0,0.00%,4,4,0.00%
junade.ns.cloudflare.com,0,0.00%,14,14,0.00%
dns6.hostitbro.com,0,0.00%,4,4,0.00%
ns1045.ui-dns.biz,0,0.00%,16,16,0.00%
keira.ns.cloudflare.com,0,0.00%,2,2,0.00%
sevki.ns.cloudflare.com,0,0.00%,2,2,0.00%
502d.com,0,0.00%,2,2,0.00%
ns-109.awsdns-13.com,0,0.00%,2,2,0.00%
ns06.domaincontrol.com,0,0.00%,32,32,0.00%
ns-1228.awsdns-25.org,0,0.00%,4,4,0.00%
ns18.xincache.com,0,0.00%,14,14,0.00%
ns2.hastydns.com,0,0.00%,6,6,0.00%
ns27.domaincontrol.com,0,0.00%,50,50,0.00%
ns-1591.awsdns-06.co.uk,0,0.00%,2,2,0.00%
ns28.domaincontrol.com,0,0.00%,46,46,0.00%
ns1.phase8.net,0,0.00%,10,10,0.00%
ns-809.awsdns-37.net,0,0.00%,2,2,0.00%
ns544.pair.com,0,0.00%,4,4,0.00%
ns21055.ztomy.com,0,0.00%,8,8,0.00%
ns2.phase8.net,0,0.00%,10,10,0.00%
ns0.phase8.net,0,0.00%,10,10,0.00%
ns9.asurahosting.com,0,0.00%,2,2,0.00%
ns7.ns0.com,0,0.00%,2,2,0.00%
irns1.netafraz.com,0,0.00%,12,12,0.00%
ns5.cloudez.io,0,0.00%,4,4,0.00%
ns43.domaincontrol.com,0,0.00%,134,134,0.00%
nsp21511.dns-privadas.es,0,0.00%,2,2,0.00%
ns10.ovh.net,0,0.00%,4,4,0.00%
ns44.domaincontrol.com,0,0.00%,140,140,0.00%
eugene.ns.cloudflare.com,0,0.00%,6,6,0.00%
cosmin.ns.cloudflare.com,0,0.00%,8,8,0.00%
gene.ns.cloudflare.com,0,0.00%,8,8,0.00%
elsa.ns.cloudflare.com,0,0.00%,6,6,0.00%
verification1.plaindns.net,0,0.00%,10,10,0.00%
irns2.netafraz.com,0,0.00%,12,12,0.00%
verification2.plaindns.net,0,0.00%,10,10,0.00%
ns27.hostia.name,0,0.00%,2,2,0.00%
artgrafo.com,0,0.00%,2,2,0.00%
ns2.md-in-42.webhostbox.net,0,0.00%,2,2,0.00%
ns29.iaasdns.com,0,0.00%,2,2,0.00%
ns22.piensasolutions.com,0,0.00%,12,12,0.00%
ns28.hostia.name,0,0.00%,2,2,0.00%
olof.ns.cloudflare.com,0,0.00%,4,4,0.00%
ns21.piensasolutions.com,0,0.00%,10,10,0.00%
tani.ns.cloudflare.com,0,0.00%,2,2,0.00%
iris-de-prod-azsc-eas.eastasia.cloudapp.azure.com,0,0.00%,10,10,0.00%
qyhljy.com,0,0.00%,1,1,0.00%
edward.ns.cloudflare.com,0,0.00%,10,10,0.00%
dns1.p05.nsone.net,0,0.00%,36,36,0.00%
ns2.dijitalisyerim.com.tr,0,0.00%,2,2,0.00%
cheryl.ns.cloudflare.com,0,0.00%,8,8,0.00%
dns2.p05.nsone.net,0,0.00%,36,36,0.00%
ns1093.ui-dns.com,0,0.00%,6,6,0.00%
ns-a1.conoha.io,0,0.00%,62,62,0.00%
ns1031.ui-dns.de,0,0.00%,4,4,0.00%
ariadne.ns.cloudflare.com,0,0.00%,4,4,0.00%
dns4.p05.nsone.net,0,0.00%,34,34,0.00%
ns3.hostpoint.ch,0,0.00%,14,14,0.00%
ns1.tech101.cloud,0,0.00%,2,2,0.00%
lazzett.com,0,0.00%,2,2,0.00%
ns.hostpoint.ch,0,0.00%,14,14,0.00%
k.ns.arvancdn.com,0,0.00%,2,2,0.00%
ns1.asmallorange.com,0,0.00%,4,4,0.00%
ns2.hostpoint.ch,0,0.00%,14,14,0.00%
jimmy.ns.cloudflare.com,0,0.00%,10,10,0.00%
ns2.asmallorange.com,0,0.00%,2,2,0.00%
nero.ns.cloudflare.com,0,0.00%,4,4,0.00%
ns3.alastyr.com,0,0.00%,6,6,0.00%
ns1.locaweb.com.br,0,0.00%,12,12,0.00%
dns1.cscdns.net,0,0.00%,20,20,0.00%
dns3.p05.nsone.net,0,0.00%,32,32,0.00%
ns3.locaweb.com.br,0,0.00%,12,12,0.00%
ns2.value-domain.com,0,0.00%,46,46,0.00%
dns2.cscdns.net,0,0.00%,18,18,0.00%
ns2.locaweb.com.br,0,0.00%,12,12,0.00%
ns1104.ui-dns.com,0,0.00%,2,2,0.00%
leah.ns.cloudflare.com,0,0.00%,6,6,0.00%
noah.ns.cloudflare.com,0,0.00%,4,4,0.00%
clns2.iranhost.com,0,0.00%,2,2,0.00%
ns05.domaincontrol.com,0,0.00%,28,28,0.00%
jaziel.ns.cloudflare.com,0,0.00%,6,6,0.00%
clns1.iranhost.com,0,0.00%,2,2,0.00%
val.ns.cloudflare.com,0,0.00%,12,12,0.00%
ns1.dns.com.cn,0,0.00%,10,10,0.00%
ns3.whois.com,0,0.00%,6,6,0.00%
ns2.whois.com,0,0.00%,6,6,0.00%
diva.ns.cloudflare.com,0,0.00%,6,6,0.00%
ns1.whois.com,0,0.00%,6,6,0.00%
ns2.beohost.com,0,0.00%,2,2,0.00%
ns1.99midns.com,0,0.00%,94,94,0.00%
donald.ns.cloudflare.com,0,0.00%,30,30,0.00%
ns4.whois.com,0,0.00%,6,6,0.00%
ns4238.hostgator.com,0,0.00%,10,10,0.00%
ns.rse.gofasthost.com,0,0.00%,2,2,0.00%
scott.ns.cloudflare.com,0,0.00%,12,12,0.00%
ns-53-b.gandi.net,0,0.00%,2,2,0.00%
ns1113.ui-dns.de,0,0.00%,2,2,0.00%
ns4237.hostgator.com,0,0.00%,10,10,0.00%
ns2.99midns.com,0,0.00%,92,92,0.00%
ns2.rse.gofasthost.com,0,0.00%,2,2,0.00%
peaches.ns.cloudflare.com,0,0.00%,2,2,0.00%
ns13.xincache.com,0,0.00%,2,2,0.00%
ns4.gofasthost.com,0,0.00%,2,2,0.00%
vida.ns.cloudflare.com,0,0.00%,10,10,0.00%
ns1.beohost.com,0,0.00%,2,2,0.00%
ns3.gofasthost.com,0,0.00%,2,2,0.00%
ns-201-c.gandi.net,0,0.00%,2,2,0.00%
mckenzie.ns.cloudflare.com,0,0.00%,6,6,0.00%
ns36.labelhosting.net,0,0.00%,2,2,0.00%
nia.ns.cloudflare.com,0,0.00%,6,6,0.00%
ns1.masquelaser.com,0,0.00%,2,2,0.00%
dns19.hichina.com,0,0.00%,28,28,0.00%
ns2.omnis.com,0,0.00%,2,2,0.00%
dns20.hichina.com,0,0.00%,30,30,0.00%
ns1.dijitalisyerim.com.tr,0,0.00%,2,2,0.00%
ns37.labelhosting.net,0,0.00%,2,2,0.00%
ns1.omnis.com,0,0.00%,8,8,0.00%
ns3.host-fusion.com,0,0.00%,2,2,0.00%
ns.tradeindia.com,0,0.00%,10,10,0.00%
ns3.omnis.com,0,0.00%,2,2,0.00%
ns1.rtahosting.net,0,0.00%,2,2,0.00%
ns11055.ztomy.com,0,0.00%,8,8,0.00%
ns2.rtahosting.net,0,0.00%,2,2,0.00%
karsyn.ns.cloudflare.com,0,0.00%,6,6,0.00%
ns4.dnsmadeeasy.com,0,0.00%,6,6,0.00%
ns1.registry-server.com,0,0.00%,6,6,0.00%
ns1.disayana.com,0,0.00%,2,2,0.00%
ns3.dnsmadeeasy.com,0,0.00%,6,6,0.00%
ns4243.hostgator.com,0,0.00%,14,14,0.00%
ns1.telecelula.com,0,0.00%,2,2,0.00%
dns3.digitalhost.com,0,0.00%,2,2,0.00%
ns2.registry-server.com,0,0.00%,6,6,0.00%
ns0.dnsmadeeasy.com,0,0.00%,6,6,0.00%
ns4244.hostgator.com,0,0.00%,16,16,0.00%
julio.ns.cloudflare.com,0,0.00%,4,4,0.00%
ns2.cdmon.net,0,0.00%,12,12,0.00%
ns12.jimdo.com,0,0.00%,4,4,0.00%
ns-us.1and1-dns.de,0,0.00%,2,2,0.00%
ns1.dnsmadeeasy.com,0,0.00%,6,6,0.00%
nss21511.dns-privadas.es,0,0.00%,2,2,0.00%
ns11.jimdo.com,0,0.00%,4,4,0.00%
ns1.cdmon.net,0,0.00%,12,12,0.00%
kara.ns.cloudflare.com,0,0.00%,8,8,0.00%
ns2.dnsmadeeasy.com,0,0.00%,6,6,0.00%
verification-4coodhu6.ns3.dan.hosting,0,0.00%,2,2,0.00%
ns1.startlogic.com,0,0.00%,10,10,0.00%
ns2.disayana.com,0,0.00%,2,2,0.00%
theo.ns.cloudflare.com,0,0.00%,22,22,0.00%
ns4.cdmondns-01.org,0,0.00%,12,12,0.00%
ns2.telecelula.com,0,0.00%,2,2,0.00%
evangeline.ns.cloudflare.com,0,0.00%,10,10,0.00%
angela.ns.cloudflare.com,0,0.00%,16,16,0.00%
allaboutstorageomaha.com,0,0.00%,2,2,0.00%
ns3.freeola.net,0,0.00%,2,2,0.00%
miguel.ns.cloudflare.com,0,0.00%,4,4,0.00%
ns-us.1and1-dns.org,0,0.00%,2,2,0.00%
dns1.digitalhost.com,0,0.00%,2,2,0.00%
bison.ezoicns.com,0,0.00%,4,4,0.00%
ns10.asurahosting.com,0,0.00%,2,2,0.00%
keyla.ns.cloudflare.com,0,0.00%,6,6,0.00%
virginia.ns.cloudflare.com,0,0.00%,6,6,0.00%
ns2.namefind.com,0,0.00%,8,8,0.00%
llama.ezoicns.com,0,0.00%,4,4,0.00%
ns5.cdmondns-01.com,0,0.00%,12,12,0.00%
ns-us.1and1-dns.com,0,0.00%,2,2,0.00%
okapi.ezoicns.com,0,0.00%,4,4,0.00%
destiny.ns.cloudflare.com,0,0.00%,10,10,0.00%
ns1.verio.com,0,0.00%,2,2,0.00%
ns2.systemdns.com,0,0.00%,36,36,0.00%
ns4.freeola.net,0,0.00%,2,2,0.00%
zebra.ezoicns.com,0,0.00%,4,4,0.00%
ns2.verio.com,0,0.00%,2,2,0.00%
naya.ns.cloudflare.com,0,0.00%,6,6,0.00%
ns2.bdydns.cn,0,0.00%,18,18,0.00%
hub.docker.com,0,0.00%,4,4,0.00%
ns-us.1and1-dns.us,0,0.00%,2,2,0.00%
ns2.dne.com,0,0.00%,24,24,0.00%
ns102.ovh.net,0,0.00%,2,2,0.00%
ns3.cdmon.net,0,0.00%,10,10,0.00%
dolly.ns.cloudflare.com,0,0.00%,4,4,0.00%
ns1.dne.com,0,0.00%,24,24,0.00%
dns102.ovh.net,0,0.00%,2,2,0.00%
ns2.c005jp3534.info,0,0.00%,2,2,0.00%
sri.ns.cloudflare.com,0,0.00%,4,4,0.00%
ns111383.ztomy.com,0,0.00%,4,4,0.00%
ns1.bdydns.cn,0,0.00%,18,18,0.00%
ns1.c005jp3534.info,0,0.00%,2,2,0.00%
allyourproducts.com,0,0.00%,2,2,0.00%
cdyjgd.com,0,0.00%,2,2,0.00%
ns1.abay.net.tr,0,0.00%,2,2,0.00%
wangmeiwang.com,0,0.00%,2,2,0.00%
ns211383.ztomy.com,0,0.00%,4,4,0.00%
jacob.ns.cloudflare.com,0,0.00%,10,10,0.00%
joselyn.ns.cloudflare.com,0,0.00%,6,6,0.00%
ns1.domainesia.net,0,0.00%,14,14,0.00%
ns2.chemibiology.com,0,0.00%,2,2,0.00%
dns10.ovh.net,0,0.00%,6,6,0.00%
ns2.abay.net.tr,0,0.00%,2,2,0.00%
ns.datacenter.no,0,0.00%,6,6,0.00%
ns2.domainesia.net,0,0.00%,14,14,0.00%
ns1.chemibiology.com,0,0.00%,2,2,0.00%
ns603.hostgator.com.br,0,0.00%,2,2,0.00%
ns602.hostgator.com.br,0,0.00%,2,2,0.00%
ns6.cnmsn.net,0,0.00%,6,6,0.00%
ns2.datacenter.no,0,0.00%,6,6,0.00%
ns5.cnmsn.net,0,0.00%,6,6,0.00%
ns1.ibersoft.es,0,0.00%,2,2,0.00%
ns907.hostgator.com.br,0,0.00%,2,2,0.00%
ns906.hostgator.com.br,0,0.00%,2,2,0.00%
ns2.ibersoft.es,0,0.00%,2,2,0.00%
cloudinfo.rising.com.cn,0,0.00%,52,52,0.00%
piotr.ns.cloudflare.com,0,0.00%,6,6,0.00%
fattouche.ns.cloudflare.com,0,0.00%,4,4,0.00%
ns4.whoisdomain.kr,0,0.00%,14,14,0.00%
ns3.whoisdomain.kr,0,0.00%,14,14,0.00%
dns32.hichina.com,0,0.00%,46,46,0.00%
gina.ns.cloudflare.com,0,0.00%,10,10,0.00%
ns1-02.azure-dns.com,0,0.00%,2,2,0.00%
yns1.yahoo.com,0,0.00%,8,8,0.00%
ns1.cp-35.webhostbox.net,0,0.00%,2,2,0.00%
ns2-02.azure-dns.net,0,0.00%,2,2,0.00%
ns2.whoisdomain.kr,0,0.00%,14,14,0.00%
auth-v2.oray.com,0,0.00%,95,95,0.00%
ns2.cp-35.webhostbox.net,0,0.00%,2,2,0.00%
ns3-02.azure-dns.org,0,0.00%,2,2,0.00%
yns2.yahoo.com,0,0.00%,8,8,0.00%
ns1.ohioconcreteandexcavating.com,0,0.00%,2,2,0.00%
ns1.whoisdomain.kr,0,0.00%,14,14,0.00%
appexorch.bestsdwan.com,0,0.00%,29,29,0.00%
eric.ns.cloudflare.com,0,0.00%,4,4,0.00%
hsk-api.oray.com,0,0.00%,34,34,0.00%
plato.ns.cloudflare.com,0,0.00%,6,6,0.00%
dns2.technorail.com,0,0.00%,46,46,0.00%
ns-1955.awsdns-52.co.uk,0,0.00%,4,4,0.00%
ns-287.awsdns-35.com,0,0.00%,4,4,0.00%
lcsjgwz.com,0,0.00%,2,2,0.00%
ns-744.awsdns-29.net,0,0.00%,2,2,0.00%
dns1.hosteur.com,0,0.00%,4,4,0.00%
blob.bz6prdstr14a.store.core.windows.NET,0,0.00%,4,4,0.00%
xn--ketq8xxnqvkmeqq.com,0,0.00%,2,2,0.00%
dns2.hosteur.com,0,0.00%,4,4,0.00%
hsk-api-v2.oray.com,0,0.00%,12,12,0.00%
ns3.supercp.com,0,0.00%,8,8,0.00%
ns894.hostgator.com.br,0,0.00%,2,2,0.00%
b.ns36.de,0,0.00%,6,6,0.00%
ns895.hostgator.com.br,0,0.00%,2,2,0.00%
ns1.wix.com,0,0.00%,2,2,0.00%
a.ns36.de,0,0.00%,6,6,0.00%
verification-6g147kh6.ns3.dan.hosting,0,0.00%,2,2,0.00%
verification-u4h7az4r.ns3.dan.hosting,0,0.00%,2,2,0.00%
ns2.supercp.com,0,0.00%,10,10,0.00%
ns1.n001.com,0,0.00%,2,2,0.00%
dns1.as12513.net,0,0.00%,2,2,0.00%
ns2.n001.com,0,0.00%,2,2,0.00%
pancake.dnspod.net,0,0.00%,2,2,0.00%
ns4.supercp.com,0,0.00%,10,10,0.00%
newt.ns.cloudflare.com,0,0.00%,8,8,0.00%
ns2.utilitycomputerscience.com,0,0.00%,2,2,0.00%
site.4dlo.com,0,0.00%,10,10,0.00%
jingdianhaomenliyi.com,0,0.00%,2,2,0.00%
verification-768cf101.ns3.dan.hosting,0,0.00%,2,2,0.00%
uns01.lolipop.jp,0,0.00%,22,22,0.00%
ns2.prncpm.com,0,0.00%,2,2,0.00%
dns1.eclipse.net.uk,0,0.00%,2,2,0.00%
grass.dnspod.net,0,0.00%,2,2,0.00%
uns02.lolipop.jp,0,0.00%,22,22,0.00%
bayan.ns.cloudflare.com,0,0.00%,8,8,0.00%
venus.ns.cloudflare.com,0,0.00%,6,6,0.00%
ns4.cloudez.io,0,0.00%,4,4,0.00%
dns2.as12513.net,0,0.00%,2,2,0.00%
ns1.prncpm.com,0,0.00%,2,2,0.00%
ns4.tech101.cloud,0,0.00%,2,2,0.00%
ns2.goldheavenly.com,0,0.00%,2,2,0.00%
ns1.clhdesigns.com,0,0.00%,2,2,0.00%
ns2.dnsimple.com,0,0.00%,28,28,0.00%
joyce.ns.cloudflare.com,0,0.00%,2,2,0.00%
dns13.servidoresdns.net,0,0.00%,12,12,0.00%
yarnsandfibres.com,0,0.00%,2,2,0.00%
ns3.prncpm.com,0,0.00%,2,2,0.00%
ns1.hastydns.com,0,0.00%,6,6,0.00%
wtr.domainhizmetleri.net,0,0.00%,2,2,0.00%
ns2.cloudez.io,0,0.00%,4,4,0.00%
ns1.utilitycomputerscience.com,0,0.00%,2,2,0.00%
ns1.goldheavenly.com,0,0.00%,2,2,0.00%
ara.ns.cloudflare.com,0,0.00%,8,8,0.00%
ns3.cloudez.io,0,0.00%,4,4,0.00%
ns1071.ui-dns.de,0,0.00%,6,6,0.00%
ns2.clhdesigns.com,0,0.00%,2,2,0.00%
res13.irpowerweb.com,0,0.00%,2,2,0.00%
ns2.tech101.cloud,0,0.00%,2,2,0.00%
dns14.servidoresdns.net,0,0.00%,12,12,0.00%
puppis.dnspod.net,0,0.00%,6,6,0.00%
ns-971.awsdns-57.net,0,0.00%,2,2,0.00%
norman.ns.cloudflare.com,0,0.00%,10,10,0.00%
ns2.coastalbase.com,0,0.00%,4,4,0.00%
weu.domainhizmetleri.net,0,0.00%,2,2,0.00%
ceu-a03.stream.node-fnf.xyz,0,0.00%,4,4,0.00%
ruth.ns.cloudflare.com,0,0.00%,2,2,0.00%
josephine.ns.cloudflare.com,0,0.00%,4,4,0.00%
ns1.breedanimalstipsinfo.org.uk,0,0.00%,2,2,0.00%
ns1.cloudez.io,0,0.00%,4,4,0.00%
ns8296.hostgator.com,0,0.00%,2,2,0.00%
ns4.cybexhosting.com,0,0.00%,2,2,0.00%
nsbd2.hostseba.com,0,0.00%,2,2,0.00%
ns1.regery.net,0,0.00%,6,6,0.00%
ns1.easyname.eu,0,0.00%,4,4,0.00%
ns2.regery.net,0,0.00%,6,6,0.00%
dns1.nominalia.com,0,0.00%,10,10,0.00%
docks13.rzone.de,0,0.00%,2,2,0.00%
lloyd.ns.cloudflare.com,0,0.00%,6,6,0.00%
bella.ns.cloudflare.com,0,0.00%,6,6,0.00%
isaac.ns.cloudflare.com,0,0.00%,16,16,0.00%
kuna1117639.earth.orderbox-dns.com,0,0.00%,22,22,0.00%
ns1109.ui-dns.org,0,0.00%,8,8,0.00%
shades12.rzone.de,0,0.00%,2,2,0.00%
ns6521.hostgator.com,0,0.00%,2,2,0.00%
ns2.k4u.serverfreak.biz,0,0.00%,2,2,0.00%
kuna1117639.venus.orderbox-dns.com,0,0.00%,24,24,0.00%
ns1.icasei.com.br,0,0.00%,20,20,0.00%
ns10.icasei.com.br,0,0.00%,20,20,0.00%
ns2.icasei.com.br,0,0.00%,18,18,0.00%
gwen.ns.cloudflare.com,0,0.00%,4,4,0.00%
pdns14.domaincontrol.com,0,0.00%,16,16,0.00%
verification-637008hv.ns3.dan.hosting,0,0.00%,2,2,0.00%
ns4.lpmtr.net,0,0.00%,2,2,0.00%
ns1029.ui-dns.biz,0,0.00%,8,8,0.00%
ns2.lpmtr.net,0,0.00%,2,2,0.00%
ns3.lpmtr.net,0,0.00%,2,2,0.00%
ns1.lpmtr.net,0,0.00%,2,2,0.00%
ns1.ipower.com,0,0.00%,10,10,0.00%
dns2.papaki.gr,0,0.00%,4,4,0.00%
tim.ns.cloudflare.com,0,0.00%,10,10,0.00%
ns2.ipower.com,0,0.00%,10,10,0.00%
dns01.muumuu-domain.com,0,0.00%,48,48,0.00%
dns24.hichina.com,0,0.00%,46,46,0.00%
dns1.papaki.gr,0,0.00%,6,6,0.00%
ns4.stackdns.com,0,0.00%,32,32,0.00%
ns3.lyricalhost.com,0,0.00%,2,2,0.00%
ns0.transip.net,0,0.00%,24,24,0.00%
ns5932.banahosting.com,0,0.00%,2,2,0.00%
ns5933.banahosting.com,0,0.00%,2,2,0.00%
ns2.transip.eu,0,0.00%,26,26,0.00%
raina.ns.cloudflare.com,0,0.00%,4,4,0.00%
ns22.migracem.com,0,0.00%,2,2,0.00%
aaden.ns.cloudflare.com,0,0.00%,4,4,0.00%
ullis.ns.cloudflare.com,0,0.00%,6,6,0.00%
elisa.ns.cloudflare.com,0,0.00%,6,6,0.00%
emily.ns.cloudflare.com,0,0.00%,6,6,0.00%
ns2.cynethost.com,0,0.00%,2,2,0.00%
jeremy.dnspod.net,0,0.00%,4,4,0.00%
ns2.hndnsv1.com,0,0.00%,4,4,0.00%
re6.hostinglotus.net,0,0.00%,2,2,0.00%
ns3.cynethost.com,0,0.00%,2,2,0.00%
rustam.ns.cloudflare.com,0,0.00%,6,6,0.00%
ns-1484.awsdns-57.org,0,0.00%,2,2,0.00%
princess.ns.cloudflare.com,0,0.00%,2,2,0.00%
ns-1116.awsdns-11.org,0,0.00%,2,2,0.00%
vita.dnspod.net,0,0.00%,4,4,0.00%
cpns2.turhost.com,0,0.00%,6,6,0.00%
ns4.cynethost.com,0,0.00%,2,2,0.00%
ns-1809.awsdns-34.co.uk,0,0.00%,2,2,0.00%
ns-1940.awsdns-50.co.uk,0,0.00%,2,2,0.00%
ns1067.ui-dns.de,0,0.00%,6,6,0.00%
dns2.laisvas.lt,0,0.00%,2,2,0.00%
re5.hostinglotus.net,0,0.00%,2,2,0.00%
ns-1499.awsdns-59.org,0,0.00%,2,2,0.00%
guss.ns.cloudflare.com,0,0.00%,80,80,0.00%
ns-474.awsdns-59.com,0,0.00%,2,2,0.00%
colette.ns.cloudflare.com,0,0.00%,12,12,0.00%
ns-1388.awsdns-45.org,0,0.00%,2,2,0.00%
ns-473.awsdns-59.com,0,0.00%,2,2,0.00%
ns-1713.awsdns-22.co.uk,0,0.00%,2,2,0.00%
lee.ns.cloudflare.com,0,0.00%,16,16,0.00%
ns-912.awsdns-50.net,0,0.00%,2,2,0.00%
ns1.md-in-75.webhostbox.net,0,0.00%,2,2,0.00%
cpanel3.lws-hosting.com,0,0.00%,4,4,0.00%
ns-1640.awsdns-13.co.uk,0,0.00%,2,2,0.00%
park2.livedns.co.il,0,0.00%,2,2,0.00%
ns-904.awsdns-49.net,0,0.00%,2,2,0.00%
ns1.cynethost.com,0,0.00%,2,2,0.00%
george.ns.cloudflare.com,0,0.00%,4,4,0.00%
ns-454.awsdns-56.com,0,0.00%,2,2,0.00%
betty.ns.cloudflare.com,0,0.00%,6,6,0.00%
ns100.nsresponse.com,0,0.00%,6,6,0.00%
ns-823.awsdns-38.net,0,0.00%,2,2,0.00%
uma.ns.cloudflare.com,0,0.00%,18,18,0.00%
vh1036569.sudu-ppv5.com,0,0.00%,2,2,0.00%
sreeni.ns.cloudflare.com,0,0.00%,4,4,0.00%
ns-520.awsdns-01.net,0,0.00%,2,2,0.00%
dns1.rumahosting.com,0,0.00%,2,2,0.00%
ns4.name.com,0,0.00%,2,2,0.00%
cpns1.turhost.com,0,0.00%,6,6,0.00%
tosana.ns.cloudflare.com,0,0.00%,4,4,0.00%
cpanel4.lws-hosting.com,0,0.00%,4,4,0.00%
bharatimpx.com,0,0.00%,2,2,0.00%
marge.ns.cloudflare.com,0,0.00%,6,6,0.00%
ns2-tec.de,0,0.00%,6,6,0.00%
malavika.ns.cloudflare.com,0,0.00%,12,12,0.00%
dns1.bacloud.com,0,0.00%,2,2,0.00%
brian.ns.cloudflare.com,0,0.00%,2,2,0.00%
barexconstruction.com,0,0.00%,2,2,0.00%
ns1-tec.de,0,0.00%,6,6,0.00%
dns1.laisvas.lt,0,0.00%,2,2,0.00%
webquotestaticpic.dfcfw.com,0,0.00%,8,8,0.00%
khoa805853.mercury.orderbox-dns.com,0,0.00%,2,2,0.00%
pns103.cloudns.net,0,0.00%,10,10,0.00%
ns98.hostgator.mx,0,0.00%,2,2,0.00%
fatima.ns.cloudflare.com,0,0.00%,4,4,0.00%
arya.ns.cloudflare.com,0,0.00%,6,6,0.00%
bc-pottery.com,0,0.00%,1,1,0.00%
ns99.hostgator.mx,0,0.00%,2,2,0.00%
bradley.ns.cloudflare.com,0,0.00%,6,6,0.00%
ns1045.ui-dns.de,0,0.00%,20,20,0.00%
lila.ns.cloudflare.com,0,0.00%,10,10,0.00%
mario.ns.cloudflare.com,0,0.00%,10,10,0.00%
kiki.ns.cloudflare.com,0,0.00%,8,8,0.00%
ns-1336.awsdns-39.org,0,0.00%,2,2,0.00%
carlane.ns.cloudflare.com,0,0.00%,4,4,0.00%
nitin.ns.cloudflare.com,0,0.00%,2,2,0.00%
ns1057.ui-dns.biz,0,0.00%,8,8,0.00%
ns1.huaweicloud-dns.net,0,0.00%,28,28,0.00%
ns1.hosttech.ch,0,0.00%,2,2,0.00%
ns1025.ui-dns.com,0,0.00%,12,12,0.00%
dns2.bacloud.com,0,0.00%,2,2,0.00%
bgxcyfuired5.h.bdy.smp11.cn,0,0.00%,2,2,0.00%
ns2.empretienda.net,0,0.00%,2,2,0.00%
sergi.ns.cloudflare.com,0,0.00%,2,2,0.00%
ns1045.ui-dns.org,0,0.00%,16,16,0.00%
pdns1.registrar-servers.com,0,0.00%,52,52,0.00%
mmarn3mxxh6yjr4.gt-99-js-ii-i1-0o-j9-o0-1i-0o-sd-hg-kj.com,0,0.00%,2,2,0.00%
lola.ns.cloudflare.com,0,0.00%,16,16,0.00%
ns1041.ui-dns.de,0,0.00%,8,8,0.00%
bdy.gz01.bdysite.com,0,0.00%,2,2,0.00%
leif.ns.cloudflare.com,0,0.00%,2,2,0.00%
ns1.nwpro5.fcomet.com,0,0.00%,2,2,0.00%
ns.gabia.net,0,0.00%,68,68,0.00%
ns4.mxserver.ro,0,0.00%,2,2,0.00%
ns2.hosttech.ch,0,0.00%,2,2,0.00%
pltraffic35.com,0,0.00%,6,6,0.00%
ns5.simplecplogin.com,0,0.00%,2,2,0.00%
ns1045.ui-dns.com,0,0.00%,14,14,0.00%
ns3.hosttech.ch,0,0.00%,2,2,0.00%
pdns13.domaincontrol.com,0,0.00%,16,16,0.00%
ns1103.ui-dns.org,0,0.00%,6,6,0.00%
elder.dnspod.net,0,0.00%,2,2,0.00%
ns577.hostgator.com.br,0,0.00%,2,2,0.00%
damon.ns.cloudflare.com,0,0.00%,6,6,0.00%
dust.dnspod.net,0,0.00%,2,2,0.00%
ns6.simplecplogin.com,0,0.00%,2,2,0.00%
bess.dnspod.net,0,0.00%,2,2,0.00%
ns2.shockhosting.net,0,0.00%,4,4,0.00%
ns2jrt.name.com,0,0.00%,18,18,0.00%
laila.ns.cloudflare.com,0,0.00%,6,6,0.00%
ns576.hostgator.com.br,0,0.00%,2,2,0.00%
ns3fhx.name.com,0,0.00%,2,2,0.00%
ns4lpv.name.com,0,0.00%,6,6,0.00%
ns2.lineadns.com,0,0.00%,2,2,0.00%
ns1091.ui-dns.com,0,0.00%,2,2,0.00%
ns27.netkl.com,0,0.00%,6,6,0.00%
ns2.cafe24.co.kr,0,0.00%,18,18,0.00%
ns1064.ui-dns.biz,0,0.00%,6,6,0.00%
ns1065.ui-dns.com,0,0.00%,4,4,0.00%
ns2.cafe24.com,0,0.00%,18,18,0.00%
ns206.f7-networks.com,0,0.00%,2,2,0.00%
ns207.f7-networks.com,0,0.00%,2,2,0.00%
dns4.cosmotown.com,0,0.00%,4,4,0.00%
dns2.cosmotown.com,0,0.00%,2,2,0.00%
ns2.guardeddns.net,0,0.00%,2,2,0.00%
dns3.cosmotown.com,0,0.00%,4,4,0.00%
dns1.cosmotown.com,0,0.00%,2,2,0.00%
otto.ns.cloudflare.com,0,0.00%,4,4,0.00%
stock2.finance.sina.com.cn,0,0.00%,6,6,0.00%
ns1.matthias-escher.de,0,0.00%,2,2,0.00%
dns1.wfolio.ru,0,0.00%,2,2,0.00%
jocelyn.ns.cloudflare.com,0,0.00%,6,6,0.00%
henrik.ns.cloudflare.com,0,0.00%,6,6,0.00%
ns1psw.name.com,0,0.00%,8,8,0.00%
ns1glr.name.com,0,0.00%,6,6,0.00%
ns2.matthias-escher.de,0,0.00%,2,2,0.00%
ns2glx.name.com,0,0.00%,6,6,0.00%
tiffany.ns.cloudflare.com,0,0.00%,4,4,0.00%
lara.ns.cloudflare.com,0,0.00%,4,4,0.00%
dns8.cloudns.net,0,0.00%,2,2,0.00%
ns4246.hostgator.com,0,0.00%,8,8,0.00%
bestdealdistribution.com,0,0.00%,2,2,0.00%
bestdrawtool.com,0,0.00%,2,2,0.00%
ns4245.hostgator.com,0,0.00%,8,8,0.00%
serena.ns.cloudflare.com,0,0.00%,6,6,0.00%
ns4fqz.name.com,0,0.00%,6,6,0.00%
chi-ns1.websitehostserver.net,0,0.00%,12,12,0.00%
piers.ns.cloudflare.com,0,0.00%,2,2,0.00%
dns2.hosterpk.com,0,0.00%,4,4,0.00%
ns2.checkdomain.de,0,0.00%,10,10,0.00%
ams-ns1.websitehostserver.net,0,0.00%,12,12,0.00%
johnathan.ns.cloudflare.com,0,0.00%,18,18,0.00%
ns302.mihanwebhost.com,0,0.00%,2,2,0.00%
dns1.hosterpk.com,0,0.00%,4,4,0.00%
ns.checkdomain.de,0,0.00%,12,12,0.00%
anastasia.ns.cloudflare.com,0,0.00%,2,2,0.00%
ns02.bestjobnearyou.com,0,0.00%,2,2,0.00%
ns2.bestepoxytables.com,0,0.00%,2,2,0.00%
ns5.brandshelter.us,0,0.00%,12,12,0.00%
lns1.adnshost.com,0,0.00%,2,2,0.00%
conrad.ns.cloudflare.com,0,0.00%,6,6,0.00%
kim.ns.cloudflare.com,0,0.00%,18,18,0.00%
ns01.bestjobnearyou.com,0,0.00%,2,2,0.00%
ns3.green-internet.net,0,0.00%,2,2,0.00%
lns2.adnshost.com,0,0.00%,2,2,0.00%
ns1122.ui-dns.org,0,0.00%,4,4,0.00%
ns4234.hostgator.com,0,0.00%,30,30,0.00%
ns1.md-in-80.hostgatorwebservers.com,0,0.00%,2,2,0.00%
abby.ns.cloudflare.com,0,0.00%,16,16,0.00%
grant.ns.cloudflare.com,0,0.00%,10,10,0.00%
ns1.bigbrotherintelligence.com,0,0.00%,2,2,0.00%
litchi.dnspod.net,0,0.00%,2,2,0.00%
ns2.md-in-80.hostgatorwebservers.com,0,0.00%,2,2,0.00%
ns1.guardedhost.com,0,0.00%,2,2,0.00%
sureena.ns.cloudflare.com,0,0.00%,4,4,0.00%
ancbd.earth.orderbox-dns.com,0,0.00%,2,2,0.00%
ns2dfg.name.com,0,0.00%,4,4,0.00%
ns2.bigbrotherintelligence.com,0,0.00%,2,2,0.00%
cory.ns.cloudflare.com,0,0.00%,10,10,0.00%
julissa.ns.cloudflare.com,0,0.00%,4,4,0.00%
stan.ns.cloudflare.com,0,0.00%,6,6,0.00%
ns4lny.name.com,0,0.00%,4,4,0.00%
nsa.n0c.com,0,0.00%,2,2,0.00%
sharon.ns.cloudflare.com,0,0.00%,4,4,0.00%
ancbd.mars.orderbox-dns.com,0,0.00%,2,2,0.00%
denver.ns.cloudflare.com,0,0.00%,4,4,0.00%
webquotepic.eastmoney.com,0,0.00%,8,8,0.00%
ns2.hawkhost.com,0,0.00%,10,10,0.00%
great.jagoanhosting.com,0,0.00%,2,2,0.00%
ancbd.venus.orderbox-dns.com,0,0.00%,2,2,0.00%
ns1.hawkhost.com,0,0.00%,10,10,0.00%
grannbo.ns.cloudflare.com,0,0.00%,6,6,0.00%
best.jagoanhosting.com,0,0.00%,2,2,0.00%
ns4.mysecurecloudhost.com,0,0.00%,8,8,0.00%
crystal.ns.cloudflare.com,0,0.00%,2,2,0.00%
pns101.cloudns.net,0,0.00%,10,10,0.00%
nsb.n0c.com,0,0.00%,2,2,0.00%
candy.ns.cloudflare.com,0,0.00%,6,6,0.00%
betterchoicefoodandspice.com,0,0.00%,2,2,0.00%
nataly.ns.cloudflare.com,0,0.00%,8,8,0.00%
ns102.cloudns.net,0,0.00%,6,6,0.00%
nsc.n0c.com,0,0.00%,2,2,0.00%
sam.ns.cloudflare.com,0,0.00%,10,10,0.00%
dns1.123hjemmeside.dk,0,0.00%,20,20,0.00%
ns-1378.awsdns-44.org,0,0.00%,2,2,0.00%
pns102.cloudns.net,0,0.00%,8,8,0.00%
dns3.123hjemmeside.dk,0,0.00%,18,18,0.00%
ns1.host-ww.net,0,0.00%,2,2,0.00%
ns1.nic53.net,0,0.00%,22,22,0.00%
ns-1672.awsdns-17.co.uk,0,0.00%,4,4,0.00%
pns104.cloudns.net,0,0.00%,10,10,0.00%
ns3.eurodns.com,0,0.00%,10,10,0.00%
ns2.host-ww.net,0,0.00%,2,2,0.00%
ns2.nic53.de,0,0.00%,20,20,0.00%
ns1.dnsimple.com,0,0.00%,30,30,0.00%
ns-183.awsdns-22.com,0,0.00%,2,2,0.00%
ns2.mxserver.ro,0,0.00%,2,2,0.00%
park1.livedns.co.il,0,0.00%,2,2,0.00%
ns.gabia.co.kr,0,0.00%,66,66,0.00%
docks01.rzone.de,0,0.00%,8,8,0.00%
ns1.green-internet.net,0,0.00%,3,3,0.00%
ns3.mxserver.ro,0,0.00%,2,2,0.00%
evelyn.ns.cloudflare.com,0,0.00%,6,6,0.00%
ns-666.awsdns-19.net,0,0.00%,2,2,0.00%
ns3.dnsimple.com,0,0.00%,28,28,0.00%
carla.ns.cloudflare.com,0,0.00%,4,4,0.00%
ns1.dns.web.tr,0,0.00%,2,2,0.00%
ns1.mxserver.ro,0,0.00%,2,2,0.00%
ns1030.ui-dns.de,0,0.00%,10,10,0.00%
ns4.dnsimple.com,0,0.00%,26,26,0.00%
reese.ns.cloudflare.com,0,0.00%,4,4,0.00%
ns1.gabia.co.kr,0,0.00%,66,66,0.00%
ns4.green-internet.net,0,0.00%,2,2,0.00%
ns2.dns.web.tr,0,0.00%,2,2,0.00%
ns2.argewebhosting.com,0,0.00%,10,10,0.00%
ns3.argewebhosting.nl,0,0.00%,8,8,0.00%
ns1.argewebhosting.eu,0,0.00%,8,8,0.00%
ns2.green-internet.net,0,0.00%,2,2,0.00%
ns3.webgo.de,0,0.00%,4,4,0.00%
ns2.sitesdepot.com,0,0.00%,4,4,0.00%
api.boxcryptor.com,0,0.00%,10,10,0.00%
nsid3.rumahweb.biz,0,0.00%,14,14,0.00%
dns1.p07.nsone.net,0,0.00%,36,36,0.00%
ns2.netx.com.ua,0,0.00%,4,4,0.00%
corey.ns.cloudflare.com,0,0.00%,4,4,0.00%
ns2.nindohost.net,0,0.00%,4,4,0.00%
ns180.seeoux.com,0,0.00%,4,4,0.00%
ns28.netkl.com,0,0.00%,6,6,0.00%
mark.dnspod.net,0,0.00%,4,4,0.00%
ns1.nindohost.net,0,0.00%,4,4,0.00%
ns02.trademarkarea.com,0,0.00%,2,2,0.00%
beloved-accessory.com,0,0.00%,2,2,0.00%
ns3.nindohost.net,0,0.00%,4,4,0.00%
tanner.ns.cloudflare.com,0,0.00%,14,14,0.00%
mary.ns.cloudflare.com,0,0.00%,12,12,0.00%
ns03.trademarkarea.com,0,0.00%,2,2,0.00%
door.dnspod.net,0,0.00%,4,4,0.00%
ns1.weblium.com,0,0.00%,2,2,0.00%
ns4.nindohost.net,0,0.00%,4,4,0.00%
ns1066.ui-dns.org,0,0.00%,10,10,0.00%
ns01.trademarkarea.com,0,0.00%,2,2,0.00%
khoa805853.mars.orderbox-dns.com,0,0.00%,2,2,0.00%
ns-2022.awsdns-60.co.uk,0,0.00%,2,2,0.00%
ns2.weblium.com,0,0.00%,2,2,0.00%
ns241.mihanwebhost.com,0,0.00%,4,4,0.00%
arnold.ns.cloudflare.com,0,0.00%,10,10,0.00%
ns1074.ui-dns.de,0,0.00%,4,4,0.00%
ns-1250.awsdns-28.org,0,0.00%,4,4,0.00%
khoa805853.venus.orderbox-dns.com,0,0.00%,2,2,0.00%
ns4.weblium.com,0,0.00%,2,2,0.00%
derek.ns.cloudflare.com,0,0.00%,2,2,0.00%
ns1061.ui-dns.biz,0,0.00%,4,4,0.00%
ns4.dinahosting.com,0,0.00%,2,2,0.00%
ns-1889.awsdns-44.co.uk,0,0.00%,2,2,0.00%
ns1070.ui-dns.com,0,0.00%,2,2,0.00%
ns3.weblium.com,0,0.00%,2,2,0.00%
ns1115.ui-dns.com,0,0.00%,6,6,0.00%
ns-466.awsdns-58.com,0,0.00%,2,2,0.00%
ns3.systemdns.com,0,0.00%,38,38,0.00%
tess.ns.cloudflare.com,0,0.00%,6,6,0.00%
khoa805853.earth.orderbox-dns.com,0,0.00%,2,2,0.00%
dc1-pp.ksn.kaspersky-labs.com,0,0.00%,2,2,0.00%
ns-537.awsdns-03.net,0,0.00%,2,2,0.00%
ns2.turkticaret.net,0,0.00%,12,12,0.00%
ns-1448.awsdns-53.org,0,0.00%,4,4,0.00%
ns1095.ui-dns.org,0,0.00%,4,4,0.00%
ns1089.ui-dns.biz,0,0.00%,4,4,0.00%
ns-1874.awsdns-42.co.uk,0,0.00%,2,2,0.00%
ns-a.dns.yourhosting.nl,0,0.00%,6,6,0.00%
ns-887.awsdns-46.net,0,0.00%,2,2,0.00%
ns2.sybell.hu,0,0.00%,2,2,0.00%
ns1.dipantau.id,0,0.00%,2,2,0.00%
ns-92.awsdns-11.com,0,0.00%,8,8,0.00%
cns4002.hostgator.in,0,0.00%,2,2,0.00%
ns2.dipantau.id,0,0.00%,2,2,0.00%
bensegseguranca.com,0,0.00%,2,2,0.00%
ns3.bigcommerce.com,0,0.00%,6,6,0.00%
ns1081.ui-dns.com,0,0.00%,4,4,0.00%
hera.ns.cloudflare.com,0,0.00%,2,2,0.00%
ns13.mehrhost.com,0,0.00%,2,2,0.00%
ns1.bigcommerce.com,0,0.00%,6,6,0.00%
ns1.sybell.hu,0,0.00%,2,2,0.00%
ns2.bigcommerce.com,0,0.00%,6,6,0.00%
ns1.itnuthosting.com,0,0.00%,2,2,0.00%
dns3.talahost.com,0,0.00%,4,4,0.00%
ns1.o2switch.net,0,0.00%,30,30,0.00%
ns-252.awsdns-31.com,0,0.00%,2,2,0.00%
2-nest.njalla.ma,0,0.00%,2,2,0.00%
ns3.netregistry.net,0,0.00%,8,8,0.00%
ns2.o2switch.net,0,0.00%,30,30,0.00%
twenty.dnspod.net,0,0.00%,2,2,0.00%
ns21.migracem.com,0,0.00%,2,2,0.00%
ns.ssandomain.com,0,0.00%,2,2,0.00%
cellist.dnspod.net,0,0.00%,2,2,0.00%
ns2.ssandomain.com,0,0.00%,2,2,0.00%
aida.ns.cloudflare.com,0,0.00%,12,12,0.00%
ns1.name.com,0,0.00%,2,2,0.00%
clint.ns.cloudflare.com,0,0.00%,6,6,0.00%
ns-1609.awsdns-09.co.uk,0,0.00%,6,6,0.00%
ns5.sitesepeti.com,0,0.00%,2,2,0.00%
ns2.name.com,0,0.00%,2,2,0.00%
rush.easydns.com,0,0.00%,4,4,0.00%
ns3.brandshelter.info,0,0.00%,12,12,0.00%
ns1.jp5.fcomet.com,0,0.00%,4,4,0.00%
ns7.sitesepeti.com,0,0.00%,2,2,0.00%
ns3.name.com,0,0.00%,2,2,0.00%
1-ceci.njalla.do,0,0.00%,4,4,0.00%
dns4.talahost.com,0,0.00%,4,4,0.00%
motorhead.easydns.org,0,0.00%,4,4,0.00%
wilson.ns.cloudflare.com,0,0.00%,2,2,0.00%
sns1.nsgodo.com,0,0.00%,4,4,0.00%
3-pas.njalla.in,0,0.00%,6,6,0.00%
zone-iix3.cmhoster.com,0,0.00%,2,2,0.00%
nirvana.easydns.net,0,0.00%,4,4,0.00%
agustin.ns.cloudflare.com,0,0.00%,8,8,0.00%
dns02.muumuu-domain.com,0,0.00%,48,48,0.00%
www.comodo.com,0,0.00%,2,2,0.00%
sns2.nsgodo.com,0,0.00%,4,4,0.00%
ns1103.ui-dns.com,0,0.00%,12,12,0.00%
dns17.hichina.com,0,0.00%,20,20,0.00%
nolan.ns.cloudflare.com,0,0.00%,4,4,0.00%
dns3.p04.nsone.net,0,0.00%,30,30,0.00%
dns18.hichina.com,0,0.00%,22,22,0.00%
ns1.alastyr.com,0,0.00%,6,6,0.00%
dns2.talahost.com,0,0.00%,4,4,0.00%
dns7.cloudns.net,0,0.00%,2,2,0.00%
ns321.mihanwebhost.com,0,0.00%,2,2,0.00%
ns261.hostgator.com.br,0,0.00%,2,2,0.00%
damien.ns.cloudflare.com,0,0.00%,6,6,0.00%
dns2.hostingcentar.com,0,0.00%,2,2,0.00%
matt.ns.cloudflare.com,0,0.00%,6,6,0.00%
ns260.hostgator.com.br,0,0.00%,2,2,0.00%
dns238.a.register.com,0,0.00%,2,2,0.00%
ns2.bcocenter.com,0,0.00%,2,2,0.00%
ns-1068.awsdns-05.org,0,0.00%,2,2,0.00%
ns1.eurodns.com,0,0.00%,12,12,0.00%
sloan.ns.cloudflare.com,0,0.00%,6,6,0.00%
kyrie.ns.cloudflare.com,0,0.00%,2,2,0.00%
ignacio.ns.cloudflare.com,0,0.00%,2,2,0.00%
joel.ns.cloudflare.com,0,0.00%,2,2,0.00%
dns051.b.register.com,0,0.00%,6,6,0.00%
ns2.eurodns.com,0,0.00%,12,12,0.00%
ns-216.awsdns-27.com,0,0.00%,2,2,0.00%
ns2.tik-takbiz.co.il,0,0.00%,2,2,0.00%
dns223.c.register.com,0,0.00%,10,10,0.00%
ns1.hostiservices.com,0,0.00%,2,2,0.00%
shahin1042.limoo.host,0,0.00%,2,2,0.00%
ns2.hosting.com.tr,0,0.00%,2,2,0.00%
dns1.talahost.com,0,0.00%,4,4,0.00%
ns1.bcocenter.com,0,0.00%,2,2,0.00%
indri.ezoicns.com,0,0.00%,2,2,0.00%
ns4.eurodns.com,0,0.00%,12,12,0.00%
dns1.hostingcentar.com,0,0.00%,2,2,0.00%
uriah.ns.cloudflare.com,0,0.00%,4,4,0.00%
ns2.spaceweb.ru,0,0.00%,6,6,0.00%
ns3sxz.name.com,0,0.00%,6,6,0.00%
ns1.789-lady.online,0,0.00%,2,2,0.00%
ns3fgq.name.com,0,0.00%,6,6,0.00%
ns2.syd6.hostingplatform.net.au,0,0.00%,4,4,0.00%
dns13.hichina.com,0,0.00%,28,28,0.00%
ns43.worldnic.com,0,0.00%,2,2,0.00%
ns5.byet.org,0,0.00%,2,2,0.00%
ns44.worldnic.com,0,0.00%,2,2,0.00%
dns14.hichina.com,0,0.00%,28,28,0.00%
ns117.inhostedns.com,0,0.00%,6,6,0.00%
i.ns.arvancdn.com,0,0.00%,6,6,0.00%
ns116.inhostedns.com,0,0.00%,12,12,0.00%
ns2.ace-k-q-nnnjp.com,0,0.00%,28,28,0.00%
ns32.inhostedns.org,0,0.00%,2,2,0.00%
ns1.bitcoin-dns.com,0,0.00%,6,6,0.00%
dns3.hichina.com,0,0.00%,34,34,0.00%
ns1.spaceweb.ru,0,0.00%,4,4,0.00%
verification-45e58646.ns3.dan.hosting,0,0.00%,2,2,0.00%
ns216.inhostedns.net,0,0.00%,14,14,0.00%
ns1.byet.org,0,0.00%,2,2,0.00%
janet.ns.cloudflare.com,0,0.00%,4,4,0.00%
ns217.inhostedns.net,0,0.00%,6,6,0.00%
ns3.byet.org,0,0.00%,2,2,0.00%
ns316.inhostedns.org,0,0.00%,12,12,0.00%
b4bf120.pg.gladns.com,0,0.00%,2,2,0.00%
b4bf120.pe.gladns.com,0,0.00%,2,2,0.00%
b4bf120.v6.gladns.com,0,0.00%,2,2,0.00%
b4bf120.v8.gladns.com,0,0.00%,2,2,0.00%
b4bf120.v5.gladns.com,0,0.00%,2,2,0.00%
ns2.epizy.com,0,0.00%,2,2,0.00%
ns1.codeshaolin.in,0,0.00%,2,2,0.00%
ns1cnb.name.com,0,0.00%,44,44,0.00%
ns2.codeshaolin.in,0,0.00%,2,2,0.00%
cesar.ns.cloudflare.com,0,0.00%,2,2,0.00%
ns1.789lady.online,0,0.00%,2,2,0.00%
ns4.teknosos.com,0,0.00%,4,4,0.00%
ns317.inhostedns.org,0,0.00%,6,6,0.00%
ns2.789-lady.online,0,0.00%,2,2,0.00%
ns2.789lady.online,0,0.00%,2,2,0.00%
ns2.byet.org,0,0.00%,2,2,0.00%
ns3.teknosos.com,0,0.00%,4,4,0.00%
abdullahhamdan.online,0,0.00%,2,2,0.00%
ns2fln.name.com,0,0.00%,4,4,0.00%
ns4bht.name.com,0,0.00%,6,6,0.00%
ns3.spaceweb.pro,0,0.00%,6,6,0.00%
ns2ckr.name.com,0,0.00%,20,20,0.00%
token.services.mozilla.com,0,0.00%,3,3,0.00%
www.xicidaili.com,0,0.00%,14,14,0.00%
addysearch.online,0,0.00%,2,2,0.00%
ns-1136.awsdns-14.org,0,0.00%,2,2,0.00%
ns39.worldnic.com,0,0.00%,6,6,0.00%
hazel.ns.cloudflare.com,0,0.00%,6,6,0.00%
dns2.freehostia.com,0,0.00%,2,2,0.00%
ns78.worldnic.com,0,0.00%,4,4,0.00%
quentin.ns.cloudflare.com,0,0.00%,10,10,0.00%
dns1.freehostia.com,0,0.00%,2,2,0.00%
lucy.ns.cloudflare.com,0,0.00%,10,10,0.00%
ns33.domaincontrol.com,0,0.00%,4,4,0.00%
francocarballar.github.io,0,0.00%,2,2,0.00%
ns1060.ui-dns.biz,0,0.00%,4,4,0.00%
ns1.sagaming88.online,0,0.00%,2,2,0.00%
webquoteklinepic.eastmoney.com,0,0.00%,6,6,0.00%
ns1.secureparkme.com,0,0.00%,6,6,0.00%
airplane.dnspod.net,0,0.00%,2,2,0.00%
ns3.zomro.com,0,0.00%,2,2,0.00%
function.dnspod.net,0,0.00%,2,2,0.00%
ns5.kasserver.com,0,0.00%,32,32,0.00%
ns18.inhostedns.com,0,0.00%,4,4,0.00%
ns1.zomro.net,0,0.00%,2,2,0.00%
ns6.kasserver.com,0,0.00%,32,32,0.00%
ns-74-b.gandi.net,0,0.00%,2,2,0.00%
ns2.zomro.ru,0,0.00%,2,2,0.00%
ns1102.ui-dns.de,0,0.00%,4,4,0.00%
ns60.worldnic.com,0,0.00%,4,4,0.00%
ns-83-a.gandi.net,0,0.00%,2,2,0.00%
ns4.zomro.su,0,0.00%,2,2,0.00%
ns2.secureparkme.com,0,0.00%,4,4,0.00%
ns-49-b.gandi.net,0,0.00%,2,2,0.00%
ns1022.ui-dns.com,0,0.00%,4,4,0.00%
ns2.hosting.de,0,0.00%,8,8,0.00%
pola.ns.cloudflare.com,0,0.00%,2,2,0.00%
ns28.inhostedns.net,0,0.00%,4,4,0.00%
kolkataffresult.online,0,0.00%,2,2,0.00%
ns-40-c.gandi.net,0,0.00%,2,2,0.00%
brenna.ns.cloudflare.com,0,0.00%,10,10,0.00%
ns2.netim.net,0,0.00%,12,12,0.00%
nsb.whogohost.com,0,0.00%,12,12,0.00%
fwd4.dns.ws,0,0.00%,6,6,0.00%
dns053.b.register.com,0,0.00%,2,2,0.00%
ns1.floripa.servidor.net.br,0,0.00%,2,2,0.00%
jeff.ns.cloudflare.com,0,0.00%,16,16,0.00%
fwd2.dns.ws,0,0.00%,6,6,0.00%
ns2.floripa.servidor.net.br,0,0.00%,2,2,0.00%
fwd1.dns.ws,0,0.00%,6,6,0.00%
ns1.hostdserver.com,0,0.00%,2,2,0.00%
sandra.ns.cloudflare.com,0,0.00%,12,12,0.00%
harmony.ns.cloudflare.com,0,0.00%,2,2,0.00%
ns38.inhostedns.org,0,0.00%,4,4,0.00%
fwd3.dns.ws,0,0.00%,6,6,0.00%
novalee.ns.cloudflare.com,0,0.00%,4,4,0.00%
ns1019.ui-dns.org,0,0.00%,4,4,0.00%
chelsea.ns.cloudflare.com,0,0.00%,14,14,0.00%
92.push2his.eastmoney.com,0,0.00%,6,6,0.00%
harvey.ns.cloudflare.com,0,0.00%,4,4,0.00%
ns2.rsncache.net,0,0.00%,2,2,0.00%
ns4.azdigi.com,0,0.00%,6,6,0.00%
ns2.enter-system.com,0,0.00%,10,10,0.00%
ns2.hostdserver.com,0,0.00%,2,2,0.00%
ns1116.ui-dns.biz,0,0.00%,6,6,0.00%
auriga.dnspod.net,0,0.00%,8,8,0.00%
blakely.ns.cloudflare.com,0,0.00%,2,2,0.00%
emerson.ns.cloudflare.com,0,0.00%,4,4,0.00%
chloe.ns.cloudflare.com,0,0.00%,6,6,0.00%
nsr2.domeny.com,0,0.00%,6,6,0.00%
nsr3.domeny.com,0,0.00%,6,6,0.00%
ns3jnr.name.com,0,0.00%,4,4,0.00%
nsr4.domeny.com,0,0.00%,6,6,0.00%
ns4blx.name.com,0,0.00%,4,4,0.00%
cruz.ns.cloudflare.com,0,0.00%,6,6,0.00%
ns3.cyberfolks.pl,0,0.00%,4,4,0.00%
verification-3f308ab4.ns3.dan.hosting,0,0.00%,8,8,0.00%
19.push2his.eastmoney.com,0,0.00%,2,2,0.00%
23.push2his.eastmoney.com,0,0.00%,2,2,0.00%
ns2.cyberfolks.pl,0,0.00%,4,4,0.00%
ns1.cyberfolks.pl,0,0.00%,4,4,0.00%
tess.dnspod.net,0,0.00%,4,4,0.00%
47.push2his.eastmoney.com,0,0.00%,2,2,0.00%
57.push2his.eastmoney.com,0,0.00%,2,2,0.00%
29.push2his.eastmoney.com,0,0.00%,6,6,0.00%
58.push2his.eastmoney.com,0,0.00%,2,2,0.00%
qb-extension.firebaseio.com,0,0.00%,23,23,0.00%
365-products.online,0,0.00%,1,1,0.00%
89.push2his.eastmoney.com,0,0.00%,4,4,0.00%
65.push2his.eastmoney.com,0,0.00%,2,2,0.00%
ns1.oray.net,0,0.00%,4,4,0.00%
dns2.markum.net,0,0.00%,10,10,0.00%
dns25.hichina.com,0,0.00%,34,34,0.00%
izabella.ns.cloudflare.com,0,0.00%,6,6,0.00%
ns-1734.awsdns-24.co.uk,0,0.00%,2,2,0.00%
mia.ns.cloudflare.com,0,0.00%,6,6,0.00%
ns1.aftermarket.pl,0,0.00%,12,12,0.00%
dns1.bigrock.in,0,0.00%,4,4,0.00%
mirror.dnspod.net,0,0.00%,2,2,0.00%
ns4-cloud.nic.ru,0,0.00%,2,2,0.00%
fast.dnspod.net,0,0.00%,2,2,0.00%
ns1123.ui-dns.de,0,0.00%,8,8,0.00%
a.ezdnscenter.com,0,0.00%,14,14,0.00%
ns-145-c.gandi.net,0,0.00%,2,2,0.00%
dns206.b.register.com,0,0.00%,16,16,0.00%
dylan.ns.cloudflare.com,0,0.00%,2,2,0.00%
ns1036.ui-dns.com,0,0.00%,10,10,0.00%
ns3dkz.name.com,0,0.00%,10,10,0.00%
ns8-l2.nic.ru,0,0.00%,2,2,0.00%
push.hicloud.com,0,0.00%,16,16,0.00%
ns3.epik.com,0,0.00%,48,48,0.00%
ns65.worldnic.com,0,0.00%,4,4,0.00%
dns2.3dcart.com,0,0.00%,4,4,0.00%
ns02.cashparking.com,0,0.00%,14,14,0.00%
ns-5-a.gandi.net,0,0.00%,2,2,0.00%
ns1024.ui-dns.org,0,0.00%,8,8,0.00%
ns2.stackdns.com,0,0.00%,32,32,0.00%
ns66.worldnic.com,0,0.00%,4,4,0.00%
ns1083.ui-dns.biz,0,0.00%,6,6,0.00%
ns8-cloud.nic.ru,0,0.00%,2,2,0.00%
ns8.worldnic.com,0,0.00%,2,2,0.00%
ns25.worldnic.com,0,0.00%,4,4,0.00%
elle.ns.cloudflare.com,0,0.00%,4,4,0.00%
ns2.sexygaming168.network,0,0.00%,2,2,0.00%
ns8.alidns.com,0,0.00%,18,18,0.00%
pdns09.domaincontrol.com,0,0.00%,16,16,0.00%
ns1044.ui-dns.org,0,0.00%,6,6,0.00%
ns7.worldnic.com,0,0.00%,2,2,0.00%
ns4.spaceweb.pro,0,0.00%,4,4,0.00%
ns100.worldnic.com,0,0.00%,2,2,0.00%
ns1111.ui-dns.org,0,0.00%,2,2,0.00%
mona.ns.cloudflare.com,0,0.00%,4,4,0.00%
ns-250-b.gandi.net,0,0.00%,2,2,0.00%
kenia.ns.cloudflare.com,0,0.00%,2,2,0.00%
ganz.ns.cloudflare.com,0,0.00%,10,10,0.00%
june.ns.cloudflare.com,0,0.00%,12,12,0.00%
malcolm.ns.cloudflare.com,0,0.00%,2,2,0.00%
kai.ns.cloudflare.com,0,0.00%,10,10,0.00%
ns-1292.awsdns-33.org,0,0.00%,2,2,0.00%
ns1.sexygaming168.network,0,0.00%,2,2,0.00%
ns5.chosting.dk,0,0.00%,2,2,0.00%
martha.ns.cloudflare.com,0,0.00%,2,2,0.00%
peyton.ns.cloudflare.com,0,0.00%,4,4,0.00%
ns2.softgamings.network,0,0.00%,2,2,0.00%
monroe.ns.cloudflare.com,0,0.00%,4,4,0.00%
ns7.alidns.com,0,0.00%,20,20,0.00%
ns4-l2.nic.ru,0,0.00%,2,2,0.00%
pet-oasis.net,0,0.00%,2,2,0.00%
v0n0.nic.news,0,0.00%,10,10,0.00%
ns-276.awsdns-34.com,0,0.00%,2,2,0.00%
ns1.softgamings.network,0,0.00%,2,2,0.00%
dns2.p07.nsone.net,0,0.00%,32,32,0.00%
ns2.sexygamingvip.network,0,0.00%,2,2,0.00%
ns1056.ui-dns.com,0,0.00%,2,2,0.00%
ns6.chosting.dk,0,0.00%,2,2,0.00%
static-3.no-ip.com,0,0.00%,4,4,0.00%
dns3.p07.nsone.net,0,0.00%,32,32,0.00%
luke.ns.cloudflare.com,0,0.00%,4,4,0.00%
ns2.simorgh.dev,0,0.00%,1,1,0.00%
ns1.bh-47.webhostbox.net,0,0.00%,4,4,0.00%
ns3-l2.nic.ru,0,0.00%,2,2,0.00%
ns26.worldnic.com,0,0.00%,2,2,0.00%
skip.ns.cloudflare.com,0,0.00%,2,2,0.00%
ns1.stackdns.com,0,0.00%,32,32,0.00%
ns-655.awsdns-17.net,0,0.00%,4,4,0.00%
ns2.bh-47.webhostbox.net,0,0.00%,4,4,0.00%
dns4.hichina.com,0,0.00%,28,28,0.00%
ns185149112227.a2dns.com,0,0.00%,2,2,0.00%
ns3.stackdns.com,0,0.00%,34,34,0.00%
ns3flt.name.com,0,0.00%,12,12,0.00%
lamar.ns.cloudflare.com,0,0.00%,2,2,0.00%
ns6032.hostgator.com,0,0.00%,2,2,0.00%
ns1.syrahost.com,0,0.00%,2,2,0.00%
cass.ns.cloudflare.com,0,0.00%,6,6,0.00%
ns6031.hostgator.com,0,0.00%,2,2,0.00%
ns1.boxsecured.com,0,0.00%,4,4,0.00%
ns4fmw.name.com,0,0.00%,6,6,0.00%
ns1.freehosting.com,0,0.00%,4,4,0.00%
ns2.syrahost.com,0,0.00%,2,2,0.00%
v0n0.nic.ninja,0,0.00%,4,4,0.00%
ns1kwy.name.com,0,0.00%,4,4,0.00%
ns1.simorgh.dev,0,0.00%,1,1,0.00%
cpsfixone.iphoster.net,0,0.00%,2,2,0.00%
enid.dnspod.net,0,0.00%,2,2,0.00%
ns2.boxsecured.com,0,0.00%,4,4,0.00%
ns1.enter-system.com,0,0.00%,10,10,0.00%
jeremy.ns.cloudflare.com,0,0.00%,8,8,0.00%
dion.ns.cloudflare.com,0,0.00%,6,6,0.00%
wally.ns.cloudflare.com,0,0.00%,10,10,0.00%
ns3.netim.net,0,0.00%,10,10,0.00%
ns4kmw.name.com,0,0.00%,4,4,0.00%
nsid1.rumahweb.com,0,0.00%,16,16,0.00%
a0.nic.ong,0,0.00%,2,2,0.00%
ns1107.ui-dns.org,0,0.00%,2,2,0.00%
meg.ns.cloudflare.com,0,0.00%,6,6,0.00%
ns1.netim.net,0,0.00%,12,12,0.00%
ns1.serverhost.name,0,0.00%,2,2,0.00%
bethany.ns.cloudflare.com,0,0.00%,4,4,0.00%
ns3dgj.name.com,0,0.00%,4,4,0.00%
ns1100.ui-dns.com,0,0.00%,2,2,0.00%
ns2.simply.com,0,0.00%,14,14,0.00%
sue.ns.cloudflare.com,0,0.00%,4,4,0.00%
ns2.ufas.online,0,0.00%,2,2,0.00%
cleo.ns.cloudflare.com,0,0.00%,4,4,0.00%
ns1.hosting.de,0,0.00%,8,8,0.00%
noor.ns.cloudflare.com,0,0.00%,6,6,0.00%
keaton.ns.cloudflare.com,0,0.00%,2,2,0.00%
ns1.ufas.online,0,0.00%,2,2,0.00%
ns1100.ui-dns.de,0,0.00%,2,2,0.00%
NS3.IRANDNS.COM,0,0.00%,2,2,0.00%
serenity.ns.cloudflare.com,0,0.00%,4,4,0.00%
hostingdynamo.earth.orderbox-dns.com,0,0.00%,2,2,0.00%
ns5.be,0,0.00%,6,6,0.00%
ns1.webhostingserver.nl,0,0.00%,2,2,0.00%
ns23.dutaspace.com,0,0.00%,2,2,0.00%
ns1.haberpaketleri.com,0,0.00%,2,2,0.00%
europe-62.banahosting.com,0,0.00%,2,2,0.00%
ns1041.ui-dns.biz,0,0.00%,2,2,0.00%
mydrugs.online,0,0.00%,2,2,0.00%
ns13.hawkhost.com,0,0.00%,4,4,0.00%
triangle.onl,0,0.00%,2,2,0.00%
juniper.dnspod.net,0,0.00%,2,2,0.00%
ns7.diyahost.COM,0,0.00%,2,2,0.00%
ns1.newtronics.eu,0,0.00%,2,2,0.00%
ns3.webhostingserver.nl,0,0.00%,2,2,0.00%
ns8.diyahost.COM,0,0.00%,2,2,0.00%
ns.idiom.us,0,0.00%,2,2,0.00%
ns01.cashparking.com,0,0.00%,14,14,0.00%
ns3.inet.vn,0,0.00%,6,6,0.00%
ns2.newtronics.eu,0,0.00%,2,2,0.00%
ns2.webhostingserver.nl,0,0.00%,2,2,0.00%
dns2.bluehost.com,0,0.00%,4,4,0.00%
ns3.tino.org,0,0.00%,6,6,0.00%
ns2.frienddns.info,0,0.00%,2,2,0.00%
ns151.talahost.com,0,0.00%,2,2,0.00%
ns1.rsncache.net,0,0.00%,2,2,0.00%
u1.hoster.by,0,0.00%,2,2,0.00%
ns4.frienddns.net,0,0.00%,2,2,0.00%
lilyana.ns.cloudflare.com,0,0.00%,2,2,0.00%
packages.microsoft.com,0,0.00%,4,4,0.00%
dns1.oderland.com,0,0.00%,2,2,0.00%
ns150.talahost.com,0,0.00%,2,2,0.00%
dns3.oderland.com,0,0.00%,2,2,0.00%
dns2.oderland.com,0,0.00%,2,2,0.00%
helpkprotect1.ksmobile.com,0,0.00%,2,2,0.00%
blob.dsm08prdstr03a.store.core.windows.NET,0,0.00%,2,2,0.00%
ns4.secureparkme.com,0,0.00%,2,2,0.00%
vasilii.ns.cloudflare.com,0,0.00%,10,10,0.00%
ns1051.hostgator.com.br,0,0.00%,2,2,0.00%
dns2.domainesia.com,0,0.00%,6,6,0.00%
ns2.mojsite.com,0,0.00%,2,2,0.00%
dns1.domainesia.com,0,0.00%,6,6,0.00%
dns3.domainesia.com,0,0.00%,6,6,0.00%
ns3.nsentry.de,0,0.00%,2,2,0.00%
dns4.domainesia.com,0,0.00%,6,6,0.00%
ns3.dominios.uol.com.br,0,0.00%,20,20,0.00%
ns-1863.awsdns-40.co.uk,0,0.00%,2,2,0.00%
ns1.mojsite.com,0,0.00%,2,2,0.00%
miles.ns.cloudflare.com,0,0.00%,4,4,0.00%
pdns10.domaincontrol.com,0,0.00%,16,16,0.00%
ns-30.awsdns-03.com,0,0.00%,4,4,0.00%
ns-628.awsdns-14.net,0,0.00%,2,2,0.00%
ns4.nsentry.de,0,0.00%,2,2,0.00%
dns29.hichina.com,0,0.00%,30,30,0.00%
ns2.virtono.com,0,0.00%,4,4,0.00%
win4.navicosoft.com,0,0.00%,2,2,0.00%
ns14.truehostdns.com,0,0.00%,2,2,0.00%
ns1.idwebhost.com,0,0.00%,14,14,0.00%
win3.navicosoft.com,0,0.00%,2,2,0.00%
ns33.creativeon.net,0,0.00%,2,2,0.00%
ns2.idwebhost.com,0,0.00%,14,14,0.00%
ns34.creativeon.net,0,0.00%,2,2,0.00%
ns1dhl.name.com,0,0.00%,2,2,0.00%
ns2dqx.name.com,0,0.00%,10,10,0.00%
ns3cpr.name.com,0,0.00%,2,2,0.00%
ns4ksy.name.com,0,0.00%,8,8,0.00%
dns3.smarthost.pl,0,0.00%,2,2,0.00%
vip2.zndns.com,0,0.00%,2,2,0.00%
vip1.zndns.com,0,0.00%,2,2,0.00%
dns.smarthost.pl,0,0.00%,2,2,0.00%
dns2.smarthost.pl,0,0.00%,2,2,0.00%
ns4.alastyr.com,0,0.00%,6,6,0.00%
ns1020.ui-dns.de,0,0.00%,2,2,0.00%
ns1077.ui-dns.org,0,0.00%,2,2,0.00%
verification-5zcc85ha.ns3.dan.hosting,0,0.00%,2,2,0.00%
tom.ns.cloudflare.com,0,0.00%,4,4,0.00%
ns3.secureparkme.com,0,0.00%,2,2,0.00%
ns15.shared-servers.com,0,0.00%,2,2,0.00%
66.push2his.eastmoney.com,0,0.00%,2,2,0.00%
queen.sugardns.net,0,0.00%,2,2,0.00%
ns4.hosting-server-1022.com,0,0.00%,2,2,0.00%
star.sugardns.net,0,0.00%,2,2,0.00%
earth.sugardns.net,0,0.00%,2,2,0.00%
ns16.shared-servers.com,0,0.00%,2,2,0.00%
rudy.ns.cloudflare.com,0,0.00%,4,4,0.00%
ns-1231.awsdns-25.org,0,0.00%,2,2,0.00%
sky.sugardns.net,0,0.00%,2,2,0.00%
ns-1570.awsdns-04.co.uk,0,0.00%,2,2,0.00%
ns2.azdigi.com,0,0.00%,2,2,0.00%
ns-449.awsdns-56.com,0,0.00%,4,4,0.00%
ginkgo.dnspod.net,0,0.00%,2,2,0.00%
ns3.hosting-server-1022.com,0,0.00%,2,2,0.00%
ns1.azdigi.com,0,0.00%,2,2,0.00%
ns-953.awsdns-55.net,0,0.00%,2,2,0.00%
yetta.dnspod.net,0,0.00%,2,2,0.00%
ns1.dotvndns.vn,0,0.00%,2,2,0.00%
lars.ns.cloudflare.com,0,0.00%,6,6,0.00%
nsbak.dotvndns.com,0,0.00%,2,2,0.00%
ns3.dotvndns.vn,0,0.00%,2,2,0.00%
dns4.bluehost.com,0,0.00%,4,4,0.00%
megan.ns.cloudflare.com,0,0.00%,14,14,0.00%
shades09.rzone.de,0,0.00%,2,2,0.00%
52.push2his.eastmoney.com,0,0.00%,4,4,0.00%
90.push2his.eastmoney.com,0,0.00%,2,2,0.00%
64.push2his.eastmoney.com,0,0.00%,6,6,0.00%
73.push2his.eastmoney.com,0,0.00%,4,4,0.00%
54.push2his.eastmoney.com,0,0.00%,4,4,0.00%
8.push2his.eastmoney.com,0,0.00%,2,2,0.00%
12.push2his.eastmoney.com,0,0.00%,4,4,0.00%
15.push2his.eastmoney.com,0,0.00%,4,4,0.00%
49.push2his.eastmoney.com,0,0.00%,4,4,0.00%
51.push2his.eastmoney.com,0,0.00%,2,2,0.00%
rscloud.rising.net.cn,0,0.00%,26,26,0.00%
golf.dnspod.net,0,0.00%,2,2,0.00%
ns4.p17.dynect.net,0,0.00%,2,2,0.00%
msginfo.rising.com.cn,0,0.00%,4,4,0.00%
ns2.p17.dynect.net,0,0.00%,2,2,0.00%
ns1.p17.dynect.net,0,0.00%,2,2,0.00%
ali.ns.cloudflare.com,0,0.00%,12,12,0.00%
ns1.a2hosting.com,0,0.00%,18,18,0.00%
ns3.p17.dynect.net,0,0.00%,2,2,0.00%
suagranaextra.com,0,0.00%,2,2,0.00%
dalary.ns.cloudflare.com,0,0.00%,4,4,0.00%
ns2.a2hosting.com,0,0.00%,18,18,0.00%
dns.4cun.com,0,0.00%,10,10,0.00%
rns23.webhostbox.net,0,0.00%,2,2,0.00%
ns1090.ui-dns.org,0,0.00%,10,10,0.00%
ns1026.ui-dns.com,0,0.00%,6,6,0.00%
belimitlessnutrition.com,0,0.00%,2,2,0.00%
ns1.catch.club,0,0.00%,6,6,0.00%
ns3.virtono.com,0,0.00%,4,4,0.00%
cody.ns.cloudflare.com,0,0.00%,8,8,0.00%
ns1092.ui-dns.com,0,0.00%,2,2,0.00%
marjory.ns.cloudflare.com,0,0.00%,6,6,0.00%
ns4.virtono.com,0,0.00%,4,4,0.00%
felicity.ns.cloudflare.com,0,0.00%,4,4,0.00%
teresa.ns.cloudflare.com,0,0.00%,2,2,0.00%
inference.location.live.net,0,0.00%,16,16,0.00%
dsm04pap002.storage.live.com,0,0.00%,4,4,0.00%
ds.kaspersky.com,0,0.00%,8,8,0.00%
ns20.dnsproviders.info,0,0.00%,2,2,0.00%
onedriveclucproddm20016.blob.core.windows.net,0,0.00%,2,2,0.00%
ns30.dnshubpro.com,0,0.00%,2,2,0.00%
ns40.dns2us.com,0,0.00%,2,2,0.00%
aarav.ns.cloudflare.com,0,0.00%,4,4,0.00%
ns72.websiteplex.com,0,0.00%,2,2,0.00%
ns1.hosting.co.kr,0,0.00%,18,18,0.00%
ny2.fivecron.com,0,0.00%,2,2,0.00%
dns2.cafe24.com,0,0.00%,2,2,0.00%
ny1.fivecron.com,0,0.00%,2,2,0.00%
dns2.cafe24.co.kr,0,0.00%,2,2,0.00%
ns3.g4w-nameserver.de,0,0.00%,2,2,0.00%
dns1.cafe24.co.kr,0,0.00%,2,2,0.00%
dns30.hichina.com,0,0.00%,26,26,0.00%
ns1.hotelcgr.com,0,0.00%,2,2,0.00%
ns6427.hostgator.com,0,0.00%,2,2,0.00%
verification-c7893359.ns3.dan.hosting,0,0.00%,2,2,0.00%
sonny.ns.cloudflare.com,0,0.00%,2,2,0.00%
dns1.cafe24.com,0,0.00%,2,2,0.00%
ns13.cloudns.net,0,0.00%,4,4,0.00%
walk.ns.cloudflare.com,0,0.00%,4,4,0.00%
ns2.hotelcgr.com,0,0.00%,2,2,0.00%
ns2.sofate.net,0,0.00%,2,2,0.00%
spectator.dnspod.net,0,0.00%,2,2,0.00%
ns2.g4w-nameserver.de,0,0.00%,2,2,0.00%
humphrey.dnspod.net,0,0.00%,2,2,0.00%
ns10.twhostdns.com,0,0.00%,2,2,0.00%
ns13.nationbuilder.com,0,0.00%,2,2,0.00%
ns1.sofate.net,0,0.00%,2,2,0.00%
ns09.twhostdns.com,0,0.00%,2,2,0.00%
ns4.g4w-nameserver.de,0,0.00%,2,2,0.00%
ns4.inleed.net,0,0.00%,2,2,0.00%
43-courier.push.apple.com,0,0.00%,14,14,0.00%
3.rlb.router.teamviewer.cn,0,0.00%,181,181,0.00%
clock.via.net,0,0.00%,22,22,0.00%
13-courier.push.apple.com,0,0.00%,19,19,0.00%
19-courier.push.apple.com,0,0.00%,14,14,0.00%
ntp.ntsc.ac.cn,0,0.00%,26,26,0.00%
accscdn.m.taobao.com,0,0.00%,8,8,0.00%
26-courier.push.apple.com,0,0.00%,17,17,0.00%
cdn.packages.deepin.com,0,0.00%,10,10,0.00%
tracker.hdsky.me,0,0.00%,6,6,0.00%
46-courier.push.apple.com,0,0.00%,14,14,0.00%
community-store-packages.deepin.com,0,0.00%,20,20,0.00%
5-courier.push.apple.com,0,0.00%,14,14,0.00%
weather2db.cmcm.com,0,0.00%,39,39,0.00%
9-courier.push.apple.com,0,0.00%,15,15,0.00%
via.cnode.xyz,0,0.00%,16,16,0.00%
18-courier.push.apple.com,0,0.00%,12,12,0.00%
25-courier.push.apple.com,0,0.00%,12,12,0.00%
32-courier.push.apple.com,0,0.00%,14,14,0.00%
dstore-metadata.deepin.cn,0,0.00%,10,10,0.00%
38-courier.push.apple.com,0,0.00%,10,10,0.00%
ios.ac.cn,0,0.00%,20,20,0.00%
45-courier.push.apple.com,0,0.00%,12,12,0.00%
api.appstore.deepin.org,0,0.00%,20,20,0.00%
4-courier.push.apple.com,0,0.00%,13,13,0.00%
cip.cc,0,0.00%,18,18,0.00%
prom-monitorproxy1.fastsdwan.com,0,0.00%,18,18,0.00%
11-courier.push.apple.com,0,0.00%,12,12,0.00%
17-courier.push.apple.com,0,0.00%,16,16,0.00%
open.tingjiandan.com,0,0.00%,3,3,0.00%
37-courier.push.apple.com,0,0.00%,13,13,0.00%
44-courier.push.apple.com,0,0.00%,13,13,0.00%
xred.mooo.com,0,0.00%,2,2,0.00%
50-courier.push.apple.com,0,0.00%,14,14,0.00%
3-courier.push.apple.com,0,0.00%,23,23,0.00%
7-courier.push.apple.com,0,0.00%,14,14,0.00%
ping.dgraph.io,0,0.00%,106,106,0.00%
16-courier.push.apple.com,0,0.00%,17,17,0.00%
20-courier.push.apple.com,0,0.00%,16,16,0.00%
23-courier.push.apple.com,0,0.00%,13,13,0.00%
30-courier.push.apple.com,0,0.00%,20,20,0.00%
36-courier.push.apple.com,0,0.00%,14,14,0.00%
49-courier.push.apple.com,0,0.00%,13,13,0.00%
2-courier.push.apple.com,0,0.00%,15,15,0.00%
wsus.f.360.cn,0,0.00%,19,19,0.00%
dns.console.aliyun.com,0,0.00%,2,2,0.00%
register.naas.huawei.com,0,0.00%,8,8,0.00%
15-courier.push.apple.com,0,0.00%,12,12,0.00%
22-courier.push.apple.com,0,0.00%,13,13,0.00%
35-courier.push.apple.com,0,0.00%,23,23,0.00%
48-courier.push.apple.com,0,0.00%,10,10,0.00%
14-courier.push.apple.com,0,0.00%,19,19,0.00%
41-courier.push.apple.com,0,0.00%,12,12,0.00%
config.app.yinxiang.com,0,0.00%,6,6,0.00%
29-courier.push.apple.com,0,0.00%,10,10,0.00%
common-afd.fe.1drv.com,0,0.00%,2,2,0.00%
odc-commonafd-geo.onedrive.akadns.net,0,0.00%,2,2,0.00%
odc-commonafd-brs.onedrive.akadns.net,0,0.00%,2,2,0.00%
l-0003.l-msedge.net,0,0.00%,14,14,0.00%
ct.duba.net,0,0.00%,17,17,0.00%
mm.ilovescholar.xyz,0,0.00%,4,4,0.00%
geo-applefinance-cache.internal.query.g03.yahoodns.net,0,0.00%,18,18,0.00%
jx.xinhuanet.com,0,0.00%,2,2,0.00%
cqxm2.home.news.cn,0,0.00%,2,2,0.00%
update.b.cqttech.com,0,0.00%,3,3,0.00%
tl1385.home.news.cn,0,0.00%,2,2,0.00%
metadata.packet.net,0,0.00%,2,2,0.00%
dsm01pap008.storage.live.com,0,0.00%,2,2,0.00%
onedriveclucproddm20042.blob.core.windows.net,0,0.00%,5,5,0.00%
data-api.similarsites.com,0,0.00%,3,3,0.00%
s.wanfangdata.com.cn,0,0.00%,2,2,0.00%
worldwide.sogou.com,0,0.00%,2,2,0.00%
oss.wanfangdata.com.cn,0,0.00%,2,2,0.00%
my.wanfangdata.com.cn,0,0.00%,2,2,0.00%
twgame06.graniterapids.com,0,0.00%,2,2,0.00%
web.p.qq.com,0,0.00%,6,6,0.00%
krgame03.graniterapids.com,0,0.00%,2,2,0.00%
w.deepl.com,0,0.00%,11,11,0.00%
docteamapi.wps.cn,0,0.00%,10,10,0.00%
account.sogou.com,0,0.00%,26,26,0.00%
pinyin.sogou.com,0,0.00%,10,10,0.00%
login.weixin.qq.com,0,0.00%,13,13,0.00%
f5-ck.zhhainiao.com,0,0.00%,61,61,0.00%
mres.ximalaya.com,0,0.00%,2,2,0.00%
pop3.iscas.ac.cn,0,0.00%,2,2,0.00%
mail.nfschina.com,0,0.00%,20,20,0.00%
w3.wild2home.ga,0,0.00%,1,1,0.00%
m0.mail.sina.com.cn,0,0.00%,8,8,0.00%
48afe871-i.andns.co,0,0.00%,10,10,0.00%
nfs.iscas.ac.cn,0,0.00%,9,9,0.00%
twct09.graniterapids.com,0,0.00%,1,1,0.00%
tracker.uw0.xyz,0,0.00%,21,21,0.00%
denis.stalker.upeer.me,0,0.00%,10,10,0.00%
atrack.pow7.com,0,0.00%,15,15,0.00%
tr.abirxo.cf,0,0.00%,38,38,0.00%
tracker.pow7.com,0,0.00%,12,12,0.00%
task.alibench.com,0,0.00%,4,4,0.00%
hp3.mail.netease.com,0,0.00%,36,36,0.00%
qbwup.imtt.qq.com,0,0.00%,33,33,0.00%
cevbnsq7.mirror.aliyuncs.com,0,0.00%,12,12,0.00%
tracker.tasvideos.org,0,0.00%,46,46,0.00%
t.overflow.biz,0,0.00%,31,31,0.00%
retracker.sevstar.net,0,0.00%,2,2,0.00%
api.cntv.cn,0,0.00%,6,6,0.00%
masters-tb.com,0,0.00%,3,3,0.00%
open.tracker.cl,0,0.00%,32,32,0.00%
sqm.telemetry.microsoft.com,0,0.00%,12,12,0.00%
ssl.mail.126.com,0,0.00%,2,2,0.00%
p205-caldav.icloud.com.cn,0,0.00%,2,2,0.00%
t1.pow7.com,0,0.00%,16,16,0.00%
bluebird-hd.org,0,0.00%,6,6,0.00%
au01.graniterapids.com,0,0.00%,2,2,0.00%
www.tribalmixes.com,0,0.00%,38,38,0.00%
btracker.top,0,0.00%,6,6,0.00%
home.yxgz.vip,0,0.00%,2,2,0.00%
tracker.foreverpirates.co,0,0.00%,20,20,0.00%
cntr.wps.cn,0,0.00%,20,20,0.00%
pc-plugin.wpscdn.cn,0,0.00%,39,39,0.00%
lbdata.tj.ijinshan.com,0,0.00%,6,6,0.00%
blackz.ro,0,0.00%,6,6,0.00%
tracker.m-team.cc,0,0.00%,4,4,0.00%
tracker.lilithraws.org,0,0.00%,2,2,0.00%
mermaid.ximalaya.com,0,0.00%,4,4,0.00%
ioav5-policy.ioa.tencent.com,0,0.00%,6,6,0.00%
ossapi.baidu.com,0,0.00%,10,10,0.00%
h4.trakx.nibba.trade,0,0.00%,11,11,0.00%
tracker.skyts.cn,0,0.00%,2,2,0.00%
open.acgtracker.com,0,0.00%,4,4,0.00%
intf-pc.iquicksee.com,0,0.00%,4,4,0.00%
jm.v2api.xyz,0,0.00%,20,20,0.00%
dashi.163.com,0,0.00%,8,8,0.00%
diskapi.n.shifen.com,0,0.00%,28,28,0.00%
ioav5-upload.ioa.tencent.com,0,0.00%,8,8,0.00%
update.client.163.com,0,0.00%,23,23,0.00%
hdwebv6.mail.split.netease.com,0,0.00%,8,8,0.00%
mam.netease.com,0,0.00%,29,29,0.00%
pnrt-stsdk.vivo.com.cn,0,0.00%,5,5,0.00%
azwus1-client-s.gateway.messenger.live.com,0,0.00%,8,8,0.00%
fanyi.youdao.com,0,0.00%,1,1,0.00%
v3-x.douyinvod.com.w.cdngslb.com,0,0.00%,1,1,0.00%
impression.aflink.com,0,0.00%,1,1,0.00%
www.badmintoncn.com,0,0.00%,1,1,0.00%
vku.youku.com,0,0.00%,1,1,0.00%
app.badmintoncn.com,0,0.00%,4,4,0.00%
ping-edge.smartscreen.microsoft.com,0,0.00%,33,33,0.00%
ifs.tanx.com,0,0.00%,5,5,0.00%
poplayer.template.alibaba.com,0,0.00%,1,1,0.00%
statusapi.micloud.xiaomi.net,0,0.00%,6,6,0.00%
sis.jpush.io,0,0.00%,11,11,0.00%
cm-10-33.getui.com,0,0.00%,1,1,0.00%
s.jpush.cn,0,0.00%,9,9,0.00%
easytomessage.com,0,0.00%,13,13,0.00%
dinamicx.alibabausercontent.com,0,0.00%,2,2,0.00%
dualstack-restsdk.amap.com,0,0.00%,1,1,0.00%
dualstack-mpsapi.amap.com,0,0.00%,5,5,0.00%
crash2.zhihu.com,0,0.00%,6,6,0.00%
ali-bj-pcdn-15.biliapi.net,0,0.00%,3,3,0.00%
cm-10-38.getui.com,0,0.00%,3,3,0.00%
vdn1.vzuu.com,0,0.00%,14,14,0.00%
vdn3.vzuu.com,0,0.00%,14,14,0.00%
httpdns.c.cdnhwc2.com,0,0.00%,20,20,0.00%
market.m.taobao.com,0,0.00%,1,1,0.00%
consul-kv.app.kdsec.org,0,0.00%,10,10,0.00%
api.basedata.union.longu.xyz,0,0.00%,103,103,0.00%
picasso.alicdn.com,0,0.00%,1,1,0.00%
dashenga.com,0,0.00%,3,3,0.00%
adsup.togothermany.cn,0,0.00%,1,1,0.00%
luna.avcdn.net,0,0.00%,2,2,0.00%
ynote-statistic.lx.netease.com,0,0.00%,2,2,0.00%
ai1.acciff.com,0,0.00%,11,11,0.00%
cdn.akamai.steamstatic.com,0,0.00%,2,2,0.00%
sub.ssr.ac,0,0.00%,5,5,0.00%
subserver.maying.io,0,0.00%,8,8,0.00%
smtp.nfschina.com,0,0.00%,4,4,0.00%
naixisubs.com,0,0.00%,10,10,0.00%
t.undefined-site.top,0,0.00%,7,7,0.00%
toblog.snssdk.com,0,0.00%,1,1,0.00%
apk.cdn.bleachcarnival.com,0,0.00%,1,1,0.00%
cs22.wpc.v0cdn.net,0,0.00%,5,5,0.00%
www.aliyun.com,0,0.00%,9,9,0.00%
center.bleachcarnival.com,0,0.00%,2,2,0.00%
data.bleachcarnival.com,0,0.00%,2,2,0.00%
a6f5288.pe.gladns.com,0,0.00%,6,6,0.00%
a6f5288.pb.gladns.com,0,0.00%,6,6,0.00%
a6f5288.ph.gladns.com,0,0.00%,6,6,0.00%
a6f5288.pd.gladns.com,0,0.00%,8,8,0.00%
a6f5288.pg.gladns.com,0,0.00%,4,4,0.00%
a6f5288.pa.gladns.com,0,0.00%,4,4,0.00%
a6f5288.pf.gladns.com,0,0.00%,4,4,0.00%
log.trackingio.com,0,0.00%,1,1,0.00%
star.xiaojukeji.com,0,0.00%,2,2,0.00%
cm-10-19.getui.com,0,0.00%,1,1,0.00%
gwp.xiaojukeji.com,0,0.00%,3,3,0.00%
motd.ubuntu.com,0,0.00%,7,7,0.00%
api.itechs.ac.cn,0,0.00%,4,4,0.00%
amonsul.douban.com,0,0.00%,6,6,0.00%
api.g.micloud.xiaomi.net,0,0.00%,6,6,0.00%
s19.cnzz.com,0,0.00%,4,4,0.00%
adscfg.togothermany.cn,0,0.00%,2,2,0.00%
catchdata.xiaojukeji.com,0,0.00%,2,2,0.00%
dls2.bigdata.samsung.com.cn,0,0.00%,6,6,0.00%
msgacs.youku.com,0,0.00%,6,6,0.00%
cn.app.chat.xiaomi.net,0,0.00%,2,2,0.00%
resolver.msg.xiaomi.net,0,0.00%,10,10,0.00%
az667904-pme.azureedge.net,0,0.00%,6,6,0.00%
qmzgh5-1251003022.file.myqcloud.com,0,0.00%,3,3,0.00%
osint.bambenekconsulting.com,0,0.00%,11,11,0.00%
seeds-open.xycdn.com.gslb.kuiniuca.com,0,0.00%,5,5,0.00%
lf-webcast-sourcecdn-tos.bytegecko.com,0,0.00%,1,1,0.00%
ipm-klca.kaspersky.com,0,0.00%,12,12,0.00%
static.deepl.com,0,0.00%,5,5,0.00%
s.deepl.com,0,0.00%,5,5,0.00%
oth.str.mdt.qq.com,0,0.00%,23,23,0.00%
u6.y.qq.com,0,0.00%,10,10,0.00%
www2.deepl.com,0,0.00%,2,2,0.00%
dict.deepl.com,0,0.00%,1,1,0.00%
dpubstatic.udache.com,0,0.00%,1,1,0.00%
sentry.deepl.com,0,0.00%,2,2,0.00%
grafana.net,0,0.00%,7,7,0.00%
cn-pek-ali-r009.router.teamviewer.cn,0,0.00%,14,14,0.00%
1912-ipv4e.clump.prod.aa-rt.sharepoint.com,0,0.00%,1,1,0.00%
soup.v.qq.com,0,0.00%,20,20,0.00%
skyapi.live.net,0,0.00%,13,13,0.00%
skyapi.policies.live.net,0,0.00%,1,1,0.00%
lv2sndwioabiaasw.hjspyto.cn,0,0.00%,6,6,0.00%
i4.c.eset.com,0,0.00%,2,2,0.00%
onedscolprdneu02.northeurope.cloudapp.azure.com,0,0.00%,4,4,0.00%
qmzgh5s4613.gameserver.youxigu.com,0,0.00%,2,2,0.00%
a.klaviyo.com,0,0.00%,2,2,0.00%
cloud.dell.com,0,0.00%,15,15,0.00%
shark.douyucdn.cn,0,0.00%,2,2,0.00%
www.google-analytics.com,0,0.00%,42,42,0.00%
gtm.quillbot.com,0,0.00%,4,4,0.00%
buy.itunes-apple.com.akadns.net,0,0.00%,11,11,0.00%
update.eset.com,0,0.00%,27,27,0.00%
j.clarity.ms,0,0.00%,1,1,0.00%
update.qnap.com,0,0.00%,3,3,0.00%
open.a.shifen.com,0,0.00%,1,1,0.00%
afd.baidu.com,0,0.00%,1,1,0.00%
pim.baidu.com,0,0.00%,1,1,0.00%
hmma.e.shifen.com,0,0.00%,1,1,0.00%
list.z.qingting.fm,0,0.00%,1,1,0.00%
pimlog.baidu.com,0,0.00%,1,1,0.00%
vipauth.hpplay.cn,0,0.00%,3,3,0.00%
logu.hpplay.cn,0,0.00%,1,1,0.00%
ssdkauth.hpplay.cn,0,0.00%,5,5,0.00%
rp.hpplay.cn,0,0.00%,2,2,0.00%
panpic.baidu.com,0,0.00%,1,1,0.00%
filehouse.zhhainiao.com,0,0.00%,21,21,0.00%
e44ee7b.pa.gladns.com,0,0.00%,2,2,0.00%
e44ee7b.ph.gladns.com,0,0.00%,2,2,0.00%
storage.live.com,0,0.00%,13,13,0.00%
m.analytics.126.net,0,0.00%,2,2,0.00%
www2.bing.com,0,0.00%,16,16,0.00%
static.zhihu.com,0,0.00%,21,21,0.00%
sugar.zhihu.com,0,0.00%,25,25,0.00%
compiles.overleaf.com,0,0.00%,16,16,0.00%
cn6.gmdns.net,0,0.00%,6,6,0.00%
jp3.gmdns.net,0,0.00%,6,6,0.00%
gb.gmdns.net,0,0.00%,6,6,0.00%
in1.gmdns.net,0,0.00%,6,6,0.00%
jp1.gmdns.net,0,0.00%,6,6,0.00%
tw1ssltide.gmdns.net,0,0.00%,3,3,0.00%
in2.gmdns.net,0,0.00%,4,4,0.00%
tw2.gmdns.net,0,0.00%,3,3,0.00%
us3.gmdns.net,0,0.00%,3,3,0.00%
sg1.gmdns.net,0,0.00%,6,6,0.00%
ss.wlmnzf.xyz,0,0.00%,3,3,0.00%
apida.net,0,0.00%,6,6,0.00%
api-takumi.mihoyo.com,0,0.00%,2,2,0.00%
s-usc1b-nss-2163.firebaseio.com,0,0.00%,2,2,0.00%
sdk1xyajs.data.kuiniuca.com,0,0.00%,14,14,0.00%
dispatch.updrv.com,0,0.00%,11,11,0.00%
mq.focustodo.net,0,0.00%,2,2,0.00%
cmhk.tcpbbr.xyz,0,0.00%,24,24,0.00%
www.focustodo.net,0,0.00%,4,4,0.00%
info-push.duba.net,0,0.00%,1,1,0.00%
msg-push.duba.net,0,0.00%,2,2,0.00%
armmf.adobe.com,0,0.00%,8,8,0.00%
ocsp.thawte.com,0,0.00%,6,6,0.00%
crl.thawte.com,0,0.00%,4,4,0.00%
time.android.com,0,0.00%,6,6,0.00%
alt4-mtalk.google.com,0,0.00%,2,2,0.00%
exp.notion.so,0,0.00%,8,8,0.00%
rq.optimize.cloud.duba.net,0,0.00%,12,12,0.00%
c6.y.qq.com,0,0.00%,6,6,0.00%
apisnd.heytapmobi.com,0,0.00%,3,3,0.00%
appconf-ocs.heytapdownload.com,0,0.00%,7,7,0.00%
cloud.videojj.com,0,0.00%,2,2,0.00%
obus-cn.dc.heytapmobi.com,0,0.00%,4,4,0.00%
api-cn.theme.heytapmobi.com,0,0.00%,2,2,0.00%
api-cn.open.heytapmobi.com,0,0.00%,2,2,0.00%
api.cdo.oppomobile.com,0,0.00%,2,2,0.00%
conf-cn.dc.heytapmobi.com,0,0.00%,2,2,0.00%
sls.sourceinsight.com,0,0.00%,2,2,0.00%
conf-cn-dc.heytapdownload.com,0,0.00%,2,2,0.00%
www.chrome-helper.cc,0,0.00%,2,2,0.00%
iphonesubmissions.apple.com,0,0.00%,10,10,0.00%
p-beha.ksmobile.com,0,0.00%,2,2,0.00%
msfhttp.3g.qq.com,0,0.00%,2,2,0.00%
client-uc.heytapmobi.com,0,0.00%,2,2,0.00%
idm.iot.mi.com,0,0.00%,1,1,0.00%
dnet.mb.qq.com,0,0.00%,1,1,0.00%
cfg.imtt.qq.com,0,0.00%,3,3,0.00%
helpgamemoneysdk1.ksmobile.com,0,0.00%,1,1,0.00%
captcha.zhihu.com,0,0.00%,6,6,0.00%
h-adashx.ut.hzshudian.com,0,0.00%,2,2,0.00%
i4.cwip.eset.com,0,0.00%,6,6,0.00%
gateway.im.weibo.cn,0,0.00%,22,22,0.00%
dp.im.weibo.cn,0,0.00%,17,17,0.00%
wbapp.uve.weibo.com,0,0.00%,12,12,0.00%
service.lx.qianxin.com,0,0.00%,2,2,0.00%
th-b.pinduoduo.com,0,0.00%,12,12,0.00%
loginserver.kuwo.cn,0,0.00%,6,6,0.00%
mobileinterfaces.kuwo.cn,0,0.00%,4,4,0.00%
sdkapp.uve.weibo.com,0,0.00%,16,16,0.00%
a.qchannel03.cn,0,0.00%,2,2,0.00%
online.kugou.com,0,0.00%,5,5,0.00%
omes-sec.heytapmobi.com,0,0.00%,2,2,0.00%
onedriveclucprodbn20011.blob.core.windows.net,0,0.00%,4,4,0.00%
gzyd.120.817777.xyz,0,0.00%,4,4,0.00%
startpage.ic.ksosoft.com,0,0.00%,6,6,0.00%
uf-api6.ksord.com,0,0.00%,2,2,0.00%
cnt.wps.cn,0,0.00%,2,2,0.00%
ai.wps.cn,0,0.00%,2,2,0.00%
skin.docer.wps.cn,0,0.00%,2,2,0.00%
conf.psvr.wps.cn,0,0.00%,2,2,0.00%
wpsfile.ks3-cn-beijing.ksyun.com,0,0.00%,7,7,0.00%
shuc-pc-snow.ksord.com,0,0.00%,6,6,0.00%
r4---sn-ni5eln7l.gvt1.com,0,0.00%,4,4,0.00%
r2---sn-ni5een7l.gvt1.com,0,0.00%,4,4,0.00%
shb.richaudience.com,0,0.00%,10,10,0.00%
mp.4dex.io,0,0.00%,7,7,0.00%
prebid.smilewanted.com,0,0.00%,2,2,0.00%
moa-upload-cn.allawntech.com,0,0.00%,2,2,0.00%
cs9.wac.phicdn.net,0,0.00%,11,11,0.00%
p207-caldav.icloud.com.cn,0,0.00%,2,2,0.00%
calendars.fe.apple-dns.net,0,0.00%,6,6,0.00%
ex.m.jd.com,0,0.00%,8,8,0.00%
nodestore.logitech.io,0,0.00%,4,4,0.00%
android.rqd.qq.com,0,0.00%,10,10,0.00%
ww1097.smartadserver.com,0,0.00%,14,14,0.00%
oss.mail.qq.com,0,0.00%,14,14,0.00%
slink.gifshow.com,0,0.00%,2,2,0.00%
slink.ksapisrv.com,0,0.00%,2,2,0.00%
kuaishou.com,0,0.00%,4,4,0.00%
iwx.mail.qq.com,0,0.00%,2,2,0.00%
torrentsmd.com,0,0.00%,12,12,0.00%
notification.adblockplus.org,0,0.00%,5,5,0.00%
quark-h3-v1.upaas.uc.cn,0,0.00%,2,2,0.00%
ui.ptlogin2.qq.com,0,0.00%,7,7,0.00%
bizapi.csdn.net,0,0.00%,17,17,0.00%
followservice.kugou.com,0,0.00%,8,8,0.00%
wlimg10.360buyimg.com,0,0.00%,4,4,0.00%
onedriveclubprodbn20029.blob.core.windows.net,0,0.00%,2,2,0.00%
catdot.dianping.com,0,0.00%,9,9,0.00%
api.neixin.cn,0,0.00%,12,12,0.00%
portal-portm.meituan.com,0,0.00%,10,10,0.00%
dreport.meituan.net,0,0.00%,20,20,0.00%
api.meituan.com,0,0.00%,6,6,0.00%
hlx.meituan.com,0,0.00%,8,8,0.00%
dd.meituan.com,0,0.00%,13,13,0.00%
shark.dianping.com,0,0.00%,12,12,0.00%
dpmtpush.dianping.com,0,0.00%,8,8,0.00%
bd0.d.meituan.net,0,0.00%,6,6,0.00%
ocsp.crlocsp.cn,0,0.00%,6,6,0.00%
safe1.shouji.sogou.com,0,0.00%,2,2,0.00%
conn-service-cn-05.allawntech.com,0,0.00%,6,6,0.00%
conn-service-cn-03.allawntech.com,0,0.00%,14,14,0.00%
brain.safe.360.cn,0,0.00%,2,2,0.00%
logbak.hicloud.com,0,0.00%,8,8,0.00%
github-cloud.s3.amazonaws.com,0,0.00%,10,10,0.00%
awareness-api-drcn.ai.dbankcloud.com,0,0.00%,6,6,0.00%
wmapi.meituan.com,0,0.00%,4,4,0.00%
maplocatesdksnapshot.dreport.meituan.net,0,0.00%,6,6,0.00%
apimobile.meituan.com,0,0.00%,9,9,0.00%
alita.waimai.meituan.com,0,0.00%,6,6,0.00%
nearby-drcn.platform.dbankcloud.com,0,0.00%,6,6,0.00%
ops.wedobest.com.cn,0,0.00%,2,2,0.00%
remotecfg.wedobest.com.cn,0,0.00%,2,2,0.00%
release.gitkraken.com,0,0.00%,2,2,0.00%
catfront.dianping.com,0,0.00%,10,10,0.00%
P2PStuNtESt.HAPlaT.Net,0,0.00%,2,2,0.00%
maMbaP2pvODh5.8686c.COm,0,0.00%,2,2,0.00%
clIeNtlOGvODp2p.hAPLat.net,0,0.00%,2,2,0.00%
TRaNsIT1.WslOG.CHiNANEtCENTEr.Com,0,0.00%,2,2,0.00%
lwlog.laiwang.com,0,0.00%,2,2,0.00%
mum.alibabachengdun.com,0,0.00%,2,2,0.00%
securetime.playready.microsoft.com,0,0.00%,4,4,0.00%
resolver.dingtalk.com,0,0.00%,2,2,0.00%
1eae257e44aa9d5b.jijifun.com,0,0.00%,2,2,0.00%
scss.adobesc.com,0,0.00%,4,4,0.00%
acs-mum.alibabachengdun.com,0,0.00%,2,2,0.00%
inside-gateway.alipay.com,0,0.00%,4,4,0.00%
dualstack-arestapi.amap.com,0,0.00%,2,2,0.00%
h-adashx.ut.dingtalk.com,0,0.00%,4,4,0.00%
release.axocdn.com,0,0.00%,2,2,0.00%
pubgw.api.ddxq.mobi,0,0.00%,6,6,0.00%
i.waimai.meituan.com,0,0.00%,6,6,0.00%
www.dingtalk.com,0,0.00%,3,3,0.00%
p2.d.meituan.net,0,0.00%,7,7,0.00%
o0.d.meituan.net,0,0.00%,6,6,0.00%
mesu.g.aaplimg.com,0,0.00%,5,5,0.00%
global.quickconnect.cn,0,0.00%,19,19,0.00%
m2.d.meituan.net,0,0.00%,4,4,0.00%
ss-prod-an1-notif-36.aws.adobess.com,0,0.00%,8,8,0.00%
o3.d.meituan.net,0,0.00%,7,7,0.00%
m.dianping.com,0,0.00%,6,6,0.00%
p5.d.meituan.net,0,0.00%,12,12,0.00%
orange-dc.alibaba.com,0,0.00%,2,2,0.00%
alimei-api.aliyun.com,0,0.00%,2,2,0.00%
p6.d.meituan.net,0,0.00%,11,11,0.00%
p213-imap.mail.icloud.com.cn,0,0.00%,2,2,0.00%
hk.pool.ntp.org,0,0.00%,10,10,0.00%
tw.pool.ntp.org,0,0.00%,11,11,0.00%
liangcang-material.alicdn.com.danuoyi.alicdn.com,0,0.00%,2,2,0.00%
xpgw-xcdn.youku.com,0,0.00%,7,7,0.00%
mc.atm.youku.com,0,0.00%,1,1,0.00%
aserver-heyi.m.taobao.com.gds.alibabadns.com,0,0.00%,5,5,0.00%
httpdns.alicdn.com.danuoyi.tbcache.com,0,0.00%,2,2,0.00%
vs.biz.weibo.com,0,0.00%,19,19,0.00%
k.us.sinaimg.cn,0,0.00%,6,6,0.00%
tvax3.sinaimg.cn,0,0.00%,20,20,0.00%
wbapp.mobile.sina.cn,0,0.00%,2,2,0.00%
mediadata.api.weibo.com,0,0.00%,8,8,0.00%
gw5.push.mcp.weibo.cn,0,0.00%,6,6,0.00%
wbox.sinaimg.cn,0,0.00%,1,1,0.00%
tva3.sinaimg.cn,0,0.00%,12,12,0.00%
smarthome.dbankcloud.cn,0,0.00%,6,6,0.00%
ins-giuzhgwa.ias.tencent-cloud.net,0,0.00%,2,2,0.00%
push-rtmp-hs-f5-encryption.douyincdn.com.c.volcfcdndvs.com,0,0.00%,9,9,0.00%
push-rtmp-f5-vs.douyincdn.com.c.bytefcdn.com,0,0.00%,11,11,0.00%
push-rtmp-l11-cny.douyincdn.com.livepush.myqcloud.com,0,0.00%,8,8,0.00%
push-rtmp-l26-cny.douyincdn.com.c.cdnhwc3.com,0,0.00%,11,11,0.00%
pull-flv-f26.douyincdn.com.c.cdnhwc3.com,0,0.00%,9,9,0.00%
push-rtmp-l95.douyincdn.com.ctdns.cn,0,0.00%,13,13,0.00%
pull-flv-l95.douyincdn.com.ctdns.cn,0,0.00%,14,14,0.00%
pull-hls-f13.douyincdn.com.a.bdydns.com,0,0.00%,11,11,0.00%
play.ulive.ugslb.com,0,0.00%,13,13,0.00%
push-rtmp-f5-cny.douyincdn.com.c.bytefcdn.com,0,0.00%,12,12,0.00%
pull-rtmp-l95.douyincdn.com.ctdns.cn,0,0.00%,13,13,0.00%
pull-flv-l11-cny.douyincdn.com.tcdnlive.com,0,0.00%,12,12,0.00%
push-rtmp-spe-l3.douyincdn.com.230b2a2545cfa773.queniufm.com,0,0.00%,14,14,0.00%
pull-rtmp-f29.douyincdn.com.ucloud.com.cn,0,0.00%,10,10,0.00%
push-rtmp-vr-l3.douyincdn.com.230b2a2545cfa773.queniufm.com,0,0.00%,14,14,0.00%
datapipeline.logitech.io,0,0.00%,7,7,0.00%
conn.wemeet.tencent.com,0,0.00%,17,17,0.00%
kv801.prod.do.dsp.mp.microsoft.com,0,0.00%,35,35,0.00%
image.sinajs.cn,0,0.00%,1,1,0.00%
tracker.tamersunion.org,0,0.00%,18,18,0.00%
s.qhupdate.com,0,0.00%,12,12,0.00%
aicleaner.shouji.360.cn,0,0.00%,4,4,0.00%
pdata.log.mgtv.com,0,0.00%,7,7,0.00%
api.ssl.so.com,0,0.00%,12,12,0.00%
p0.ssl.qhimg.com,0,0.00%,10,10,0.00%
e.so.com,0,0.00%,10,10,0.00%
dcagent.mecdn.synacast.com,0,0.00%,5,5,0.00%
up.ijinshan.com,0,0.00%,6,6,0.00%
s5.ssl.qhimg.com,0,0.00%,2,2,0.00%
p2.ssl.qhimg.com,0,0.00%,8,8,0.00%
lbs.netease.im,0,0.00%,12,12,0.00%
storedl3.heytapdownload.com,0,0.00%,3,3,0.00%
gtm-cn-6ja22i7nm0h.gtm-a4b8.com,0,0.00%,4,4,0.00%
bkvv.video.qq.com,0,0.00%,13,13,0.00%
bk.info.zb.qq.com,0,0.00%,11,11,0.00%
info.zb.qq.com,0,0.00%,11,11,0.00%
imap.126.com,0,0.00%,4,4,0.00%
ntp.msn.com,0,0.00%,2,2,0.00%
ntp.msn.cn,0,0.00%,19,19,0.00%
kns.cnki.net,0,0.00%,6,6,0.00%
c.msn.com,0,0.00%,24,24,0.00%
piccache.cnki.net,0,0.00%,7,7,0.00%
recsys.cnki.net,0,0.00%,4,4,0.00%
obus-dc20157-cn.heytapmobi.com,0,0.00%,9,9,0.00%
web.qun.qq.com,0,0.00%,8,8,0.00%
a.cnki.net,0,0.00%,3,3,0.00%
edd.e4.nl,0,0.00%,2,2,0.00%
shadowshq.eddie4.nl,0,0.00%,1,1,0.00%
update-zl.2345.cc,0,0.00%,4,4,0.00%
th-a.pinduoduo.com,0,0.00%,3,3,0.00%
accwww15c1.53kf.com,0,0.00%,7,7,0.00%
latexlive-resourse.oss-cn-beijing.aliyuncs.com,0,0.00%,2,2,0.00%
hub5pnc.sandai.net,0,0.00%,59,59,0.00%
security.bilibili.com,0,0.00%,26,26,0.00%
passport.bilibili.com,0,0.00%,19,19,0.00%
rgeo-aloc.amap.com,0,0.00%,1,1,0.00%
tls-eleme.dingtalk.com,0,0.00%,3,3,0.00%
adashx.ut.ele.me,0,0.00%,3,3,0.00%
restapi.ele.me,0,0.00%,1,1,0.00%
app-monitor.ele.me,0,0.00%,3,3,0.00%
l-rcd.iqiyi.com,0,0.00%,16,16,0.00%
api.vip.iqiyi.com,0,0.00%,3,3,0.00%
qq.com,0,0.00%,56,56,0.00%
ai-drcn.op.hihonorcloud.com,0,0.00%,2,2,0.00%
dnkeeper.hicloud.com,0,0.00%,2,2,0.00%
vpn.whu.edu.cn,0,0.00%,4,4,0.00%
logger.csslcloud.net,0,0.00%,2,2,0.00%
nsp-appgallery-cmsimg3az-drcn.obs.cn-north-2.myhuaweicloud.com,0,0.00%,4,4,0.00%
hwvipkid.vipkidcdn.com,0,0.00%,4,4,0.00%
hwpub-s01-drcn.cloud.dbankcloud.cn,0,0.00%,4,4,0.00%
newtoncity.org,0,0.00%,6,6,0.00%
d3u8eo6n4jxbvx.cloudfront.net,0,0.00%,3,3,0.00%
search.webofknowledge.com,0,0.00%,4,4,0.00%
stsdk.vivo.com.cn,0,0.00%,2,2,0.00%
ccc-x.jd.com,0,0.00%,4,4,0.00%
cloud.10jqka.com.cn,0,0.00%,2,2,0.00%
gdfp.gifshow.com,0,0.00%,2,2,0.00%
kste.ksapisrv.com,0,0.00%,1,1,0.00%
httpdns.bcelive.com,0,0.00%,5,5,0.00%
js2.a.yximgs.com,0,0.00%,3,3,0.00%
jscmmov.a.etoote.com,0,0.00%,3,3,0.00%
ali.push.yximgs.com,0,0.00%,1,1,0.00%
api.kmovie.gifshow.com,0,0.00%,3,3,0.00%
app.kwaixiaodian.com,0,0.00%,3,3,0.00%
bs-adaptive.pull.yximgs.com,0,0.00%,3,3,0.00%
hw-p2p.pull.yximgs.com,0,0.00%,1,1,0.00%
d5-ks.a.kwimgs.com,0,0.00%,1,1,0.00%
js-im-simi.xxpkg.com,0,0.00%,2,2,0.00%
jscm.a.etoote.com,0,0.00%,1,1,0.00%
keep-so.kwd.inkuai.com,0,0.00%,1,1,0.00%
d2-ec.a.kwimgs.com,0,0.00%,1,1,0.00%
ks.push.yximgs.com,0,0.00%,1,1,0.00%
push.kwd.inkuai.com,0,0.00%,2,2,0.00%
d2-yoda.a.kwimgs.com,0,0.00%,1,1,0.00%
d3-ec.a.kwimgs.com,0,0.00%,1,1,0.00%
d3-ks.a.kwimgs.com,0,0.00%,1,1,0.00%
d3-push.static.yximgs.com,0,0.00%,1,1,0.00%
d4-ec.a.kwimgs.com,0,0.00%,1,1,0.00%
js.a.kspkg.com,0,0.00%,1,1,0.00%
tx-game.push.yximgs.com,0,0.00%,1,1,0.00%
gdfpsec.ksapisrv.com,0,0.00%,2,2,0.00%
v1-vod.kwaicdn.com,0,0.00%,1,1,0.00%
v10.kwaicdn.com,0,0.00%,1,1,0.00%
v2-cty03.kwaicdn.com,0,0.00%,2,2,0.00%
v2-cty06.kwaicdn.com,0,0.00%,4,4,0.00%
v2-cty02.kwaicdn.com,0,0.00%,2,2,0.00%
v2-vod.kwaicdn.com,0,0.00%,1,1,0.00%
yoda.kwd.inkuai.com,0,0.00%,4,4,0.00%
msfwifi.3g.qq.com,0,0.00%,4,4,0.00%
qappcenterv6.3g.qq.com,0,0.00%,4,4,0.00%
api2.e.kuaishou.com,0,0.00%,3,3,0.00%
adashx.ut.dingtalk.com,0,0.00%,13,13,0.00%
qpushapi.innotechx.com,0,0.00%,4,4,0.00%
miniapi.ksapisrv.com,0,0.00%,1,1,0.00%
tdid.m.qq.com,0,0.00%,3,3,0.00%
masdkv6.3g.qq.com,0,0.00%,2,2,0.00%
open.kuaishou.com,0,0.00%,1,1,0.00%
api.smoot.apple.com,0,0.00%,14,14,0.00%
srtb.msn.com,0,0.00%,17,17,0.00%
035937cc-rh8yo0-riqqjl-1etsw.pccw.alrihla.net,0,0.00%,4,4,0.00%
www.yuque.com,0,0.00%,4,4,0.00%
b.alicdn.com,0,0.00%,2,2,0.00%
cdn.nlark.com,0,0.00%,1,1,0.00%
cdn-pri.nlark.com,0,0.00%,1,1,0.00%
cdn.yuque.com,0,0.00%,1,1,0.00%
g.yuque.com,0,0.00%,2,2,0.00%
kcart.alipay.com,0,0.00%,2,2,0.00%
ib.adnxs.com,0,0.00%,9,9,0.00%
c2shb.pubgw.yahoo.com,0,0.00%,12,12,0.00%
mdap.yuque.com,0,0.00%,4,4,0.00%
jf.creditcard.ecitic.com,0,0.00%,2,2,0.00%
species.missionsec.io,0,0.00%,2,2,0.00%
win1910.ipv6.microsoft.com,0,0.00%,2,2,0.00%
conn.meeting.work.weixin.qq.com,0,0.00%,2,2,0.00%
jf.citiccardcdn.citicbank.com,0,0.00%,1,1,0.00%
ur.alipay.com,0,0.00%,2,2,0.00%
tracert.alipay.com,0,0.00%,2,2,0.00%
mcs.citiccardcdn.citicbank.com,0,0.00%,2,2,0.00%
ss.gb1.se.sx.cn,0,0.00%,4,4,0.00%
sucai.alicdn.com,0,0.00%,2,2,0.00%
obsetear.github.io,0,0.00%,1,1,0.00%
proxy.zenithspace.net,0,0.00%,1,1,0.00%
cm-10-47.getui.com,0,0.00%,3,3,0.00%
tysdk.95516.com,0,0.00%,2,2,0.00%
report.idqqimg.com,0,0.00%,23,23,0.00%
swallow-apple-com.v.aaplimg.com,0,0.00%,4,4,0.00%
aefd.nelreports.net,0,0.00%,30,30,0.00%
onedscolprdwus02.westus.cloudapp.azure.com,0,0.00%,18,18,0.00%
hicall-drcn.emui.hicloud.com,0,0.00%,2,2,0.00%
tbshop.m.taobao.com,0,0.00%,2,2,0.00%
hybrid.miniapp.taobao.com,0,0.00%,1,1,0.00%
fsc.fitbit.com,0,0.00%,2,2,0.00%
iphone-api.fitbit.com,0,0.00%,2,2,0.00%
120-220-160-245.volcsiriusbd.com,0,0.00%,2,2,0.00%
dc-dragate-cn.heytapmobi.com,0,0.00%,8,8,0.00%
desktop-release.notion-static.com,0,0.00%,1,1,0.00%
router8.teamviewer.com,0,0.00%,27,27,0.00%
ext.baidu.com,0,0.00%,9,9,0.00%
app.any.run,0,0.00%,2,2,0.00%
analytics.95516.com,0,0.00%,8,8,0.00%
ap.lijit.com,0,0.00%,6,6,0.00%
p13n.adobe.io,0,0.00%,21,21,0.00%
cn.voidcc.com,0,0.00%,2,2,0.00%
www.yy.com,0,0.00%,4,4,0.00%
tpstelemetry.tencent.com,0,0.00%,28,28,0.00%
hcl.baidu.com,0,0.00%,4,4,0.00%
www.hao123.com,0,0.00%,14,14,0.00%
gamedelivery.bj.bcebos.com,0,0.00%,2,2,0.00%
trc.taboola.com,0,0.00%,6,6,0.00%
www.freesion.com,0,0.00%,2,2,0.00%
hpd.a.shifen.com,0,0.00%,8,8,0.00%
eopa.n.shifen.com,0,0.00%,6,6,0.00%
cdnjs.cloudflare.com,0,0.00%,16,16,0.00%
sploit-edge.smartscreen.microsoft.com,0,0.00%,2,2,0.00%
mini.group.qq.com,0,0.00%,4,4,0.00%
img1.doubanio.com,0,0.00%,12,12,0.00%
relay-6810dbc0.net.anydesk.com.cn,0,0.00%,8,8,0.00%
fundin.douban.com,0,0.00%,6,6,0.00%
erebor.douban.com,0,0.00%,8,8,0.00%
frodo.douban.com,0,0.00%,8,8,0.00%
mbd.n.shifen.com,0,0.00%,4,4,0.00%
cds.taboola.com,0,0.00%,4,4,0.00%
user-api-v2.oray.com,0,0.00%,2,2,0.00%
dev.visualwebsiteoptimizer.com,0,0.00%,4,4,0.00%
tls.dingtalk.com,0,0.00%,2,2,0.00%
gartic.io,0,0.00%,4,4,0.00%
qszhang.com,0,0.00%,2,2,0.00%
trello-attachments.s3.amazonaws.com,0,0.00%,3,3,0.00%
osupdateservice.yunos.com,0,0.00%,2,2,0.00%
fund.eastmoney.com,0,0.00%,2,2,0.00%
gubatopic.eastmoney.com,0,0.00%,2,2,0.00%
passport2.eastmoney.com,0,0.00%,2,2,0.00%
www.eastmoney.com,0,0.00%,2,2,0.00%
zqhd.eastmoney.com,0,0.00%,2,2,0.00%
emhd2.eastmoney.com,0,0.00%,2,2,0.00%
huoqibao.1234567.com.cn,0,0.00%,2,2,0.00%
js5.eastmoney.com,0,0.00%,2,2,0.00%
qs.dfcfw.com,0,0.00%,2,2,0.00%
www.cyberpolice.cn,0,0.00%,3,3,0.00%
zhaopin.eastmoney.com,0,0.00%,2,2,0.00%
searchapi.eastmoney.com,0,0.00%,6,6,0.00%
84.newspush.eastmoney.com,0,0.00%,4,4,0.00%
emdesk.eastmoney.com,0,0.00%,2,2,0.00%
quote.eastmoney.com,0,0.00%,6,6,0.00%
faxian.1234567.com.cn,0,0.00%,2,2,0.00%
fundsc.eastmoney.com,0,0.00%,2,2,0.00%
fundzt.eastmoney.com,0,0.00%,2,2,0.00%
service.weibo.com,0,0.00%,2,2,0.00%
choice.eastmoney.com,0,0.00%,2,2,0.00%
sentry.music.163.com,0,0.00%,2,2,0.00%
mobile.cmbchina.com,0,0.00%,2,2,0.00%
list.lvb.eastmoney.com,0,0.00%,6,6,0.00%
crl3.digicert.com,0,0.00%,11,11,0.00%
redis.io,0,0.00%,2,2,0.00%
dgphy16.netease.im,0,0.00%,2,2,0.00%
mbads.paas.cmbchina.com,0,0.00%,4,4,0.00%
www.googletagservices.com,0,0.00%,22,22,0.00%
webappcfg.paas.cmbchina.com,0,0.00%,4,4,0.00%
cc.map.qq.com,0,0.00%,4,4,0.00%
sodefaultwordapi.paas.cmbchina.com,0,0.00%,4,4,0.00%
netpay.cmbchina.com,0,0.00%,4,4,0.00%
ai.cmbchina.com,0,0.00%,4,4,0.00%
mbmodule-openapi.paas.cmbchina.com,0,0.00%,4,4,0.00%
kunyu.csdn.net,0,0.00%,17,17,0.00%
wwads.cn,0,0.00%,9,9,0.00%
netshield.paas.cmbchina.com,0,0.00%,2,2,0.00%
yl.zh.cmbchina.com,0,0.00%,4,4,0.00%
upload_data.qq.com,0,0.00%,5,5,0.00%
id.rlcdn.com,0,0.00%,21,21,0.00%
odr.mookie1.com,0,0.00%,17,17,0.00%
image6.pubmatic.com,0,0.00%,22,22,0.00%
googlecm.hit.gemius.pl,0,0.00%,12,12,0.00%
pr-bh.ybp.yahoo.com,0,0.00%,4,4,0.00%
log.cmbchina.com,0,0.00%,4,4,0.00%
data.ping.shouji.sogou.com,0,0.00%,2,2,0.00%
api-std.sunlogin.oray.com,0,0.00%,57,57,0.00%
auth-sl.oray.com,0,0.00%,8,8,0.00%
pcsdata.baidu.com,0,0.00%,22,22,0.00%
rb122n.jomodns.com,0,0.00%,6,6,0.00%
ebank.sz1.cmbchina.com,0,0.00%,4,4,0.00%
wpad,0,0.00%,2,2,0.00%
xacu07.baidupcs.com,0,0.00%,2,2,0.00%
szsupport.weixin.qq.com,0,0.00%,4,4,0.00%
a2p-s01-drcn.cloud.dbankcloud.cn,0,0.00%,10,10,0.00%
ra490n.jomodns.com,0,0.00%,4,4,0.00%
array604.prod.do.dsp.mp.microsoft.com,0,0.00%,12,12,0.00%
array609.prod.do.dsp.mp.microsoft.com,0,0.00%,10,10,0.00%
www.bj.cyberpolice.cn,0,0.00%,4,4,0.00%
nstool.netease.com,0,0.00%,24,24,0.00%
natdetection.onethingpcs.com,0,0.00%,11,11,0.00%
presence.api.drift.com,0,0.00%,4,4,0.00%
logs.amap.com,0,0.00%,2,2,0.00%
only-332144-159-226-95-67.nstool.haowu.link,0,0.00%,1,1,0.00%
vscodeexperiments.azureedge.net,0,0.00%,2,2,0.00%
dc.services.visualstudio.com,0,0.00%,60,60,0.00%
identify.zhhainiao.com,0,0.00%,2,2,0.00%
router11.teamviewer.com,0,0.00%,44,44,0.00%
211f1a883c3d471f8598394851d07035.fp.measure.office.com,0,0.00%,2,2,0.00%
gz-lb1.internet-g.spanner.alipaydns.com,0,0.00%,10,10,0.00%
kjjs.stat.360safe.com,0,0.00%,6,6,0.00%
cr.file.cloud.duba.net,0,0.00%,6,6,0.00%
c.tieba.baidu.com,0,0.00%,4,4,0.00%
www.cnblogs.com,0,0.00%,7,7,0.00%
img.chajianxw.com,0,0.00%,2,2,0.00%
download.ffnews.cn,0,0.00%,4,4,0.00%
mq.dataservices.hp.com,0,0.00%,18,18,0.00%
arthas.safe.360.cn,0,0.00%,2,2,0.00%
www.as.com,0,0.00%,1,1,0.00%
api.51dzt.com,0,0.00%,2,2,0.00%
count.cnblogs.com,0,0.00%,4,4,0.00%
xy6hjm0xw4.feishu.cn,0,0.00%,1,1,0.00%
api-kos.wps.cn,0,0.00%,6,6,0.00%
pu-kos.ks3-cn-beijing.ksyun.com,0,0.00%,6,6,0.00%
stats.norton.com,0,0.00%,2,2,0.00%
pcapp-push.youku.com,0,0.00%,5,5,0.00%
router13.teamviewer.com,0,0.00%,37,37,0.00%
apd-0abeeb5cff31a0eea8bc3101a3b083fc.v.smtcdns.com,0,0.00%,2,2,0.00%
commentowebd.vps.webdock.io,0,0.00%,1,1,0.00%
datacollect.foxmail.com.cn,0,0.00%,3,3,0.00%
api.installer.xiaomi.com,0,0.00%,2,2,0.00%
miui-fxcse.avlyun.com,0,0.00%,2,2,0.00%
c2cpicdw.qpic.cn,0,0.00%,2,2,0.00%
torrent.centos.org,0,0.00%,4,4,0.00%
git.octodata.com.cn,0,0.00%,9,9,0.00%
orange-pcsafe.2345.cc,0,0.00%,39,39,0.00%
mkt-advertisement.tuhu.cn,0,0.00%,2,2,0.00%
router6.teamviewer.com,0,0.00%,34,34,0.00%
obd.gtimg.com,0,0.00%,2,2,0.00%
muse.theme-next.org,0,0.00%,2,2,0.00%
launches.appsflyer.com,0,0.00%,6,6,0.00%
vvbin.cn,0,0.00%,2,2,0.00%
lc.tencent.com,0,0.00%,4,4,0.00%
grs.hihonorcloud.com,0,0.00%,8,8,0.00%
dbg.pinyin.sogou.com,0,0.00%,2,2,0.00%
weather-drcn.music.hicloud.com,0,0.00%,2,2,0.00%
www.hostbuf.com,0,0.00%,8,8,0.00%
res.qhmsg.com,0,0.00%,9,9,0.00%
logapi.zhipin.com,0,0.00%,15,15,0.00%
search.namequery.com,0,0.00%,4,4,0.00%
cloudphoto-drcn.cloud.dbankcloud.cn,0,0.00%,30,30,0.00%
auth.10jqka.com.cn,0,0.00%,2,2,0.00%
hawkeye.10jqka.com.cn,0,0.00%,2,2,0.00%
push.hexin.cn,0,0.00%,2,2,0.00%
eq.10jqka.com.cn,0,0.00%,3,3,0.00%
adm.10jqka.com.cn,0,0.00%,5,5,0.00%
recommend.10jqka.com.cn,0,0.00%,2,2,0.00%
pns.hexin.cn,0,0.00%,2,2,0.00%
u.thsi.cn,0,0.00%,3,3,0.00%
zntg.10jqka.com.cn,0,0.00%,5,5,0.00%
ozone.10jqka.com.cn,0,0.00%,2,2,0.00%
news.10jqka.com.cn,0,0.00%,6,6,0.00%
cs.10jqka.com.cn,0,0.00%,2,2,0.00%
upass.10jqka.com.cn,0,0.00%,2,2,0.00%
s.thsi.cn,0,0.00%,16,16,0.00%
smarthome.hicloud.com,0,0.00%,4,4,0.00%
t.10jqka.com.cn,0,0.00%,2,2,0.00%
mgkh.10jqka.com.cn,0,0.00%,2,2,0.00%
openapi-drcn.cloud.dbankcloud.cn,0,0.00%,21,21,0.00%
logservice.hicloud.com,0,0.00%,18,18,0.00%
logservice1.hicloud.com,0,0.00%,18,18,0.00%
nsp-logservice-hiview-p41-drcn.obs.cn-north-2.myhuaweicloud.com,0,0.00%,5,5,0.00%
tmfsdktcpv4.m.qq.com,0,0.00%,9,9,0.00%
www.xboxab.com,0,0.00%,20,20,0.00%
repo.spring.io,0,0.00%,6,6,0.00%
cerebrum.emotivcloud.com,0,0.00%,10,10,0.00%
conf.f.360.cn,0,0.00%,36,36,0.00%
array601.prod.do.dsp.mp.microsoft.com,0,0.00%,26,26,0.00%
lsw-fast.lenovo.com.cn,0,0.00%,2,2,0.00%
a1.cnblogs.com,0,0.00%,4,4,0.00%
account.cnblogs.com,0,0.00%,4,4,0.00%
analytics.cnblogs.com,0,0.00%,4,4,0.00%
r3---sn-2x3elnez.gvt1.com,0,0.00%,10,10,0.00%
rpt.gdt.qq.com,0,0.00%,14,14,0.00%
lcdn-locator.apple.com,0,0.00%,9,9,0.00%
cloud.pinyin.sogou.com,0,0.00%,6,6,0.00%
cl2-cn.ls-apple.com.akadns.net,0,0.00%,4,4,0.00%
api.fcsc.com,0,0.00%,4,4,0.00%
check.shareinstall.com.cn,0,0.00%,2,2,0.00%
task.shareinstall.com.cn,0,0.00%,2,2,0.00%
bd.95358.com,0,0.00%,4,4,0.00%
config.shareinstall.com.cn,0,0.00%,2,2,0.00%
ecollision.shareinstall.com.cn,0,0.00%,2,2,0.00%
impush.fcsc.com,0,0.00%,5,5,0.00%
url-query.api.pc120.com,0,0.00%,6,6,0.00%
stare.fcsc.com,0,0.00%,4,4,0.00%
zqnweb.v.trpcdn.NET,0,0.00%,4,4,0.00%
decisionhub-drcn.emui.dbankcloud.com,0,0.00%,4,4,0.00%
channels.weixin.qq.com,0,0.00%,17,17,0.00%
software.drivergenius.com,0,0.00%,36,36,0.00%
forum-api-drcn.jos.hicloud.com,0,0.00%,6,6,0.00%
store1.hispace.hicloud.com,0,0.00%,6,6,0.00%
tsms-drcn.security.dbankcloud.cn,0,0.00%,6,6,0.00%
rms-drcn.platform.dbankcloud.cn,0,0.00%,6,6,0.00%
tsms-drcn.platform.dbankcloud.com,0,0.00%,4,4,0.00%
vpn.ouc.edu.cn,0,0.00%,2,2,0.00%
api-sdk.mihoyo.com,0,0.00%,4,4,0.00%
videoepg.hicloud.com,0,0.00%,22,22,0.00%
log-upload.mihoyo.com,0,0.00%,6,6,0.00%
dispatchcnglobal.yuanshen.com,0,0.00%,2,2,0.00%
videouser-drcn.himovie.dbankcloud.cn,0,0.00%,2,2,0.00%
hot.browser.miui.com,0,0.00%,2,2,0.00%
lb1.3gdisk.com,0,0.00%,2,2,0.00%
pushtrs1.push.hicloud.com,0,0.00%,2,2,0.00%
gnss-eph.oss-cn-hangzhou.aliyuncs.com,0,0.00%,2,2,0.00%
gaode-jmacs.m.taobao.com,0,0.00%,2,2,0.00%
m5.amap.com,0,0.00%,4,4,0.00%
m5-zb.amap.com,0,0.00%,2,2,0.00%
mps.amap.com,0,0.00%,2,2,0.00%
awaken.amap.com,0,0.00%,4,4,0.00%
amap-aos-info-nogw.amap.com,0,0.00%,3,3,0.00%
sync.amap.com,0,0.00%,2,2,0.00%
sns.amap.com,0,0.00%,2,2,0.00%
event-drcn.push.dbankcloud.com,0,0.00%,6,6,0.00%
apm.fcsc.com,0,0.00%,4,4,0.00%
ss.dolphinpaper.com,0,0.00%,2,2,0.00%
ts.amap.com,0,0.00%,2,2,0.00%
gaode-acs.m.taobao.com,0,0.00%,2,2,0.00%
apush.fcsc.com,0,0.00%,4,4,0.00%
ocsps.ssl.com,0,0.00%,4,4,0.00%
udpolimeok.baidu.com,0,0.00%,9,9,0.00%
weather-drcn.music.dbankcloud.cn,0,0.00%,16,16,0.00%
q2.qlogo.cn,0,0.00%,4,4,0.00%
amdc.m.taobao.com,0,0.00%,9,9,0.00%
szshort.weixin.qq.com,0,0.00%,14,14,0.00%
ml314.com,0,0.00%,8,8,0.00%
adashx.ut.amap.com,0,0.00%,3,3,0.00%
p.guanjia.qq.com,0,0.00%,4,4,0.00%
sv.symcd.com,0,0.00%,18,18,0.00%
stat.tpns.tencent.com,0,0.00%,2,2,0.00%
api-mayi.django.t.taobao.com,0,0.00%,2,2,0.00%
us1-2.nigirocloud.com,0,0.00%,19,19,0.00%
gsp10-ssl.ls.apple.com,0,0.00%,2,2,0.00%
stream.cadmore.media,0,0.00%,5,5,0.00%
v2.cs3.duba.net,0,0.00%,30,30,0.00%
c.pc.qq.com,0,0.00%,16,16,0.00%
tags.tiqcdn.com,0,0.00%,7,7,0.00%
w.usabilla.com,0,0.00%,8,8,0.00%
loadus.exelator.com,0,0.00%,4,4,0.00%
ps.eyeota.net,0,0.00%,6,6,0.00%
amp-api-edge.apps.apple.com,0,0.00%,10,10,0.00%
sync-tm.everesttech.net,0,0.00%,2,2,0.00%
wss.app.yinxiang.com,0,0.00%,9,9,0.00%
docs.qq.com,0,0.00%,45,45,0.00%
smetrics-ieeexplore.ieee.org,0,0.00%,6,6,0.00%
mariadb.org,0,0.00%,3,3,0.00%
to.snipaste.com,0,0.00%,2,2,0.00%
s.symcb.com,0,0.00%,13,13,0.00%
465fe81be1b5cc4f9a8c4f8553cfa7cd.dlied1.cdntips.net,0,0.00%,4,4,0.00%
cloudfont.docer.wps.cn,0,0.00%,4,4,0.00%
client.docer.wps.cn,0,0.00%,8,8,0.00%
tradenavigator2.18.cn,0,0.00%,2,2,0.00%
h.m.mpl.dutils.com,0,0.00%,8,8,0.00%
2a7ae868aaf63974d41c2ea4bf0d321e.dlied1.cdntips.net,0,0.00%,2,2,0.00%
ali-stats.jpush.cn,0,0.00%,8,8,0.00%
api.fd.mob.com,0,0.00%,6,6,0.00%
probe.eastmoney.com,0,0.00%,4,4,0.00%
appserverlistal.eastmoney.com,0,0.00%,2,2,0.00%
codedictdata.eastmoney.com,0,0.00%,3,3,0.00%
nhtradegateway.18.cn,0,0.00%,2,2,0.00%
emdcmessage.18.cn,0,0.00%,2,2,0.00%
tradenotice.18.cn,0,0.00%,4,4,0.00%
emimpcpf.eastmoney.com,0,0.00%,10,10,0.00%
bdstatics.eastmoney.com,0,0.00%,8,8,0.00%
bdwblog.eastmoney.com,0,0.00%,8,8,0.00%
ssl.google-analytics.com,0,0.00%,13,13,0.00%
router4.teamviewer.com,0,0.00%,49,49,0.00%
onedriveclucproddm20018.blob.core.windows.net,0,0.00%,6,6,0.00%
listlog.baofeng.net,0,0.00%,1,1,0.00%
redirect.kaspersky.com,0,0.00%,8,8,0.00%
edgetippingservice.webxtsvc.microsoft.com,0,0.00%,4,4,0.00%
tracker.torrentsnows.com,0,0.00%,2,2,0.00%
tracker1.520.jp,0,0.00%,4,4,0.00%
bigfoot1942.sektori.org,0,0.00%,2,2,0.00%
public.publictracker.xyz,0,0.00%,2,2,0.00%
public.tracker.vraphim.com,0,0.00%,2,2,0.00%
config.push.sogou.com,0,0.00%,1,1,0.00%
seedbay.net,0,0.00%,2,2,0.00%
cloudflarestream.com,0,0.00%,10,10,0.00%
rd-service-gobfe.e.shifen.com,0,0.00%,2,2,0.00%
tr.greenhat.be,0,0.00%,2,2,0.00%
tracker.army,0,0.00%,2,2,0.00%
tracker.pomf.se,0,0.00%,2,2,0.00%
open.stealth.si,0,0.00%,2,2,0.00%
ort.stsdk.vivo.com.cn,0,0.00%,2,2,0.00%
flow.logitech.io,0,0.00%,6,6,0.00%
schemastore.azurewebsites.net,0,0.00%,1,1,0.00%
tracker.loligirl.cn,0,0.00%,4,4,0.00%
secure.pow7.com,0,0.00%,9,9,0.00%
api.ultimaker.com,0,0.00%,18,18,0.00%
mccontacts.mail.163.com,0,0.00%,14,14,0.00%
array613.prod.do.dsp.mp.microsoft.com,0,0.00%,3,3,0.00%
share.camoe.cn,0,0.00%,18,18,0.00%
clients.config.office.net,0,0.00%,14,14,0.00%
r3---sn-2x3elnel.gvt1.com,0,0.00%,4,4,0.00%
ten.sngapm.qq.com,0,0.00%,4,4,0.00%
opentracker.cc,0,0.00%,6,6,0.00%
report.meeting.tencent.com,0,0.00%,10,10,0.00%
nodestore-kiros-prod-lb-132549143.us-east-1.elb.amazonaws.com,0,0.00%,25,25,0.00%
am.abc.wdpdk.link,0,0.00%,27,27,0.00%
search.kuwo.cn,0,0.00%,20,20,0.00%
www.jianshu.com,0,0.00%,6,6,0.00%
shiyd.cn,0,0.00%,6,6,0.00%
weapp.cloud.tencent.com,0,0.00%,1,1,0.00%
fanyi.baidu.com,0,0.00%,24,24,0.00%
ipv4announce.sktorrent.eu,0,0.00%,2,2,0.00%
filehelper.weixin.qq.com,0,0.00%,28,28,0.00%
nsp-hicloud-cloudbackupnorth4-p01-drcn.obs.cn-north-4.myhuaweicloud.cn,0,0.00%,2,2,0.00%
pdcweb.micloud.xiaomi.net,0,0.00%,8,8,0.00%
nsp-hicloud-cloudbackupnorth4-p03-drcn.obs.cn-north-4.myhuaweicloud.com,0,0.00%,1,1,0.00%
nsp-hicloud-cloudphotonorth4-p03-drcn.obs.cn-north-4.myhuaweicloud.cn,0,0.00%,2,2,0.00%
nsp-hicloud-cloudphotonorth4-p03-drcn.obs.cn-north-4.myhuaweicloud.com,0,0.00%,3,3,0.00%
nsp-hicloud-cloudphotonorth4-p02-drcn.obs.cn-north-4.myhuaweicloud.cn,0,0.00%,3,3,0.00%
v1-play.log.mgtv.com,0,0.00%,2,2,0.00%
math.jianshu.com,0,0.00%,2,2,0.00%
nat-port-1.verysync.cn,0,0.00%,1,1,0.00%
a-ring-fallback.msedge.net,0,0.00%,6,6,0.00%
c-ring.msedge.net,0,0.00%,12,12,0.00%
ea390e023e9ea301e0133c8d87bcd7cd.clo.footprintdns.com,0,0.00%,2,2,0.00%
m.sohu.com,0,0.00%,1,1,0.00%
iframe.videodelivery.net,0,0.00%,12,12,0.00%
v1.cnzz.com,0,0.00%,3,3,0.00%
meeting.tencent.com,0,0.00%,12,12,0.00%
c.cnzz.com,0,0.00%,16,16,0.00%
z6.cnzz.com,0,0.00%,4,4,0.00%
cnzz.mmstat.com,0,0.00%,12,12,0.00%
quic.conn.wemeet.qq.com,0,0.00%,4,4,0.00%
uconf.f.360.cn,0,0.00%,3,3,0.00%
trakx.herokuapp.com,0,0.00%,2,2,0.00%
frp.zwlin.top,0,0.00%,6,6,0.00%
jubao.qq.com,0,0.00%,4,4,0.00%
www.worldboxingvideoarchive.com,0,0.00%,1,1,0.00%
insight.cloud.tencent.com,0,0.00%,1,1,0.00%
tracker.fixr.pro,0,0.00%,14,14,0.00%
alt3-mtalk.google.com,0,0.00%,3,3,0.00%
fp-vp.azureedge.net,0,0.00%,3,3,0.00%
ocsp.godaddy.com,0,0.00%,10,10,0.00%
plugins.zhile.io,0,0.00%,2,2,0.00%
matomo.360eol.com,0,0.00%,61,61,0.00%
www.pythonheidong.com,0,0.00%,2,2,0.00%
cdn.bootcss.com,0,0.00%,2,2,0.00%
nodejs1.yunduoketang.com,0,0.00%,2,2,0.00%
mlog.meituan.com,0,0.00%,4,4,0.00%
mmhead.c2c.wechat.com,0,0.00%,3,3,0.00%
mmsns.c2c.wechat.com,0,0.00%,4,4,0.00%
onedriveclucprodbn20004.blob.core.windows.net,0,0.00%,3,3,0.00%
onedriveclucproddm20027.blob.core.windows.net,0,0.00%,13,13,0.00%
update-pcsafe.2345.cc,0,0.00%,3,3,0.00%
p9.qhimg.com,0,0.00%,4,4,0.00%
remarq.scienceconnect.io,0,0.00%,8,8,0.00%
s5.cnzz.com,0,0.00%,2,2,0.00%
na1e.services.adobe.com,0,0.00%,1,1,0.00%
analytics.map.qq.com,0,0.00%,2,2,0.00%
main.qcloudimg.com,0,0.00%,1,1,0.00%
buy.cloud.tencent.com,0,0.00%,1,1,0.00%
tracker.corpscorp.online,0,0.00%,4,4,0.00%
cloud.tencent.com,0,0.00%,1,1,0.00%
work.medialab.qq.com,0,0.00%,4,4,0.00%
ii.gdt.qq.com,0,0.00%,1,1,0.00%
ping3.teamviewer.com,0,0.00%,28,28,0.00%
api.statistics.tobii.com,0,0.00%,1,1,0.00%
vip-rec.ksord.com,0,0.00%,8,8,0.00%
mvgroup.org,0,0.00%,2,2,0.00%
sukebei.tracker.wf,0,0.00%,3,3,0.00%
tracker.trancetraffic.com,0,0.00%,2,2,0.00%
alloyreport.cdn-go.cn,0,0.00%,1,1,0.00%
augloop.office.com,0,0.00%,5,5,0.00%
vor479806228.cdn.xiaodutvcdn.com,0,0.00%,2,2,0.00%
notifier.win-rar.com,0,0.00%,1,1,0.00%
e.thsi.cn,0,0.00%,2,2,0.00%
yd.9669.me,0,0.00%,2,2,0.00%
api.xiaoheihe.cn,0,0.00%,4,4,0.00%
data.xiaoheihe.cn,0,0.00%,4,4,0.00%
pudn-static.oss-cn-beijing.aliyuncs.com,0,0.00%,2,2,0.00%
dblp.uni-trier.de,0,0.00%,2,2,0.00%
agdist-api.cloud.huawei.com,0,0.00%,6,6,0.00%
static2.51cto.com,0,0.00%,2,2,0.00%
blog.51cto.com,0,0.00%,4,4,0.00%
s2.51cto.com,0,0.00%,1,1,0.00%
shavar.services.mozilla.com,0,0.00%,24,24,0.00%
shavar.prod.mozaws.net,0,0.00%,18,18,0.00%
quay.io,0,0.00%,9,9,0.00%
ms.jr.jd.com,0,0.00%,1,1,0.00%
greasyfork.org,0,0.00%,1,1,0.00%
c.clarity.ms,0,0.00%,3,3,0.00%
fd.api.iris.microsoft.com,0,0.00%,12,12,0.00%
ucenter.51cto.com,0,0.00%,2,2,0.00%
collect-v6.51.la,0,0.00%,3,3,0.00%
s1.51cto.com,0,0.00%,1,1,0.00%
www.sobot.com,0,0.00%,2,2,0.00%
popup.browser.360.cn,0,0.00%,1,1,0.00%
api.zhaomishijie.com,0,0.00%,1,1,0.00%
papi.look.360.cn,0,0.00%,4,4,0.00%
connect.facebook.net,0,0.00%,2,2,0.00%
open.onebox.so.com,0,0.00%,2,2,0.00%
onedriveclucprodbn20010.blob.core.windows.net,0,0.00%,9,9,0.00%
onedriveclucproddm20008.blob.core.windows.net,0,0.00%,10,10,0.00%
p4.qhimg.com,0,0.00%,2,2,0.00%
sc.51cto.com,0,0.00%,1,1,0.00%
jwxk.ucas.ac.cn,0,0.00%,10,10,0.00%
stat.lianmeng.360.cn,0,0.00%,3,3,0.00%
sfstat.lianmeng.360.cn,0,0.00%,6,6,0.00%
query.rec.360.cn,0,0.00%,1,1,0.00%
imws.sobot.com,0,0.00%,2,2,0.00%
crumb.sobot.com,0,0.00%,2,2,0.00%
p0.img.360kuai.com,0,0.00%,1,1,0.00%
p1.img.360kuai.com,0,0.00%,1,1,0.00%
p0.ssl.img.360kuai.com,0,0.00%,1,1,0.00%
api.mixpanel.com,0,0.00%,10,10,0.00%
runc.myddns.cyou,0,0.00%,1,1,0.00%
xyk.cmbchina.com,0,0.00%,2,2,0.00%
interface.bilibili.com,0,0.00%,4,4,0.00%
static.cc.cmbimg.com,0,0.00%,1,1,0.00%
mars.ccc.cmbchina.com,0,0.00%,2,2,0.00%
sdc.cmbchina.com,0,0.00%,2,2,0.00%
b687f84d5942485a9ddb976a67e9cf4a.fp.measure.office.com,0,0.00%,1,1,0.00%
smtp.flawcra.cc,0,0.00%,2,2,0.00%
yuri-websocket-serve.app.kdsec.org,0,0.00%,3,3,0.00%
pc-diffpack.wps.cn,0,0.00%,5,5,0.00%
fp-afd-nocache-ccp.azureedge.net,0,0.00%,5,5,0.00%
google.cn,0,0.00%,4,4,0.00%
applog.lanxin.cn,0,0.00%,2,2,0.00%
web-player-tracker.biliapi.net,0,0.00%,2,2,0.00%
tracker.exorditech.com.tr,0,0.00%,2,2,0.00%
tracker.iamhansen.xyz,0,0.00%,2,2,0.00%
live.bilibili.com,0,0.00%,3,3,0.00%
pan.cstcloud.cn,0,0.00%,3,3,0.00%
pv.sohu.com,0,0.00%,13,13,0.00%
free.zhiyunwenxian.cn,0,0.00%,2,2,0.00%
gslb.xcloud.sandai.net,0,0.00%,7,7,0.00%
d1--cn-gotcha208.bilivideo.com,0,0.00%,2,2,0.00%
tx-gz-live-p2p-backup1.chat.bilibili.com,0,0.00%,2,2,0.00%
stun-1.chat.bilibili.com,0,0.00%,2,2,0.00%
stun-2.chat.bilibili.com,0,0.00%,2,2,0.00%
tx-bj-live-comet-03.chat.bilibili.com,0,0.00%,1,1,0.00%
stun.chat.bilibili.com,0,0.00%,9,9,0.00%
d.docs.live.net,0,0.00%,17,17,0.00%
www.nwfsc.noaa.gov,0,0.00%,1,1,0.00%
lh3.googleusercontent.com,0,0.00%,2,2,0.00%
chatwoot.unity.cn,0,0.00%,1,1,0.00%
data.bilivideo.com,0,0.00%,10,10,0.00%
tracker.internetwarriors.net,0,0.00%,4,4,0.00%
onedscolprdaus02.australiasoutheast.cloudapp.azure.com,0,0.00%,4,4,0.00%
q.cnblogs.com,0,0.00%,20,20,0.00%
www.onenote.com,0,0.00%,4,4,0.00%
domainask.weibanio.cn,0,0.00%,15,15,0.00%
array801.prod.do.dsp.mp.microsoft.com,0,0.00%,12,12,0.00%
app4.i4.cn,0,0.00%,4,4,0.00%
hub5pnc.hz.sandai.net,0,0.00%,12,12,0.00%
hub5u.hz.sandai.net,0,0.00%,12,12,0.00%
flux.iqiyi.com,0,0.00%,11,11,0.00%
drive.wpsdns.com,0,0.00%,28,28,0.00%
ios.pclog.i4.cn,0,0.00%,7,7,0.00%
rm-2zelg248g7y2034w7do.mysql.rds.aliyuncs.com,0,0.00%,28,28,0.00%
nsp-logservice-hiview-p40-drcn.obs.cn-north-2.myhuaweicloud.com,0,0.00%,11,11,0.00%
bn1305.settings.live.net,0,0.00%,2,2,0.00%
hxhvnih.nyjvbs.xyz,0,0.00%,9,9,0.00%
array813.prod.do.dsp.mp.microsoft.com,0,0.00%,10,10,0.00%
only-738015-124-16-140-6.nstool.zhuanzfx.com,0,0.00%,1,1,0.00%
sdl.360safe.com,0,0.00%,8,8,0.00%
bk.xhcdn.cn,0,0.00%,2,2,0.00%
app.yinxiang.com,0,0.00%,26,26,0.00%
passport.360.cn,0,0.00%,4,4,0.00%
cdata.browser.360.cn,0,0.00%,6,6,0.00%
profile.se.360.cn,0,0.00%,6,6,0.00%
se.score.svc.1360.com,0,0.00%,2,2,0.00%
upext.chrome.360.cn,0,0.00%,14,14,0.00%
seupdate.360safe.com,0,0.00%,13,13,0.00%
ucpop.browser.360.cn,0,0.00%,4,4,0.00%
ext.se.360.cn,0,0.00%,6,6,0.00%
chifsr.lenovomm.com,0,0.00%,2,2,0.00%
api.frdic.com,0,0.00%,2,2,0.00%
events-drcn.op.dbankcloud.com,0,0.00%,2,2,0.00%
m-cloud.zhihu.com,0,0.00%,13,13,0.00%
config.rcs.chinamobile.com,0,0.00%,12,12,0.00%
5gmcsip05.hbq.rcs.chinamobile.com,0,0.00%,2,2,0.00%
tools.3g.qq.com,0,0.00%,14,14,0.00%
feedback.youdao.com,0,0.00%,2,2,0.00%
cgi.connect.qq.com,0,0.00%,12,12,0.00%
url.i4.cn,0,0.00%,6,6,0.00%
d-updater.i4.cn,0,0.00%,2,2,0.00%
recycle.i5.cn,0,0.00%,10,10,0.00%
www.bagevent.com,0,0.00%,2,2,0.00%
ali-bj-pcdn-10.biliapi.net,0,0.00%,2,2,0.00%
music.ntes53.netease.com,0,0.00%,4,4,0.00%
weatherapi.market.xiaomi.com,0,0.00%,4,4,0.00%
odc.officeapps.live.com,0,0.00%,3,3,0.00%
webmail.iscas.ac.cn,0,0.00%,2,2,0.00%
home.mi.com,0,0.00%,2,2,0.00%
intouch.ebz.epson.net,0,0.00%,1,1,0.00%
recom.cnki.net,0,0.00%,2,2,0.00%
php.qchannel03.cn,0,0.00%,2,2,0.00%
njsfdxgckj.paperonce.org,0,0.00%,1,1,0.00%
dx.doi.org,0,0.00%,2,2,0.00%
s.pcmgr.qq.com,0,0.00%,2,2,0.00%
pc3.gtimg.com,0,0.00%,2,2,0.00%
sdi.m.qq.com,0,0.00%,2,2,0.00%
isdspeed.qq.com,0,0.00%,1,1,0.00%
sdi.3g.qq.com,0,0.00%,2,2,0.00%
jsonproxy.3g.qq.com,0,0.00%,2,2,0.00%
da.xboxservices.com,0,0.00%,2,2,0.00%
stats.jpush.cn,0,0.00%,2,2,0.00%
s.xiaohongshu.com,0,0.00%,2,2,0.00%
gsp64-ssl.ls-apple.com.akadns.net,0,0.00%,20,20,0.00%
pmir.m.qq.com,0,0.00%,2,2,0.00%
tmfmazu4.m.qq.com,0,0.00%,4,4,0.00%
qex.conf.f.360.cn,0,0.00%,4,4,0.00%
cbi.touch4.me,0,0.00%,2,2,0.00%
iploc.ywdier.com,0,0.00%,2,2,0.00%
market.touch4.me,0,0.00%,2,2,0.00%
open1ddz.nalrer.cn,0,0.00%,2,2,0.00%
ddz12wss.nalrer.cn,0,0.00%,2,2,0.00%
www.cloudflare.com,0,0.00%,16,16,0.00%
long.wxagame.weixin.qq.com,0,0.00%,2,2,0.00%
servicewechat.com,0,0.00%,2,2,0.00%
font.docer.wps.cn,0,0.00%,2,2,0.00%
tile-service.weather.msn.cn,0,0.00%,8,8,0.00%
ns-59-c.gandi.net,0,0.00%,2,2,0.00%
ns2.site4now.net,0,0.00%,12,12,0.00%
ns1.site4now.net,0,0.00%,12,12,0.00%
wappass.baidu.com,0,0.00%,5,5,0.00%
dns1.namebay.com,0,0.00%,10,10,0.00%
ns-6-a.gandi.net,0,0.00%,2,2,0.00%
f1g1ns2.dnspod.net,0,0.00%,36,36,0.00%
sunny.ns.cloudflare.com,0,0.00%,4,4,0.00%
wkctj.baidu.com,0,0.00%,4,4,0.00%
ns1.c016jp9160.info,0,0.00%,2,2,0.00%
tpa-hcdn.iqiyi.com,0,0.00%,2,2,0.00%
v-2a38440b.71edge.com,0,0.00%,2,2,0.00%
nur.hupu.com,0,0.00%,4,4,0.00%
rinjani.cloudhost.id,0,0.00%,2,2,0.00%
ns1.auzit.net,0,0.00%,4,4,0.00%
wkdsp.baidu.com,0,0.00%,4,4,0.00%
ns2.auzit.net,0,0.00%,4,4,0.00%
92meifa.com,0,0.00%,1,1,0.00%
www.safedog.cn,0,0.00%,8,8,0.00%
api.browser.miui.com,0,0.00%,4,4,0.00%
hnjiajiafu.com,0,0.00%,2,2,0.00%
tjmjsk.com,0,0.00%,2,2,0.00%
sm-sy.com,0,0.00%,2,2,0.00%
7jmrbtrvkgcqkldzyob4kotpyvsgz546yvik2xv4rpnfmrhe4imxthqd.tor2web.in,0,0.00%,4,4,0.00%
twelfth.dnspod.net,0,0.00%,2,2,0.00%
ns2jqz.name.com,0,0.00%,6,6,0.00%
ns3fqs.name.com,0,0.00%,4,4,0.00%
virgo.dnspod.net,0,0.00%,2,2,0.00%
ns1.domesticmodern.com,0,0.00%,2,2,0.00%
ns4kpx.name.com,0,0.00%,4,4,0.00%
ns-252-b.gandi.net,0,0.00%,4,4,0.00%
ns15.xincache.com,0,0.00%,12,12,0.00%
yichun.ns.cloudflare.com,0,0.00%,10,10,0.00%
ns16.xincache.com,0,0.00%,12,12,0.00%
ns1.domaindiscount24.net,0,0.00%,4,4,0.00%
dyjhrl.com,0,0.00%,2,2,0.00%
drew.ns.cloudflare.com,0,0.00%,2,2,0.00%
laylah.ns.cloudflare.com,0,0.00%,2,2,0.00%
minor-api.mihoyo.com,0,0.00%,6,6,0.00%
cs83.hostingberry.com,0,0.00%,2,2,0.00%
cs83.hostneverdie.com,0,0.00%,2,2,0.00%
education.github.com,0,0.00%,2,2,0.00%
ns196.rapidenet.ca,0,0.00%,2,2,0.00%
ns197.rapidenet.ca,0,0.00%,2,2,0.00%
appU543202558809.api.steamgamepowered.net,0,0.00%,6,6,0.00%
service1.parsdata.com,0,0.00%,2,2,0.00%
im64.jpush.cn,0,0.00%,2,2,0.00%
llanenet.com,0,0.00%,1,1,0.00%
dldcvip.com,0,0.00%,1,1,0.00%
wxjmsj.com,0,0.00%,1,1,0.00%
prtas.videocc.net,0,0.00%,2,2,0.00%
fi.doh.dns.snopyta.org,0,0.00%,8,8,0.00%
shoppingcampaigns-api-drcn.ai.dbankcloud.com,0,0.00%,4,4,0.00%
hutubin.com,0,0.00%,2,2,0.00%
api.panawyt.xyz,0,0.00%,2,2,0.00%
api.bitbucket.org,0,0.00%,4,4,0.00%
ns-1390.awsdns-45.org,0,0.00%,2,2,0.00%
ns2.canaca.net,0,0.00%,4,4,0.00%
ns-1578.awsdns-05.co.uk,0,0.00%,2,2,0.00%
ns-182.awsdns-22.com,0,0.00%,4,4,0.00%
a.dns.gandi.net,0,0.00%,16,16,0.00%
lingangyuanyi.com,0,0.00%,2,2,0.00%
b.dns.gandi.net,0,0.00%,16,16,0.00%
ns-561.awsdns-06.net,0,0.00%,2,2,0.00%
c.dns.gandi.net,0,0.00%,16,16,0.00%
shanxuewang.com,0,0.00%,2,2,0.00%
ns.canaca.net,0,0.00%,4,4,0.00%
dns27.hichina.com,0,0.00%,22,22,0.00%
developer.atlassian.com,0,0.00%,4,4,0.00%
olga.ns.cloudflare.com,0,0.00%,22,22,0.00%
bespoke-analytics.razerapi.com,0,0.00%,2,2,0.00%
dns2.stabletransit.com,0,0.00%,4,4,0.00%
metallerie-malingue.com,0,0.00%,2,2,0.00%
grace.ns.cloudflare.com,0,0.00%,10,10,0.00%
ns2.zonomi.com,0,0.00%,4,4,0.00%
ns1.zonomi.com,0,0.00%,8,8,0.00%
ns2.centos-webpanel.com,0,0.00%,2,2,0.00%
ns69.domaincontrol.com,0,0.00%,2,2,0.00%
ns1055.ui-dns.de,0,0.00%,4,4,0.00%
ns1.centos-webpanel.com,0,0.00%,2,2,0.00%
fanghu.qianxin.com,0,0.00%,2,2,0.00%
static.wenshubang.com,0,0.00%,2,2,0.00%
a.9136.com,0,0.00%,2,2,0.00%
bd.ahsrst.cn,0,0.00%,1,1,0.00%
ns35.hostjett.com,0,0.00%,2,2,0.00%
newsinfo.eastmoney.com,0,0.00%,4,4,0.00%
szxdzjt.com,0,0.00%,1,1,0.00%
volumein1.com,0,0.00%,1,1,0.00%
gwhjbh.com,0,0.00%,1,1,0.00%
same.eastmoney.com,0,0.00%,4,4,0.00%
gbfek.eastmoney.com,0,0.00%,4,4,0.00%
38.newspush.eastmoney.com,0,0.00%,2,2,0.00%
bdstatic.eastmoney.com,0,0.00%,4,4,0.00%
hk4e-api.mihoyo.com,0,0.00%,2,2,0.00%
myfavor.eastmoney.com,0,0.00%,6,6,0.00%
11.newspush.eastmoney.com,0,0.00%,2,2,0.00%
abc.ahsrst.cn,0,0.00%,2,2,0.00%
np-listapi.eastmoney.com,0,0.00%,4,4,0.00%
ns-18-b.gandi.net,0,0.00%,2,2,0.00%
f20fe36.pf.gladns.com,0,0.00%,8,8,0.00%
wxtjws.com,0,0.00%,2,2,0.00%
huaxiang.eastmoney.com,0,0.00%,4,4,0.00%
17.push2.eastmoney.com,0,0.00%,2,2,0.00%
43.push2.eastmoney.com,0,0.00%,2,2,0.00%
78.push2.eastmoney.com,0,0.00%,2,2,0.00%
data.video.iqiyi.com,0,0.00%,1,1,0.00%
14.newspush.eastmoney.com,0,0.00%,2,2,0.00%
szrg56.com,0,0.00%,2,2,0.00%
recommend.eastmoney.com,0,0.00%,2,2,0.00%
86.push2.eastmoney.com,0,0.00%,2,2,0.00%
qiyugas.com,0,0.00%,2,2,0.00%
32.newspush.eastmoney.com,0,0.00%,4,4,0.00%
cnc.quickconnect.cn,0,0.00%,4,4,0.00%
47.push2.eastmoney.com,0,0.00%,2,2,0.00%
mask-canary.icloud.com,0,0.00%,3,3,0.00%
83.newspush.eastmoney.com,0,0.00%,2,2,0.00%
73.newspush.eastmoney.com,0,0.00%,2,2,0.00%
63.newspush.eastmoney.com,0,0.00%,2,2,0.00%
7.newspush.eastmoney.com,0,0.00%,2,2,0.00%
jp03-vm0.entry.srthdw.art,0,0.00%,11,11,0.00%
ifacelog.iqiyi.com,0,0.00%,2,2,0.00%
pinxuzdh.com,0,0.00%,2,2,0.00%
files.pfsense.org,0,0.00%,6,6,0.00%
ns-18-a.gandi.net,0,0.00%,2,2,0.00%
ns-108-c.gandi.net,0,0.00%,2,2,0.00%
vote.eastmoney.com,0,0.00%,4,4,0.00%
80.newspush.eastmoney.com,0,0.00%,2,2,0.00%
27.newspush.eastmoney.com,0,0.00%,1,1,0.00%
6.push2his.eastmoney.com,0,0.00%,4,4,0.00%
reportapi.eastmoney.com,0,0.00%,4,4,0.00%
ns1.llocweb.info,0,0.00%,2,2,0.00%
www.89ip.cn,0,0.00%,10,10,0.00%
82.push2his.eastmoney.com,0,0.00%,4,4,0.00%
ns2.llocweb.info,0,0.00%,2,2,0.00%
verification-1815a6e5.ns3.dan.hosting,0,0.00%,6,6,0.00%
ada.ns.cloudflare.com,0,0.00%,6,6,0.00%
ns-1513.awsdns-61.org,0,0.00%,2,2,0.00%
elias.ns.cloudflare.com,0,0.00%,4,4,0.00%
ns7.binero.se,0,0.00%,6,6,0.00%
paige.ns.cloudflare.com,0,0.00%,4,4,0.00%
brenda.ns.cloudflare.com,0,0.00%,10,10,0.00%
ns2.syd2.hostyourservices.net,0,0.00%,2,2,0.00%
brodie.ns.cloudflare.com,0,0.00%,4,4,0.00%
ns2.289945.cloudns.net,0,0.00%,8,8,0.00%
b.dns.hostway.net,0,0.00%,12,12,0.00%
ns1.289945.cloudns.net,0,0.00%,8,8,0.00%
a.dns.hostway.net,0,0.00%,12,12,0.00%
bscricket.com,0,0.00%,2,2,0.00%
19261.bodis.com,0,0.00%,2,2,0.00%
paopao.iqiyi.com,0,0.00%,2,2,0.00%
b32f015b18b6bf83cdb52b1aa3f2d0f3.clo.footprintdns.com,0,0.00%,1,1,0.00%
dns1.privacy-dns.com,0,0.00%,2,2,0.00%
ns1.pornbeko.com,0,0.00%,2,2,0.00%
ns6164.hostgator.com,0,0.00%,2,2,0.00%
ns1.dotster.com,0,0.00%,6,6,0.00%
ns2.dotster.com,0,0.00%,6,6,0.00%
cns1.sedoparking.com,0,0.00%,6,6,0.00%
cns2.sedoparking.com,0,0.00%,6,6,0.00%
ns2.pornbeko.com,0,0.00%,2,2,0.00%
dns2.namebay.com,0,0.00%,10,10,0.00%
dns2.privacy-dns.com,0,0.00%,2,2,0.00%
41.newspush.eastmoney.com,0,0.00%,2,2,0.00%
weicolog.api.weibo.cn,0,0.00%,4,4,0.00%
22234796869649f9b67c167268952e4b.fp.measure.office.com,0,0.00%,1,1,0.00%
ns1.liqu.id,0,0.00%,6,6,0.00%
pdns11.domaincontrol.com,0,0.00%,12,12,0.00%
ns1066.ui-dns.de,0,0.00%,2,2,0.00%
pdns104.ultradns.org,0,0.00%,6,6,0.00%
ns4919.banahosting.com,0,0.00%,2,2,0.00%
ns2.liqu.id,0,0.00%,6,6,0.00%
ns4918.banahosting.com,0,0.00%,2,2,0.00%
ns2.xtrafdns.com,0,0.00%,2,2,0.00%
hydrogen.ns.hetzner.com,0,0.00%,6,6,0.00%
verification-jzrysn71.ns3.dan.hosting,0,0.00%,2,2,0.00%
oxygen.ns.hetzner.com,0,0.00%,6,6,0.00%
ns1053.ui-dns.biz,0,0.00%,22,22,0.00%
leo.ns.cloudflare.com,0,0.00%,6,6,0.00%
ns2.c019jp7984.info,0,0.00%,2,2,0.00%
ns1.xtrafdns.com,0,0.00%,2,2,0.00%
ns1.c019jp7984.info,0,0.00%,2,2,0.00%
ns1106.ui-dns.org,0,0.00%,2,2,0.00%
helium.ns.hetzner.de,0,0.00%,6,6,0.00%
stevie.ns.cloudflare.com,0,0.00%,4,4,0.00%
ns2.fortresscolo.com,0,0.00%,2,2,0.00%
ns3.domaindiscount24.net,0,0.00%,4,4,0.00%
sat02pap005.storage.live.com,0,0.00%,7,7,0.00%
slp2p-east-std1033.oray.net,0,0.00%,4,4,0.00%
slp2px-east-std31.oray.net,0,0.00%,6,6,0.00%
ynuf.alipay.com,0,0.00%,10,10,0.00%
tips.ime.baidu.com,0,0.00%,5,5,0.00%
up.vipguanjia.net,0,0.00%,20,20,0.00%
statclient.baidu.com,0,0.00%,2,2,0.00%
mirrors.ustc.edu.cn,0,0.00%,10,10,0.00%
mailhz.qiye.163.com,0,0.00%,6,6,0.00%
pop.ie.sogou.com,0,0.00%,6,6,0.00%
pop.ym.163.com,0,0.00%,12,12,0.00%
onedriveclucproddm20025.blob.core.windows.net,0,0.00%,2,2,0.00%
weby.aaas.org,0,0.00%,8,8,0.00%
szcloud.baidu.com,0,0.00%,4,4,0.00%
acctcdnvzeuno.azureedge.net,0,0.00%,2,2,0.00%
onedriveclucproddm20044.blob.core.windows.net,0,0.00%,10,10,0.00%
xfer.10jqka.com.cn,0,0.00%,4,4,0.00%
router9.teamviewer.com,0,0.00%,24,24,0.00%
polka.typekit.com,0,0.00%,8,8,0.00%
cn-zjcm2.testfaj.top,0,0.00%,18,18,0.00%
clientstream.launchdarkly.com,0,0.00%,16,16,0.00%
imap.cstnet.cn,0,0.00%,14,14,0.00%
p216-imap.mail.icloud.com.cn,0,0.00%,4,4,0.00%
pop.exmail.qq.com,0,0.00%,14,14,0.00%
team-speed-cdn-vip.xunlei.com,0,0.00%,9,9,0.00%
cdp.cloud.unity3d.com,0,0.00%,18,18,0.00%
onedriveclucproddm20026.blob.core.windows.net,0,0.00%,6,6,0.00%
router7.teamviewer.com,0,0.00%,20,20,0.00%
onedriveclucprodbn20021.blob.core.windows.net,0,0.00%,11,11,0.00%
speeddials.opera.com,0,0.00%,4,4,0.00%
sg-feed.r-tb.com,0,0.00%,12,12,0.00%
t.ocmhood.com,0,0.00%,12,12,0.00%
sg-t.r-tb.net,0,0.00%,8,8,0.00%
image.mndsrv.com,0,0.00%,4,4,0.00%
icon.mndsrv.com,0,0.00%,4,4,0.00%
cdn3.mndsrv.com,0,0.00%,4,4,0.00%
livejs1.gifshow.com,0,0.00%,2,2,0.00%
pcoma.qq.com,0,0.00%,46,46,0.00%
router3.teamviewer.com,0,0.00%,20,20,0.00%
crl.comodoca.com,0,0.00%,34,34,0.00%
s4.torrentstream.net,0,0.00%,2,2,0.00%
launcher.store.epicgames.com,0,0.00%,6,6,0.00%
tiny.china.qiniu.com.trpcdn.NET,0,0.00%,2,2,0.00%
beacons4.gvt2.com,0,0.00%,13,13,0.00%
doi.cnjournals.com,0,0.00%,4,4,0.00%
d.wn51.com,0,0.00%,20,20,0.00%
pcmgr-cdn.vipguanjia.net,0,0.00%,14,14,0.00%
data.vipguanjia.net,0,0.00%,18,18,0.00%
g-api.kwai.com,0,0.00%,1,1,0.00%
embed.cloudflarestream.com,0,0.00%,5,5,0.00%
onedriveclucproddm20023.blob.core.windows.net,0,0.00%,10,10,0.00%
bk.ps2.gamedl.qq.com,0,0.00%,8,8,0.00%
ct.vipguanjia.net,0,0.00%,6,6,0.00%
vip-pcmgr.vipguanjia.net,0,0.00%,6,6,0.00%
onedriveclucproddm20007.blob.core.windows.net,0,0.00%,6,6,0.00%
article.cnjournals.com,0,0.00%,8,8,0.00%
api.weixin.qq.com,0,0.00%,7,7,0.00%
yuncl-zs.51fapiao.cn,0,0.00%,6,6,0.00%
api.tabnine.com,0,0.00%,18,18,0.00%
apu-chin.htccomm.com.cn,0,0.00%,2,2,0.00%
helpinfockeniu1.ksmobile.com,0,0.00%,8,8,0.00%
be59399.pb.gladns.com,0,0.00%,14,14,0.00%
tm-sdk.platinumai.net,0,0.00%,8,8,0.00%
globalconfig.flashlightproxy.com,0,0.00%,4,4,0.00%
pop3.aliyun.com,0,0.00%,4,4,0.00%
slp2p-east-std61.oray.net,0,0.00%,5,5,0.00%
f062936a96d3c8bd.jijifun.com,0,0.00%,14,14,0.00%
5570f1ee738c40c4955062e9026850f0.fp.measure.office.com,0,0.00%,1,1,0.00%
waconatm.officeapps.live.com,0,0.00%,10,10,0.00%
asia.odcsm1.live.com.akadns.net,0,0.00%,2,2,0.00%
p208-caldav.icloud.com.cn,0,0.00%,4,4,0.00%
p208-contacts.icloud.com.cn,0,0.00%,4,4,0.00%
caldav.fe.apple-dns.cn,0,0.00%,18,18,0.00%
v2-mg02.kwaicdn.com,0,0.00%,4,4,0.00%
nebula.kuaishou.com,0,0.00%,4,4,0.00%
log-sdk.ksapisrv.com,0,0.00%,2,2,0.00%
kds.wps.cn,0,0.00%,8,8,0.00%
5gmcsip04.hbq.rcs.chinamobile.com,0,0.00%,10,10,0.00%
www.kuaijinniu.com,0,0.00%,2,2,0.00%
api.kuaishouzt.com,0,0.00%,2,2,0.00%
broker.mqtt.pandora.xiaomi.com,0,0.00%,4,4,0.00%
stat.pandora.xiaomi.com,0,0.00%,4,4,0.00%
p205-contacts.icloud.com.cn,0,0.00%,6,6,0.00%
onedscolprdcus02.centralus.cloudapp.azure.com,0,0.00%,4,4,0.00%
caldav.126.com,0,0.00%,4,4,0.00%
fsrhk.lenovomm.com,0,0.00%,16,16,0.00%
consumer.entitlement.skype.com,0,0.00%,4,4,0.00%
sconsentit9.trafficmanager.net,0,0.00%,4,4,0.00%
sconsentit911.cloudapp.net,0,0.00%,4,4,0.00%
36.courier-push-apple.com.akadns.net,0,0.00%,4,4,0.00%
dns9.360safe.com,0,0.00%,4,4,0.00%
wh.vipguanjia.net,0,0.00%,8,8,0.00%
checkip.synology.com,0,0.00%,8,8,0.00%
checkip.digitalocean.synology.com,0,0.00%,16,16,0.00%
appvolcanoedc.jianguoyun.com,0,0.00%,8,8,0.00%
ns-cmn1.qq.com,0,0.00%,4,4,0.00%
ns-tel1.qq.com,0,0.00%,10,10,0.00%
report.im.qcloud.com,0,0.00%,10,10,0.00%
sadownload-new.mcafee.com.edgekey.net,0,0.00%,8,8,0.00%
ns4-39.azure-dns.info,0,0.00%,2,2,0.00%
e8203.g.akamaiedge.net,0,0.00%,6,6,0.00%
onedscolprdgwc07.germanywestcentral.cloudapp.azure.com,0,0.00%,2,2,0.00%
ns6.ntes53.nease.net,0,0.00%,10,10,0.00%
cname.dict.ntes53.netease.com,0,0.00%,14,14,0.00%
dict.ntes53.netease.com,0,0.00%,14,14,0.00%
scc.bytedance.net,0,0.00%,2,2,0.00%
ns3-35.azure-dns.org,0,0.00%,5,5,0.00%
common-geo.ha.1drv.com,0,0.00%,2,2,0.00%
common-geo.onedrive.trafficmanager.net,0,0.00%,2,2,0.00%
snz04pcor002-com.be.1drv.com,0,0.00%,2,2,0.00%
i-snz04p-cor002.api.p001.1drv.com,0,0.00%,2,2,0.00%
iduxlmv.qiniudns.com,0,0.00%,4,4,0.00%
ns2-07.azure-dns.net,0,0.00%,2,2,0.00%
dc.applicationinsights.microsoft.com,0,0.00%,6,6,0.00%
dc.applicationinsights.azure.com,0,0.00%,6,6,0.00%
ns4-03.azure-dns.info,0,0.00%,4,4,0.00%
ns3-03.azure-dns.org,0,0.00%,4,4,0.00%
global.in.ai.monitor.azure.com,0,0.00%,6,6,0.00%
global.in.ai.privatelink.monitor.azure.com,0,0.00%,6,6,0.00%
dc.trafficmanager.net,0,0.00%,6,6,0.00%
weu010-breeziest-in.cloudapp.net,0,0.00%,4,4,0.00%
settings-prod-cin-1.centralindia.cloudapp.azure.com,0,0.00%,8,8,0.00%
edge.skype.com,0,0.00%,6,6,0.00%
sjy.stream.qqmusic.qq.com.vdncache.com,0,0.00%,10,10,0.00%
ns3.huaweicloud-dns.cn,0,0.00%,12,12,0.00%
ns3.huaweicloud-dns.com,0,0.00%,14,14,0.00%
ns3-34.azure-dns.org,0,0.00%,6,6,0.00%
mail.arubafin.com,0,0.00%,6,6,0.00%
tm2.edgedns-tm.info,0,0.00%,26,26,0.00%
settings-prod-uks-1.uksouth.cloudapp.azure.com,0,0.00%,8,8,0.00%
onedscolprduks01.uksouth.cloudapp.azure.com,0,0.00%,2,2,0.00%
onedscolprdwus00.westus.cloudapp.azure.com,0,0.00%,2,2,0.00%
m6816.talk99.cn,0,0.00%,4,4,0.00%
prod.nexusrules.live.com.akadns.net,0,0.00%,22,22,0.00%
onedscolprdeus09.eastus.cloudapp.azure.com,0,0.00%,6,6,0.00%
prod.odcsm1.live.com.akadns.net,0,0.00%,4,4,0.00%
pancake.g.aaplimg.com,0,0.00%,2,2,0.00%
ace.pgp.wanmei.com,0,0.00%,6,6,0.00%
dns8.360safe.com,0,0.00%,8,8,0.00%
dcbrowser.cqttech.com,0,0.00%,4,4,0.00%
dcbrowser.cqttech.com.w.kunlungr.com,0,0.00%,4,4,0.00%
locini.gslb.360safe.com,0,0.00%,6,6,0.00%
iniupdate.360qhcdn.com,0,0.00%,8,8,0.00%
apidns.kwd.inkuai.com,0,0.00%,2,2,0.00%
ns5-38.azure-dns.com,0,0.00%,4,4,0.00%
settings-prod-scus-2.southcentralus.cloudapp.azure.com,0,0.00%,6,6,0.00%
5kong4.com,0,0.00%,20,20,0.00%
29.courier-push-apple.com.akadns.net,0,0.00%,2,2,0.00%
settings-prod-eus-1.eastus.cloudapp.azure.com,0,0.00%,14,14,0.00%
glacial-ravine-7295.morning-tundra-7160.herokuspace.com,0,0.00%,8,8,0.00%
api.vps315.com,0,0.00%,4,4,0.00%
pccw.test.gotochinatown.net,0,0.00%,2,2,0.00%
hkt.test.gotochinatown.net,0,0.00%,2,2,0.00%
us2.test.gotochinatown.net,0,0.00%,2,2,0.00%
myfavor1.eastmoney.com,0,0.00%,5,5,0.00%
api.ipify.org,0,0.00%,2,2,0.00%
m0.mail.sina.cn,0,0.00%,18,18,0.00%
up.sinastorage.com,0,0.00%,18,18,0.00%
exmail.qq.com,0,0.00%,24,24,0.00%
96e9f497-1d03-494c-b235-80c403797149.apple.com.v.aaplimg.com,0,0.00%,8,8,0.00%
file2.wx.qq.com,0,0.00%,33,33,0.00%
wx2.qq.com,0,0.00%,22,22,0.00%
ocsp.entrust.net.edgekey.net,0,0.00%,34,34,0.00%
p204-caldav.icloud.com.cn,0,0.00%,6,6,0.00%
update.gtm.eset.com,0,0.00%,30,30,0.00%
bgp.netarch-bjlgy-edge-lb-v3.bjlgy.bytedns.net,0,0.00%,6,6,0.00%
xycrx.net,0,0.00%,10,10,0.00%
onedscolprdeus11.eastus.cloudapp.azure.com,0,0.00%,14,14,0.00%
glb.sls.prod.dcat.dsp.trafficmanager.net,0,0.00%,2,2,0.00%
emimpcpf.trafficmanager.cn,0,0.00%,8,8,0.00%
121.t.keepitpumpin.io,0,0.00%,2,2,0.00%
settings-prod-sea-2.southeastasia.cloudapp.azure.com,0,0.00%,10,10,0.00%
onedscolprdcus05.centralus.cloudapp.azure.com,0,0.00%,2,2,0.00%
onedscolprdwus01.westus.cloudapp.azure.com,0,0.00%,9,9,0.00%
sslcom.crl.certum.pl,0,0.00%,3,3,0.00%
10.courier-push-apple.com.akadns.net,0,0.00%,4,4,0.00%
appleid.apple.com,0,0.00%,2,2,0.00%
acc.qq.com,0,0.00%,39,39,0.00%
sf.symcd.com,0,0.00%,5,5,0.00%
sw.symcd.com,0,0.00%,3,3,0.00%
nine.littlenetwork.ml,0,0.00%,1,1,0.00%
wtt.tcpbbr.xyz,0,0.00%,3,3,0.00%
655aa810-rh7400-rilj3b-iz5k.pccw.alrihla.net,0,0.00%,1,1,0.00%
array614.prod.do.dsp.mp.microsoft.com,0,0.00%,11,11,0.00%
ex.exmail.qq.com,0,0.00%,7,7,0.00%
ims-na1.adobelogin.com,0,0.00%,1,1,0.00%
stock.adobe.io,0,0.00%,2,2,0.00%
global.infoapis.com,0,0.00%,5,5,0.00%
teams.events.data.microsoft.com,0,0.00%,18,18,0.00%
cloudpush.iqiyi.com,0,0.00%,8,8,0.00%
imap.exmail.qq.com,0,0.00%,8,8,0.00%
mse.gov.sg,0,0.00%,2,2,0.00%
ns1.sogou.com,0,0.00%,2,2,0.00%
ns2.sogou.com,0,0.00%,2,2,0.00%
today.org.ua,0,0.00%,1,1,0.00%
ts-helper.2345.cc,0,0.00%,6,6,0.00%
msg.iqiyi.com,0,0.00%,8,8,0.00%
www.figma.com,0,0.00%,8,8,0.00%
xz.wn51.com,0,0.00%,10,10,0.00%
mtdlp.sankuai.com,0,0.00%,6,6,0.00%
qiquan.if.iqiyi.com,0,0.00%,2,2,0.00%
mlextshort.weixin.qq.com,0,0.00%,10,10,0.00%
v4-14.hiaoxui.work,0,0.00%,4,4,0.00%
clientnotification-userprodea1-2.servicebus.windows.net,0,0.00%,4,4,0.00%
mail.14alledufreee.ml,0,0.00%,1,1,0.00%
clientnotification-userprodea1-3.servicebus.windows.net,0,0.00%,2,2,0.00%
flbgpi.yixuedianzishu.com,0,0.00%,12,12,0.00%
hj5k.nomade.ga,0,0.00%,1,1,0.00%
appcfg.v.qq.com,0,0.00%,2,2,0.00%
profile.firefox.com.cn,0,0.00%,10,10,0.00%
s17-sync.firefox.com.cn,0,0.00%,2,2,0.00%
api-accounts.firefox.com.cn,0,0.00%,6,6,0.00%
test.memryplus.no,0,0.00%,61,61,0.00%
nn9.boom.skin,0,0.00%,11,11,0.00%
nowpick.nowcoder.com,0,0.00%,24,24,0.00%
CM.SSRSS.CLUB,0,0.00%,2,2,0.00%
delivery.51zmt.net,0,0.00%,2,2,0.00%
chat.google.com,0,0.00%,18,18,0.00%
deault-exp-tas-com.e-0014.e-msedge.NET,0,0.00%,2,2,0.00%
tracker0.ufibox.com,0,0.00%,18,18,0.00%
valakas.rollo.dnsabr.com,0,0.00%,12,12,0.00%
udp.cloud.duba.net,0,0.00%,16,16,0.00%
service.weather.msn.cn,0,0.00%,6,6,0.00%
asbrvuy5eytinisxv7jzno26lererj55ryvomhht6iw7tmcbbyswebid.tor2web.in,0,0.00%,4,4,0.00%
prod.nexusrules.live.com.akadns.NET,0,0.00%,6,6,0.00%
zephir.monocul.us,0,0.00%,12,12,0.00%
clt2.sangfor.com.cn,0,0.00%,20,20,0.00%
isrc.iscas.ac.cn,0,0.00%,22,22,0.00%
server1.yoics.net,0,0.00%,21,21,0.00%
qiao.baidu.com,0,0.00%,13,13,0.00%
nbcache00.baidupcs.com,0,0.00%,17,17,0.00%
pic.263em.com,0,0.00%,13,13,0.00%
teams.microsoft.com,0,0.00%,50,50,0.00%
tr.skype.com,0,0.00%,13,13,0.00%
cn-release-pub-room-gz.lgame.qq.com,0,0.00%,15,15,0.00%
api.weibo.com,0,0.00%,19,19,0.00%
upload.video.sina.com.cn,0,0.00%,18,18,0.00%
fileplatform.api.weibo.com,0,0.00%,16,16,0.00%
api.t.sina.com.cn,0,0.00%,16,16,0.00%
sinaapp.com,0,0.00%,18,18,0.00%
clubajax.autohome.com.cn,0,0.00%,19,19,0.00%
weibo.cn,0,0.00%,23,23,0.00%
youtu.be,0,0.00%,14,14,0.00%
sharepoint.com,0,0.00%,32,32,0.00%
icloud.com,0,0.00%,15,15,0.00%
t.sina.com.cn,0,0.00%,17,17,0.00%
mail.sina.com.cn,0,0.00%,31,31,0.00%
t.showone.com.cn,0,0.00%,19,19,0.00%
t.p4p.sina.com.cn,0,0.00%,18,18,0.00%
www.tianya.cn,0,0.00%,27,27,0.00%
tianya.cn,0,0.00%,16,16,0.00%
autohome.com.cn,0,0.00%,15,15,0.00%
yinxiang.com,0,0.00%,19,19,0.00%
wiz.cn,0,0.00%,16,16,0.00%
doc88.com,0,0.00%,18,18,0.00%
yeah.net,0,0.00%,16,16,0.00%
youtube.googleapis.com,0,0.00%,16,16,0.00%
www.youtube-nocookie.com,0,0.00%,15,15,0.00%
sharefile.com,0,0.00%,12,12,0.00%
sina.com.cn,0,0.00%,16,16,0.00%
qiye.163.com,0,0.00%,16,16,0.00%
mail.10086.cn,0,0.00%,16,16,0.00%
jamboard.google.com,0,0.00%,16,16,0.00%
www.google.ad,0,0.00%,16,16,0.00%
www.google.al,0,0.00%,16,16,0.00%
weiyun.com,0,0.00%,16,16,0.00%
docin.com,0,0.00%,17,17,0.00%
gmail.com,0,0.00%,19,19,0.00%
www.google.be,0,0.00%,16,16,0.00%
www.google.bs,0,0.00%,17,17,0.00%
www.google.by,0,0.00%,19,19,0.00%
www.google.ch,0,0.00%,18,18,0.00%
www.google.cf,0,0.00%,17,17,0.00%
www.google.cl,0,0.00%,18,18,0.00%
mail.263.net,0,0.00%,16,16,0.00%
appmail.mail.10086.cn,0,0.00%,16,16,0.00%
news.google.com,0,0.00%,14,14,0.00%
photos.google.com,0,0.00%,16,16,0.00%
www.google.ae,0,0.00%,18,18,0.00%
www.google.am,0,0.00%,18,18,0.00%
www.google.cm,0,0.00%,17,17,0.00%
www.google.ci,0,0.00%,19,19,0.00%
www.google.cv,0,0.00%,17,17,0.00%
www.google.dm,0,0.00%,19,19,0.00%
skype.com,0,0.00%,16,16,0.00%
file.wx.qq.com,0,0.00%,18,18,0.00%
web.wechat.com,0,0.00%,16,16,0.00%
live.com,0,0.00%,14,14,0.00%
login.windows.net,0,0.00%,32,32,0.00%
bing.com,0,0.00%,40,40,0.00%
www.google.co.ao,0,0.00%,17,17,0.00%
www.google.ba,0,0.00%,18,18,0.00%
www.google.bf,0,0.00%,17,17,0.00%
www.google.bg,0,0.00%,20,20,0.00%
www.google.bj,0,0.00%,17,17,0.00%
www.google.ca,0,0.00%,18,18,0.00%
www.google.cd,0,0.00%,19,19,0.00%
www.google.cg,0,0.00%,19,19,0.00%
www.google.cz,0,0.00%,16,16,0.00%
www.google.de,0,0.00%,16,16,0.00%
www.google.dk,0,0.00%,20,20,0.00%
office.com,0,0.00%,16,16,0.00%
www.google.as,0,0.00%,19,19,0.00%
www.google.bt,0,0.00%,19,19,0.00%
www.dropbox.com,0,0.00%,20,20,0.00%
meet.google.com,0,0.00%,16,16,0.00%
www.google.bi,0,0.00%,19,19,0.00%
www.google.dj,0,0.00%,15,15,0.00%
wx.qq.com,0,0.00%,18,18,0.00%
login.microsoft.com,0,0.00%,22,22,0.00%
baidu.com,0,0.00%,22,22,0.00%
www.getdropbox.com,0,0.00%,22,22,0.00%
api.pdfxd.com,0,0.00%,2,2,0.00%
newonboarding.socialacademy.me,0,0.00%,1,1,0.00%
cdn.cache.netvigators.xyz,0,0.00%,12,12,0.00%
webex.com.cn,0,0.00%,10,10,0.00%
wapp.baidu.com,0,0.00%,15,15,0.00%
msg.baidu.com,0,0.00%,18,18,0.00%
uploadphotos.baidu.com,0,0.00%,17,17,0.00%
upload.tieba.baidu.com,0,0.00%,16,16,0.00%
pcs.baidu.com,0,0.00%,18,18,0.00%
login.yahoo.com,0,0.00%,18,18,0.00%
www.google.at,0,0.00%,18,18,0.00%
www.google.az,0,0.00%,18,18,0.00%
dynsrv.wps.cn,0,0.00%,37,37,0.00%
hk1-8.nigirocloud.com,0,0.00%,12,12,0.00%
tr.cili001.com,0,0.00%,10,10,0.00%
tracker2.itzmx.com,0,0.00%,8,8,0.00%
maps.metager.de,0,0.00%,1,1,0.00%
ecs-office.s-0005.s-msedge.NET,0,0.00%,4,4,0.00%
asbrvuy5eytinisxv7jzno26lererj55ryvomhht6iw7tmcbbyswebid.tor2web.it,0,0.00%,6,6,0.00%
us3-2.nigirocloud.com,0,0.00%,12,12,0.00%
us3-3.nigirocloud.com,0,0.00%,12,12,0.00%
hk1-4.nigirocloud.com,0,0.00%,14,14,0.00%
hk1-5.nigirocloud.com,0,0.00%,14,14,0.00%
hk1-2.nigirocloud.com,0,0.00%,10,10,0.00%
us3-1.nigirocloud.com,0,0.00%,12,12,0.00%
hk1-1.nigirocloud.com,0,0.00%,16,16,0.00%
hk1-3.nigirocloud.com,0,0.00%,12,12,0.00%
hk1-6.nigirocloud.com,0,0.00%,12,12,0.00%
au1-1.nigirocloud.com,0,0.00%,12,12,0.00%
au1-2.nigirocloud.com,0,0.00%,12,12,0.00%
au1-3.nigirocloud.com,0,0.00%,12,12,0.00%
au1-4.nigirocloud.com,0,0.00%,12,12,0.00%
au2-1.nigirocloud.com,0,0.00%,12,12,0.00%
au2-2.nigirocloud.com,0,0.00%,12,12,0.00%
au2-3.nigirocloud.com,0,0.00%,12,12,0.00%
au2-4.nigirocloud.com,0,0.00%,12,12,0.00%
de1-1.nigirocloud.com,0,0.00%,12,12,0.00%
de1-2.nigirocloud.com,0,0.00%,12,12,0.00%
de1-3.nigirocloud.com,0,0.00%,12,12,0.00%
us3-4.nigirocloud.com,0,0.00%,12,12,0.00%
us3-5.nigirocloud.com,0,0.00%,12,12,0.00%
de1-4.nigirocloud.com,0,0.00%,12,12,0.00%
de2-1.nigirocloud.com,0,0.00%,12,12,0.00%
de2-2.nigirocloud.com,0,0.00%,12,12,0.00%
de2-4.nigirocloud.com,0,0.00%,12,12,0.00%
de2-3.nigirocloud.com,0,0.00%,12,12,0.00%
ee1-1.nigirocloud.com,0,0.00%,12,12,0.00%
ee1-2.nigirocloud.com,0,0.00%,12,12,0.00%
ee1-3.nigirocloud.com,0,0.00%,12,12,0.00%
ee1-4.nigirocloud.com,0,0.00%,12,12,0.00%
us1-1.nigirocloud.com,0,0.00%,12,12,0.00%
us1-3.nigirocloud.com,0,0.00%,12,12,0.00%
us1-4.nigirocloud.com,0,0.00%,12,12,0.00%
us2-1.nigirocloud.com,0,0.00%,12,12,0.00%
us2-2.nigirocloud.com,0,0.00%,12,12,0.00%
us2-3.nigirocloud.com,0,0.00%,12,12,0.00%
us2-4.nigirocloud.com,0,0.00%,12,12,0.00%
ty2-1.nigirocloud.com,0,0.00%,12,12,0.00%
code2chicken.nl,0,0.00%,6,6,0.00%
edu.uifr.ru,0,0.00%,4,4,0.00%
torrentclub.online,0,0.00%,10,10,0.00%
vibe.community,0,0.00%,11,11,0.00%
wassermann.online,0,0.00%,2,2,0.00%
accountv2.wpsdns.com,0,0.00%,4,4,0.00%
cloud.huawei.com,0,0.00%,5,5,0.00%
tracker.ccp.ovh,0,0.00%,12,12,0.00%
zhxin.xfplay.com,0,0.00%,22,22,0.00%
mozilla.cloudflare-dns.com,0,0.00%,6,6,0.00%
xmsj-vip1.omo-m0m.com,0,0.00%,23,23,0.00%
ntp.aliyun.com,0,0.00%,26,26,0.00%
www.microvirt.com,0,0.00%,27,27,0.00%
a.sox.si,0,0.00%,123,123,0.00%
APAC03.azure-devices.net,0,0.00%,6,6,0.00%
winatp-gw-cus3.microsoft.com,0,0.00%,69,69,0.00%
pr3.getnjnd.com,0,0.00%,47,47,0.00%
bggts547gukhvmf4cgandlgxxphengxovoyo6ewhns5qmmb2b5oi43yd.tor2web.in,0,0.00%,12,12,0.00%
mail.bjtu.edu.cn,0,0.00%,6,6,0.00%
wps.processon.com,0,0.00%,2,2,0.00%
hk-proxy.isrc.ac.cn,0,0.00%,49,49,0.00%
circlepic.upqzfile.com,0,0.00%,6,6,0.00%
pic.upqzfile.com,0,0.00%,6,6,0.00%
circlevideo.upqzfile.com,0,0.00%,6,6,0.00%
video.upqzfile.com,0,0.00%,6,6,0.00%
other.upqzfile.com,0,0.00%,5,5,0.00%
mobilelog.upqzfile.com,0,0.00%,6,6,0.00%
bd-rwk.pull.etoote.com,0,0.00%,5,5,0.00%
rq.qb-lbcct.cloud.duba.net,0,0.00%,6,6,0.00%
array510.prod.do.dsp.mp.microsoft.com,0,0.00%,14,14,0.00%
cacerts.digicert.com,0,0.00%,4,4,0.00%
e71e16d.tt.cloudflare.systems,0,0.00%,2,2,0.00%
e71e16d.ph.gladns.com,0,0.00%,12,12,0.00%
e71e16d.cw.cloudflare.systems,0,0.00%,4,4,0.00%
e71e16d.pe.gladns.com,0,0.00%,6,6,0.00%
e71e16d.ts.cloudflare.systems,0,0.00%,4,4,0.00%
e71e16d.pf.gladns.com,0,0.00%,4,4,0.00%
e71e16d.pd.gladns.com,0,0.00%,4,4,0.00%
e71e16d.th.cloudflare.systems,0,0.00%,4,4,0.00%
e71e16d.td.cloudflare.systems,0,0.00%,4,4,0.00%
e71e16d.nx.cloudflare.systems,0,0.00%,2,2,0.00%
e71e16d.pg.gladns.com,0,0.00%,4,4,0.00%
e71e16d.pa.gladns.com,0,0.00%,4,4,0.00%
e71e16d.pb.gladns.com,0,0.00%,4,4,0.00%
e71e16d.pc.gladns.com,0,0.00%,2,2,0.00%
musicstatus.edge-itunes-apple.com.akadns.net,0,0.00%,1,1,0.00%
router.tracking.miui.com,0,0.00%,4,4,0.00%
targetednotifications-tm.trafficmanager.net,0,0.00%,18,18,0.00%
aks.jdpay.com,0,0.00%,8,8,0.00%
db-safe.2345.cc,0,0.00%,6,6,0.00%
5897320.slp2p-east-std19.oray.net,0,0.00%,1,1,0.00%
0ck5q2up.sched.sma-dk.tdnsstic1.cn,0,0.00%,2,2,0.00%
i.weread.qq.com,0,0.00%,6,6,0.00%
weread.qq.com,0,0.00%,2,2,0.00%
p2p.hd.sohu.com.cn,0,0.00%,2,2,0.00%
1671aab.ne.gladns.com,0,0.00%,4,4,0.00%
sb.firefox.com.cn,0,0.00%,2,2,0.00%
ap-shanghai.cls.tencentcs.com,0,0.00%,5,5,0.00%
33aef1e.nf.gladns.com,0,0.00%,6,6,0.00%
33aef1e.hc.gladns.com,0,0.00%,1,1,0.00%
33aef1e.hd.gladns.com,0,0.00%,1,1,0.00%
33aef1e.hb.gladns.com,0,0.00%,2,2,0.00%
33aef1e.ha.gladns.com,0,0.00%,2,2,0.00%
33aef1e.hf.gladns.com,0,0.00%,2,2,0.00%
33aef1e.he.gladns.com,0,0.00%,1,1,0.00%
extensionwebstorebase.edgesv.net,0,0.00%,2,2,0.00%
tx-kmplive.pull.yximgs.com,0,0.00%,3,3,0.00%
media.st.dl.eccdnx.com,0,0.00%,11,11,0.00%
alt7-mtalk.google.com,0,0.00%,2,2,0.00%
wechat.todesk.com,0,0.00%,6,6,0.00%
c0.ipjingling.com,0,0.00%,7,7,0.00%
alb-wy5mqfy1o52wprnwel.cn-hangzhou.alb.aliyuncs.com,0,0.00%,1,1,0.00%
rc10-linux.oray.com,0,0.00%,1,1,0.00%
time-f.netgear.com,0,0.00%,2,2,0.00%
online2.ts.api.xiangtatech.com,0,0.00%,4,4,0.00%
890a3c996d534bf19f8ed08103f71d66.fp.measure.office.com,0,0.00%,1,1,0.00%
t-safe.2345.com,0,0.00%,13,13,0.00%
zeus.ad.xiaomi.com,0,0.00%,1,1,0.00%
sandbox.itunes.apple.com,0,0.00%,1,1,0.00%
expendablekmrcdn.kugou.com,0,0.00%,3,3,0.00%
singerimg.kugou.com,0,0.00%,1,1,0.00%
tts.baidu.com,0,0.00%,3,3,0.00%
lbs.mail.163.com,0,0.00%,14,14,0.00%
sf1.helloking.win,0,0.00%,8,8,0.00%
zhxin2.xfplay.com,0,0.00%,25,25,0.00%
ebook-discount-checker.herokuapp.com,0,0.00%,61,61,0.00%
www.mythtao.com,0,0.00%,2,2,0.00%
js.a.yximgs.com,0,0.00%,3,3,0.00%
onedriveclucproddm20041.blob.core.windows.net,0,0.00%,3,3,0.00%
ws-pclivemate.pull.yximgs.com,0,0.00%,3,3,0.00%
mailsjlueducn-my.sharepoint.com,0,0.00%,3,3,0.00%
ali-kmplive.pull.yximgs.com,0,0.00%,3,3,0.00%
r4---sn-i3belnlz.gvt1.com,0,0.00%,1,1,0.00%
yb-safe.2345.cc,0,0.00%,9,9,0.00%
p215-caldav.icloud.com.cn,0,0.00%,1,1,0.00%
kb.vmware.com,0,0.00%,2,2,0.00%
b29f269.pc.gladns.com,0,0.00%,8,8,0.00%
b29f269.pb.gladns.com,0,0.00%,6,6,0.00%
b29f269.pa.gladns.com,0,0.00%,11,11,0.00%
dsm01pap001.storage.live.com,0,0.00%,2,2,0.00%
source-fcdn-spe-push.s.bytefcdn.com,0,0.00%,12,12,0.00%
push-rtmp-l27.douyincdn.com.live-publish.galileo.jcloud-cdn.com,0,0.00%,6,6,0.00%
yun.livepush.myqcloud.com,0,0.00%,6,6,0.00%
lls-douyin.cloudrtc.myhuaweicloud.com,0,0.00%,10,10,0.00%
pull-lls-l26.douyincdn.com.c.cdnhwc3.com,0,0.00%,10,10,0.00%
hcdnl.pulldyin.rtm.gslb.c.cdnhwc2.com,0,0.00%,10,10,0.00%
pull-rtmp-l6-cny.douyincdn.com.rtmpvcloud.ks-cdn.com,0,0.00%,6,6,0.00%
pull-flv-l27.douyincdn.com.live-play.galileo.jcloud-cdn.com,0,0.00%,8,8,0.00%
pull-hls-f29.douyincdn.com.ucloud.com.cn,0,0.00%,8,8,0.00%
toutiao.hdllive.ks-cdn.com,0,0.00%,6,6,0.00%
pull-flv-f5-enc.flive.douyincdn.com.c.bytefcdn.com,0,0.00%,6,6,0.00%
array612.prod.do.dsp.mp.microsoft.com,0,0.00%,4,4,0.00%
as.hypergryph.com,0,0.00%,4,4,0.00%
7t6t37m9hi95b6fa.aliyunddos1005.com,0,0.00%,4,4,0.00%
dns1.cdn20.org,0,0.00%,4,4,0.00%
v1.gslb.aaplimg.com,0,0.00%,6,6,0.00%
ak-gs-gf.hypergryph.com,0,0.00%,8,8,0.00%
7w58afwy72xqljh1.aliyunddos1005.com,0,0.00%,8,8,0.00%
trouter-azsc-asse-0-a.trouter.skype.com,0,0.00%,4,4,0.00%
trouter-azsc-asse-0-a.cloudapp.net,0,0.00%,4,4,0.00%
prod.registrar.skype.com,0,0.00%,2,2,0.00%
production.skype-registar.akadns.net,0,0.00%,2,2,0.00%
skconf.f.360.cn,0,0.00%,5,5,0.00%
client-teamviewer-com.trafficmanager.net,0,0.00%,4,4,0.00%
cde-prod-eastasia.azurewebsites.net,0,0.00%,4,4,0.00%
waws-prod-hk1-037.sip.azurewebsites.windows.net,0,0.00%,4,4,0.00%
waws-prod-hk1-037-8347.eastasia.cloudapp.azure.com,0,0.00%,4,4,0.00%
dns1.a.ksycdn.cn,0,0.00%,2,2,0.00%
ns-756.awsdns-30.net,0,0.00%,4,4,0.00%
ns-1273.awsdns-31.org,0,0.00%,2,2,0.00%
openx2-match.dotomi.com,0,0.00%,2,2,0.00%
19.courier-push-apple.com.akadns.net,0,0.00%,4,4,0.00%
apsoutheast-match.deepintent.com,0,0.00%,2,2,0.00%
match.deepintent.com,0,0.00%,5,5,0.00%
40.courier-push-apple.com.akadns.net,0,0.00%,2,2,0.00%
sync.firefox.com.cn,0,0.00%,8,8,0.00%
s10-sync.firefox.com.cn,0,0.00%,2,2,0.00%
gv1.xdrig.com,0,0.00%,6,6,0.00%
ns3.dnsv4.com,0,0.00%,4,4,0.00%
ns4.dnsv4.com,0,0.00%,2,2,0.00%
gv1.xdrig.com.td.fusion.iaas.jdcloud.com,0,0.00%,8,8,0.00%
gv1.xdrig.com.td.fusion.iaas.jdcloud.com.jcloudlb.com,0,0.00%,8,8,0.00%
onedscolprdcus09.centralus.cloudapp.azure.com,0,0.00%,8,8,0.00%
ins-5i86z7w2.ias.tencent-cloud.net,0,0.00%,6,6,0.00%
aidc.origin-apple.com.akadns.net,0,0.00%,2,2,0.00%
ins-g4ztq7u7.ias.tencent-cloud.net,0,0.00%,6,6,0.00%
onedscolprdeus14.eastus.cloudapp.azure.com,0,0.00%,8,8,0.00%
macime.sogou.com,0,0.00%,8,8,0.00%
5a880faf6fb5e608.jijifun.com,0,0.00%,2,2,0.00%
gdmf.v.aaplimg.com,0,0.00%,6,6,0.00%
telemetry-incoming.r53-2.services.mozilla.com,0,0.00%,2,2,0.00%
helpyuanqicleaner1.ksmobile.com,0,0.00%,6,6,0.00%
x.bidswitch.net,0,0.00%,6,6,0.00%
user-data-apac-jp.bidswitch.net,0,0.00%,2,2,0.00%
ocsp.comodoca.com.cdn.cloudflare.net,0,0.00%,4,4,0.00%
inv-nets.admixer.net,0,0.00%,2,2,0.00%
inv-nets-sg-s1.admixer.net,0,0.00%,2,2,0.00%
8361147c-rh7400-rink2v-1d9xe.pccw.alrihla.net,0,0.00%,8,8,0.00%
me.xdrig.com,0,0.00%,2,2,0.00%
me.xdrig.com.td.fusion.iaas.jdcloud.com,0,0.00%,6,6,0.00%
rightmentalattitude.classic.kicksite.net,0,0.00%,1,1,0.00%
ns1.aedns.ae,0,0.00%,2,2,0.00%
ns2.aedns.ae,0,0.00%,2,2,0.00%
ns1.anycastdns.cz,0,0.00%,8,8,0.00%
anycastdns1-cz.nic.ai,0,0.00%,2,2,0.00%
rip.psg.com,0,0.00%,4,4,0.00%
ns.anycast.nic.af,0,0.00%,1,1,0.00%
ns2.anycastdns.cz,0,0.00%,10,10,0.00%
pch.whois.ai,0,0.00%,2,2,0.00%
nsx.nic.al,0,0.00%,2,2,0.00%
ns1.nic.al,0,0.00%,2,2,0.00%
nlns.globnix.net,0,0.00%,2,2,0.00%
a.nic.bg,0,0.00%,2,2,0.00%
f.dns.br,0,0.00%,2,2,0.00%
a.registre.bf,0,0.00%,2,2,0.00%
pch.ns.registre.bf,0,0.00%,2,2,0.00%
censvrns0001.ird.fr,0,0.00%,4,4,0.00%
d.nic.bg,0,0.00%,2,2,0.00%
p.nic.bg,0,0.00%,2,2,0.00%
b.dns.br,0,0.00%,2,2,0.00%
c.dns.br,0,0.00%,2,2,0.00%
d.dns.br,0,0.00%,2,2,0.00%
mail.116bestwork.cf,0,0.00%,2,2,0.00%
vcsa.vmware.com,0,0.00%,6,6,0.00%
csync.loopme.me,0,0.00%,3,3,0.00%
sync.adotmob.com,0,0.00%,4,4,0.00%
cookiesyncing-1395500543.us-east-1.elb.amazonaws.com,0,0.00%,2,2,0.00%
u2.amazonaws.com,0,0.00%,8,8,0.00%
eu-u.openx.net,0,0.00%,2,2,0.00%
stocks-edge.news.apple-dns.net,0,0.00%,2,2,0.00%
dl-wh.vipguanjia.net,0,0.00%,2,2,0.00%
settings-prod-uks-2.uksouth.cloudapp.azure.com,0,0.00%,34,34,0.00%
api.openweathermap.org,0,0.00%,2,2,0.00%
www.aliyundrive.com,0,0.00%,2,2,0.00%
i.gridsumdissector.com,0,0.00%,6,6,0.00%
verification-wok76t84.ns3.dan.hosting,0,0.00%,2,2,0.00%
ns3.tech101.cloud,0,0.00%,2,2,0.00%
ns1.coastalbase.com,0,0.00%,4,4,0.00%
ns8295.hostgator.com,0,0.00%,2,2,0.00%
ns2.breedanimalstipsinfo.org.uk,0,0.00%,2,2,0.00%
ns1.webstarts.com,0,0.00%,2,2,0.00%
ns2.webstarts.com,0,0.00%,2,2,0.00%
xiangfuchina.com,0,0.00%,2,2,0.00%
ns101.nsresponse.com,0,0.00%,6,6,0.00%
ns2.anadoludns.com,0,0.00%,8,8,0.00%
priscilla.ns.cloudflare.com,0,0.00%,4,4,0.00%
ns2.marksstrategy.com,0,0.00%,2,2,0.00%
ns2.hmsns.com,0,0.00%,4,4,0.00%
ns2.iwantmyname.net,0,0.00%,2,2,0.00%
ns1.anadoludns.com,0,0.00%,8,8,0.00%
ns1034.ui-dns.com,0,0.00%,2,2,0.00%
ns1049.ui-dns.org,0,0.00%,2,2,0.00%
ns55.accessdeny.net,0,0.00%,2,2,0.00%
ns1016.ui-dns.org,0,0.00%,4,4,0.00%
xn--9cr32lqhrkn41i7ndu3ujsal2w.com,0,0.00%,1,1,0.00%
ns1.hmsns.com,0,0.00%,4,4,0.00%
ns3.hmsns.com,0,0.00%,4,4,0.00%
ns1029.ui-dns.de,0,0.00%,4,4,0.00%
ns56.accessdeny.net,0,0.00%,2,2,0.00%
keanu.ns.cloudflare.com,0,0.00%,2,2,0.00%
ns2cqs.name.com,0,0.00%,12,12,0.00%
docks08.rzone.de,0,0.00%,6,6,0.00%
noel.ns.cloudflare.com,0,0.00%,4,4,0.00%
opal.ns.cloudflare.com,0,0.00%,2,2,0.00%
marlowe.ns.cloudflare.com,0,0.00%,12,12,0.00%
jillian.ns.cloudflare.com,0,0.00%,4,4,0.00%
dns0.heteml.jp,0,0.00%,2,2,0.00%
melnicoff.ns.cloudflare.com,0,0.00%,4,4,0.00%
ns4.zpowerdns.com,0,0.00%,2,2,0.00%
3-dem.com,0,0.00%,2,2,0.00%
trans-central.com,0,0.00%,2,2,0.00%
ns3.zpowerdns.com,0,0.00%,2,2,0.00%
dns1.heteml.jp,0,0.00%,2,2,0.00%
update.drivergenius.com,0,0.00%,20,20,0.00%
dns19.ovh.net,0,0.00%,4,4,0.00%
ns12.ovh.net,0,0.00%,2,2,0.00%
ns1.zpowerdns.com,0,0.00%,2,2,0.00%
ace.ns.cloudflare.com,0,0.00%,2,2,0.00%
ns2.zpowerdns.com,0,0.00%,2,2,0.00%
violet.ns.cloudflare.com,0,0.00%,8,8,0.00%
ns1115.ui-dns.de,0,0.00%,6,6,0.00%
ns211.superhosting.bg,0,0.00%,2,2,0.00%
ns19.ovh.net,0,0.00%,4,4,0.00%
wesley.ns.cloudflare.com,0,0.00%,16,16,0.00%
everton.ns.cloudflare.com,0,0.00%,8,8,0.00%
ns1062.ui-dns.com,0,0.00%,2,2,0.00%
katelyn.ns.cloudflare.com,0,0.00%,2,2,0.00%
ns1124.ui-dns.biz,0,0.00%,2,2,0.00%
ziggy.ns.cloudflare.com,0,0.00%,4,4,0.00%
ns1116.ui-dns.org,0,0.00%,2,2,0.00%
liz.ns.cloudflare.com,0,0.00%,12,12,0.00%
verification-ba2e0195.ns3.dan.hosting,0,0.00%,2,2,0.00%
rodrigo.ns.cloudflare.com,0,0.00%,4,4,0.00%
ns3.volusion.com,0,0.00%,2,2,0.00%
ns17.xincache.com,0,0.00%,12,12,0.00%
scrapathletics.com,0,0.00%,2,2,0.00%
wells.ns.cloudflare.com,0,0.00%,10,10,0.00%
ns2.meganameservers.eu,0,0.00%,2,2,0.00%
ns2.my-ndns.com,0,0.00%,2,2,0.00%
dorthy.ns.cloudflare.com,0,0.00%,24,24,0.00%
ns-96-c.gandi.net,0,0.00%,2,2,0.00%
ns4.volusion.com,0,0.00%,2,2,0.00%
josh.ns.cloudflare.com,0,0.00%,4,4,0.00%
treasure.ns.cloudflare.com,0,0.00%,2,2,0.00%
ns-13-a.gandi.net,0,0.00%,2,2,0.00%
alec.ns.cloudflare.com,0,0.00%,6,6,0.00%
jasmine.ns.cloudflare.com,0,0.00%,2,2,0.00%
ns1.my-ndns.com,0,0.00%,2,2,0.00%
dns12.ovh.net,0,0.00%,2,2,0.00%
verification-uysnbfq6.ns3.dan.hosting,0,0.00%,2,2,0.00%
ns-186-b.gandi.net,0,0.00%,2,2,0.00%
ns1.dewabiz.com,0,0.00%,2,2,0.00%
globalcanineregistry.com,0,0.00%,1,1,0.00%
ns2.nameself.com,0,0.00%,2,2,0.00%
alexandra.ns.cloudflare.com,0,0.00%,2,2,0.00%
ns5.webhostingpad.com,0,0.00%,2,2,0.00%
ns1.dns-h.com,0,0.00%,6,6,0.00%
cns4004.webhostbox.net,0,0.00%,2,2,0.00%
ns34.domaincontrol.com,0,0.00%,2,2,0.00%
stripdoctor.com,0,0.00%,2,2,0.00%
stage.dnspod.net,0,0.00%,4,4,0.00%
ns1021.ui-dns.com,0,0.00%,2,2,0.00%
mypeacepalace.com,0,0.00%,2,2,0.00%
kaiser.ns.cloudflare.com,0,0.00%,2,2,0.00%
v.ns.arvancdn.com,0,0.00%,2,2,0.00%
ns4.iwantmyname.net,0,0.00%,2,2,0.00%
cns4003.webhostbox.net,0,0.00%,2,2,0.00%
ns1.webhost1.com,0,0.00%,2,2,0.00%
ns2.dns.com.cn,0,0.00%,8,8,0.00%
pranab.ns.cloudflare.com,0,0.00%,2,2,0.00%
rob.ns.cloudflare.com,0,0.00%,14,14,0.00%
ns6.webhostingpad.com,0,0.00%,2,2,0.00%
ns1082.ui-dns.org,0,0.00%,2,2,0.00%
ridge.ns.cloudflare.com,0,0.00%,2,2,0.00%
ns1059.ui-dns.de,0,0.00%,6,6,0.00%
dexter.ns.cloudflare.com,0,0.00%,4,4,0.00%
ben.ns.cloudflare.com,0,0.00%,10,10,0.00%
ns1.iwantmyname.net,0,0.00%,2,2,0.00%
thea.ns.cloudflare.com,0,0.00%,6,6,0.00%
ns1049.ui-dns.com,0,0.00%,2,2,0.00%
ns3.iwantmyname.net,0,0.00%,2,2,0.00%
rafe.ns.cloudflare.com,0,0.00%,16,16,0.00%
melissa.ns.cloudflare.com,0,0.00%,8,8,0.00%
asa.ns.cloudflare.com,0,0.00%,6,6,0.00%
paul-lobel.com,0,0.00%,1,1,0.00%
ns14.xincache.com,0,0.00%,2,2,0.00%
nicole.ns.cloudflare.com,0,0.00%,12,12,0.00%
igor.ns.cloudflare.com,0,0.00%,8,8,0.00%
arely.ns.cloudflare.com,0,0.00%,2,2,0.00%
athena.ns.cloudflare.com,0,0.00%,4,4,0.00%
corporate.vip61.noc40.com,0,0.00%,4,4,0.00%
ns-1498.awsdns-59.org,0,0.00%,2,2,0.00%
marvin.ns.cloudflare.com,0,0.00%,6,6,0.00%
corporate.vip62.noc40.com,0,0.00%,4,4,0.00%
ns-1711.awsdns-21.co.uk,0,0.00%,2,2,0.00%
dcsj168.com,0,0.00%,2,2,0.00%
ns-424.awsdns-53.com,0,0.00%,2,2,0.00%
ns1.marksstrategy.com,0,0.00%,4,4,0.00%
jasper.ns.cloudflare.com,0,0.00%,10,10,0.00%
ns-852.awsdns-42.net,0,0.00%,2,2,0.00%
shades10.rzone.de,0,0.00%,4,4,0.00%
magdalena.ns.cloudflare.com,0,0.00%,4,4,0.00%
pdns07.domaincontrol.com,0,0.00%,10,10,0.00%
liberty.ns.cloudflare.com,0,0.00%,12,12,0.00%
pdns08.domaincontrol.com,0,0.00%,14,14,0.00%
ns4.webhost1.org,0,0.00%,2,2,0.00%
ns2.curanet.dk,0,0.00%,2,2,0.00%
jihoon.ns.cloudflare.com,0,0.00%,2,2,0.00%
f.17986.net,0,0.00%,2,2,0.00%
ns2.unrouted.com,0,0.00%,8,8,0.00%
dns-ch2.xinnet.com,0,0.00%,8,8,0.00%
ns2.webhost1.com,0,0.00%,2,2,0.00%
aspen.ns.cloudflare.com,0,0.00%,8,8,0.00%
bruce.ns.cloudflare.com,0,0.00%,4,4,0.00%
ns1047.ui-dns.biz,0,0.00%,2,2,0.00%
cameron.ns.cloudflare.com,0,0.00%,2,2,0.00%
kayleigh.ns.cloudflare.com,0,0.00%,8,8,0.00%
ns1.skymedasia.com,0,0.00%,2,2,0.00%
ns3.webhost1.org,0,0.00%,2,2,0.00%
ns1125.ui-dns.org,0,0.00%,2,2,0.00%
ns2.dns-h.com,0,0.00%,6,6,0.00%
ns2.skymedasia.com,0,0.00%,2,2,0.00%
ns1.host-h.net,0,0.00%,6,6,0.00%
ofreceservicios.com,0,0.00%,1,1,0.00%
NS3.irandns.com,0,0.00%,10,10,0.00%
NS4.irandns.com,0,0.00%,10,10,0.00%
ns2.host-h.net,0,0.00%,6,6,0.00%
ns2.digi.net.ar,0,0.00%,1,1,0.00%
ns1.axxisprod.com.ar,0,0.00%,1,1,0.00%
ns3.melbourneit.net,0,0.00%,2,2,0.00%
ns1.digi.net.ar,0,0.00%,1,1,0.00%
ns2.axxisprod.com.ar,0,0.00%,1,1,0.00%
xn--jlq34hq7d7u0am13c.com,0,0.00%,2,2,0.00%
andronicus.ns.cloudflare.com,0,0.00%,2,2,0.00%
ns-1338.awsdns-39.org,0,0.00%,2,2,0.00%
zara.ns.cloudflare.com,0,0.00%,2,2,0.00%
ns-177.awsdns-22.com,0,0.00%,2,2,0.00%
ns-1933.awsdns-49.co.uk,0,0.00%,2,2,0.00%
adele.ns.cloudflare.com,0,0.00%,6,6,0.00%
finley.ns.cloudflare.com,0,0.00%,8,8,0.00%
ns4cpw.name.com,0,0.00%,14,14,0.00%
rayden.ns.cloudflare.com,0,0.00%,2,2,0.00%
owen.ns.cloudflare.com,0,0.00%,4,4,0.00%
simone.ns.cloudflare.com,0,0.00%,2,2,0.00%
ns98.hostgator.com.br,0,0.00%,4,4,0.00%
verification-ffc96e06.ns3.dan.hosting,0,0.00%,2,2,0.00%
ns2.alanadlari.com,0,0.00%,2,2,0.00%
ns99.hostgator.com.br,0,0.00%,4,4,0.00%
margot.ns.cloudflare.com,0,0.00%,2,2,0.00%
yoxall.ns.cloudflare.com,0,0.00%,6,6,0.00%
dns1.goope.jp,0,0.00%,2,2,0.00%
ns1.unrouted.com,0,0.00%,8,8,0.00%
dns2.goope.jp,0,0.00%,2,2,0.00%
ns2.mweweb.com,0,0.00%,2,2,0.00%
ns2.diymysite.com,0,0.00%,4,4,0.00%
ns2.1stdomains.net.nz,0,0.00%,2,2,0.00%
ns1.kenceng-solusindo.web.id,0,0.00%,2,2,0.00%
dns2.123hjemmeside.dk,0,0.00%,16,16,0.00%
ns-b.dns.yourhosting.eu,0,0.00%,6,6,0.00%
saola.ezoicns.com,0,0.00%,2,2,0.00%
ns1.1stdomains.net.nz,0,0.00%,2,2,0.00%
chin.ns.cloudflare.com,0,0.00%,6,6,0.00%
sheep.ezoicns.com,0,0.00%,2,2,0.00%
skunk.ezoicns.com,0,0.00%,2,2,0.00%
ns-501.awsdns-62.com,0,0.00%,2,2,0.00%
ns2.timeweb.ru,0,0.00%,2,2,0.00%
ns1.slaytshell.com,0,0.00%,2,2,0.00%
beefonstick.com,0,0.00%,2,2,0.00%
ns4241.hostgator.com,0,0.00%,8,8,0.00%
ns-1012.awsdns-62.net,0,0.00%,2,2,0.00%
dns1.p03.nsone.net,0,0.00%,38,38,0.00%
beekuba.com,0,0.00%,2,2,0.00%
ns12.dnsmadeeasy.com,0,0.00%,4,4,0.00%
ns1.bh-in-23.webhostbox.net,0,0.00%,2,2,0.00%
beeshumm.com,0,0.00%,2,2,0.00%
ns2.web.de,0,0.00%,6,6,0.00%
ns11.dnsmadeeasy.com,0,0.00%,4,4,0.00%
ns2.bh-in-23.webhostbox.net,0,0.00%,2,2,0.00%
ns2.slaytshell.com,0,0.00%,2,2,0.00%
ns13.dnsmadeeasy.com,0,0.00%,4,4,0.00%
ns-rs2.gmoserver.jp,0,0.00%,12,12,0.00%
ed.ns.cloudflare.com,0,0.00%,6,6,0.00%
bart.ns.cloudflare.com,0,0.00%,10,10,0.00%
ns14.dnsmadeeasy.com,0,0.00%,4,4,0.00%
ns3.dothome.co.kr,0,0.00%,6,6,0.00%
ns15.dnsmadeeasy.com,0,0.00%,4,4,0.00%
kimora.ns.cloudflare.com,0,0.00%,4,4,0.00%
dns176.d.register.com,0,0.00%,10,10,0.00%
ns1.kilathosting.id,0,0.00%,2,2,0.00%
ns1.tekiranco.ir,0,0.00%,2,2,0.00%
ns1.bdm.microsoftonline.com,0,0.00%,16,16,0.00%
ns-1517.awsdns-61.org,0,0.00%,2,2,0.00%
ns1.dothome.co.kr,0,0.00%,6,6,0.00%
dns190.a.register.com,0,0.00%,4,4,0.00%
ns1007.hostgator.com.br,0,0.00%,2,2,0.00%
dns4.serverfreak.biz,0,0.00%,2,2,0.00%
ns1006.hostgator.com.br,0,0.00%,2,2,0.00%
ns2.kilathosting.id,0,0.00%,2,2,0.00%
ns1.lnwshop.com,0,0.00%,4,4,0.00%
ns1035.ui-dns.de,0,0.00%,2,2,0.00%
dijkstra.ihsdns.com,0,0.00%,6,6,0.00%
ns1.turkticaret.net,0,0.00%,18,18,0.00%
paul.ns.cloudflare.com,0,0.00%,2,2,0.00%
macy.ns.cloudflare.com,0,0.00%,4,4,0.00%
dns3.serverfreak.biz,0,0.00%,2,2,0.00%
ns2.servershost.net,0,0.00%,2,2,0.00%
ns2.lnwshop.com,0,0.00%,4,4,0.00%
plesk4600b.trouble-free.net,0,0.00%,2,2,0.00%
plesk4600a.trouble-free.net,0,0.00%,2,2,0.00%
dc1-st.ksn.kaspersky-labs.com,0,0.00%,8,8,0.00%
ns-1441.awsdns-52.org,0,0.00%,2,2,0.00%
ns10.dnsmadeeasy.com,0,0.00%,4,4,0.00%
ns1.easyhost.be,0,0.00%,4,4,0.00%
knuth.ihsdns.com,0,0.00%,6,6,0.00%
ns3.turkticaret.net,0,0.00%,16,16,0.00%
dns2.wfolio.ru,0,0.00%,2,2,0.00%
norm.ns.cloudflare.com,0,0.00%,6,6,0.00%
dns2.wfolio.com,0,0.00%,2,2,0.00%
ns3.paidboom.com,0,0.00%,2,2,0.00%
jack.ns.cloudflare.com,0,0.00%,12,12,0.00%
dns1.wfolio.com,0,0.00%,2,2,0.00%
ns2.audi.de,0,0.00%,2,2,0.00%
ns2.vultr.com,0,0.00%,4,4,0.00%
ns1.transip.nl,0,0.00%,22,22,0.00%
ns2.puskomedia.id,0,0.00%,2,2,0.00%
dns2.p03.nsone.net,0,0.00%,40,40,0.00%
ns-854.awsdns-42.net,0,0.00%,2,2,0.00%
bayouwalk.com,0,0.00%,2,2,0.00%
carrera.ns.cloudflare.com,0,0.00%,2,2,0.00%
cns6003.bigrock.com,0,0.00%,2,2,0.00%
harvey.dnspod.net,0,0.00%,2,2,0.00%
ns2.bdm.microsoftonline.com,0,0.00%,16,16,0.00%
ns1.puskomedia.id,0,0.00%,2,2,0.00%
ns301.mihanwebhost.com,0,0.00%,2,2,0.00%
ns1.dnspark.be,0,0.00%,2,2,0.00%
cns6004.bigrock.com,0,0.00%,2,2,0.00%
docks12.rzone.de,0,0.00%,4,4,0.00%
ns4.brandshelter.net,0,0.00%,12,12,0.00%
ns2.webgo.de,0,0.00%,4,4,0.00%
ns1.shockhosting.net,0,0.00%,4,4,0.00%
dns2.serverfreak.biz,0,0.00%,2,2,0.00%
ns3.mdnsservice.com,0,0.00%,4,4,0.00%
nsid2.rumahweb.net,0,0.00%,16,16,0.00%
dns1.serverfreak.biz,0,0.00%,2,2,0.00%
ns63.worldnic.com,0,0.00%,2,2,0.00%
ns2.mdnsservice.com,0,0.00%,4,4,0.00%
ns1027.ui-dns.de,0,0.00%,6,6,0.00%
ns1.germany.hostns.io,0,0.00%,2,2,0.00%
ns1.web.de,0,0.00%,6,6,0.00%
odiseus.backtothe80-90s.com,0,0.00%,2,2,0.00%
ns2.germany.hostns.io,0,0.00%,2,2,0.00%
ns1.md-in-48.webhostbox.net,0,0.00%,2,2,0.00%
ns1.webgo.de,0,0.00%,4,4,0.00%
ns1.da1.hosteons.com,0,0.00%,2,2,0.00%
ns4.webgo.de,0,0.00%,4,4,0.00%
ns2.md-in-48.webhostbox.net,0,0.00%,2,2,0.00%
ns1.mdnsservice.com,0,0.00%,4,4,0.00%
ns6.webrserver.com,0,0.00%,2,2,0.00%
ns2.da1.hosteons.com,0,0.00%,2,2,0.00%
bjvpn.sugon.com,0,0.00%,6,6,0.00%
ns4.web.de,0,0.00%,6,6,0.00%
hassan.ns.cloudflare.com,0,0.00%,2,2,0.00%
ns5.webrserver.com,0,0.00%,2,2,0.00%
ns-46-b.gandi.net,0,0.00%,2,2,0.00%
ns1.bbprizeilbaskanligi.com,0,0.00%,2,2,0.00%
ns2.itnuthosting.com,0,0.00%,2,2,0.00%
autumn.ns.cloudflare.com,0,0.00%,4,4,0.00%
ns1108.ui-dns.de,0,0.00%,10,10,0.00%
houston.ns.cloudflare.com,0,0.00%,2,2,0.00%
ns21.iserverplanet.net,0,0.00%,2,2,0.00%
titan.ns.cloudflare.com,0,0.00%,6,6,0.00%
topic.dnspod.net,0,0.00%,4,4,0.00%
ns1090.ui-dns.biz,0,0.00%,14,14,0.00%
romina.ns.cloudflare.com,0,0.00%,4,4,0.00%
nsid4.rumahweb.org,0,0.00%,18,18,0.00%
ns1048.ui-dns.org,0,0.00%,14,14,0.00%
nsb21.swiftlyserver.com,0,0.00%,2,2,0.00%
carol.ns.cloudflare.com,0,0.00%,12,12,0.00%
ns3.web.de,0,0.00%,6,6,0.00%
nsa21.swiftlyserver.com,0,0.00%,2,2,0.00%
daisy.ns.cloudflare.com,0,0.00%,4,4,0.00%
ns2.bbprizeilbaskanligi.com,0,0.00%,2,2,0.00%
ns1.agreerisk.com,0,0.00%,1,1,0.00%
sg4.webrserver.com,0,0.00%,2,2,0.00%
9wu652mg-u.funnull01.vip,0,0.00%,2,2,0.00%
ns2.tekiranco.ir,0,0.00%,2,2,0.00%
f6qya49d.n.funnull31.com,0,0.00%,2,2,0.00%
ns1.diymysite.com,0,0.00%,4,4,0.00%
ns242.mihanwebhost.com,0,0.00%,4,4,0.00%
ns2.ov2.com,0,0.00%,2,2,0.00%
dorukdns3.doruk.net.tr,0,0.00%,8,8,0.00%
beau.ns.cloudflare.com,0,0.00%,8,8,0.00%
ns1.cloudswebserver.com,0,0.00%,6,6,0.00%
ns1.cafe24.co.kr,0,0.00%,16,16,0.00%
eoin.ns.cloudflare.com,0,0.00%,6,6,0.00%
neil.ns.cloudflare.com,0,0.00%,5,5,0.00%
a7-65.akam.net,0,0.00%,2,2,0.00%
a6-64.akam.net,0,0.00%,2,2,0.00%
ns2.cloudswebserver.com,0,0.00%,6,6,0.00%
ns1.bbvaedge.com,0,0.00%,2,2,0.00%
ns1.nsitcmx.com,0,0.00%,2,2,0.00%
ns2.bbvaedge.com,0,0.00%,2,2,0.00%
ns3cjl.name.com,0,0.00%,2,2,0.00%
a22-65.akam.net,0,0.00%,2,2,0.00%
a1-166.akam.net,0,0.00%,2,2,0.00%
ns-1331.awsdns-38.org,0,0.00%,4,4,0.00%
a4-67.akam.net,0,0.00%,2,2,0.00%
ns-1692.awsdns-19.co.uk,0,0.00%,4,4,0.00%
a3-66.akam.net,0,0.00%,2,2,0.00%
ns-21.awsdns-02.com,0,0.00%,2,2,0.00%
ns-895.awsdns-47.net,0,0.00%,2,2,0.00%
nsa.whogohost.com,0,0.00%,8,8,0.00%
ns64.worldnic.com,0,0.00%,2,2,0.00%
mail.mydomain.com,0,0.00%,2,2,0.00%
ns-455.awsdns-56.com,0,0.00%,2,2,0.00%
zita.ns.cloudflare.com,0,0.00%,6,6,0.00%
ns1.point2point-01.com,0,0.00%,2,2,0.00%
augustus.ns.cloudflare.com,0,0.00%,8,8,0.00%
ns-195-c.gandi.net,0,0.00%,2,2,0.00%
ns2.krystal.uk,0,0.00%,6,6,0.00%
bandagentv.com,0,0.00%,2,2,0.00%
ns41.ethii.com,0,0.00%,2,2,0.00%
dns2.indowebsite.net,0,0.00%,2,2,0.00%
ns5.porar.com,0,0.00%,2,2,0.00%
ns6.porar.com,0,0.00%,2,2,0.00%
ns42.ethii.com,0,0.00%,2,2,0.00%
ns1035.ui-dns.org,0,0.00%,6,6,0.00%
dns1.indowebsite.net,0,0.00%,2,2,0.00%
ns1052.ui-dns.org,0,0.00%,6,6,0.00%
ns-90-b.gandi.net,0,0.00%,2,2,0.00%
verification-55b813b4.ns3.dan.hosting,0,0.00%,6,6,0.00%
ns3.mysecurecloudhost.com,0,0.00%,8,8,0.00%
dns4.indowebsite.net,0,0.00%,2,2,0.00%
ns2.sonicsalepage.com,0,0.00%,2,2,0.00%
dns2.cloud.claro.com.do,0,0.00%,2,2,0.00%
ns184.mschosting.com,0,0.00%,6,6,0.00%
hadlee.ns.cloudflare.com,0,0.00%,6,6,0.00%
ns1.hosting.com.tr,0,0.00%,2,2,0.00%
ns1073.ui-dns.com,0,0.00%,4,4,0.00%
ns185.mschosting.com,0,0.00%,6,6,0.00%
ns3cfp.name.com,0,0.00%,6,6,0.00%
ns1099.ui-dns.biz,0,0.00%,10,10,0.00%
ns186.mschosting.com,0,0.00%,6,6,0.00%
ns1024.ui-dns.de,0,0.00%,6,6,0.00%
ns1.sonicsalepage.com,0,0.00%,2,2,0.00%
ns2.wobiz.com,0,0.00%,2,2,0.00%
ns1082.ui-dns.com,0,0.00%,6,6,0.00%
ns59.sellvir.com,0,0.00%,2,2,0.00%
ns44.cloudns.net,0,0.00%,2,2,0.00%
amir.ns.cloudflare.com,0,0.00%,4,4,0.00%
ns1.dnsbackup.net,0,0.00%,2,2,0.00%
dns3.p03.nsone.net,0,0.00%,38,38,0.00%
ns2hjl.name.com,0,0.00%,6,6,0.00%
melina.ns.cloudflare.com,0,0.00%,4,4,0.00%
dns4.p03.nsone.net,0,0.00%,40,40,0.00%
ns4242.hostgator.com,0,0.00%,10,10,0.00%
ns1036.ui-dns.org,0,0.00%,14,14,0.00%
leia.ns.cloudflare.com,0,0.00%,28,28,0.00%
ns.inmotionhosting.com,0,0.00%,2,2,0.00%
ns1055.ui-dns.biz,0,0.00%,2,2,0.00%
parking2.whc.ca,0,0.00%,4,4,0.00%
ns-1213.awsdns-23.org,0,0.00%,2,2,0.00%
ns1.krystal.uk,0,0.00%,6,6,0.00%
ns1.nameserver.sk,0,0.00%,2,2,0.00%
ns-291.awsdns-36.com,0,0.00%,2,2,0.00%
dns153.a.register.com,0,0.00%,2,2,0.00%
ns-743.awsdns-28.net,0,0.00%,2,2,0.00%
parking1.whc.ca,0,0.00%,4,4,0.00%
dns2.nominalia.com,0,0.00%,10,10,0.00%
dns083.d.register.com,0,0.00%,38,38,0.00%
win4.hisupport.net,0,0.00%,2,2,0.00%
basmatisushiwok.com,0,0.00%,2,2,0.00%
ns2.entersoftsystems.com,0,0.00%,2,2,0.00%
dns036.c.register.com,0,0.00%,38,38,0.00%
baballhere.com,0,0.00%,2,2,0.00%
ns2.barkoush.com,0,0.00%,2,2,0.00%
ns1117.ui-dns.de,0,0.00%,2,2,0.00%
dns208.b.register.com,0,0.00%,6,6,0.00%
ns1110.ui-dns.com,0,0.00%,2,2,0.00%
ns2.dnsbackup.net,0,0.00%,2,2,0.00%
ns-1210.awsdns-23.org,0,0.00%,2,2,0.00%
ns1027.ui-dns.biz,0,0.00%,4,4,0.00%
win3.hisupport.net,0,0.00%,2,2,0.00%
ns54.shetabanhost.com,0,0.00%,2,2,0.00%
ns1073.ui-dns.org,0,0.00%,6,6,0.00%
ns2.dinahosting.com,0,0.00%,2,2,0.00%
ns-513.awsdns-00.net,0,0.00%,2,2,0.00%
ns1072.ui-dns.com,0,0.00%,2,2,0.00%
ns53.shetabanhost.com,0,0.00%,2,2,0.00%
ns1043.ui-dns.biz,0,0.00%,4,4,0.00%
ns1.entersoftsystems.com,0,0.00%,2,2,0.00%
ns2.nameserver.sk,0,0.00%,2,2,0.00%
ns1.barkoush.com,0,0.00%,2,2,0.00%
ns-1303.awsdns-34.org,0,0.00%,2,2,0.00%
ns-1777.awsdns-30.co.uk,0,0.00%,4,4,0.00%
ns-52.awsdns-06.com,0,0.00%,4,4,0.00%
ns-977.awsdns-58.net,0,0.00%,2,2,0.00%
ns1.clusterdns.co.za,0,0.00%,2,2,0.00%
ns3.dinahosting.com,0,0.00%,2,2,0.00%
ns1097.ui-dns.com,0,0.00%,8,8,0.00%
ns1.hrdns.info,0,0.00%,2,2,0.00%
ns1042.ui-dns.biz,0,0.00%,6,6,0.00%
ns.dinahosting.com,0,0.00%,2,2,0.00%
ns2.hrdns.info,0,0.00%,2,2,0.00%
ns1067.ui-dns.org,0,0.00%,8,8,0.00%
ns1032.ui-dns.de,0,0.00%,8,8,0.00%
ns1jsv.name.com,0,0.00%,6,6,0.00%
config.safedog.cn,0,0.00%,8,8,0.00%
ns1.kramitinfotech.com,0,0.00%,2,2,0.00%
ns1.messagingengine.com,0,0.00%,4,4,0.00%
badalagro.com,0,0.00%,2,2,0.00%
down.safedog.cn,0,0.00%,6,6,0.00%
bagherajones.com,0,0.00%,2,2,0.00%
storm.dnspod.net,0,0.00%,2,2,0.00%
ns4230.hostgator.com,0,0.00%,4,4,0.00%
ns4.empretienda.net,0,0.00%,2,2,0.00%
birch.dnspod.net,0,0.00%,2,2,0.00%
lepus.dnspod.net,0,0.00%,2,2,0.00%
guy.ns.cloudflare.com,0,0.00%,8,8,0.00%
dns116.a.register.com,0,0.00%,2,2,0.00%
ns1.badgesystemcenter.com,0,0.00%,2,2,0.00%
ns-213-c.gandi.net,0,0.00%,2,2,0.00%
darlene.dnspod.net,0,0.00%,2,2,0.00%
ns2.parspack.co,0,0.00%,2,2,0.00%
ns1.md-in-15.webhostbox.net,0,0.00%,2,2,0.00%
arthur.dnspod.net,0,0.00%,4,4,0.00%
michelle.ns.cloudflare.com,0,0.00%,4,4,0.00%
type.dnspod.net,0,0.00%,2,2,0.00%
dns210.b.register.com,0,0.00%,10,10,0.00%
ns2.md-in-15.webhostbox.net,0,0.00%,2,2,0.00%
pns41.cloudns.net,0,0.00%,6,6,0.00%
ns4247.hostgator.com,0,0.00%,4,4,0.00%
phil.ns.cloudflare.com,0,0.00%,2,2,0.00%
ns43.cloudns.net,0,0.00%,2,2,0.00%
ns4248.hostgator.com,0,0.00%,4,4,0.00%
pns44.cloudns.net,0,0.00%,6,6,0.00%
ns4.parspack.co,0,0.00%,2,2,0.00%
ns42.cloudns.net,0,0.00%,2,2,0.00%
woz.ns.cloudflare.com,0,0.00%,2,2,0.00%
ns02.budhahost.com,0,0.00%,2,2,0.00%
pns42.cloudns.net,0,0.00%,6,6,0.00%
ns1.lyricalhost.com,0,0.00%,2,2,0.00%
ns41.cloudns.net,0,0.00%,2,2,0.00%
ns1.parspack.co,0,0.00%,4,4,0.00%
ns2.lyricalhost.com,0,0.00%,2,2,0.00%
ns-19-a.gandi.net,0,0.00%,4,4,0.00%
ns-1109.awsdns-10.org,0,0.00%,4,4,0.00%
ns2.ofisimo.net,0,0.00%,2,2,0.00%
ns2.badgesystemcenter.com,0,0.00%,2,2,0.00%
ns-1870.awsdns-41.co.uk,0,0.00%,2,2,0.00%
sg1.serverorange.com,0,0.00%,2,2,0.00%
pns43.cloudns.net,0,0.00%,6,6,0.00%
ns-362.awsdns-45.com,0,0.00%,2,2,0.00%
gordon.ns.cloudflare.com,0,0.00%,18,18,0.00%
ns-952.awsdns-55.net,0,0.00%,2,2,0.00%
ns1.netx.com.ua,0,0.00%,2,2,0.00%
ns3.parspack.co,0,0.00%,2,2,0.00%
zoe.ns.cloudflare.com,0,0.00%,14,14,0.00%
ns3.timeweb.org,0,0.00%,2,2,0.00%
ns1.arandomserver.com,0,0.00%,2,2,0.00%
ns1.empretienda.net,0,0.00%,2,2,0.00%
ns4.lyricalhost.com,0,0.00%,2,2,0.00%
kurt.ns.cloudflare.com,0,0.00%,4,4,0.00%
ns1.timeweb.ru,0,0.00%,2,2,0.00%
ns2.arandomserver.com,0,0.00%,2,2,0.00%
elva.dnspod.net,0,0.00%,2,2,0.00%
ns3.empretienda.net,0,0.00%,2,2,0.00%
ns1.ofisimo.net,0,0.00%,2,2,0.00%
sg7.serverorange.com,0,0.00%,2,2,0.00%
ns2.brandshelter.de,0,0.00%,12,12,0.00%
ns3.rsncache.net,0,0.00%,2,2,0.00%
ns1.frienddns.info,0,0.00%,2,2,0.00%
u2.hoster.by,0,0.00%,2,2,0.00%
todd.ns.cloudflare.com,0,0.00%,6,6,0.00%
sns13.bigrock.com,0,0.00%,2,2,0.00%
sns14.bigrock.com,0,0.00%,2,2,0.00%
ns2.freehosting.com,0,0.00%,2,2,0.00%
ns2.arltnet.de,0,0.00%,2,2,0.00%
ns.arltnet.de,0,0.00%,2,2,0.00%
rosalie.ns.cloudflare.com,0,0.00%,2,2,0.00%
ns1060.ui-dns.de,0,0.00%,2,2,0.00%
ns1075.ui-dns.org,0,0.00%,2,2,0.00%
ns1019.ui-dns.com,0,0.00%,2,2,0.00%
bdns.cs.siteprotect.com,0,0.00%,2,2,0.00%
ns-1060.awsdns-04.org,0,0.00%,2,2,0.00%
karl.ns.cloudflare.com,0,0.00%,4,4,0.00%
dns2.sitezoogle.com,0,0.00%,10,10,0.00%
web3file.net,0,0.00%,2,2,0.00%
april.ns.cloudflare.com,0,0.00%,12,12,0.00%
doug.ns.cloudflare.com,0,0.00%,6,6,0.00%
ns-970.awsdns-57.net,0,0.00%,2,2,0.00%
holly.ns.cloudflare.com,0,0.00%,2,2,0.00%
ns-1866.awsdns-41.co.uk,0,0.00%,2,2,0.00%
coleman.ns.cloudflare.com,0,0.00%,2,2,0.00%
wellnessvoices.net,0,0.00%,2,2,0.00%
shades17.rzone.de,0,0.00%,8,8,0.00%
board.dnspod.net,0,0.00%,8,8,0.00%
charles.ns.cloudflare.com,0,0.00%,2,2,0.00%
cns1.cloudpit.de,0,0.00%,2,2,0.00%
kevin.ns.cloudflare.com,0,0.00%,24,24,0.00%
blob.dsz04prdstr03a.store.core.windows.NET,0,0.00%,2,2,0.00%
ns-910.awsdns-49.net,0,0.00%,4,4,0.00%
ns-160.awsdns-20.com,0,0.00%,2,2,0.00%
ns4hny.name.com,0,0.00%,6,6,0.00%
kip.ns.cloudflare.com,0,0.00%,4,4,0.00%
ns3.svethostingu.eu,0,0.00%,2,2,0.00%
ns-1848.awsdns-39.co.uk,0,0.00%,2,2,0.00%
ns4qxz.name.com,0,0.00%,10,10,0.00%
cpsfixtwo.iphoster.net,0,0.00%,2,2,0.00%
ns3jwx.name.com,0,0.00%,2,2,0.00%
dns2.ileriyazilim.com,0,0.00%,2,2,0.00%
ns2.bsexygaming77.network,0,0.00%,2,2,0.00%
ns-937.awsdns-53.net,0,0.00%,2,2,0.00%
redbusprimarydns.thefirstchristians.net,0,0.00%,2,2,0.00%
dns3.netsons.net,0,0.00%,2,2,0.00%
ns4htz.name.com,0,0.00%,2,2,0.00%
cns2.cloudpit.com,0,0.00%,2,2,0.00%
ns1.zzz.com.ua,0,0.00%,2,2,0.00%
dns1.znetlive.com,0,0.00%,2,2,0.00%
dns027.a.register.com,0,0.00%,2,2,0.00%
ashton.ns.cloudflare.com,0,0.00%,4,4,0.00%
ns1.starizpk.com,0,0.00%,2,2,0.00%
cns3.cloudpit.io,0,0.00%,2,2,0.00%
alina.ns.cloudflare.com,0,0.00%,12,12,0.00%
amalia.ns.cloudflare.com,0,0.00%,6,6,0.00%
ns-1794.awsdns-32.co.uk,0,0.00%,2,2,0.00%
austin.ns.cloudflare.com,0,0.00%,6,6,0.00%
ivan.ns.cloudflare.com,0,0.00%,2,2,0.00%
ns2cvx.name.com,0,0.00%,4,4,0.00%
ns-49.awsdns-06.com,0,0.00%,2,2,0.00%
ns2.gmxnet.de,0,0.00%,4,4,0.00%
ns-1350.awsdns-40.org,0,0.00%,2,2,0.00%
ns1.bsexygaming77.network,0,0.00%,2,2,0.00%
ns2.veridyen.com,0,0.00%,2,2,0.00%
ns2.starizpk.com,0,0.00%,2,2,0.00%
arch.ns.cloudflare.com,0,0.00%,6,6,0.00%
ns-654.awsdns-17.net,0,0.00%,4,4,0.00%
ns1kpv.name.com,0,0.00%,4,4,0.00%
ns3bfm.name.com,0,0.00%,4,4,0.00%
ns1.svethostingu.cz,0,0.00%,2,2,0.00%
dns4.netsons.net,0,0.00%,2,2,0.00%
ns2.dns.ne.jp,0,0.00%,14,14,0.00%
ns-1682.awsdns-18.co.uk,0,0.00%,2,2,0.00%
ns4.gmxnet.de,0,0.00%,4,4,0.00%
edison.dnspod.net,0,0.00%,2,2,0.00%
dns2.netsons.net,0,0.00%,2,2,0.00%
ns2fgv.name.com,0,0.00%,4,4,0.00%
ns-355.awsdns-44.com,0,0.00%,2,2,0.00%
redbussecondarydns.thefirstchristians.net,0,0.00%,2,2,0.00%
ns2.serverhost.name,0,0.00%,2,2,0.00%
ns1112.ui-dns.de,0,0.00%,8,8,0.00%
ns1120.ui-dns.de,0,0.00%,2,2,0.00%
dns1.kinghost.com.br,0,0.00%,2,2,0.00%
jerome.ns.cloudflare.com,0,0.00%,16,16,0.00%
craig.dnspod.net,0,0.00%,2,2,0.00%
ns-532.awsdns-02.net,0,0.00%,2,2,0.00%
ns2.idiom.us,0,0.00%,2,2,0.00%
ns3.mijn.host,0,0.00%,2,2,0.00%
ns1121.ui-dns.biz,0,0.00%,2,2,0.00%
robin.ns.cloudflare.com,0,0.00%,2,2,0.00%
dana.ns.cloudflare.com,0,0.00%,2,2,0.00%
ns-1000.awsdns-61.net,0,0.00%,2,2,0.00%
ns3.gmxnet.de,0,0.00%,4,4,0.00%
dns1.netsons.net,0,0.00%,2,2,0.00%
lily.ns.cloudflare.com,0,0.00%,8,8,0.00%
ns-1267.awsdns-30.org,0,0.00%,2,2,0.00%
ns1.gmxnet.de,0,0.00%,4,4,0.00%
ns4cgs.name.com,0,0.00%,6,6,0.00%
mosquito.dnspod.net,0,0.00%,2,2,0.00%
b.ezdnscenter.com,0,0.00%,14,14,0.00%
ns1080.ui-dns.com,0,0.00%,2,2,0.00%
docks06.rzone.de,0,0.00%,4,4,0.00%
ns2.startlogic.com,0,0.00%,8,8,0.00%
ns3.hosting.de,0,0.00%,8,8,0.00%
ns2.svethostingu.cz,0,0.00%,2,2,0.00%
ns-22.awsdns-02.com,0,0.00%,2,2,0.00%
ns1068.ui-dns.de,0,0.00%,2,2,0.00%
redbusprimarydns.initiativeforpeace.net,0,0.00%,2,2,0.00%
trap.mountain-view.ca.us,0,0.00%,2,2,0.00%
ns1099.ui-dns.org,0,0.00%,4,4,0.00%
ns1.ace-k-q-nnnjp.com,0,0.00%,28,28,0.00%
carlos.ns.cloudflare.com,0,0.00%,2,2,0.00%
ns2.justhost.com,0,0.00%,4,4,0.00%
ns1123.ui-dns.com,0,0.00%,2,2,0.00%
ns1.iinet.com,0,0.00%,2,2,0.00%
ns1gjz.name.com,0,0.00%,2,2,0.00%
leonidas.ns.cloudflare.com,0,0.00%,2,2,0.00%
diana.ns.cloudflare.com,0,0.00%,2,2,0.00%
ns-112-c.gandi.net,0,0.00%,2,2,0.00%
shades14.rzone.de,0,0.00%,4,4,0.00%
ns2fwz.name.com,0,0.00%,8,8,0.00%
dns3.supremedns.com,0,0.00%,6,6,0.00%
p.ns.arvancdn.net,0,0.00%,2,2,0.00%
ns1.customer.ne.jp,0,0.00%,2,2,0.00%
liv.ns.cloudflare.com,0,0.00%,6,6,0.00%
pete.ns.cloudflare.com,0,0.00%,4,4,0.00%
maxine.ns.cloudflare.com,0,0.00%,4,4,0.00%
ns2.haberpaketleri.com,0,0.00%,2,2,0.00%
ns3.linode.com,0,0.00%,6,6,0.00%
redbussecondarydns.initiativeforpeace.net,0,0.00%,2,2,0.00%
zeus.ns.cloudflare.com,0,0.00%,4,4,0.00%
dns.rebel.com,0,0.00%,2,2,0.00%
ns-271.awsdns-33.com,0,0.00%,2,2,0.00%
ns1.bkkwebhosting.com,0,0.00%,2,2,0.00%
graham.ns.cloudflare.com,0,0.00%,2,2,0.00%
docks10.rzone.de,0,0.00%,4,4,0.00%
ns2.customer.ne.jp,0,0.00%,2,2,0.00%
ns-146-a.gandi.net,0,0.00%,2,2,0.00%
v0n0.nic.network,0,0.00%,6,6,0.00%
dns2.rebel.com,0,0.00%,2,2,0.00%
vita.ns.cloudflare.com,0,0.00%,4,4,0.00%
carmelo.ns.cloudflare.com,0,0.00%,6,6,0.00%
ns2.bkkwebhosting.com,0,0.00%,2,2,0.00%
verification-9e862e2d.ns3.dan.hosting,0,0.00%,2,2,0.00%
ns21.domaincontrol.com,0,0.00%,8,8,0.00%
ns1037.ui-dns.com,0,0.00%,8,8,0.00%
jacqueline.ns.cloudflare.com,0,0.00%,4,4,0.00%
ns-31-b.gandi.net,0,0.00%,2,2,0.00%
emma.ns.cloudflare.com,0,0.00%,4,4,0.00%
ns22.domaincontrol.com,0,0.00%,8,8,0.00%
ns3gxy.name.com,0,0.00%,2,2,0.00%
chad.ns.cloudflare.com,0,0.00%,14,14,0.00%
ns1126.ui-dns.org,0,0.00%,2,2,0.00%
ns1034.ui-dns.biz,0,0.00%,2,2,0.00%
ns-1425.awsdns-50.org,0,0.00%,2,2,0.00%
ashley.ns.cloudflare.com,0,0.00%,6,6,0.00%
iots01-g2.oray.net,0,0.00%,4,4,0.00%
ns-1654.awsdns-14.co.uk,0,0.00%,2,2,0.00%
ns-470.awsdns-58.com,0,0.00%,2,2,0.00%
ns1126.ui-dns.com,0,0.00%,4,4,0.00%
ns2.csof.net,0,0.00%,4,4,0.00%
ns1046.ui-dns.org,0,0.00%,4,4,0.00%
ns1098.ui-dns.org,0,0.00%,6,6,0.00%
ns-822.awsdns-38.net,0,0.00%,2,2,0.00%
ns1088.ui-dns.biz,0,0.00%,2,2,0.00%
ns5.csof.net,0,0.00%,4,4,0.00%
redbussecondarydns.virtualcells.net,0,0.00%,2,2,0.00%
ns4.csof.net,0,0.00%,4,4,0.00%
ns2.oray.net,0,0.00%,4,4,0.00%
ns4.vbeno.com,0,0.00%,2,2,0.00%
ns7.csof.net,0,0.00%,4,4,0.00%
ns1116.ui-dns.de,0,0.00%,2,2,0.00%
ns6.csof.net,0,0.00%,4,4,0.00%
ns-127-a.gandi.net,0,0.00%,2,2,0.00%
ns1086.ui-dns.org,0,0.00%,2,2,0.00%
ns24.dutaspace.com,0,0.00%,2,2,0.00%
ns8.csof.net,0,0.00%,4,4,0.00%
ns1035.ui-dns.biz,0,0.00%,6,6,0.00%
ns3.combell.net,0,0.00%,2,2,0.00%
ns3.csof.net,0,0.00%,4,4,0.00%
ns4.combell.net,0,0.00%,2,2,0.00%
ns1.csof.net,0,0.00%,4,4,0.00%
aragorn.ns.cloudflare.com,0,0.00%,2,2,0.00%
ns-106-c.gandi.net,0,0.00%,4,4,0.00%
ns3.vbeno.com,0,0.00%,2,2,0.00%
ns3.wpx.ne.jp,0,0.00%,2,2,0.00%
ns3.star-domain.jp,0,0.00%,4,4,0.00%
ns1.star-domain.jp,0,0.00%,4,4,0.00%
ns2.star-domain.jp,0,0.00%,4,4,0.00%
ns1.vbeno.com,0,0.00%,2,2,0.00%
ns2.vbeno.com,0,0.00%,2,2,0.00%
ns2.metunic.com.tr,0,0.00%,2,2,0.00%
gracie.ns.cloudflare.com,0,0.00%,4,4,0.00%
ns1.metunic.com.tr,0,0.00%,2,2,0.00%
ultimatedatasource.net,0,0.00%,2,2,0.00%
queipo3w.nodedata.net,0,0.00%,2,2,0.00%
ns1.hostingww.com,0,0.00%,2,2,0.00%
brynne.ns.cloudflare.com,0,0.00%,4,4,0.00%
james.ns.cloudflare.com,0,0.00%,2,2,0.00%
lennon.ns.cloudflare.com,0,0.00%,4,4,0.00%
clayton.ns.cloudflare.com,0,0.00%,2,2,0.00%
maxim.ns.cloudflare.com,0,0.00%,2,2,0.00%
ns12.ebndns.com,0,0.00%,2,2,0.00%
sohamhealthcare.net,0,0.00%,2,2,0.00%
paint.dnspod.net,0,0.00%,4,4,0.00%
dns3.lonex.com,0,0.00%,4,4,0.00%
srilankancongress.net,0,0.00%,2,2,0.00%
ns-148.awsdns-18.com,0,0.00%,2,2,0.00%
ns-1315.awsdns-36.org,0,0.00%,2,2,0.00%
jamie.ns.cloudflare.com,0,0.00%,2,2,0.00%
ns1088.ui-dns.com,0,0.00%,6,6,0.00%
ns-1644.awsdns-13.co.uk,0,0.00%,2,2,0.00%
cpanel53b.lws-hosting.com,0,0.00%,2,2,0.00%
ns-229.awsdns-28.com,0,0.00%,2,2,0.00%
registracom.mercury.orderbox-dns.com,0,0.00%,6,6,0.00%
srilankacongress.net,0,0.00%,2,2,0.00%
registracom.mars.orderbox-dns.com,0,0.00%,6,6,0.00%
ns1059.ui-dns.org,0,0.00%,4,4,0.00%
ns2clp.name.com,0,0.00%,2,2,0.00%
registracom.venus.orderbox-dns.com,0,0.00%,6,6,0.00%
ns1.dns-principal-33.com,0,0.00%,2,2,0.00%
dns3.3dcart.com,0,0.00%,4,4,0.00%
registracom.earth.orderbox-dns.com,0,0.00%,6,6,0.00%
dns1.3dcart.com,0,0.00%,4,4,0.00%
ns1.lp.hostpapa.com,0,0.00%,2,2,0.00%
ulla.ns.cloudflare.com,0,0.00%,14,14,0.00%
ns2.dns-principal-33.com,0,0.00%,2,2,0.00%
ns-1403.awsdns-47.org,0,0.00%,2,2,0.00%
ns2.lp.hostpapa.com,0,0.00%,2,2,0.00%
ns2.lqa.fik.mybluehost.me,0,0.00%,4,4,0.00%
aiden.ns.cloudflare.com,0,0.00%,8,8,0.00%
ns-299.awsdns-37.com,0,0.00%,2,2,0.00%
ns1.lqa.fik.mybluehost.me,0,0.00%,2,2,0.00%
laura.ns.cloudflare.com,0,0.00%,14,14,0.00%
ns1040.ui-dns.com,0,0.00%,4,4,0.00%
ns2.seohost.pl,0,0.00%,2,2,0.00%
q3trading.net,0,0.00%,2,2,0.00%
sage.ns.cloudflare.com,0,0.00%,2,2,0.00%
bailey.ns.cloudflare.com,0,0.00%,2,2,0.00%
michael.ns.cloudflare.com,0,0.00%,8,8,0.00%
lana.ns.cloudflare.com,0,0.00%,4,4,0.00%
ns1.seohost.pl,0,0.00%,2,2,0.00%
ns283.umbler.com.br,0,0.00%,2,2,0.00%
ns1.ankarahosting.web.tr,0,0.00%,4,4,0.00%
parking4058.hostinet.com,0,0.00%,2,2,0.00%
dns3.bluehost.com,0,0.00%,4,4,0.00%
ns2.texasholdem888.net,0,0.00%,2,2,0.00%
dns1.bluehost.com,0,0.00%,4,4,0.00%
ns2.symbolhost.com,0,0.00%,2,2,0.00%
ns1.texasholdem888.net,0,0.00%,2,2,0.00%
ns.titan.gofasthost.com,0,0.00%,2,2,0.00%
ns1.texas-888.net,0,0.00%,2,2,0.00%
ns2.ankarahosting.web.tr,0,0.00%,4,4,0.00%
ns2.texas-888.net,0,0.00%,2,2,0.00%
ns1.beget.com,0,0.00%,6,6,0.00%
ns3.icedhost.com,0,0.00%,2,2,0.00%
ns1.icedhost.com,0,0.00%,2,2,0.00%
ns2.icedhost.com,0,0.00%,2,2,0.00%
ns1.fatcow.com,0,0.00%,2,2,0.00%
escuelaencuba.net,0,0.00%,2,2,0.00%
ns2.fatcow.com,0,0.00%,2,2,0.00%
elliott.ns.cloudflare.com,0,0.00%,4,4,0.00%
shubhi.ns.cloudflare.com,0,0.00%,4,4,0.00%
aaron.ns.cloudflare.com,0,0.00%,2,2,0.00%
troy.ns.cloudflare.com,0,0.00%,4,4,0.00%
luciana.ns.cloudflare.com,0,0.00%,2,2,0.00%
redbussecondarydns.sexdrugsanddeath.net,0,0.00%,2,2,0.00%
remy.ns.cloudflare.com,0,0.00%,6,6,0.00%
ns1.velkhana.jp,0,0.00%,2,2,0.00%
ratioarts.net,0,0.00%,2,2,0.00%
ns3gmv.name.com,0,0.00%,6,6,0.00%
cns3.alfahosting.info,0,0.00%,8,8,0.00%
ns2.gvodns.com,0,0.00%,2,2,0.00%
dns2.supremedns.com,0,0.00%,6,6,0.00%
ns4bty.name.com,0,0.00%,6,6,0.00%
ns2.hostingww.com,0,0.00%,2,2,0.00%
dns4.supremedns.com,0,0.00%,6,6,0.00%
ken.ns.cloudflare.com,0,0.00%,12,12,0.00%
dns1.supremedns.com,0,0.00%,6,6,0.00%
ns1.ezhostingserver.com,0,0.00%,2,2,0.00%
galileo.aternos.org,0,0.00%,2,2,0.00%
ns3.hostingww.com,0,0.00%,2,2,0.00%
ns2.hostpanel.me,0,0.00%,2,2,0.00%
cns1.alfahosting.info,0,0.00%,8,8,0.00%
dns2.lonex.com,0,0.00%,4,4,0.00%
ns1mpz.name.com,0,0.00%,2,2,0.00%
dns22.website.com,0,0.00%,6,6,0.00%
linda.ns.cloudflare.com,0,0.00%,4,4,0.00%
ns2.s1.hostomy.net,0,0.00%,2,2,0.00%
ns1.g4w-nameserver.de,0,0.00%,2,2,0.00%
ns1.inleed.net,0,0.00%,2,2,0.00%
ns1.s1.hostomy.net,0,0.00%,2,2,0.00%
ns1505.websitewelcome.com,0,0.00%,2,2,0.00%
ns1506.websitewelcome.com,0,0.00%,2,2,0.00%
ns6.inleed.net,0,0.00%,2,2,0.00%
ns237.hostgator.com.br,0,0.00%,2,2,0.00%
ns5.inleed.net,0,0.00%,2,2,0.00%
ns236.hostgator.com.br,0,0.00%,2,2,0.00%
ns2.inleed.net,0,0.00%,2,2,0.00%
ns3.inleed.net,0,0.00%,2,2,0.00%
ns73.websiteplex.com,0,0.00%,2,2,0.00%
blob.bn9prdstr05a.store.core.windows.NET,0,0.00%,2,2,0.00%
ns1092.ui-dns.org,0,0.00%,4,4,0.00%
gabriella.ns.cloudflare.com,0,0.00%,4,4,0.00%
ns-965.awsdns-56.net,0,0.00%,2,2,0.00%
whelk.dnspod.net,0,0.00%,2,2,0.00%
godfery.dnspod.net,0,0.00%,2,2,0.00%
ns1.amicushost.com,0,0.00%,2,2,0.00%
ns1114.ui-dns.com,0,0.00%,4,4,0.00%
ns3.za-dns.com,0,0.00%,2,2,0.00%
ns1104.ui-dns.biz,0,0.00%,2,2,0.00%
ns2.amicushost.com,0,0.00%,2,2,0.00%
ns1109.ui-dns.de,0,0.00%,4,4,0.00%
ns6428.hostgator.com,0,0.00%,2,2,0.00%
ns12.medyaweb.net,0,0.00%,2,2,0.00%
love.ns.cloudflare.com,0,0.00%,2,2,0.00%
desi.ns.cloudflare.com,0,0.00%,4,4,0.00%
ns1030.ui-dns.biz,0,0.00%,2,2,0.00%
marek.ns.cloudflare.com,0,0.00%,8,8,0.00%
ns-1010.awsdns-62.net,0,0.00%,2,2,0.00%
orca.instantdomains.com,0,0.00%,2,2,0.00%
ns-1173.awsdns-18.org,0,0.00%,2,2,0.00%
ns5.za-dns.com,0,0.00%,2,2,0.00%
coho.instantdomains.com,0,0.00%,2,2,0.00%
ns-2028.awsdns-61.co.uk,0,0.00%,2,2,0.00%
ns11.medyaweb.net,0,0.00%,2,2,0.00%
ns-156-a.gandi.net,0,0.00%,2,2,0.00%
ns-398.awsdns-49.com,0,0.00%,2,2,0.00%
ns21.servidoresseguros.com,0,0.00%,2,2,0.00%
ns-144-c.gandi.net,0,0.00%,2,2,0.00%
ns-192-b.gandi.net,0,0.00%,2,2,0.00%
ns-1992.awsdns-57.co.uk,0,0.00%,6,6,0.00%
ns3.raidboxes.net,0,0.00%,2,2,0.00%
ns-1251.awsdns-28.org,0,0.00%,2,2,0.00%
ns-399.awsdns-49.com,0,0.00%,2,2,0.00%
ns-124-c.gandi.net,0,0.00%,2,2,0.00%
ns1.raidboxes.net,0,0.00%,2,2,0.00%
bristol.ns.cloudflare.com,0,0.00%,4,4,0.00%
ns-918.awsdns-50.net,0,0.00%,2,2,0.00%
ns2.raidboxes.net,0,0.00%,2,2,0.00%
ns-45.awsdns-05.com,0,0.00%,2,2,0.00%
jinchanzijue.com,0,0.00%,2,2,0.00%
ns-741.awsdns-28.net,0,0.00%,2,2,0.00%
ns4.raidboxes.net,0,0.00%,2,2,0.00%
securedirectionpgh.com,0,0.00%,2,2,0.00%
ns3.onlydomains.com,0,0.00%,8,8,0.00%
musicstatus.itunes.apple.com,0,0.00%,5,5,0.00%
musicstatus-apac-n.edge-itunes-apple.com.akadns.net,0,0.00%,2,2,0.00%
verification-jquchc5z.ns3.dan.hosting,0,0.00%,2,2,0.00%
ns2.onlydomains.com,0,0.00%,8,8,0.00%
ns-73-b.gandi.net,0,0.00%,2,2,0.00%
ns1.onlydomains.com,0,0.00%,8,8,0.00%
train.dnspod.net,0,0.00%,2,2,0.00%
ns-141-a.gandi.net,0,0.00%,2,2,0.00%
note.ntes53.netease.com,0,0.00%,6,6,0.00%
ns14.nationbuilder.com,0,0.00%,2,2,0.00%
shades16.rzone.de,0,0.00%,10,10,0.00%
qzhmny.com,0,0.00%,1,1,0.00%
ns12.nationbuilder.com,0,0.00%,2,2,0.00%
dns2.sered.net,0,0.00%,6,6,0.00%
ns1bdg.name.com,0,0.00%,2,2,0.00%
ns10.nationbuilder.com,0,0.00%,2,2,0.00%
ns11.nationbuilder.com,0,0.00%,2,2,0.00%
ns-247-b.gandi.net,0,0.00%,2,2,0.00%
darts.dnspod.net,0,0.00%,4,4,0.00%
verification-72b1d323.ns3.dan.hosting,0,0.00%,2,2,0.00%
ns2.generichost.com,0,0.00%,2,2,0.00%
ns1.dnscpanel.com,0,0.00%,4,4,0.00%
ns-86-a.gandi.net,0,0.00%,2,2,0.00%
ns15.nationbuilder.com,0,0.00%,2,2,0.00%
first.dnspod.net,0,0.00%,4,4,0.00%
ns1.generichost.com,0,0.00%,2,2,0.00%
ns-48-c.gandi.net,0,0.00%,2,2,0.00%
ns3.dnscpanel.com,0,0.00%,4,4,0.00%
dns4.sered.net,0,0.00%,6,6,0.00%
uk1.hostbuddy.cloud,0,0.00%,2,2,0.00%
pdns05.domaincontrol.com,0,0.00%,6,6,0.00%
pdns06.domaincontrol.com,0,0.00%,6,6,0.00%
ns2.dnscpanel.com,0,0.00%,4,4,0.00%
ns71.dnszi.com,0,0.00%,2,2,0.00%
bavash.com,0,0.00%,2,2,0.00%
ns1.smartname.com,0,0.00%,2,2,0.00%
ns66.dnszi.com,0,0.00%,2,2,0.00%
ns2.smartname.com,0,0.00%,2,2,0.00%
ns14.bigwww.com,0,0.00%,2,2,0.00%
ns88.dnszi.com,0,0.00%,2,2,0.00%
beacher.dnspod.net,0,0.00%,2,2,0.00%
rns24.webhostbox.net,0,0.00%,2,2,0.00%
ns13.bigwww.com,0,0.00%,2,2,0.00%
scutum.dnspod.net,0,0.00%,2,2,0.00%
ns25.dnszi.com,0,0.00%,2,2,0.00%
ns180.superhosting.bg,0,0.00%,2,2,0.00%
ns9.dnszi.com,0,0.00%,2,2,0.00%
url.sodiao.cc,0,0.00%,2,2,0.00%
verification-kddwozqw.ns3.dan.hosting,0,0.00%,2,2,0.00%
ns179.superhosting.bg,0,0.00%,2,2,0.00%
admi972071.mercury.orderbox-dns.com,0,0.00%,2,2,0.00%
admi972071.mars.orderbox-dns.com,0,0.00%,2,2,0.00%
admi972071.venus.orderbox-dns.com,0,0.00%,2,2,0.00%
admi972071.earth.orderbox-dns.com,0,0.00%,2,2,0.00%
ns4240.hostgator.com,0,0.00%,8,8,0.00%
ns4239.hostgator.com,0,0.00%,8,8,0.00%
cns2.alfahosting.info,0,0.00%,8,8,0.00%
ns1.dns.ne.jp,0,0.00%,14,14,0.00%
ns0.thundercloud.uk,0,0.00%,2,2,0.00%
shades13.rzone.de,0,0.00%,4,4,0.00%
ns1.thundercloud.uk,0,0.00%,2,2,0.00%
docks09.rzone.de,0,0.00%,2,2,0.00%
ns1.cafe24.com,0,0.00%,16,16,0.00%
dns055.b.register.com,0,0.00%,2,2,0.00%
verification-nzxsz26k.ns3.dan.hosting,0,0.00%,2,2,0.00%
dns239.a.register.com,0,0.00%,2,2,0.00%
dns3.sered.net,0,0.00%,6,6,0.00%
ns14.cloudns.net,0,0.00%,4,4,0.00%
ns4lqx.name.com,0,0.00%,8,8,0.00%
uk2.hostbuddy.cloud,0,0.00%,2,2,0.00%
pns11.cloudns.net,0,0.00%,4,4,0.00%
ns12.cloudns.net,0,0.00%,4,4,0.00%
us.guzelhosting.com,0,0.00%,6,6,0.00%
ns2.yoncu.com,0,0.00%,6,6,0.00%
ns11.cloudns.net,0,0.00%,4,4,0.00%
tr.guzelhosting.com,0,0.00%,6,6,0.00%
hal.ns.cloudflare.com,0,0.00%,2,2,0.00%
pns12.cloudns.net,0,0.00%,4,4,0.00%
kate.ns.cloudflare.com,0,0.00%,6,6,0.00%
t-khd.2345.cc,0,0.00%,9,9,0.00%
array602.prod.do.dsp.mp.microsoft.com,0,0.00%,6,6,0.00%
mail.on101.co.uk,0,0.00%,1,1,0.00%
www.nx.xinhuanet.com,0,0.00%,2,2,0.00%
www.qh.news.cn,0,0.00%,2,2,0.00%
www.qh.xinhuanet.com,0,0.00%,2,2,0.00%
googlecode.l.googleusercontent.com,0,0.00%,2,2,0.00%
api.cloudfs.info,0,0.00%,12,12,0.00%
ext.henzanapp.com,0,0.00%,6,6,0.00%
na61-na62.wagbridge.alibaba.aliyun.com,0,0.00%,6,6,0.00%
na61-na62.wagbridge.alibaba.aliyun.com.gds.alibabadns.com,0,0.00%,6,6,0.00%
tiny.china.qiniu.com.trpcdn.net,0,0.00%,4,4,0.00%
zqnweb.v.trpcdn.net,0,0.00%,4,4,0.00%
kjk3jf40.sched.sma-dk.tdnsstic1.cn.cjt.krcdn.idatacube.com,0,0.00%,2,2,0.00%
array810.prod.do.dsp.mp.microsoft.com,0,0.00%,14,14,0.00%
ncsi-geo.trafficmanager.net,0,0.00%,2,2,0.00%
vod.news.cn,0,0.00%,2,2,0.00%
bk.n.shifen.com,0,0.00%,2,2,0.00%
bk.baidu.com,0,0.00%,2,2,0.00%
database.clamav.net,0,0.00%,58,58,0.00%
ewiki.vnexpress.net,0,0.00%,2,2,0.00%
masterconn.qq.com,0,0.00%,12,12,0.00%
masterconn2.qq.com,0,0.00%,6,6,0.00%
dedi.1808.cf,0,0.00%,122,122,0.00%
kakafdm.home.news.cn,0,0.00%,2,2,0.00%
aus5.mozilla.org,0,0.00%,9,9,0.00%
prod.balrog.prod.cloudops.mozgcp.net,0,0.00%,4,4,0.00%
api.speed.miwifi.com,0,0.00%,1,1,0.00%
twct01.graniterapids.com,0,0.00%,2,2,0.00%
hide.likeafaieog.tk,0,0.00%,1,1,0.00%
crl.usertrust.com,0,0.00%,11,11,0.00%
cloud.lixueyang.site,0,0.00%,10,10,0.00%
hd-084.stpl.net.pl,0,0.00%,1,1,0.00%
array503.prod.do.dsp.mp.microsoft.com,0,0.00%,14,14,0.00%
www.kuaidaili.com,0,0.00%,6,6,0.00%
srv01.got-skills.de,0,0.00%,61,61,0.00%
krgame06.graniterapids.com,0,0.00%,2,2,0.00%
pr.x.hub.sandai.net,0,0.00%,18,18,0.00%
anc.relaybit.top,0,0.00%,8,8,0.00%
pc.profile.pinyin.sogou.com,0,0.00%,8,8,0.00%
profile.pinyin.sogou.com,0,0.00%,12,12,0.00%
platform.bing.com,0,0.00%,19,19,0.00%
pc-store.mbgstore.lenovo.com.cn,0,0.00%,4,4,0.00%
tracker.tambovnet.org,0,0.00%,3,3,0.00%
torrent.nwps.ws,0,0.00%,1,1,0.00%
mediaclub.tv,0,0.00%,2,2,0.00%
tracker.publictorrent.net,0,0.00%,4,4,0.00%
doh.dns.sb,0,0.00%,26,26,0.00%
tracker.torrentleech.org,0,0.00%,5,5,0.00%
api.pcloud.com,0,0.00%,1,1,0.00%
us02.graniterapids.com,0,0.00%,2,2,0.00%
app.cadmoremedia.com,0,0.00%,2,2,0.00%
dpm.demdex.net,0,0.00%,6,6,0.00%
service.weather.microsoft.com,0,0.00%,2,2,0.00%
cm.everesttech.net,0,0.00%,4,4,0.00%
ins-0nhm2n93.ias.tencent-cloud.net,0,0.00%,2,2,0.00%
vpn.pcl.ac.cn,0,0.00%,2,2,0.00%
sofire.n.shifen.com,0,0.00%,1,1,0.00%
ins-609loygs.ias.tencent-cloud.net,0,0.00%,1,1,0.00%
supportmetrics.v.aaplimg.com,0,0.00%,6,6,0.00%
chat.apsgo.com,0,0.00%,6,6,0.00%
tx-nat.videojj.com,0,0.00%,2,2,0.00%
www.weibo.com,0,0.00%,3,3,0.00%
p205-fmfmobile.icloud.com.cn,0,0.00%,2,2,0.00%
pop.163.com,0,0.00%,6,6,0.00%
imap.iscas.ac.cn,0,0.00%,5,5,0.00%
appleglobal.102.112.2o7.net,0,0.00%,2,2,0.00%
weu09-breeziest-in.cloudapp.net,0,0.00%,2,2,0.00%
m8.music.126.net,0,0.00%,12,12,0.00%
array513.prod.do.dsp.mp.microsoft.com,0,0.00%,5,5,0.00%
smtp.office365.com,0,0.00%,2,2,0.00%
notify.bugsnag.com,0,0.00%,3,3,0.00%
bitbucket.org,0,0.00%,2,2,0.00%
1d83e3e8e6b57a65f526e888e184d335.clo.footprintdns.com,0,0.00%,1,1,0.00%
fcmtoken.googleapis.com,0,0.00%,4,4,0.00%
teams-ring.msedge.net,0,0.00%,6,6,0.00%
amdc-v6.alipaydns.com,0,0.00%,10,10,0.00%
securemvt.apple.com,0,0.00%,2,2,0.00%
rum8.perf.linkedin.com,0,0.00%,2,2,0.00%
lgame.tdm.qq.com,0,0.00%,8,8,0.00%
ios.crashsight.qq.com,0,0.00%,2,2,0.00%
itop.qq.com,0,0.00%,2,2,0.00%
cloudctrl.gcloud.qq.com,0,0.00%,2,2,0.00%
cloud.tgpa.qq.com,0,0.00%,3,3,0.00%
api-adservices.apple.com,0,0.00%,2,2,0.00%
gnar.grammarly.com,0,0.00%,2,2,0.00%
xueshu.baidu.com,0,0.00%,5,5,0.00%
onedscolprdneu05.northeurope.cloudapp.azure.com,0,0.00%,6,6,0.00%
cn-release-pub.lgame.qq.com,0,0.00%,2,2,0.00%
tmfmazu.m.qq.com,0,0.00%,4,4,0.00%
download.2.891218518.gcloudlgame.qq.com,0,0.00%,2,2,0.00%
puffer.4.891218518.gcloudlgame.qq.com,0,0.00%,2,2,0.00%
speed.gsdk.qq.com,0,0.00%,2,2,0.00%
queuesdk-sh.gcloud.qq.com,0,0.00%,2,2,0.00%
idmsa.apple.com,0,0.00%,2,2,0.00%
tools.tmga.qq.com,0,0.00%,2,2,0.00%
cn.voice.gcloudcs.com,0,0.00%,2,2,0.00%
control.mna.qq.com,0,0.00%,2,2,0.00%
szmg.qq.com,0,0.00%,2,2,0.00%
guid.tpns.sh.tencent.com,0,0.00%,2,2,0.00%
api.unipay.qq.com,0,0.00%,4,4,0.00%
speed.ino.qq.com,0,0.00%,2,2,0.00%
lgamem.broker.tplay.qq.com,0,0.00%,2,2,0.00%
jsonatm.broker.tplay.qq.com,0,0.00%,2,2,0.00%
access1.tpns.sh.tencent.com,0,0.00%,2,2,0.00%
cn-release-pub-room-tj.lgame.qq.com,0,0.00%,2,2,0.00%
pub.flutter-io.cn,0,0.00%,2,2,0.00%
publicfaas.game.qq.com,0,0.00%,2,2,0.00%
p206-content.icloud.com.cn,0,0.00%,4,4,0.00%
066f0144-rh8cg0-ria0w6-g0mc.pccw.alrihla.net,0,0.00%,7,7,0.00%
p207-fmip.icloud.com.cn,0,0.00%,2,2,0.00%
adv.sec.miui.com,0,0.00%,6,6,0.00%
club.bilibili.com,0,0.00%,4,4,0.00%
mall.bilibili.com,0,0.00%,10,10,0.00%
member.bilibili.com,0,0.00%,12,12,0.00%
chatsupport.apple.com,0,0.00%,2,2,0.00%
ins-cludasce.ias.tencent-cloud.net,0,0.00%,2,2,0.00%
guideupload.map.qq.com,0,0.00%,2,2,0.00%
ins-txxc9cum.ias.tencent-cloud.net,0,0.00%,2,2,0.00%
mmapgwh.map.qq.com,0,0.00%,2,2,0.00%
na61-na62.wagbridge.alibaba.taobao.com.gds.alibabadns.com,0,0.00%,2,2,0.00%
iphone-cdn-api.fitbit.com,0,0.00%,2,2,0.00%
eprint.iacr.org,0,0.00%,6,6,0.00%
ebad288.wy.glados-config.net,0,0.00%,2,2,0.00%
ebad288.ts.glados-config.net,0,0.00%,2,2,0.00%
ebad288.cw.glados-config.net,0,0.00%,2,2,0.00%
ebad288.th.glados-config.net,0,0.00%,2,2,0.00%
ebad288.ng.gladns.com,0,0.00%,2,2,0.00%
ebad288.nd.gladns.com,0,0.00%,2,2,0.00%
submit.acsac.org,0,0.00%,7,7,0.00%
pay.bilibili.com,0,0.00%,12,12,0.00%
live-trace.bilibili.com,0,0.00%,4,4,0.00%
cs.weishi.ijinshan.com,0,0.00%,2,2,0.00%
pdc.micloud.xiaomi.net,0,0.00%,4,4,0.00%
onedscolprdjpe05.japaneast.cloudapp.azure.com,0,0.00%,2,2,0.00%
16827d4fc6e54507858a3f783fc81b82.fp.measure.office.com,0,0.00%,2,2,0.00%
edge-quic-aliec1-oss.bytecdn.cn,0,0.00%,2,2,0.00%
updatecenter.qq.com,0,0.00%,4,4,0.00%
center.lanxin.cn,0,0.00%,2,2,0.00%
ali-bj-pcdn-18.biliapi.net,0,0.00%,2,2,0.00%
www.sina.com,0,0.00%,13,13,0.00%
consul.app.kdsec.org,0,0.00%,4,4,0.00%
cmonitor.iqiyi.com,0,0.00%,14,14,0.00%
imeclient.openspeech.cn,0,0.00%,7,7,0.00%
f623a9adbacb4ed993a46926677ad063.fp.measure.office.com,0,0.00%,1,1,0.00%
btrace.video.qq.com,0,0.00%,16,16,0.00%
login.cnki.net,0,0.00%,2,2,0.00%
search.cnki.net,0,0.00%,3,3,0.00%
ishufang.cnki.net,0,0.00%,4,4,0.00%
t.cnki.net,0,0.00%,3,3,0.00%
coupon.xmluren.com,0,0.00%,2,2,0.00%
dcc2.shuzilm.cn,0,0.00%,6,6,0.00%
mobile.shuzilm.cn,0,0.00%,6,6,0.00%
chidc2.outbrain.org,0,0.00%,2,2,0.00%
snz04pap002.storage.live.com,0,0.00%,2,2,0.00%
eqx.smartadserver.com,0,0.00%,2,2,0.00%
jp1.chuqiangtou.com,0,0.00%,2,2,0.00%
webrtcice.video.qq.com,0,0.00%,9,9,0.00%
cm-10-51.getui.com,0,0.00%,2,2,0.00%
fp-it.fengkongcloud.com,0,0.00%,6,6,0.00%
oth.update.mdt.qq.com,0,0.00%,2,2,0.00%
id6.me,0,0.00%,6,6,0.00%
api-fd.dutils.com,0,0.00%,6,6,0.00%
config.jpush.cn,0,0.00%,2,2,0.00%
ce3e75d5.jpush.cn,0,0.00%,2,2,0.00%
web-resource-app.xiaohongshu.com,0,0.00%,5,5,0.00%
smartop-sdkapi.jiguang.cn,0,0.00%,1,1,0.00%
api.verify.mob.com,0,0.00%,5,5,0.00%
bjuser.jpush.cn,0,0.00%,2,2,0.00%
tsis.jpush.cn,0,0.00%,2,2,0.00%
unicom.shuzilm.cn,0,0.00%,4,4,0.00%
ads-img-al.xhscdn.com,0,0.00%,4,4,0.00%
config.cmpassport.com,0,0.00%,2,2,0.00%
log-verify.mob.com,0,0.00%,3,3,0.00%
cm-10-133.getui.com,0,0.00%,2,2,0.00%
fe-static.xhscdn.com,0,0.00%,6,6,0.00%
prebid-us.creativecdn.com,0,0.00%,3,3,0.00%
nxboom.com,0,0.00%,2,2,0.00%
ps.qhupdate.com,0,0.00%,8,8,0.00%
edith.xiaohongshu.com,0,0.00%,6,6,0.00%
supportapi.lenovo.com,0,0.00%,1,1,0.00%
newsie.2345.com,0,0.00%,6,6,0.00%
api.so.lianmeng.360.cn,0,0.00%,4,4,0.00%
sp4.tf.360.cn,0,0.00%,1,1,0.00%
qspace.awehunt.com,0,0.00%,2,2,0.00%
bam.nr-data.net,0,0.00%,24,24,0.00%
devs-data.dutils.com,0,0.00%,4,4,0.00%
galaxy.person.mgtv.com,0,0.00%,2,2,0.00%
m.mpl.dutils.com,0,0.00%,6,6,0.00%
api-fc.dutils.com,0,0.00%,3,3,0.00%
dfe.mic.mob.com,0,0.00%,3,3,0.00%
api-exc.dutils.com,0,0.00%,4,4,0.00%
api.df.mob.com,0,0.00%,4,4,0.00%
dm.wo.com.cn,0,0.00%,4,4,0.00%
cm.adgrx.com,0,0.00%,3,3,0.00%
referee.xiaohongshu.com,0,0.00%,5,5,0.00%
t3.xiaohongshu.com,0,0.00%,10,10,0.00%
music.cliggo.com,0,0.00%,1,1,0.00%
report.sp.miui.com,0,0.00%,1,1,0.00%
cm-10-21.getui.com,0,0.00%,2,2,0.00%
phx02pap001.storage.live.com,0,0.00%,1,1,0.00%
appcloud.zhihu.com,0,0.00%,2,2,0.00%
jupiter.sys.miui.com,0,0.00%,2,2,0.00%
aads.shuzilm.cn,0,0.00%,6,6,0.00%
ipv4.shuzilm.cn,0,0.00%,4,4,0.00%
daa.shuzilm.cn,0,0.00%,8,8,0.00%
api.health.comm.miui.com,0,0.00%,6,6,0.00%
appbackupapi.micloud.xiaomi.net,0,0.00%,2,2,0.00%
stun.hitv.com,0,0.00%,3,3,0.00%
dl.etax.chinatax.gov.cn,0,0.00%,1,1,0.00%
r1.dianping.com,0,0.00%,6,6,0.00%
api-unionid.meituan.com,0,0.00%,6,6,0.00%
r.dianping.com,0,0.00%,4,4,0.00%
httpdns.meituan.com,0,0.00%,4,4,0.00%
babel-statistics-android.dreport.meituan.net,0,0.00%,3,3,0.00%
home.mcafee.com,0,0.00%,1,1,0.00%
appcloud2.zhihu.com,0,0.00%,4,4,0.00%
mobile.meituan.com,0,0.00%,3,3,0.00%
datahub.zhihu.com,0,0.00%,7,7,0.00%
timeservice.meituan.com,0,0.00%,3,3,0.00%
medusa.dianping.com,0,0.00%,4,4,0.00%
config2.cmpassport.com,0,0.00%,2,2,0.00%
p.meituan.com,0,0.00%,5,5,0.00%
dynamicf.sankuai.com,0,0.00%,8,8,0.00%
dxlvs.meituan.com,0,0.00%,6,6,0.00%
chatroom.meituan.com,0,0.00%,1,1,0.00%
appsec-mobile.meituan.com,0,0.00%,18,18,0.00%
s0.d.meituan.net,0,0.00%,3,3,0.00%
s.go-mpulse.net,0,0.00%,1,1,0.00%
app.mcafee.com,0,0.00%,2,2,0.00%
fallback.signal.xm.meituan.com,0,0.00%,4,4,0.00%
jp.pool.ntp.org,0,0.00%,6,6,0.00%
slp2p-east-std1054.oray.net,0,0.00%,2,2,0.00%
array501.prod.do.dsp.mp.microsoft.com,0,0.00%,6,6,0.00%
m5.d.meituan.net,0,0.00%,5,5,0.00%
p4.d.meituan.net,0,0.00%,3,3,0.00%
p10.d.meituan.net,0,0.00%,7,7,0.00%
s3plus-shon.meituan.net,0,0.00%,1,1,0.00%
p13.d.meituan.net,0,0.00%,8,8,0.00%
p16.d.meituan.net,0,0.00%,6,6,0.00%
l3-qj-prod-gs.bilibiligame.net,0,0.00%,1,1,0.00%
servicediscovery.ccs.mcafee.com,0,0.00%,8,8,0.00%
cohort.ccs.mcafee.com,0,0.00%,1,1,0.00%
p14.d.meituan.net,0,0.00%,6,6,0.00%
instruaccess.mcafee.com,0,0.00%,1,1,0.00%
data-sdk-uuid-report.dreport.meituan.net,0,0.00%,8,8,0.00%
bs5.360sres.com,0,0.00%,1,1,0.00%
bs4.360sres.com,0,0.00%,2,2,0.00%
200-service-tang-1544055741.us-east-1.elb.amazonaws.com,0,0.00%,4,4,0.00%
tracker.tvunderground.org.ru,0,0.00%,3,3,0.00%
connectivitycheck.cbg-app.huawei.com,0,0.00%,11,11,0.00%
s1.d.meituan.net,0,0.00%,3,3,0.00%
w.meituan.net,0,0.00%,1,1,0.00%
g.cn.miaozhen.com,0,0.00%,8,8,0.00%
adserver-vpc-alb-2-459505712.ap-southeast-1.elb.amazonaws.com,0,0.00%,2,2,0.00%
pay.meituan.com,0,0.00%,1,1,0.00%
ad.tencentmusic.com,0,0.00%,1,1,0.00%
timg01.bdimg.com,0,0.00%,3,3,0.00%
open.meituan.com,0,0.00%,5,5,0.00%
kf.dianping.com,0,0.00%,1,1,0.00%
a.fxltsbl.com,0,0.00%,4,4,0.00%
thirdwx.qlogo.cn,0,0.00%,11,11,0.00%
vc.y.qq.com,0,0.00%,2,2,0.00%
st.douding.cn,0,0.00%,1,1,0.00%
page.douding.cn,0,0.00%,1,1,0.00%
www.docin.com,0,0.00%,1,1,0.00%
zx.docin.com,0,0.00%,1,1,0.00%
img4.douding.cn,0,0.00%,1,1,0.00%
img3.douding.cn,0,0.00%,2,2,0.00%
img.douding.cn,0,0.00%,1,1,0.00%
img.docin.com,0,0.00%,1,1,0.00%
deviceintegritytokens-pa.googleapis.com,0,0.00%,2,2,0.00%
bf.pinyin.sogou.com,0,0.00%,4,4,0.00%
conf.hpplay.cn,0,0.00%,2,2,0.00%
gslb.hpplay.cn,0,0.00%,2,2,0.00%
ir.youdao.com,0,0.00%,2,2,0.00%
remind.api.weibo.com,0,0.00%,2,2,0.00%
static.m.cmbchina.com,0,0.00%,4,4,0.00%
marketing.cmschina.com,0,0.00%,2,2,0.00%
sdk.e.qq.com,0,0.00%,14,14,0.00%
server07.gartic.io,0,0.00%,4,4,0.00%
rb484n.jomodns.com,0,0.00%,2,2,0.00%
dsum.casalemedia.com,0,0.00%,2,2,0.00%
sdk.iad-05.braze.com,0,0.00%,2,2,0.00%
retcode.taobao.com,0,0.00%,6,6,0.00%
twd.f.360.cn,0,0.00%,6,6,0.00%
xueqiu.com,0,0.00%,2,2,0.00%
rc09-g1.oray.com,0,0.00%,2,2,0.00%
kvt.sddan.com,0,0.00%,7,7,0.00%
captive.g.aaplimg.com,0,0.00%,4,4,0.00%
commnat-main-gc.ess.apple.com,0,0.00%,9,9,0.00%
commnat-cohort-gc.ess.apple.com,0,0.00%,4,4,0.00%
p54-buy.itunes.apple.com,0,0.00%,2,2,0.00%
majsoul-hk-client.cn-hongkong.log.aliyuncs.com,0,0.00%,4,4,0.00%
rb960n.jomodns.com,0,0.00%,2,2,0.00%
baoxian.pingan.com,0,0.00%,2,2,0.00%
baoxian.pingan.com.paxdn.com,0,0.00%,2,2,0.00%
icu.wjwblog.ml,0,0.00%,61,61,0.00%
mirrors.tuna.tsinghua.edu.cn,0,0.00%,15,15,0.00%
bfdmirrors.s.tuna.tsinghua.edu.cn,0,0.00%,2,2,0.00%
ahk02.wjsq.online,0,0.00%,4,4,0.00%
cloudmeeting-kwe-mmr-2.welink.huawei.com,0,0.00%,2,2,0.00%
ccm-frontier-hl.feishu.cn,0,0.00%,6,6,0.00%
orsp.f-secure.com,0,0.00%,2,2,0.00%
tva1.sinaimg.cn,0,0.00%,7,7,0.00%
orsp-c1-ane1.aws.orsp.f-secure.com,0,0.00%,2,2,0.00%
report.banyunjuhe.com,0,0.00%,3,3,0.00%
api.banyunjuhe.com,0,0.00%,4,4,0.00%
534dbbbf246b702affa2145d24beee00.dlied1.cdntips.net,0,0.00%,3,3,0.00%
www.likecs.com,0,0.00%,4,4,0.00%
jp.cloudss.online,0,0.00%,2,2,0.00%
sdk.51.la,0,0.00%,2,2,0.00%
imgser.wangyeyixia.com,0,0.00%,2,2,0.00%
cdn.smoot.apple.com,0,0.00%,12,12,0.00%
work.weixin.qq.com,0,0.00%,2,2,0.00%
user1.likecs.com,0,0.00%,2,2,0.00%
by3302.storage.live.com,0,0.00%,9,9,0.00%
shrouded-wave-5410.morning-tundra-7160.herokuspace.com,0,0.00%,2,2,0.00%
kklulqbwyj3s3g2i2otjajef2a3kychks2t3agsbv2hdwtiymkbnueid.tor2web.it,0,0.00%,8,8,0.00%
open.e.kuaishou.com,0,0.00%,6,6,0.00%
analytics.wondershare.cc,0,0.00%,4,4,0.00%
yupao-prod.54xiaoshuo.com,0,0.00%,5,5,0.00%
mail.nfs-china.com,0,0.00%,2,2,0.00%
madx.flyme.cn,0,0.00%,6,6,0.00%
api-dandelion.flyme.cn,0,0.00%,4,4,0.00%
bkclick.n.shifen.com,0,0.00%,2,2,0.00%
v112.v2dns.bar,0,0.00%,2,2,0.00%
dispatch.b.api.cqttech.com,0,0.00%,20,20,0.00%
ssp.ibluefrog.com,0,0.00%,1,1,0.00%
track.sohu.com,0,0.00%,6,6,0.00%
p6.itc.cn,0,0.00%,1,1,0.00%
v4.passport.sohu.com,0,0.00%,5,5,0.00%
v2.sohu.com,0,0.00%,8,8,0.00%
p8.itc.cn,0,0.00%,1,1,0.00%
imp.go.sohu.com,0,0.00%,3,3,0.00%
qpb0.sohu.com,0,0.00%,2,2,0.00%
apiv2.sohu.com,0,0.00%,5,5,0.00%
t.go.sohu.com,0,0.00%,5,5,0.00%
i.go.sohu.com,0,0.00%,5,5,0.00%
lf1-cdn-tos.bytegoofy.com,0,0.00%,2,2,0.00%
su.bdstatic.com,0,0.00%,1,1,0.00%
gsp1.baidu.com,0,0.00%,2,2,0.00%
telecom.shuzilm.cn,0,0.00%,4,4,0.00%
cm-10-20.getui.com,0,0.00%,1,1,0.00%
zxid-m.mobileservice.cn,0,0.00%,3,3,0.00%
fclick.e.shifen.com,0,0.00%,4,4,0.00%
client.map.baidu.com,0,0.00%,2,2,0.00%
b-gtc.getui.net,0,0.00%,3,3,0.00%
pwo4tgrz.slt.sched.tdnsv8.com,0,0.00%,4,4,0.00%
static.googleadsserving.cn,0,0.00%,6,6,0.00%
analyticspixel.microsoft.com,0,0.00%,3,3,0.00%
a-0005.a-msedge.net,0,0.00%,2,2,0.00%
ad.doubleclick.net,0,0.00%,2,2,0.00%
dsp.ads.umeng.com,0,0.00%,4,4,0.00%
dispatch.dc.api.cqttech.com,0,0.00%,4,4,0.00%
showxml.qq.com,0,0.00%,6,6,0.00%
dashboard.snapcraft.io,0,0.00%,4,4,0.00%
flash.xiaohongshu.com,0,0.00%,2,2,0.00%
supl.platform.hicloud.com,0,0.00%,2,2,0.00%
apppush.xiaohongshu.com,0,0.00%,6,6,0.00%
tva2.sinaimg.cn,0,0.00%,14,14,0.00%
cm-10-56.getui.com,0,0.00%,2,2,0.00%
fp-afd.azurefd.net,0,0.00%,2,2,0.00%
cube.weixinbridge.com,0,0.00%,4,4,0.00%
zgcalos.mudfwd.xyz,0,0.00%,6,6,0.00%
g1.163.com,0,0.00%,4,4,0.00%
b.qchannel03.cn,0,0.00%,4,4,0.00%
wire.ws.126.net,0,0.00%,2,2,0.00%
talk.nz4.getui.com,0,0.00%,2,2,0.00%
talk.nz4.gepush.com,0,0.00%,2,2,0.00%
find.qq.com,0,0.00%,2,2,0.00%
cgi.qqweb.qq.com,0,0.00%,2,2,0.00%
cgi.find.qq.com,0,0.00%,2,2,0.00%
appbox.qq.com,0,0.00%,2,2,0.00%
appstream.ubuntu.com,0,0.00%,2,2,0.00%
download.shuzilm.cn,0,0.00%,1,1,0.00%
talk.nz4.getui.net,0,0.00%,2,2,0.00%
bjbgp01.baidupcs.com,0,0.00%,30,30,0.00%
g.ceipmsn.com,0,0.00%,3,3,0.00%
wagbridge.amap.com,0,0.00%,2,2,0.00%
collapsar.amap.com,0,0.00%,2,2,0.00%
www.qchannel01.cn,0,0.00%,4,4,0.00%
space.bilibili.com,0,0.00%,4,4,0.00%
dnsscan.shadowserver.org,0,0.00%,26,26,0.00%
vcl-brain.snssdk.com,0,0.00%,6,6,0.00%
vc-mirror.snssdk.com,0,0.00%,1,1,0.00%
connectivity.samsung.com.cn,0,0.00%,2,2,0.00%
v6-x.douyinvod.com,0,0.00%,2,2,0.00%
onedscolprdcus14.centralus.cloudapp.azure.com,0,0.00%,7,7,0.00%
majorworklink.com,0,0.00%,1,1,0.00%
v3.douyinvod.com,0,0.00%,1,1,0.00%
imcdn.co,0,0.00%,1,1,0.00%
sea.notifications.skype.com,0,0.00%,2,2,0.00%
push-rest.zui.com,0,0.00%,2,2,0.00%
inferno.demonoid.pw,0,0.00%,1,1,0.00%
bclearning.top,0,0.00%,2,2,0.00%
softwareupdate.vmware.com,0,0.00%,2,2,0.00%
cb.e.shifen.com,0,0.00%,6,6,0.00%
ipv6.open-internet.nl,0,0.00%,2,2,0.00%
api.biliapi.net,0,0.00%,2,2,0.00%
qa.sockets.stackexchange.com,0,0.00%,3,3,0.00%
i.gdt.qq.com,0,0.00%,2,2,0.00%
coral.qq.com,0,0.00%,2,2,0.00%
pingtas.qq.com,0,0.00%,2,2,0.00%
l.qq.com,0,0.00%,2,2,0.00%
sdkmonitor.biz.weibo.com,0,0.00%,8,8,0.00%
adstrategy.biz.weibo.com,0,0.00%,8,8,0.00%
sdkaction.biz.weibo.com,0,0.00%,4,4,0.00%
livep.l.qq.com,0,0.00%,4,4,0.00%
p.l.qq.com,0,0.00%,2,2,0.00%
adss.video.qq.com,0,0.00%,2,2,0.00%
camera.lei001.com,0,0.00%,2,2,0.00%
www.ssg.com,0,0.00%,4,4,0.00%
cm.l.qq.com,0,0.00%,2,2,0.00%
report.fantuants.com,0,0.00%,4,4,0.00%
isatap.tsinghua.edu.cn,0,0.00%,2,2,0.00%
gaming-config.asus.com,0,0.00%,2,2,0.00%
travelservice-drcn.emui.hicloud.com,0,0.00%,6,6,0.00%
chrome.cloudflare-dns.com,0,0.00%,3,3,0.00%
chi01pap002.storage.live.com,0,0.00%,4,4,0.00%
agps.location.live.net,0,0.00%,2,2,0.00%
ws.infinitynewtab.com,0,0.00%,2,2,0.00%
ext3-hkg1.steamserver.net,0,0.00%,4,4,0.00%
cm3-sgp1.cm.steampowered.com,0,0.00%,4,4,0.00%
cm1-tyo2.cm.steampowered.com,0,0.00%,2,2,0.00%
pc.api.360kan.com,0,0.00%,4,4,0.00%
p.s.360kan.com,0,0.00%,7,7,0.00%
api.biliapi.com,0,0.00%,2,2,0.00%
ext1-hkg1.steamserver.net,0,0.00%,6,6,0.00%
tjtv3.wn51.com,0,0.00%,12,12,0.00%
kl.hnayg.com,0,0.00%,4,4,0.00%
ad.xwdsp.com,0,0.00%,2,2,0.00%
1.mini.eastday.com,0,0.00%,4,4,0.00%
kyjh.hnayg.com,0,0.00%,2,2,0.00%
show.3.mediav.com,0,0.00%,2,2,0.00%
tj.wn51.com,0,0.00%,2,2,0.00%
cm1-tyo1.cm.steampowered.com,0,0.00%,4,4,0.00%
clientnotification-userprodscus1-2.servicebus.windows.net,0,0.00%,17,17,0.00%
ad.us.sinaimg.cn,0,0.00%,13,13,0.00%
rls-proxy-01.chinaeast2.cloudapp.chinacloudapi.cn,0,0.00%,2,2,0.00%
www.icloud.g.aaplimg.com,0,0.00%,4,4,0.00%
msn.com,0,0.00%,2,2,0.00%
www.msn.com,0,0.00%,2,2,0.00%
messaging.ccs.mcafee.com,0,0.00%,2,2,0.00%
www.istylepdf.com,0,0.00%,1,1,0.00%
trouter-azsc-asse-0-b.trouter.skype.com,0,0.00%,2,2,0.00%
rta.xboxlive.com,0,0.00%,2,2,0.00%
notificationinbox.xboxlive.com,0,0.00%,2,2,0.00%
chat.xboxlive.com,0,0.00%,2,2,0.00%
steamcloud-hkg.oss-accelerate.aliyuncs.com,0,0.00%,2,2,0.00%
rog-live-service.asus.com,0,0.00%,2,2,0.00%
xblmessaging.xboxlive.com,0,0.00%,2,2,0.00%
privacy.xboxlive.com,0,0.00%,2,2,0.00%
img.mb.cmbimg.com,0,0.00%,2,2,0.00%
presence.teams.live.com,0,0.00%,2,2,0.00%
open.facedatabg.net,0,0.00%,2,2,0.00%
fantuantanshu.datasink.sensorsdata.cn,0,0.00%,4,4,0.00%
open.upeer.org,0,0.00%,1,1,0.00%
tracker.monitorit4.me,0,0.00%,2,2,0.00%
public.popcorn-tracker.org,0,0.00%,2,2,0.00%
router14.teamviewer.com,0,0.00%,17,17,0.00%
stun.l.google.com,0,0.00%,2,2,0.00%
torr.ws,0,0.00%,2,2,0.00%
captcha.qq.com,0,0.00%,2,2,0.00%
data.hexin.cn,0,0.00%,2,2,0.00%
bi.10jqka.com.cn,0,0.00%,2,2,0.00%
stat.10jqka.com.cn,0,0.00%,4,4,0.00%
download.jetbrains.com,0,0.00%,12,12,0.00%
run.publictracker.xyz,0,0.00%,2,2,0.00%
author.baidu.com,0,0.00%,3,3,0.00%
jianyi.baidu.com,0,0.00%,3,3,0.00%
i.baidu.com,0,0.00%,4,4,0.00%
top.baidu.com,0,0.00%,3,3,0.00%
storage.jd.com,0,0.00%,2,2,0.00%
dispatcher.is.autonavi.com.gds.alibabadns.com,0,0.00%,16,16,0.00%
passport.aliyundrive.com,0,0.00%,2,2,0.00%
update.pc.mi.com,0,0.00%,6,6,0.00%
m.addthis.com,0,0.00%,2,2,0.00%
f8293015-rh7400-rrfsly-dmr0.pccw.alrihla.net,0,0.00%,9,9,0.00%
static.hotjar.com,0,0.00%,2,2,0.00%
api.fanyi.baidu.com,0,0.00%,3,3,0.00%
sdk.split.io,0,0.00%,9,9,0.00%
radarsubmissions.apple.com,0,0.00%,12,12,0.00%
appleimap.163.com,0,0.00%,7,7,0.00%
only-648766-159-226-95-67.nstool.321fenx.com,0,0.00%,1,1,0.00%
auth.split.io,0,0.00%,2,2,0.00%
keyvalueservice.icloud.com.cn,0,0.00%,10,10,0.00%
p212-keyvalueservice.icloud.com.cn,0,0.00%,2,2,0.00%
p212-escrowproxy.icloud.com.cn,0,0.00%,2,2,0.00%
apd-967ba12da5a0ed4560941a7046e84651.v.smtcdns.com,0,0.00%,2,2,0.00%
pbaccess.video.qq.com,0,0.00%,12,12,0.00%
tycs.hpccube.com,0,0.00%,8,8,0.00%
wp.mail.qq.com,0,0.00%,9,9,0.00%
s7.addthis.com,0,0.00%,4,4,0.00%
v.aty.sohu.com,0,0.00%,2,2,0.00%
vm.aty.sohu.com,0,0.00%,2,2,0.00%
analytics.getpostman.com,0,0.00%,16,16,0.00%
p212-caldav.icloud.com.cn,0,0.00%,4,4,0.00%
tracker.ddunlimited.net,0,0.00%,4,4,0.00%
tr.bangumi.moe,0,0.00%,4,4,0.00%
tracker.leech.ie,0,0.00%,2,2,0.00%
tracker.publictracker.xyz,0,0.00%,1,1,0.00%
klone-mobile-12.vapp-servers.com,0,0.00%,1,1,0.00%
tracker.open-internet.nl,0,0.00%,4,4,0.00%
tracker.theoks.net,0,0.00%,2,2,0.00%
q-client.cn-hongkong.log.aliyuncs.com,0,0.00%,4,4,0.00%
fe-mtweapp-log.dreport.meituan.net,0,0.00%,6,6,0.00%
ss-prod-an1-notif-19.aws.adobess.com,0,0.00%,4,4,0.00%
oth.ludashi.com,0,0.00%,4,4,0.00%
client-log.kuwo.cn,0,0.00%,2,2,0.00%
discovery.lenovo.com.cn,0,0.00%,6,6,0.00%
cl4-cn.ls-apple.com.akadns.net,0,0.00%,4,4,0.00%
www.hxkba.com,0,0.00%,1,1,0.00%
lqejsl851amke4fa6oan4l744502ehs5i3486lqf59f096v4r8pvu5t3.tt.x.bsgslb.cn,0,0.00%,1,1,0.00%
is4-ssl.mzstatic.com,0,0.00%,1,1,0.00%
hag-drcn.op.dbankcloud.com,0,0.00%,1,1,0.00%
img-3.pddpic.com,0,0.00%,1,1,0.00%
dataservice.protection.outlook.com,0,0.00%,5,5,0.00%
messaging.lifecycle.office.com,0,0.00%,1,1,0.00%
autodiscover-s.outlook.com,0,0.00%,1,1,0.00%
autodiscover.365ms.vip,0,0.00%,1,1,0.00%
open.kwaizt.com,0,0.00%,1,1,0.00%
szshort6.weixin.qq.com,0,0.00%,1,1,0.00%
aidatatest.zhihu.com,0,0.00%,2,2,0.00%
s.xinshuru.com,0,0.00%,9,9,0.00%
globalapi.juneyaoair.com,0,0.00%,11,11,0.00%
www.world68.com,0,0.00%,1,1,0.00%
img-2.pddpic.com,0,0.00%,1,1,0.00%
notes-analytics-events.news.apple-dns.net,0,0.00%,3,3,0.00%
ipchaxun.com,0,0.00%,1,1,0.00%
mw.flypgs.com,0,0.00%,6,6,0.00%
tva4.sinaimg.cn,0,0.00%,16,16,0.00%
ww2.sinaimg.cn,0,0.00%,1,1,0.00%
ww4.sinaimg.cn,0,0.00%,1,1,0.00%
ww3.sinaimg.cn,0,0.00%,1,1,0.00%
httpdns.kwd.inkuai.com,0,0.00%,7,7,0.00%
vdposter.bdstatic.com,0,0.00%,1,1,0.00%
open.kuaishouzt.com,0,0.00%,7,7,0.00%
news.hbtv.com.cn,0,0.00%,1,1,0.00%
res.cjyun.org,0,0.00%,1,1,0.00%
img.cjyun.org,0,0.00%,1,1,0.00%
app.cjyun.org,0,0.00%,1,1,0.00%
wenming.cjyun.org,0,0.00%,1,1,0.00%
gdj.hubei.gov.cn,0,0.00%,1,1,0.00%
wsxf.hbzw.gov.cn,0,0.00%,1,1,0.00%
www.hbgbdst.com,0,0.00%,1,1,0.00%
www.hbja.cn,0,0.00%,1,1,0.00%
www.hbwhcyw.com,0,0.00%,1,1,0.00%
www.hubei.gov.cn,0,0.00%,1,1,0.00%
www.people.com.cn,0,0.00%,1,1,0.00%
www.nrta.gov.cn,0,0.00%,1,1,0.00%
www.zgjx.cn,0,0.00%,1,1,0.00%
zwfw.hubei.gov.cn,0,0.00%,1,1,0.00%
www.xinhuanet.com,0,0.00%,1,1,0.00%
tj.cjyun.org,0,0.00%,1,1,0.00%
videoplus.cjyun.org,0,0.00%,1,1,0.00%
update.khd.2345.cc,0,0.00%,1,1,0.00%
ts.helper.2345.cc,0,0.00%,1,1,0.00%
mtusgate.de,0,0.00%,1,1,0.00%
pica.zhimg.com.download.ks-cdn.com,0,0.00%,1,1,0.00%
ddx.gubit.cn,0,0.00%,1,1,0.00%
by3301.storage.live.com,0,0.00%,3,3,0.00%
mobilelog.kugou.com,0,0.00%,3,3,0.00%
ipv4-ipv6-phase4.tsp-web.vip.meituan.com,0,0.00%,2,2,0.00%
plx.meituan.com,0,0.00%,2,2,0.00%
orcid.org,0,0.00%,5,5,0.00%
v6.s.360.cn,0,0.00%,4,4,0.00%
ip.3322.net,0,0.00%,2,2,0.00%
softlog.ahhxwavi.cn,0,0.00%,4,4,0.00%
g.us.sinaimg.cn,0,0.00%,3,3,0.00%
lynxbee.com,0,0.00%,1,1,0.00%
humb.apple.com,0,0.00%,1,1,0.00%
ced.sascdn.com,0,0.00%,1,1,0.00%
spl.zeotap.com,0,0.00%,1,1,0.00%
s.cn.bing.chinacache.net,0,0.00%,1,1,0.00%
c.4dex.io,0,0.00%,1,1,0.00%
ghb.adtelligent.com,0,0.00%,1,1,0.00%
tlx.3lift.com,0,0.00%,1,1,0.00%
ajax.googleapis.com,0,0.00%,1,1,0.00%
cdn.sstatic.net,0,0.00%,2,2,0.00%
i.stack.imgur.com,0,0.00%,1,1,0.00%
www.gravatar.com,0,0.00%,18,18,0.00%
askubuntu.com,0,0.00%,1,1,0.00%
widget.publishub.optimhub.com,0,0.00%,1,1,0.00%
conf-drcn.cloud.dbankcloud.cn,0,0.00%,7,7,0.00%
b1sync.zemanta.com,0,0.00%,3,3,0.00%
hublnk.com,0,0.00%,1,1,0.00%
creativecdn.com,0,0.00%,1,1,0.00%
eb2.3lift.com,0,0.00%,1,1,0.00%
ic.tynt.com,0,0.00%,1,1,0.00%
sync.richaudience.com,0,0.00%,1,1,0.00%
csync.smilewanted.com,0,0.00%,1,1,0.00%
s.adtelligent.com,0,0.00%,1,1,0.00%
s.uuidksinc.net,0,0.00%,1,1,0.00%
pixel-sync.sitescout.com,0,0.00%,14,14,0.00%
triplelift-match.dotomi.com,0,0.00%,1,1,0.00%
ad.a-ads.com,0,0.00%,7,7,0.00%
sync.adtelligent.com,0,0.00%,1,1,0.00%
ad.admitad.com,0,0.00%,1,1,0.00%
de.tynt.com,0,0.00%,1,1,0.00%
sync.spotim.market,0,0.00%,1,1,0.00%
dm.hybrid.ai,0,0.00%,1,1,0.00%
dmp.gotechnology.io,0,0.00%,2,2,0.00%
cms.quantserve.com,0,0.00%,3,3,0.00%
cdn.admitad-connect.com,0,0.00%,1,1,0.00%
rtb.com.ru,0,0.00%,1,1,0.00%
go.ezodn.com,0,0.00%,1,1,0.00%
cdn.connectad.io,0,0.00%,1,1,0.00%
u.openx.net,0,0.00%,1,1,0.00%
us.creativecdn.com,0,0.00%,2,2,0.00%
office15client.microsoft.com,0,0.00%,3,3,0.00%
api3-normal-hl.toutiaoapi.com,0,0.00%,1,1,0.00%
bizhi.shanhutech.cn,0,0.00%,4,4,0.00%
ghb1.adtelligent.com,0,0.00%,2,2,0.00%
ghb2.adtelligent.com,0,0.00%,1,1,0.00%
d.turn.com,0,0.00%,1,1,0.00%
t8868567577997562992.id.amgdgt.com,0,0.00%,1,1,0.00%
ce.lijit.com,0,0.00%,1,1,0.00%
toutiao.com,0,0.00%,3,3,0.00%
logintcpnv.wps.cn,0,0.00%,9,9,0.00%
bttrack.com,0,0.00%,2,2,0.00%
vcode-api-fnk.vivo.com.cn,0,0.00%,4,4,0.00%
rtb-csync.smartadserver.com,0,0.00%,1,1,0.00%
b5n.1password.com,0,0.00%,1,1,0.00%
www.booking.com,0,0.00%,3,3,0.00%
a.nel.cloudflare.com,0,0.00%,4,4,0.00%
api.foxitreader.cn,0,0.00%,4,4,0.00%
data.adsrvr.org,0,0.00%,2,2,0.00%
media-exp1.licdn.com,0,0.00%,1,1,0.00%
fides-pol.apple.com,0,0.00%,1,1,0.00%
clientlogvodp2p.haplat.net,0,0.00%,3,3,0.00%
img.maitao.com,0,0.00%,3,3,0.00%
pixel.quantserve.com,0,0.00%,2,2,0.00%
osiprod-krc-celadon-000.cloudapp.net,0,0.00%,3,3,0.00%
gd-stats.jpush.cn,0,0.00%,2,2,0.00%
update65.nomachine.com,0,0.00%,2,2,0.00%
d.clarity.ms,0,0.00%,3,3,0.00%
prebid.a-mo.net,0,0.00%,1,1,0.00%
only-865396-124-16-140-6.nstool.yqkk.link,0,0.00%,1,1,0.00%
wbs.icbc.com.cn,0,0.00%,2,2,0.00%
caproxy.video.weibocdn.com,0,0.00%,2,2,0.00%
eap-log-cn.allawntech.com,0,0.00%,2,2,0.00%
gaea.meituan.com,0,0.00%,5,5,0.00%
mop.meituan.com,0,0.00%,5,5,0.00%
tuanfriend.meituan.com,0,0.00%,7,7,0.00%
passport.meituan.com,0,0.00%,2,2,0.00%
q4.qlogo.cn,0,0.00%,4,4,0.00%
mars.meituan.com,0,0.00%,2,2,0.00%
m0.d.meituan.net,0,0.00%,2,2,0.00%
aop.meituan.com,0,0.00%,7,7,0.00%
weather.meituan.com,0,0.00%,2,2,0.00%
collect.hupu.com,0,0.00%,2,2,0.00%
im-api.meituan.com,0,0.00%,7,7,0.00%
file.neixin.cn,0,0.00%,2,2,0.00%
pubmsg.meituan.com,0,0.00%,6,6,0.00%
tsmapi.pay.xiaomi.com,0,0.00%,2,2,0.00%
d.xfinfr.com,0,0.00%,2,2,0.00%
qinfo.clt.qq.com,0,0.00%,2,2,0.00%
qun.qq.com,0,0.00%,2,2,0.00%
badjs.qq.com,0,0.00%,2,2,0.00%
sjz.ke.com,0,0.00%,2,2,0.00%
www.bingapis.com,0,0.00%,2,2,0.00%
haveaniceday.gitee.com,0,0.00%,2,2,0.00%
cloudi.browser.oppomobile.com,0,0.00%,2,2,0.00%
gitee.cn,0,0.00%,2,2,0.00%
m6.d.meituan.net,0,0.00%,2,2,0.00%
oschina.gitee.io,0,0.00%,4,4,0.00%
scan.call.f.360.cn,0,0.00%,2,2,0.00%
bp.conf.f.360.cn,0,0.00%,4,4,0.00%
m.anjuke.com,0,0.00%,2,2,0.00%
webservices.agi.com,0,0.00%,1,1,0.00%
anti-sdk-ccs.m.jd.com,0,0.00%,2,2,0.00%
ccfjma.m.jd.com,0,0.00%,2,2,0.00%
rjsb-token-m.jd.com,0,0.00%,2,2,0.00%
knicks.jd.com,0,0.00%,2,2,0.00%
jpushjd.m.jd.com,0,0.00%,8,8,0.00%
lbsapi.m.jd.com,0,0.00%,10,10,0.00%
un.m.jd.com,0,0.00%,2,2,0.00%
plogin.m.jd.com,0,0.00%,2,2,0.00%
homepage-gw.jd.com,0,0.00%,2,2,0.00%
content.fe.apple-dns.cn,0,0.00%,2,2,0.00%
st.jingxi.com,0,0.00%,2,2,0.00%
plus.m.jd.com,0,0.00%,2,2,0.00%
wqlogin2.jd.com,0,0.00%,2,2,0.00%
rsp.jd.com,0,0.00%,2,2,0.00%
h5speed.m.jd.com,0,0.00%,4,4,0.00%
uranus.jd.com,0,0.00%,2,2,0.00%
prebjdata1.anihpvhiv2333.xyz,0,0.00%,4,4,0.00%
contacts.fe.apple-dns.net,0,0.00%,4,4,0.00%
adx.ads.heytapmobi.com,0,0.00%,2,2,0.00%
kunpeng-sc.csdnimg.cn,0,0.00%,4,4,0.00%
tuihuan.jd.com,0,0.00%,2,2,0.00%
fd.3.cn.gslb.qianxun.com,0,0.00%,2,2,0.00%
ex.m.jd.com.gslb.qianxun.com,0,0.00%,2,2,0.00%
meta.pinduoduo.com,0,0.00%,6,6,0.00%
commimg-1.pddpic.com,0,0.00%,2,2,0.00%
m.pinduoduo.net,0,0.00%,2,2,0.00%
ta.pinduoduo.com,0,0.00%,2,2,0.00%
api-drcn.music.dbankcloud.cn,0,0.00%,2,2,0.00%
planconfig.openspeech.cn,0,0.00%,2,2,0.00%
time1.google.com,0,0.00%,2,2,0.00%
rhdc-acs.m.taobao.com,0,0.00%,2,2,0.00%
array804.prod.do.dsp.mp.microsoft.com,0,0.00%,4,4,0.00%
www.manongjc.com,0,0.00%,2,2,0.00%
time2.google.com,0,0.00%,2,2,0.00%
business.smartcamera.api.io.mi.com,0,0.00%,2,2,0.00%
api.io.mi.com,0,0.00%,2,2,0.00%
time3.google.com,0,0.00%,2,2,0.00%
p72-contacts.icloud.com,0,0.00%,2,2,0.00%
dev.virtualearth.net,0,0.00%,2,2,0.00%
time4.google.com,0,0.00%,2,2,0.00%
up-ck.zhhainiao.com,0,0.00%,2,2,0.00%
analysis.leetcode.cn,0,0.00%,2,2,0.00%
httpdns-sdk.n.netease.com,0,0.00%,2,2,0.00%
only-204697-124-16-140-6.nstool.laiqukankan.com,0,0.00%,1,1,0.00%
only-263465-124-16-140-6.nstool.laiqukankan.com,0,0.00%,1,1,0.00%
only-271485-124-16-140-6.nstool.laiqukankan.com,0,0.00%,1,1,0.00%
only-272874-124-16-140-6.nstool.laiqukankan.com,0,0.00%,1,1,0.00%
only-442863-124-16-140-6.nstool.laiqukankan.com,0,0.00%,1,1,0.00%
only-414794-124-16-140-6.nstool.laiqukankan.com,0,0.00%,1,1,0.00%
csm.sg1.as.criteo.net,0,0.00%,4,4,0.00%
api.qrserver.com,0,0.00%,3,3,0.00%
movie.douban.com,0,0.00%,4,4,0.00%
m.douban.com,0,0.00%,4,4,0.00%
ad.doubanio.com,0,0.00%,6,6,0.00%
us-u.openx.net,0,0.00%,4,4,0.00%
um.simpli.fi,0,0.00%,2,2,0.00%
cm.v3w.mojichina.com,0,0.00%,2,2,0.00%
ins-bd1wfwcf.ias.tencent-cloud.net,0,0.00%,2,2,0.00%
p212-quota.icloud.com.cn,0,0.00%,2,2,0.00%
only-430870-124-16-140-6.nstool.321fenx.com,0,0.00%,1,1,0.00%
query.prod.cms.rt.microsoft.com,0,0.00%,2,2,0.00%
pregzdata1.anihpvhiv2333.xyz,0,0.00%,2,2,0.00%
skdisplay.jd.com,0,0.00%,4,4,0.00%
v26-ipv6.douyinvod.com,0,0.00%,2,2,0.00%
uri6.com,0,0.00%,3,3,0.00%
array807.prod.do.dsp.mp.microsoft.com,0,0.00%,6,6,0.00%
array802.prod.do.dsp.mp.microsoft.com,0,0.00%,8,8,0.00%
s3m5.fenxi.com,0,0.00%,4,4,0.00%
pleivxf.jxpoam.xyz,0,0.00%,2,2,0.00%
only-99924-124-16-140-6.nstool.zhuanzfx.com,0,0.00%,1,1,0.00%
pic4.iqiyipic.com,0,0.00%,2,2,0.00%
rtb.flyme.cn,0,0.00%,2,2,0.00%
v2.gdt.qq.com,0,0.00%,8,8,0.00%
win.gdt.qq.com,0,0.00%,4,4,0.00%
t-flow.flyme.cn,0,0.00%,2,2,0.00%
api-flow.flyme.cn,0,0.00%,2,2,0.00%
adm.zookingsoft.com,0,0.00%,2,2,0.00%
safe.meizu.com,0,0.00%,2,2,0.00%
ssc-api.banqumusic.com,0,0.00%,2,2,0.00%
ssp-api.banqumusic.com,0,0.00%,2,2,0.00%
music-api.banqumusic.com,0,0.00%,2,2,0.00%
api.meizu.com,0,0.00%,2,2,0.00%
bqapi.tingmall.com,0,0.00%,2,2,0.00%
app-site-association.cdn-apple.com,0,0.00%,5,5,0.00%
api-theme.meizu.com,0,0.00%,2,2,0.00%
api-game.meizu.com,0,0.00%,2,2,0.00%
onemind.meizu.com,0,0.00%,2,2,0.00%
hades.meizu.com,0,0.00%,2,2,0.00%
policy.jd.com.gslb.qianxun.com,0,0.00%,2,2,0.00%
chaohua.sinaimg.cn,0,0.00%,2,2,0.00%
serviceplus.phytium.com.cn,0,0.00%,8,8,0.00%
uxip.meizu.com,0,0.00%,2,2,0.00%
releases.hyper.is,0,0.00%,1,1,0.00%
hyper-news.now.sh,0,0.00%,2,2,0.00%
hyper-news.vercel.app,0,0.00%,2,2,0.00%
simg.s.weibo.com,0,0.00%,10,10,0.00%
intf-pc.shanhutech.cn,0,0.00%,2,2,0.00%
apps.yunfan.me,0,0.00%,2,2,0.00%
h5.vedamobi.com,0,0.00%,2,2,0.00%
fastlane.rubiconproject.com,0,0.00%,2,2,0.00%
login.sina.com.cn,0,0.00%,6,6,0.00%
a.audrte.com,0,0.00%,2,2,0.00%
cookie-matching.mediarithmics.com,0,0.00%,4,4,0.00%
wuji.video.qq.com,0,0.00%,2,2,0.00%
p.qpic.cn,0,0.00%,2,2,0.00%
ins-dwgaq849.ias.tencent-cloud.net,0,0.00%,2,2,0.00%
array805.prod.do.dsp.mp.microsoft.com,0,0.00%,2,2,0.00%
sdkconfig.video.qq.com,0,0.00%,2,2,0.00%
punch.p2p.qq.com,0,0.00%,2,2,0.00%
7jmrbtrvkgcqkldzyob4kotpyvsgz546yvik2xv4rpnfmrhe4imxthqd.tor2web.it,0,0.00%,2,2,0.00%
ns3.binero.se,0,0.00%,6,6,0.00%
ns-1151.awsdns-15.org,0,0.00%,2,2,0.00%
ns13.hostjett.com,0,0.00%,2,2,0.00%
ns4.binero.se,0,0.00%,6,6,0.00%
ns-1813.awsdns-34.co.uk,0,0.00%,2,2,0.00%
ns2.domaindiscount24.net,0,0.00%,4,4,0.00%
ns-213-a.gandi.net,0,0.00%,2,2,0.00%
ns5.binero.se,0,0.00%,6,6,0.00%
ns-313.awsdns-39.com,0,0.00%,2,2,0.00%
ns6.binero.se,0,0.00%,6,6,0.00%
ns-902.awsdns-48.net,0,0.00%,4,4,0.00%
jp01-vm0.entry.srthdw.art,0,0.00%,8,8,0.00%
nico.ns.cloudflare.com,0,0.00%,2,2,0.00%
ns21.hostjett.com,0,0.00%,2,2,0.00%
ns-251-c.gandi.net,0,0.00%,2,2,0.00%
elinore.ns.cloudflare.com,0,0.00%,4,4,0.00%
verification-4u6uhod3.ns3.dan.hosting,0,0.00%,6,6,0.00%
ns4236.hostgator.com,0,0.00%,2,2,0.00%
verification-no6dglgv.ns3.dan.hosting,0,0.00%,2,2,0.00%
ns31.hostjett.com,0,0.00%,2,2,0.00%
lex.ns.cloudflare.com,0,0.00%,6,6,0.00%
ns1.site5.com,0,0.00%,6,6,0.00%
tztyjd.com,0,0.00%,2,2,0.00%
rum18.perf.linkedin.com,0,0.00%,2,2,0.00%
blob.dsm08prdstr14a.store.core.windows.NET,0,0.00%,4,4,0.00%
vibiuv.space,0,0.00%,2,2,0.00%
skxfy.com,0,0.00%,2,2,0.00%
86dd4d0626634b4798e642034996c00f.fp.measure.office.com,0,0.00%,1,1,0.00%
37.push2his.eastmoney.com,0,0.00%,6,6,0.00%
96.push2his.eastmoney.com,0,0.00%,2,2,0.00%
34.push2his.eastmoney.com,0,0.00%,2,2,0.00%
hk01-vm5.entry.sdjighbiuodrfhgiuo.beauty,0,0.00%,6,6,0.00%
87.push2his.eastmoney.com,0,0.00%,2,2,0.00%
50.push2his.eastmoney.com,0,0.00%,4,4,0.00%
80.push2his.eastmoney.com,0,0.00%,2,2,0.00%
nina.ns.cloudflare.com,0,0.00%,6,6,0.00%
ipinfo.io,0,0.00%,5,5,0.00%
hk4e-sdk.mihoyo.com,0,0.00%,2,2,0.00%
sqt.gtimg.cn,0,0.00%,2,2,0.00%
16.push2his.eastmoney.com,0,0.00%,4,4,0.00%
2.push2his.eastmoney.com,0,0.00%,4,4,0.00%
77.push2his.eastmoney.com,0,0.00%,4,4,0.00%
verification-745daa83.ns3.dan.hosting,0,0.00%,2,2,0.00%
martin.ns.cloudflare.com,0,0.00%,14,14,0.00%
santino.ns.cloudflare.com,0,0.00%,2,2,0.00%
dns1.stabletransit.com,0,0.00%,4,4,0.00%
ns-183-a.gandi.net,0,0.00%,2,2,0.00%
ns-75-b.gandi.net,0,0.00%,2,2,0.00%
shee9noh.nodedata.net,0,0.00%,2,2,0.00%
teagan.ns.cloudflare.com,0,0.00%,2,2,0.00%
hw.mail.163.com,0,0.00%,2,2,0.00%
ns-134-c.gandi.net,0,0.00%,2,2,0.00%
ns-151-a.gandi.net,0,0.00%,2,2,0.00%
ns2.corpservers.net,0,0.00%,2,2,0.00%
ns1113.ui-dns.com,0,0.00%,2,2,0.00%
ns1056.ui-dns.org,0,0.00%,6,6,0.00%
verification-qspqykui.ns3.dan.hosting,0,0.00%,2,2,0.00%
ns-rs1.gmoserver.jp,0,0.00%,10,10,0.00%
frankbush.com,0,0.00%,2,2,0.00%
ns-165-b.gandi.net,0,0.00%,2,2,0.00%
ns1.cafe24dns.co.kr,0,0.00%,4,4,0.00%
ns1.mycyberhosting.com,0,0.00%,2,2,0.00%
pdns12.domaincontrol.com,0,0.00%,12,12,0.00%
ns-34-c.gandi.net,0,0.00%,2,2,0.00%
tjccip.com,0,0.00%,2,2,0.00%
ns1113.ui-dns.org,0,0.00%,2,2,0.00%
ns3.cafe24dns.co.kr,0,0.00%,4,4,0.00%
moura.ns.cloudflare.com,0,0.00%,4,4,0.00%
angelina.ns.cloudflare.com,0,0.00%,10,10,0.00%
dane.ns.cloudflare.com,0,0.00%,12,12,0.00%
ned.ns.cloudflare.com,0,0.00%,4,4,0.00%
ns2.site5.com,0,0.00%,6,6,0.00%
ns1079.ui-dns.com,0,0.00%,2,2,0.00%
ns.mycyberhosting.com,0,0.00%,2,2,0.00%
jpvariedades.com,0,0.00%,2,2,0.00%
ns2.instradns.com,0,0.00%,2,2,0.00%
ns1.instradns.com,0,0.00%,2,2,0.00%
ns3.instradns.com,0,0.00%,2,2,0.00%
ns1078.ui-dns.de,0,0.00%,2,2,0.00%
nelly.ns.cloudflare.com,0,0.00%,2,2,0.00%
ns1085.ui-dns.biz,0,0.00%,2,2,0.00%
vipns1.oscloudcdns.com,0,0.00%,2,2,0.00%
nick.ns.cloudflare.com,0,0.00%,2,2,0.00%
zpworker2.com,0,0.00%,2,2,0.00%
piper.ns.cloudflare.com,0,0.00%,2,2,0.00%
vipns1.oscloudcdns.net,0,0.00%,2,2,0.00%
bonnie.ns.cloudflare.com,0,0.00%,14,14,0.00%
ns1.mycairohosting.com,0,0.00%,2,2,0.00%
verification-j6qfbec9.ns3.dan.hosting,0,0.00%,2,2,0.00%
ns1.misk.com,0,0.00%,4,4,0.00%
ns350.dnsever.com,0,0.00%,2,2,0.00%
ns2.mycairohosting.com,0,0.00%,2,2,0.00%
shades07.rzone.de,0,0.00%,6,6,0.00%
ns2.misk.com,0,0.00%,4,4,0.00%
dns18.servidoresdns.net,0,0.00%,2,2,0.00%
docks02.rzone.de,0,0.00%,4,4,0.00%
ariella.ns.cloudflare.com,0,0.00%,2,2,0.00%
shanximall.com,0,0.00%,2,2,0.00%
cotswoldpropertylettings.com,0,0.00%,2,2,0.00%
ns4.colombiahosting.com,0,0.00%,2,2,0.00%
dns17.servidoresdns.net,0,0.00%,2,2,0.00%
ns2.colombiahosting.com,0,0.00%,2,2,0.00%
verification-nputkrls.ns3.dan.hosting,0,0.00%,14,14,0.00%
dns109.ovh.net,0,0.00%,2,2,0.00%
ns109.ovh.net,0,0.00%,2,2,0.00%
ns3.colombiahosting.com,0,0.00%,2,2,0.00%
uqhdkynyqiccr0ff-gzo0ffeun6pvl9od-gebf7khwpyapzzta.prprmoe.xyz,0,0.00%,20,20,0.00%
ns1.colombiahosting.com,0,0.00%,2,2,0.00%
etienne.ns.cloudflare.com,0,0.00%,2,2,0.00%
ns1.dnsnuts.com,0,0.00%,10,10,0.00%
2.namedc.com,0,0.00%,2,2,0.00%
ns2.uviproject.com,0,0.00%,2,2,0.00%
1.namedc.com,0,0.00%,2,2,0.00%
dns1.sitezoogle.com,0,0.00%,8,8,0.00%
ns2.validname.com,0,0.00%,2,2,0.00%
blog.jobfie.es,0,0.00%,2,2,0.00%
byron.ns.cloudflare.com,0,0.00%,2,2,0.00%
veda.ns.cloudflare.com,0,0.00%,2,2,0.00%
dara.ns.cloudflare.com,0,0.00%,18,18,0.00%
ns4252.hostgator.com,0,0.00%,4,4,0.00%
henry.ns.cloudflare.com,0,0.00%,2,2,0.00%
ns4251.hostgator.com,0,0.00%,4,4,0.00%
ns1.validname.com,0,0.00%,2,2,0.00%
mmjs.adutp.com,0,0.00%,2,2,0.00%
ns-1846.awsdns-38.co.uk,0,0.00%,2,2,0.00%
ns-358.awsdns-44.com,0,0.00%,2,2,0.00%
ns-528.awsdns-02.net,0,0.00%,2,2,0.00%
ns2.wizzyhost.com,0,0.00%,2,2,0.00%
m.amap.com,0,0.00%,2,2,0.00%
ns1087.ui-dns.org,0,0.00%,2,2,0.00%
ns1050.ui-dns.biz,0,0.00%,2,2,0.00%
ns1.wizzyhost.com,0,0.00%,2,2,0.00%
ns1.syd2.hostyourservices.net,0,0.00%,2,2,0.00%
aron.ns.cloudflare.com,0,0.00%,2,2,0.00%
z.17986.net,0,0.00%,2,2,0.00%
vor1680527707.cdn.xiaodutvcdn.com,0,0.00%,2,2,0.00%
wgo.mmstat.com,0,0.00%,4,4,0.00%
ditu.amap.com,0,0.00%,4,4,0.00%
cn-hbcd-cu-02-07.bilivideo.com,0,0.00%,2,2,0.00%
fdhmm6.tdum.alibaba.com,0,0.00%,1,1,0.00%
be59399.pd.gladns.com,0,0.00%,5,5,0.00%
be59399.pf.gladns.com,0,0.00%,5,5,0.00%
be59399.pg.gladns.com,0,0.00%,8,8,0.00%
be59399.ph.gladns.com,0,0.00%,9,9,0.00%
be59399.pc.gladns.com,0,0.00%,9,9,0.00%
be59399.pa.gladns.com,0,0.00%,9,9,0.00%
be59399.pe.gladns.com,0,0.00%,9,9,0.00%
be59399.ts.glados-config.net,0,0.00%,8,8,0.00%
nanism.art,0,0.00%,8,8,0.00%
bn1304.storage.live.com,0,0.00%,2,2,0.00%
diana.ie.sogou.com,0,0.00%,2,2,0.00%
agd.p.360.cn,0,0.00%,4,4,0.00%
ssl.mail.163.com,0,0.00%,8,8,0.00%
onedriveclucproddm20028.blob.core.windows.net,0,0.00%,2,2,0.00%
dsm04pap001.storage.live.com,0,0.00%,4,4,0.00%
x2.c.lencr.org,0,0.00%,21,21,0.00%
a.tampermonkey.net,0,0.00%,7,7,0.00%
onedriveclucprodbn20001.blob.core.windows.net,0,0.00%,2,2,0.00%
down1.thorzip.muxin.fun,0,0.00%,4,4,0.00%
o1224273.ingest.sentry.io,0,0.00%,4,4,0.00%
developer.unity.cn,0,0.00%,8,8,0.00%
updateime.baidu.com,0,0.00%,2,2,0.00%
analytics64.techsmith.com,0,0.00%,2,2,0.00%
ataprod.remarqable.com,0,0.00%,5,5,0.00%
onedriveclucprodbn20020.blob.core.windows.net,0,0.00%,8,8,0.00%
saladict.crimx.com,0,0.00%,6,6,0.00%
pz.antsysht.com,0,0.00%,2,2,0.00%
newxmp.rcv.sandai.net,0,0.00%,3,3,0.00%
pcstat.kugou.com,0,0.00%,4,4,0.00%
collect.kugou.com,0,0.00%,4,4,0.00%
onedriveclucprodbn20037.blob.core.windows.net,0,0.00%,4,4,0.00%
stun.miwifi.com,0,0.00%,2,2,0.00%
uple.qq.com,0,0.00%,4,4,0.00%
c-uaa.if.iqiyi.com,0,0.00%,4,4,0.00%
msg.video.qiyi.com,0,0.00%,6,6,0.00%
www.holidayiq.com,0,0.00%,1,1,0.00%
d3e5zkjv0mw5t1.cloudfront.net,0,0.00%,1,1,0.00%
c.jia.mn,0,0.00%,2,2,0.00%
api.mxgcat.wang,0,0.00%,4,4,0.00%
vpn.iie.ac.cn,0,0.00%,2,2,0.00%
browser.events.data.msn.com,0,0.00%,2,2,0.00%
blacklist.tampermonkey.net,0,0.00%,3,3,0.00%
apd-8089a4f507b62159e15de8e0484f44b7.v.smtcdns.com,0,0.00%,10,10,0.00%
c.nic.bh,0,0.00%,2,2,0.00%
ns-2046.awsdns-63.co.uk,0,0.00%,4,4,0.00%
file.wx2.qq.com,0,0.00%,4,4,0.00%
l-0007.config.skype.com,0,0.00%,10,10,0.00%
4.courier-push-apple.com.akadns.net,0,0.00%,2,2,0.00%
gspe35-ssl.ls-apple.com.akadns.net,0,0.00%,18,18,0.00%
batch-rgeo.is.autonavi.com,0,0.00%,15,15,0.00%
gspe35-cn-ssl.ls-apple.com.akadns.net,0,0.00%,16,16,0.00%
batch-rgeo.is.autonavi.com.gds.alibabadns.com,0,0.00%,12,12,0.00%
onedscolprdcus08.centralus.cloudapp.azure.com,0,0.00%,14,14,0.00%
spatialsearch.is.autonavi.com.gds.alibabadns.com,0,0.00%,12,12,0.00%
so.qss-lb.com,0,0.00%,2,2,0.00%
p.ssl.qhimg.com,0,0.00%,8,8,0.00%
p.ssl.qhimg.com.qh-cdn.com,0,0.00%,2,2,0.00%
api.ssl.so.qss-lb.com,0,0.00%,2,2,0.00%
lb.e.so.com,0,0.00%,2,2,0.00%
cm.mediav.com,0,0.00%,6,6,0.00%
max.mdvdns.qhcdn.com,0,0.00%,2,2,0.00%
login.360.cn,0,0.00%,2,2,0.00%
smart.sug.so.com,0,0.00%,4,4,0.00%
smart.sug.so.qss-lb.com,0,0.00%,2,2,0.00%
show-3.mediav.com,0,0.00%,2,2,0.00%
max-dr.mdvdns.qihucdn.cn,0,0.00%,2,2,0.00%
show-g.mediav.com,0,0.00%,5,5,0.00%
ns2.edgecastdns.net,0,0.00%,6,6,0.00%
cs10.wpc.v0cdn.net,0,0.00%,8,8,0.00%
videodaily.ptmi.gitv.tv,0,0.00%,2,2,0.00%
chi01pap001.storage.live.com,0,0.00%,4,4,0.00%
chi01pcor001-meta.fe.1drv.com,0,0.00%,4,4,0.00%
odc-chi01pap001-meta-geo.onedrive.akadns.net,0,0.00%,4,4,0.00%
odc-chi01pap001-meta-brs.onedrive.akadns.net,0,0.00%,4,4,0.00%
chi01pcor001-meta.be.1drv.com.l-0003.dc-msedge.net.l-0003.l-msedge.net,0,0.00%,4,4,0.00%
blob.dsm08prdstr08a.store.core.windows.net,0,0.00%,2,2,0.00%
13.courier-push-apple.com.akadns.net,0,0.00%,4,4,0.00%
m8.music.126.net.163jiasu.com,0,0.00%,6,6,0.00%
onedscolprdjpw03.japanwest.cloudapp.azure.com,0,0.00%,2,2,0.00%
m.video.xiaomi.com,0,0.00%,2,2,0.00%
az700632-pme.azureedge.net,0,0.00%,2,2,0.00%
az700632-pme.ec.azureedge.net,0,0.00%,2,2,0.00%
api.dropboxapi.com,0,0.00%,30,30,0.00%
api.languagetoolplus.com,0,0.00%,4,4,0.00%
s.safe.360.cn.s.galileo.jcloud-cdn.com,0,0.00%,4,4,0.00%
mfn-sched.jcloud-cdn.com,0,0.00%,4,4,0.00%
query7.hicloud.com,0,0.00%,2,2,0.00%
appct.jianguoyun.com,0,0.00%,6,6,0.00%
sat02pap001.storage.live.com,0,0.00%,4,4,0.00%
klbv2.wpsdns.com,0,0.00%,6,6,0.00%
com1.solocdn.cn,0,0.00%,4,4,0.00%
com2.solocdn.cn,0,0.00%,4,4,0.00%
com3.solocdn.cn,0,0.00%,4,4,0.00%
gnscom1.v.solocdn.cn,0,0.00%,4,4,0.00%
newvpn.cumt.edu.cn,0,0.00%,2,2,0.00%
ns3.ntes53.netease.com,0,0.00%,4,4,0.00%
ipv6-static.dns.iqiyi.com,0,0.00%,10,10,0.00%
2v21nxa7.sched.sma-dk.tdnsstic1.cn,0,0.00%,8,8,0.00%
apien.ldmnq.com,0,0.00%,2,2,0.00%
a5-130.akagtm.org,0,0.00%,2,2,0.00%
tg35.syscdn.zjsxlt.com,0,0.00%,4,4,0.00%
ext4-hkg1.steamserver.net,0,0.00%,4,4,0.00%
cm4-sgp1.cm.steampowered.com,0,0.00%,2,2,0.00%
array616.prod.do.dsp.mp.microsoft.com,0,0.00%,16,16,0.00%
sns.synology.com,0,0.00%,4,4,0.00%
global.sns.cs.quickconnect.to,0,0.00%,4,4,0.00%
array607.prod.do.dsp.mp.microsoft.com,0,0.00%,2,2,0.00%
ns3-06.azure-dns.org,0,0.00%,8,8,0.00%
subscription.iqiyi.com,0,0.00%,4,4,0.00%
44.courier-push-apple.com.akadns.net,0,0.00%,2,2,0.00%
pop3.163.idns.yeah.net,0,0.00%,4,4,0.00%
upd2.sangfor.com.cn,0,0.00%,14,14,0.00%
sconf.f.qh-lb.com,0,0.00%,10,10,0.00%
myou.cvte.com,0,0.00%,4,4,0.00%
map.n.shifen.com,0,0.00%,12,12,0.00%
ns2-36.azure-dns.net,0,0.00%,4,4,0.00%
ns1-36.azure-dns.com,0,0.00%,2,2,0.00%
ns4-36.azure-dns.info,0,0.00%,4,4,0.00%
ns3-36.azure-dns.org,0,0.00%,2,2,0.00%
msn-cn.a-0032.a-msedge.net,0,0.00%,4,4,0.00%
msn-china.bing123.com,0,0.00%,4,4,0.00%
ns3-204.azure-dns.org,0,0.00%,12,12,0.00%
ns4-204.azure-dns.info,0,0.00%,2,2,0.00%
gnscom2.v.solocdn.cn,0,0.00%,6,6,0.00%
21.courier-push-apple.com.akadns.net,0,0.00%,2,2,0.00%
o.andfx.cn,0,0.00%,20,20,0.00%
spatialsearch.is.autonavi.com,0,0.00%,12,12,0.00%
ns-cnc1.qq.com,0,0.00%,14,14,0.00%
intel11.cn.edgekey.net,0,0.00%,6,6,0.00%
lib.iscas.ac.cn,0,0.00%,4,4,0.00%
onedscolprdwus14.westus.cloudapp.azure.com,0,0.00%,12,12,0.00%
fe2.update.msft.com.trafficmanager.net,0,0.00%,6,6,0.00%
ecs-office.s-0005.s-msedge.net,0,0.00%,10,10,0.00%
cfw.gti.mcafee.akadns.net,0,0.00%,6,6,0.00%
repper-lb-tokyo.gtinative.cloudplatform.mcafee.com,0,0.00%,8,8,0.00%
weather-api.extfans.com,0,0.00%,33,33,0.00%
hk.vtnas.com,0,0.00%,12,12,0.00%
downloads-aws-prod-alb-134617303.eu-west-1.elb.amazonaws.com,0,0.00%,6,6,0.00%
infinity-api.infinitynewtab.com,0,0.00%,4,4,0.00%
bam.nr-data.net.cdn.cloudflare.net,0,0.00%,6,6,0.00%
maskells.luxuryrealestate.com,0,0.00%,1,1,0.00%
dev.sissai.com,0,0.00%,1,1,0.00%
js-agent.newrelic.com,0,0.00%,3,3,0.00%
cf.duba.net,0,0.00%,10,10,0.00%
stats.use-snip.com,0,0.00%,1,1,0.00%
zh.us.to,0,0.00%,7,7,0.00%
fortimail.flashentertainment.com,0,0.00%,2,2,0.00%
crash.glodon.com,0,0.00%,2,2,0.00%
delivery.maihehd.com,0,0.00%,4,4,0.00%
codeup.aliyun.com,0,0.00%,4,4,0.00%
wss.tim.qq.com,0,0.00%,2,2,0.00%
repo1.maven.org,0,0.00%,4,4,0.00%
pxyygxtq.nodelist.xyz,0,0.00%,2,2,0.00%
app-analytics.ultraleap.com,0,0.00%,4,4,0.00%
pay.video.qq.com,0,0.00%,2,2,0.00%
s1.symcb.com,0,0.00%,4,4,0.00%
upmobile.v.qq.com,0,0.00%,4,4,0.00%
mlminorshort.weixin.qq.com,0,0.00%,6,6,0.00%
c1dld.igtb.bankofchina.com,0,0.00%,2,2,0.00%
sec23summer.usenix.hotcrp.com,0,0.00%,2,2,0.00%
pcaapi.iqiyi.com,0,0.00%,2,2,0.00%
static.iqiyi.com,0,0.00%,2,2,0.00%
telecommand.telemetry.microsoft.com,0,0.00%,10,10,0.00%
9085c317e16947ad9316c3f606bfeb61.fp.measure.office.com,0,0.00%,2,2,0.00%
infoc1.duba.net,0,0.00%,4,4,0.00%
hax.peakgg.ml,0,0.00%,1,1,0.00%
17hs.servyou.com.cn,0,0.00%,2,2,0.00%
tracker.gbitt.info,0,0.00%,7,7,0.00%
syncdrive-drcn.cloud.dbankcloud.cn,0,0.00%,4,4,0.00%
cseupdate.360safe.com,0,0.00%,4,4,0.00%
tracker.nrx.me,0,0.00%,4,4,0.00%
intf-pc.pdfxd.com,0,0.00%,2,2,0.00%
www.wegame.com.cn,0,0.00%,6,6,0.00%
dir-update.wegame.com.cn,0,0.00%,4,4,0.00%
ied-tqos-tgp.qq.com,0,0.00%,6,6,0.00%
sat02pap003.storage.live.com,0,0.00%,6,6,0.00%
onedriveclucproddm20005.blob.core.windows.net,0,0.00%,4,4,0.00%
tracker4.itzmx.com,0,0.00%,10,10,0.00%
56396c8c2ff1940dbea2c5abd340b49f.dlied1.cdntips.net,0,0.00%,2,2,0.00%
fashionpedia.github.io,0,0.00%,1,1,0.00%
nxnx.9394.cf,0,0.00%,1,1,0.00%
registry.npmjs.org,0,0.00%,30,30,0.00%
ixin.itrus.com.cn,0,0.00%,6,6,0.00%
download-ib01.fedoraproject.org,0,0.00%,4,4,0.00%
api.raese.top,0,0.00%,16,16,0.00%
sub.ppbox.xyz,0,0.00%,4,4,0.00%
mirrorz.org,0,0.00%,6,6,0.00%
pdloader.com,0,0.00%,4,4,0.00%
nk5.boom.skin,0,0.00%,9,9,0.00%
hmhuawei.orvibo.com,0,0.00%,2,2,0.00%
ivdu.herokuapp.com,0,0.00%,61,61,0.00%
macxmp.rcv.sandai.net,0,0.00%,2,2,0.00%
advanced-cm-1.nodesub.com,0,0.00%,2,2,0.00%
www.sxz8.club,0,0.00%,2,2,0.00%
jp05-vm0.entry.srthdw.art,0,0.00%,10,10,0.00%
newdoc.docer.wps.cn,0,0.00%,2,2,0.00%
userinfo.docer.wps.cn,0,0.00%,4,4,0.00%
sh.0xbadc0de.stream,0,0.00%,26,26,0.00%
doh.li,0,0.00%,4,4,0.00%
liveupdate01s.asus.com.cn,0,0.00%,2,2,0.00%
seapp.stat.360safe.com,0,0.00%,9,9,0.00%
9.courier-push-apple.com.akadns.net,0,0.00%,4,4,0.00%
0386fe84025b4e89b34f7082cca26f35.fp.measure.office.com,0,0.00%,1,1,0.00%
APAC04.azure-devices.net,0,0.00%,15,15,0.00%
39.courier-push-apple.com.akadns.net,0,0.00%,4,4,0.00%
softbus-msg.wps.cn,0,0.00%,4,4,0.00%
wss.rest.gti.mcafee.com,0,0.00%,10,10,0.00%
updates.nextcloud.org,0,0.00%,4,4,0.00%
47.courier-push-apple.com.akadns.net,0,0.00%,4,4,0.00%
union.infoc.duba.net,0,0.00%,4,4,0.00%
api.naea1.uds.lenovo.com,0,0.00%,5,5,0.00%
onedriveclubprodbn20007.blob.core.windows.net,0,0.00%,1,1,0.00%
baileywood.co.uk,0,0.00%,1,1,0.00%
jp06-vm0.entry.srthdw.art,0,0.00%,5,5,0.00%
5c705f0af0ed4765a700cdca6800c147.fp.measure.office.com,0,0.00%,1,1,0.00%
prod.fs.microsoft.com.akadns.NET,0,0.00%,2,2,0.00%
online.ts.api.xiangtatech.com,0,0.00%,9,9,0.00%
fmipalservice.icloud.com,0,0.00%,1,1,0.00%
amdc-sibling.alipay.com.cn,0,0.00%,2,2,0.00%
jp02-vm0.entry.srthdw.art,0,0.00%,5,5,0.00%
1671aab.nb.gladns.com,0,0.00%,4,4,0.00%
1671aab.na.gladns.com,0,0.00%,4,4,0.00%
api.jdapi.com,0,0.00%,2,2,0.00%
nrgcom.kugou.com,0,0.00%,3,3,0.00%
blobcollector.events.data.trafficmanager.NET,0,0.00%,8,8,0.00%
grs-iot.platform.dbankcloud.com,0,0.00%,2,2,0.00%
ume1.umetrip.com,0,0.00%,2,2,0.00%
updatecn.maxthon.com,0,0.00%,2,2,0.00%
stun.syncthing.net,0,0.00%,4,4,0.00%
dl.maxthon.cn,0,0.00%,1,1,0.00%
array511.prod.do.dsp.mp.microsoft.com,0,0.00%,7,7,0.00%
test.schoene-karten.com,0,0.00%,1,1,0.00%
uptime.sangfor.net,0,0.00%,1,1,0.00%
fa.163.com,0,0.00%,2,2,0.00%
secfsr.lenovomm.com,0,0.00%,2,2,0.00%
dcs.mspcloud.cn,0,0.00%,2,2,0.00%
iqiyi.irs01.com,0,0.00%,2,2,0.00%
app-b01.lp1.npns.srv.nintendo.net,0,0.00%,4,4,0.00%
tianqi.eastday.com,0,0.00%,1,1,0.00%
s23.cnzz.com,0,0.00%,2,2,0.00%
stat.eastday.com,0,0.00%,2,2,0.00%
location.dftoutiao.com,0,0.00%,2,2,0.00%
show.g.mediav.com,0,0.00%,2,2,0.00%
minipagelog.dfxwdc.com,0,0.00%,2,2,0.00%
s3m.mediav.com,0,0.00%,3,3,0.00%
s3m1.fenxi.com,0,0.00%,2,2,0.00%
match.adsrvr.cn,0,0.00%,2,2,0.00%
rnnvndes02-nvidia.msappproxy.net,0,0.00%,2,2,0.00%
onedscolprdeus00.eastus.cloudapp.azure.com,0,0.00%,8,8,0.00%
v2.gslb.aaplimg.com,0,0.00%,2,2,0.00%
doh.dns.apple.com.v.aaplimg.com,0,0.00%,2,2,0.00%
onedscolprdneu06.northeurope.cloudapp.azure.com,0,0.00%,2,2,0.00%
weighted-zh-catalog-public-service-prod06.ol.epicgames.com,0,0.00%,2,2,0.00%
link-dit3la5z.gaapqcloud.com,0,0.00%,2,2,0.00%
telv6.music.ntes53.netease.com,0,0.00%,2,2,0.00%
tracker.tongyifan.me,0,0.00%,2,2,0.00%
ntes53.mail.yeah.net,0,0.00%,4,4,0.00%
onedscolprdfrc07.francecentral.cloudapp.azure.com,0,0.00%,2,2,0.00%
sub.rapidcc.cn,0,0.00%,8,8,0.00%
query.ess.apple.com,0,0.00%,3,3,0.00%
query.ess-apple.com.akadns.net,0,0.00%,2,2,0.00%
settings-prod-cin-2.centralindia.cloudapp.azure.com,0,0.00%,10,10,0.00%
wd-prod-ss-as-southeast-2-fe.southeastasia.cloudapp.azure.com,0,0.00%,2,2,0.00%
tracker-campus.tjupt.org,0,0.00%,2,2,0.00%
lab-a.tongyifan.me,0,0.00%,2,2,0.00%
ns4-09.azure-dns.info,0,0.00%,2,2,0.00%
epicunitscan.info,0,0.00%,1,1,0.00%
helpdubaservice.ksmobile.com,0,0.00%,2,2,0.00%
link-yqsx02.netease.im,0,0.00%,2,2,0.00%
link.netease.im,0,0.00%,4,4,0.00%
link.ntes53.netease.com,0,0.00%,2,2,0.00%
ns1.ntes53.netease.com,0,0.00%,2,2,0.00%
link-yqsx01.netease.im,0,0.00%,2,2,0.00%
nim-lbs-netease-im.ntes53.netease.com,0,0.00%,2,2,0.00%
ulogs.umeng.com.gds.alibabadns.com,0,0.00%,4,4,0.00%
outsea.yun-app.net,0,0.00%,2,2,0.00%
alog-default.umeng.com,0,0.00%,4,4,0.00%
onedscolprdeus05.eastus.cloudapp.azure.com,0,0.00%,4,4,0.00%
aahk3.yubb12.site,0,0.00%,12,12,0.00%
g-msn-com-nsatc.trafficmanager.net,0,0.00%,6,6,0.00%
think.afunapp.com,0,0.00%,2,2,0.00%
wx-love-ws.afunapp.com,0,0.00%,2,2,0.00%
wx-love-api.afunapp.com,0,0.00%,2,2,0.00%
connectivitycheck.getdropbox.com,0,0.00%,4,4,0.00%
edge-misc-env.dropbox-dns.com,0,0.00%,6,6,0.00%
ns-mobile.bytedns.com,0,0.00%,6,6,0.00%
onedscolprdfrc00.francecentral.cloudapp.azure.com,0,0.00%,2,2,0.00%
xmrj002.xmrth-node.xyz,0,0.00%,1,1,0.00%
push-rtmp-f5-io.flive.douyincdn.com.c.bytefcdn.com,0,0.00%,4,4,0.00%
mailn2sk.message.cmbchina.com,0,0.00%,4,4,0.00%
mailn3qh.message.cmbchina.com,0,0.00%,4,4,0.00%
mailn7sh.message.cmbchina.com,0,0.00%,4,4,0.00%
mailn6sk.message.cmbchina.com,0,0.00%,4,4,0.00%
mailn3sh.message.cmbchina.com,0,0.00%,4,4,0.00%
mailn5qh.message.cmbchina.com,0,0.00%,4,4,0.00%
mailn7qh.message.cmbchina.com,0,0.00%,4,4,0.00%
mailn1qh.message.cmbchina.com,0,0.00%,4,4,0.00%
mailn5sh.message.cmbchina.com,0,0.00%,4,4,0.00%
mailn4sh.message.cmbchina.com,0,0.00%,4,4,0.00%
mailn8sk.message.cmbchina.com,0,0.00%,4,4,0.00%
mail1.message.cmbchina.com,0,0.00%,4,4,0.00%
mail2.message.cmbchina.com,0,0.00%,4,4,0.00%
mailn3sz.message.cmbchina.com,0,0.00%,4,4,0.00%
mailh1.message.cmbchina.com,0,0.00%,4,4,0.00%
mailh2.message.cmbchina.com,0,0.00%,4,4,0.00%
mailn4sz.message.cmbchina.com,0,0.00%,4,4,0.00%
pull-f5.flive.douyincdn.com.c.bytefcdn.com,0,0.00%,4,4,0.00%
mailn1sz.message.cmbchina.com,0,0.00%,4,4,0.00%
mail.message.cmbchina.com,0,0.00%,4,4,0.00%
25.courier-push-apple.com.akadns.net,0,0.00%,2,2,0.00%
plbslog.umeng.com,0,0.00%,2,2,0.00%
umengacs.m.taobao.com,0,0.00%,2,2,0.00%
amdcopen.m.taobao.com,0,0.00%,2,2,0.00%
yunxin-data-live-126-net-yq.ntes53.netease.com,0,0.00%,2,2,0.00%
ns2.hoaxesignorance.com,0,0.00%,2,2,0.00%
annabel.ns.cloudflare.com,0,0.00%,6,6,0.00%
ns2.slybilgisayar.com,0,0.00%,2,2,0.00%
sk.s5.ans1.ns148.ztomy.com,0,0.00%,2,2,0.00%
nicolas.ns.cloudflare.com,0,0.00%,4,4,0.00%
62.push2his.eastmoney.com,0,0.00%,4,4,0.00%
ns1.hoaxesignorance.com,0,0.00%,2,2,0.00%
lyjinqing.com,0,0.00%,1,1,0.00%
sk.s5.ans2.ns148.ztomy.com,0,0.00%,2,2,0.00%
ns96.accountservergroup.com,0,0.00%,2,2,0.00%
ns5.ns0.com,0,0.00%,2,2,0.00%
ns-84-c.gandi.net,0,0.00%,2,2,0.00%
ms.dicp.ac.cn,0,0.00%,2,2,0.00%
ns1.volusion.com,0,0.00%,2,2,0.00%
ns1.slybilgisayar.com,0,0.00%,2,2,0.00%
docks11.rzone.de,0,0.00%,4,4,0.00%
rose.dicp.ac.cn,0,0.00%,2,2,0.00%
ns97.accountservergroup.com,0,0.00%,2,2,0.00%
cn-sdxy.com,0,0.00%,2,2,0.00%
ns2.volusion.com,0,0.00%,2,2,0.00%
ns2.dewabiz.com,0,0.00%,2,2,0.00%
ns106.ovh.net,0,0.00%,2,2,0.00%
ns1bcp.name.com,0,0.00%,4,4,0.00%
sdlccs.com,0,0.00%,2,2,0.00%
ns3dgr.name.com,0,0.00%,2,2,0.00%
ns212.superhosting.bg,0,0.00%,2,2,0.00%
13.push2his.eastmoney.com,0,0.00%,4,4,0.00%
dns106.ovh.net,0,0.00%,2,2,0.00%
ns1-mut.hosting-mexico.net,0,0.00%,2,2,0.00%
verification-19f13160.ns3.dan.hosting,0,0.00%,2,2,0.00%
ns2.sharedhostingip.com,0,0.00%,2,2,0.00%
ns1.syd6.hostingplatform.net.au,0,0.00%,2,2,0.00%
ns2.cnolnic.com,0,0.00%,4,4,0.00%
ns1.cnolnic.com,0,0.00%,4,4,0.00%
ns4.newtekdns.com,0,0.00%,2,2,0.00%
ns1.sharedhostingip.com,0,0.00%,2,2,0.00%
tina.ns.cloudflare.com,0,0.00%,4,4,0.00%
lou.ns.cloudflare.com,0,0.00%,32,32,0.00%
ns3.newtekdns.com,0,0.00%,2,2,0.00%
ns2.tosme.org,0,0.00%,2,2,0.00%
info653475.mercury.orderbox-dns.com,0,0.00%,2,2,0.00%
info653475.mars.orderbox-dns.com,0,0.00%,2,2,0.00%
ns2.glimpsin.com,0,0.00%,2,2,0.00%
info653475.venus.orderbox-dns.com,0,0.00%,2,2,0.00%
a.ns.varmegye.com,0,0.00%,2,2,0.00%
info653475.earth.orderbox-dns.com,0,0.00%,2,2,0.00%
ns1.tosme.org,0,0.00%,2,2,0.00%
9.push2his.eastmoney.com,0,0.00%,4,4,0.00%
b.ns.varmegye.com,0,0.00%,2,2,0.00%
ns22.iaasdns.com,0,0.00%,2,2,0.00%
ns1.glimpsin.com,0,0.00%,2,2,0.00%
ns21.iaasdns.com,0,0.00%,2,2,0.00%
61.push2his.eastmoney.com,0,0.00%,4,4,0.00%
21.push2his.eastmoney.com,0,0.00%,2,2,0.00%
93.push2his.eastmoney.com,0,0.00%,2,2,0.00%
eihie4vi.nodedata.net,0,0.00%,2,2,0.00%
ambulance.dnspod.net,0,0.00%,2,2,0.00%
lupus.dnspod.net,0,0.00%,2,2,0.00%
ns1078.ui-dns.org,0,0.00%,2,2,0.00%
terracordum.com,0,0.00%,2,2,0.00%
ns1040.ui-dns.biz,0,0.00%,2,2,0.00%
ns.domainca.com,0,0.00%,2,2,0.00%
ns2.domainca.com,0,0.00%,2,2,0.00%
i.17986.net,0,0.00%,2,2,0.00%
huangshikang.com,0,0.00%,2,2,0.00%
white.dnspod.net,0,0.00%,2,2,0.00%
ns-55-a.gandi.net,0,0.00%,2,2,0.00%
locate.dnspod.net,0,0.00%,2,2,0.00%
ns1022.ui-dns.de,0,0.00%,2,2,0.00%
vda2800a.trouble-free.net,0,0.00%,2,2,0.00%
vda2800b.trouble-free.net,0,0.00%,2,2,0.00%
ns101.cloudns.net,0,0.00%,4,4,0.00%
ns2.degoudengaai.nl,0,0.00%,2,2,0.00%
ns-191-b.gandi.net,0,0.00%,2,2,0.00%
brady.ns.cloudflare.com,0,0.00%,8,8,0.00%
ns1.nameserverservice.com,0,0.00%,2,2,0.00%
ns2.nameserverservice.com,0,0.00%,2,2,0.00%
maciej.ns.cloudflare.com,0,0.00%,4,4,0.00%
dan.ns.cloudflare.com,0,0.00%,12,12,0.00%
ns1.degoudengaai.nl,0,0.00%,2,2,0.00%
clara.ns.cloudflare.com,0,0.00%,2,2,0.00%
dns-ch.xinnet.com,0,0.00%,8,8,0.00%
ns-1480.awsdns-57.org,0,0.00%,2,2,0.00%
ns1.meganameservers.eu,0,0.00%,2,2,0.00%
ebony.dnspod.net,0,0.00%,2,2,0.00%
ns-1597.awsdns-07.co.uk,0,0.00%,2,2,0.00%
mackerel.dnspod.net,0,0.00%,2,2,0.00%
ns-38.awsdns-04.com,0,0.00%,2,2,0.00%
ns-634.awsdns-15.net,0,0.00%,2,2,0.00%
ns1038.ui-dns.de,0,0.00%,4,4,0.00%
ns3.meganameservers.eu,0,0.00%,2,2,0.00%
ns2.bicorticalimplant.com,0,0.00%,2,2,0.00%
ns1084.ui-dns.com,0,0.00%,6,6,0.00%
ns-cloud4.googledomains.com,0,0.00%,2,2,0.00%
ns1.bicorticalimplant.com,0,0.00%,2,2,0.00%
naomi.ns.cloudflare.com,0,0.00%,6,6,0.00%
ns2.tlh.ro,0,0.00%,2,2,0.00%
ns3183.ispapi.net,0,0.00%,2,2,0.00%
ns1210.ispapi.net,0,0.00%,2,2,0.00%
ns2161.ispapi.net,0,0.00%,2,2,0.00%
ns1.tlh.ro,0,0.00%,2,2,0.00%
amanda.ns.cloudflare.com,0,0.00%,2,2,0.00%
dante.ns.cloudflare.com,0,0.00%,2,2,0.00%
evan.ns.cloudflare.com,0,0.00%,6,6,0.00%
ns2.e-monsite.com,0,0.00%,2,2,0.00%
ns1.e-monsite.com,0,0.00%,2,2,0.00%
justin.ns.cloudflare.com,0,0.00%,4,4,0.00%
ns206.superhosting.bg,0,0.00%,2,2,0.00%
ns1.alanadlari.com,0,0.00%,2,2,0.00%
becky.ns.cloudflare.com,0,0.00%,6,6,0.00%
ns205.superhosting.bg,0,0.00%,2,2,0.00%
matteo.ns.cloudflare.com,0,0.00%,2,2,0.00%
ccradvisorygroup.com,0,0.00%,2,2,0.00%
ns2.hostbobusiness1.com,0,0.00%,2,2,0.00%
verification-8dfes0h2.ns3.dan.hosting,0,0.00%,4,4,0.00%
ns1.assigned.network,0,0.00%,2,2,0.00%
ns1.hostbobusiness1.com,0,0.00%,2,2,0.00%
xn--chqq35emmp5sv.com,0,0.00%,2,2,0.00%
ns2.hostns.io,0,0.00%,4,4,0.00%
ns1.hostns.io,0,0.00%,4,4,0.00%
cns4004.hostgator.in,0,0.00%,2,2,0.00%
cns4003.hostgator.in,0,0.00%,2,2,0.00%
thu0thei.nodedata.net,0,0.00%,2,2,0.00%
rs52.rcnoc.com,0,0.00%,2,2,0.00%
rs51.rcnoc.com,0,0.00%,2,2,0.00%
ns2.ubizhost.kr,0,0.00%,2,2,0.00%
surina.ns.cloudflare.com,0,0.00%,2,2,0.00%
backkomkids.com,0,0.00%,2,2,0.00%
ns2.360wzb.com,0,0.00%,2,2,0.00%
ns8.cdpk.io,0,0.00%,2,2,0.00%
leonard.ns.cloudflare.com,0,0.00%,2,2,0.00%
ns165.accountservergroup.com,0,0.00%,2,2,0.00%
ns2.renewyourname.net,0,0.00%,2,2,0.00%
celine.ns.cloudflare.com,0,0.00%,2,2,0.00%
ns1.360wzb.com,0,0.00%,2,2,0.00%
ns7.cdpk.io,0,0.00%,2,2,0.00%
ns164.accountservergroup.com,0,0.00%,2,2,0.00%
ns1.renewyourname.net,0,0.00%,2,2,0.00%
dns3.raiolanetworks.es,0,0.00%,4,4,0.00%
dns2.raiolanetworks.es,0,0.00%,4,4,0.00%
dns1.raiolanetworks.es,0,0.00%,6,6,0.00%
ns244.hostgator.com.br,0,0.00%,4,4,0.00%
ns2.omnisdns.net,0,0.00%,8,8,0.00%
ns245.hostgator.com.br,0,0.00%,4,4,0.00%
dns103.ovh.net,0,0.00%,2,2,0.00%
dns18.ovh.net,0,0.00%,2,2,0.00%
ns13.asurahosting.com,0,0.00%,2,2,0.00%
ns18.ovh.net,0,0.00%,2,2,0.00%
gail.ns.cloudflare.com,0,0.00%,6,6,0.00%
ns14.asurahosting.com,0,0.00%,2,2,0.00%
rick.ns.cloudflare.com,0,0.00%,8,8,0.00%
r14.dnsserve.rs,0,0.00%,2,2,0.00%
r13.dnsserve.rs,0,0.00%,2,2,0.00%
ns103.ovh.net,0,0.00%,2,2,0.00%
ns-cloud3.googledomains.com,0,0.00%,2,2,0.00%
ns-cloud2.googledomains.com,0,0.00%,2,2,0.00%
jewel.ns.cloudflare.com,0,0.00%,4,4,0.00%
ns-cloud1.googledomains.com,0,0.00%,2,2,0.00%
digiocta.com,0,0.00%,2,2,0.00%
dns1.conexcol.net,0,0.00%,2,2,0.00%
dns2.conexcol.net,0,0.00%,2,2,0.00%
ns3.netx.com.ua,0,0.00%,2,2,0.00%
ns4.timeweb.org,0,0.00%,2,2,0.00%
ns2.isewis.co.in,0,0.00%,2,2,0.00%
ns1.banabigorev.com,0,0.00%,2,2,0.00%
ns1.idwebhost.id,0,0.00%,2,2,0.00%
ns1.isewis.co.in,0,0.00%,2,2,0.00%
vip2.alidns.com,0,0.00%,2,2,0.00%
ns181.seeoux.com,0,0.00%,4,4,0.00%
ns1060.ui-dns.org,0,0.00%,2,2,0.00%
vip1.alidns.com,0,0.00%,2,2,0.00%
sg8.serverorange.com,0,0.00%,2,2,0.00%
ns2.idwebhost.id,0,0.00%,2,2,0.00%
weston.ns.cloudflare.com,0,0.00%,2,2,0.00%
ns1039.ui-dns.biz,0,0.00%,4,4,0.00%
ns2.banabigorev.com,0,0.00%,2,2,0.00%
sg2.serverorange.com,0,0.00%,2,2,0.00%
ns2.dnshosting.me,0,0.00%,2,2,0.00%
rns31.webhostbox.net,0,0.00%,2,2,0.00%
rns32.webhostbox.net,0,0.00%,2,2,0.00%
ns1.dnshosting.me,0,0.00%,2,2,0.00%
zone-iix4.cmhoster.com,0,0.00%,2,2,0.00%
ns1.servershost.net,0,0.00%,2,2,0.00%
ns131.mschosting.com,0,0.00%,2,2,0.00%
ns1.bh-74.webhostbox.net,0,0.00%,2,2,0.00%
ns2.mysecurecloudhost.com,0,0.00%,8,8,0.00%
daniella.ns.cloudflare.com,0,0.00%,8,8,0.00%
ns132.mschosting.com,0,0.00%,2,2,0.00%
ns-a3.cloud.z.com,0,0.00%,4,4,0.00%
ns1.cnolnic.net,0,0.00%,4,4,0.00%
ns-a1.cloud.z.com,0,0.00%,4,4,0.00%
ns134.mschosting.com,0,0.00%,2,2,0.00%
ns2.md-41.webhostbox.net,0,0.00%,4,4,0.00%
ns1.mysecurecloudhost.com,0,0.00%,8,8,0.00%
shades20.rzone.de,0,0.00%,6,6,0.00%
ns1.click-servers.com,0,0.00%,2,2,0.00%
ns-a4.cloud.z.com,0,0.00%,4,4,0.00%
ns1.md-41.webhostbox.net,0,0.00%,4,4,0.00%
haley.ns.cloudflare.com,0,0.00%,4,4,0.00%
ns2.cnolnic.net,0,0.00%,4,4,0.00%
ns133.mschosting.com,0,0.00%,2,2,0.00%
ns3jmt.name.com,0,0.00%,2,2,0.00%
ns2.indiandns.net,0,0.00%,2,2,0.00%
ns2.isimkayit.com,0,0.00%,2,2,0.00%
ns2.chipservers.com,0,0.00%,2,2,0.00%
ns1.indiandns.net,0,0.00%,2,2,0.00%
ns322.mihanwebhost.com,0,0.00%,2,2,0.00%
docks18.rzone.de,0,0.00%,2,2,0.00%
vicky.ns.cloudflare.com,0,0.00%,4,4,0.00%
ns2.mytrafficmanagement.com,0,0.00%,6,6,0.00%
ns1.rms009.com,0,0.00%,2,2,0.00%
ns1.isimkayit.com,0,0.00%,2,2,0.00%
ns1.chipservers.com,0,0.00%,2,2,0.00%
shahin1041.limoo.host,0,0.00%,2,2,0.00%
ns-1594.awsdns-07.co.uk,0,0.00%,4,4,0.00%
ns4229.hostgator.com,0,0.00%,3,3,0.00%
ns-210.awsdns-26.com,0,0.00%,2,2,0.00%
cns4001.hostgator.in,0,0.00%,2,2,0.00%
trace.ns.cloudflare.com,0,0.00%,6,6,0.00%
ns-608.awsdns-12.net,0,0.00%,2,2,0.00%
ns4gvx.name.com,0,0.00%,10,10,0.00%
ns2.rms009.com,0,0.00%,2,2,0.00%
ns3.hostdns.co.za,0,0.00%,2,2,0.00%
dns4.cloudns.net,0,0.00%,2,2,0.00%
ns09.domaincontrol.com,0,0.00%,4,4,0.00%
dns3.cloudns.net,0,0.00%,2,2,0.00%
nsany2.infomaniak.com,0,0.00%,8,8,0.00%
ns10.domaincontrol.com,0,0.00%,4,4,0.00%
ns-1710.awsdns-21.co.uk,0,0.00%,2,2,0.00%
ns-41.awsdns-05.com,0,0.00%,2,2,0.00%
dns6.cloudoon.net,0,0.00%,2,2,0.00%
ns1079.ui-dns.biz,0,0.00%,2,2,0.00%
ns-707.awsdns-24.net,0,0.00%,2,2,0.00%
lin45.ozkula.com,0,0.00%,2,2,0.00%
dns7.nova-seo.com,0,0.00%,2,2,0.00%
ns4.getspace.us,0,0.00%,4,4,0.00%
ns39.domaincontrol.com,0,0.00%,2,2,0.00%
kuna1117639.mercury.orderbox-dns.com,0,0.00%,20,20,0.00%
dns1.hostiq.ua,0,0.00%,4,4,0.00%
lin46.ozkula.com,0,0.00%,2,2,0.00%
ns40.domaincontrol.com,0,0.00%,2,2,0.00%
ns1.shreenathjibuildcon.com,0,0.00%,2,2,0.00%
azomoz.com,0,0.00%,2,2,0.00%
kuna1117639.mars.orderbox-dns.com,0,0.00%,20,20,0.00%
ns4.clusterdns.org,0,0.00%,2,2,0.00%
ns1053.ui-dns.de,0,0.00%,4,4,0.00%
dns8.nova-seo.com,0,0.00%,2,2,0.00%
ns2.clusterdns.co.za,0,0.00%,2,2,0.00%
margo.ns.cloudflare.com,0,0.00%,2,2,0.00%
ns2.kramitinfotech.com,0,0.00%,2,2,0.00%
odiseus.backtothe8090.com,0,0.00%,2,2,0.00%
rns401.webhostbox.net,0,0.00%,2,2,0.00%
rns402.webhostbox.net,0,0.00%,2,2,0.00%
backint0-ctblive.com,0,0.00%,2,2,0.00%
ns2.shreenathjibuildcon.com,0,0.00%,2,2,0.00%
ns2.hostriko.com,0,0.00%,2,2,0.00%
ns2.webnames.ca,0,0.00%,4,4,0.00%
ns1.webnames.ca,0,0.00%,4,4,0.00%
ns1.hostriko.com,0,0.00%,2,2,0.00%
ns3.webnames.ca,0,0.00%,4,4,0.00%
ns2.babyvannochka.com,0,0.00%,2,2,0.00%
odiseus.backtothe80-90.com,0,0.00%,2,2,0.00%
ns2.beget.com,0,0.00%,6,6,0.00%
ns1.babyvannochka.com,0,0.00%,2,2,0.00%
odiseus.backtothe80s-90s.com,0,0.00%,2,2,0.00%
summit.dnspod.net,0,0.00%,2,2,0.00%
water.dnspod.net,0,0.00%,2,2,0.00%
dorukdns2.doruk.net.tr,0,0.00%,8,8,0.00%
ns1.beget.pro,0,0.00%,6,6,0.00%
dorukdns1.doruk.net.tr,0,0.00%,8,8,0.00%
ns2.beget.pro,0,0.00%,6,6,0.00%
babysmeet.com,0,0.00%,2,2,0.00%
ns1.world4you.at,0,0.00%,2,2,0.00%
ns2.world4you.at,0,0.00%,2,2,0.00%
ns59.sudoly.com,0,0.00%,8,8,0.00%
ns217.websitewelcome.com,0,0.00%,2,2,0.00%
ns218.websitewelcome.com,0,0.00%,2,2,0.00%
ns1112.ui-dns.biz,0,0.00%,8,8,0.00%
ns-1949.awsdns-51.co.uk,0,0.00%,2,2,0.00%
r4-ns1.nshostsite.com,0,0.00%,2,2,0.00%
sid.ns.cloudflare.com,0,0.00%,4,4,0.00%
ns1.bluehost.in,0,0.00%,6,6,0.00%
ns-1774.awsdns-29.co.uk,0,0.00%,2,2,0.00%
ns1.cbsv.jp,0,0.00%,2,2,0.00%
ns1.mixhostadult.jp,0,0.00%,2,2,0.00%
ns-409.awsdns-51.com,0,0.00%,2,2,0.00%
ns2.fasthostserver.com,0,0.00%,2,2,0.00%
ns2.cbsv.jp,0,0.00%,2,2,0.00%
ns2.mixhostadult.jp,0,0.00%,2,2,0.00%
ns-710.awsdns-24.net,0,0.00%,2,2,0.00%
shades15.rzone.de,0,0.00%,6,6,0.00%
ns2.dominiok.it,0,0.00%,2,2,0.00%
ns1.brownservers.xyz,0,0.00%,2,2,0.00%
ns2.btmcdfk.com,0,0.00%,2,2,0.00%
dns2.uk2.net,0,0.00%,4,4,0.00%
ns1.fasthostserver.com,0,0.00%,2,2,0.00%
ns2.brownservers.xyz,0,0.00%,2,2,0.00%
dns3.uk2.net,0,0.00%,4,4,0.00%
ns250.mihanwebhost.com,0,0.00%,2,2,0.00%
nsany1.infomaniak.com,0,0.00%,8,8,0.00%
ns97.hostgator.mx,0,0.00%,6,6,0.00%
dns1.uk2.net,0,0.00%,4,4,0.00%
docks05.rzone.de,0,0.00%,2,2,0.00%
ns96.hostgator.mx,0,0.00%,6,6,0.00%
ns.namedserver.net,0,0.00%,2,2,0.00%
ns3.alphadnszone.com,0,0.00%,2,2,0.00%
dns1.interdominios.com,0,0.00%,4,4,0.00%
ns3.parsdata.com,0,0.00%,2,2,0.00%
ns1.dominiok.it,0,0.00%,2,2,0.00%
ns1.albionson.com,0,0.00%,2,2,0.00%
ns-1042.awsdns-02.org,0,0.00%,2,2,0.00%
ns-15.awsdns-01.com,0,0.00%,2,2,0.00%
ns249.mihanwebhost.com,0,0.00%,2,2,0.00%
julian.ns.cloudflare.com,0,0.00%,2,2,0.00%
ns1090.ui-dns.com,0,0.00%,8,8,0.00%
pablo.ns.cloudflare.com,0,0.00%,6,6,0.00%
ns-1769.awsdns-29.co.uk,0,0.00%,2,2,0.00%
carl.ns.cloudflare.com,0,0.00%,2,2,0.00%
ns-759.awsdns-30.net,0,0.00%,2,2,0.00%
ns21.superdomainzone.com,0,0.00%,2,2,0.00%
ns-1488.awsdns-58.org,0,0.00%,2,2,0.00%
ns2.server.plus,0,0.00%,4,4,0.00%
ns-1629.awsdns-11.co.uk,0,0.00%,2,2,0.00%
ns4.parsdata.com,0,0.00%,2,2,0.00%
ns.dandomain.dk,0,0.00%,2,2,0.00%
ns-627.awsdns-14.net,0,0.00%,4,4,0.00%
ns-69.awsdns-08.com,0,0.00%,2,2,0.00%
ns22.superdomainzone.com,0,0.00%,2,2,0.00%
ns13.inhostedns.com,0,0.00%,2,2,0.00%
adel.ns.cloudflare.com,0,0.00%,4,4,0.00%
ns23.inhostedns.net,0,0.00%,2,2,0.00%
ns6005.hostgator.com,0,0.00%,2,2,0.00%
ns2.alphadnszone.com,0,0.00%,2,2,0.00%
ns6006.hostgator.com,0,0.00%,2,2,0.00%
docks14.rzone.de,0,0.00%,2,2,0.00%
ns5.alphadnszone.com,0,0.00%,2,2,0.00%
rommy.ns.cloudflare.com,0,0.00%,2,2,0.00%
ns2.host256.com,0,0.00%,2,2,0.00%
ns1.yoncu.com,0,0.00%,6,6,0.00%
ns-1457.awsdns-54.org,0,0.00%,2,2,0.00%
ns-1882.awsdns-43.co.uk,0,0.00%,2,2,0.00%
ns33.inhostedns.org,0,0.00%,2,2,0.00%
zayd.genious.net,0,0.00%,2,2,0.00%
ns-367.awsdns-45.com,0,0.00%,4,4,0.00%
ns-1118.awsdns-11.org,0,0.00%,2,2,0.00%
dns1.cloud.claro.com.do,0,0.00%,2,2,0.00%
ns-1883.awsdns-43.co.uk,0,0.00%,2,2,0.00%
ns-611.awsdns-12.net,0,0.00%,2,2,0.00%
ns-1962.awsdns-53.co.uk,0,0.00%,2,2,0.00%
renan.ns.cloudflare.com,0,0.00%,4,4,0.00%
ns-306.awsdns-38.com,0,0.00%,4,4,0.00%
ns58.sudoly.com,0,0.00%,8,8,0.00%
ns5.xc-ns.de,0,0.00%,2,2,0.00%
curt.ns.cloudflare.com,0,0.00%,2,2,0.00%
ns2.asifaspac.com,0,0.00%,2,2,0.00%
ns1.centos.mx,0,0.00%,2,2,0.00%
ns897.hostgator.com.br,0,0.00%,2,2,0.00%
ns-896.awsdns-48.net,0,0.00%,2,2,0.00%
ns1110.ui-dns.biz,0,0.00%,8,8,0.00%
ns896.hostgator.com.br,0,0.00%,2,2,0.00%
ns1074.ui-dns.org,0,0.00%,2,2,0.00%
lesley.dnspod.net,0,0.00%,2,2,0.00%
dns111.a.register.com,0,0.00%,2,2,0.00%
ns2.centos.mx,0,0.00%,2,2,0.00%
ns2.messagingengine.com,0,0.00%,4,4,0.00%
fred.ns.cloudflare.com,0,0.00%,4,4,0.00%
coco.ns.cloudflare.com,0,0.00%,6,6,0.00%
ns2.bh-74.webhostbox.net,0,0.00%,2,2,0.00%
bank.dnspod.net,0,0.00%,2,2,0.00%
ns2.lifetimefastserver.com,0,0.00%,2,2,0.00%
ns11.ewallhost.com,0,0.00%,2,2,0.00%
ns1.host256.com,0,0.00%,2,2,0.00%
ns1021.ui-dns.de,0,0.00%,2,2,0.00%
ns4ghm.name.com,0,0.00%,2,2,0.00%
ray.ns.cloudflare.com,0,0.00%,4,4,0.00%
auroranegocios.com,0,0.00%,2,2,0.00%
ns1095.ui-dns.com,0,0.00%,2,2,0.00%
ns-1037.awsdns-01.org,0,0.00%,2,2,0.00%
ns6.alphadnszone.com,0,0.00%,2,2,0.00%
ns-1860.awsdns-40.co.uk,0,0.00%,6,6,0.00%
ns1029.ui-dns.org,0,0.00%,2,2,0.00%
ns1.alphadnszone.com,0,0.00%,2,2,0.00%
ns2.cunhost.cc,0,0.00%,2,2,0.00%
ns-475.awsdns-59.com,0,0.00%,2,2,0.00%
ns6529.hostgator.com,0,0.00%,2,2,0.00%
rns13.webhostbox.net,0,0.00%,2,2,0.00%
ns1059.ui-dns.biz,0,0.00%,2,2,0.00%
auschoo.com,0,0.00%,2,2,0.00%
ns-901.awsdns-48.net,0,0.00%,2,2,0.00%
ns4.alphadnszone.com,0,0.00%,2,2,0.00%
ns6530.hostgator.com,0,0.00%,2,2,0.00%
rns14.webhostbox.net,0,0.00%,2,2,0.00%
ns2.r-cursodigital.com,0,0.00%,2,2,0.00%
flash.funnels.msgsndr.com,0,0.00%,2,2,0.00%
awaidha.com,0,0.00%,2,2,0.00%
ns1.brandshelter.com,0,0.00%,12,12,0.00%
rayne.ns.cloudflare.com,0,0.00%,2,2,0.00%
dns2.zyro.com,0,0.00%,8,8,0.00%
dns1.zyro.com,0,0.00%,8,8,0.00%
ns1.r-cursodigital.com,0,0.00%,2,2,0.00%
authogladment.com,0,0.00%,2,2,0.00%
ns327.mihanwebhost.com,0,0.00%,2,2,0.00%
ns582.hostgator.com.br,0,0.00%,2,2,0.00%
ns18.hostslim.nl,0,0.00%,2,2,0.00%
ns1031.ui-dns.org,0,0.00%,8,8,0.00%
ns1043.ui-dns.de,0,0.00%,4,4,0.00%
drake.ns.cloudflare.com,0,0.00%,6,6,0.00%
ns2.automobiletraininginstitute.com,0,0.00%,2,2,0.00%
dns053.a.register.com,0,0.00%,2,2,0.00%
ns17.hostslim.nl,0,0.00%,2,2,0.00%
ns1103.ui-dns.biz,0,0.00%,4,4,0.00%
dns065.a.register.com,0,0.00%,2,2,0.00%
wanda.ns.cloudflare.com,0,0.00%,2,2,0.00%
ns1.automobiletraininginstitute.com,0,0.00%,2,2,0.00%
pat.ns.cloudflare.com,0,0.00%,4,4,0.00%
ns.au-globaldns.com,0,0.00%,2,2,0.00%
ns583.hostgator.com.br,0,0.00%,2,2,0.00%
ns1024.ui-dns.com,0,0.00%,16,16,0.00%
oswald.ns.cloudflare.com,0,0.00%,4,4,0.00%
donna.ns.cloudflare.com,0,0.00%,6,6,0.00%
razvan.ns.cloudflare.com,0,0.00%,2,2,0.00%
autodiwane.com,0,0.00%,2,2,0.00%
roxy.ns.cloudflare.com,0,0.00%,4,4,0.00%
ns.eu-globaldns.com,0,0.00%,2,2,0.00%
ns1072.ui-dns.org,0,0.00%,2,2,0.00%
ns1.btmcdfk.com,0,0.00%,2,2,0.00%
ns1052.ui-dns.de,0,0.00%,14,14,0.00%
docks19.rzone.de,0,0.00%,2,2,0.00%
ns.us-globaldns.com,0,0.00%,2,2,0.00%
ns3.webnodepro.com,0,0.00%,2,2,0.00%
ns2.webnodepro.com,0,0.00%,2,2,0.00%
ns4.webnodepro.com,0,0.00%,2,2,0.00%
ns.cn-globaldns.com,0,0.00%,2,2,0.00%
ns1.webnodepro.com,0,0.00%,2,2,0.00%
ns2.xbiz.ne.jp,0,0.00%,4,4,0.00%
ns-1383.awsdns-44.org,0,0.00%,2,2,0.00%
ns.jagoanweb.com,0,0.00%,2,2,0.00%
ns2.namegear.co,0,0.00%,2,2,0.00%
ns3.xbiz.ne.jp,0,0.00%,4,4,0.00%
atasyacht.com,0,0.00%,2,2,0.00%
ns1.namegear.co,0,0.00%,2,2,0.00%
ns1.xbiz.ne.jp,0,0.00%,4,4,0.00%
ns-1395.awsdns-46.org,0,0.00%,2,2,0.00%
ns-819.awsdns-38.net,0,0.00%,4,4,0.00%
nancy.ns.cloudflare.com,0,0.00%,2,2,0.00%
r4-ns2.nshostsite.com,0,0.00%,2,2,0.00%
ns3.registrant-verification.ispapi.net,0,0.00%,2,2,0.00%
ns2.anjalidmakeup.com,0,0.00%,2,2,0.00%
b00325.protectx.work,0,0.00%,2,2,0.00%
ns-253.awsdns-31.com,0,0.00%,2,2,0.00%
ns2.hawkdns.net,0,0.00%,2,2,0.00%
ns-1466.awsdns-55.org,0,0.00%,2,2,0.00%
ns1.evolutionsistemasdigitais.com.br,0,0.00%,1,1,0.00%
ns-1797.awsdns-32.co.uk,0,0.00%,2,2,0.00%
ns1.hawkdns.net,0,0.00%,2,2,0.00%
ns-792.awsdns-35.net,0,0.00%,2,2,0.00%
slategray.dnspod.net,0,0.00%,2,2,0.00%
ns1203.websitewelcome.com,0,0.00%,2,2,0.00%
ns6.qservers.net,0,0.00%,2,2,0.00%
ns1204.websitewelcome.com,0,0.00%,2,2,0.00%
atlantabredco.com,0,0.00%,2,2,0.00%
ns2.evolutionsistemasdigitais.com.br,0,0.00%,1,1,0.00%
ns5.qservers.net,0,0.00%,2,2,0.00%
ns1098.ui-dns.com,0,0.00%,4,4,0.00%
ns-1203.awsdns-22.org,0,0.00%,2,2,0.00%
ns1122.ui-dns.biz,0,0.00%,2,2,0.00%
ns-1830.awsdns-36.co.uk,0,0.00%,4,4,0.00%
ns2.linode.com,0,0.00%,6,6,0.00%
delilah.ns.cloudflare.com,0,0.00%,2,2,0.00%
f.ns.arvancdn.com,0,0.00%,2,2,0.00%
ns-325.awsdns-40.com,0,0.00%,2,2,0.00%
ns5.linode.com,0,0.00%,6,6,0.00%
ns55.hostgator.mx,0,0.00%,2,2,0.00%
peter.ns.cloudflare.com,0,0.00%,4,4,0.00%
dns21.website.com,0,0.00%,6,6,0.00%
ns2.ezhostingserver.com,0,0.00%,2,2,0.00%
roguelikerpg.net,0,0.00%,2,2,0.00%
walt.ns.cloudflare.com,0,0.00%,2,2,0.00%
dns2.website.com,0,0.00%,6,6,0.00%
ns3qtx.name.com,0,0.00%,2,2,0.00%
yolanda.ns.cloudflare.com,0,0.00%,28,28,0.00%
dns1.website.com,0,0.00%,6,6,0.00%
dns1.first3guarantee.com,0,0.00%,32,32,0.00%
jakub.ns.cloudflare.com,0,0.00%,2,2,0.00%
dns4.lonex.com,0,0.00%,4,4,0.00%
inbo671965.mars.orderbox-dns.com,0,0.00%,2,2,0.00%
static-2.no-ip.com,0,0.00%,4,4,0.00%
inbo671965.earth.orderbox-dns.com,0,0.00%,2,2,0.00%
dns2.first3guarantee.com,0,0.00%,30,30,0.00%
ns3.extremhost.net,0,0.00%,4,4,0.00%
ns4.gkg.net,0,0.00%,4,4,0.00%
inbo671965.mercury.orderbox-dns.com,0,0.00%,2,2,0.00%
static-1.no-ip.com,0,0.00%,4,4,0.00%
inbo671965.venus.orderbox-dns.com,0,0.00%,2,2,0.00%
dns1.lonex.com,0,0.00%,4,4,0.00%
return.dnspod.net,0,0.00%,2,2,0.00%
s1share.net,0,0.00%,2,2,0.00%
ns4.extremhost.net,0,0.00%,4,4,0.00%
wages.dnspod.net,0,0.00%,2,2,0.00%
ns1.domainoffensive.de,0,0.00%,2,2,0.00%
ns2.mckennahosting.com,0,0.00%,2,2,0.00%
ns3.gkg.net,0,0.00%,4,4,0.00%
ns2.extremhost.net,0,0.00%,4,4,0.00%
max.ns.cloudflare.com,0,0.00%,8,8,0.00%
ns1-08.azure-dns.com,0,0.00%,2,2,0.00%
ns1cwy.name.com,0,0.00%,2,2,0.00%
ns14.hawkhost.com,0,0.00%,4,4,0.00%
barbara.ns.cloudflare.com,0,0.00%,8,8,0.00%
gagabao.net,0,0.00%,2,2,0.00%
ns1.extremhost.net,0,0.00%,4,4,0.00%
ns3cqz.name.com,0,0.00%,6,6,0.00%
ns3.domainoffensive.net,0,0.00%,2,2,0.00%
ns1.mckennahosting.com,0,0.00%,2,2,0.00%
redbusprimarydns.sexdrugsanddeath.net,0,0.00%,2,2,0.00%
fonzie.ns.cloudflare.com,0,0.00%,2,2,0.00%
ns209.hostgator.com.br,0,0.00%,2,2,0.00%
ns208.hostgator.com.br,0,0.00%,2,2,0.00%
ns2.domainoffensive.eu,0,0.00%,2,2,0.00%
ricardo.ns.cloudflare.com,0,0.00%,2,2,0.00%
ns03.freenom.com,0,0.00%,2,2,0.00%
ns-1515.awsdns-61.org,0,0.00%,2,2,0.00%
dns206.a.register.com,0,0.00%,2,2,0.00%
ns-1894.awsdns-44.co.uk,0,0.00%,2,2,0.00%
ns-784.awsdns-34.net,0,0.00%,2,2,0.00%
dns2.kinghost.com.br,0,0.00%,2,2,0.00%
dns1.markum.net,0,0.00%,10,10,0.00%
ns-101-b.gandi.net,0,0.00%,2,2,0.00%
ns1.symbolhost.com,0,0.00%,2,2,0.00%
ns02.freenom.com,0,0.00%,2,2,0.00%
mira.ns.cloudflare.com,0,0.00%,4,4,0.00%
eloise.ns.cloudflare.com,0,0.00%,2,2,0.00%
albert.ns.cloudflare.com,0,0.00%,2,2,0.00%
ns68.hostgator.mx,0,0.00%,4,4,0.00%
ns04.freenom.com,0,0.00%,2,2,0.00%
ns-220-a.gandi.net,0,0.00%,2,2,0.00%
ns-1374.awsdns-43.org,0,0.00%,4,4,0.00%
ns01.freenom.com,0,0.00%,3,3,0.00%
ns69.hostgator.mx,0,0.00%,4,4,0.00%
snp26kj.s366cne.com,0,0.00%,2,2,0.00%
ns-60-c.gandi.net,0,0.00%,2,2,0.00%
ns-1560.awsdns-03.co.uk,0,0.00%,2,2,0.00%
ns8373.hostgator.com,0,0.00%,2,2,0.00%
hasslo.ns.cloudflare.com,0,0.00%,2,2,0.00%
ns-498.awsdns-62.com,0,0.00%,2,2,0.00%
ns8374.hostgator.com,0,0.00%,2,2,0.00%
ns-751.awsdns-29.net,0,0.00%,2,2,0.00%
platinum.dnspod.net,0,0.00%,2,2,0.00%
ns-1381.awsdns-44.org,0,0.00%,2,2,0.00%
hostingdynamo.venus.orderbox-dns.com,0,0.00%,2,2,0.00%
ns-1986.awsdns-56.co.uk,0,0.00%,2,2,0.00%
hostingdynamo.mars.orderbox-dns.com,0,0.00%,2,2,0.00%
ns1033.ui-dns.biz,0,0.00%,6,6,0.00%
d.ns14.net,0,0.00%,2,2,0.00%
ns-1215.awsdns-23.org,0,0.00%,2,2,0.00%
maeve.ns.cloudflare.com,0,0.00%,2,2,0.00%
ns-437.awsdns-54.com,0,0.00%,2,2,0.00%
ns-1585.awsdns-06.co.uk,0,0.00%,2,2,0.00%
hostingdynamo.mercury.orderbox-dns.com,0,0.00%,2,2,0.00%
ns-721.awsdns-26.net,0,0.00%,2,2,0.00%
ns1063.ui-dns.com,0,0.00%,8,8,0.00%
ethan.ns.cloudflare.com,0,0.00%,2,2,0.00%
yvette.dnspod.net,0,0.00%,2,2,0.00%
ns-1247.awsdns-27.org,0,0.00%,2,2,0.00%
ns1094.ui-dns.org,0,0.00%,8,8,0.00%
ns-162-b.gandi.net,0,0.00%,2,2,0.00%
grace.dnspod.net,0,0.00%,2,2,0.00%
ns1111.ui-dns.biz,0,0.00%,4,4,0.00%
ns1058.ui-dns.com,0,0.00%,6,6,0.00%
ns-1190.awsdns-20.org,0,0.00%,2,2,0.00%
ns-206-c.gandi.net,0,0.00%,2,2,0.00%
ns-47-a.gandi.net,0,0.00%,2,2,0.00%
em2.site-dns.com,0,0.00%,2,2,0.00%
hymn.dnspod.net,0,0.00%,2,2,0.00%
ns4.powerdns.de,0,0.00%,2,2,0.00%
ns-130.awsdns-16.com,0,0.00%,2,2,0.00%
ns8185.hostgator.com,0,0.00%,2,2,0.00%
amy.ns.cloudflare.com,0,0.00%,2,2,0.00%
ns-122-a.gandi.net,0,0.00%,2,2,0.00%
ns2.iinet.com,0,0.00%,2,2,0.00%
leanna.ns.cloudflare.com,0,0.00%,2,2,0.00%
ns8186.hostgator.com,0,0.00%,2,2,0.00%
ns1087.ui-dns.de,0,0.00%,8,8,0.00%
lennox.ns.cloudflare.com,0,0.00%,2,2,0.00%
ns02.xsserver.gmbh,0,0.00%,2,2,0.00%
ns1.mijn.host,0,0.00%,2,2,0.00%
ns2.mijn.host,0,0.00%,2,2,0.00%
ns-1286.awsdns-32.org,0,0.00%,4,4,0.00%
cuttloefish.dnspod.net,0,0.00%,2,2,0.00%
ns5.iinet.com,0,0.00%,2,2,0.00%
q3trade.net,0,0.00%,2,2,0.00%
prointernationalschool.net,0,0.00%,2,2,0.00%
download.api.bsb.baidu.com,0,0.00%,10,10,0.00%
downloadapi.n.shifen.com,0,0.00%,4,4,0.00%
ns01.xsserver.gmbh,0,0.00%,2,2,0.00%
parking2.mdnsservice.com,0,0.00%,10,10,0.00%
parking1.mdnsservice.com,0,0.00%,12,12,0.00%
ns11.ebndns.com,0,0.00%,2,2,0.00%
ns1.ezydomain.com,0,0.00%,2,2,0.00%
quarxtechnologies.net,0,0.00%,2,2,0.00%
z.ns.joker.com,0,0.00%,8,8,0.00%
ns33.guzelhosting.com,0,0.00%,2,2,0.00%
ns32.guzelhosting.com,0,0.00%,2,2,0.00%
ns4.tino.org,0,0.00%,4,4,0.00%
dora.ns.cloudflare.com,0,0.00%,6,6,0.00%
ns-1847.awsdns-38.co.uk,0,0.00%,2,2,0.00%
ryan.ns.cloudflare.com,0,0.00%,2,2,0.00%
milejotum.net,0,0.00%,2,2,0.00%
ns-623.awsdns-13.net,0,0.00%,2,2,0.00%
buck.ns.cloudflare.com,0,0.00%,4,4,0.00%
ns-310.awsdns-38.com,0,0.00%,2,2,0.00%
dns3.home.pl,0,0.00%,4,4,0.00%
koin98.net,0,0.00%,2,2,0.00%
ns-843.awsdns-41.net,0,0.00%,2,2,0.00%
damiete.ns.cloudflare.com,0,0.00%,30,30,0.00%
ns-d6j77nd6ed.dnswnd.de,0,0.00%,2,2,0.00%
ajay.ns.cloudflare.com,0,0.00%,6,6,0.00%
dns2.home.pl,0,0.00%,6,6,0.00%
ns-817.awsdns-38.net,0,0.00%,2,2,0.00%
isla.ns.cloudflare.com,0,0.00%,4,4,0.00%
mimyk.net,0,0.00%,2,2,0.00%
ns-92-c.gandi.net,0,0.00%,2,2,0.00%
momgetsajob.net,0,0.00%,2,2,0.00%
amber.ns.cloudflare.com,0,0.00%,4,4,0.00%
ns-189.awsdns-23.com,0,0.00%,2,2,0.00%
ns-199-a.gandi.net,0,0.00%,2,2,0.00%
hope.ns.cloudflare.com,0,0.00%,2,2,0.00%
ns62.hostgator.mx,0,0.00%,2,2,0.00%
ns-153-a.gandi.net,0,0.00%,2,2,0.00%
rene.ns.cloudflare.com,0,0.00%,4,4,0.00%
dale.ns.cloudflare.com,0,0.00%,4,4,0.00%
ns1.wpx.ne.jp,0,0.00%,2,2,0.00%
ns63.hostgator.mx,0,0.00%,2,2,0.00%
ns2.zzz.com.ua,0,0.00%,2,2,0.00%
ns8327.hostgator.com,0,0.00%,2,2,0.00%
ns-141-b.gandi.net,0,0.00%,2,2,0.00%
ns8328.hostgator.com,0,0.00%,2,2,0.00%
dns1.server.my,0,0.00%,2,2,0.00%
ns2.wpx.ne.jp,0,0.00%,2,2,0.00%
ns-219-c.gandi.net,0,0.00%,2,2,0.00%
mspigeon.net,0,0.00%,2,2,0.00%
dns2.server.my,0,0.00%,2,2,0.00%
lock.dnspod.net,0,0.00%,2,2,0.00%
y.ns.joker.com,0,0.00%,8,8,0.00%
ns1ksz.name.com,0,0.00%,2,2,0.00%
x.ns.joker.com,0,0.00%,8,8,0.00%
ns2.cpsvr.com,0,0.00%,2,2,0.00%
bookstore.dnspod.net,0,0.00%,2,2,0.00%
lisa.ns.cloudflare.com,0,0.00%,2,2,0.00%
ns1.cpsvr.com,0,0.00%,2,2,0.00%
ns-855.awsdns-42.net,0,0.00%,4,4,0.00%
liliesandhearts.net,0,0.00%,2,2,0.00%
ns1.crystalwebhosting.com,0,0.00%,2,2,0.00%
ns6178.hostgator.com,0,0.00%,2,2,0.00%
ns-33-a.gandi.net,0,0.00%,2,2,0.00%
dns4.znetlive.com,0,0.00%,2,2,0.00%
ns6177.hostgator.com,0,0.00%,2,2,0.00%
ns17.worldnic.com,0,0.00%,2,2,0.00%
taxi.dnspod.net,0,0.00%,2,2,0.00%
ns1.gurkhahost.com,0,0.00%,2,2,0.00%
ns7.webd.pl,0,0.00%,2,2,0.00%
ns-81-b.gandi.net,0,0.00%,2,2,0.00%
dns3.znetlive.com,0,0.00%,2,2,0.00%
0.mm-rr.com,0,0.00%,2,2,0.00%
ns-1432.awsdns-51.org,0,0.00%,2,2,0.00%
ns-1504.awsdns-60.org,0,0.00%,2,2,0.00%
ns4.gurkhahost.com,0,0.00%,2,2,0.00%
ns-1908.awsdns-46.co.uk,0,0.00%,2,2,0.00%
ns-72-b.gandi.net,0,0.00%,4,4,0.00%
ns2.snowsidehosting.com,0,0.00%,2,2,0.00%
ns-1850.awsdns-39.co.uk,0,0.00%,2,2,0.00%
ns-267.awsdns-33.com,0,0.00%,2,2,0.00%
ns-238.awsdns-29.com,0,0.00%,2,2,0.00%
ns2.gurkhahost.com,0,0.00%,2,2,0.00%
ns-68-a.gandi.net,0,0.00%,2,2,0.00%
ns-208.awsdns-26.com,0,0.00%,2,2,0.00%
elijah.ns.cloudflare.com,0,0.00%,4,4,0.00%
dns2.znetlive.com,0,0.00%,2,2,0.00%
cecelia.ns.cloudflare.com,0,0.00%,4,4,0.00%
ns-762.awsdns-31.net,0,0.00%,2,2,0.00%
jarred.ns.cloudflare.com,0,0.00%,2,2,0.00%
ns-86-c.gandi.net,0,0.00%,2,2,0.00%
ns-747.awsdns-29.net,0,0.00%,4,4,0.00%
ns-930.awsdns-52.net,0,0.00%,2,2,0.00%
ns-1317.awsdns-36.org,0,0.00%,2,2,0.00%
ns3.gurkhahost.com,0,0.00%,2,2,0.00%
ns-1616.awsdns-10.co.uk,0,0.00%,2,2,0.00%
ns-1051.awsdns-03.org,0,0.00%,2,2,0.00%
emely.ns.cloudflare.com,0,0.00%,2,2,0.00%
ns-151-c.gandi.net,0,0.00%,2,2,0.00%
ns-340.awsdns-42.com,0,0.00%,4,4,0.00%
ns1.mydomain.com,0,0.00%,2,2,0.00%
ns-1833.awsdns-37.co.uk,0,0.00%,2,2,0.00%
ns1mtw.name.com,0,0.00%,2,2,0.00%
ns2.mydomain.com,0,0.00%,2,2,0.00%
ns-377.awsdns-47.com,0,0.00%,2,2,0.00%
ns5.webd.pl,0,0.00%,2,2,0.00%
brad.ns.cloudflare.com,0,0.00%,4,4,0.00%
ns840.umbler.co.uk,0,0.00%,2,2,0.00%
randy.ns.cloudflare.com,0,0.00%,2,2,0.00%
redbussecondarydns.britishforeignoffice.net,0,0.00%,2,2,0.00%
ns-514.awsdns-00.net,0,0.00%,2,2,0.00%
ns2bkr.name.com,0,0.00%,4,4,0.00%
ns2.mc-news.net,0,0.00%,2,2,0.00%
ns-958.awsdns-55.net,0,0.00%,4,4,0.00%
ns534.umbler.com,0,0.00%,2,2,0.00%
columbus.aternos.org,0,0.00%,2,2,0.00%
ns1.hostpanel.me,0,0.00%,2,2,0.00%
11776.BODIS.com,0,0.00%,2,2,0.00%
ns148.umbler.in,0,0.00%,2,2,0.00%
ns1.mc-news.net,0,0.00%,2,2,0.00%
sns11.hostgator.in,0,0.00%,2,2,0.00%
sns12.hostgator.in,0,0.00%,2,2,0.00%
ns1106.ui-dns.com,0,0.00%,2,2,0.00%
ns-1073.awsdns-06.org,0,0.00%,2,2,0.00%
ns-1984.awsdns-56.co.uk,0,0.00%,2,2,0.00%
ns-826.awsdns-39.net,0,0.00%,2,2,0.00%
ian.ns.cloudflare.com,0,0.00%,2,2,0.00%
ns2.ware.net,0,0.00%,2,2,0.00%
ns1.ware.net,0,0.00%,2,2,0.00%
ns2.cyon.ch,0,0.00%,2,2,0.00%
ns1.taipandns.com,0,0.00%,2,2,0.00%
nspro39.hostgator.mx,0,0.00%,2,2,0.00%
hwbola.net,0,0.00%,2,2,0.00%
david.ns.cloudflare.com,0,0.00%,6,6,0.00%
gba-mbc.net,0,0.00%,1,1,0.00%
ns-0-b.gandi.net,0,0.00%,2,2,0.00%
ns1093.ui-dns.de,0,0.00%,2,2,0.00%
chi-ns2.websitehostserver.net,0,0.00%,12,12,0.00%
odin.ns.cloudflare.com,0,0.00%,2,2,0.00%
ns926.hostgator.com.br,0,0.00%,2,2,0.00%
ns927.hostgator.com.br,0,0.00%,2,2,0.00%
eu.guzelhosting.com,0,0.00%,8,8,0.00%
sg.guzelhosting.com,0,0.00%,6,6,0.00%
web.push.126.net,0,0.00%,6,6,0.00%
portainer-io-assets.sfo2.digitaloceanspaces.com,0,0.00%,4,4,0.00%
ns1.infinit-lms.com,0,0.00%,2,2,0.00%
pns14.cloudns.net,0,0.00%,4,4,0.00%
pns13.cloudns.net,0,0.00%,4,4,0.00%
ns2.infinit-lms.com,0,0.00%,2,2,0.00%
ns2.server621.iseencloud.com,0,0.00%,2,2,0.00%
ns1.server621.iseencloud.com,0,0.00%,2,2,0.00%
only-920850-124-16-139-252.nstool.321fenx.com,0,0.00%,1,1,0.00%
a.nstool.ntes53.netease.com,0,0.00%,2,2,0.00%
ns3.doregi.com,0,0.00%,2,2,0.00%
ns-1211.awsdns-23.org,0,0.00%,2,2,0.00%
dididatuan.com,0,0.00%,2,2,0.00%
ns1.reimobile.com,0,0.00%,2,2,0.00%
ns-1820.awsdns-35.co.uk,0,0.00%,2,2,0.00%
ns2.doregi.com,0,0.00%,2,2,0.00%
ns2.ardetamedia.com,0,0.00%,2,2,0.00%
ns-197.awsdns-24.com,0,0.00%,2,2,0.00%
ns22.servidoresseguros.com,0,0.00%,2,2,0.00%
ns1121.ui-dns.com,0,0.00%,2,2,0.00%
ns1.doregi.com,0,0.00%,2,2,0.00%
ns1079.ui-dns.de,0,0.00%,2,2,0.00%
ns2.reimobile.com,0,0.00%,2,2,0.00%
ns1082.ui-dns.biz,0,0.00%,2,2,0.00%
ns1032.ui-dns.org,0,0.00%,2,2,0.00%
ns2.bh-in-20.webhostbox.net,0,0.00%,2,2,0.00%
ns1061.ui-dns.org,0,0.00%,10,10,0.00%
ns1.bh-in-20.webhostbox.net,0,0.00%,2,2,0.00%
NS2.SOLVPS.com,0,0.00%,2,2,0.00%
ns4025.websitewelcome.com,0,0.00%,2,2,0.00%
ns1019.ui-dns.biz,0,0.00%,4,4,0.00%
ns1082.ui-dns.de,0,0.00%,2,2,0.00%
NS1.SOLVPS.com,0,0.00%,2,2,0.00%
NS3.SOLVPS.com,0,0.00%,2,2,0.00%
ns19.piensasolutions.com,0,0.00%,4,4,0.00%
chus549256.mars.orderbox-dns.com,0,0.00%,2,2,0.00%
chus549256.earth.orderbox-dns.com,0,0.00%,2,2,0.00%
chus549256.venus.orderbox-dns.com,0,0.00%,2,2,0.00%
chus549256.mercury.orderbox-dns.com,0,0.00%,2,2,0.00%
estrategiasdevendas.com,0,0.00%,2,2,0.00%
ns1.velocitydatacenter3.biz,0,0.00%,2,2,0.00%
ns2.velocitydatacenter3.biz,0,0.00%,2,2,0.00%
ns2.server148.iseencloud.com,0,0.00%,2,2,0.00%
ns15.powerhostbg.com,0,0.00%,2,2,0.00%
ns1.server148.iseencloud.com,0,0.00%,2,2,0.00%
ns16.powerhostbg.com,0,0.00%,2,2,0.00%
clay.ns.cloudflare.com,0,0.00%,2,2,0.00%
ns4.jogjahost.co.id,0,0.00%,2,2,0.00%
ns3.jogjahost.co.id,0,0.00%,2,2,0.00%
dns1.privatesdnservers.com,0,0.00%,2,2,0.00%
ns1077.ui-dns.de,0,0.00%,6,6,0.00%
ns1.jogjahost.co.id,0,0.00%,2,2,0.00%
dns011.a.register.com,0,0.00%,2,2,0.00%
dns2.privatesdnservers.com,0,0.00%,2,2,0.00%
ns2.jogjahost.co.id,0,0.00%,2,2,0.00%
ns1046.hostgator.com.br,0,0.00%,4,4,0.00%
ns1047.hostgator.com.br,0,0.00%,4,4,0.00%
bns1.hostcocoa.com,0,0.00%,2,2,0.00%
ns4026.websitewelcome.com,0,0.00%,2,2,0.00%
ns6313.hostgator.com,0,0.00%,2,2,0.00%
ns6314.hostgator.com,0,0.00%,2,2,0.00%
ns2fhn.name.com,0,0.00%,6,6,0.00%
collins.ns.cloudflare.com,0,0.00%,2,2,0.00%
ns2.macandigital.com,0,0.00%,2,2,0.00%
ns2.jp5.fcomet.com,0,0.00%,2,2,0.00%
ns4cfn.name.com,0,0.00%,4,4,0.00%
gaotiantraining.com,0,0.00%,2,2,0.00%
ns1.macandigital.com,0,0.00%,2,2,0.00%
ns1.vietnix.net,0,0.00%,2,2,0.00%
nsbak.vietnix.net,0,0.00%,2,2,0.00%
ns16.vhostplatform.com,0,0.00%,2,2,0.00%
ns2.vietnix.net,0,0.00%,2,2,0.00%
ns15.vhostplatform.com,0,0.00%,2,2,0.00%
ns3.panelboxmanager.com,0,0.00%,10,10,0.00%
94.push2his.eastmoney.com,0,0.00%,2,2,0.00%
mitch.ns.cloudflare.com,0,0.00%,2,2,0.00%
xprchina.com,0,0.00%,2,2,0.00%
zuibachongyaojiu.com,0,0.00%,2,2,0.00%
ns1051.ui-dns.org,0,0.00%,4,4,0.00%
85.push2his.eastmoney.com,0,0.00%,2,2,0.00%
dns105.ovh.net,0,0.00%,14,14,0.00%
ns88.hostingraja.org,0,0.00%,2,2,0.00%
ns87.hostingraja.org,0,0.00%,2,2,0.00%
irena.ns.cloudflare.com,0,0.00%,2,2,0.00%
ns2.nameserverseo.com,0,0.00%,2,2,0.00%
doma634347.mercury.orderbox-dns.com,0,0.00%,2,2,0.00%
ns2.engazmedia.com,0,0.00%,2,2,0.00%
doma634347.mars.orderbox-dns.com,0,0.00%,2,2,0.00%
25.push2his.eastmoney.com,0,0.00%,4,4,0.00%
doma634347.venus.orderbox-dns.com,0,0.00%,2,2,0.00%
dgzdk168.com,0,0.00%,2,2,0.00%
doma634347.earth.orderbox-dns.com,0,0.00%,2,2,0.00%
ns3.nameserverseo.com,0,0.00%,2,2,0.00%
coby.ns.cloudflare.com,0,0.00%,2,2,0.00%
2handmro.com,0,0.00%,1,1,0.00%
lindsey.ns.cloudflare.com,0,0.00%,2,2,0.00%
ns-43-a.gandi.net,0,0.00%,2,2,0.00%
ns1087.ui-dns.biz,0,0.00%,2,2,0.00%
ns1.engazmedia.com,0,0.00%,2,2,0.00%
ns1.nameserverseo.com,0,0.00%,2,2,0.00%
www.russian.xinhuanet.com,0,0.00%,2,2,0.00%
www.sanya.news.cn,0,0.00%,2,2,0.00%
www.sc.news.cn,0,0.00%,2,2,0.00%
www.sc.xinhuanet.com,0,0.00%,2,2,0.00%
bba423cba9e64b9a92febdc56af509a9.fp.measure.office.com,0,0.00%,1,1,0.00%
search.apps.ubuntu.com,0,0.00%,6,6,0.00%
nist1-nj2.ustiming.org,0,0.00%,1,1,0.00%
www.sd.news.cn,0,0.00%,2,2,0.00%
www.sd.xinhuanet.com,0,0.00%,2,2,0.00%
chdbits.co,0,0.00%,2,2,0.00%
krgame02.graniterapids.com,0,0.00%,2,2,0.00%
wss-backup.slack.com,0,0.00%,4,4,0.00%
gs.apple.com,0,0.00%,2,2,0.00%
gtm-update-khd.2345.cc,0,0.00%,2,2,0.00%
board.rellek.org,0,0.00%,1,1,0.00%
pccw02.graniterapids.com,0,0.00%,2,2,0.00%
wss-primary.slack.com,0,0.00%,4,4,0.00%
jp20.graniterapids.com,0,0.00%,1,1,0.00%
au02.graniterapids.com,0,0.00%,1,1,0.00%
ns1.c-msedge.net,0,0.00%,2,2,0.00%
fr02.graniterapids.com,0,0.00%,2,2,0.00%
tianqing.qianxin.com,0,0.00%,4,4,0.00%
edgeapi.slack.com,0,0.00%,2,2,0.00%
nearby-find-api-drcn.hms.dbankcloud.com,0,0.00%,2,2,0.00%
g.msn.com,0,0.00%,6,6,0.00%
ac.dun.163yun.com,0,0.00%,6,6,0.00%
www9.53kf.com,0,0.00%,4,4,0.00%
krgame08.graniterapids.com,0,0.00%,2,2,0.00%
pccw09.graniterapids.com,0,0.00%,2,2,0.00%
krgame04.graniterapids.com,0,0.00%,2,2,0.00%
tw02.graniterapids.com,0,0.00%,2,2,0.00%
s14-sync.firefox.com.cn,0,0.00%,6,6,0.00%
902f60a038b04253a7f2376315adba10.fp.measure.office.com,0,0.00%,1,1,0.00%
onedriveclucproddm20001.blob.core.windows.net,0,0.00%,4,4,0.00%
apple.com.cn.data.adobedc.cn,0,0.00%,2,2,0.00%
us1.gmdns.net,0,0.00%,2,2,0.00%
cn12.gmdns.net,0,0.00%,2,2,0.00%
iknow.n.shifen.com,0,0.00%,2,2,0.00%
us2.gmdns.net,0,0.00%,2,2,0.00%
ca.gmdns.net,0,0.00%,2,2,0.00%
de.gmdns.net,0,0.00%,4,4,0.00%
cn13.gmdns.net,0,0.00%,2,2,0.00%
cn3.gmdns.net,0,0.00%,2,2,0.00%
cn9.gmdns.net,0,0.00%,4,4,0.00%
cn1.gmdns.net,0,0.00%,4,4,0.00%
au.gmdns.net,0,0.00%,2,2,0.00%
cn15.gmdns.net,0,0.00%,2,2,0.00%
cn14.gmdns.net,0,0.00%,2,2,0.00%
cn2.gmdns.net,0,0.00%,4,4,0.00%
cn4.gmdns.net,0,0.00%,2,2,0.00%
sdp.qihucdn.com,0,0.00%,2,2,0.00%
ebad288.ne.gladns.com,0,0.00%,4,4,0.00%
cn5.gmdns.net,0,0.00%,2,2,0.00%
loader-professional.com,0,0.00%,4,4,0.00%
api.goodnotescloud.com,0,0.00%,2,2,0.00%
waitlist.goodnotesplatform.com,0,0.00%,2,2,0.00%
api.goodnotes.email,0,0.00%,2,2,0.00%
APAC01.azure-devices.net,0,0.00%,6,6,0.00%
ns-sb2-prod-sn3-010.cloudapp.net,0,0.00%,10,10,0.00%
neofeng04-my.sharepoint.com,0,0.00%,2,2,0.00%
v9-cold1.douyinvod.com,0,0.00%,2,2,0.00%
v9-cold2.douyinvod.com,0,0.00%,2,2,0.00%
bifrost-https-v4.gw.postman.com,0,0.00%,4,4,0.00%
v1-y.douyinvod.com,0,0.00%,2,2,0.00%
ip0467472086.livehwc3.cn,0,0.00%,2,2,0.00%
sdkapi.douyucdn.cn,0,0.00%,2,2,0.00%
logs.browser-intake-datadoghq.com,0,0.00%,2,2,0.00%
submit.iacr.org,0,0.00%,4,4,0.00%
alt8-mtalk.google.com,0,0.00%,4,4,0.00%
oauth.account.jetbrains.com,0,0.00%,4,4,0.00%
preview.feed.toolbox.app,0,0.00%,2,2,0.00%
v83-017.douyinvod.com,0,0.00%,2,2,0.00%
clientnotification-userprodscus1-7.servicebus.windows.net,0,0.00%,6,6,0.00%
APAC02.azure-devices.net,0,0.00%,2,2,0.00%
clientnotification-userprodea1-11.servicebus.windows.net,0,0.00%,4,4,0.00%
www.wshifen.com,0,0.00%,2,2,0.00%
builds.parsecgaming.com,0,0.00%,6,6,0.00%
wwww.bing.com,0,0.00%,2,2,0.00%
dual-a-0001.a-msedge.net,0,0.00%,2,2,0.00%
passport.n.shifen.com,0,0.00%,6,6,0.00%
www.bing.cn,0,0.00%,2,2,0.00%
bing.cn,0,0.00%,4,4,0.00%
c0.wp.com,0,0.00%,4,4,0.00%
s0.wp.com,0,0.00%,4,4,0.00%
stats.wp.com,0,0.00%,4,4,0.00%
i0.wp.com,0,0.00%,4,4,0.00%
pixel.wp.com,0,0.00%,4,4,0.00%
defaultcustomheadersdata.files.wordpress.com,0,0.00%,2,2,0.00%
s8.files.wordpress.com,0,0.00%,2,2,0.00%
sequoia.cdn-apple.com,0,0.00%,4,4,0.00%
p206-quota.icloud.com.cn,0,0.00%,2,2,0.00%
ns-sb2-prod-hk2-005.cloudapp.net,0,0.00%,2,2,0.00%
onedscolprduks02.uksouth.cloudapp.azure.com,0,0.00%,2,2,0.00%
cn-0001.cn-msedge.net,0,0.00%,2,2,0.00%
zlxxglobal.v.lxcvc.com,0,0.00%,2,2,0.00%
clientnotification-userprodcus1-6.servicebus.windows.net,0,0.00%,2,2,0.00%
p2plive-ws.douyucdn.cn,0,0.00%,12,12,0.00%
statwup.huya.com,0,0.00%,4,4,0.00%
ylog.huya.com,0,0.00%,2,2,0.00%
metric.huya.com,0,0.00%,2,2,0.00%
pgdt.ugdtimg.com,0,0.00%,2,2,0.00%
manage-api.infinitytab.com,0,0.00%,2,2,0.00%
miniapp.bilibili.com,0,0.00%,3,3,0.00%
e-stat.huya.com,0,0.00%,2,2,0.00%
api.sobot.com,0,0.00%,10,10,0.00%
amp-api-edge-lb.itunes-apple.com.akadns.net,0,0.00%,3,3,0.00%
securetoken.googleapis.com,0,0.00%,2,2,0.00%
mobaxterm.mobatek.net,0,0.00%,2,2,0.00%
push-statics.meizu.com,0,0.00%,2,2,0.00%
connectivitycheck-backup.platform.hihonorcloud.com,0,0.00%,2,2,0.00%
connectivitycheck.platform.hihonorcloud.com,0,0.00%,2,2,0.00%
cn-shenzhen.axt.aliyun.com,0,0.00%,9,9,0.00%
ts4.mm.bing.net,0,0.00%,3,3,0.00%
ts1.mm.bing.net,0,0.00%,2,2,0.00%
cpestatus.hipplayconnect.com,0,0.00%,6,6,0.00%
drive.weixin.qq.com,0,0.00%,11,11,0.00%
ai-unified-gateway4.vivo.com.cn,0,0.00%,2,2,0.00%
r2---sn-2x3elnez.gvt1.com,0,0.00%,6,6,0.00%
na61-ucc-upaas.uc.cn,0,0.00%,2,2,0.00%
th.symcd.com,0,0.00%,2,2,0.00%
th.symcb.com,0,0.00%,2,2,0.00%
vi.bls.mdt.qq.com,0,0.00%,4,4,0.00%
python-world.github.io,0,0.00%,1,1,0.00%
a.video.qq.com,0,0.00%,2,2,0.00%
6.rlb.router.teamviewer.cn,0,0.00%,3,3,0.00%
unpm-upaas.uc.cn,0,0.00%,3,3,0.00%
api5.zhipin.com,0,0.00%,2,2,0.00%
p205-quota.icloud.com.cn,0,0.00%,4,4,0.00%
only-890326-159-226-95-66.nstool.yqkk.link,0,0.00%,2,2,0.00%
p1.music.126.net,0,0.00%,5,5,0.00%
officeci-mauservice.azurewebsites.net,0,0.00%,4,4,0.00%
push.douban.com,0,0.00%,2,2,0.00%
api.douban.com,0,0.00%,2,2,0.00%
dsp-x.jd.com,0,0.00%,6,6,0.00%
xlog.jd.com,0,0.00%,6,6,0.00%
mi.gdt.qq.com,0,0.00%,10,10,0.00%
apm-and.zhipin.com,0,0.00%,2,2,0.00%
logapi-and.zhipin.com,0,0.00%,2,2,0.00%
001.jiang2020.ga,0,0.00%,1,1,0.00%
onedriveclucprodbn20003.blob.core.windows.net,0,0.00%,2,2,0.00%
download.gfe.nvidia.com,0,0.00%,2,2,0.00%
v9-cold.douyinvod.com,0,0.00%,2,2,0.00%
weather-edge.apple.com,0,0.00%,2,2,0.00%
qumas.mail.qq.com,0,0.00%,2,2,0.00%
only-147899-159-226-95-66.nstool.yqkk.link,0,0.00%,2,2,0.00%
p216-fmf.icloud.com.cn,0,0.00%,2,2,0.00%
logincdn.msauth.net,0,0.00%,6,6,0.00%
mail.beijing.gov.cn,0,0.00%,1,1,0.00%
shift.is.autonavi.com,0,0.00%,6,6,0.00%
download.mobatek.net,0,0.00%,2,2,0.00%
puf6no0k.nodedata.net,0,0.00%,2,2,0.00%
32z8y94232.qicp.vip,0,0.00%,1,1,0.00%
easyscholar.cc,0,0.00%,2,2,0.00%
archiva-maven-storage-prod.oss-cn-beijing.aliyuncs.com,0,0.00%,1,1,0.00%
ad.wappalyzer.com,0,0.00%,1,1,0.00%
nep.advangelists.com,0,0.00%,3,3,0.00%
content.dellsupportcenter.com,0,0.00%,1,1,0.00%
opencloud.wostore.cn,0,0.00%,4,4,0.00%
aid.m.taobao.com,0,0.00%,1,1,0.00%
nisbj3.10010.com,0,0.00%,2,2,0.00%
iota197.rtb.appier.net,0,0.00%,1,1,0.00%
ea119-su121-na610.wagbridge.gaode.com.gds.alibabadns.com,0,0.00%,2,2,0.00%
guoguouser.cainiao.com,0,0.00%,2,2,0.00%
nbnest-admonitor.cainiao.com,0,0.00%,1,1,0.00%
adashx.ut.cainiao.com,0,0.00%,2,2,0.00%
px.effirst.com,0,0.00%,1,1,0.00%
s-gm.mmstat.com,0,0.00%,1,1,0.00%
nbnetflow-reply-log.cn-wulanchabu.log.aliyuncs.com,0,0.00%,1,1,0.00%
iyes.youku.com,0,0.00%,5,5,0.00%
h-adashx.ut.cainiao.com,0,0.00%,2,2,0.00%
apidp.dell.com,0,0.00%,1,1,0.00%
wpad.com,0,0.00%,2,2,0.00%
p37-buy.itunes.apple.com,0,0.00%,1,1,0.00%
www-wide.l.google.com,0,0.00%,2,2,0.00%
downloaddispatch.itunes.apple.com,0,0.00%,1,1,0.00%
quillbot.com,0,0.00%,4,4,0.00%
doi.org,0,0.00%,6,6,0.00%
crossmark.crossref.org,0,0.00%,2,2,0.00%
downloads.dell.com,0,0.00%,1,1,0.00%
cdn.taboola.com,0,0.00%,1,1,0.00%
app-site-association.g.aaplimg.com,0,0.00%,2,2,0.00%
chipmunk.grammarly.com,0,0.00%,6,6,0.00%
stdl.qq.com,0,0.00%,8,8,0.00%
wis.qq.com,0,0.00%,2,2,0.00%
baas.browser.qq.com,0,0.00%,2,2,0.00%
apizui.lenovomm.com,0,0.00%,2,2,0.00%
dl.lenovomm.com,0,0.00%,2,2,0.00%
vs5.bj2ct.u3.ucweb.com,0,0.00%,4,4,0.00%
quark.sm.cn,0,0.00%,4,4,0.00%
ad.360yield.com,0,0.00%,1,1,0.00%
d.vidoomy.com,0,0.00%,2,2,0.00%
metrics.hub.caaws.services,0,0.00%,2,2,0.00%
view.inews.qq.com,0,0.00%,1,1,0.00%
userinfogw-drcn.cloud.dbankcloud.cn,0,0.00%,2,2,0.00%
as.weixin.qq.com,0,0.00%,2,2,0.00%
mobile.baidu.com,0,0.00%,2,2,0.00%
fxgate.baidu.com,0,0.00%,2,2,0.00%
cid-091729499ed26496.users.storage.live.com,0,0.00%,2,2,0.00%
sjs0.sinajs.cn,0,0.00%,5,5,0.00%
ins-9fciednc.ias.tencent-cloud.net,0,0.00%,2,2,0.00%
fclog.baidu.com,0,0.00%,2,2,0.00%
tbgl2e4529ejnjrb.aliyunddos1001.com,0,0.00%,2,2,0.00%
trpcpb.imtt.qq.com,0,0.00%,2,2,0.00%
feeds.qq.com,0,0.00%,2,2,0.00%
skin.browser.qq.com,0,0.00%,2,2,0.00%
cre.mix.sina.com.cn,0,0.00%,7,7,0.00%
sbeacon.sina.com.cn,0,0.00%,7,7,0.00%
k.sinaimg.cn,0,0.00%,7,7,0.00%
blackhole.m.jd.com.gslb.qianxun.com,0,0.00%,2,2,0.00%
t.zoukankan.com,0,0.00%,1,1,0.00%
img.blog.csdn.net,0,0.00%,1,1,0.00%
ali-bj-pcdn-27.biliapi.net,0,0.00%,2,2,0.00%
www.eclipse.org,0,0.00%,1,1,0.00%
developer.nvidia.com,0,0.00%,1,1,0.00%
download.eclipse.org,0,0.00%,1,1,0.00%
isaac.ele.me,0,0.00%,2,2,0.00%
nbsdk-baichuan.taobao.com,0,0.00%,2,2,0.00%
some.url,0,0.00%,2,2,0.00%
p204-contacts.icloud.com.cn,0,0.00%,14,14,0.00%
seed.siri.apple.com,0,0.00%,6,6,0.00%
res.browser.qq.com,0,0.00%,2,2,0.00%
skeyword.browser.qq.com,0,0.00%,2,2,0.00%
down.360safe.com,0,0.00%,2,2,0.00%
access-tel-i.alicdn.com,0,0.00%,4,4,0.00%
searchsuggest.browser.qq.com,0,0.00%,2,2,0.00%
ad.browser.qq.com,0,0.00%,2,2,0.00%
smartgate.oa.tencent.com,0,0.00%,8,8,0.00%
ip-smartgate.oa.tencent.com,0,0.00%,8,8,0.00%
api.huangye.miui.com,0,0.00%,2,2,0.00%
4rv3.pt,0,0.00%,1,1,0.00%
pssn.alicdn.com,0,0.00%,4,4,0.00%
security.browser.miui.com,0,0.00%,2,2,0.00%
userver-upaas.uc.cn,0,0.00%,2,2,0.00%
cdn.windroid.xyz,0,0.00%,2,2,0.00%
freeconnect.ioa.tencent.com,0,0.00%,4,4,0.00%
sg2-ngnpc-s.sgw.woa.com,0,0.00%,4,4,0.00%
sg2-ngnpc-g.sgw.woa.com,0,0.00%,4,4,0.00%
access.ioa.tencent.com,0,0.00%,4,4,0.00%
amd-infra.itunes.apple.com,0,0.00%,4,4,0.00%
sdkapiv2.bizport.cn,0,0.00%,6,6,0.00%
p217-escrowproxy.icloud.com.cn,0,0.00%,2,2,0.00%
mstat.tpns.tencent.com,0,0.00%,4,4,0.00%
wps-file.obs.cn-north-4.myhuaweicloud.com,0,0.00%,2,2,0.00%
picasso-static.xiaohongshu.com,0,0.00%,2,2,0.00%
transit1.wslog.chinanetcenter.com,0,0.00%,2,2,0.00%
p2pstuntest.haplat.net,0,0.00%,2,2,0.00%
mambap2pvodh5.8686c.com,0,0.00%,2,2,0.00%
smarturl.sync.maxthon.cn,0,0.00%,2,2,0.00%
clientnotification-userprodea1-0.servicebus.windows.net,0,0.00%,2,2,0.00%
aps.amap.com.gds.alibabadns.com,0,0.00%,2,2,0.00%
apifox.cn-hangzhou.log.aliyuncs.com,0,0.00%,2,2,0.00%
activity-geo.trafficmanager.net,0,0.00%,6,6,0.00%
s-adashx.ut.taobao.com,0,0.00%,1,1,0.00%
emdcadvertise.eastmoney.com,0,0.00%,2,2,0.00%
emdcmiddleware.eastmoney.com,0,0.00%,2,2,0.00%
msgcnt.eastmoney.com,0,0.00%,2,2,0.00%
cfgpassport2.eastmoney.com,0,0.00%,2,2,0.00%
emimpcpf2.eastmoney.com,0,0.00%,1,1,0.00%
gbapi-wg.eastmoney.com,0,0.00%,1,1,0.00%
emdctrade.eastmoney.com,0,0.00%,1,1,0.00%
avator.eastmoney.com,0,0.00%,1,1,0.00%
gate.push.eastmoney.com,0,0.00%,1,1,0.00%
shealth-api.samsunghealth.com,0,0.00%,2,2,0.00%
emdcadvise.eastmoney.com,0,0.00%,2,2,0.00%
acttg.eastmoney.com,0,0.00%,1,1,0.00%
qhemrs.eastmoney.com,0,0.00%,1,1,0.00%
np-kuaixun.eastmoney.com,0,0.00%,2,2,0.00%
empic.dfcfw.com,0,0.00%,1,1,0.00%
cn-api.samsungosp.com,0,0.00%,2,2,0.00%
china-gld.push.samsungosp.com.cn,0,0.00%,1,1,0.00%
np-metadata.eastmoney.com,0,0.00%,2,2,0.00%
emapcapi.eastmoney.com,0,0.00%,2,2,0.00%
client-server1.safedog.cn,0,0.00%,1,1,0.00%
www.processon.com.w.kunluncan.com,0,0.00%,2,2,0.00%
pcapp-robot.youku.com,0,0.00%,3,3,0.00%
t.kanzhun.com,0,0.00%,1,1,0.00%
lenovocdn.ilive.cn,0,0.00%,1,1,0.00%
weibanzhushou.oss-cn-shenzhen.aliyuncs.com,0,0.00%,2,2,0.00%
dellupdater.dell.com,0,0.00%,2,2,0.00%
accountcapabilities-pa.googleapis.com,0,0.00%,1,1,0.00%
newsapp.sina.cn,0,0.00%,1,1,0.00%
newsapi.sina.cn,0,0.00%,4,4,0.00%
time.cloud.tencent.com,0,0.00%,1,1,0.00%
link-yqsx03.netease.im,0,0.00%,1,1,0.00%
lnk0.com,0,0.00%,3,3,0.00%
zpgetworker11.com,0,0.00%,2,2,0.00%
relaxtime24.biz,0,0.00%,2,2,0.00%
cajviewer.cnki.net,0,0.00%,1,1,0.00%
yt3.ggpht.com,0,0.00%,1,1,0.00%
mobile2.10jqka.com.cn,0,0.00%,1,1,0.00%
onedriveclucprodbn20013.blob.core.windows.net,0,0.00%,1,1,0.00%
slog.trackingio.com,0,0.00%,1,1,0.00%
selfstock.10jqka.com.cn,0,0.00%,1,1,0.00%
nos.ns1.ff.avast.com,0,0.00%,3,3,0.00%
t.in-neo.cn,0,0.00%,1,1,0.00%
encrypted-tbn0.gstatic.com,0,0.00%,1,1,0.00%
rc10-fc06.oray.com,0,0.00%,2,2,0.00%
a.shentonggo.cn,0,0.00%,1,1,0.00%
id.google.com.hk,0,0.00%,4,4,0.00%
id.google.com,0,0.00%,1,1,0.00%
adservice.google.com.hk,0,0.00%,4,4,0.00%
d2kaokxjvx18eu.cloudfront.net,0,0.00%,1,1,0.00%
p50-caldav.icloud.com,0,0.00%,1,1,0.00%
discovery-v4.syncthing.net,0,0.00%,3,3,0.00%
ocsp.comodoca.com,0,0.00%,1,1,0.00%
kae.wpsdns.com,0,0.00%,1,1,0.00%
weboffice.wpsdns.com,0,0.00%,3,3,0.00%
amisfile.bj.bcebos.com,0,0.00%,1,1,0.00%
sendvsfeedback2.azurewebsites.net,0,0.00%,1,1,0.00%
services.readcube.com,0,0.00%,1,1,0.00%
plugin.jeejen.com,0,0.00%,1,1,0.00%
sync.readcube.com,0,0.00%,1,1,0.00%
c.mipcdn.com,0,0.00%,1,1,0.00%
jss.51dongshi.com,0,0.00%,1,1,0.00%
js.51dongshi.com,0,0.00%,1,1,0.00%
tuijian.51dongshi.com,0,0.00%,1,1,0.00%
userweatherapi-xzdesktop.cqttech.com,0,0.00%,3,3,0.00%
img.how234.com,0,0.00%,1,1,0.00%
api-shoulei-ssl.xunlei.com,0,0.00%,6,6,0.00%
jspassport.ssl.qhimg.com,0,0.00%,1,1,0.00%
p212-contacts.icloud.com.cn,0,0.00%,5,5,0.00%
cdn.pendo.io,0,0.00%,4,4,0.00%
sdfestaticassets-us-east-1.sciencedirectassets.com,0,0.00%,3,3,0.00%
ars.els-cdn.com,0,0.00%,2,2,0.00%
xcx.yqgz.beijing.gov.cn,0,0.00%,1,1,0.00%
bah7uchi.nodedata.net,0,0.00%,3,3,0.00%
assets.adobedtm.com,0,0.00%,2,2,0.00%
unpkg.com,0,0.00%,3,3,0.00%
appoptimize-drcn.dbankcdn.com.HOST,0,0.00%,2,2,0.00%
brxt-research.mendeley.com,0,0.00%,2,2,0.00%
b.c2r.ts.cdn.office.net,0,0.00%,1,1,0.00%
service.seamlessaccess.org,0,0.00%,1,1,0.00%
bam-cell.nr-data.net,0,0.00%,1,1,0.00%
static.cloudflareinsights.com,0,0.00%,1,1,0.00%
elsevier.demdex.net,0,0.00%,3,3,0.00%
smetrics.elsevier.com,0,0.00%,1,1,0.00%
api.interpreter.caiyunai.com,0,0.00%,4,4,0.00%
ceuswatcab01.blob.core.windows.net,0,0.00%,1,1,0.00%
fanyi.qq.com,0,0.00%,1,1,0.00%
gomediago.baidu.com,0,0.00%,1,1,0.00%
xdssp.mediav.com,0,0.00%,1,1,0.00%
match.p4p.1688.com,0,0.00%,1,1,0.00%
live-s3m.mediav.com,0,0.00%,1,1,0.00%
user.statsanalytical.com,0,0.00%,1,1,0.00%
auth.elsevier.com,0,0.00%,1,1,0.00%
e2c28.gcp.gvt2.com,0,0.00%,1,1,0.00%
app.api.ke.com,0,0.00%,2,2,0.00%
download.firefox.com.cn,0,0.00%,1,1,0.00%
ddns.oray.com,0,0.00%,2,2,0.00%
ws12.gti.mcafee.com,0,0.00%,2,2,0.00%
ip.taobao.com,0,0.00%,1,1,0.00%
mapi.weibo.com,0,0.00%,1,1,0.00%
basic-enroll.ccs.mcafee.com,0,0.00%,2,2,0.00%
sdkclick.biz.weibo.com,0,0.00%,1,1,0.00%
api.im.weibo.cn,0,0.00%,3,3,0.00%
api.fqtodo.cn,0,0.00%,2,2,0.00%
elsevierlimited.tt.omtrdc.net,0,0.00%,1,1,0.00%
id.elsevier.com,0,0.00%,1,1,0.00%
apps.apple.com,0,0.00%,1,1,0.00%
api.300624.com,0,0.00%,1,1,0.00%
dsm01pap003.storage.live.com,0,0.00%,1,1,0.00%
onedriveclucproddm20004.blob.core.windows.net,0,0.00%,1,1,0.00%
zoomsgp30zc.sg.zoom.us,0,0.00%,1,1,0.00%
provision.ccs.mcafee.com,0,0.00%,3,3,0.00%
s2-10623.kwimgs.com,0,0.00%,1,1,0.00%
wapwbclick.uve.weibo.com,0,0.00%,2,2,0.00%
pics2.baidu.com,0,0.00%,1,1,0.00%
pics6.baidu.com,0,0.00%,1,1,0.00%
china1.elsevier.com,0,0.00%,1,1,0.00%
s.m.sohu.com,0,0.00%,2,2,0.00%
house.focus.cn,0,0.00%,2,2,0.00%
ncov2019.sohu.com,0,0.00%,2,2,0.00%
policy.ccs.mcafee.com,0,0.00%,10,10,0.00%
www.elsevier.com,0,0.00%,1,1,0.00%
cdn.plu.mx,0,0.00%,4,4,0.00%
analytics.ccs.mcafee.com,0,0.00%,1,1,0.00%
0000184e.701C.q3njiiiwhnmgd6e3vus1n97tib.avqs.mcafee.com,0,0.00%,2,2,0.00%
wlog.gifshow.com,0,0.00%,1,1,0.00%
reader.elsevier.com,0,0.00%,1,1,0.00%
analyticsdcs.ccs.mcafee.com,0,0.00%,2,2,0.00%
api.plu.mx,0,0.00%,1,1,0.00%
webrtcpunch.video.qq.com,0,0.00%,4,4,0.00%
pdf.sciencedirectassets.com,0,0.00%,2,2,0.00%
qmac.f.360.cn,0,0.00%,2,2,0.00%
nj.h.bcsp2p.baidu.com,0,0.00%,1,1,0.00%
antispam.wanmei.com,0,0.00%,2,2,0.00%
vietjet-api.vietjetair.com,0,0.00%,1,1,0.00%
www.logitech.com,0,0.00%,1,1,0.00%
updates.logitech.com,0,0.00%,2,2,0.00%
apigtwb2c.us.dell.com,0,0.00%,1,1,0.00%
turingapi-rapiddeploy.microsoft.com,0,0.00%,1,1,0.00%
www.googleadservices.com,0,0.00%,4,4,0.00%
e2c24.gcp.gvt2.com,0,0.00%,2,2,0.00%
www.zotero.org,0,0.00%,11,11,0.00%
cloudsearch.googleapis.com,0,0.00%,2,2,0.00%
e2c12.gcp.gvt2.com,0,0.00%,1,1,0.00%
ubacollect-drcn.cloud.dbankcloud.cn,0,0.00%,2,2,0.00%
photoshare-drcn.cloud.dbankcloud.cn,0,0.00%,4,4,0.00%
wap.zol.com.cn,0,0.00%,1,1,0.00%
icon.zol-img.com.cn,0,0.00%,1,1,0.00%
ask-fd.zol-img.com.cn,0,0.00%,1,1,0.00%
in2-prod-east-us2-23fa330.trafficmanager.net,0,0.00%,8,8,0.00%
cpro.zol.com.cn,0,0.00%,2,2,0.00%
res2.wx.qq.com,0,0.00%,1,1,0.00%
newbbs-fd.zol-img.com.cn,0,0.00%,1,1,0.00%
doc-fd.zol-img.com.cn,0,0.00%,1,1,0.00%
p.zol-img.com.cn,0,0.00%,1,1,0.00%
pro-fd.zol-img.com.cn,0,0.00%,1,1,0.00%
common-fd.zol-img.com.cn,0,0.00%,1,1,0.00%
js.zol.com.cn,0,0.00%,2,2,0.00%
pvnwap.zol.com.cn,0,0.00%,1,1,0.00%
ca.zol.com.cn,0,0.00%,1,1,0.00%
ydjs.zol.com.cn,0,0.00%,2,2,0.00%
wappv.zol.com.cn,0,0.00%,2,2,0.00%
dynamic.zol.com.cn,0,0.00%,1,1,0.00%
impa.zol.com.cn,0,0.00%,2,2,0.00%
dg-fd.zol-img.com.cn,0,0.00%,1,1,0.00%
m7.music.126.net,0,0.00%,2,2,0.00%
apijs1.ksapisrv.com,0,0.00%,1,1,0.00%
uploads1.gifshow.com,0,0.00%,2,2,0.00%
policyorchestration.ccs.mcafee.com,0,0.00%,2,2,0.00%
kernelapi.vivo.com.cn,0,0.00%,1,1,0.00%
wdl1.pcfg.cache.wpscdn.com,0,0.00%,4,4,0.00%
api.fghrsh.net,0,0.00%,2,2,0.00%
get-bx.g.aaplimg.com,0,0.00%,2,2,0.00%
tax.51fapiao.cn,0,0.00%,2,2,0.00%
eaus2watcab01.blob.core.windows.net,0,0.00%,2,2,0.00%
amcore.rest.gti.mcafee.com,0,0.00%,12,12,0.00%
settings.data.microsoft.com,0,0.00%,4,4,0.00%
securemetrics.apple.com.cn,0,0.00%,2,2,0.00%
slp2p-east-std45.oray.net,0,0.00%,4,4,0.00%
v1.play.log.hunantv.com,0,0.00%,2,2,0.00%
cp.bz.mgtv.com,0,0.00%,2,2,0.00%
disp.titan.mgtv.com,0,0.00%,2,2,0.00%
hw-v2.log.mgtv.com,0,0.00%,2,2,0.00%
data.feidee.net,0,0.00%,2,2,0.00%
api.feidee.net,0,0.00%,2,2,0.00%
tg.feidee.com,0,0.00%,2,2,0.00%
moneymarket.ssjlicai.com,0,0.00%,2,2,0.00%
yun.feidee.net,0,0.00%,2,2,0.00%
m.sui.com,0,0.00%,2,2,0.00%
invest.feidee.net,0,0.00%,2,2,0.00%
message.feidee.com,0,0.00%,2,2,0.00%
kinglog.feidee.net,0,0.00%,2,2,0.00%
oss.feidee.net,0,0.00%,2,2,0.00%
ssjapp.ssjlicai.com,0,0.00%,2,2,0.00%
kncreditcenter.cardniu.com,0,0.00%,2,2,0.00%
sxd.ssjlicai.com,0,0.00%,2,2,0.00%
community.feidee.com,0,0.00%,2,2,0.00%
sync.feidee.net,0,0.00%,2,2,0.00%
userapi.feidee.net,0,0.00%,2,2,0.00%
sync2.feidee.net,0,0.00%,2,2,0.00%
cb10bdfbd90f88db560d0ad1e8f78722.dlied1.cdntips.net,0,0.00%,6,6,0.00%
bgp.fq.mk,0,0.00%,3,3,0.00%
www.nowcoder.com,0,0.00%,20,20,0.00%
e2cs48.gcp.gvt2.com,0,0.00%,3,3,0.00%
docker.mirrors.ustc.edu.cn,0,0.00%,2,2,0.00%
spaceapp.net,0,0.00%,2,2,0.00%
conf-m-ssl.xunlei.com,0,0.00%,3,3,0.00%
ssl.captcha.qq.com,0,0.00%,10,10,0.00%
www.jeasyui.com,0,0.00%,3,3,0.00%
udiab1.jianshu.com,0,0.00%,2,2,0.00%
ei.cnzz.com,0,0.00%,2,2,0.00%
revive.outin.cn,0,0.00%,2,2,0.00%
udiab2.jianshu.com,0,0.00%,2,2,0.00%
lib.sinaapp.com,0,0.00%,2,2,0.00%
s2.yylady.cn,0,0.00%,2,2,0.00%
s3m5.nzwgs.com,0,0.00%,4,4,0.00%
microsoftedgewelcome.microsoft.com,0,0.00%,2,2,0.00%
only-252159-124-16-140-6.nstool.netease.com,0,0.00%,1,1,0.00%
edgefrecdn.azureedge.net,0,0.00%,2,2,0.00%
target.microsoft.com,0,0.00%,1,1,0.00%
microsoftmscompoc.tt.omtrdc.net,0,0.00%,1,1,0.00%
my.ruanmei.com,0,0.00%,2,2,0.00%
px.ucweb.com,0,0.00%,6,6,0.00%
browser.events.data.microsoft.com,0,0.00%,2,2,0.00%
online.dc.api.cqttech.com,0,0.00%,4,4,0.00%
code.aliyun.com,0,0.00%,4,4,0.00%
sourcedb.is.cas.cn,0,0.00%,2,2,0.00%
netmon.stat.360safe.com,0,0.00%,1,1,0.00%
8d3bc6ea34fc5d069acca1b820b03b10.clo.footprintdns.com,0,0.00%,1,1,0.00%
pypi.python.org,0,0.00%,2,2,0.00%
p57-buy.itunes-apple.com.akadns.net,0,0.00%,2,2,0.00%
mime.n.shifen.com,0,0.00%,4,4,0.00%
only-515923-124-16-140-6.nstool.321fenx.com,0,0.00%,1,1,0.00%
c-pay.lingkou.com,0,0.00%,2,2,0.00%
olimenew.baidu.com,0,0.00%,2,2,0.00%
www.pagespeed-mod.com,0,0.00%,1,1,0.00%
wp-front.shanhutech.cn,0,0.00%,2,2,0.00%
wp.shanhutech.cn,0,0.00%,2,2,0.00%
o324374.ingest.sentry.io,0,0.00%,2,2,0.00%
nw-umwatson.events.data.microsoft.com,0,0.00%,2,2,0.00%
musicpunch.p2p.qq.com,0,0.00%,5,5,0.00%
browser-plug-api.yangjibao.com,0,0.00%,2,2,0.00%
ss.shanhutech.cn,0,0.00%,2,2,0.00%
cdn-ali-file-front.shanhutech.cn,0,0.00%,2,2,0.00%
digbird.shanhutech.cn,0,0.00%,2,2,0.00%
cdn-ali-file-digbird.shanhutech.cn,0,0.00%,2,2,0.00%
xyz.51job.com,0,0.00%,2,2,0.00%
img03.51jobcdn.com,0,0.00%,2,2,0.00%
user.jpush.cn,0,0.00%,2,2,0.00%
cloud.fanruan.com,0,0.00%,4,4,0.00%
flow.wps.cn,0,0.00%,4,4,0.00%
0e058cb0b410019fdb5b3a606c9d0c43.clo.footprintdns.com,0,0.00%,1,1,0.00%
zt.baidu.com,0,0.00%,4,4,0.00%
rdc.aliyun.com,0,0.00%,2,2,0.00%
login.rdc.aliyun.com,0,0.00%,2,2,0.00%
z13.cnzz.com,0,0.00%,2,2,0.00%
online2.dc.api.cqttech.com,0,0.00%,2,2,0.00%
a.cnzz.com,0,0.00%,6,6,0.00%
my.rdc.aliyun.com,0,0.00%,2,2,0.00%
service.rdc.aliyun.com,0,0.00%,2,2,0.00%
repomanage.rdc.aliyun.com,0,0.00%,2,2,0.00%
f.alicdn.com,0,0.00%,4,4,0.00%
code.rdc.aliyun.com,0,0.00%,2,2,0.00%
home.console.aliyun.com,0,0.00%,2,2,0.00%
vone-new.rdc.aliyun.com,0,0.00%,2,2,0.00%
yuncodeweb.oss-cn-hangzhou.aliyuncs.com,0,0.00%,2,2,0.00%
webadvisorc.rest.gti.mcafee.com,0,0.00%,2,2,0.00%
1582937130534912.mqrest.cn-qingdao-public.aliyuncs.com,0,0.00%,2,2,0.00%
account.aliyun.com,0,0.00%,2,2,0.00%
adimg.uve.weibo.com,0,0.00%,4,4,0.00%
olimenew.n.shifen.com,0,0.00%,4,4,0.00%
kylin.im.weibo.cn,0,0.00%,2,2,0.00%
weibointl.api.weibo.cn,0,0.00%,2,2,0.00%
tqt.weibo.cn,0,0.00%,4,4,0.00%
jingyan.baidu.com,0,0.00%,5,5,0.00%
weico.api.weibo.cn,0,0.00%,1,1,0.00%
ns-strategy.cdn.bcebos.com,0,0.00%,2,2,0.00%
metis.vivo.com.cn,0,0.00%,2,2,0.00%
live-adapt.pddpic.com,0,0.00%,1,1,0.00%
live12-adapt.pddpic.com,0,0.00%,1,1,0.00%
live04-adapt.pddpic.com,0,0.00%,1,1,0.00%
canonical-bos01.cdn.snapcraftcontent.com,0,0.00%,2,2,0.00%
msgstore.www.notion.so,0,0.00%,1,1,0.00%
tracker.ai.xiaomi.com,0,0.00%,6,6,0.00%
exp.bdstatic.com,0,0.00%,1,1,0.00%
bj.bcebos.com,0,0.00%,3,3,0.00%
debian.map.fastlydns.net,0,0.00%,9,9,0.00%
audd.shuzilm.cn,0,0.00%,1,1,0.00%
p5.itc.cn,0,0.00%,1,1,0.00%
39d0825d09f05.cdn.sohucs.com,0,0.00%,2,2,0.00%
js.sohu.com,0,0.00%,2,2,0.00%
txt.go.sohu.com,0,0.00%,1,1,0.00%
www.360.com,0,0.00%,469,469,0.00%
www.sina.com.cn,0,0.00%,169,169,0.00%
wren.ns.cloudflare.com,0,0.00%,2,2,0.00%
ns57.domaincontrol.com,0,0.00%,6,6,0.00%
ns58.domaincontrol.com,0,0.00%,6,6,0.00%
kayaksuperstore.com,0,0.00%,2,2,0.00%
ns2.webhostinghub.com,0,0.00%,4,4,0.00%
h.17986.net,0,0.00%,2,2,0.00%
ns.inspediumcorp.com,0,0.00%,2,2,0.00%
ns24.inhostedns.net,0,0.00%,2,2,0.00%
akndw.safe.360.cn,0,0.00%,2,2,0.00%
ns.corpservers.net,0,0.00%,2,2,0.00%
ns2.inspediumcorp.com,0,0.00%,2,2,0.00%
r.17986.net,0,0.00%,2,2,0.00%
ns2.hostmonster.com,0,0.00%,6,6,0.00%
ns1.hostmonster.com,0,0.00%,6,6,0.00%
ns1.fortresscolo.com,0,0.00%,2,2,0.00%
ns2.powweb.com,0,0.00%,2,2,0.00%
john-mark.com,0,0.00%,2,2,0.00%
ns1.powweb.com,0,0.00%,2,2,0.00%
pdns104.ultradns.com,0,0.00%,6,6,0.00%
pdns104.ultradns.net,0,0.00%,6,6,0.00%
ns1.netregistry.net,0,0.00%,8,8,0.00%
ns5.dnslake.com,0,0.00%,2,2,0.00%
pdns104.ultradns.biz,0,0.00%,6,6,0.00%
nora.ns.cloudflare.com,0,0.00%,2,2,0.00%
ns2.netregistry.net,0,0.00%,8,8,0.00%
ns383.dnsever.com,0,0.00%,2,2,0.00%
device.auth.xboxlive.com,0,0.00%,5,5,0.00%
ns2.dnslake.com,0,0.00%,2,2,0.00%
thomas.ns.cloudflare.com,0,0.00%,10,10,0.00%
ns363.dnsever.com,0,0.00%,2,2,0.00%
ns306.dnsever.com,0,0.00%,2,2,0.00%
ns2.namehero.com,0,0.00%,4,4,0.00%
ns321.dnsever.com,0,0.00%,2,2,0.00%
ns1.ultahost.com,0,0.00%,2,2,0.00%
title.auth.xboxlive.com,0,0.00%,5,5,0.00%
title.mgt.xboxlive.com,0,0.00%,4,4,0.00%
cns499.hostgator.com,0,0.00%,2,2,0.00%
user.auth.xboxlive.com,0,0.00%,4,4,0.00%
b4bf120.pf.gladns.com,0,0.00%,2,2,0.00%
xtyxjx.com,0,0.00%,2,2,0.00%
gzhp168.com,0,0.00%,2,2,0.00%
blob.bz7prdstr10a.store.core.windows.NET,0,0.00%,2,2,0.00%
achiel.ns.cloudflare.com,0,0.00%,4,4,0.00%
v-7a8dc840.71edge.com,0,0.00%,4,4,0.00%
ns1.uviproject.com,0,0.00%,2,2,0.00%
sow.dnspod.net,0,0.00%,2,2,0.00%
s.17986.net,0,0.00%,2,2,0.00%
imani.ns.cloudflare.com,0,0.00%,4,4,0.00%
ns1.namehero.com,0,0.00%,4,4,0.00%
ns1.lotosus.com,0,0.00%,2,2,0.00%
obexpo.com,0,0.00%,2,2,0.00%
ns1086.ui-dns.de,0,0.00%,4,4,0.00%
ns1097.ui-dns.org,0,0.00%,2,2,0.00%
ns2.youstable.com,0,0.00%,2,2,0.00%
ns1.youstable.com,0,0.00%,2,2,0.00%
chefvlog.com,0,0.00%,2,2,0.00%
ns3.lotosus.com,0,0.00%,2,2,0.00%
ns2.ihsdnsx1.com,0,0.00%,2,2,0.00%
ns-1236.awsdns-26.org,0,0.00%,2,2,0.00%
ns1112.ui-dns.com,0,0.00%,4,4,0.00%
ns2.quickdns.co.uk,0,0.00%,2,2,0.00%
ns4.ultahost.com,0,0.00%,2,2,0.00%
180231.com,0,0.00%,2,2,0.00%
b.17986.net,0,0.00%,2,2,0.00%
ns2.lotosus.com,0,0.00%,2,2,0.00%
ns3.ultahost.com,0,0.00%,2,2,0.00%
ns2.ultahost.com,0,0.00%,2,2,0.00%
connie.ns.cloudflare.com,0,0.00%,2,2,0.00%
matias.ns.cloudflare.com,0,0.00%,2,2,0.00%
ns2.yourhostingaccount.com,0,0.00%,4,4,0.00%
ram.ns.cloudflare.com,0,0.00%,4,4,0.00%
ns1.webhostinghub.com,0,0.00%,4,4,0.00%
ns1.yourhostingaccount.com,0,0.00%,4,4,0.00%
ns4.firstfind.nl,0,0.00%,2,2,0.00%
ns1017.ui-dns.biz,0,0.00%,6,6,0.00%
dns086.a.register.com,0,0.00%,2,2,0.00%
ns6.zonomi.com,0,0.00%,2,2,0.00%
plant.dnspod.net,0,0.00%,2,2,0.00%
dns073.b.register.com,0,0.00%,2,2,0.00%
fibreglass.dnspod.net,0,0.00%,2,2,0.00%
dc.dqa.samsung.com,0,0.00%,2,2,0.00%
dls-udc.dqa.samsung.com.cn,0,0.00%,2,2,0.00%
ns-1490.awsdns-58.org,0,0.00%,2,2,0.00%
ns-1704.awsdns-21.co.uk,0,0.00%,2,2,0.00%
cns500.hostgator.com,0,0.00%,2,2,0.00%
ns-91.awsdns-11.com,0,0.00%,2,2,0.00%
NS5.PAIRNIC.com,0,0.00%,2,2,0.00%
cookiesllc.com,0,0.00%,2,2,0.00%
cqpcys.com,0,0.00%,2,2,0.00%
NS6.PAIRNIC.com,0,0.00%,2,2,0.00%
blob.bnz10prdstr16a.store.core.windows.NET,0,0.00%,2,2,0.00%
ns3.diymysite.com,0,0.00%,6,6,0.00%
ns4.diymysite.com,0,0.00%,6,6,0.00%
cvs.adobe.com,0,0.00%,2,2,0.00%
array611.prod.do.dsp.mp.microsoft.com,0,0.00%,3,3,0.00%
be59399.wx.glados-config.net,0,0.00%,4,4,0.00%
be59399.wz.glados-config.net,0,0.00%,4,4,0.00%
be59399.nx.glados-config.net,0,0.00%,4,4,0.00%
be59399.td.glados-config.net,0,0.00%,4,4,0.00%
be59399.tt.glados-config.net,0,0.00%,4,4,0.00%
be59399.th.glados-config.net,0,0.00%,4,4,0.00%
be59399.wy.glados-config.net,0,0.00%,4,4,0.00%
be59399.cw.glados-config.net,0,0.00%,4,4,0.00%
wap.sogou.com,0,0.00%,4,4,0.00%
cm2-sgp1.cm.steampowered.com,0,0.00%,10,10,0.00%
cm5-sgp1.cm.steampowered.com,0,0.00%,8,8,0.00%
mobads-logs.baidu.com,0,0.00%,1,1,0.00%
wns2-sg2p.wns.windows.com,0,0.00%,2,2,0.00%
195.sammentik.cf,0,0.00%,1,1,0.00%
thunderx.rcv.sandai.net,0,0.00%,9,9,0.00%
caldavhz.qiye.163.com,0,0.00%,2,2,0.00%
ds.download.windowsupdate.com,0,0.00%,4,4,0.00%
services.myendnoteweb.com,0,0.00%,4,4,0.00%
cloud.xylink.com,0,0.00%,2,2,0.00%
bvvfsx.herlpyo.ga,0,0.00%,1,1,0.00%
onedriveclucprodbn20040.blob.core.windows.net,0,0.00%,2,2,0.00%
onedriveclucproddm20038.blob.core.windows.net,0,0.00%,4,4,0.00%
r1---sn-2x3elnez.gvt1.com,0,0.00%,4,4,0.00%
ext2-hkg1.steamserver.net,0,0.00%,4,4,0.00%
cm2-tyo2.cm.steampowered.com,0,0.00%,4,4,0.00%
e9196c7e60d6459aae7fa2e380d131f8.fp.measure.office.com,0,0.00%,1,1,0.00%
demonhe.coding.net,0,0.00%,4,4,0.00%
vulfile.masterconn.qq.com,0,0.00%,6,6,0.00%
s.w.org,0,0.00%,3,3,0.00%
udp-dc.51y5.net,0,0.00%,2,2,0.00%
push-dc.51y5.net,0,0.00%,2,2,0.00%
msg.push.51y5.net,0,0.00%,2,2,0.00%
login.push.51y5.net,0,0.00%,2,2,0.00%
papi.funshion.com,0,0.00%,10,10,0.00%
ip1880706120.funshion.com,0,0.00%,4,4,0.00%
hwvv.yilanvaas.com,0,0.00%,12,12,0.00%
play4.cp21.ott.cibntv.net,0,0.00%,4,4,0.00%
onedscolprdeus06.eastus.cloudapp.azure.com,0,0.00%,14,14,0.00%
ms-ns.anycast.pch.net,0,0.00%,4,4,0.00%
dns3.wscloudcdn.org,0,0.00%,2,2,0.00%
tools.l.google.com,0,0.00%,4,4,0.00%
hw-prod-pub-alb-245537193.us-west-2.elb.amazonaws.com,0,0.00%,4,4,0.00%
i1.c.eset.com,0,0.00%,2,2,0.00%
i1.cwip.eset.com,0,0.00%,2,2,0.00%
ns1.qq.com,0,0.00%,4,4,0.00%
consumerapps.mcafee.com,0,0.00%,8,8,0.00%
consumerapps-prod-53.awscommon.mcafee.com,0,0.00%,4,4,0.00%
prdwss-prod-nlb-wss-b8099ab1e72f69ce.elb.us-west-2.amazonaws.com,0,0.00%,4,4,0.00%
data.hackerwatch.org,0,0.00%,8,8,0.00%
42.courier-push-apple.com.akadns.net,0,0.00%,2,2,0.00%
glb.cws.prod.dcat.dsp.trafficmanager.net,0,0.00%,10,10,0.00%
a.iana-servers.net,0,0.00%,4,4,0.00%
c.iana-servers.net,0,0.00%,4,4,0.00%
b.iana-servers.net,0,0.00%,2,2,0.00%
c.gtld-servers.net,0,0.00%,2,2,0.00%
ns.icann.org,0,0.00%,4,4,0.00%
naz.com.sa,0,0.00%,1,1,0.00%
124.t.keepitpumpin.io,0,0.00%,4,4,0.00%
dns2.cdn20.info,0,0.00%,2,2,0.00%
dns4.cdn20.info,0,0.00%,6,6,0.00%
ns2-205.azure-dns.net,0,0.00%,6,6,0.00%
ns1-205.azure-dns.com,0,0.00%,8,8,0.00%
hubstat.sandai.net,0,0.00%,2,2,0.00%
onedscolprdcus06.centralus.cloudapp.azure.com,0,0.00%,4,4,0.00%
ip.moojing.com,0,0.00%,4,4,0.00%
cloudcontrol.ai.xiaomi.com,0,0.00%,4,4,0.00%
ns-939.awsdns-53.net,0,0.00%,4,4,0.00%
post.n.shifen.com,0,0.00%,2,2,0.00%
upload.post.n.shifen.com,0,0.00%,2,2,0.00%
uploadphotos.n.shifen.com,0,0.00%,2,2,0.00%
15.expertcoach.ml,0,0.00%,1,1,0.00%
gstat.ptmi.gitv.tv,0,0.00%,2,2,0.00%
ns2-221.azure-dns.net,0,0.00%,2,2,0.00%
ns3-221.azure-dns.org,0,0.00%,2,2,0.00%
ns4-221.azure-dns.info,0,0.00%,2,2,0.00%
new.weibo.cn,0,0.00%,2,2,0.00%
common7.dpool.sina.com.cn,0,0.00%,4,4,0.00%
overdue.aliyun.com,0,0.00%,4,4,0.00%
alb00000053.dpool.sina.com.cn,0,0.00%,2,2,0.00%
focus2009.tianya.cn,0,0.00%,2,2,0.00%
c3.pcs.n.shifen.com,0,0.00%,2,2,0.00%
static.n.shifen.com,0,0.00%,2,2,0.00%
pcsdata.n.shifen.com,0,0.00%,4,4,0.00%
use9.akam.net,0,0.00%,2,2,0.00%
usc4.akam.net,0,0.00%,4,4,0.00%
ntes53.mail.126.com,0,0.00%,2,2,0.00%
ds-ats.member.g02.yahoodns.net,0,0.00%,2,2,0.00%
ns1-132.akam.net,0,0.00%,4,4,0.00%
c2.pcs.n.shifen.com,0,0.00%,4,4,0.00%
pcs.n.shifen.com,0,0.00%,4,4,0.00%
wenku.n.shifen.com,0,0.00%,4,4,0.00%
ntes53.mail.163.com,0,0.00%,6,6,0.00%
cs3-upgrade-yuanqicleaner-srv.yuanqidesk.com,0,0.00%,1,1,0.00%
lax.link.ac.cn,0,0.00%,6,6,0.00%
sqm.telemetry.microsoft.com.nsatc.net,0,0.00%,2,2,0.00%
cl5.apple.com,0,0.00%,2,2,0.00%
cl5-cdn.origin-apple.com.akadns.net,0,0.00%,2,2,0.00%
fm.dl.126.net.163jiasu.com,0,0.00%,2,2,0.00%
p209-quota.icloud.com.cn,0,0.00%,2,2,0.00%
quota.fe.apple-dns.cn,0,0.00%,4,4,0.00%
prod-data.acquisition.grammarlyaws.com,0,0.00%,2,2,0.00%
cdn.viglink.com.cdn.cloudflare.NET,0,0.00%,2,2,0.00%
tls12.newrelic.com.cdn.cloudflare.NET,0,0.00%,2,2,0.00%
um02.eset.com,0,0.00%,2,2,0.00%
um04.eset.com,0,0.00%,2,2,0.00%
um10.eset.com,0,0.00%,2,2,0.00%
28.courier-push-apple.com.akadns.net,0,0.00%,4,4,0.00%
um01.eset.com,0,0.00%,2,2,0.00%
um16.eset.com,0,0.00%,2,2,0.00%
um06.eset.com,0,0.00%,2,2,0.00%
um12.eset.com,0,0.00%,2,2,0.00%
docs.axisrooms.com,0,0.00%,1,1,0.00%
e2c30.gcp.gvt2.com,0,0.00%,2,2,0.00%
11031fd0d5784462bbf23f2acebc333e.fp.measure.office.com,0,0.00%,1,1,0.00%
n116.boom.skin,0,0.00%,11,11,0.00%
nplserver.kuwo.cn,0,0.00%,4,4,0.00%
103-56-60-82.dhost.00cdn.com,0,0.00%,2,2,0.00%
hk1.chuqiangtou.net,0,0.00%,2,2,0.00%
autosoga.ggga.ga,0,0.00%,1,1,0.00%
r3---sn-ni5een7z.gvt1.com,0,0.00%,2,2,0.00%
nj9.boom.skin,0,0.00%,11,11,0.00%
p211-contacts.icloud.com.cn,0,0.00%,6,6,0.00%
updates.thingsboard.io,0,0.00%,4,4,0.00%
ncphn.phx.baofeng.net,0,0.00%,2,2,0.00%
smtp.gmail.com,0,0.00%,2,2,0.00%
mail.persbywepocad.tk,0,0.00%,2,2,0.00%
dlp-transit.100tal.com,0,0.00%,4,4,0.00%
271509e17755a70d683b7f40cdb3eec6df604067.u.fdmpkg.org,0,0.00%,4,4,0.00%
astivysauran.com,0,0.00%,2,2,0.00%
littlecdn.com,0,0.00%,4,4,0.00%
feed.wan.360.cn,0,0.00%,4,4,0.00%
cn01www3.zoom.com.cn,0,0.00%,4,4,0.00%
fmt1.link.ac.cn,0,0.00%,8,8,0.00%
livepatch.canonical.com,0,0.00%,2,2,0.00%
home.vas.wpsdns.com,0,0.00%,2,2,0.00%
download.se.360.cn,0,0.00%,4,4,0.00%
kklulqbwyj3s3g2i2otjajef2a3kychks2t3agsbv2hdwtiymkbnueid.tor2web.in,0,0.00%,7,7,0.00%
fastapi.metacpan.org,0,0.00%,2,2,0.00%
adash.m.taobao.com,0,0.00%,2,2,0.00%
iplc.a.hellossr.com,0,0.00%,2,2,0.00%
iplc.b.hellossr.com,0,0.00%,2,2,0.00%
cdn-cn.nekocloud.cn,0,0.00%,2,2,0.00%
ns2-proddns.glbdns.o365filtering.com,0,0.00%,2,2,0.00%
ns1-proddns.glbdns.o365filtering.com,0,0.00%,2,2,0.00%
gzyd.lanyunshi.cc,0,0.00%,6,6,0.00%
downloads.yoctoproject.org,0,0.00%,22,22,0.00%
iepl03.nnooddee.cyou,0,0.00%,6,6,0.00%
7195c67.pc.gladns.com,0,0.00%,6,6,0.00%
darkreader.github.io,0,0.00%,2,2,0.00%
darkreader.org,0,0.00%,2,2,0.00%
settings-prod-wus3-1.westus3.cloudapp.azure.com,0,0.00%,16,16,0.00%
subscription.rhsm.redhat.com,0,0.00%,2,2,0.00%
access.fluidx.ai,0,0.00%,1,1,0.00%
mail22.pension.gov.ae,0,0.00%,2,2,0.00%
mail11.pension.gov.ae,0,0.00%,2,2,0.00%
data.bytedance.net,0,0.00%,2,2,0.00%
search.xunlei.com,0,0.00%,2,2,0.00%
ham-staging-oracle.redant.cloud,0,0.00%,1,1,0.00%
flashloader.net,0,0.00%,2,2,0.00%
weather.ubuntukylin.com,0,0.00%,2,2,0.00%
p206-contacts.icloud.com.cn,0,0.00%,2,2,0.00%
chat.api.autohome.com.cn,0,0.00%,4,4,0.00%
e2cs31.gcp.gvt2.com,0,0.00%,2,2,0.00%
stage.www.kooliruum.ee,0,0.00%,1,1,0.00%
sh.sys-stat.download,0,0.00%,27,27,0.00%
psg1-collabhubrtc.officeapps.live.com,0,0.00%,3,3,0.00%
people.canonical.com,0,0.00%,141,141,0.00%
app-a05.lp1.npns.srv.nintendo.net,0,0.00%,4,4,0.00%
forums.developer.nvidia.com,0,0.00%,24,24,0.00%
xasha1.icloud-content.com.cn,0,0.00%,2,2,0.00%
cloud.culturedcode.com,0,0.00%,4,4,0.00%
alibaba-cn-pvg-00001.oss-cn-shanghai.aliyuncs.com,0,0.00%,2,2,0.00%
active.baofeng.com,0,0.00%,2,2,0.00%
sclog.moviebox.baofeng.com,0,0.00%,2,2,0.00%
appsso.oh.isrc.ac.cn,0,0.00%,21,21,0.00%
telemetry.gfe.nvidia.com,0,0.00%,2,2,0.00%
ns2-35.azure-dns.net,0,0.00%,2,2,0.00%
bs2-1.getnjnd.com,0,0.00%,3,3,0.00%
pr4.getnjnd.com,0,0.00%,6,6,0.00%
bs1-1.getnjnd.com,0,0.00%,4,4,0.00%
jksb.v.zzu.edu.cn,0,0.00%,2,2,0.00%
spoc.norton.com,0,0.00%,8,8,0.00%
t0.tiles.ditu.live.com,0,0.00%,1,1,0.00%
dynamic.api.tiles.ditu.live.com,0,0.00%,1,1,0.00%
t1.dxqjy.top,0,0.00%,36,36,0.00%
nexus.prod.osssc.ac.cn,0,0.00%,17,17,0.00%
online2.b.api.cqttech.com,0,0.00%,9,9,0.00%
down1.abckantu.com,0,0.00%,2,2,0.00%
www36oo.com,0,0.00%,9,9,0.00%
down2.abckantu.com,0,0.00%,4,4,0.00%
platform.cn.bing.com,0,0.00%,2,2,0.00%
app-a03.lp1.npns.srv.nintendo.net,0,0.00%,2,2,0.00%
6e880d8685484084b8b3542b5d7ba30a.fp.measure.office.com,0,0.00%,1,1,0.00%
pcwallpaper.zhhainiao.com,0,0.00%,4,4,0.00%
telemetry.rancher.io,0,0.00%,2,2,0.00%
6.courier-push-apple.com.akadns.net,0,0.00%,2,2,0.00%
nvidia.github.io,0,0.00%,2,2,0.00%
xy.pull.yximgs.com,0,0.00%,4,4,0.00%
bn1301.storage.live.com,0,0.00%,4,4,0.00%
onedriveclucproddm20045.blob.core.windows.net,0,0.00%,2,2,0.00%
driveservicessh.lenovo.com.cn,0,0.00%,2,2,0.00%
array508.prod.do.dsp.mp.microsoft.com,0,0.00%,4,4,0.00%
p210-caldav.icloud.com.cn,0,0.00%,3,3,0.00%
download.proxmox.com,0,0.00%,12,12,0.00%
releases.turnkeylinux.org,0,0.00%,8,8,0.00%
enterprise.proxmox.com,0,0.00%,2,2,0.00%
113gb5.g132d3.10002tli.device-ddp2-dns.ictun.com,0,0.00%,8,8,0.00%
b29f269.nx.cloudflare.systems,0,0.00%,3,3,0.00%
sz-videocloud-dev.oss-cn-shenzhen.aliyuncs.com,0,0.00%,8,8,0.00%
drmkit-drcn.himovie.dbankcloud.cn,0,0.00%,2,2,0.00%
jp_62.antchatxj.com,0,0.00%,4,4,0.00%
hwid.platform.hicloud.com,0,0.00%,4,4,0.00%
xiumi.us,0,0.00%,2,2,0.00%
statuse.digitalcertvalidation.com,0,0.00%,4,4,0.00%
g1.tagtic.cn,0,0.00%,2,2,0.00%
img4.nga.178.com,0,0.00%,2,2,0.00%
33aef1e.cw.cloudflare.systems,0,0.00%,4,4,0.00%
33aef1e.nx.cloudflare.systems,0,0.00%,4,4,0.00%
33aef1e.tt.cloudflare.systems,0,0.00%,4,4,0.00%
33aef1e.ts.cloudflare.systems,0,0.00%,5,5,0.00%
33aef1e.td.cloudflare.systems,0,0.00%,3,3,0.00%
33aef1e.th.cloudflare.systems,0,0.00%,3,3,0.00%
qinfo.wps.cn,0,0.00%,4,4,0.00%
abot.pos.baidu.com,0,0.00%,2,2,0.00%
game.163.com,0,0.00%,2,2,0.00%
magic.h3c.com,0,0.00%,2,2,0.00%
05f454e90e57433fbd4556ca8e6cf73d.fp.measure.office.com,0,0.00%,2,2,0.00%
array502.prod.do.dsp.mp.microsoft.com,0,0.00%,4,4,0.00%
settings-prod-wus2-1.westus2.cloudapp.azure.com,0,0.00%,8,8,0.00%
iosapps.itunes.g.aaplimg.com,0,0.00%,2,2,0.00%
wechat.intelcupid.com,0,0.00%,2,2,0.00%
alb-krmaiwe3bwhbkec015.cn-beijing.alb.aliyuncs.com,0,0.00%,2,2,0.00%
ns4-38.azure-dns.info,0,0.00%,4,4,0.00%
weu015-breeziest-in.cloudapp.net,0,0.00%,2,2,0.00%
weu011-breeziest-in.cloudapp.net,0,0.00%,2,2,0.00%
tr-b.p.360.cn,0,0.00%,4,4,0.00%
dnsj.e5.sk,0,0.00%,2,2,0.00%
dsp-x.jd.com.gslb.qianxun.com,0,0.00%,2,2,0.00%
xlog.jd.com.gslb.qianxun.com,0,0.00%,2,2,0.00%
nex.163.com,0,0.00%,4,4,0.00%
static-dxospf.split.netease.com,0,0.00%,2,2,0.00%
ad.ntes53.netease.com,0,0.00%,2,2,0.00%
janapi.jd.com,0,0.00%,4,4,0.00%
janapi.jd.com.gslb.qianxun.com,0,0.00%,2,2,0.00%
yp.ws.126.net,0,0.00%,2,2,0.00%
yqws126-dxospf.split.netease.com,0,0.00%,2,2,0.00%
e-p4p.163.com,0,0.00%,2,2,0.00%
blob.dz5prdstr06a.store.core.windows.net,0,0.00%,2,2,0.00%
repository.gtm.eset.com,0,0.00%,2,2,0.00%
d35aqihjxzbj2q.cloudfront.cn,0,0.00%,2,2,0.00%
repositorynocdn.eset.com,0,0.00%,2,2,0.00%
nocdn-repository.gtm.eset.com,0,0.00%,2,2,0.00%
ns7-38.azure-dns.org,0,0.00%,2,2,0.00%
onedscolprdcus10.centralus.cloudapp.azure.com,0,0.00%,2,2,0.00%
onedscolprdweu02.westeurope.cloudapp.azure.com,0,0.00%,2,2,0.00%
in1-gw2-01-ce7dd027.eastus2.cloudapp.azure.com,0,0.00%,6,6,0.00%
b.ns.apple.com,0,0.00%,2,2,0.00%
ns4-205.azure-dns.info,0,0.00%,2,2,0.00%
weighted-zh-launcher-public-service-prod06.ol.epicgames.com,0,0.00%,4,4,0.00%
2be5b59124d13cfd58dd8c5eca066b15.qcloudzygj.com,0,0.00%,4,4,0.00%
de756e7cb5050f7a-cl2.qcloudcjgj.com,0,0.00%,4,4,0.00%
onedscolprdweu03.westeurope.cloudapp.azure.com,0,0.00%,2,2,0.00%
deepviz-nlb-prod-ap-southeast-1-f64fb66f5d07c49a.elb.ap-southeast-1.amazonaws.com,0,0.00%,2,2,0.00%
apne1-bytedance-cn.sentinelone.net,0,0.00%,2,2,0.00%
daodian.vip.meituan.com,0,0.00%,2,2,0.00%
ipv6.ts.qq.com,0,0.00%,4,4,0.00%
tnc3-aliec2.feishu.cn,0,0.00%,2,2,0.00%
p47-fmf.icloud.com.cn,0,0.00%,2,2,0.00%
shift.is.autonavi.com.gds.alibabadns.com,0,0.00%,2,2,0.00%
334b7a777e914521b14b70fb15ebb8b8.fp.measure.office.com,0,0.00%,2,2,0.00%
weather-analytics-events.apple.com,0,0.00%,2,2,0.00%
weather-analytics-events.news.apple-dns.net,0,0.00%,2,2,0.00%
ns.cnmobile.net,0,0.00%,2,2,0.00%
ns5.n.shifen.com,0,0.00%,10,10,0.00%
ns1-191.akam.net,0,0.00%,2,2,0.00%
a1b8892e-4b87-43c6-a00b-79fd18fb15e6.apple.com,0,0.00%,2,2,0.00%
fe3.delivery.mp.microsoft.com,0,0.00%,2,2,0.00%
111-20-12-242.volcsiriusbd.com,0,0.00%,2,2,0.00%
ddns-checkip.quickconnect.to,0,0.00%,6,6,0.00%
onedriveclucproddm20015.blob.core.windows.net,0,0.00%,2,2,0.00%
blob.dz6prdstr08a.store.core.windows.net,0,0.00%,2,2,0.00%
k.gtld-servers.net,0,0.00%,6,6,0.00%
wxjnj.readvi.cf,0,0.00%,1,1,0.00%
onedriveclucproddm20011.blob.core.windows.net,0,0.00%,2,2,0.00%
c929f230-rh7400-0-1k3xp.us.pyboard.vip,0,0.00%,2,2,0.00%
bj-a.bcebos.com.n.shifen.com,0,0.00%,2,2,0.00%
extranet-alllines-pub-c3-c4.alb.xiaomi.com,0,0.00%,2,2,0.00%
cname-app-com-amsproxy.w.mi-dun.com,0,0.00%,2,2,0.00%
ssq.cwlo.com.cn,0,0.00%,2,2,0.00%
rf-h1.cwlo.com.cn,0,0.00%,2,2,0.00%
map.qq.com,0,0.00%,2,2,0.00%
rf-serv.cwlo.com.cn,0,0.00%,2,2,0.00%
languagetool.org,0,0.00%,2,2,0.00%
i0.hdslb.com.download.ks-cdn.com,0,0.00%,2,2,0.00%
7e0ee17389484800b93382d0775c09b3.fp.measure.office.com,0,0.00%,1,1,0.00%
p2.shared.global.fastly.net,0,0.00%,4,4,0.00%
assets.msn.cn-c.edgekey.net,0,0.00%,2,2,0.00%
a-0032.a-msedge.net,0,0.00%,4,4,0.00%
ecn.dev.ditu.live.com.lxcvc.com,0,0.00%,2,2,0.00%
anna.ns.cloudflare.com,0,0.00%,2,2,0.00%
georgia.ns.cloudflare.com,0,0.00%,2,2,0.00%
glen.ns.cloudflare.com,0,0.00%,4,4,0.00%
ns2.extrem.jp,0,0.00%,6,6,0.00%
ns1.extrem.jp,0,0.00%,6,6,0.00%
ns-1101.awsdns-09.org,0,0.00%,2,2,0.00%
dns1.maxion.co.kr,0,0.00%,2,2,0.00%
ns-1696.awsdns-20.co.uk,0,0.00%,2,2,0.00%
ns-481.awsdns-60.com,0,0.00%,2,2,0.00%
ns-669.awsdns-19.net,0,0.00%,2,2,0.00%
dns2.maxion.co.kr,0,0.00%,2,2,0.00%
elmo.ns.cloudflare.com,0,0.00%,4,4,0.00%
ns2.netafraz.com,0,0.00%,4,4,0.00%
dns2.hostiq.ua,0,0.00%,4,4,0.00%
ns.netafraz.com,0,0.00%,4,4,0.00%
ns2.assigned.network,0,0.00%,2,2,0.00%
ns2.serveriai.lt,0,0.00%,4,4,0.00%
ns3.serveriai.lt,0,0.00%,4,4,0.00%
ns1.serveriai.lt,0,0.00%,4,4,0.00%
ns4.serveriai.lt,0,0.00%,4,4,0.00%
luciane.ns.cloudflare.com,0,0.00%,2,2,0.00%
ns1.ubizhost.kr,0,0.00%,2,2,0.00%
ns-1165.awsdns-17.org,0,0.00%,2,2,0.00%
ns2.create.com,0,0.00%,2,2,0.00%
ns-416.awsdns-52.com,0,0.00%,2,2,0.00%
ns1.create.com,0,0.00%,2,2,0.00%
ns-802.awsdns-36.net,0,0.00%,2,2,0.00%
lynn.ns.cloudflare.com,0,0.00%,4,4,0.00%
asarcikhaber.com,0,0.00%,2,2,0.00%
ns2-mut.hosting-mexico.net,0,0.00%,2,2,0.00%
thedomaindirectory.mars.orderbox-dns.com,0,0.00%,2,2,0.00%
thedomaindirectory.earth.orderbox-dns.com,0,0.00%,2,2,0.00%
thedomaindirectory.venus.orderbox-dns.com,0,0.00%,2,2,0.00%
thedomaindirectory.mercury.orderbox-dns.com,0,0.00%,2,2,0.00%
heidi.ns.cloudflare.com,0,0.00%,2,2,0.00%
kianchau.ns.cloudflare.com,0,0.00%,4,4,0.00%
ns1.nameself.com,0,0.00%,2,2,0.00%
jermaine.ns.cloudflare.com,0,0.00%,2,2,0.00%
c.17986.net,0,0.00%,2,2,0.00%
cs33.hostingberry.com,0,0.00%,2,2,0.00%
ns1.bidasoamm.com,0,0.00%,2,2,0.00%
cs33.hostneverdie.com,0,0.00%,2,2,0.00%
ns1.ftcyazilim.com.tr,0,0.00%,2,2,0.00%
ns1075.ui-dns.de,0,0.00%,4,4,0.00%
ns1.kolaywebsite.net,0,0.00%,2,2,0.00%
gaomiaoba.com,0,0.00%,2,2,0.00%
ns2.dunford-hittorf.com,0,0.00%,2,2,0.00%
ns1104.ui-dns.org,0,0.00%,2,2,0.00%
ns1.dunford-hittorf.com,0,0.00%,2,2,0.00%
ns2.bidasoamm.com,0,0.00%,2,2,0.00%
NS2.YACHAY.PE,0,0.00%,2,2,0.00%
ns2.kolaywebsite.net,0,0.00%,2,2,0.00%
NS1.YACHAY.PE,0,0.00%,2,2,0.00%
ns2.ftcyazilim.com.tr,0,0.00%,2,2,0.00%
ns1.hannaorder.com,0,0.00%,2,2,0.00%
ns2.hannaorder.com,0,0.00%,2,2,0.00%
kay.ns.cloudflare.com,0,0.00%,6,6,0.00%
ns127.hostgator.com.br,0,0.00%,2,2,0.00%
ns1.bittersweetlesson.com,0,0.00%,2,2,0.00%
ns126.hostgator.com.br,0,0.00%,2,2,0.00%
ns1.liquidtelecom.net,0,0.00%,2,2,0.00%
ns2.bittersweetlesson.com,0,0.00%,2,2,0.00%
partnermarketingservices.com,0,0.00%,2,2,0.00%
ns2.liquidtelecom.net,0,0.00%,2,2,0.00%
ns2.fsdatans.net,0,0.00%,2,2,0.00%
ns1.fsdatans.net,0,0.00%,2,2,0.00%
powerofnone.com,0,0.00%,2,2,0.00%
ns733.hostgator.com,0,0.00%,2,2,0.00%
merlin.ns.cloudflare.com,0,0.00%,2,2,0.00%
ns.abdns.info,0,0.00%,2,2,0.00%
paityn.ns.cloudflare.com,0,0.00%,2,2,0.00%
ns1.pixelturk.com,0,0.00%,2,2,0.00%
ns1.eu11.tmd.cloud,0,0.00%,2,2,0.00%
paris.ns.cloudflare.com,0,0.00%,4,4,0.00%
vern.ns.cloudflare.com,0,0.00%,2,2,0.00%
ns2.eu11.tmd.cloud,0,0.00%,2,2,0.00%
mckinley.ns.cloudflare.com,0,0.00%,2,2,0.00%
ns2.pixelturk.com,0,0.00%,2,2,0.00%
ns-1451.awsdns-53.org,0,0.00%,2,2,0.00%
ns-1642.awsdns-13.co.uk,0,0.00%,2,2,0.00%
ns12.servicio-online.net,0,0.00%,8,8,0.00%
ns1055.ui-dns.org,0,0.00%,4,4,0.00%
ns-694.awsdns-22.net,0,0.00%,2,2,0.00%
ns1036.ui-dns.biz,0,0.00%,2,2,0.00%
ns11.servicio-online.net,0,0.00%,8,8,0.00%
kami.ns.cloudflare.com,0,0.00%,2,2,0.00%
arushi.ns.cloudflare.com,0,0.00%,2,2,0.00%
ns10.servicio-online.net,0,0.00%,8,8,0.00%
ns2.gridhost.com,0,0.00%,2,2,0.00%
ns1.gridhost.com,0,0.00%,2,2,0.00%
lia.ns.cloudflare.com,0,0.00%,4,4,0.00%
ns585.hostgator.com.br,0,0.00%,2,2,0.00%
ns1.melbourneit.net,0,0.00%,2,2,0.00%
dns1.completeweb.net,0,0.00%,2,2,0.00%
t.ns.arvancdn.com,0,0.00%,2,2,0.00%
braden.ns.cloudflare.com,0,0.00%,2,2,0.00%
ns1.linode.com,0,0.00%,6,6,0.00%
ns4.linode.com,0,0.00%,6,6,0.00%
ns-1198.awsdns-21.org,0,0.00%,2,2,0.00%
ns1083.ui-dns.de,0,0.00%,2,2,0.00%
ns1.md-100.webhostbox.net,0,0.00%,2,2,0.00%
atlanticshoresrealtyinc.com,0,0.00%,2,2,0.00%
ns-1826.awsdns-36.co.uk,0,0.00%,2,2,0.00%
ns1.intermesh.net,0,0.00%,2,2,0.00%
ns1094.ui-dns.com,0,0.00%,2,2,0.00%
pretzels.dnspod.net,0,0.00%,8,8,0.00%
ns-278.awsdns-34.com,0,0.00%,2,2,0.00%
ns1093.ui-dns.org,0,0.00%,4,4,0.00%
ns-903.awsdns-48.net,0,0.00%,2,2,0.00%
dns2.planetahosting.pe,0,0.00%,2,2,0.00%
ns1050.ui-dns.com,0,0.00%,4,4,0.00%
ns4249.hostgator.com,0,0.00%,2,2,0.00%
dns5.cloudoon.com,0,0.00%,2,2,0.00%
atvcrat.com,0,0.00%,2,2,0.00%
ns1017.ui-dns.org,0,0.00%,4,4,0.00%
ns2.intermesh.net,0,0.00%,2,2,0.00%
amos.ns.cloudflare.com,0,0.00%,2,2,0.00%
dns1.planetahosting.pe,0,0.00%,2,2,0.00%
ns-1282.awsdns-32.org,0,0.00%,2,2,0.00%
ns2.email-soft.me,0,0.00%,2,2,0.00%
tegan.ns.cloudflare.com,0,0.00%,2,2,0.00%
dns2.interdominios.com,0,0.00%,4,4,0.00%
jonah.ns.cloudflare.com,0,0.00%,2,2,0.00%
ns2.speedydns.net,0,0.00%,4,4,0.00%
dns1.hostgator.in,0,0.00%,2,2,0.00%
ns1.speedydns.net,0,0.00%,4,4,0.00%
ns1.atomedya.com,0,0.00%,2,2,0.00%
ns1.c07.tmdcloud.eu,0,0.00%,2,2,0.00%
ns2.nsitcmx.com,0,0.00%,2,2,0.00%
dns3.hostgator.in,0,0.00%,2,2,0.00%
dns2.hostgator.in,0,0.00%,2,2,0.00%
ns2.registrant-verification.ispapi.net,0,0.00%,2,2,0.00%
dns169.a.register.com,0,0.00%,2,2,0.00%
ashce5nga7.com,0,0.00%,2,2,0.00%
ns12.cunhost.cc,0,0.00%,2,2,0.00%
dns4.hostgator.in,0,0.00%,2,2,0.00%
ns1.selfhost.co.in,0,0.00%,2,2,0.00%
docks17.rzone.de,0,0.00%,2,2,0.00%
joaquin.ns.cloudflare.com,0,0.00%,4,4,0.00%
ns4.awesomesites.org,0,0.00%,2,2,0.00%
ns1667.websitewelcome.com,0,0.00%,2,2,0.00%
ns1.ashleyhargreeves.com,0,0.00%,2,2,0.00%
ns1.sermayesizeticaret.com,0,0.00%,4,4,0.00%
ns-1202.awsdns-22.org,0,0.00%,2,2,0.00%
ns3.awesomesites.org,0,0.00%,2,2,0.00%
ns1668.websitewelcome.com,0,0.00%,2,2,0.00%
ns-123.awsdns-15.com,0,0.00%,2,2,0.00%
ns2.selfhost.co.in,0,0.00%,2,2,0.00%
ns2.atomedya.com,0,0.00%,2,2,0.00%
ns4.thehost.com.ua,0,0.00%,2,2,0.00%
summer.ns.cloudflare.com,0,0.00%,2,2,0.00%
ns1.asifaspac.com,0,0.00%,2,2,0.00%
ns328.mihanwebhost.com,0,0.00%,2,2,0.00%
molly.ns.cloudflare.com,0,0.00%,2,2,0.00%
ns1.ov2.com,0,0.00%,2,2,0.00%
ns2.ashleyhargreeves.com,0,0.00%,2,2,0.00%
ns2.sermayesizeticaret.com,0,0.00%,4,4,0.00%
ns2.onleehost.com,0,0.00%,2,2,0.00%
m.ns.arvancdn.com,0,0.00%,2,2,0.00%
ns2.dnspark.be,0,0.00%,2,2,0.00%
yasm1.7hostir.com,0,0.00%,2,2,0.00%
hans.ns.cloudflare.com,0,0.00%,2,2,0.00%
yasm2.7hostir.com,0,0.00%,2,2,0.00%
ingrid.ns.cloudflare.com,0,0.00%,6,6,0.00%
ns2.tebixa.co.in,0,0.00%,2,2,0.00%
attorneyzacharytaylor.com,0,0.00%,2,2,0.00%
nikon.ns.cloudflare.com,0,0.00%,2,2,0.00%
ns1.1usd.net,0,0.00%,2,2,0.00%
brahma.thirdeye.it,0,0.00%,2,2,0.00%
36.push2his.eastmoney.com,0,0.00%,2,2,0.00%
ns1.tebixa.co.in,0,0.00%,2,2,0.00%
asiadiamondexc.com,0,0.00%,2,2,0.00%
ns1.onleehost.com,0,0.00%,2,2,0.00%
ns2.thirdeye.it,0,0.00%,2,2,0.00%
usama.genious.net,0,0.00%,2,2,0.00%
nsw1.cloudtechtiq.in,0,0.00%,2,2,0.00%
nsw2.cloudtechtiq.in,0,0.00%,2,2,0.00%
ns1.whm.fr-par.scw.cloud,0,0.00%,4,4,0.00%
ns1.email-soft.me,0,0.00%,2,2,0.00%
ns1104.hostgator.com.br,0,0.00%,2,2,0.00%
ns2.1usd.net,0,0.00%,2,2,0.00%
ns3.getspace.us,0,0.00%,4,4,0.00%
ns1.md-in-61.webhostbox.net,0,0.00%,4,4,0.00%
ns2.scripterhost.com,0,0.00%,2,2,0.00%
ns2.md-in-61.webhostbox.net,0,0.00%,4,4,0.00%
ns2.whm.fr-par.scw.cloud,0,0.00%,4,4,0.00%
ns1092.ui-dns.de,0,0.00%,2,2,0.00%
ns1.scripterhost.com,0,0.00%,2,2,0.00%
tony.ns.cloudflare.com,0,0.00%,2,2,0.00%
24.push2his.eastmoney.com,0,0.00%,2,2,0.00%
ns1069.ui-dns.com,0,0.00%,2,2,0.00%
cora.ns.cloudflare.com,0,0.00%,2,2,0.00%
ns2.namecity.com,0,0.00%,2,2,0.00%
dns2.site5.com,0,0.00%,2,2,0.00%
dns.site5.com,0,0.00%,2,2,0.00%
bill.ns.cloudflare.com,0,0.00%,2,2,0.00%
shallow.dnspod.net,0,0.00%,6,6,0.00%
lyra.dnspod.net,0,0.00%,6,6,0.00%
fridge.dnspod.net,0,0.00%,2,2,0.00%
ns1.rumahosting.com,0,0.00%,2,2,0.00%
davina.ns.cloudflare.com,0,0.00%,2,2,0.00%
ximena.ns.cloudflare.com,0,0.00%,6,6,0.00%
98.push2his.eastmoney.com,0,0.00%,2,2,0.00%
11.push2his.eastmoney.com,0,0.00%,4,4,0.00%
ns-285.awsdns-35.com,0,0.00%,2,2,0.00%
97.push2his.eastmoney.com,0,0.00%,4,4,0.00%
ns3.ourklient.com,0,0.00%,2,2,0.00%
yacht.dnspod.net,0,0.00%,2,2,0.00%
ns10.ewallhost.com,0,0.00%,2,2,0.00%
ns2.rumahosting.com,0,0.00%,2,2,0.00%
ns13.ewallhost.com,0,0.00%,2,2,0.00%
ns2.antistressskvish.com,0,0.00%,2,2,0.00%
ns1.wobiz.com,0,0.00%,2,2,0.00%
ns12.ewallhost.com,0,0.00%,2,2,0.00%
verification-wzyrzys9.ns3.dan.hosting,0,0.00%,2,2,0.00%
r4-ns3.nshostsite.com,0,0.00%,2,2,0.00%
71.push2his.eastmoney.com,0,0.00%,2,2,0.00%
46.push2his.eastmoney.com,0,0.00%,2,2,0.00%
ns3.limonhost.cloud,0,0.00%,2,2,0.00%
artistshmartist.com,0,0.00%,2,2,0.00%
ns1.server.plus,0,0.00%,4,4,0.00%
ns3.server.plus,0,0.00%,4,4,0.00%
appinappafrique.com,0,0.00%,2,2,0.00%
ns4.server.plus,0,0.00%,4,4,0.00%
ns4.limonhost.cloud,0,0.00%,2,2,0.00%
harlan.ns.cloudflare.com,0,0.00%,2,2,0.00%
ns2.namedserver.net,0,0.00%,2,2,0.00%
ns1088.ui-dns.org,0,0.00%,2,2,0.00%
ns6460.hostgator.com,0,0.00%,2,2,0.00%
ns6459.hostgator.com,0,0.00%,2,2,0.00%
ns1.mytrafficmanagement.com,0,0.00%,8,8,0.00%
ns2.taplink.cc,0,0.00%,2,2,0.00%
ns2kqz.name.com,0,0.00%,2,2,0.00%
ns2.md-100.webhostbox.net,0,0.00%,2,2,0.00%
70.push2his.eastmoney.com,0,0.00%,4,4,0.00%
ns101.hostingcosmos.com,0,0.00%,2,2,0.00%
ns102.hostingcosmos.com,0,0.00%,2,2,0.00%
ns216.superhosting.bg,0,0.00%,4,4,0.00%
simon.ns.cloudflare.com,0,0.00%,4,4,0.00%
ns2.bh-14.webhostbox.net,0,0.00%,2,2,0.00%
ns1.bh-14.webhostbox.net,0,0.00%,2,2,0.00%
ns1.bdmi.net,0,0.00%,4,4,0.00%
ns215.superhosting.bg,0,0.00%,4,4,0.00%
ns2.kenceng-solusindo.web.id,0,0.00%,2,2,0.00%
aitana.ns.cloudflare.com,0,0.00%,2,2,0.00%
dns182.a.register.com,0,0.00%,2,2,0.00%
ns618.hostgator.com.br,0,0.00%,2,2,0.00%
ns1.sitesdepot.com,0,0.00%,4,4,0.00%
w.ns.arvancdn.com,0,0.00%,2,2,0.00%
archieboris.com,0,0.00%,2,2,0.00%
ns2.hoster.co.id,0,0.00%,2,2,0.00%
ns8381.hostgator.com,0,0.00%,2,2,0.00%
ans1.hostcocoa.com,0,0.00%,2,2,0.00%
ns4.hoster.co.id,0,0.00%,2,2,0.00%
ns8382.hostgator.com,0,0.00%,2,2,0.00%
ns1076.ui-dns.biz,0,0.00%,6,6,0.00%
ns02.servage.net,0,0.00%,2,2,0.00%
ans2.hostcocoa.com,0,0.00%,2,2,0.00%
ns2086.ifastnet.com,0,0.00%,2,2,0.00%
ns3.hoster.co.id,0,0.00%,2,2,0.00%
ns3.azdigi.com,0,0.00%,6,6,0.00%
ans3.hostcocoa.com,0,0.00%,2,2,0.00%
ns201.01isp.net,0,0.00%,2,2,0.00%
ns1.hoster.co.id,0,0.00%,2,2,0.00%
ans4.hostcocoa.com,0,0.00%,2,2,0.00%
arechigaeventrentals.com,0,0.00%,2,2,0.00%
ns200.01isp.com,0,0.00%,2,2,0.00%
ns2.click-servers.com,0,0.00%,2,2,0.00%
ns4.paidboom.com,0,0.00%,2,2,0.00%
ns-1482.awsdns-57.org,0,0.00%,4,4,0.00%
ns1046.ui-dns.biz,0,0.00%,6,6,0.00%
ns11.veeblehosting.com,0,0.00%,2,2,0.00%
jake.ns.cloudflare.com,0,0.00%,4,4,0.00%
ns-1743.awsdns-25.co.uk,0,0.00%,2,2,0.00%
hydra.dnspod.net,0,0.00%,4,4,0.00%
ns10.veeblehosting.com,0,0.00%,2,2,0.00%
ns-984.awsdns-59.net,0,0.00%,2,2,0.00%
nspro52.hostgator.com.br,0,0.00%,2,2,0.00%
ns1.prosystemsug.com,0,0.00%,2,2,0.00%
nspro53.hostgator.com.br,0,0.00%,2,2,0.00%
ns2.towebs.com,0,0.00%,4,4,0.00%
ns1.aridiabuenostore.com,0,0.00%,2,2,0.00%
ns1086.ui-dns.com,0,0.00%,4,4,0.00%
milan.ns.cloudflare.com,0,0.00%,4,4,0.00%
ns1cmt.name.com,0,0.00%,4,4,0.00%
ns1.ndns.cn,0,0.00%,2,2,0.00%
ns2.prosystemsug.com,0,0.00%,2,2,0.00%
anirban.ns.cloudflare.com,0,0.00%,4,4,0.00%
ns2lns.name.com,0,0.00%,2,2,0.00%
ns-1044.awsdns-02.org,0,0.00%,2,2,0.00%
ns2.point2point-01.com,0,0.00%,2,2,0.00%
ns2.ndns.cn,0,0.00%,2,2,0.00%
ns3.towebs.com,0,0.00%,4,4,0.00%
ns3dty.name.com,0,0.00%,4,4,0.00%
etta.ns.cloudflare.com,0,0.00%,10,10,0.00%
ns2.aridiabuenostore.com,0,0.00%,2,2,0.00%
ns-1679.awsdns-17.co.uk,0,0.00%,2,2,0.00%
ns2.ns0.hu,0,0.00%,2,2,0.00%
ns-151-b.gandi.net,0,0.00%,2,2,0.00%
ns-393.awsdns-49.com,0,0.00%,2,2,0.00%
ns649.hostgator.com.br,0,0.00%,2,2,0.00%
ns619.hostgator.com.br,0,0.00%,2,2,0.00%
ns4.towebs.com,0,0.00%,4,4,0.00%
ns187.mihanwebhost.com,0,0.00%,2,2,0.00%
ns-187-a.gandi.net,0,0.00%,2,2,0.00%
alynefavoretti.com,0,0.00%,2,2,0.00%
ns-797.awsdns-35.net,0,0.00%,2,2,0.00%
ns648.hostgator.com.br,0,0.00%,2,2,0.00%
o.ns.arvancdn.net,0,0.00%,2,2,0.00%
ns6227.hostgator.com,0,0.00%,2,2,0.00%
cullen.ns.cloudflare.com,0,0.00%,2,2,0.00%
y.ns.arvancdn.com,0,0.00%,2,2,0.00%
ns2.jp1.fcomet.com,0,0.00%,2,2,0.00%
ns04.servage.net,0,0.00%,2,2,0.00%
ns1.towebs.com,0,0.00%,4,4,0.00%
ns1.syd5.hostingplatform.net.au,0,0.00%,2,2,0.00%
ns386.mihanwebhost.com,0,0.00%,2,2,0.00%
appafriq.com,0,0.00%,2,2,0.00%
ns188.mihanwebhost.com,0,0.00%,2,2,0.00%
ns1.jp1.fcomet.com,0,0.00%,2,2,0.00%
ns2fjz.name.com,0,0.00%,4,4,0.00%
ns-126-c.gandi.net,0,0.00%,2,2,0.00%
ns4fmx.name.com,0,0.00%,8,8,0.00%
ns7.musteridestek.net,0,0.00%,6,6,0.00%
ns1.temizisim.com,0,0.00%,2,2,0.00%
ns5.awardspace.com,0,0.00%,2,2,0.00%
ns385.mihanwebhost.com,0,0.00%,2,2,0.00%
ns14.midphase.com,0,0.00%,4,4,0.00%
ns6.awardspace.com,0,0.00%,2,2,0.00%
ns54.d9hosting.com,0,0.00%,2,2,0.00%
ns2.md-in-32.webhostbox.net,0,0.00%,2,2,0.00%
bryce.ns.cloudflare.com,0,0.00%,2,2,0.00%
blr1.fivecron.com,0,0.00%,2,2,0.00%
ns-1742.awsdns-25.co.uk,0,0.00%,2,2,0.00%
adns.cs.siteprotect.com,0,0.00%,2,2,0.00%
soren1.irandns.com,0,0.00%,2,2,0.00%
ns1.tx15.fcomet.com,0,0.00%,2,2,0.00%
ns1.webhouse.sk,0,0.00%,2,2,0.00%
ns1067.ui-dns.biz,0,0.00%,4,4,0.00%
ns1038.ui-dns.com,0,0.00%,4,4,0.00%
integratedserenity.net,0,0.00%,2,2,0.00%
ns2.tx15.fcomet.com,0,0.00%,2,2,0.00%
soren2.irandns.com,0,0.00%,2,2,0.00%
dns1.ileriyazilim.com,0,0.00%,2,2,0.00%
minisite.alibaba.com,0,0.00%,2,2,0.00%
ns-1465.awsdns-55.org,0,0.00%,2,2,0.00%
sand.dnspod.net,0,0.00%,2,2,0.00%
ns3.host4fans.net,0,0.00%,2,2,0.00%
ns-1726.awsdns-23.co.uk,0,0.00%,2,2,0.00%
ns1106.ui-dns.biz,0,0.00%,2,2,0.00%
dns2.namesecure.com,0,0.00%,2,2,0.00%
fir.dnspod.net,0,0.00%,2,2,0.00%
ns2.webhouse.sk,0,0.00%,2,2,0.00%
ns1.cowcart.net,0,0.00%,4,4,0.00%
dns1.namesecure.com,0,0.00%,2,2,0.00%
brit.ns.cloudflare.com,0,0.00%,4,4,0.00%
ns2.easyname.eu,0,0.00%,2,2,0.00%
ns-786.awsdns-34.net,0,0.00%,2,2,0.00%
shades08.rzone.de,0,0.00%,4,4,0.00%
kinsley.ns.cloudflare.com,0,0.00%,2,2,0.00%
ns-1097.awsdns-09.org,0,0.00%,2,2,0.00%
ns1.odedi94715.mywhc.ca,0,0.00%,2,2,0.00%
ns52.dnsowner.com,0,0.00%,2,2,0.00%
mustafa.ns.cloudflare.com,0,0.00%,2,2,0.00%
ns-1128.awsdns-13.org,0,0.00%,2,2,0.00%
itsnuqtah.net,0,0.00%,2,2,0.00%
agatha.dnspod.net,0,0.00%,2,2,0.00%
felix.dnspod.net,0,0.00%,2,2,0.00%
ns4787.banahosting.com,0,0.00%,2,2,0.00%
dns122.a.register.com,0,0.00%,2,2,0.00%
c.ns14.net,0,0.00%,2,2,0.00%
ns-90.awsdns-11.com,0,0.00%,2,2,0.00%
b.ns14.net,0,0.00%,2,2,0.00%
lutongxue.net,0,0.00%,2,2,0.00%
a.ns14.net,0,0.00%,2,2,0.00%
elisabeth.ns.cloudflare.com,0,0.00%,6,6,0.00%
ns1101.ui-dns.de,0,0.00%,4,4,0.00%
ns2.host4fans.net,0,0.00%,2,2,0.00%
mercury-shared.dzsecurity.net,0,0.00%,2,2,0.00%
ns4.host4fans.net,0,0.00%,2,2,0.00%
minisite.alibaba.com.gds.alibabadns.com,0,0.00%,2,2,0.00%
fx-china.net,0,0.00%,2,2,0.00%
ns4014.hostgator.com,0,0.00%,2,2,0.00%
dns1.shop-pro.jp,0,0.00%,2,2,0.00%
ns4013.hostgator.com,0,0.00%,2,2,0.00%
ns2.game-gate.net,0,0.00%,1,1,0.00%
dns2.shop-pro.jp,0,0.00%,2,2,0.00%
ns1.regtr.com,0,0.00%,2,2,0.00%
ns2.altervista.com,0,0.00%,2,2,0.00%
ns1.host4fans.net,0,0.00%,2,2,0.00%
fiona.ns.cloudflare.com,0,0.00%,6,6,0.00%
ns-360.awsdns-45.com,0,0.00%,2,2,0.00%
redbusprimarydns.gameengineers.net,0,0.00%,2,2,0.00%
dns068.a.register.com,0,0.00%,2,2,0.00%
ns1.game-gate.net,0,0.00%,1,1,0.00%
governmentdao.net,0,0.00%,2,2,0.00%
ns-2019.awsdns-60.co.uk,0,0.00%,2,2,0.00%
dns030.a.register.com,0,0.00%,2,2,0.00%
ns2.c04.tmdcloud.eu,0,0.00%,2,2,0.00%
ns1.c04.tmdcloud.eu,0,0.00%,2,2,0.00%
ns9081.banahosting.com,0,0.00%,2,2,0.00%
ns9082.banahosting.com,0,0.00%,2,2,0.00%
ns-ay4p8faygd.dnswnd.eu,0,0.00%,2,2,0.00%
demi.ns.cloudflare.com,0,0.00%,6,6,0.00%
redbussecondarydns.gameengineers.net,0,0.00%,2,2,0.00%
ns34.guzelhosting.com,0,0.00%,2,2,0.00%
ns2.usa.cloudns.io,0,0.00%,2,2,0.00%
ns1020.ui-dns.org,0,0.00%,2,2,0.00%
ns-juxtljjufd.dnswnd.be,0,0.00%,2,2,0.00%
verification-c3ccc9c1.ns3.dan.hosting,0,0.00%,2,2,0.00%
ns1.usa.cloudns.io,0,0.00%,2,2,0.00%
ns1032.ui-dns.biz,0,0.00%,2,2,0.00%
ns1.cyon.ch,0,0.00%,2,2,0.00%
ns2.cowcart.net,0,0.00%,4,4,0.00%
honeyglam.net,0,0.00%,2,2,0.00%
snn36kj.s366cne.com,0,0.00%,2,2,0.00%
marissa.ns.cloudflare.com,0,0.00%,28,28,0.00%
jule.ns.cloudflare.com,0,0.00%,6,6,0.00%
ns31.guzelhosting.com,0,0.00%,2,2,0.00%
ns11.lwsdns.com,0,0.00%,2,2,0.00%
ns1.stablehost.com,0,0.00%,2,2,0.00%
redbusprimarydns.howdoesgravitywork.net,0,0.00%,2,2,0.00%
ns2.stablehost.com,0,0.00%,2,2,0.00%
snt46kj.s366cne.com,0,0.00%,2,2,0.00%
snm16kj.s366cne.com,0,0.00%,2,2,0.00%
ns1.dogadakiler.com,0,0.00%,2,2,0.00%
ns2.dogadakiler.com,0,0.00%,2,2,0.00%
ns2.ivyro.net,0,0.00%,2,2,0.00%
ns1.ansdizayn.com,0,0.00%,2,2,0.00%
ns3.ivyro.net,0,0.00%,2,2,0.00%
ns1.ivyro.net,0,0.00%,2,2,0.00%
dns207.a.register.com,0,0.00%,2,2,0.00%
ns2.titan.gofasthost.com,0,0.00%,2,2,0.00%
redbussecondarydns.howdoesgravitywork.net,0,0.00%,2,2,0.00%
ns-1160.awsdns-17.org,0,0.00%,2,2,0.00%
ns-162.awsdns-20.com,0,0.00%,2,2,0.00%
ns1.ojenik.com,0,0.00%,2,2,0.00%
ns-1938.awsdns-50.co.uk,0,0.00%,2,2,0.00%
ns-661.awsdns-18.net,0,0.00%,2,2,0.00%
damian.ns.cloudflare.com,0,0.00%,2,2,0.00%
ns1.dna-wellness.net,0,0.00%,2,2,0.00%
ns54.hostgator.mx,0,0.00%,2,2,0.00%
redbusprimarydns.creditratingagencies.net,0,0.00%,2,2,0.00%
ns2.dna-wellness.net,0,0.00%,2,2,0.00%
ns-115-c.gandi.net,0,0.00%,2,2,0.00%
champiearns.net,0,0.00%,2,2,0.00%
ns-1346.awsdns-40.org,0,0.00%,2,2,0.00%
ns1.no-ip.com,0,0.00%,2,2,0.00%
ns-1540.awsdns-00.co.uk,0,0.00%,2,2,0.00%
dns204.a.register.com,0,0.00%,2,2,0.00%
ns1016.ui-dns.de,0,0.00%,4,4,0.00%
tr2.sunucualdns.com,0,0.00%,2,2,0.00%
ns-309.awsdns-38.com,0,0.00%,2,2,0.00%
ns3.no-ip.com,0,0.00%,2,2,0.00%
dns246.a.register.com,0,0.00%,2,2,0.00%
ns4.no-ip.com,0,0.00%,2,2,0.00%
ns-948.awsdns-54.net,0,0.00%,2,2,0.00%
em4.site-dns.com,0,0.00%,2,2,0.00%
ns2.no-ip.com,0,0.00%,2,2,0.00%
ns2.odedi94715.mywhc.ca,0,0.00%,2,2,0.00%
ns1058.ui-dns.org,0,0.00%,2,2,0.00%
ns4.verigom.com,0,0.00%,2,2,0.00%
tr1.sunucualdns.com,0,0.00%,2,2,0.00%
ophelia.ns.cloudflare.com,0,0.00%,2,2,0.00%
frank.ns.cloudflare.com,0,0.00%,4,4,0.00%
3-get.njalla.fo,0,0.00%,2,2,0.00%
cloudyslime.net,0,0.00%,2,2,0.00%
ns3.verigom.com,0,0.00%,2,2,0.00%
ns1111.ui-dns.com,0,0.00%,2,2,0.00%
ns5.no-ip.com,0,0.00%,2,2,0.00%
nspro38.hostgator.mx,0,0.00%,2,2,0.00%
1-you.njalla.no,0,0.00%,2,2,0.00%
2-can.njalla.in,0,0.00%,2,2,0.00%
ns7.brownservers.xyz,0,0.00%,2,2,0.00%
dom.ns.cloudflare.com,0,0.00%,4,4,0.00%
em3.site-dns.com,0,0.00%,2,2,0.00%
sns404.bigrock.com,0,0.00%,2,2,0.00%
ns1081.ui-dns.biz,0,0.00%,2,2,0.00%
em1.site-dns.com,0,0.00%,2,2,0.00%
ns3.mvmnet.it,0,0.00%,2,2,0.00%
sns403.bigrock.com,0,0.00%,2,2,0.00%
elmadrono.net,0,0.00%,2,2,0.00%
ns2.myhostingbank.com,0,0.00%,2,2,0.00%
ns-61-b.gandi.net,0,0.00%,2,2,0.00%
ns1.netzone.ch,0,0.00%,2,2,0.00%
ns2.mvmnet.com,0,0.00%,2,2,0.00%
ns-93-c.gandi.net,0,0.00%,2,2,0.00%
ns-143-c.gandi.net,0,0.00%,2,2,0.00%
ns1.dnsbycomodo.net,0,0.00%,2,2,0.00%
ns46.doveserver.com,0,0.00%,2,2,0.00%
ns1.myhostingbank.com,0,0.00%,2,2,0.00%
ns-91-a.gandi.net,0,0.00%,2,2,0.00%
ns1071.ui-dns.biz,0,0.00%,2,2,0.00%
maya.ns.cloudflare.com,0,0.00%,2,2,0.00%
ns2.dnsbycomodo.net,0,0.00%,2,2,0.00%
patrick.ns.cloudflare.com,0,0.00%,2,2,0.00%
ns2.netzone.ch,0,0.00%,2,2,0.00%
ns4.mvmnet-dns.eu,0,0.00%,2,2,0.00%
rns37.webhostbox.net,0,0.00%,2,2,0.00%
ns1085.ui-dns.de,0,0.00%,2,2,0.00%
ns1.snowsidehosting.com,0,0.00%,2,2,0.00%
ns-197-b.gandi.net,0,0.00%,2,2,0.00%
ns1.mvmnet.com,0,0.00%,2,2,0.00%
rns38.webhostbox.net,0,0.00%,2,2,0.00%
ns1054.ui-dns.com,0,0.00%,2,2,0.00%
ns2-08.azure-dns.net,0,0.00%,2,2,0.00%
ns2fgp.name.com,0,0.00%,2,2,0.00%
ns45.doveserver.com,0,0.00%,2,2,0.00%
ns2.ezydomain.com,0,0.00%,2,2,0.00%
ns3-08.azure-dns.org,0,0.00%,2,2,0.00%
ns2.crystalwebhosting.com,0,0.00%,2,2,0.00%
ns1091.ui-dns.de,0,0.00%,2,2,0.00%
ns4-08.azure-dns.info,0,0.00%,2,2,0.00%
phx02pap002.storage.live.com,0,0.00%,2,2,0.00%
ns2.handyhost.ru,0,0.00%,2,2,0.00%
ns3.netzone.ch,0,0.00%,2,2,0.00%
ns4786.banahosting.com,0,0.00%,2,2,0.00%
ns-1956.awsdns-52.co.uk,0,0.00%,2,2,0.00%
clarissa.ns.cloudflare.com,0,0.00%,4,4,0.00%
coen.ns.cloudflare.com,0,0.00%,2,2,0.00%
redbussecondarydns.creditratingagencies.net,0,0.00%,2,2,0.00%
ns-45-a.gandi.net,0,0.00%,2,2,0.00%
doma168020.mars.orderbox-dns.com,0,0.00%,2,2,0.00%
ns-1366.awsdns-42.org,0,0.00%,2,2,0.00%
sky.ns.cloudflare.com,0,0.00%,4,4,0.00%
ns-487.awsdns-60.com,0,0.00%,2,2,0.00%
ns1087.ui-dns.com,0,0.00%,2,2,0.00%
ns15.midphase.com,0,0.00%,4,4,0.00%
ferasmaddah.net,0,0.00%,2,2,0.00%
ns1.handyhost.ru,0,0.00%,2,2,0.00%
ns16.midphase.com,0,0.00%,4,4,0.00%
ns-9-c.gandi.net,0,0.00%,2,2,0.00%
ns1.gvodns.com,0,0.00%,2,2,0.00%
ns1085.ui-dns.org,0,0.00%,2,2,0.00%
ns1106.ui-dns.de,0,0.00%,2,2,0.00%
ns-234-b.gandi.net,0,0.00%,2,2,0.00%
ns1071.ui-dns.com,0,0.00%,2,2,0.00%
foobarley.net,0,0.00%,2,2,0.00%
dakota.ns.cloudflare.com,0,0.00%,6,6,0.00%
ns3.powerdns.de,0,0.00%,2,2,0.00%
ns1.appliednetwork1.com,0,0.00%,2,2,0.00%
cloudwebx-dns2.newtekwebhosting.com,0,0.00%,2,2,0.00%
95.push2his.eastmoney.com,0,0.00%,2,2,0.00%
63.push2his.eastmoney.com,0,0.00%,6,6,0.00%
76.push2his.eastmoney.com,0,0.00%,2,2,0.00%
wuhuxiaodai.com,0,0.00%,2,2,0.00%
kfduocai.com,0,0.00%,2,2,0.00%
lipinhsw.com,0,0.00%,2,2,0.00%
wyzxcx.com,0,0.00%,2,2,0.00%
karina.ns.cloudflare.com,0,0.00%,4,4,0.00%
szjhlc666.com,0,0.00%,2,2,0.00%
tzwqzs.com,0,0.00%,2,2,0.00%
kav2.7hostir.com,0,0.00%,2,2,0.00%
05c3b39.pc.gladns.com,0,0.00%,2,2,0.00%
niudiaowang.com,0,0.00%,2,2,0.00%
laura.dnspod.net,0,0.00%,2,2,0.00%
kav1.7hostir.com,0,0.00%,2,2,0.00%
ns1025.ui-dns.biz,0,0.00%,4,4,0.00%
frida.ns.cloudflare.com,0,0.00%,2,2,0.00%
ns1084.ui-dns.de,0,0.00%,4,4,0.00%
ns2.winhost.com,0,0.00%,2,2,0.00%
ns1.winhost.com,0,0.00%,2,2,0.00%
ns4.megabytesserver.com,0,0.00%,2,2,0.00%
ns4.panelboxmanager.com,0,0.00%,10,10,0.00%
ns3.winhost.com,0,0.00%,2,2,0.00%
ns1.syd2.hostingplatform.net.au,0,0.00%,2,2,0.00%
ns10.hostmar.com,0,0.00%,2,2,0.00%
szsxzn.com,0,0.00%,2,2,0.00%
njwaiwei.com,0,0.00%,2,2,0.00%
qianruimjg.com,0,0.00%,2,2,0.00%
zjkyz88.com,0,0.00%,2,2,0.00%
njjncm.com,0,0.00%,2,2,0.00%
jiangsujunxun.com,0,0.00%,2,2,0.00%
xptyqc.com,0,0.00%,2,2,0.00%
ns105.ovh.net,0,0.00%,14,14,0.00%
suyinguitar.com,0,0.00%,2,2,0.00%
shundayoule.com,0,0.00%,2,2,0.00%
ns4.ardetamedia.com,0,0.00%,2,2,0.00%
future-better.com,0,0.00%,2,2,0.00%
ns1.ardetamedia.com,0,0.00%,2,2,0.00%
mzlcglxs.com,0,0.00%,2,2,0.00%
hongtewj.com,0,0.00%,2,2,0.00%
ns3.ardetamedia.com,0,0.00%,2,2,0.00%
yfyuhang.com,0,0.00%,2,2,0.00%
nwzyk.com,0,0.00%,2,2,0.00%
nadia.ns.cloudflare.com,0,0.00%,4,4,0.00%
rel1.maralhost.com,0,0.00%,2,2,0.00%
ncomment.kuwo.cn,0,0.00%,2,2,0.00%
xhgongzuoshi.com,0,0.00%,2,2,0.00%
iwgh163.com,0,0.00%,2,2,0.00%
ns3.webhostingireland.ie,0,0.00%,4,4,0.00%
cymyzp.com,0,0.00%,2,2,0.00%
ns2.suempresa.com,0,0.00%,2,2,0.00%
curiosidadesdeluniverso.com,0,0.00%,2,2,0.00%
yykkhotel.com,0,0.00%,2,2,0.00%
ghjc888.com,0,0.00%,2,2,0.00%
ns2.syd2.hostingplatform.net.au,0,0.00%,2,2,0.00%
guankangnuo.com,0,0.00%,2,2,0.00%
agent31.juming.com,0,0.00%,4,4,0.00%
ns1.domain-imminent2.com,0,0.00%,2,2,0.00%
bjlcmc.com,0,0.00%,2,2,0.00%
ns2.domain-imminent2.com,0,0.00%,2,2,0.00%
kirk.ns.cloudflare.com,0,0.00%,2,2,0.00%
ns1093.ui-dns.biz,0,0.00%,2,2,0.00%
ns20.piensasolutions.com,0,0.00%,4,4,0.00%
cns469.hostgator.com,0,0.00%,4,4,0.00%
ns1096.ui-dns.de,0,0.00%,2,2,0.00%
cns470.hostgator.com,0,0.00%,4,4,0.00%
ns1.regzone.cz,0,0.00%,2,2,0.00%
dns2.m6.net,0,0.00%,2,2,0.00%
ns1027.ui-dns.org,0,0.00%,2,2,0.00%
ns2.md-in-47.webhostbox.net,0,0.00%,2,2,0.00%
ns1059.ui-dns.com,0,0.00%,2,2,0.00%
ns1.md-in-47.webhostbox.net,0,0.00%,2,2,0.00%
ns-1002.awsdns-61.net,0,0.00%,2,2,0.00%
dns1.m6.net,0,0.00%,2,2,0.00%
ns-1272.awsdns-31.org,0,0.00%,2,2,0.00%
ns2.interplanet.com.mx,0,0.00%,2,2,0.00%
ns1.keurigonline77.nl,0,0.00%,2,2,0.00%
ns1.regzone.de,0,0.00%,2,2,0.00%
ns1112.ui-dns.org,0,0.00%,2,2,0.00%
ns-139.awsdns-17.com,0,0.00%,2,2,0.00%
ns-150-c.gandi.net,0,0.00%,2,2,0.00%
bns2.hostcocoa.com,0,0.00%,2,2,0.00%
rocky.ns.cloudflare.com,0,0.00%,8,8,0.00%
yadabuxiugang.com,0,0.00%,2,2,0.00%
bns3.hostcocoa.com,0,0.00%,2,2,0.00%
bns4.hostcocoa.com,0,0.00%,2,2,0.00%
dns3.m6.net,0,0.00%,2,2,0.00%
ns1.regzone.info,0,0.00%,2,2,0.00%
ns3.interplanet.com.mx,0,0.00%,2,2,0.00%
ns2.keurigonline77.nl,0,0.00%,2,2,0.00%
ns1.interplanet.com.mx,0,0.00%,2,2,0.00%
ns-111-b.gandi.net,0,0.00%,2,2,0.00%
ns1.websupport.sk,0,0.00%,2,2,0.00%
ns2.megabytesserver.com,0,0.00%,2,2,0.00%
ns1.panelboxmanager.com,0,0.00%,10,10,0.00%
ns1.megabytesserver.com,0,0.00%,2,2,0.00%
jonas.dnspod.net,0,0.00%,2,2,0.00%
air0757.com,0,0.00%,2,2,0.00%
gabrielle.dnspod.net,0,0.00%,2,2,0.00%
ns2.panelboxmanager.com,0,0.00%,10,10,0.00%
ns104.ovh.net,0,0.00%,2,2,0.00%
dns104.ovh.net,0,0.00%,2,2,0.00%
rel2.maralhost.com,0,0.00%,2,2,0.00%
ns3.megabytesserver.com,0,0.00%,2,2,0.00%
ns113.inhostedns.com,0,0.00%,2,2,0.00%
ns1.rayandesign.com,0,0.00%,2,2,0.00%
ns1.suempresa.com,0,0.00%,2,2,0.00%
ns1124.ui-dns.org,0,0.00%,2,2,0.00%
ns3.suempresa.com,0,0.00%,2,2,0.00%
ns213.inhostedns.net,0,0.00%,2,2,0.00%
ns2.rayandesign.com,0,0.00%,2,2,0.00%
ns313.inhostedns.org,0,0.00%,2,2,0.00%
ns58.maxdominios.com,0,0.00%,2,2,0.00%
sdysfw.com,0,0.00%,2,2,0.00%
lnyrsy.com,0,0.00%,2,2,0.00%
cloudwebx-dns1.newtekwebhosting.com,0,0.00%,2,2,0.00%
blob.bnz10prdstr22a.store.core.windows.NET,0,0.00%,2,2,0.00%
pgy-api.oray.com,0,0.00%,6,6,0.00%
gengniucy.com,0,0.00%,2,2,0.00%
dns1.qwords.id,0,0.00%,2,2,0.00%
ns21051.ztomy.com,0,0.00%,2,2,0.00%
ns11051.ztomy.com,0,0.00%,2,2,0.00%
ip.jiangxianli.com,0,0.00%,4,4,0.00%
h3o2.me,0,0.00%,4,4,0.00%
tw05.graniterapids.com,0,0.00%,2,2,0.00%
v6-zb-alibaba-clould.tengine.alibaba.com,0,0.00%,2,2,0.00%
accwww9.53kf.com,0,0.00%,4,4,0.00%
time.tencent.com,0,0.00%,4,4,0.00%
hk05.19910501.xyz,0,0.00%,4,4,0.00%
doctor.ioa.tencent.com,0,0.00%,2,2,0.00%
tr.abir.ga,0,0.00%,2,2,0.00%
tr.torland.ga,0,0.00%,1,1,0.00%
openbittorrent.com,0,0.00%,2,2,0.00%
tr.highstar.shop,0,0.00%,2,2,0.00%
xbtrutor.com,0,0.00%,3,3,0.00%
tracker.openzim.org,0,0.00%,4,4,0.00%
odoooacnz-my.sharepoint.com,0,0.00%,5,5,0.00%
tracker.gigatorrents.ws,0,0.00%,6,6,0.00%
tracker.mywaifu.best,0,0.00%,2,2,0.00%
chihaya-heroku.120181311.xyz,0,0.00%,2,2,0.00%
www.bitseduce.com,0,0.00%,4,4,0.00%
anidex.moe,0,0.00%,2,2,0.00%
sc.icodef.com,0,0.00%,2,2,0.00%
upsnet.ksmobile.com,0,0.00%,2,2,0.00%
emirates.com,0,0.00%,2,2,0.00%
sgp11.graniterapids.com,0,0.00%,2,2,0.00%
gy.brnt.fun,0,0.00%,2,2,0.00%
demo17.tool-box.io,0,0.00%,1,1,0.00%
heraeus.safi.ai,0,0.00%,1,1,0.00%
hr15.graniterapids.com,0,0.00%,2,2,0.00%
1D.tlu.dl.delivery.mp.microsoft.com,0,0.00%,2,2,0.00%
pow7.com,0,0.00%,3,3,0.00%
tracker.gcvchp.com,0,0.00%,2,2,0.00%
tracker.theempire.bz,0,0.00%,2,2,0.00%
www.qydaili.com,0,0.00%,8,8,0.00%
tracker.nyaa.uk,0,0.00%,2,2,0.00%
open.trackerlist.xyz,0,0.00%,4,4,0.00%
torrent.ubuntu.com,0,0.00%,2,2,0.00%
pccw08.graniterapids.com,0,0.00%,2,2,0.00%
virginmobile.co,0,0.00%,2,2,0.00%
laobameishijia.github.io,0,0.00%,2,2,0.00%
laoba-1304292449.cos.ap-chengdu.myqcloud.com,0,0.00%,1,1,0.00%
cd.file.myqcloud.com,0,0.00%,2,2,0.00%
cdn.globalsigncdn.com.cdn.cloudflare.net,0,0.00%,2,2,0.00%
boxer.baidu.com,0,0.00%,2,2,0.00%
js.fundebug.cn,0,0.00%,2,2,0.00%
avoscloud.com,0,0.00%,2,2,0.00%
oedlyege.slt.sched.tdnsv8.com,0,0.00%,2,2,0.00%
busuanzi.ibruce.info,0,0.00%,4,4,0.00%
api-ucloud.leancloud.cn,0,0.00%,2,2,0.00%
zerossl.ocsp.sectigo.com,0,0.00%,2,2,0.00%
wakeup.baidu.com,0,0.00%,2,2,0.00%
ip1865110026.funshion.com,0,0.00%,4,4,0.00%
sync.search.spotxchange.com,0,0.00%,4,4,0.00%
rtb0.doubleverify.com,0,0.00%,4,4,0.00%
servedby.flashtalking.com,0,0.00%,2,2,0.00%
cdn.flashtalking.com,0,0.00%,2,2,0.00%
ebad288.f4.gladns.com,0,0.00%,2,2,0.00%
tps.doubleverify.com,0,0.00%,2,2,0.00%
web.meituan.com,0,0.00%,6,6,0.00%
inf-faas.meituan.com,0,0.00%,4,4,0.00%
m3.d.meituan.net,0,0.00%,4,4,0.00%
pdf.update.wps.cn,0,0.00%,4,4,0.00%
fmfmobile.fe.apple-dns.cn,0,0.00%,4,4,0.00%
in1-gw2-02-ce7dd027.eastus2.cloudapp.azure.com,0,0.00%,2,2,0.00%
acp-ss.adobe.io,0,0.00%,2,2,0.00%
upload-va.synacast.com,0,0.00%,2,2,0.00%
pushlog.yy.com,0,0.00%,2,2,0.00%
sdkapp.mobile.sina.cn,0,0.00%,4,4,0.00%
weather-server-gl.allawntech.com,0,0.00%,2,2,0.00%
joogh2uf.nodedata.net,0,0.00%,2,2,0.00%
octocaptcha.com,0,0.00%,2,2,0.00%
api.funcaptcha.com,0,0.00%,2,2,0.00%
activation.gfe.nvidia.com,0,0.00%,3,3,0.00%
isisn.nsfc.gov.cn,0,0.00%,4,4,0.00%
cdn.arkoselabs.com,0,0.00%,2,2,0.00%
drive-ruanjiandown-com.supergslb.com,0,0.00%,10,10,0.00%
p215-fmfmobile.icloud.com.cn,0,0.00%,2,2,0.00%
isp-map.xunyou.mobi,0,0.00%,2,2,0.00%
sklep.architekci.pl,0,0.00%,61,61,0.00%
p213-ckdatabase.icloud.com.cn,0,0.00%,2,2,0.00%
alt6-mtalk.google.com,0,0.00%,2,2,0.00%
p209-keyvalueservice.icloud.com.cn,0,0.00%,2,2,0.00%
p209-escrowproxy.icloud.com.cn,0,0.00%,2,2,0.00%
escrowproxy.fe.apple-dns.cn,0,0.00%,2,2,0.00%
p213-caldav.icloud.com.cn,0,0.00%,2,2,0.00%
mail.iscas.ac.cn,0,0.00%,2,2,0.00%
rentals.lofteystaging.info,0,0.00%,1,1,0.00%
cpro2.baidustatic.com,0,0.00%,1,1,0.00%
filerep-replica.ff.avast.com,0,0.00%,1,1,0.00%
ntc-keyid-1591d4b6eaf98d0104864b6903a48dd0026077d3.microsoftaik.azure.net,0,0.00%,1,1,0.00%
tedsyncfs.coloros.com,0,0.00%,1,1,0.00%
110-dot.teddymobile.cn,0,0.00%,2,2,0.00%
120-220-160-243.volcsiriusbd.com,0,0.00%,2,2,0.00%
aflink.edgekey.net,0,0.00%,2,2,0.00%
datasec-kmsex-cn.heytapmobi.com,0,0.00%,2,2,0.00%
tac.googleapis.com,0,0.00%,2,2,0.00%
ctftime.org,0,0.00%,2,2,0.00%
blog.bi0s.in,0,0.00%,1,1,0.00%
dougee652.blogspot.com,0,0.00%,3,3,0.00%
syedhasan010.medium.com,0,0.00%,3,3,0.00%
dfchallenge.org,0,0.00%,1,1,0.00%
svch0st.medium.com,0,0.00%,4,4,0.00%
forensicscontest.com,0,0.00%,1,1,0.00%
old.honeynet.org,0,0.00%,2,2,0.00%
sms.ads.heytapmobi.com,0,0.00%,2,2,0.00%
idp.springer.com,0,0.00%,2,2,0.00%
cacerts.digitalcertvalidation.com,0,0.00%,1,1,0.00%
vosdkauth.hpplay.cn,0,0.00%,2,2,0.00%
rps.hpplay.cn,0,0.00%,1,1,0.00%
imsg.ac.cn,0,0.00%,1,1,0.00%
bilibili.com,0,0.00%,2,2,0.00%
ns1.p27.dynect.net,0,0.00%,2,2,0.00%
www.newsmth.net,0,0.00%,3,3,0.00%
pinyin.voicecloud.cn,0,0.00%,1,1,0.00%
v3-y.douyinvod.com.w.cdngslb.com,0,0.00%,2,2,0.00%
alihealth.taobao.com,0,0.00%,2,2,0.00%
alihealth-fed-log.cn-hangzhou.log.aliyuncs.com,0,0.00%,2,2,0.00%
yixiu-js-abtest.alicdn.com,0,0.00%,2,2,0.00%
t.alicdn.com,0,0.00%,1,1,0.00%
ug.snssdk.com,0,0.00%,1,1,0.00%
m.loupan.com,0,0.00%,2,2,0.00%
power.baidu.com,0,0.00%,1,1,0.00%
iknow-base.cdn.bcebos.com,0,0.00%,1,1,0.00%
etrade-api.baidu.com,0,0.00%,1,1,0.00%
iknow-base.bj.bcebos.com,0,0.00%,1,1,0.00%
android-context-data.googleapis.com,0,0.00%,1,1,0.00%
zhaopin-c.bj.bcebos.com,0,0.00%,1,1,0.00%
www.xingdach.com,0,0.00%,1,1,0.00%
cn.gravatar.com,0,0.00%,2,2,0.00%
nantong.65650000.com,0,0.00%,1,1,0.00%
360.aireden.com,0,0.00%,1,1,0.00%
www.qtaoxiaozhu.com,0,0.00%,1,1,0.00%
hfbdf.fynews.net,0,0.00%,1,1,0.00%
www.rm1.cn,0,0.00%,2,2,0.00%
apps.bdimg.com,0,0.00%,1,1,0.00%
cdn.rm1.cn,0,0.00%,1,1,0.00%
cdn.zsci.cn,0,0.00%,1,1,0.00%
rtb.openx.net,0,0.00%,2,2,0.00%
pixel.rubiconproject.com,0,0.00%,1,1,0.00%
ssum-sec.casalemedia.com,0,0.00%,1,1,0.00%
imasdk.googleapis.com,0,0.00%,1,1,0.00%
bid.g.doubleclick.net,0,0.00%,1,1,0.00%
pixel.everesttech.net,0,0.00%,1,1,0.00%
beacon.walmart.com,0,0.00%,2,2,0.00%
r18---sn-2x3eln76.c.2mdn.net,0,0.00%,2,2,0.00%
r6---sn-2x3eln7l.c.2mdn.net,0,0.00%,1,1,0.00%
gcdn.2mdn.net,0,0.00%,1,1,0.00%
edas.info,0,0.00%,2,2,0.00%
polyfill.io,0,0.00%,2,2,0.00%
trustcom-2022.edas.info,0,0.00%,1,1,0.00%
cdn.datatables.net,0,0.00%,2,2,0.00%
www.latex-tables.com,0,0.00%,2,2,0.00%
kit.fontawesome.com,0,0.00%,1,1,0.00%
captcha.gtimg.com.sched.legopic1-dk.tdnsv6.com,0,0.00%,2,2,0.00%
sp.tinymce.com,0,0.00%,1,1,0.00%
m.stripe.network,0,0.00%,1,1,0.00%
m.stripe.com,0,0.00%,2,2,0.00%
ka-p.fontawesome.com,0,0.00%,1,1,0.00%
api.geetest.com,0,0.00%,5,5,0.00%
static.geetest.com.w.cdngslb.com,0,0.00%,2,2,0.00%
115-220-11-232.volcsiriusbd.com,0,0.00%,1,1,0.00%
m.baike.com,0,0.00%,1,1,0.00%
m.baike.com.w.cdngslb.com,0,0.00%,1,1,0.00%
lf3-baike.searchpstatp.com,0,0.00%,1,1,0.00%
ltnas-2022.cn3.quickconnect.cn,0,0.00%,1,1,0.00%
v5-coldy.douyinvod.com,0,0.00%,1,1,0.00%
cacerts.digicert.cn,0,0.00%,1,1,0.00%
v-2a384bf7.71edge.com,0,0.00%,3,3,0.00%
517ap08y.sched.d0-dk.tdnsdp1.cn,0,0.00%,1,1,0.00%
v5.douyinvod.com.zjgslb.com,0,0.00%,1,1,0.00%
picx.zhimg.com.bytexns.com,0,0.00%,1,1,0.00%
setting1.hicloud.com,0,0.00%,1,1,0.00%
upfile1.hicloud.com,0,0.00%,1,1,0.00%
o1069899.ingest.sentry.io,0,0.00%,1,1,0.00%
evo.m.taobao.com,0,0.00%,1,1,0.00%
cn-huhehaote.axt.aliyun.com,0,0.00%,3,3,0.00%
vdn.vzuu.com.w.kunlunar.com,0,0.00%,1,1,0.00%
cn-shanghai.axt.aliyun.com,0,0.00%,3,3,0.00%
styx.b.qianxin.com,0,0.00%,1,1,0.00%
www.linkedin.com,0,0.00%,1,1,0.00%
pti.store.microsoft.com,0,0.00%,1,1,0.00%
ac-dun.security.ntes53.netease.com,0,0.00%,1,1,0.00%
92c6583.cw.glados-config.net,0,0.00%,2,2,0.00%
92c6583.th.glados-config.net,0,0.00%,2,2,0.00%
92c6583.wz.glados-config.net,0,0.00%,2,2,0.00%
92c6583.td.glados-config.net,0,0.00%,2,2,0.00%
92c6583.pa.gladns.com,0,0.00%,3,3,0.00%
92c6583.nx.glados-config.net,0,0.00%,2,2,0.00%
92c6583.ph.gladns.com,0,0.00%,4,4,0.00%
92c6583.pb.gladns.com,0,0.00%,3,3,0.00%
92c6583.wx.glados-config.net,0,0.00%,2,2,0.00%
92c6583.tt.glados-config.net,0,0.00%,2,2,0.00%
92c6583.wy.glados-config.net,0,0.00%,2,2,0.00%
92c6583.pc.gladns.com,0,0.00%,3,3,0.00%
92c6583.pd.gladns.com,0,0.00%,3,3,0.00%
92c6583.pf.gladns.com,0,0.00%,4,4,0.00%
92c6583.pg.gladns.com,0,0.00%,3,3,0.00%
match.adsrvr.org,0,0.00%,4,4,0.00%
p.adsymptotic.com,0,0.00%,2,2,0.00%
idsync.rlcdn.com,0,0.00%,4,4,0.00%
skin.chrome.360.cn,0,0.00%,2,2,0.00%
ddi.shuzilm.cn,0,0.00%,2,2,0.00%
alog.umeng.com,0,0.00%,4,4,0.00%
track.mm.taou.com,0,0.00%,4,4,0.00%
sdk.open.phone.igexin.com,0,0.00%,2,2,0.00%
cm-10-134.getui.com,0,0.00%,2,2,0.00%
p215-quota.icloud.com.cn,0,0.00%,2,2,0.00%
312f6456e0f0fef1ff277e8599528b93.safeframe.googlesyndication.com,0,0.00%,1,1,0.00%
unix.stackexchange.com,0,0.00%,2,2,0.00%
userk-drcn.cloud.dbankcloud.cn,0,0.00%,2,2,0.00%
videoeditor-drcn.hms.dbankcloud.com,0,0.00%,2,2,0.00%
node-1204.yh82l3dsytxzf8.com,0,0.00%,2,2,0.00%
wenda.so.com,0,0.00%,8,8,0.00%
s3m7.nzwgs.com,0,0.00%,2,2,0.00%
ss1.360tres.com,0,0.00%,2,2,0.00%
s3m7.fenxi.com,0,0.00%,2,2,0.00%
cc-wt1-cloud.lol.qq.com,0,0.00%,2,2,0.00%
db.auto.sina.com.cn,0,0.00%,2,2,0.00%
auto.sina.com.cn,0,0.00%,2,2,0.00%
i.sso.sina.com.cn,0,0.00%,6,6,0.00%
clc.stackoverflow.com,0,0.00%,2,2,0.00%
so1.360tres.com,0,0.00%,2,2,0.00%
map.so.com,0,0.00%,2,2,0.00%
p.ssl.so.com,0,0.00%,2,2,0.00%
www.sinaimg.cn,0,0.00%,6,6,0.00%
auto4.sinaimg.cn,0,0.00%,2,2,0.00%
auto.sinaimg.cn,0,0.00%,2,2,0.00%
auto3.sinaimg.cn,0,0.00%,2,2,0.00%
p.sug.so.com,0,0.00%,4,4,0.00%
auto1.sinaimg.cn,0,0.00%,2,2,0.00%
auto5.sinaimg.cn,0,0.00%,2,2,0.00%
auto2.sinaimg.cn,0,0.00%,2,2,0.00%
i3.sinaimg.cn,0,0.00%,6,6,0.00%
i0.sinaimg.cn,0,0.00%,6,6,0.00%
s.auto.sina.com.cn,0,0.00%,2,2,0.00%
api.crossref.org,0,0.00%,4,4,0.00%
i1.sinaimg.cn,0,0.00%,6,6,0.00%
mail.ucas.ac.cn,0,0.00%,2,2,0.00%
fp-vp-nocache.azureedge.net,0,0.00%,1,1,0.00%
i.w.bilicdn1.com,0,0.00%,2,2,0.00%
passport.csdn.net,0,0.00%,3,3,0.00%
m6815.talk99.cn,0,0.00%,10,10,0.00%
tw-07-7F287.ferryhwp8ebm.com,0,0.00%,4,4,0.00%
www.ntjiheng.com,0,0.00%,3,3,0.00%
proxy-sub.vulgraph.org,0,0.00%,6,6,0.00%
appupgrade.vivo.com.cn,0,0.00%,1,1,0.00%
rd.nstrive.com,0,0.00%,6,6,0.00%
app.compendium.com,0,0.00%,2,2,0.00%
profile.chrome.360.cn,0,0.00%,2,2,0.00%
tv.360.cn,0,0.00%,5,5,0.00%
www.freebuf.com,0,0.00%,2,2,0.00%
plugin.myip.ms,0,0.00%,1,1,0.00%
image.3001.net,0,0.00%,1,1,0.00%
vip.dingtalk.com,0,0.00%,33,33,0.00%
ns1.a.shifen.com,0,0.00%,4,4,0.00%
ns5.a.shifen.com,0,0.00%,1,1,0.00%
ns4.a.shifen.com,0,0.00%,1,1,0.00%
ns3.a.shifen.com,0,0.00%,3,3,0.00%
ns2.a.shifen.com,0,0.00%,2,2,0.00%
p0.ssl.qhimgs1.com,0,0.00%,4,4,0.00%
www.example.com,0,0.00%,158,158,0.00%
abtest-tx-beijing-01.saas.sensorsdata.cn,0,0.00%,2,2,0.00%
us12.cc,0,0.00%,6,6,0.00%
ssl.bing.com,0,0.00%,4,4,0.00%
time.pool.aliyun.com,0,0.00%,2,2,0.00%
global.infoapis.net,0,0.00%,5,5,0.00%
shop1622256100.v.weidian.com,0,0.00%,2,2,0.00%
ps.ssl.qhimg.com,0,0.00%,2,2,0.00%
p3.qhimg.com,0,0.00%,4,4,0.00%
image.so.com,0,0.00%,8,8,0.00%
p1.ssl.qhimgs1.com,0,0.00%,4,4,0.00%
p3.ssl.qhimgs1.com,0,0.00%,4,4,0.00%
p5.ssl.qhimgs1.com,0,0.00%,4,4,0.00%
p2.ssl.qhimgs1.com,0,0.00%,4,4,0.00%
apistore.360.cn,0,0.00%,4,4,0.00%
content.dropboxapi.com,0,0.00%,4,4,0.00%
kong.citics.com,0,0.00%,2,2,0.00%
tracker.citicsinfo.com,0,0.00%,2,2,0.00%
ws.stream.qqmusic.qq.com,0,0.00%,4,4,0.00%
mon.snssdk.com,0,0.00%,4,4,0.00%
www.tibetairlines.com.cn,0,0.00%,8,8,0.00%
kis.tv.sohu.com,0,0.00%,2,2,0.00%
startpage.foxitsoftware.com,0,0.00%,2,2,0.00%
ad.foxitreader.cn,0,0.00%,2,2,0.00%
globe-request.foxitservice.com,0,0.00%,2,2,0.00%
dcs.foxitreader.cn,0,0.00%,6,6,0.00%
teams.live.com,0,0.00%,2,2,0.00%
update.os.nfschina.com,0,0.00%,10,10,0.00%
usamd.ptuu.tk,0,0.00%,4,4,0.00%
chunchuan-02.aikala.shop,0,0.00%,2,2,0.00%
jgwdj3.gaox.ml,0,0.00%,6,6,0.00%
sg.guiqing.ml,0,0.00%,2,2,0.00%
jgwld3.gaox.ml,0,0.00%,6,6,0.00%
yhkt2.154cc.xyz,0,0.00%,4,4,0.00%
guibi.ml,0,0.00%,2,2,0.00%
e.coding.net,0,0.00%,16,16,0.00%
contacts.163.com,0,0.00%,2,2,0.00%
protocol.mail.163.com,0,0.00%,2,2,0.00%
lftxali.fancyapi.com,0,0.00%,2,2,0.00%
wn-x.jd.com,0,0.00%,2,2,0.00%
mm.jbzj.com.cname3097.yjs-cdn.com,0,0.00%,2,2,0.00%
cdn.chilli.red,0,0.00%,2,2,0.00%
app.reserve.mail.163.com,0,0.00%,2,2,0.00%
u.wps.cn,0,0.00%,2,2,0.00%
mybank.icbc.com.cn,0,0.00%,4,4,0.00%
cn-shtele.lfk5s2.ccddns.lol,0,0.00%,7,7,0.00%
jtrn.is.autonavi.com.gds.alibabadns.com,0,0.00%,2,2,0.00%
mathjax.cnblogs.com,0,0.00%,2,2,0.00%
cinema-tx.hicloud.com,0,0.00%,3,3,0.00%
ping.ie.sogou.com,0,0.00%,2,2,0.00%
vinci.ie.sogou.com,0,0.00%,4,4,0.00%
so.csdn.net,0,0.00%,2,2,0.00%
recommend.docer.wps.cn,0,0.00%,2,2,0.00%
img20.jcloud-cdn.com,0,0.00%,2,2,0.00%
g1xd.mediav.com,0,0.00%,2,2,0.00%
blog.sengxian.com,0,0.00%,2,2,0.00%
wan.sogou.com,0,0.00%,2,2,0.00%
s0.ssl.qhres2.com,0,0.00%,2,2,0.00%
js.redirect.hp.com,0,0.00%,2,2,0.00%
polo.feathr.co,0,0.00%,2,2,0.00%
2022.ieeeicassp.org,0,0.00%,1,1,0.00%
rum7.perf.linkedin.com,0,0.00%,4,4,0.00%
xmpp007.hpeprint.com,0,0.00%,2,2,0.00%
rpc-global.znly.co,0,0.00%,2,2,0.00%
gs-loc.apple.com,0,0.00%,2,2,0.00%
fang-zf.anjuke.com,0,0.00%,2,2,0.00%
c.58cdn.com.cn,0,0.00%,2,2,0.00%
appwos.58.com,0,0.00%,2,2,0.00%
api.fc.mob.com,0,0.00%,4,4,0.00%
cm-10-60.getui.com,0,0.00%,2,2,0.00%
im58log.58.com,0,0.00%,2,2,0.00%
apiwmda.58.com.cn,0,0.00%,4,4,0.00%
verifycode.58.com,0,0.00%,2,2,0.00%
bindwpush.58.com,0,0.00%,2,2,0.00%
devs.data.mob.com,0,0.00%,2,2,0.00%
midinfo.baofeng.com,0,0.00%,2,2,0.00%
cyes.youku.com,0,0.00%,4,4,0.00%
tip.soku.com,0,0.00%,3,3,0.00%
oyster.58.com,0,0.00%,2,2,0.00%
user.youku.com,0,0.00%,4,4,0.00%
v2.reachmax.cn,0,0.00%,4,4,0.00%
apirent.anjuke.com,0,0.00%,2,2,0.00%
api.i-meto.com,0,0.00%,4,4,0.00%
pic3.58cdn.com.cn,0,0.00%,4,4,0.00%
pic6.58cdn.com.cn,0,0.00%,4,4,0.00%
houserentweb.58.com,0,0.00%,2,2,0.00%
socialhouse.58.com,0,0.00%,2,2,0.00%
housecontact.58.com,0,0.00%,2,2,0.00%
pmp.365dmp.com,0,0.00%,2,2,0.00%
www.urbandictionary.com,0,0.00%,4,4,0.00%
yk-ssp.ad.youku.com,0,0.00%,5,5,0.00%
youku.com,0,0.00%,4,4,0.00%
www.gjbmj.gov.cn,0,0.00%,2,2,0.00%
dav.jianguoyun.com,0,0.00%,4,4,0.00%
vip.youku.com,0,0.00%,4,4,0.00%
scikit-learn.org,0,0.00%,2,2,0.00%
cl2.webterren.com,0,0.00%,2,2,0.00%
tools.people.com.cn,0,0.00%,2,2,0.00%
yjfk.gjbmj.gov.cn,0,0.00%,2,2,0.00%
d.webterren.com,0,0.00%,2,2,0.00%
pic8.58cdn.com.cn,0,0.00%,2,2,0.00%
tysl.beijing.chinatax.gov.cn,0,0.00%,2,2,0.00%
www.nsstec.org.cn,0,0.00%,2,2,0.00%
www.jccb.com.cn,0,0.00%,2,2,0.00%
www.baomi.org.cn,0,0.00%,2,2,0.00%
cl0.webterren.com,0,0.00%,2,2,0.00%
search.gjbmj.gov.cn,0,0.00%,2,2,0.00%
zgbmxh.cn,0,0.00%,2,2,0.00%
ec.i-xinnuo.com,0,0.00%,2,2,0.00%
pc.589s.cn,0,0.00%,2,2,0.00%
r1---sn-2x3elnee.gvt1.com,0,0.00%,2,2,0.00%
predownload-admin.g.mi.com,0,0.00%,2,2,0.00%
galleryapi.micloud.xiaomi.net,0,0.00%,2,2,0.00%
wifiapi.micloud.xiaomi.net,0,0.00%,2,2,0.00%
smsapi.micloud.xiaomi.net,0,0.00%,2,2,0.00%
access1.tpns.tencent.com,0,0.00%,4,4,0.00%
pyk.in-neo.cn,0,0.00%,2,2,0.00%
d.heinote.com,0,0.00%,2,2,0.00%
update-ruanjian.2345.cc,0,0.00%,2,2,0.00%
dmp.adform.net,0,0.00%,2,2,0.00%
osm.dianping.com,0,0.00%,4,4,0.00%
osm-t.dianping.com,0,0.00%,4,4,0.00%
signal.xm.test.sankuai.com,0,0.00%,2,2,0.00%
oneservice.meituan.com,0,0.00%,2,2,0.00%
baoku-safe.2345.cc,0,0.00%,2,2,0.00%
platform.wondershare.com,0,0.00%,3,3,0.00%
p.rfihub.com,0,0.00%,2,2,0.00%
apd-0cbd3cd40442416ae34737b56e3c42fb.v.smtcdns.com,0,0.00%,2,2,0.00%
tytx.m.cn.miaozhen.com,0,0.00%,2,2,0.00%
www.cnbeta.com,0,0.00%,8,8,0.00%
images.taboola.com.cn,0,0.00%,2,2,0.00%
ads.vidoomy.com,0,0.00%,3,3,0.00%
ups.analytics.yahoo.com,0,0.00%,2,2,0.00%
trc-events.taboola.com,0,0.00%,2,2,0.00%
hk-trc-events.taboola.com,0,0.00%,2,2,0.00%
dnacdn.net,0,0.00%,2,2,0.00%
imprhkmp.taboola.com,0,0.00%,2,2,0.00%
hk-match.taboola.com,0,0.00%,2,2,0.00%
hk-vid-events.taboola.com,0,0.00%,2,2,0.00%
sync-t1.taboola.com,0,0.00%,4,4,0.00%
wf.taboola.com,0,0.00%,2,2,0.00%
vidstatb.taboola.com,0,0.00%,2,2,0.00%
hk-wf.taboola.com,0,0.00%,2,2,0.00%
s100.boom.skin,0,0.00%,10,10,0.00%
n24.boom.skin,0,0.00%,9,9,0.00%
n21.boom.skin,0,0.00%,9,9,0.00%
nkb.boom.skin,0,0.00%,9,9,0.00%
nm7.boom.skin,0,0.00%,9,9,0.00%
nn1.boom.skin,0,0.00%,9,9,0.00%
n119.boom.skin,0,0.00%,10,10,0.00%
jp14.boom.skin,0,0.00%,11,11,0.00%
jp13.boom.skin,0,0.00%,9,9,0.00%
nn2.boom.skin,0,0.00%,9,9,0.00%
nn5.boom.skin,0,0.00%,9,9,0.00%
nn6.boom.skin,0,0.00%,9,9,0.00%
opt22.boom.skin,0,0.00%,9,9,0.00%
nn3.boom.skin,0,0.00%,9,9,0.00%
nn7.boom.skin,0,0.00%,9,9,0.00%
jp1.boom.skin,0,0.00%,9,9,0.00%
jp2.boom.skin,0,0.00%,9,9,0.00%
jp4.boom.skin,0,0.00%,9,9,0.00%
nn4.boom.skin,0,0.00%,9,9,0.00%
nn14.boom.skin,0,0.00%,9,9,0.00%
nn12.boom.skin,0,0.00%,9,9,0.00%
jp3.boom.skin,0,0.00%,9,9,0.00%
jp5.boom.skin,0,0.00%,9,9,0.00%
nn13.boom.skin,0,0.00%,9,9,0.00%
nn8.boom.skin,0,0.00%,9,9,0.00%
n04.boom.skin,0,0.00%,10,10,0.00%
opt14.boom.skin,0,0.00%,9,9,0.00%
opt23.boom.skin,0,0.00%,9,9,0.00%
opt24.boom.skin,0,0.00%,9,9,0.00%
opt25.boom.skin,0,0.00%,9,9,0.00%
opt26.boom.skin,0,0.00%,9,9,0.00%
opt7.boom.skin,0,0.00%,9,9,0.00%
opt8.boom.skin,0,0.00%,9,9,0.00%
opt9.boom.skin,0,0.00%,9,9,0.00%
nna.boom.skin,0,0.00%,9,9,0.00%
nn11.boom.skin,0,0.00%,9,9,0.00%
opt6.boom.skin,0,0.00%,9,9,0.00%
opt15.boom.skin,0,0.00%,9,9,0.00%
opt21.boom.skin,0,0.00%,9,9,0.00%
opt10.boom.skin,0,0.00%,9,9,0.00%
opt11.boom.skin,0,0.00%,9,9,0.00%
opt12.boom.skin,0,0.00%,9,9,0.00%
opt5.boom.skin,0,0.00%,9,9,0.00%
opt13.boom.skin,0,0.00%,9,9,0.00%
opt1.boom.skin,0,0.00%,9,9,0.00%
opt20.boom.skin,0,0.00%,9,9,0.00%
n28.boom.skin,0,0.00%,10,10,0.00%
n11.boom.skin,0,0.00%,7,7,0.00%
n54.boom.skin,0,0.00%,10,10,0.00%
opt3.boom.skin,0,0.00%,9,9,0.00%
n32.boom.skin,0,0.00%,9,9,0.00%
opt2.boom.skin,0,0.00%,9,9,0.00%
opt4.boom.skin,0,0.00%,9,9,0.00%
ntemp10.boom.skin,0,0.00%,9,9,0.00%
ntemp15.boom.skin,0,0.00%,9,9,0.00%
ntemp19.boom.skin,0,0.00%,9,9,0.00%
ntemp16.boom.skin,0,0.00%,10,10,0.00%
ntemp17.boom.skin,0,0.00%,10,10,0.00%
ntemp18.boom.skin,0,0.00%,12,12,0.00%
n57.boom.skin,0,0.00%,9,9,0.00%
n62.boom.skin,0,0.00%,9,9,0.00%
n06.boom.skin,0,0.00%,9,9,0.00%
ntemp01.boom.skin,0,0.00%,7,7,0.00%
ntemp02.boom.skin,0,0.00%,9,9,0.00%
ntemp03.boom.skin,0,0.00%,9,9,0.00%
n43.boom.skin,0,0.00%,9,9,0.00%
ntemp05.boom.skin,0,0.00%,9,9,0.00%
ntemp06.boom.skin,0,0.00%,9,9,0.00%
ntemp07.boom.skin,0,0.00%,7,7,0.00%
ntemp08.boom.skin,0,0.00%,8,8,0.00%
ntemp09.boom.skin,0,0.00%,11,11,0.00%
ntemp04.boom.skin,0,0.00%,9,9,0.00%
n47.boom.skin,0,0.00%,7,7,0.00%
n22.boom.skin,0,0.00%,9,9,0.00%
n48.boom.skin,0,0.00%,9,9,0.00%
n05.boom.skin,0,0.00%,9,9,0.00%
us5.edge.boom.skin,0,0.00%,8,8,0.00%
jp15.boom.skin,0,0.00%,9,9,0.00%
nm8.boom.skin,0,0.00%,9,9,0.00%
nm9.boom.skin,0,0.00%,9,9,0.00%
nma.boom.skin,0,0.00%,9,9,0.00%
us6.edge.boom.skin,0,0.00%,7,7,0.00%
nmc.boom.skin,0,0.00%,9,9,0.00%
nmb.boom.skin,0,0.00%,9,9,0.00%
n93.boom.skin,0,0.00%,9,9,0.00%
n111.boom.skin,0,0.00%,9,9,0.00%
nmd.boom.skin,0,0.00%,9,9,0.00%
us7.edge.boom.skin,0,0.00%,7,7,0.00%
us8.edge.boom.skin,0,0.00%,7,7,0.00%
us10.edge.boom.skin,0,0.00%,7,7,0.00%
us1.edge.boom.skin,0,0.00%,7,7,0.00%
us2.edge.boom.skin,0,0.00%,7,7,0.00%
n115.boom.skin,0,0.00%,9,9,0.00%
us9.edge.boom.skin,0,0.00%,7,7,0.00%
n37.boom.skin,0,0.00%,7,7,0.00%
s102.boom.skin,0,0.00%,7,7,0.00%
s103.boom.skin,0,0.00%,7,7,0.00%
s105.boom.skin,0,0.00%,7,7,0.00%
us3.edge.boom.skin,0,0.00%,7,7,0.00%
us4.edge.boom.skin,0,0.00%,7,7,0.00%
s01.boom.skin,0,0.00%,9,9,0.00%
s104.boom.skin,0,0.00%,8,8,0.00%
n117.boom.skin,0,0.00%,11,11,0.00%
n17.boom.skin,0,0.00%,7,7,0.00%
jp6.boom.skin,0,0.00%,9,9,0.00%
n96.boom.skin,0,0.00%,7,7,0.00%
n30.boom.skin,0,0.00%,9,9,0.00%
opt18.boom.skin,0,0.00%,11,11,0.00%
opt16.boom.skin,0,0.00%,9,9,0.00%
opt17.boom.skin,0,0.00%,11,11,0.00%
jp7.boom.skin,0,0.00%,9,9,0.00%
jp16.boom.skin,0,0.00%,9,9,0.00%
nf6.boom.skin,0,0.00%,7,7,0.00%
n110.boom.skin,0,0.00%,7,7,0.00%
n09.boom.skin,0,0.00%,7,7,0.00%
jp17.boom.skin,0,0.00%,9,9,0.00%
n13.boom.skin,0,0.00%,7,7,0.00%
n27.boom.skin,0,0.00%,7,7,0.00%
n63.boom.skin,0,0.00%,7,7,0.00%
n92.boom.skin,0,0.00%,7,7,0.00%
n77.boom.skin,0,0.00%,7,7,0.00%
n60.boom.skin,0,0.00%,7,7,0.00%
ntemp25.boom.skin,0,0.00%,7,7,0.00%
n100.boom.skin,0,0.00%,7,7,0.00%
nk1.boom.skin,0,0.00%,17,17,0.00%
nk2.boom.skin,0,0.00%,7,7,0.00%
jp18.boom.skin,0,0.00%,10,10,0.00%
jp19.boom.skin,0,0.00%,9,9,0.00%
jp20.boom.skin,0,0.00%,9,9,0.00%
nk3.boom.skin,0,0.00%,7,7,0.00%
nk4.boom.skin,0,0.00%,7,7,0.00%
nk6.boom.skin,0,0.00%,7,7,0.00%
nk7.boom.skin,0,0.00%,7,7,0.00%
nf1.boom.skin,0,0.00%,7,7,0.00%
nf2.boom.skin,0,0.00%,7,7,0.00%
n114.boom.skin,0,0.00%,7,7,0.00%
nf3.boom.skin,0,0.00%,7,7,0.00%
nf4.boom.skin,0,0.00%,7,7,0.00%
nf5.boom.skin,0,0.00%,7,7,0.00%
nl9.boom.skin,0,0.00%,9,9,0.00%
nkc.boom.skin,0,0.00%,9,9,0.00%
nkd.boom.skin,0,0.00%,9,9,0.00%
nke.boom.skin,0,0.00%,9,9,0.00%
nl2.boom.skin,0,0.00%,9,9,0.00%
nl4.boom.skin,0,0.00%,9,9,0.00%
nl5.boom.skin,0,0.00%,9,9,0.00%
nl6.boom.skin,0,0.00%,9,9,0.00%
nl1.boom.skin,0,0.00%,9,9,0.00%
nl3.boom.skin,0,0.00%,9,9,0.00%
nl7.boom.skin,0,0.00%,9,9,0.00%
nl8.boom.skin,0,0.00%,9,9,0.00%
nm1.boom.skin,0,0.00%,9,9,0.00%
nla.boom.skin,0,0.00%,9,9,0.00%
s101.boom.skin,0,0.00%,9,9,0.00%
n61.boom.skin,0,0.00%,9,9,0.00%
n67.boom.skin,0,0.00%,9,9,0.00%
n74.boom.skin,0,0.00%,9,9,0.00%
nj6.boom.skin,0,0.00%,9,9,0.00%
nf7.boom.skin,0,0.00%,7,7,0.00%
nf8.boom.skin,0,0.00%,7,7,0.00%
nf9.boom.skin,0,0.00%,7,7,0.00%
nf10.boom.skin,0,0.00%,7,7,0.00%
n170.boom.skin,0,0.00%,9,9,0.00%
nf11.boom.skin,0,0.00%,7,7,0.00%
nj2.boom.skin,0,0.00%,10,10,0.00%
nj3.boom.skin,0,0.00%,9,9,0.00%
nj1.boom.skin,0,0.00%,9,9,0.00%
nj4.boom.skin,0,0.00%,9,9,0.00%
nj5.boom.skin,0,0.00%,9,9,0.00%
njc.boom.skin,0,0.00%,9,9,0.00%
nj7.boom.skin,0,0.00%,9,9,0.00%
nj8.boom.skin,0,0.00%,9,9,0.00%
nja.boom.skin,0,0.00%,9,9,0.00%
nje.boom.skin,0,0.00%,9,9,0.00%
nk8.boom.skin,0,0.00%,9,9,0.00%
nk9.boom.skin,0,0.00%,9,9,0.00%
nka.boom.skin,0,0.00%,9,9,0.00%
njb.boom.skin,0,0.00%,9,9,0.00%
njd.boom.skin,0,0.00%,9,9,0.00%
jp9.boom.skin,0,0.00%,13,13,0.00%
jp10.boom.skin,0,0.00%,13,13,0.00%
jp11.boom.skin,0,0.00%,9,9,0.00%
jp12.boom.skin,0,0.00%,9,9,0.00%
jp8.boom.skin,0,0.00%,11,11,0.00%
opt19.boom.skin,0,0.00%,11,11,0.00%
nm3.boom.skin,0,0.00%,9,9,0.00%
nm6.boom.skin,0,0.00%,9,9,0.00%
nm5.boom.skin,0,0.00%,9,9,0.00%
nm4.boom.skin,0,0.00%,9,9,0.00%
nm2.boom.skin,0,0.00%,9,9,0.00%
n0.sinaimg.cn,0,0.00%,2,2,0.00%
d8.sina.com.cn,0,0.00%,2,2,0.00%
top.news.sina.com.cn,0,0.00%,6,6,0.00%
beacon.sina.com.cn,0,0.00%,4,4,0.00%
tech.sina.com.cn,0,0.00%,6,6,0.00%
n3.sinaimg.cn,0,0.00%,2,2,0.00%
match.lottery.sina.com.cn,0,0.00%,6,6,0.00%
s.weibo.com,0,0.00%,8,8,0.00%
js.bd.dhsz.cn,0,0.00%,6,6,0.00%
edge.caitong.sina.com.cn,0,0.00%,4,4,0.00%
rm.ttyingqiu.com,0,0.00%,4,4,0.00%
ent.sina.com.cn,0,0.00%,6,6,0.00%
comment.sina.com.cn,0,0.00%,6,6,0.00%
j.bd.dhsz.cn,0,0.00%,4,4,0.00%
s9.cnzz.com,0,0.00%,3,3,0.00%
fav.mix.sina.com.cn,0,0.00%,6,6,0.00%
interface.sina.cn,0,0.00%,6,6,0.00%
cn.mvconf.50union.com,0,0.00%,4,4,0.00%
cn.aiclean.50union.com,0,0.00%,2,2,0.00%
ns5.firstfind.net,0,0.00%,2,2,0.00%
ns3.firstfind.nl,0,0.00%,2,2,0.00%
irns31.hostdl.com,0,0.00%,2,2,0.00%
ns3.serverhostgroup.com,0,0.00%,2,2,0.00%
ns2.serverhostgroup.com,0,0.00%,2,2,0.00%
ns1.serverhostgroup.com,0,0.00%,2,2,0.00%
irns32.hostdl.com,0,0.00%,2,2,0.00%
ns8.01isp.net,0,0.00%,2,2,0.00%
ns7.01isp.com,0,0.00%,2,2,0.00%
dns1.yemenhosting.com,0,0.00%,2,2,0.00%
ns20.ovh.net,0,0.00%,2,2,0.00%
ns1.quickdns.co.uk,0,0.00%,2,2,0.00%
dns2.yemenhosting.com,0,0.00%,2,2,0.00%
dns20.ovh.net,0,0.00%,2,2,0.00%
sarah.ns.cloudflare.com,0,0.00%,2,2,0.00%
app.mokahr.com,0,0.00%,2,2,0.00%
ns2.ezi-cart.net,0,0.00%,2,2,0.00%
valueconverter.com,0,0.00%,2,2,0.00%
ns-1926.awsdns-48.co.uk,0,0.00%,2,2,0.00%
ns1.ezi-cart.net,0,0.00%,2,2,0.00%
ns-647.awsdns-16.net,0,0.00%,2,2,0.00%
cash.ns.cloudflare.com,0,0.00%,6,6,0.00%
ns-88.awsdns-11.com,0,0.00%,2,2,0.00%
nspro57.hostgator.com.br,0,0.00%,2,2,0.00%
line.dnspod.net,0,0.00%,2,2,0.00%
nspro56.hostgator.com.br,0,0.00%,2,2,0.00%
chips.dnspod.net,0,0.00%,2,2,0.00%
courtney.ns.cloudflare.com,0,0.00%,2,2,0.00%
ruben.ns.cloudflare.com,0,0.00%,2,2,0.00%
harlee.ns.cloudflare.com,0,0.00%,2,2,0.00%
ns2.hosterion.com,0,0.00%,4,4,0.00%
ns1.ihsdnsx1.com,0,0.00%,2,2,0.00%
ns1.hosterion.com,0,0.00%,4,4,0.00%
ns2.hosterion.net,0,0.00%,4,4,0.00%
appportal2.cmy.network,0,0.00%,2,2,0.00%
iplc-ji.cmy-dns.com,0,0.00%,2,2,0.00%
ns14.inhostedns.com,0,0.00%,2,2,0.00%
ns1.hosterion.net,0,0.00%,4,4,0.00%
api.mumu3.nie.netease.com,0,0.00%,2,2,0.00%
wnsmusic.qq.com,0,0.00%,2,2,0.00%
ns34.inhostedns.org,0,0.00%,2,2,0.00%
33.push2his.eastmoney.com,0,0.00%,2,2,0.00%
hk02-vm5.entry.hsrtd.club,0,0.00%,2,2,0.00%
prestigemansion.com,0,0.00%,2,2,0.00%
sub.fnf.one,0,0.00%,4,4,0.00%
softcenter.os3.win.nfschina.com,0,0.00%,4,4,0.00%
kristin.ns.cloudflare.com,0,0.00%,2,2,0.00%
mercury.dnspod.net,0,0.00%,2,2,0.00%
second.dnspod.net,0,0.00%,5,5,0.00%
amaryllis.dnspod.net,0,0.00%,5,5,0.00%
song.dnspod.net,0,0.00%,2,2,0.00%
socks.dnspod.net,0,0.00%,2,2,0.00%
tate.ns.cloudflare.com,0,0.00%,2,2,0.00%
susan.ns.cloudflare.com,0,0.00%,4,4,0.00%
may.ns.cloudflare.com,0,0.00%,10,10,0.00%
grasshopper.dnspod.net,0,0.00%,1,1,0.00%
dns4.supremepanel.com,0,0.00%,2,2,0.00%
spring.dnspod.net,0,0.00%,2,2,0.00%
xyhg7388.com,0,0.00%,2,2,0.00%
ns1.md-ht-4.bigrockservers.com,0,0.00%,2,2,0.00%
cap.dnspod.net,0,0.00%,4,4,0.00%
ns4.jovabilisim.com,0,0.00%,2,2,0.00%
dns218.a.register.com,0,0.00%,2,2,0.00%
ns1.digitalbusinesslounge.com,0,0.00%,2,2,0.00%
false.dnspod.net,0,0.00%,2,2,0.00%
ns29.domaincontrol.com,0,0.00%,54,54,0.00%
ns30.domaincontrol.com,0,0.00%,56,56,0.00%
ns106.hostgator.mx,0,0.00%,2,2,0.00%
v.ns.arvancdn.net,0,0.00%,4,4,0.00%
ns5.zonomi.com,0,0.00%,2,2,0.00%
cn-1-data.airdroid.cn,0,0.00%,2,2,0.00%
stat3.airdroid.com,0,0.00%,2,2,0.00%
ns2bls.name.com,0,0.00%,2,2,0.00%
ns4dfh.name.com,0,0.00%,2,2,0.00%
3.push2his.eastmoney.com,0,0.00%,2,2,0.00%
miki.ns.cloudflare.com,0,0.00%,14,14,0.00%
dt.netease.im,0,0.00%,2,2,0.00%
wanproxy.127.net,0,0.00%,2,2,0.00%
api.iplay.163.com,0,0.00%,2,2,0.00%
27.push2his.eastmoney.com,0,0.00%,2,2,0.00%
plover.dnspod.net,0,0.00%,4,4,0.00%
yonderstayz.com,0,0.00%,2,2,0.00%
17.push2his.eastmoney.com,0,0.00%,2,2,0.00%
only-541488-159-226-95-33.nstool.321fenx.com,0,0.00%,1,1,0.00%
ns3.jovabilisim.com,0,0.00%,2,2,0.00%
api.crush.163.com,0,0.00%,2,2,0.00%
api.k.163.com,0,0.00%,2,2,0.00%
ns1115.ui-dns.biz,0,0.00%,2,2,0.00%
carl.dnspod.net,0,0.00%,2,2,0.00%
deer.dnspod.net,0,0.00%,2,2,0.00%
wannos.127.net,0,0.00%,2,2,0.00%
flowers.dnspod.net,0,0.00%,2,2,0.00%
humid.dnspod.net,0,0.00%,2,2,0.00%
vodkgeyttp9c.vod.126.net,0,0.00%,2,2,0.00%
similar.dnspod.net,0,0.00%,2,2,0.00%
liqueur.dnspod.net,0,0.00%,2,2,0.00%
youcanlearntoquilt.com,0,0.00%,2,2,0.00%
ns-1305.awsdns-35.org,0,0.00%,2,2,0.00%
climbing.dnspod.net,0,0.00%,2,2,0.00%
ns-1808.awsdns-34.co.uk,0,0.00%,2,2,0.00%
41.push2his.eastmoney.com,0,0.00%,4,4,0.00%
data.dnspod.net,0,0.00%,2,2,0.00%
ns3.digitalbusinesslounge.com,0,0.00%,2,2,0.00%
jelly.dnspod.net,0,0.00%,2,2,0.00%
ns-429.awsdns-53.com,0,0.00%,2,2,0.00%
younderstayz.com,0,0.00%,2,2,0.00%
ns1.convertlabs.website,0,0.00%,2,2,0.00%
rex.ns.cloudflare.com,0,0.00%,4,4,0.00%
ns4.digitalbusinesslounge.com,0,0.00%,2,2,0.00%
ns2.convertlabs.website,0,0.00%,2,2,0.00%
ns25.hostingcare.net,0,0.00%,2,2,0.00%
ns2.digitalbusinesslounge.com,0,0.00%,2,2,0.00%
dns121.a.register.com,0,0.00%,2,2,0.00%
p5.music.126.net,0,0.00%,2,2,0.00%
dns186.b.register.com,0,0.00%,6,6,0.00%
ns2.md-ht-4.bigrockservers.com,0,0.00%,2,2,0.00%
i7-static.jjwxc.net,0,0.00%,2,2,0.00%
garrett.ns.cloudflare.com,0,0.00%,2,2,0.00%
ns16.hostingcare.net,0,0.00%,2,2,0.00%
91.push2his.eastmoney.com,0,0.00%,2,2,0.00%
ns26.hostingcare.net,0,0.00%,2,2,0.00%
pop.139.com,0,0.00%,2,2,0.00%
ns15.hostingcare.net,0,0.00%,2,2,0.00%
open.e.189.cn,0,0.00%,2,2,0.00%
www.yourwatchfactory.com,0,0.00%,2,2,0.00%
albedozero.s3.amazonaws.com,0,0.00%,2,2,0.00%
newdefault2.go2https.com,0,0.00%,1,1,0.00%
2cca7b635362400b9dd6bbbb8aead89f.fp.measure.office.com,0,0.00%,1,1,0.00%
ip2091323408.funshion.com,0,0.00%,4,4,0.00%
recom.docer.wps.cn,0,0.00%,4,4,0.00%
7fi.ukzcyp.ga,0,0.00%,1,1,0.00%
cm2-tyo1.cm.steampowered.com,0,0.00%,2,2,0.00%
61fa87a230d24d82aeace22c68121609.fp.measure.office.com,0,0.00%,1,1,0.00%
goldendict.org,0,0.00%,2,2,0.00%
rebelmouse.map.fastly.NET,0,0.00%,2,2,0.00%
api100-eeft-drive-quic-lf.feishu.cn,0,0.00%,2,2,0.00%
gc.kis.v2.scr.kaspersky-labs.com,0,0.00%,2,2,0.00%
onedriveclucprodbn20024.blob.core.windows.net,0,0.00%,3,3,0.00%
ldc.lenovo.com.cn.trpcdn.NET,0,0.00%,2,2,0.00%
weus2watcab01.blob.core.windows.net,0,0.00%,8,8,0.00%
store.viveport.com,0,0.00%,2,2,0.00%
apm.music.163.com,0,0.00%,2,2,0.00%
s2.symcb.com,0,0.00%,4,4,0.00%
s.symcd.com,0,0.00%,4,4,0.00%
ts-ocsp.ws.symantec.com,0,0.00%,2,2,0.00%
warehouse.leapmotion.com,0,0.00%,1,1,0.00%
hwlicai.ztqft.com,0,0.00%,2,2,0.00%
hwqfttools.ztqft.com,0,0.00%,4,4,0.00%
licai.ztqft.com,0,0.00%,4,4,0.00%
ngo.minigame.qq.com,0,0.00%,2,2,0.00%
dir.minigame.qq.com,0,0.00%,2,2,0.00%
sdup.360.cn,0,0.00%,4,4,0.00%
ini.sdup.360.cn,0,0.00%,4,4,0.00%
sec.cmbchina.com,0,0.00%,2,2,0.00%
ns-384.awsdns-48.com,0,0.00%,2,2,0.00%
developer.apple.com,0,0.00%,4,4,0.00%
world-gen.g.aaplimg.com,0,0.00%,2,2,0.00%
ws.mmstat.com,0,0.00%,2,2,0.00%
hd.mmstat.com,0,0.00%,6,6,0.00%
ws.mmstat.com.gds.alibabadns.com,0,0.00%,2,2,0.00%
hd.mmstat.com.gds.alibabadns.com,0,0.00%,2,2,0.00%
hd-v6.mmstat.com,0,0.00%,2,2,0.00%
hd-v6.mmstat.com.gds.alibabadns.com,0,0.00%,2,2,0.00%
jira.qero.io,0,0.00%,1,1,0.00%
39b43358d311419d932c4c98825df25b.fp.measure.office.com,0,0.00%,1,1,0.00%
seed-swallow.siri.apple.com,0,0.00%,2,2,0.00%
fpc.msedge.net,0,0.00%,4,4,0.00%
ns-open2.qq.com,0,0.00%,8,8,0.00%
dashiwebv6.mail.split.netease.com,0,0.00%,2,2,0.00%
check.bt.cn,0,0.00%,2,2,0.00%
38.courier-push-apple.com.akadns.net,0,0.00%,2,2,0.00%
119.t.keepitpumpin.io,0,0.00%,2,2,0.00%
m.sogo.com,0,0.00%,2,2,0.00%
ns4-04.azure-dns.info,0,0.00%,6,6,0.00%
ns3-224.azure-dns.org,0,0.00%,2,2,0.00%
onedscolprdneu03.northeurope.cloudapp.azure.com,0,0.00%,10,10,0.00%
cp3.huoying666.com,0,0.00%,5,5,0.00%
ns3-07.azure-dns.org,0,0.00%,4,4,0.00%
weu017-breeziest-in.cloudapp.net,0,0.00%,2,2,0.00%
cc.f.qh-lb.com,0,0.00%,7,7,0.00%
alfonsino.top,0,0.00%,2,2,0.00%
linux-updatepro.wps.cn,0,0.00%,2,2,0.00%
3.courier-push-apple.com.akadns.net,0,0.00%,2,2,0.00%
c801s1.jamjams3.net,0,0.00%,4,4,0.00%
azwcus1-client-s.gateway.messenger.live.com,0,0.00%,2,2,0.00%
azwcus1-client-s.msnmessenger.msn.com.akadns.net,0,0.00%,2,2,0.00%
ip.azwcus1-client-s.msnmessenger.msn.com.akadns.net,0,0.00%,2,2,0.00%
sg-drive.wps.com,0,0.00%,2,2,0.00%
ejp1-urlp.secure.skypeassets.com,0,0.00%,2,2,0.00%
event.wps.com,0,0.00%,6,6,0.00%
ejp-urlp.azureedge.net,0,0.00%,2,2,0.00%
event.4wps.net,0,0.00%,2,2,0.00%
p36-imap.mail.me.com,0,0.00%,2,2,0.00%
p36-imap.mail.me.com.akadns.net,0,0.00%,2,2,0.00%
imap.mail.me.com.akadns.net,0,0.00%,2,2,0.00%
people-service-prod.trafficmanager.net,0,0.00%,2,2,0.00%
b-ring.b-9999.b-msedge.net,0,0.00%,2,2,0.00%
b-9999.b-msedge.net,0,0.00%,2,2,0.00%
guce.yahoo.com,0,0.00%,1,1,0.00%
go.trouter.skype.com,0,0.00%,2,2,0.00%
root.skype-edf.akadns.net,0,0.00%,2,2,0.00%
oauth.intservices.aws.intellij.net,0,0.00%,2,2,0.00%
prod-oauth-public-alb-939786626.eu-west-1.elb.amazonaws.com,0,0.00%,2,2,0.00%
www.zybuluo.com,0,0.00%,2,2,0.00%
zybuluo.com,0,0.00%,4,4,0.00%
sv1.bdydns.cn,0,0.00%,2,2,0.00%
files.fireinthehole.cf,0,0.00%,1,1,0.00%
www.osticket.com,0,0.00%,2,2,0.00%
p211-ckdatabase.icloud.com.cn,0,0.00%,2,2,0.00%
array512.prod.do.dsp.mp.microsoft.com,0,0.00%,6,6,0.00%
ns4-ms-acdc.office.com,0,0.00%,2,2,0.00%
ant.if.iqiyi.com,0,0.00%,2,2,0.00%
my.maxon.net,0,0.00%,2,2,0.00%
api.b.qianxin.com,0,0.00%,4,4,0.00%
omnatuor.com,0,0.00%,2,2,0.00%
engplus.ru,0,0.00%,4,4,0.00%
doh-fi.blahdns.com,0,0.00%,2,2,0.00%
ip.parrotdns.com,0,0.00%,19,19,0.00%
7195c67.pf.gladns.com,0,0.00%,2,2,0.00%
7195c67.ph.gladns.com,0,0.00%,4,4,0.00%
7195c67.pe.gladns.com,0,0.00%,2,2,0.00%
7195c67.pb.gladns.com,0,0.00%,2,2,0.00%
7195c67.pd.gladns.com,0,0.00%,2,2,0.00%
7195c67.pa.gladns.com,0,0.00%,2,2,0.00%
7195c67.pg.gladns.com,0,0.00%,2,2,0.00%
software.macpaw.com,0,0.00%,7,7,0.00%
www.i0rp1l2j.com,0,0.00%,2,2,0.00%
www.tg5tj2cu.com,0,0.00%,2,2,0.00%
eu.10jqka.com.cn,0,0.00%,2,2,0.00%
sha-cu-001.omo-m0m.com,0,0.00%,14,14,0.00%
1qw2cd.qqscml.ga,0,0.00%,1,1,0.00%
rubygems.org,0,0.00%,2,2,0.00%
onedscolprduks05.uksouth.cloudapp.azure.com,0,0.00%,2,2,0.00%
redqueen.tj-un.com,0,0.00%,2,2,0.00%
archive1.kylinos.cn,0,0.00%,2,2,0.00%
upgrade.xl9.xunlei.com,0,0.00%,3,3,0.00%
selectcarpetcleaninginc.rk3t.com,0,0.00%,1,1,0.00%
airtcpapp.top,0,0.00%,2,2,0.00%
www.lowes.com,0,0.00%,2,2,0.00%
ffed.toilet-extras.org,0,0.00%,2,2,0.00%
ns1.phicdn.net,0,0.00%,1,1,0.00%
edge-096.hktko1.icloud-content.com,0,0.00%,1,1,0.00%
arangodb.prod.osssc.ac.cn,0,0.00%,11,11,0.00%
code.osssc.ac.cn,0,0.00%,56,56,0.00%
api.pc120.com,0,0.00%,4,4,0.00%
wifi.www.duba.net,0,0.00%,1,1,0.00%
start.desktopcal.com,0,0.00%,1,1,0.00%
in.hceok.com,0,0.00%,7,7,0.00%
cmhk2.edgehelper.com,0,0.00%,3,3,0.00%
fsU543202558809.harmonyoscloudcdn.com,0,0.00%,1,1,0.00%
fileU543202558809.edge.pubmed-hub.com,0,0.00%,1,1,0.00%
hkthome2.iggfastweb.com,0,0.00%,3,3,0.00%
idcdo11948.netvigators.xyz,0,0.00%,3,3,0.00%
jsU543202558809.edge.huawei-static.com,0,0.00%,1,1,0.00%
hksk2.edgehelper.com,0,0.00%,4,4,0.00%
imgU543202558809.hk.huawei-cacahe.com,0,0.00%,1,1,0.00%
mirrors.fedoraproject.org,0,0.00%,15,15,0.00%
wildcard.fedoraproject.org,0,0.00%,7,7,0.00%
mirrors.neusoft.edu.cn,0,0.00%,1,1,0.00%
mirrors.bfsu.edu.cn,0,0.00%,1,1,0.00%
debuginfo.centos.org,0,0.00%,2,2,0.00%
d2h67oheeuigaw.cloudfront.net,0,0.00%,2,2,0.00%
download.virtualbox.org,0,0.00%,1,1,0.00%
us20.cc,0,0.00%,7,7,0.00%
arch.ver.input.yunbiaosoft.com,0,0.00%,2,2,0.00%
conf.wifi.360.cn,0,0.00%,2,2,0.00%
api.free.wifi.360.cn,0,0.00%,3,3,0.00%
p210-quota.icloud.com.cn,0,0.00%,1,1,0.00%
webmail.up4net.net,0,0.00%,1,1,0.00%
2398.35go.net,0,0.00%,2,2,0.00%
accounts.nvgs.nvidia.com,0,0.00%,2,2,0.00%
ota.nvidia.com,0,0.00%,1,1,0.00%
cf45.herokuapp.com,0,0.00%,1,1,0.00%
app-b02.lp1.npns.srv.nintendo.net,0,0.00%,1,1,0.00%
2022.esec-fse.org,0,0.00%,1,1,0.00%
licensebuttons.net,0,0.00%,1,1,0.00%
ihsu-japaneast-2.japaneast.cloudapp.azure.com,0,0.00%,2,2,0.00%
blob.dsm07prdstr13a.store.core.windows.net,0,0.00%,1,1,0.00%
beacons5.gvt2.com,0,0.00%,1,1,0.00%
bggts547gukhvmf4cgandlgxxphengxovoyo6ewhns5qmmb2b5oi43yd.tor2web.it,0,0.00%,9,9,0.00%
jtwlgl.nm.chinamobile.com,0,0.00%,3,3,0.00%
blob.bnz14prdstr09a.store.core.windows.net,0,0.00%,1,1,0.00%
imap.139.com,0,0.00%,5,5,0.00%
p59-contacts.icloud.com,0,0.00%,1,1,0.00%
resolver-eu.lelux.fi,0,0.00%,3,3,0.00%
polyester-dead-5f6.notion.site,0,0.00%,4,4,0.00%
v.graphics.ac.cn,0,0.00%,2,2,0.00%
fc0e256f601542db9f09dfc7f45a721c.fp.measure.office.com,0,0.00%,2,2,0.00%
euserv6p.ezddns.tk,0,0.00%,1,1,0.00%
conf.researchr.org,0,0.00%,3,3,0.00%
people.cs.uchicago.edu,0,0.00%,4,4,0.00%
app-b03.lp1.npns.srv.nintendo.net,0,0.00%,2,2,0.00%
appstore.ldmnq.com,0,0.00%,2,2,0.00%
array803.prod.do.dsp.mp.microsoft.com,0,0.00%,6,6,0.00%
o1098464.ingest.sentry.io,0,0.00%,2,2,0.00%
ali-pc-x-speed-auth-vip.xunlei.com,0,0.00%,2,2,0.00%
m.reachmax.cn,0,0.00%,2,2,0.00%
apphub.aliyuncs.com,0,0.00%,8,8,0.00%
www.xwt-classics.net,0,0.00%,2,2,0.00%
cn2888.v2free.xyz,0,0.00%,14,14,0.00%
announce.partis.si,0,0.00%,2,2,0.00%
torrents.hikarinokiseki.com,0,0.00%,4,4,0.00%
filters.adtidy.org,0,0.00%,2,2,0.00%
speedtest-rtc.xtsmart.link,0,0.00%,3,3,0.00%
admin.kdsec.org,0,0.00%,5,5,0.00%
master16.teamviewer.com,0,0.00%,4,4,0.00%
bttracker.debian.org,0,0.00%,2,2,0.00%
bt.3dmgame.com,0,0.00%,4,4,0.00%
account.youku.com,0,0.00%,2,2,0.00%
fourier.alibaba.com,0,0.00%,1,1,0.00%
g2.ykimg.com,0,0.00%,1,1,0.00%
www.ludashi.com,0,0.00%,4,4,0.00%
tracker.frozen-layer.net,0,0.00%,2,2,0.00%
open.nyap2p.com,0,0.00%,2,2,0.00%
comm.weixinbridge.com,0,0.00%,2,2,0.00%
tracker.electro-torrent.pl,0,0.00%,2,2,0.00%
tracker.nucozer-tracker.ml,0,0.00%,2,2,0.00%
lf3-cdn-tos.bytecdntp.com,0,0.00%,1,1,0.00%
zgc.ai-cas.com,0,0.00%,2,2,0.00%
tracker.hiyj.cn,0,0.00%,2,2,0.00%
tracker.xn--vzyr4p.top,0,0.00%,2,2,0.00%
torrent-team.net,0,0.00%,4,4,0.00%
beertracker.ml,0,0.00%,2,2,0.00%
tr.abiir.top,0,0.00%,2,2,0.00%
cad.youku.com,0,0.00%,2,2,0.00%
report.meituan.com,0,0.00%,2,2,0.00%
sealine.youku.com,0,0.00%,2,2,0.00%
sharkwsbj.sankuai.com,0,0.00%,2,2,0.00%
vaiwan.com,0,0.00%,2,2,0.00%
www.skeimg.com,0,0.00%,1,1,0.00%
paint.ludashi.com,0,0.00%,2,2,0.00%
www.casmooc.cn,0,0.00%,2,2,0.00%
imge.ali.kugou.com,0,0.00%,2,2,0.00%
direwolf-cdbae92306.herokuapp.com,0,0.00%,1,1,0.00%
event.ksosoft.com,0,0.00%,2,2,0.00%
apph.wpsmail.net,0,0.00%,2,2,0.00%
counter.kingsoft.com,0,0.00%,1,1,0.00%
f0eab2bd26cc4cf893a5858256c824eb.fp.measure.office.com,0,0.00%,1,1,0.00%
d1w2n8w3obm3k0.cloudfront.net,0,0.00%,61,61,0.00%
gcore.yunfan.info,0,0.00%,4,4,0.00%
v.qiihu.com,0,0.00%,2,2,0.00%
v2.qiihu.com,0,0.00%,2,2,0.00%
ccc.hpeprint.com,0,0.00%,2,2,0.00%
apsrgeo.amap.com,0,0.00%,2,2,0.00%
service.ijomo.net,0,0.00%,2,2,0.00%
sp1.sangfor.com.cn,0,0.00%,20,20,0.00%
sp3.sangfor.com.cn,0,0.00%,8,8,0.00%
sp2.sangfor.com.cn,0,0.00%,4,4,0.00%
jsU228491353758.edge.huawei-static.com,0,0.00%,2,2,0.00%
imgU228491353758.hk.huawei-cacahe.com,0,0.00%,2,2,0.00%
fsU228491353758.harmonyoscloudcdn.com,0,0.00%,2,2,0.00%
appU228491353758.api.steamgamepowered.net,0,0.00%,2,2,0.00%
fileU228491353758.edge.pubmed-hub.com,0,0.00%,2,2,0.00%
mucp.api.account.microsoft.com,0,0.00%,2,2,0.00%
api.wondercv.com,0,0.00%,8,8,0.00%
sd-gl.xycdn.com,0,0.00%,2,2,0.00%
crl-symcprod.digicert.com,0,0.00%,4,4,0.00%
35.courier-push-apple.com.akadns.net,0,0.00%,2,2,0.00%
sub1.bgp.netarch-alisc1-edge-lb.l.bytedns.net,0,0.00%,2,2,0.00%
ns2-39.azure-dns.net,0,0.00%,2,2,0.00%
botfuel-hermes-backend-bo.herokuapp.com,0,0.00%,61,61,0.00%
platform.maps.glbdns2.microsoft.com,0,0.00%,2,2,0.00%
p213-quota.icloud.com.cn,0,0.00%,2,2,0.00%
mail.consearchgiffipic.ml,0,0.00%,2,2,0.00%
proxy-detection.eset.com,0,0.00%,2,2,0.00%
suggestion.a.shifen.com,0,0.00%,2,2,0.00%
wwwlb.newsmth.net,0,0.00%,2,2,0.00%
ns-662.awsdns-18.net,0,0.00%,2,2,0.00%
ns-1925.awsdns-48.co.uk,0,0.00%,2,2,0.00%
tagr-gcp-lb1-ase1.mookie1.com,0,0.00%,2,2,0.00%
image6v2.pubmnet.com,0,0.00%,2,2,0.00%
pugmaster-sg4c.pubmnet.com,0,0.00%,2,2,0.00%
a.svtrd.com,0,0.00%,2,2,0.00%
onedscolprdeus13.eastus.cloudapp.azure.com,0,0.00%,4,4,0.00%
pixel-a.sitescout.com,0,0.00%,2,2,0.00%
imap.mail.10086.cn,0,0.00%,2,2,0.00%
ums.acuityplatform.com,0,0.00%,2,2,0.00%
securepubads46.g.doubleclick.net,0,0.00%,2,2,0.00%
ocsp.godaddy.com.akadns.net,0,0.00%,2,2,0.00%
bs-geo.dvgtm.akadns.net,0,0.00%,2,2,0.00%
gpdream.github.io,0,0.00%,1,1,0.00%
ns2.melbourneit.net,0,0.00%,2,2,0.00%
dns2.completeweb.net,0,0.00%,2,2,0.00%
doh-sg.blahdns.com,0,0.00%,5,5,0.00%
ns.state.net,0,0.00%,2,2,0.00%
ns1.naklov.com,0,0.00%,2,2,0.00%
ns8154.hostgator.com,0,0.00%,2,2,0.00%
dns2.comunidades.net,0,0.00%,2,2,0.00%
apollo.ns.cloudflare.com,0,0.00%,2,2,0.00%
kira.ns.cloudflare.com,0,0.00%,2,2,0.00%
hank.ns.cloudflare.com,0,0.00%,2,2,0.00%
rory.ns.cloudflare.com,0,0.00%,2,2,0.00%
grupoproducts.com,0,0.00%,2,2,0.00%
ns-1326.awsdns-37.org,0,0.00%,2,2,0.00%
ns-1759.awsdns-27.co.uk,0,0.00%,2,2,0.00%
ns-300.awsdns-37.com,0,0.00%,2,2,0.00%
ns-200.awsdns-25.com,0,0.00%,2,2,0.00%
ns-688.awsdns-22.net,0,0.00%,2,2,0.00%
ns584.hostgator.com.br,0,0.00%,2,2,0.00%
gd-ad.com,0,0.00%,2,2,0.00%
vinni.gowebdirect.com,0,0.00%,2,2,0.00%
ns105.websitewelcome.com,0,0.00%,2,2,0.00%
ns106.websitewelcome.com,0,0.00%,2,2,0.00%
ns2.123-reg.co.uk,0,0.00%,4,4,0.00%
oslik.gowebdirect.com,0,0.00%,2,2,0.00%
ns.abdns.biz,0,0.00%,2,2,0.00%
ns2.novasishost.com,0,0.00%,2,2,0.00%
cpns2.turdns.com,0,0.00%,2,2,0.00%
ns1.hostingbay.net,0,0.00%,2,2,0.00%
ns.abdns.eu,0,0.00%,2,2,0.00%
ns2.neodigit.net,0,0.00%,2,2,0.00%
ns2.wpdns.com,0,0.00%,2,2,0.00%
ns2.fastpark.net,0,0.00%,4,4,0.00%
ns2.hostingbay.net,0,0.00%,2,2,0.00%
ns1.novasishost.com,0,0.00%,2,2,0.00%
ns1.fastpark.net,0,0.00%,4,4,0.00%
doh-ch.blahdns.com,0,0.00%,5,5,0.00%
ns1.wpdns.com,0,0.00%,2,2,0.00%
cpns1.turdns.com,0,0.00%,2,2,0.00%
shirt.dnspod.net,0,0.00%,2,2,0.00%
ns-1323.awsdns-37.org,0,0.00%,2,2,0.00%
valentin.ns.cloudflare.com,0,0.00%,2,2,0.00%
excellent.dnspod.net,0,0.00%,2,2,0.00%
ns-1897.awsdns-45.co.uk,0,0.00%,6,6,0.00%
ns1.neodigit.net,0,0.00%,2,2,0.00%
ns-400.awsdns-50.com,0,0.00%,2,2,0.00%
ns1.ajlconsult.com,0,0.00%,2,2,0.00%
ns-727.awsdns-26.net,0,0.00%,2,2,0.00%
fay.ns.cloudflare.com,0,0.00%,2,2,0.00%
maisie.ns.cloudflare.com,0,0.00%,2,2,0.00%
jobs.ns.cloudflare.com,0,0.00%,4,4,0.00%
christina.neostrada.nl,0,0.00%,2,2,0.00%
ns2.graweb.net,0,0.00%,2,2,0.00%
sandra.neostrada.nl,0,0.00%,2,2,0.00%
ns1.graweb.net,0,0.00%,2,2,0.00%
lisa.neostrada.nl,0,0.00%,2,2,0.00%
ns2.ajlconsult.com,0,0.00%,2,2,0.00%
ns734.hostgator.com,0,0.00%,2,2,0.00%
ns2.imcloud.org,0,0.00%,2,2,0.00%
ns1.imcloud.org,0,0.00%,2,2,0.00%
40.push2his.eastmoney.com,0,0.00%,2,2,0.00%
s.ns.arvancdn.com,0,0.00%,2,2,0.00%
g.ns.arvancdn.com,0,0.00%,4,4,0.00%
t.17986.net,0,0.00%,2,2,0.00%
38.push2his.eastmoney.com,0,0.00%,4,4,0.00%
45.push2his.eastmoney.com,0,0.00%,2,2,0.00%
ns0.e-digitalhosting.net,0,0.00%,2,2,0.00%
dns11.servidoresdns.net,0,0.00%,2,2,0.00%
ns1.e-digitalhosting.net,0,0.00%,2,2,0.00%
77.newspush.eastmoney.com,0,0.00%,2,2,0.00%
ns2.fvos.com,0,0.00%,2,2,0.00%
dns12.servidoresdns.net,0,0.00%,2,2,0.00%
simpleauthority.com,0,0.00%,2,2,0.00%
94.newspush.eastmoney.com,0,0.00%,2,2,0.00%
57.newspush.eastmoney.com,0,0.00%,2,2,0.00%
26.push2.eastmoney.com,0,0.00%,2,2,0.00%
7.push2his.eastmoney.com,0,0.00%,2,2,0.00%
70.push2.eastmoney.com,0,0.00%,2,2,0.00%
ns1.herohosty.xyz,0,0.00%,2,2,0.00%
ns1.fvos.com,0,0.00%,2,2,0.00%
alexia.ns.cloudflare.com,0,0.00%,2,2,0.00%
nash.ns.cloudflare.com,0,0.00%,4,4,0.00%
91.newspush.eastmoney.com,0,0.00%,2,2,0.00%
dns2.etonic.net,0,0.00%,2,2,0.00%
jinkunboli.com,0,0.00%,2,2,0.00%
85.push2.eastmoney.com,0,0.00%,2,2,0.00%
35.push2.eastmoney.com,0,0.00%,2,2,0.00%
dns1.etonic.net,0,0.00%,2,2,0.00%
92.newspush.eastmoney.com,0,0.00%,2,2,0.00%
28.newspush.eastmoney.com,0,0.00%,2,2,0.00%
98.push2.eastmoney.com,0,0.00%,2,2,0.00%
73.push2.eastmoney.com,0,0.00%,2,2,0.00%
ns2.caravan-epub.com,0,0.00%,2,2,0.00%
ns.caravan-epub.com,0,0.00%,2,2,0.00%
95.newspush.eastmoney.com,0,0.00%,2,2,0.00%
44.newspush.eastmoney.com,0,0.00%,2,2,0.00%
72.newspush.eastmoney.com,0,0.00%,2,2,0.00%
21.newspush.eastmoney.com,0,0.00%,2,2,0.00%
65.newspush.eastmoney.com,0,0.00%,2,2,0.00%
dns3.warnahost.net,0,0.00%,2,2,0.00%
ns2.outstandingdesigner.com,0,0.00%,2,2,0.00%
ns.123-reg.co.uk,0,0.00%,4,4,0.00%
shenshengjiao.com,0,0.00%,2,2,0.00%
dns2.warnahost.net,0,0.00%,2,2,0.00%
NS4.IRANDNS.com,0,0.00%,2,2,0.00%
dns1.comunidades.net,0,0.00%,2,2,0.00%
ns-1020.awsdns-63.net,0,0.00%,2,2,0.00%
NS3.IRANDNS.com,0,0.00%,2,2,0.00%
ns1.gruphost.es,0,0.00%,2,2,0.00%
ns2.temizisim.com,0,0.00%,2,2,0.00%
ns1.md-in-32.webhostbox.net,0,0.00%,2,2,0.00%
dns.dns4.de,0,0.00%,2,2,0.00%
ernest.ns.cloudflare.com,0,0.00%,2,2,0.00%
ns79.hostgator.mx,0,0.00%,2,2,0.00%
ns2.sumejorweb.com,0,0.00%,2,2,0.00%
y.ns.arvancdn.net,0,0.00%,2,2,0.00%
ns78.hostgator.mx,0,0.00%,2,2,0.00%
ns1028.ui-dns.biz,0,0.00%,2,2,0.00%
ns1116.ui-dns.com,0,0.00%,2,2,0.00%
ns3.cloudoon.org,0,0.00%,2,2,0.00%
ns-1836.awsdns-37.co.uk,0,0.00%,2,2,0.00%
ns-206-b.gandi.net,0,0.00%,2,2,0.00%
ns1.cloudoon.com,0,0.00%,2,2,0.00%
ns2.sedopark.net,0,0.00%,2,2,0.00%
ns2.medyabim.com,0,0.00%,2,2,0.00%
ns1114.ui-dns.biz,0,0.00%,4,4,0.00%
ns2.cloudoon.net,0,0.00%,2,2,0.00%
ns1.medyabim.com,0,0.00%,2,2,0.00%
ns1.sedopark.net,0,0.00%,2,2,0.00%
ns1049.ui-dns.de,0,0.00%,2,2,0.00%
ns3.shockmedia.nl,0,0.00%,2,2,0.00%
ns2.dandomain.dk,0,0.00%,2,2,0.00%
ns-12-c.gandi.net,0,0.00%,2,2,0.00%
dax.ns.cloudflare.com,0,0.00%,2,2,0.00%
ns-1147.awsdns-15.org,0,0.00%,2,2,0.00%
ns-1945.awsdns-51.co.uk,0,0.00%,2,2,0.00%
prvh1047.presinet.ne.jp,0,0.00%,2,2,0.00%
ns-757.awsdns-30.net,0,0.00%,2,2,0.00%
ns-212-a.gandi.net,0,0.00%,4,4,0.00%
ns-86.awsdns-10.com,0,0.00%,2,2,0.00%
ns1682.webempresa.eu,0,0.00%,2,2,0.00%
dnsx32.onmydns.com,0,0.00%,2,2,0.00%
ns1681.webempresa.eu,0,0.00%,2,2,0.00%
dnsx31.onmydns.com,0,0.00%,2,2,0.00%
ns1.taplink.cc,0,0.00%,2,2,0.00%
arambagtv.com,0,0.00%,2,2,0.00%
blob.bnz13prdstr11a.store.core.windows.NET,0,0.00%,2,2,0.00%
ns2.nexcess.net,0,0.00%,2,2,0.00%
ns3.hostingmadeeasy.com,0,0.00%,2,2,0.00%
ns1dhq.name.com,0,0.00%,2,2,0.00%
ns-1357.awsdns-41.org,0,0.00%,2,2,0.00%
ns1.sectigoweb.com,0,0.00%,2,2,0.00%
ns2.sectigoweb.com,0,0.00%,2,2,0.00%
anneelitemizlik.com,0,0.00%,2,2,0.00%
salvador.ns.porkbun.com,0,0.00%,2,2,0.00%
ns2.akkyservicios.mx,0,0.00%,2,2,0.00%
ns3.sectigoweb.com,0,0.00%,2,2,0.00%
ns1.antistressskvish.com,0,0.00%,2,2,0.00%
ns4.sectigoweb.com,0,0.00%,2,2,0.00%
ns1.namecity.com,0,0.00%,2,2,0.00%
annurpamijahan.com,0,0.00%,2,2,0.00%
elly.ns.cloudflare.com,0,0.00%,4,4,0.00%
ns1103.ui-dns.de,0,0.00%,4,4,0.00%
dns164.a.register.com,0,0.00%,2,2,0.00%
ns4.hiperbilisim.com,0,0.00%,2,2,0.00%
ns1064.ui-dns.org,0,0.00%,4,4,0.00%
ns27.websitewelcome.com,0,0.00%,2,2,0.00%
ns4250.hostgator.com,0,0.00%,2,2,0.00%
ns2.bdmi.net,0,0.00%,4,4,0.00%
rihana.ns.cloudflare.com,0,0.00%,2,2,0.00%
ns1085.ui-dns.com,0,0.00%,2,2,0.00%
ns2.mireene.com,0,0.00%,2,2,0.00%
5068.dns3.managedns.org,0,0.00%,2,2,0.00%
ns1062.ui-dns.biz,0,0.00%,4,4,0.00%
ns2.aotokawara.com,0,0.00%,2,2,0.00%
ns2.mazinhost.net,0,0.00%,2,2,0.00%
5068.dns4.managedns.org,0,0.00%,2,2,0.00%
ns4.cogservers.com,0,0.00%,2,2,0.00%
num9.test-cdn77.xyz,0,0.00%,2,2,0.00%
dns4.hitme.net.pl,0,0.00%,2,2,0.00%
ns56.worldnic.com,0,0.00%,2,2,0.00%
ns7052.webempresa.eu,0,0.00%,2,2,0.00%
ns55.worldnic.com,0,0.00%,2,2,0.00%
ns3.cogservers.com,0,0.00%,2,2,0.00%
5068.dns1.managedns.org,0,0.00%,2,2,0.00%
ns-1752.awsdns-27.co.uk,0,0.00%,2,2,0.00%
ns-1048.awsdns-03.org,0,0.00%,2,2,0.00%
ns-53.awsdns-06.com,0,0.00%,2,2,0.00%
antrithanhpro.com,0,0.00%,2,2,0.00%
capella.dnspod.net,0,0.00%,2,2,0.00%
dns3.hitme.net.pl,0,0.00%,2,2,0.00%
ns1.ada.net.tr,0,0.00%,2,2,0.00%
cherry.dnspod.net,0,0.00%,2,2,0.00%
ns-527.awsdns-01.net,0,0.00%,2,2,0.00%
5068.dns2.managedns.org,0,0.00%,2,2,0.00%
curitiba.ns.porkbun.com,0,0.00%,2,2,0.00%
ns4.alexhost.md,0,0.00%,2,2,0.00%
fortaleza.ns.porkbun.com,0,0.00%,2,2,0.00%
ns3.alexhost.md,0,0.00%,2,2,0.00%
maceio.ns.porkbun.com,0,0.00%,2,2,0.00%
ns2.proserv.ge,0,0.00%,2,2,0.00%
ns7051.webempresa.eu,0,0.00%,2,2,0.00%
puertomarina2.sered.net,0,0.00%,2,2,0.00%
ns11.cunhost.cc,0,0.00%,2,2,0.00%
cdns2.controlpanel.si,0,0.00%,2,2,0.00%
ns1.cunhost.cc,0,0.00%,2,2,0.00%
ns2.bh-40.webhostbox.net,0,0.00%,2,2,0.00%
ns1.proserv.ge,0,0.00%,2,2,0.00%
ns1.anniecksbusiness.com,0,0.00%,2,2,0.00%
dns1.orbis.hr,0,0.00%,2,2,0.00%
dns2.orbis.hr,0,0.00%,2,2,0.00%
cdns1.controlpanel.si,0,0.00%,2,2,0.00%
ns1068.ui-dns.biz,0,0.00%,2,2,0.00%
ns1066.ui-dns.com,0,0.00%,2,2,0.00%
ns9.syskay.com,0,0.00%,2,2,0.00%
ns1099.ui-dns.de,0,0.00%,4,4,0.00%
ns1am.service-dns.net,0,0.00%,2,2,0.00%
www.ip3366.net,0,0.00%,2,2,0.00%
ns2am.service-dns.net,0,0.00%,2,2,0.00%
ns1.vultr.com,0,0.00%,2,2,0.00%
ns3am.service-dns.net,0,0.00%,2,2,0.00%
ns2.ahost.uz,0,0.00%,2,2,0.00%
ns2.anniecksbusiness.com,0,0.00%,2,2,0.00%
ns2.webhoxrentacar.com,0,0.00%,2,2,0.00%
ns1.webhoxrentacar.com,0,0.00%,2,2,0.00%
ns4021.websitewelcome.com,0,0.00%,2,2,0.00%
ns706.hostgator.com.br,0,0.00%,2,2,0.00%
ns2.bigscoots.com,0,0.00%,2,2,0.00%
puertomarina1.sered.net,0,0.00%,2,2,0.00%
dns05.yellchile.cl,0,0.00%,1,1,0.00%
aneeshaaariwork.com,0,0.00%,2,2,0.00%
ns331.hostgator.com.br,0,0.00%,2,2,0.00%
ns707.hostgator.com.br,0,0.00%,2,2,0.00%
ns267.hostgator.com.br,0,0.00%,2,2,0.00%
ns1.ahost.uz,0,0.00%,2,2,0.00%
ns02.yell.com.ar,0,0.00%,2,2,0.00%
ns2.bitdomain.biz,0,0.00%,2,2,0.00%
ns-1924.awsdns-48.co.uk,0,0.00%,2,2,0.00%
cns2052.hostgator.com,0,0.00%,2,2,0.00%
ns01.yell.com.ar,0,0.00%,2,2,0.00%
ns330.hostgator.com.br,0,0.00%,2,2,0.00%
ns1.ihsdnsx4.com,0,0.00%,2,2,0.00%
aihlbd.com,0,0.00%,2,2,0.00%
dns06.yellchile.cl,0,0.00%,1,1,0.00%
ns1028.hostgator.com.br,0,0.00%,2,2,0.00%
ns2.ehostingo.com,0,0.00%,4,4,0.00%
ns29.guzelhosting.com,0,0.00%,2,2,0.00%
ns2.aliasdns.net,0,0.00%,2,2,0.00%
ns1029.hostgator.com.br,0,0.00%,2,2,0.00%
ns2.ihsdnsx4.com,0,0.00%,2,2,0.00%
ns3.thehost.com.ua,0,0.00%,2,2,0.00%
ns1.myasp.jp,0,0.00%,2,2,0.00%
ns1.akkyservicios.mx,0,0.00%,2,2,0.00%
ns1.aliasdns.net,0,0.00%,2,2,0.00%
ns28.websitewelcome.com,0,0.00%,2,2,0.00%
kyree.ns.cloudflare.com,0,0.00%,2,2,0.00%
ns1.sdns.vn,0,0.00%,2,2,0.00%
ns3.aliasdns.net,0,0.00%,2,2,0.00%
blr2.fivecron.com,0,0.00%,2,2,0.00%
ns-1328.awsdns-38.org,0,0.00%,2,2,0.00%
ns40.qservers.net,0,0.00%,2,2,0.00%
ns1.ehostingo.com,0,0.00%,4,4,0.00%
ns2.sdns.vn,0,0.00%,2,2,0.00%
ns4.aliasdns.net,0,0.00%,2,2,0.00%
ns1086.ifastnet.com,0,0.00%,2,2,0.00%
ns1.thehost.com.ua,0,0.00%,2,2,0.00%
ns-1562.awsdns-03.co.uk,0,0.00%,2,2,0.00%
ns1.fastdns.in,0,0.00%,2,2,0.00%
ns-503.awsdns-62.com,0,0.00%,2,2,0.00%
ns-195-a.gandi.net,0,0.00%,2,2,0.00%
earl.ns.cloudflare.com,0,0.00%,4,4,0.00%
zelda.ns.cloudflare.com,0,0.00%,2,2,0.00%
u.ns.arvancdn.com,0,0.00%,2,2,0.00%
ns4.wehostwebserver.com,0,0.00%,2,2,0.00%
ns-1233.awsdns-26.org,0,0.00%,2,2,0.00%
dns105.a.register.com,0,0.00%,2,2,0.00%
ns1.anjalidmakeup.com,0,0.00%,2,2,0.00%
verification-5ea52816.ns3.dan.hosting,0,0.00%,2,2,0.00%
ns-794.awsdns-35.net,0,0.00%,2,2,0.00%
anmachkhangpro.com,0,0.00%,2,2,0.00%
ns2.thehost.com.ua,0,0.00%,2,2,0.00%
ns-1822.awsdns-35.co.uk,0,0.00%,2,2,0.00%
ns94.hostgator.mx,0,0.00%,2,2,0.00%
ns2.fastdns.in,0,0.00%,2,2,0.00%
ns2.yoursrs.com,0,0.00%,2,2,0.00%
ns-352.awsdns-44.com,0,0.00%,2,2,0.00%
ns266.hostgator.com.br,0,0.00%,2,2,0.00%
christina.ns.cloudflare.com,0,0.00%,2,2,0.00%
ns1cp46.zonasprivadasdns.com,0,0.00%,2,2,0.00%
ns1.yoursrs.com,0,0.00%,2,2,0.00%
ns-790.awsdns-34.net,0,0.00%,2,2,0.00%
ns95.hostgator.mx,0,0.00%,2,2,0.00%
ns2cp46.zonasprivadasdns.com,0,0.00%,2,2,0.00%
ns1.ioceans.in,0,0.00%,2,2,0.00%
ns8.musteridestek.net,0,0.00%,6,6,0.00%
ns-1089.awsdns-08.org,0,0.00%,2,2,0.00%
ns13.securecloud.co.in,0,0.00%,2,2,0.00%
ns1.tn.oxa.host,0,0.00%,2,2,0.00%
ns1.nexcess.net,0,0.00%,2,2,0.00%
DNS2.GIGSHOST.NET,0,0.00%,2,2,0.00%
ns14.securecloud.co.in,0,0.00%,2,2,0.00%
ns-208-c.gandi.net,0,0.00%,2,2,0.00%
ns3.wehostwebserver.com,0,0.00%,2,2,0.00%
ns-423.awsdns-52.com,0,0.00%,2,2,0.00%
ns4.nexcess.net,0,0.00%,2,2,0.00%
ns6228.hostgator.com,0,0.00%,2,2,0.00%
ns57.sellvir.com,0,0.00%,2,2,0.00%
ns-820.awsdns-38.net,0,0.00%,2,2,0.00%
ns1.mail.testlab.mx,0,0.00%,2,2,0.00%
ns-1375.awsdns-43.org,0,0.00%,2,2,0.00%
ns3.nexcess.net,0,0.00%,2,2,0.00%
ns2.v2nets.com,0,0.00%,2,2,0.00%
ns-1708.awsdns-21.co.uk,0,0.00%,2,2,0.00%
ns-947.awsdns-54.net,0,0.00%,2,2,0.00%
ns1.ourklient.com,0,0.00%,2,2,0.00%
ns53.d9hosting.com,0,0.00%,2,2,0.00%
ns-438.awsdns-54.com,0,0.00%,2,2,0.00%
ns1.v2nets.com,0,0.00%,2,2,0.00%
ns2.ourklient.com,0,0.00%,2,2,0.00%
ns58.sellvir.com,0,0.00%,2,2,0.00%
ns2.mail.testlab.mx,0,0.00%,2,2,0.00%
ns4.ourklient.com,0,0.00%,2,2,0.00%
ns-1034.awsdns-01.org,0,0.00%,2,2,0.00%
basketball.dnspod.net,0,0.00%,4,4,0.00%
ns4.jimatdns.com,0,0.00%,2,2,0.00%
langston.ns.cloudflare.com,0,0.00%,2,2,0.00%
ns-383.awsdns-47.com,0,0.00%,2,2,0.00%
ns9.pcdog.ch,0,0.00%,2,2,0.00%
ns3.jimatdns.com,0,0.00%,2,2,0.00%
ns2.kylos.pl,0,0.00%,2,2,0.00%
ns1031.websiteservername.com,0,0.00%,2,2,0.00%
norah.ns.cloudflare.com,0,0.00%,2,2,0.00%
ns-525.awsdns-01.net,0,0.00%,2,2,0.00%
ns2.md-87.webhostbox.net,0,0.00%,2,2,0.00%
ns1.101domain.com,0,0.00%,2,2,0.00%
ns-205.awsdns-25.com,0,0.00%,2,2,0.00%
ns1032.websiteservername.com,0,0.00%,2,2,0.00%
ns6.pcdog.ch,0,0.00%,2,2,0.00%
ns1.kylos.pl,0,0.00%,2,2,0.00%
cns2051.hostgator.com,0,0.00%,2,2,0.00%
ns2.ht-systems.ru,0,0.00%,2,2,0.00%
ns8.mazinhost.net,0,0.00%,2,2,0.00%
ns8.integralwebsolution.com,0,0.00%,2,2,0.00%
ns1.mazinhost.net,0,0.00%,2,2,0.00%
ns7.mazinhost.net,0,0.00%,2,2,0.00%
ns7.integralwebsolution.com,0,0.00%,2,2,0.00%
dns.bizcn.com,0,0.00%,1,1,0.00%
ns2.appliednetwork1.com,0,0.00%,2,2,0.00%
rili.update.updrv.com,0,0.00%,2,2,0.00%
18.push2his.eastmoney.com,0,0.00%,2,2,0.00%
14.push2his.eastmoney.com,0,0.00%,2,2,0.00%
guxiuwu.net,0,0.00%,1,1,0.00%
ns4cjp.name.com,0,0.00%,2,2,0.00%
ns-204-c.gandi.net,0,0.00%,2,2,0.00%
ns2.svpdns.com,0,0.00%,2,2,0.00%
55.push2his.eastmoney.com,0,0.00%,2,2,0.00%
ns8.brownservers.xyz,0,0.00%,2,2,0.00%
ns18.worldnic.com,0,0.00%,2,2,0.00%
btwwth.net,0,0.00%,2,2,0.00%
ns5.webhostbd.net,0,0.00%,2,2,0.00%
bloom-bookkeeping.net,0,0.00%,2,2,0.00%
ns6.webhostbd.net,0,0.00%,2,2,0.00%
ns19.inhostedns.com,0,0.00%,2,2,0.00%
ns-1829.awsdns-36.co.uk,0,0.00%,2,2,0.00%
ns-238-a.gandi.net,0,0.00%,2,2,0.00%
ns1.svpdns.com,0,0.00%,2,2,0.00%
ns2.ojenik.com,0,0.00%,2,2,0.00%
ns29.inhostedns.net,0,0.00%,2,2,0.00%
ns1fkl.name.com,0,0.00%,2,2,0.00%
48.push2his.eastmoney.com,0,0.00%,2,2,0.00%
harlan.dnspod.net,0,0.00%,2,2,0.00%
redbusprimarydns.britishforeignoffice.net,0,0.00%,2,2,0.00%
ns1120.ui-dns.com,0,0.00%,2,2,0.00%
ns2nsy.name.com,0,0.00%,2,2,0.00%
vole.dnspod.net,0,0.00%,2,2,0.00%
ns2.mydataknox.com,0,0.00%,2,2,0.00%
ns2.educdtm.net,0,0.00%,2,2,0.00%
ns1031.ui-dns.biz,0,0.00%,2,2,0.00%
ns39.inhostedns.org,0,0.00%,2,2,0.00%
ns1.educdtm.net,0,0.00%,2,2,0.00%
ns71.worldnic.com,0,0.00%,2,2,0.00%
ezra.ns.cloudflare.com,0,0.00%,2,2,0.00%
ns72.worldnic.com,0,0.00%,2,2,0.00%
ns1.mydataknox.com,0,0.00%,2,2,0.00%
dns310.rayanegarco.com,0,0.00%,2,2,0.00%
ns-1084.awsdns-07.org,0,0.00%,2,2,0.00%
ns-853.awsdns-42.net,0,0.00%,2,2,0.00%
ns1.depro6.fcomet.com,0,0.00%,2,2,0.00%
ns2.depro6.fcomet.com,0,0.00%,2,2,0.00%
datura.dnspod.net,0,0.00%,2,2,0.00%
elma.ns.cloudflare.com,0,0.00%,2,2,0.00%
bob.dnspod.net,0,0.00%,2,2,0.00%
ns-540.awsdns-03.net,0,0.00%,2,2,0.00%
ns89.worldnic.com,0,0.00%,2,2,0.00%
ns90.worldnic.com,0,0.00%,2,2,0.00%
abbcobassessoria.net,0,0.00%,2,2,0.00%
abbcob.net,0,0.00%,2,2,0.00%
ns-u342oau3ed.dnswnd.eu,0,0.00%,2,2,0.00%
ns1068.ui-dns.org,0,0.00%,2,2,0.00%
ns-qh4a00qhgd.dnswnd.be,0,0.00%,2,2,0.00%
ns-1437.awsdns-51.org,0,0.00%,2,2,0.00%
ns-nlhexwnlfd.dnswnd.de,0,0.00%,2,2,0.00%
ns-1611.awsdns-09.co.uk,0,0.00%,2,2,0.00%
ns1qsy.name.com,0,0.00%,2,2,0.00%
ns2dky.name.com,0,0.00%,2,2,0.00%
ns1044.hostgator.com.br,0,0.00%,2,2,0.00%
jill.ns.cloudflare.com,0,0.00%,2,2,0.00%
ns1.blacknightdns.com,0,0.00%,2,2,0.00%
ns1045.hostgator.com.br,0,0.00%,2,2,0.00%
ns2.upperserver29.com,0,0.00%,2,2,0.00%
ns2.blacknightdns.com,0,0.00%,2,2,0.00%
meiyuwenhua.net,0,0.00%,1,1,0.00%
ns3.blacknightdns.com,0,0.00%,2,2,0.00%
ns300.kenyawebexperts.co.ke,0,0.00%,2,2,0.00%
maria.ns.cloudflare.com,0,0.00%,2,2,0.00%
dnswordpress100b.trouble-free.net,0,0.00%,2,2,0.00%
ns-149-b.gandi.net,0,0.00%,2,2,0.00%
qyskills.net,0,0.00%,1,1,0.00%
ns-194-b.gandi.net,0,0.00%,2,2,0.00%
dnswordpress100a.trouble-free.net,0,0.00%,2,2,0.00%
ns299.kenyawebexperts.co.ke,0,0.00%,2,2,0.00%
ns4.blacknightdns.com,0,0.00%,2,2,0.00%
suspension2.mydomainprovider.com,0,0.00%,4,4,0.00%
suspension1.mydomainprovider.com,0,0.00%,4,4,0.00%
dell.ns.cloudflare.com,0,0.00%,2,2,0.00%
ns-2-b.gandi.net,0,0.00%,2,2,0.00%
ns-50-c.gandi.net,0,0.00%,2,2,0.00%
baatbangai.net,0,0.00%,2,2,0.00%
ns-74-a.gandi.net,0,0.00%,2,2,0.00%
ns2.secureweb.vn,0,0.00%,2,2,0.00%
yicelue.net,0,0.00%,1,1,0.00%
pltraffic7.com,0,0.00%,2,2,0.00%
xianyuhao.net,0,0.00%,1,1,0.00%
zac.ns.cloudflare.com,0,0.00%,2,2,0.00%
ns1jlp.name.com,0,0.00%,2,2,0.00%
breadandbutters.net,0,0.00%,2,2,0.00%
pc-api.wondershare.cc,0,0.00%,2,2,0.00%
baatbangaee.net,0,0.00%,2,2,0.00%
ns2.bh-68.webhostbox.net,0,0.00%,2,2,0.00%
aspenkids.net,0,0.00%,2,2,0.00%
ns1.bh-68.webhostbox.net,0,0.00%,2,2,0.00%
jombercuti.net,0,0.00%,2,2,0.00%
ns-209-a.gandi.net,0,0.00%,2,2,0.00%
cris.ns.cloudflare.com,0,0.00%,2,2,0.00%
ns1.mc-host24.de,0,0.00%,2,2,0.00%
ns2.mc-host24.de,0,0.00%,2,2,0.00%
porter.ns.cloudflare.com,0,0.00%,2,2,0.00%
ns1089.ui-dns.org,0,0.00%,2,2,0.00%
ns1.raahbar.com,0,0.00%,2,2,0.00%
ns1.reselling.services,0,0.00%,2,2,0.00%
ns1033.ui-dns.com,0,0.00%,2,2,0.00%
ns2.reselling.services,0,0.00%,2,2,0.00%
ns1125.ui-dns.com,0,0.00%,2,2,0.00%
ns1.hdedi-xlogic2600.org,0,0.00%,2,2,0.00%
ns3.raahbar.com,0,0.00%,2,2,0.00%
ns2.hdedi-xlogic2600.org,0,0.00%,2,2,0.00%
ns2.raahbar.com,0,0.00%,2,2,0.00%
b.dnspod.com,0,0.00%,2,2,0.00%
50-0.net,0,0.00%,1,1,0.00%
chan.ns.cloudflare.com,0,0.00%,2,2,0.00%
ns9.lwsdns.com,0,0.00%,2,2,0.00%
thebulger.net,0,0.00%,2,2,0.00%
dbet365-03.internet7.cc,0,0.00%,2,2,0.00%
ns1013.websitewelcome.com,0,0.00%,2,2,0.00%
pkueducn-my.sharepoint.com,0,0.00%,2,2,0.00%
ns1014.websitewelcome.com,0,0.00%,2,2,0.00%
ns2.cloudswired.com,0,0.00%,2,2,0.00%
ns0.lcn.com,0,0.00%,2,2,0.00%
ns1033.ui-dns.org,0,0.00%,2,2,0.00%
dbet365-03.internet7.vip,0,0.00%,2,2,0.00%
quincy.ns.cloudflare.com,0,0.00%,2,2,0.00%
rosalyn.ns.cloudflare.com,0,0.00%,2,2,0.00%
ns1.cloudswired.com,0,0.00%,2,2,0.00%
northeast.dnspod.net,0,0.00%,2,2,0.00%
ns1.lcn.com,0,0.00%,2,2,0.00%
ns3.websupport.sk,0,0.00%,2,2,0.00%
ns2.lcn.com,0,0.00%,2,2,0.00%
hugo.dnspod.net,0,0.00%,2,2,0.00%
ns9.hostmar.com,0,0.00%,2,2,0.00%
alicorp-pe.com,0,0.00%,2,2,0.00%
saw.dnspod.net,0,0.00%,2,2,0.00%
paislee.ns.cloudflare.com,0,0.00%,2,2,0.00%
ns2.prezent.de,0,0.00%,2,2,0.00%
ns1.webhostingireland.ie,0,0.00%,2,2,0.00%
ns3.dnsv2.com,0,0.00%,2,2,0.00%
vda3700a.trouble-free.net,0,0.00%,2,2,0.00%
nspro48.hostgator.com.br,0,0.00%,2,2,0.00%
ns.onebit.cz,0,0.00%,2,2,0.00%
gary.dnspod.net,0,0.00%,2,2,0.00%
vda3700b.trouble-free.net,0,0.00%,2,2,0.00%
nspro49.hostgator.com.br,0,0.00%,2,2,0.00%
ns57.maxdominios.com,0,0.00%,2,2,0.00%
ns3.prezent-internet.com,0,0.00%,2,2,0.00%
ns.onebit.eu,0,0.00%,2,2,0.00%
carioca.ns.cloudflare.com,0,0.00%,2,2,0.00%
ns1.prezent.nl,0,0.00%,2,2,0.00%
sole.dnspod.net,0,0.00%,2,2,0.00%
rns43.webhostbox.net,0,0.00%,2,2,0.00%
rns44.webhostbox.net,0,0.00%,2,2,0.00%
ignat.ns.cloudflare.com,0,0.00%,2,2,0.00%
ns.onebit.org,0,0.00%,2,2,0.00%
ns8040.hostgator.com,0,0.00%,2,2,0.00%
ns4.webhostingireland.eu,0,0.00%,2,2,0.00%
ns8039.hostgator.com,0,0.00%,2,2,0.00%
dns42.servidoresdns.net,0,0.00%,2,2,0.00%
reza.ns.cloudflare.com,0,0.00%,2,2,0.00%
dns41.servidoresdns.net,0,0.00%,2,2,0.00%
ns2.websupport.sk,0,0.00%,2,2,0.00%
ns2.webhostingireland.ie,0,0.00%,2,2,0.00%
ns2.dnsmisitio.net,0,0.00%,2,2,0.00%
ns3.dnsmisitio.net,0,0.00%,2,2,0.00%
ns1.dnsmisitio.net,0,0.00%,2,2,0.00%
ns0.reflected.net,0,0.00%,2,2,0.00%
ns1.reflected.net,0,0.00%,2,2,0.00%
dns082.a.register.com,0,0.00%,2,2,0.00%
ns2.dotroll.com,0,0.00%,2,2,0.00%
ns1.dotroll.com,0,0.00%,2,2,0.00%
ns12.globehosting.net,0,0.00%,2,2,0.00%
ns2.taipandns.com,0,0.00%,2,2,0.00%
parking3.dnstool.net,0,0.00%,2,2,0.00%
trinityrealestatebrokers.com,0,0.00%,2,2,0.00%
ns1102.ui-dns.com,0,0.00%,2,2,0.00%
ns11.globehosting.net,0,0.00%,2,2,0.00%
verification-j04qet0h.ns3.dan.hosting,0,0.00%,2,2,0.00%
zebra.dnspod.net,0,0.00%,2,2,0.00%
ns-118.awsdns-14.com,0,0.00%,2,2,0.00%
dnsiix2.qwords.net,0,0.00%,2,2,0.00%
ns-1524.awsdns-62.org,0,0.00%,2,2,0.00%
gardenia.dnspod.net,0,0.00%,2,2,0.00%
ns-1572.awsdns-04.co.uk,0,0.00%,2,2,0.00%
ns-993.awsdns-60.net,0,0.00%,2,2,0.00%
dns2.qwords.id,0,0.00%,2,2,0.00%
dnsiix1.qwords.net,0,0.00%,2,2,0.00%
ns1.rootservers.co,0,0.00%,2,2,0.00%
ns162.hostingraja.org,0,0.00%,2,2,0.00%
hedda.dnspod.net,0,0.00%,2,2,0.00%
ns161.hostingraja.org,0,0.00%,2,2,0.00%
popcorn.dnspod.net,0,0.00%,2,2,0.00%
dns35.skphost.net,0,0.00%,2,2,0.00%
ns8253.hostgator.com,0,0.00%,2,2,0.00%
snp2yx9.mgm8090cne.com,0,0.00%,2,2,0.00%
ns1.webcane.com,0,0.00%,2,2,0.00%
ns1.wpworld-io.com,0,0.00%,2,2,0.00%
ns8254.hostgator.com,0,0.00%,2,2,0.00%
dns36.skphost.net,0,0.00%,2,2,0.00%
ns2.hostnext.net,0,0.00%,2,2,0.00%
ns1.hostnext.net,0,0.00%,2,2,0.00%
ns2.webcane.com,0,0.00%,2,2,0.00%
stand.dnspod.net,0,0.00%,2,2,0.00%
ns2.wpworld-io.com,0,0.00%,2,2,0.00%
fish.dnspod.net,0,0.00%,2,2,0.00%
ns3.wpworld-io.com,0,0.00%,2,2,0.00%
ns2.rootservers.co,0,0.00%,2,2,0.00%
ns4.wpworld-io.com,0,0.00%,2,2,0.00%
ns2.mailplug.com,0,0.00%,2,2,0.00%
ns.mailplug.com,0,0.00%,2,2,0.00%
securityapi.d3-pr-tm.com,0,0.00%,2,2,0.00%
mmstat.ucweb.com,0,0.00%,6,6,0.00%
wow-upgrade.uc.cn,0,0.00%,6,6,0.00%
kr10.graniterapids.com,0,0.00%,2,2,0.00%
2345.hao715.com,0,0.00%,6,6,0.00%
browser.qq.com,0,0.00%,10,10,0.00%
hao123.xiuchufang.com,0,0.00%,6,6,0.00%
clients.browser.qq.com,0,0.00%,10,10,0.00%
s4.cnzz.com,0,0.00%,10,10,0.00%
z3.cnzz.com,0,0.00%,10,10,0.00%
tpush.html5.qq.com,0,0.00%,6,6,0.00%
update.browser.qq.com,0,0.00%,6,6,0.00%
qwer1231232020.github.io,0,0.00%,1,1,0.00%
uatracker.net,0,0.00%,4,4,0.00%
nk5x-jj46gxz.autbxpcje.gq,0,0.00%,1,1,0.00%
pdlxf-doctor.qq.com,0,0.00%,2,2,0.00%
cfg.xf.qq.com,0,0.00%,2,2,0.00%
xf-com-update-doctor.qq.com,0,0.00%,2,2,0.00%
local-p2p.qq.com,0,0.00%,2,2,0.00%
dtrp.url-quality.qq.com,0,0.00%,2,2,0.00%
mini-update.xf.qq.com,0,0.00%,2,2,0.00%
fs-conn-back-doctor.qq.com,0,0.00%,2,2,0.00%
fs-conn-doctor.qq.com,0,0.00%,2,2,0.00%
fs-conn-other-doctor.qq.com,0,0.00%,2,2,0.00%
url-quality-stat.xf.qq.com,0,0.00%,2,2,0.00%
fs-tcp-conn-doctor.qq.com,0,0.00%,2,2,0.00%
stun.qq.com,0,0.00%,2,2,0.00%
xf.stat-doctor.qq.com,0,0.00%,2,2,0.00%
xuanfengnet.qq.com,0,0.00%,2,2,0.00%
tr.fuckbitcoin.xyz,0,0.00%,3,3,0.00%
tw04.graniterapids.com,0,0.00%,2,2,0.00%
cn.mclean.50union.com,0,0.00%,4,4,0.00%
tehconnection.eu,0,0.00%,2,2,0.00%
h9imt8jv.sched.d0.tdnsdp1.cn,0,0.00%,2,2,0.00%
tr.burnabyhighstar.com,0,0.00%,2,2,0.00%
abufinzio.monocul.us,0,0.00%,2,2,0.00%
tr.doogh.club,0,0.00%,4,4,0.00%
www.goubanjia.com,0,0.00%,2,2,0.00%
free.kuaidaili.com,0,0.00%,2,2,0.00%
krsk01.graniterapids.com,0,0.00%,2,2,0.00%
rc10-fc01.oray.com,0,0.00%,2,2,0.00%
appimg.dbankcdn.com.c.cdnhwc1.com,0,0.00%,2,2,0.00%
appsec.hicloud.com,0,0.00%,4,4,0.00%
h5.do889.com,0,0.00%,279,279,0.00%
passport.m3guo.com,0,0.00%,30,30,0.00%
ssc.mohrss.gov.cn,0,0.00%,2,2,0.00%
cdn1.dcloud.net.cn,0,0.00%,2,2,0.00%
card.wecity.qq.com,0,0.00%,2,2,0.00%
wechat.wecity.qq.com,0,0.00%,2,2,0.00%
u18iqiyipic.sched.skalego-dk.tdnsstic1.cn.cjt.vwnti.yrzhcloud.cn,0,0.00%,2,2,0.00%
capi.mwee.cn,0,0.00%,2,2,0.00%
grs.hicloud.com,0,0.00%,2,2,0.00%
smartsms.vivo.com.cn,0,0.00%,7,7,0.00%
pendant-browser.vivo.com.cn,0,0.00%,8,8,0.00%
api.kunyu77.com,0,0.00%,2,2,0.00%
canvas.gdt.qq.com,0,0.00%,4,4,0.00%
cache.json.icu,0,0.00%,3,3,0.00%
tmge.alicdn.com,0,0.00%,2,2,0.00%
m-ali.ykimg.com,0,0.00%,4,4,0.00%
ems.youku.com,0,0.00%,2,2,0.00%
ipm.atm.youku.com,0,0.00%,2,2,0.00%
xpis-xcdn.youku.com,0,0.00%,3,3,0.00%
amdc.m.youku.com,0,0.00%,2,2,0.00%
youku-acs.m.taobao.com,0,0.00%,2,2,0.00%
log2.cmpassport.com,0,0.00%,2,2,0.00%
ups.youku.com,0,0.00%,2,2,0.00%
s-ybd.youku.com,0,0.00%,2,2,0.00%
pns.alicdn.com,0,0.00%,2,2,0.00%
push.m.youku.com,0,0.00%,6,6,0.00%
acs4baichuan.m.taobao.com,0,0.00%,2,2,0.00%
m.atm.youku.com,0,0.00%,2,2,0.00%
ykad-data.youku.com,0,0.00%,2,2,0.00%
adashx.ut.youku.com,0,0.00%,2,2,0.00%
image.planet.youku.com,0,0.00%,8,8,0.00%
apiv4-iyes.youku.com,0,0.00%,2,2,0.00%
loggw.alipay.com.cn,0,0.00%,2,2,0.00%
brpnrt.stsdk.vivo.com.cn,0,0.00%,2,2,0.00%
ws2.leetcode.cn,0,0.00%,9,9,0.00%
thekushagra.github.io,0,0.00%,1,1,0.00%
api.qiumibao.com,0,0.00%,2,2,0.00%
bifen.qiumibao.com,0,0.00%,2,2,0.00%
tongji.qiumibao.com,0,0.00%,2,2,0.00%
count.apicloud-saas.com,0,0.00%,4,4,0.00%
dns.hostux.net,0,0.00%,4,4,0.00%
svn6.apicloud.com,0,0.00%,4,4,0.00%
eus.cvte.com,0,0.00%,3,3,0.00%
mserver.link,0,0.00%,2,2,0.00%
cws.connectedpdf.com,0,0.00%,2,2,0.00%
www.360.cn,0,0.00%,2,2,0.00%
hao.360.cn,0,0.00%,2,2,0.00%
www.haosou.com,0,0.00%,2,2,0.00%
haosou.com,0,0.00%,2,2,0.00%
m.haosou.com,0,0.00%,4,4,0.00%
charles.mydarkcloud.info,0,0.00%,3,3,0.00%
discovery-v4-4.syncthing.net,0,0.00%,2,2,0.00%
authnz.mathworks.com,0,0.00%,4,4,0.00%
oe2203.oepkgs.cn,0,0.00%,2,2,0.00%
repo.openeuler.org,0,0.00%,20,20,0.00%
notifications.mathworks.com,0,0.00%,2,2,0.00%
tracker.4.babico.name.tr,0,0.00%,2,2,0.00%
463b21bf-i.andns.co,0,0.00%,2,2,0.00%
tnsvmts.qqngzh.xyz,0,0.00%,1,1,0.00%
app-a01.lp1.npns.srv.nintendo.net,0,0.00%,2,2,0.00%
clientnotification-userprodea1-6.servicebus.windows.net,0,0.00%,2,2,0.00%
down-cdn.dingtalk.com,0,0.00%,1,1,0.00%
loggw-extiny.alipay.com,0,0.00%,1,1,0.00%
bdc.ghzrzyw.beijing.gov.cn,0,0.00%,1,1,0.00%
swr.cn-north-4.myhuaweicloud.com,0,0.00%,1,1,0.00%
math.stackexchange.com,0,0.00%,1,1,0.00%
fecdn4.zhaopin.cn,0,0.00%,1,1,0.00%
0.rhel.pool.ntp.org,0,0.00%,1,1,0.00%
bjt.beijing.gov.cn,0,0.00%,1,1,0.00%
perf.m.jd.com,0,0.00%,1,1,0.00%
cache.video.iqiyi.com,0,0.00%,4,4,0.00%
s.search.bilibili.com,0,0.00%,8,8,0.00%
manga.bilibili.com,0,0.00%,1,1,0.00%
search.bilibili.com,0,0.00%,4,4,0.00%
access.if.iqiyi.com,0,0.00%,3,3,0.00%
aloc-offline.amap.com,0,0.00%,1,1,0.00%
analytics.vdo.ai,0,0.00%,3,3,0.00%
h5.vdo.ai,0,0.00%,2,2,0.00%
ncmsr.mars.baofeng.net,0,0.00%,2,2,0.00%
aclweb.org,0,0.00%,4,4,0.00%
www.ixa.eus,0,0.00%,3,3,0.00%
nlp.arizona.edu,0,0.00%,4,4,0.00%
clic.cimec.unitn.it,0,0.00%,3,3,0.00%
nlp.stanford.edu,0,0.00%,4,4,0.00%
ttic.uchicago.edu,0,0.00%,4,4,0.00%
www.mediawiki.org,0,0.00%,2,2,0.00%
www.aclweb.org,0,0.00%,2,2,0.00%
s95.cnzz.com,0,0.00%,1,1,0.00%
hiai-mars-drcn.emui.hicloud.com,0,0.00%,1,1,0.00%
pla-prod-sea-sb-ns-ingest-01.servicebus.windows.net,0,0.00%,1,1,0.00%
hc.tdm.qq.com,0,0.00%,1,1,0.00%
documentation.mailgun.com,0,0.00%,2,2,0.00%
docs.kroki.io,0,0.00%,2,2,0.00%
snowplowanalytics.com,0,0.00%,2,2,0.00%
gitpod.io,0,0.00%,2,2,0.00%
about.gitlab.com,0,0.00%,2,2,0.00%
docs.gitlab.com,0,0.00%,2,2,0.00%
forum.gitlab.com,0,0.00%,1,1,0.00%
v-2a384405.71edge.com,0,0.00%,2,2,0.00%
healthtrade-drcn.things.dbankcloud.com,0,0.00%,1,1,0.00%
operationposition-drcn.things.dbankcloud.com,0,0.00%,2,2,0.00%
sporthealth-drcn.dbankcdn.com,0,0.00%,1,1,0.00%
vcardmgt-drcn.wallet.hicloud.com,0,0.00%,1,1,0.00%
messagecenter.hicloud.com,0,0.00%,2,2,0.00%
healthcommon.hicloud.com,0,0.00%,2,2,0.00%
achievement.hicloud.com,0,0.00%,2,2,0.00%
trans-drcn.wallet.hicloud.com,0,0.00%,1,1,0.00%
wisedevice-drcn.things.hicloud.com,0,0.00%,4,4,0.00%
api.iqiyi.com,0,0.00%,2,2,0.00%
static.ptqy.gitv.tv,0,0.00%,1,1,0.00%
static.dns.ptqy.gitv.tv,0,0.00%,2,2,0.00%
tyaqy.m.cn.miaozhen.com,0,0.00%,3,3,0.00%
msga.cupid.iqiyi.com,0,0.00%,3,3,0.00%
v6-data.video.dns.iqiyi.com,0,0.00%,4,4,0.00%
browserconf.vivo.com.cn,0,0.00%,2,2,0.00%
wmapi-mt.meituan.com,0,0.00%,2,2,0.00%
waimaiucenter.meituan.com,0,0.00%,2,2,0.00%
vivopay.vivo.com.cn,0,0.00%,6,6,0.00%
gcort-stsdk.vivo.com.cn,0,0.00%,2,2,0.00%
cem.meituan.com,0,0.00%,2,2,0.00%
adreq.vivo.com.cn,0,0.00%,3,3,0.00%
ordercenter.meituan.com,0,0.00%,2,2,0.00%
signal-prod-signal-prod-rel-asse-signalr-primary-2.service.signalr.net,0,0.00%,2,2,0.00%
ort-stsdk.vivo.com.cn,0,0.00%,3,3,0.00%
appcontentapi.vivo.com.cn,0,0.00%,3,3,0.00%
isecure.vivo.com.cn,0,0.00%,3,3,0.00%
q-9999.q.dns.azurefd.NET,0,0.00%,1,1,0.00%
q-9999.standard.q-msedge.NET,0,0.00%,2,2,0.00%
signal-prod-signal-prod-rel-asse-signalr-primary-3.service.signalr.net,0,0.00%,2,2,0.00%
vcardsdkservice.vivo.com.cn,0,0.00%,3,3,0.00%
sdk.api.bjshcw.com,0,0.00%,5,5,0.00%
api.my.avira.com,0,0.00%,2,2,0.00%
appstoreort-stsdk.vivo.com.cn,0,0.00%,3,3,0.00%
data.ie.sogou.com,0,0.00%,3,3,0.00%
facepic.qidian.com,0,0.00%,3,3,0.00%
monitor.if.qidian.com,0,0.00%,3,3,0.00%
viav-cse.avlyun.com,0,0.00%,3,3,0.00%
v95-a.douyinvod.com,0,0.00%,1,1,0.00%
api-hl.amemv.com,0,0.00%,1,1,0.00%
v5-e.douyinvod.com,0,0.00%,1,1,0.00%
v5-f.douyinvod.com,0,0.00%,1,1,0.00%
v5.douyinvod.com,0,0.00%,1,1,0.00%
v9.douyinvod.com,0,0.00%,1,1,0.00%
a1818.dscg2.akamai.net,0,0.00%,1,1,0.00%
xmlconf.rcv.sandai.net,0,0.00%,1,1,0.00%
media.info.client.xunlei.com,0,0.00%,1,1,0.00%
download.code.lixian.vip.xunlei.com,0,0.00%,2,2,0.00%
plugin.xl7.xunlei.com,0,0.00%,1,1,0.00%
etl-xlmc-ssl.xunlei.com,0,0.00%,1,1,0.00%
static-xl9-ssl.xunlei.com,0,0.00%,1,1,0.00%
hubciddata.sandai.net,0,0.00%,1,1,0.00%
hub5pn.sandai.net,0,0.00%,25,25,0.00%
bz-sdk.open.extension.getui.com,0,0.00%,1,1,0.00%
dht.transmissionbt.com,0,0.00%,1,1,0.00%
router.utorrent.com,0,0.00%,4,4,0.00%
dht.aelitis.com,0,0.00%,1,1,0.00%
oss4liview.moji.com,0,0.00%,1,1,0.00%
dlcfg.client.v6.chub.sandai.net,0,0.00%,1,1,0.00%
xluser-ssl.xunlei.com,0,0.00%,1,1,0.00%
static.xbase.cloud,0,0.00%,1,1,0.00%
soa-vip-ssl.xunlei.com,0,0.00%,1,1,0.00%
pcdownsdk.rcv.sandai.net,0,0.00%,1,1,0.00%
advertpay.vip.xunlei.com,0,0.00%,1,1,0.00%
mqtt.xbase.cloud,0,0.00%,2,2,0.00%
adsp.xunlei.com,0,0.00%,1,1,0.00%
images.client.vip.xunlei.com,0,0.00%,1,1,0.00%
rcv4.xldw.n0808.com,0,0.00%,1,1,0.00%
can-01.t7n4vxsm.dxs5.xyz,0,0.00%,1,1,0.00%
svn5.apicloud.com,0,0.00%,3,3,0.00%
api.lsplayer.com,0,0.00%,1,1,0.00%
test-sso.summer-ospp.ac.cn,0,0.00%,1,1,0.00%
log.kuwo.cn,0,0.00%,2,2,0.00%
artistpicserver.kuwo.cn,0,0.00%,1,1,0.00%
154.3.35.247.globalssh.cn,0,0.00%,1,1,0.00%
c15facffece596ece87eca186c33c3a2.clo.footprintdns.com,0,0.00%,2,2,0.00%
e6e8c2dbaa69376ff90536bbc0eec4a0.clo.footprintdns.com,0,0.00%,2,2,0.00%
moiafdazure.clo.footprintdns.com,0,0.00%,2,2,0.00%
d3661cdf4a1387e40907d880475ef37e.nrb.footprintdns.com,0,0.00%,4,4,0.00%
www.google.co.id,0,0.00%,1,1,0.00%
www.google.co.ls,0,0.00%,1,1,0.00%
maps-cctld.l.google.com,0,0.00%,2,2,0.00%
maps.google.com.sb,0,0.00%,2,2,0.00%
maps.google.ae,0,0.00%,2,2,0.00%
www.google.hu,0,0.00%,1,1,0.00%
news.163.com,0,0.00%,1,1,0.00%
3valw9gt.sched.d2.tdnsdp1.cn,0,0.00%,2,2,0.00%
mim-x.jd.com,0,0.00%,1,1,0.00%
p1.ssl.qhimg.com,0,0.00%,6,6,0.00%
p1.ssl.qhimgs0.com,0,0.00%,4,4,0.00%
r3---sn-2x3elnes.gvt1.com,0,0.00%,2,2,0.00%
update-haozip.2345.cc,0,0.00%,2,2,0.00%
ts.khd.2345.cc,0,0.00%,2,2,0.00%
t-haozip.2345.com,0,0.00%,2,2,0.00%
s1a.time.edu.cn,0,0.00%,2,2,0.00%
ss-prod-ew1-notif-36.aws.adobess.com,0,0.00%,1,1,0.00%
lh-kehuduan.2345.com,0,0.00%,2,2,0.00%
update-pic.2345.cc,0,0.00%,2,2,0.00%
r4---sn-2x3elnee.gvt1.com,0,0.00%,2,2,0.00%
booking.hkexpress.com,0,0.00%,3,3,0.00%
pnsfeedback.dingtalk.com,0,0.00%,2,2,0.00%
r1---sn-2x3elnes.gvt1.com,0,0.00%,2,2,0.00%
s.go.sohu.com,0,0.00%,4,4,0.00%
wenwen.soso.com,0,0.00%,4,4,0.00%
pic.wenwen.soso.com,0,0.00%,4,4,0.00%
r2---sn-2x3elnel.gvt1.com,0,0.00%,4,4,0.00%
booking-api.hkexpress.com,0,0.00%,2,2,0.00%
p51-contacts.icloud.com,0,0.00%,2,2,0.00%
api.cognitive.microsofttranslator.com,0,0.00%,6,6,0.00%
spt.service.kugou.com,0,0.00%,2,2,0.00%
s5.ssl.qhres2.com,0,0.00%,2,2,0.00%
s3m6.nzwgs.com,0,0.00%,1,1,0.00%
s3m4.fenxi.com,0,0.00%,1,1,0.00%
26ucno0e.sched.skalego-dk.tdnsstic1.cn,0,0.00%,2,2,0.00%
ngx-out-1.op.58.com,0,0.00%,2,2,0.00%
searchrecommendretry.kugou.com,0,0.00%,2,2,0.00%
bufedr.com,0,0.00%,4,4,0.00%
i.wmgtr.com,0,0.00%,4,4,0.00%
union-click.jd.com,0,0.00%,2,2,0.00%
m4.d.meituan.net,0,0.00%,2,2,0.00%
tianqi.2345.com,0,0.00%,2,2,0.00%
kaiji.ts.2345.com,0,0.00%,2,2,0.00%
a.heroku.ssl.fastly.NET,0,0.00%,2,2,0.00%
analyze.kaochong.com,0,0.00%,2,2,0.00%
dotlog.kaochong.com,0,0.00%,2,2,0.00%
ga.gamedl.qq.com,0,0.00%,6,6,0.00%
downloadtpt.gamedl.qq.com,0,0.00%,6,6,0.00%
cloud.tenable.com,0,0.00%,3,3,0.00%
rj-ts.2345.cc,0,0.00%,2,2,0.00%
yisuapi.yisu.com,0,0.00%,2,2,0.00%
learnreport.xiaoeknow.com,0,0.00%,2,2,0.00%
callback.58.com,0,0.00%,2,2,0.00%
appcrash-report.anjuke.com,0,0.00%,2,2,0.00%
api.fantuants.com,0,0.00%,2,2,0.00%
spclient.wg.spotify.com,0,0.00%,2,2,0.00%
prism-report-knb.dreport.meituan.net,0,0.00%,2,2,0.00%
yitihuashujuguanlipingtai.coding.net,0,0.00%,2,2,0.00%
web.hb.ad.cpe.dotomi.com,0,0.00%,2,2,0.00%
www.zoosk.com,0,0.00%,3,3,0.00%
q3.qlogo.cn,0,0.00%,2,2,0.00%
md.openapi.360.cn,0,0.00%,4,4,0.00%
q1.qlogo.cn,0,0.00%,4,4,0.00%
fsr.lenovomm.com,0,0.00%,2,2,0.00%
ad.winrar.com.cn,0,0.00%,2,2,0.00%
ic-business.ks3-cn-beijing.ksyun.com,0,0.00%,2,2,0.00%
dualstack-restapi.amap.com,0,0.00%,2,2,0.00%
github.githubassets.com,0,0.00%,2,2,0.00%
avatars.githubusercontent.com,0,0.00%,2,2,0.00%
user-images.githubusercontent.com,0,0.00%,4,4,0.00%
o-ring-fallback.msedge.net,0,0.00%,2,2,0.00%
www.shichuan.org,0,0.00%,2,2,0.00%
cdn.clustrmaps.com,0,0.00%,2,2,0.00%
ipv4-ipv6-phase4.cat.sh.vip.dianping.com,0,0.00%,2,2,0.00%
cqs-drcn.emui.hicloud.com,0,0.00%,2,2,0.00%
i.ai.mi.com,0,0.00%,2,2,0.00%
clustrmaps.com,0,0.00%,6,6,0.00%
renderer.aibixby.com.cn,0,0.00%,2,2,0.00%
p2.shared.global.fastly.NET,0,0.00%,2,2,0.00%
conference.cipsc.org.cn,0,0.00%,2,2,0.00%
www.aminer.cn,0,0.00%,2,2,0.00%
graph-neural-networks.github.io,0,0.00%,2,2,0.00%
www.cil.pku.edu.cn,0,0.00%,2,2,0.00%
www.springerprofessional.de,0,0.00%,1,1,0.00%
www.bupt.edu.cn,0,0.00%,2,2,0.00%
www.ict.ac.cn,0,0.00%,2,2,0.00%
www.jlu.edu.cn,0,0.00%,2,2,0.00%
www.whu.edu.cn,0,0.00%,2,2,0.00%
leetcode.cn,0,0.00%,2,2,0.00%
js.t.sinajs.cn,0,0.00%,2,2,0.00%
o1013tn36u32026o.aliyunddos1010.com,0,0.00%,4,4,0.00%
download.qt.io,0,0.00%,2,2,0.00%
p9-be-pack-sign.pglstatp-toutiao.com,0,0.00%,2,2,0.00%
z.moatads.com,0,0.00%,2,2,0.00%
webpush.pan.baidu.com,0,0.00%,2,2,0.00%
yun.baidu.com,0,0.00%,2,2,0.00%
telem-edge.smartscreen.microsoft.com,0,0.00%,2,2,0.00%
hd2.3g.qq.com,0,0.00%,2,2,0.00%
gdp-cloud-plugin.glodon.com,0,0.00%,4,4,0.00%
cl2-cn.apple.com.download.ks-cdn.com,0,0.00%,2,2,0.00%
imap.aliyun.com,0,0.00%,2,2,0.00%
m.xinminweekly.com.cn,0,0.00%,2,2,0.00%
ns1.stc2.tdnsstic1.cn,0,0.00%,2,2,0.00%
ns1.cjt.tdnsv5.com,0,0.00%,2,2,0.00%
lws.xuexi.cn,0,0.00%,2,2,0.00%
imgmini.eastday.com,0,0.00%,2,2,0.00%
tjtv3.znyshurufa.com,0,0.00%,2,2,0.00%
mini.eastday.com,0,0.00%,2,2,0.00%
thumbnail0.baidupcs.com,0,0.00%,2,2,0.00%
misc.xinmin.cn,0,0.00%,2,2,0.00%
www.baidupcs.com,0,0.00%,2,2,0.00%
bj.baidupcs.com,0,0.00%,2,2,0.00%
qd.baidupcs.com,0,0.00%,2,2,0.00%
logback.qos.ch,0,0.00%,4,4,0.00%
newbuz.360buyimg.com,0,0.00%,2,2,0.00%
ad.3.cn,0,0.00%,2,2,0.00%
c.3.cn,0,0.00%,2,2,0.00%
jcm.jd.com,0,0.00%,2,2,0.00%
d.jd.com,0,0.00%,2,2,0.00%
dx.3.cn,0,0.00%,1,1,0.00%
d6.sina.com.cn,0,0.00%,4,4,0.00%
fb.video.weibocdn.com,0,0.00%,2,2,0.00%
onedriveclucproddm20017.blob.core.windows.net,0,0.00%,4,4,0.00%
tgscp.mainconn.gamesafe.qq.com,0,0.00%,2,2,0.00%
cs.dfnode.top,0,0.00%,1,1,0.00%
www.iggzs.com,0,0.00%,2,2,0.00%
www.slaves2.xyz,0,0.00%,2,2,0.00%
passport.sinaimg.cn,0,0.00%,2,2,0.00%
imgstar.weibo.com,0,0.00%,2,2,0.00%
vp.hexin.cn,0,0.00%,2,2,0.00%
sec_edr_file.dreport.meituan.net,0,0.00%,4,4,0.00%
w.pandora.xiaomi.com,0,0.00%,2,2,0.00%
o2o.api.xiaomi.com,0,0.00%,2,2,0.00%
account.xiaomi.com,0,0.00%,2,2,0.00%
ea32a76ee59a9d0038ae8c98fc8d58e8.dl.txcdns.com,0,0.00%,2,2,0.00%
9d25867f05e5e2923fc23a9b16092b00.dl.txcdns.com,0,0.00%,2,2,0.00%
sec_edr_proc_win.dreport.meituan.net,0,0.00%,4,4,0.00%
www.ggfwzs.com,0,0.00%,2,2,0.00%
www.slavess.xyz,0,0.00%,2,2,0.00%
f5.market.mi-img.com,0,0.00%,2,2,0.00%
e2.sinaimg.cn,0,0.00%,4,4,0.00%
english.sina.com,0,0.00%,4,4,0.00%
tags.sports.sina.com.cn,0,0.00%,4,4,0.00%
news.sina.com.cn,0,0.00%,4,4,0.00%
video.sina.com.cn,0,0.00%,4,4,0.00%
pluto.sina.cn,0,0.00%,4,4,0.00%
match.sports.sina.com.cn,0,0.00%,4,4,0.00%
slide.sports.sina.com.cn,0,0.00%,6,6,0.00%
api.sports.sina.com.cn,0,0.00%,4,4,0.00%
d0.sina.com.cn,0,0.00%,2,2,0.00%
feed.mix.sina.com.cn,0,0.00%,4,4,0.00%
blog.sina.com.cn,0,0.00%,4,4,0.00%
comment5.news.sina.com.cn,0,0.00%,4,4,0.00%
corp.sina.com.cn,0,0.00%,4,4,0.00%
emarketing.sina.com.cn,0,0.00%,4,4,0.00%
roll.sports.sina.com.cn,0,0.00%,4,4,0.00%
sax.sina.com.cn,0,0.00%,4,4,0.00%
z0.sinaimg.cn,0,0.00%,4,4,0.00%
passport.weibo.com,0,0.00%,4,4,0.00%
d3.sina.com.cn,0,0.00%,2,2,0.00%
saxn.sina.com.cn,0,0.00%,4,4,0.00%
s3.pfp.sina.net,0,0.00%,4,4,0.00%
d9.sina.com.cn,0,0.00%,2,2,0.00%
inf.vip.meituan.com,0,0.00%,2,2,0.00%
portrait5.sinaimg.cn,0,0.00%,2,2,0.00%
secgw-dualstack-na61-na62.wagbridge.alibaba.alibabacorp.com,0,0.00%,2,2,0.00%
sec_edr_log.dreport.meituan.net,0,0.00%,2,2,0.00%
sthree-itsec.meituan.com,0,0.00%,2,2,0.00%
agentserver-itsec.sec.test.meituan.com,0,0.00%,2,2,0.00%
agentserver-itsec.meituan.com,0,0.00%,2,2,0.00%
ssosv.sankuai.com,0,0.00%,2,2,0.00%
dreport.sankuai.com,0,0.00%,2,2,0.00%
e71e16d.he.gladns.com,0,0.00%,2,2,0.00%
e71e16d.hd.gladns.com,0,0.00%,2,2,0.00%
e71e16d.hc.gladns.com,0,0.00%,2,2,0.00%
e71e16d.hf.gladns.com,0,0.00%,2,2,0.00%
e71e16d.ha.gladns.com,0,0.00%,2,2,0.00%
e71e16d.hb.gladns.com,0,0.00%,2,2,0.00%
service.dcloud.net.cn,0,0.00%,2,2,0.00%
v.feed.mix.sina.com.cn,0,0.00%,4,4,0.00%
js.dhsz.cn,0,0.00%,2,2,0.00%
sina-static.oss-cn-beijing.aliyuncs.com,0,0.00%,2,2,0.00%
r2---sn-ni5eln7l.gvt1.com,0,0.00%,2,2,0.00%
tmfsdk.m.qq.com,0,0.00%,2,2,0.00%
ixav-cse.avlyun.com,0,0.00%,2,2,0.00%
l.gm.mob.com,0,0.00%,2,2,0.00%
aqv.hicloud.com,0,0.00%,2,2,0.00%
arup.m.taobao.com,0,0.00%,2,2,0.00%
android-sentry.mm.taou.com,0,0.00%,2,2,0.00%
me.cpatrk.net,0,0.00%,2,2,0.00%
log.ireader.com,0,0.00%,2,2,0.00%
content-reader-drcn.himovie.dbankcloud.com,0,0.00%,2,2,0.00%
ah2.zhangyue.com,0,0.00%,2,2,0.00%
domain03.zhangyue02.com,0,0.00%,2,2,0.00%
sys.zhangyue.com,0,0.00%,2,2,0.00%
icloud.zhangyue.com,0,0.00%,2,2,0.00%
presentation-reader-drcn.himovie.dbankcloud.com,0,0.00%,2,2,0.00%
push.zhangyue.com,0,0.00%,2,2,0.00%
uc.ireader.com,0,0.00%,2,2,0.00%
book.img.zhangyue01.com,0,0.00%,2,2,0.00%
m.zhangyue.com,0,0.00%,2,2,0.00%
iap-pay-drcn.cloud.huawei.com.cn,0,0.00%,2,2,0.00%
coupon-drcn.iap.cloud.huawei.com.cn,0,0.00%,2,2,0.00%
cpt.zhangyue.com,0,0.00%,2,2,0.00%
bookbk.d.ireader.com,0,0.00%,2,2,0.00%
sns-drcn.platform.dbankcloud.cn,0,0.00%,2,2,0.00%
cloud.sangfor.com,0,0.00%,2,2,0.00%
flowcontroll.dcdn.sandai.net,0,0.00%,2,2,0.00%
web.vortex.data.microsoft.com,0,0.00%,8,8,0.00%
r.browser.miui.com,0,0.00%,2,2,0.00%
d1.sina.com.cn,0,0.00%,2,2,0.00%
datacollection.uve.weibo.com,0,0.00%,2,2,0.00%
face.t.sinajs.cn,0,0.00%,2,2,0.00%
1671aab.nf.gladns.com,0,0.00%,2,2,0.00%
sdkclick.mobile.sina.cn,0,0.00%,2,2,0.00%
d4.sina.com.cn,0,0.00%,2,2,0.00%
ali-bj-pcdn-26.biliapi.net,0,0.00%,2,2,0.00%
s.cpro.baidu.com,0,0.00%,2,2,0.00%
api-shb1.pinduoduo.com,0,0.00%,2,2,0.00%
oloobe.officeapps.live.com,0,0.00%,3,3,0.00%
oloobe-prod-cdn-storage.azureedge.net,0,0.00%,2,2,0.00%
onedscolprdwus13.westus.cloudapp.azure.com,0,0.00%,2,2,0.00%
a-ring.msedge.net,0,0.00%,2,2,0.00%
collections.mp.microsoft.com,0,0.00%,2,2,0.00%
s2s.config.skype.com,0,0.00%,3,3,0.00%
surfacedma.azurefd.net,0,0.00%,3,3,0.00%
se1prdapp01-canary.netmon.azure.com,0,0.00%,3,3,0.00%
clickstream-data.srcgsre.com,0,0.00%,2,2,0.00%
qos3.ol.epicgames.com,0,0.00%,1,1,0.00%
heaven-eye-import.ziroom.com,0,0.00%,2,2,0.00%
apmw.ziroom.com,0,0.00%,2,2,0.00%
k-ring-fallback.msedge.net,0,0.00%,2,2,0.00%
rlog.video.qq.com,0,0.00%,2,2,0.00%
ofloc.map.baidu.com,0,0.00%,2,2,0.00%
cm-10-48.getui.com,0,0.00%,2,2,0.00%
www.epicgames.com,0,0.00%,2,2,0.00%
xmpp-service-prod.ol.epicgames.com,0,0.00%,2,2,0.00%
static-assets-prod.unrealengine.com,0,0.00%,2,2,0.00%
tracking.epicgames.com,0,0.00%,2,2,0.00%
connect.epicgames.dev,0,0.00%,2,2,0.00%
entitlement-public-service-prod08.ol.epicgames.com,0,0.00%,2,2,0.00%
friends-public-service-prod06.ol.epicgames.com,0,0.00%,3,3,0.00%
firebaselogging-pa.mihoyo.com,0,0.00%,2,2,0.00%
pedro.ns.cloudflare.com,0,0.00%,2,2,0.00%
annalise.ns.cloudflare.com,0,0.00%,4,4,0.00%
dilbert.ns.cloudflare.com,0,0.00%,6,6,0.00%
xyhg7358.com,0,0.00%,2,2,0.00%
xyhg7318.com,0,0.00%,2,2,0.00%
taro.dnspod.net,0,0.00%,2,2,0.00%
rs42.rcnoc.com,0,0.00%,2,2,0.00%
beetle.dnspod.net,0,0.00%,2,2,0.00%
cloe.ns.cloudflare.com,0,0.00%,2,2,0.00%
yangzikk.com,0,0.00%,2,2,0.00%
rs41.rcnoc.com,0,0.00%,2,2,0.00%
pumpkin.dnspod.net,0,0.00%,2,2,0.00%
ns1096.ui-dns.org,0,0.00%,2,2,0.00%
yashfawebdesigner.com,0,0.00%,2,2,0.00%
www.jsons.cn,0,0.00%,2,2,0.00%
ns2.isimtescil.net,0,0.00%,2,2,0.00%
lyle.dnspod.net,0,0.00%,2,2,0.00%
ns1070.ui-dns.biz,0,0.00%,6,6,0.00%
gigi.ns.cloudflare.com,0,0.00%,2,2,0.00%
deborah.dnspod.net,0,0.00%,2,2,0.00%
apprentice.dnspod.net,0,0.00%,2,2,0.00%
ns1.isimtescil.net,0,0.00%,2,2,0.00%
ns1.ldomhmaadns.com,0,0.00%,1,1,0.00%
ns1079.ui-dns.org,0,0.00%,6,6,0.00%
yaztatilin.com,0,0.00%,2,2,0.00%
cloud1.cdns.cn,0,0.00%,2,2,0.00%
cloud2.cdns.cn,0,0.00%,2,2,0.00%
ns107.hostgator.mx,0,0.00%,2,2,0.00%
dns3.supremepanel.com,0,0.00%,2,2,0.00%
ns2.yenjaith.com,0,0.00%,2,2,0.00%
p2.music.126.net,0,0.00%,2,2,0.00%
ns2.yhxqcwoxfdyoyddubsus.com,0,0.00%,2,2,0.00%
ns1.yenjaith.com,0,0.00%,2,2,0.00%
ns5.yhxqcwoxfdyoyddubsus.com,0,0.00%,2,2,0.00%
cloud1.lotusproxy.com,0,0.00%,2,2,0.00%
ns6.yhxqcwoxfdyoyddubsus.com,0,0.00%,2,2,0.00%
cloud2.lotusproxy.com,0,0.00%,2,2,0.00%
space.dnspod.net,0,0.00%,2,2,0.00%
pear.dnspod.net,0,0.00%,2,2,0.00%
cloud3.lotusproxy.com,0,0.00%,2,2,0.00%
ns1.yhxqcwoxfdyoyddubsus.com,0,0.00%,2,2,0.00%
cloud4.lotusproxy.com,0,0.00%,2,2,0.00%
ns1020.ui-dns.biz,0,0.00%,2,2,0.00%
ns8.yhxqcwoxfdyoyddubsus.com,0,0.00%,2,2,0.00%
ns1042.ui-dns.com,0,0.00%,2,2,0.00%
ns7.yhxqcwoxfdyoyddubsus.com,0,0.00%,2,2,0.00%
5pcvhh6p8lprqlqhm2se43dma9u0bjcivt1ihshhaumm1cgdhubfuf4c.tt.x.bsgslb.cn,0,0.00%,2,2,0.00%
h2mbd.baidu.com,0,0.00%,2,2,0.00%
easylearn.baidu.com,0,0.00%,2,2,0.00%
hanyuapp.baidu.com,0,0.00%,2,2,0.00%
storage.smartapps.cn,0,0.00%,2,2,0.00%
baikeapi.baidu.com,0,0.00%,2,2,0.00%
ns4.yhxqcwoxfdyoyddubsus.com,0,0.00%,2,2,0.00%
ns3.yhxqcwoxfdyoyddubsus.com,0,0.00%,2,2,0.00%
f20fe36.pa.gladns.com,0,0.00%,2,2,0.00%
f20fe36.pd.gladns.com,0,0.00%,2,2,0.00%
f20fe36.pg.gladns.com,0,0.00%,2,2,0.00%
f20fe36.ph.gladns.com,0,0.00%,2,2,0.00%
f20fe36.pb.gladns.com,0,0.00%,2,2,0.00%
f20fe36.pe.gladns.com,0,0.00%,2,2,0.00%
f20fe36.pc.gladns.com,0,0.00%,2,2,0.00%
gaggle.dnspod.net,0,0.00%,2,2,0.00%
sneh.ns.cloudflare.com,0,0.00%,4,4,0.00%
mole.dnspod.net,0,0.00%,2,2,0.00%
ns1077.ui-dns.com,0,0.00%,2,2,0.00%
tin.dnspod.net,0,0.00%,2,2,0.00%
skipjack.dnspod.net,0,0.00%,2,2,0.00%
nightingale.dnspod.net,0,0.00%,2,2,0.00%
mimi.ns.cloudflare.com,0,0.00%,2,2,0.00%
ns1.srvdns.io,0,0.00%,2,2,0.00%
alger.dnspod.net,0,0.00%,2,2,0.00%
ns1.sunbet303.com,0,0.00%,4,4,0.00%
julius.dnspod.net,0,0.00%,2,2,0.00%
zahir.ns.cloudflare.com,0,0.00%,2,2,0.00%
ns2.sunbet303.com,0,0.00%,4,4,0.00%
ns1.eetsvhogdns.com,0,0.00%,2,2,0.00%
dns096.a.register.com,0,0.00%,2,2,0.00%
ns3.tekveri.com,0,0.00%,2,2,0.00%
dean.ns.cloudflare.com,0,0.00%,2,2,0.00%
ns-semidedi-61.banahosting.com,0,0.00%,2,2,0.00%
ns-semidedi-60.banahosting.com,0,0.00%,2,2,0.00%
nspro74.hostgator.com.br,0,0.00%,4,4,0.00%
nspro75.hostgator.com.br,0,0.00%,4,4,0.00%
ns4.tekveri.com,0,0.00%,2,2,0.00%
ns2.tekveri.com,0,0.00%,2,2,0.00%
ns1.iiorasekadns.com,0,0.00%,1,1,0.00%
ns1.tekveri.com,0,0.00%,2,2,0.00%
cs78.hostingberry.com,0,0.00%,6,6,0.00%
ns-209.awsdns-26.com,0,0.00%,2,2,0.00%
cs78.hostneverdie.com,0,0.00%,6,6,0.00%
danica.ns.cloudflare.com,0,0.00%,2,2,0.00%
ns3ghw.name.com,0,0.00%,2,2,0.00%
ns1.americanhosting.domains,0,0.00%,2,2,0.00%
jerry.ns.cloudflare.com,0,0.00%,2,2,0.00%
ns3.americanhosting.domains,0,0.00%,2,2,0.00%
ns4.americanhosting.domains,0,0.00%,2,2,0.00%
ns1058.ui-dns.biz,0,0.00%,2,2,0.00%
ns1.registrant-verification.ispapi.net,0,0.00%,2,2,0.00%
ns2.americanhosting.domains,0,0.00%,2,2,0.00%
xn--dolapalmsatm-74be.com,0,0.00%,2,2,0.00%
ns1118.ui-dns.com,0,0.00%,2,2,0.00%
rs32a.registrar-servers.com,0,0.00%,2,2,0.00%
vulnerability-search.europe-north1-gke.intellij.net,0,0.00%,2,2,0.00%
mayybnew.3g.qq.com,0,0.00%,2,2,0.00%
active.dnspod.net,0,0.00%,2,2,0.00%
zoo.dnspod.net,0,0.00%,2,2,0.00%
bootes.dnspod.net,0,0.00%,2,2,0.00%
twig.dnspod.net,0,0.00%,2,2,0.00%
mayybstatnew.3g.qq.com,0,0.00%,1,1,0.00%
xn--kuadasmasajsalonu-hvc38f.com,0,0.00%,2,2,0.00%
ns1017.ui-dns.com,0,0.00%,2,2,0.00%
ns2.cnkuai.com,0,0.00%,2,2,0.00%
ns1.hndnsv1.com,0,0.00%,2,2,0.00%
92c6583.pe.gladns.com,0,0.00%,2,2,0.00%
algin.ns.cloudflare.com,0,0.00%,2,2,0.00%
256f3f107fde425bb220c976fdcadd3f.fp.measure.office.com,0,0.00%,1,1,0.00%
ns2.xuktioyvjqcysgmslqhj.com,0,0.00%,2,2,0.00%
ns1.xuktioyvjqcysgmslqhj.com,0,0.00%,2,2,0.00%
en.mail.qq.com,0,0.00%,2,2,0.00%
correctxt.baidu.com,0,0.00%,2,2,0.00%
ns8.xuktioyvjqcysgmslqhj.com,0,0.00%,2,2,0.00%
ns5.xuktioyvjqcysgmslqhj.com,0,0.00%,2,2,0.00%
ns41.infomaniak.com,0,0.00%,2,2,0.00%
ns42.infomaniak.com,0,0.00%,2,2,0.00%
ns3.xuktioyvjqcysgmslqhj.com,0,0.00%,2,2,0.00%
81.push2his.eastmoney.com,0,0.00%,2,2,0.00%
ns7.xuktioyvjqcysgmslqhj.com,0,0.00%,2,2,0.00%
59.push2his.eastmoney.com,0,0.00%,2,2,0.00%
sns31.hostgator.in,0,0.00%,2,2,0.00%
ns6.xuktioyvjqcysgmslqhj.com,0,0.00%,2,2,0.00%
ns4.xuktioyvjqcysgmslqhj.com,0,0.00%,2,2,0.00%
parallel.dnspod.net,0,0.00%,2,2,0.00%
benedict.ns.cloudflare.com,0,0.00%,2,2,0.00%
ns1.ftdescdns.com,0,0.00%,1,1,0.00%
nine.dnspod.net,0,0.00%,2,2,0.00%
kay.dnspod.net,0,0.00%,2,2,0.00%
condor.dnspod.net,0,0.00%,2,2,0.00%
delete.dnspod.net,0,0.00%,2,2,0.00%
rs66b.registrar-servers.com,0,0.00%,2,2,0.00%
snowflake.dnspod.net,0,0.00%,2,2,0.00%
alberta.dnspod.net,0,0.00%,2,2,0.00%
coco.dnspod.net,0,0.00%,2,2,0.00%
ns5.hostbreak.com,0,0.00%,2,2,0.00%
ns2.srvdns.io,0,0.00%,2,2,0.00%
brian.dnspod.net,0,0.00%,2,2,0.00%
ns-228-c.gandi.net,0,0.00%,2,2,0.00%
ns1.blacknight.com,0,0.00%,2,2,0.00%
ns0108.hostingcare.net,0,0.00%,2,2,0.00%
ns3.mandala.inet.co.th,0,0.00%,4,4,0.00%
th14.hostatom.com,0,0.00%,2,2,0.00%
th13.hostatom.com,0,0.00%,2,2,0.00%
ns-139-a.gandi.net,0,0.00%,2,2,0.00%
ns4.mandala.inet.co.th,0,0.00%,4,4,0.00%
ns2.parsihost.com,0,0.00%,2,2,0.00%
ns0107.hostingcare.net,0,0.00%,2,2,0.00%
sixteen.dnspod.net,0,0.00%,2,2,0.00%
ns-51-b.gandi.net,0,0.00%,2,2,0.00%
ns.i-web.kr,0,0.00%,4,4,0.00%
ns130.hostinglotus.net,0,0.00%,2,2,0.00%
ns3.jpnet.co.th,0,0.00%,2,2,0.00%
gigot.dnspod.net,0,0.00%,2,2,0.00%
ns129.hostinglotus.net,0,0.00%,2,2,0.00%
ns4.jpnet.co.th,0,0.00%,2,2,0.00%
belinda.dnspod.net,0,0.00%,2,2,0.00%
firefly.dnspod.net,0,0.00%,2,2,0.00%
rainbow.dnspod.net,0,0.00%,2,2,0.00%
svrsn.phub.sandai.net,0,0.00%,41,41,0.00%
web1.wechat.com,0,0.00%,2,2,0.00%
ipv46.fanyi-bfe.n.shifen.com,0,0.00%,2,2,0.00%
meeting-75420.pictestsz.qpic.cn,0,0.00%,2,2,0.00%
5e3ff3e6-0820-4c08-977f-dc1a630b59c6.apple.com,0,0.00%,2,2,0.00%
5e3ff3e6-0820-4c08-977f-dc1a630b59c6.apple.com.v.aaplimg.com,0,0.00%,2,2,0.00%
wemeet-da2.qq.com,0,0.00%,2,2,0.00%
disc601.prod.do.dsp.mp.microsoft.com.edgekey.net,0,0.00%,2,2,0.00%
xcast.netcond.qq.com,0,0.00%,2,2,0.00%
meeting-75420.picgzc.qpic.cn,0,0.00%,2,2,0.00%
20.courier-push-apple.com.akadns.net,0,0.00%,2,2,0.00%
cn.version.battle.net,0,0.00%,2,2,0.00%
muniucloud.app,0,0.00%,3,3,0.00%
d.cloudso.club,0,0.00%,3,3,0.00%
ns2.huaweicloud-dns.cn,0,0.00%,2,2,0.00%
ns2.huaweicloud-dns.com,0,0.00%,2,2,0.00%
ns2.huaweicloud-dns.net,0,0.00%,2,2,0.00%
ns2.huaweicloud-dns.org,0,0.00%,2,2,0.00%
ns1-32.azure-dns.com,0,0.00%,6,6,0.00%
prod.mrodevicemgr.live.com.akadns.net,0,0.00%,4,4,0.00%
cn.actual.battle.net,0,0.00%,2,2,0.00%
gateway.battlenet.com.cn,0,0.00%,2,2,0.00%
p204-quota.icloud.com.cn,0,0.00%,2,2,0.00%
bn2bcor004-meta.fe.1drv.com,0,0.00%,2,2,0.00%
odc-bn1305-meta-geo.onedrive.akadns.net,0,0.00%,2,2,0.00%
odc-bn1305-meta-brs.onedrive.akadns.net,0,0.00%,2,2,0.00%
bn2bcor004-meta.be.1drv.com.l-0003.dc-msedge.net.l-0003.l-msedge.net,0,0.00%,2,2,0.00%
blob.dsm08prdstr14a.store.core.windows.net,0,0.00%,2,2,0.00%
ac-videocloud-dev-32-1.obs.cn-south-1.myhuaweicloud.com,0,0.00%,2,2,0.00%
pecker-dev-v1.ictun.com,0,0.00%,2,2,0.00%
ns2-201.azure-dns.net,0,0.00%,4,4,0.00%
professionalsly.com,0,0.00%,2,2,0.00%
zone1-services-cdn.com,0,0.00%,2,2,0.00%
www.homecookedgadgets.com,0,0.00%,2,2,0.00%
config-teams.s-0005.s-msedge.net,0,0.00%,2,2,0.00%
notify.tabnine.com,0,0.00%,6,6,0.00%
p207-quota.icloud.com.cn,0,0.00%,1,1,0.00%
api.insight.synology.com,0,0.00%,2,2,0.00%
r.edtd.eset.com,0,0.00%,4,4,0.00%
ns6.taobao.com,0,0.00%,2,2,0.00%
mail.inglyur.com,0,0.00%,2,2,0.00%
config.teams.trafficmanager.net,0,0.00%,2,2,0.00%
ccm-frontier.feishu.cn,0,0.00%,2,2,0.00%
8.courier-push-apple.com.akadns.net,0,0.00%,2,2,0.00%
33.courier-push-apple.com.akadns.net,0,0.00%,2,2,0.00%
ftp.sjtu.edu.cn,0,0.00%,2,2,0.00%
snsvideo.c2c.wechat.com,0,0.00%,2,2,0.00%
ftp.riken.jp,0,0.00%,2,2,0.00%
mirrorlist.centos.org,0,0.00%,2,2,0.00%
ftp.postgresql.org,0,0.00%,2,2,0.00%
c801s3.jamjams3.net,0,0.00%,2,2,0.00%
c801s5.jamjams3.net,0,0.00%,2,2,0.00%
c801s4.jamjams3.net,0,0.00%,2,2,0.00%
mirrors.nipa.cloud,0,0.00%,2,2,0.00%
download.nus.edu.sg,0,0.00%,2,2,0.00%
mirror2.totbb.net,0,0.00%,2,2,0.00%
mirror.misakamikoto.network,0,0.00%,2,2,0.00%
mirror.sjtu.edu.cn,0,0.00%,2,2,0.00%
mirror.01link.hk,0,0.00%,2,2,0.00%
pop3.nfs-china.com,0,0.00%,2,2,0.00%
fpp.glodon.com,0,0.00%,2,2,0.00%
magict.glodon.com,0,0.00%,2,2,0.00%
ns4.topgslb.com,0,0.00%,2,2,0.00%
ns3.topgslb.com,0,0.00%,2,2,0.00%
ns2.topgslb.com,0,0.00%,2,2,0.00%
ns1.topgslb.com,0,0.00%,2,2,0.00%
neofeed.org,0,0.00%,2,2,0.00%
e2c34.gcp.gvt2.com,0,0.00%,4,4,0.00%
ssv4.zhengmingz.top,0,0.00%,2,2,0.00%
www.greenhouseplaza.com,0,0.00%,2,2,0.00%
nat-office-christian-gasparini-architetto.divisare.pro,0,0.00%,1,1,0.00%
community.adobe.com,0,0.00%,2,2,0.00%
rb.symcb.com,0,0.00%,2,2,0.00%
r3---sn-2x3elnee.gvt1.com,0,0.00%,4,4,0.00%
serveraddrweb.kugou.com,0,0.00%,2,2,0.00%
movies.xunlei.com,0,0.00%,2,2,0.00%
msg.autohome.com.cn,0,0.00%,2,2,0.00%
r4---sn-ni5eln7e.gvt1.com,0,0.00%,2,2,0.00%
downloads.openwrt.org,0,0.00%,2,2,0.00%
mirrors163.ntes53.netease.com,0,0.00%,2,2,0.00%
v2.clientapi.bazhuayu.com,0,0.00%,2,2,0.00%
s.vconf.f.360.cn,0,0.00%,6,6,0.00%
arxiv.paperswithcode.com,0,0.00%,2,2,0.00%
replicate.com,0,0.00%,2,2,0.00%
production-media.paperswithcode.com,0,0.00%,4,4,0.00%
psytester.github.io,0,0.00%,1,1,0.00%
cheng.vpn.rndto.com,0,0.00%,1,1,0.00%
dc1-file.ksn.kaspersky-labs.com,0,0.00%,2,2,0.00%
46a2e5c3c5a64e218b60f2c2ee76b750.pacloudflare.com,0,0.00%,1,1,0.00%
ns1.trpcdn.net,0,0.00%,2,2,0.00%
cn-request.foxitservice.com,0,0.00%,2,2,0.00%
app-b04.lp1.npns.srv.nintendo.net,0,0.00%,2,2,0.00%
git.openssl.org,0,0.00%,36,36,0.00%
www.ntnu.edu,0,0.00%,2,2,0.00%
hicbrnuxnyozpgtj.ggyy99.tk,0,0.00%,61,61,0.00%
onedriveclucprodbn20027.blob.core.windows.net,0,0.00%,2,2,0.00%
beta.audiobro.com,0,0.00%,2,2,0.00%
rm-bp151dcc75aycqd80to.mysql.rds.aliyuncs.com,0,0.00%,2,2,0.00%
ns-206.awsdns-25.com,0,0.00%,2,2,0.00%
api.ldmnq.com,0,0.00%,4,4,0.00%
public-apis.cleanmymac.com,0,0.00%,2,2,0.00%
activations.devmate.com,0,0.00%,2,2,0.00%
api.panther.macpaw.com,0,0.00%,2,2,0.00%
sen-chen.github.io,0,0.00%,4,4,0.00%
www.clustrmaps.com,0,0.00%,2,2,0.00%
slp2p-east-std1061.oray.net,0,0.00%,2,2,0.00%
fp-vs-nocache.azureedge.net,0,0.00%,2,2,0.00%
18ad87839a385ab34d95d0cb4cb02cf0.clo.footprintdns.com,0,0.00%,1,1,0.00%
7fc03b97349a4afe8b945bfcb953cd50.fp.measure.office.com,0,0.00%,1,1,0.00%
p210-contacts.icloud.com.cn,0,0.00%,2,2,0.00%
app-b05.lp1.npns.srv.nintendo.net,0,0.00%,2,2,0.00%
pc.pay.youku.com,0,0.00%,1,1,0.00%
pgw-cld-s.alicdn.com,0,0.00%,2,2,0.00%
r1.ykimg.com,0,0.00%,1,1,0.00%
tracker.frozen-layer.com,0,0.00%,1,1,0.00%
chennuo.xyz,0,0.00%,1,1,0.00%
basictransl.wps.cn,0,0.00%,1,1,0.00%
master9.teamviewer.com,0,0.00%,4,4,0.00%
o.arkcn.tk,0,0.00%,1,1,0.00%
s2.xoimg.com,0,0.00%,1,1,0.00%
adx-static.ksosoft.com,0,0.00%,1,1,0.00%
stun.voipstunt.com,0,0.00%,2,2,0.00%
21.telegream.online,0,0.00%,2,2,0.00%
open.acgnxtracker.com,0,0.00%,2,2,0.00%
t.btcland.xyz,0,0.00%,2,2,0.00%
kubernetes-charts.storage.googleapis.com,0,0.00%,4,4,0.00%
api.game.meizu.com,0,0.00%,2,2,0.00%
pss-s.alicdn.com,0,0.00%,2,2,0.00%
ns3.flashdance.cx,0,0.00%,2,2,0.00%
www.lixiangdao.vip,0,0.00%,1,1,0.00%
plugin.browser.qq.com,0,0.00%,2,2,0.00%
b23.tv,0,0.00%,2,2,0.00%
blog-static.cnblogs.com,0,0.00%,2,2,0.00%
iface2.iqiyi.com,0,0.00%,2,2,0.00%
proxy.sogou.com,0,0.00%,2,2,0.00%
g37.update.netease.com,0,0.00%,1,1,0.00%
proxy-state.nie.netease.com,0,0.00%,1,1,0.00%
tracker.vraphim.com,0,0.00%,1,1,0.00%
master11.teamviewer.com,0,0.00%,4,4,0.00%
segmentfault.com,0,0.00%,2,2,0.00%
cdn.segmentfault.com,0,0.00%,2,2,0.00%
stats.segmentfault.net,0,0.00%,2,2,0.00%
avatar-static.segmentfault.com,0,0.00%,2,2,0.00%
image-static.segmentfault.com,0,0.00%,1,1,0.00%
sponsor.segmentfault.com,0,0.00%,1,1,0.00%
errorpage.b0.upaiyun.com,0,0.00%,2,2,0.00%
www.onlinedo.cn,0,0.00%,2,2,0.00%
gkaracha.github.io,0,0.00%,122,122,0.00%
o965865.ingest.sentry.io,0,0.00%,1,1,0.00%
www.kanjiantu.com,0,0.00%,1,1,0.00%
learn.unity.com,0,0.00%,1,1,0.00%
file.service.qq.com,0,0.00%,2,2,0.00%
tracker.minglong.org,0,0.00%,1,1,0.00%
api.8864029a8b01d50a95d558b5792ce2d6.pw,0,0.00%,1,1,0.00%
ap2.agora.io,0,0.00%,1,1,0.00%
ap3.agora.io,0,0.00%,1,1,0.00%
ap4-tls.agora.io,0,0.00%,1,1,0.00%
ap3-tls.agora.io,0,0.00%,1,1,0.00%
ap2-tls.agora.io,0,0.00%,1,1,0.00%
report-edge.agora.io,0,0.00%,1,1,0.00%
ap4.agora.io,0,0.00%,1,1,0.00%
ap1.agora.io,0,0.00%,2,2,0.00%
ap1-tls.agora.io,0,0.00%,1,1,0.00%
ap5.agora.io,0,0.00%,1,1,0.00%
apiavalon.myhug.cn,0,0.00%,1,1,0.00%
ap5-tls.agora.io,0,0.00%,1,1,0.00%
tianshu.gtimg.cn,0,0.00%,1,1,0.00%
cm-10-18.getui.com,0,0.00%,2,2,0.00%
bt.ali213.net,0,0.00%,1,1,0.00%
interviewguide.cn,0,0.00%,1,1,0.00%
axiu-image-bed.oss-cn-shanghai.aliyuncs.com,0,0.00%,1,1,0.00%
hk12.cc,0,0.00%,1,1,0.00%
default-query.trtc.tencent-cloud.com,0,0.00%,2,2,0.00%
mlvbdc.live.qcloud.com,0,0.00%,2,2,0.00%
miaowu.baidu.com,0,0.00%,1,1,0.00%
crls.pki.goog,0,0.00%,2,2,0.00%
api.getquicker.net,0,0.00%,2,2,0.00%
umdc.alibaba-inc.com,0,0.00%,4,4,0.00%
