domain,num_aaaa_fail,rate_all,num_aaaa_all,num_aaaa_success,rate_aaaa_fail
hub5p.sandai.net,97184,5.73%,97184,0,100.00%
www.baidu.com,79661,4.69%,152826,73165,52.13%
www.chinauos.com,79193,4.67%,79193,0,100.00%
asimov.vortex.data.trafficmanager.net,58509,3.45%,58509,0,100.00%
downloads.yoctoproject.org,43816,2.58%,43816,0,100.00%
note.youdao.com,36083,2.13%,36083,0,100.00%
connectivity-check.ubuntu.com,36007,2.12%,36007,0,100.00%
rq.r9t1.com,28755,1.69%,28755,0,100.00%
optimizationguide-pa.googleapis.com,26365,1.55%,27075,710,97.38%
api.miwifi.com,25594,1.51%,25594,0,100.00%
daisy.ubuntu.com,25338,1.49%,66446,41108,38.13%
xgpolardb.mysql.polardb.rds.aliyuncs.com,21206,1.25%,21206,0,100.00%
sources.openembedded.org,20322,1.20%,20322,0,100.00%
yapi.kdsec.org,16876,0.99%,16876,0,100.00%
www.msftncsi.com,16836,0.99%,16836,0,100.00%
edragent.sangfor.com.cn,16489,0.97%,16489,0,100.00%
settings-win.data.microsoft.com,15534,0.92%,15534,0,100.00%
retracker.mgts.by,12627,0.74%,12627,0,100.00%
retracker.lanta-net.ru,12115,0.71%,12115,0,100.00%
es.proj217.app.kdsec.org,11982,0.71%,11982,0,100.00%
cu1pehnswss01.servicebus.windows.net,11288,0.67%,11288,0,100.00%
x.research.qq.com,11285,0.66%,11285,0,100.00%
connectivitycheck.platform.hicloud.com,10865,0.64%,16032,5167,67.77%
v10.events.data.microsoft.com,10691,0.63%,11409,718,93.71%
safebrowsing.googleapis.com,10158,0.60%,10403,245,97.64%
ipv4only.arpa,9800,0.58%,9800,0,100.00%
hsk-embed.oray.com,9386,0.55%,9386,0,100.00%
2.ubuntu.pool.ntp.org,9100,0.54%,9250,150,98.38%
osfsr.lenovomm.com,9027,0.53%,9027,0,100.00%
us-v20.events.data.microsoft.com,8533,0.50%,8656,123,98.58%
assets.contentstack.io,8414,0.50%,8414,0,100.00%
www.expressapisv2.net,8328,0.49%,15395,7067,54.10%
mail.cstnet.cn,8117,0.48%,15773,7656,51.46%
h5-api.appstore.vivo.com.cn,7975,0.47%,7975,0,100.00%
qup.b.qianxin.com,7810,0.46%,7810,0,100.00%
ip.42.pl,6781,0.40%,6781,0,100.00%
browser.360.cn,6741,0.40%,6814,73,98.93%
ctldl.windowsupdate.com,6697,0.39%,6858,161,97.65%
mvgforumtracker.mvgroup.org,6431,0.38%,6431,0,100.00%
www.tribalmixes.com,5904,0.35%,5904,0,100.00%
www.tvnihon.com,5851,0.34%,5851,0,100.00%
github.com,5768,0.34%,5768,0,100.00%
i5.cwip.eset.com,5609,0.33%,5609,0,100.00%
analytics.yinxiang.com,5502,0.32%,5502,0,100.00%
vortex.data.microsoft.com,5477,0.32%,5477,0,100.00%
self.events.data.microsoft.com,5392,0.32%,6159,767,87.55%
www.bit-hdtv.com,5318,0.31%,5318,0,100.00%
allall01.baidupcs.com,5022,0.30%,9436,4414,53.22%
www.yuwabits.net,4655,0.27%,4655,0,100.00%
api.vc.bilibili.com,4633,0.27%,5479,846,84.56%
duba-defend.zhhainiao.com,4616,0.27%,4616,0,100.00%
incoming.telemetry.mozilla.org,4533,0.27%,4533,0,100.00%
t.overflow.biz,4467,0.26%,4467,0,100.00%
stun.douyucdn.cn,4326,0.25%,8154,3828,53.05%
mirrors.aliyun.com,4305,0.25%,4560,255,94.41%
shuc-pc-hunt.ksord.com,4291,0.25%,4291,0,100.00%
default.exp-tas.com,4287,0.25%,8682,4395,49.38%
android.clients.google.com,4286,0.25%,4286,0,100.00%
ping.pinyin.sogou.com,4278,0.25%,4278,0,100.00%
stun1.douyucdn.cn,4249,0.25%,4249,0,100.00%
get.sogou.com,4147,0.24%,4147,0,100.00%
update1.sangfor.net,4103,0.24%,4103,0,100.00%
2.centos.pool.ntp.org,4065,0.24%,5383,1318,75.52%
clientservices.googleapis.com,3892,0.23%,4088,196,95.21%
contile.services.mozilla.com,3884,0.23%,3884,0,100.00%
share.camoe.cn,3547,0.21%,3547,0,100.00%
slapi.oray.net,3478,0.20%,3478,0,100.00%
nj.t.bcsp2p.baidu.com,3462,0.20%,3462,0,100.00%
mobile.events.data.microsoft.com,3282,0.19%,3627,345,90.49%
alfred.ixiacom.com,3278,0.19%,3278,0,100.00%
pan.baidu.com,3240,0.19%,9204,5964,35.20%
e-0014.e-msedge.net,3212,0.19%,3212,0,100.00%
pool.ntp.org,3167,0.19%,3167,0,100.00%
www.mvgroup.org,3105,0.18%,3105,0,100.00%
open.tracker.cl,3091,0.18%,3091,0,100.00%
tracker.tasvideos.org,2848,0.17%,5176,2328,55.02%
sl-tk.oray.com,2834,0.17%,2834,0,100.00%
config.pinyin.sogou.com,2802,0.17%,5381,2579,52.07%
locprod2-elb-us-west-2.prod.mozaws.net,2779,0.16%,2779,0,100.00%
rscloud.rising.net.cn,2659,0.16%,2659,0,100.00%
login.live.com,2585,0.15%,2585,0,100.00%
router14.teamviewer.com,2542,0.15%,2760,218,92.10%
tr.abirxo.cf,2506,0.15%,4708,2202,53.23%
router2.teamviewer.com,2503,0.15%,2638,135,94.88%
watson.telemetry.microsoft.com,2489,0.15%,3195,706,77.90%
git.rancher.io,2485,0.15%,24849,22364,10.00%
tile-service.weather.microsoft.com,2479,0.15%,2479,0,100.00%
router7.teamviewer.com,2415,0.14%,2578,163,93.68%
router5.teamviewer.com,2342,0.14%,2501,159,93.64%
router9.teamviewer.com,2337,0.14%,2485,148,94.04%
router6.teamviewer.com,2323,0.14%,2468,145,94.12%
packages.deepin.com,2318,0.14%,2318,0,100.00%
router16.teamviewer.com,2315,0.14%,2573,258,89.97%
router12.teamviewer.com,2305,0.14%,2526,221,91.25%
router3.teamviewer.com,2298,0.14%,2444,146,94.03%
router15.teamviewer.com,2296,0.14%,2554,258,89.90%
play.googleapis.com,2258,0.13%,2357,99,95.80%
frp.zwlin.top,2249,0.13%,2249,0,100.00%
router10.teamviewer.com,2229,0.13%,2357,128,94.57%
router1.teamviewer.com,2198,0.13%,2376,178,92.51%
router13.teamviewer.com,2191,0.13%,2378,187,92.14%
router8.teamviewer.com,2179,0.13%,2380,201,91.55%
ww62.uatracker.net,2168,0.13%,2168,0,100.00%
router4.teamviewer.com,2160,0.13%,2263,103,95.45%
p3p.sogou.com,2147,0.13%,2147,0,100.00%
www.belkin.com,2130,0.13%,2130,0,100.00%
update.googleapis.com,2095,0.12%,2303,208,90.97%
update.pan.baidu.com,2090,0.12%,2090,0,100.00%
router11.teamviewer.com,2060,0.12%,2234,174,92.21%
ntp.sjtu.edu.cn,2015,0.12%,2015,0,100.00%
bt.okmp3.ru,2006,0.12%,2006,0,100.00%
content-autofill.googleapis.com,1962,0.12%,2065,103,95.01%
d27xxe7juh1us6.cloudfront.net,1957,0.12%,3875,1918,50.50%
arc.msn.com,1946,0.11%,1946,0,100.00%
www.bing.com,1946,0.11%,2288,342,85.05%
usa1v2.jsssline.top,1925,0.11%,1925,0,100.00%
tracker.fixr.pro,1905,0.11%,1905,0,100.00%
pcs-sdk-server.alibaba.com,1896,0.11%,3420,1524,55.44%
midinfo.baofeng.com,1764,0.10%,1764,0,100.00%
femetrics.grammarly.io,1763,0.10%,1763,0,100.00%
mirror.iscas.ac.cn,1751,0.10%,1751,0,100.00%
h-adashx.ut.taobao.com,1750,0.10%,1750,0,100.00%
clients2.google.com,1745,0.10%,1820,75,95.88%
global.quickconnect.cn,1729,0.10%,1729,0,100.00%
monorepo-production-edge-alb-985829473.us-east-1.elb.amazonaws.com,1723,0.10%,1723,0,100.00%
nexusrules.officeapps.live.com,1713,0.10%,3224,1511,53.13%
client.wns.windows.com,1614,0.10%,2932,1318,55.05%
t1.pow7.com,1613,0.10%,3124,1511,51.63%
data.bilibili.com,1598,0.09%,2908,1310,54.95%
t2.pow7.com,1580,0.09%,3070,1490,51.47%
atrack.pow7.com,1573,0.09%,3043,1470,51.69%
t.acg.rip,1570,0.09%,1570,0,100.00%
wup.browser.qq.com,1544,0.09%,1544,0,100.00%
88dsf5l.003.1.mclqp.link,1536,0.09%,1536,0,100.00%
ipv6.google.com,1530,0.09%,2102,572,72.79%
mtalk.google.com,1526,0.09%,4232,2706,36.06%
ldc.lenovo.com.cn,1501,0.09%,1501,0,100.00%
erickson514-my.sharepoint.com,1487,0.09%,1487,0,100.00%
secure.pow7.com,1485,0.09%,2871,1386,51.72%
nzk.woqu365.com,1476,0.09%,1476,0,100.00%
huggingface.co,1474,0.09%,3246,1772,45.41%
pdcweb.micloud.xiaomi.net,1461,0.09%,1461,0,100.00%
tracker.pow7.com,1440,0.08%,2769,1329,52.00%
cn2888.v2free.xyz,1417,0.08%,1417,0,100.00%
accounts.google.com,1405,0.08%,1502,97,93.54%
mmbiz.qpic.cn,1404,0.08%,1525,121,92.07%
prom-monitorproxy1.fastsdwan.com,1398,0.08%,1398,0,100.00%
info.pinyin.sogou.com,1390,0.08%,2597,1207,53.52%
fedora.riscv.rocks,1364,0.08%,1364,0,100.00%
switch.pcfg.cache.wpscdn.cn,1363,0.08%,2909,1546,46.85%
winatp-gw-cus3.microsoft.com,1355,0.08%,1355,0,100.00%
location.services.mozilla.com,1354,0.08%,1354,0,100.00%
array504.prod.do.dsp.mp.microsoft.com,1323,0.08%,1323,0,100.00%
hk4.v2u9.top,1305,0.08%,1305,0,100.00%
www.microsoft.com,1292,0.08%,1368,76,94.44%
visualstudio-devdiv-c2s.msedge.net,1262,0.07%,1262,0,100.00%
clients1.google.com,1248,0.07%,1257,9,99.28%
treatment.grammarly.com,1246,0.07%,1246,0,100.00%
v2.get.sogou.com,1240,0.07%,1240,0,100.00%
v20.events.data.microsoft.com,1232,0.07%,1331,99,92.56%
cn.bing.com,1229,0.07%,1434,205,85.70%
cloud.browser.360.cn,1221,0.07%,1221,0,100.00%
redirector.gvt1.com,1206,0.07%,1241,35,97.18%
d11.baidupcs.com,1203,0.07%,1203,0,100.00%
btrace.qq.com,1200,0.07%,2239,1039,53.60%
ris.api.iris.microsoft.com,1195,0.07%,1195,0,100.00%
qingcenter.wps.cn,1195,0.07%,2360,1165,50.64%
hk.tcpbbr.net,1153,0.07%,2154,1001,53.53%
gitee.com,1148,0.07%,1148,0,100.00%
dldir1.qq.com,1127,0.07%,1131,4,99.65%
mini.browser.360.cn,1113,0.07%,1113,0,100.00%
api.snapcraft.io,1108,0.07%,1108,0,100.00%
diskapi.baidu.com,1067,0.06%,1979,912,53.92%
assets.msn.cn,1052,0.06%,1052,0,100.00%
c.pcs.baidu.com,1044,0.06%,1931,887,54.07%
mon.zijieapi.com,1041,0.06%,1041,0,100.00%
shortconn.im.qcloud.com,1036,0.06%,1036,0,100.00%
push.thanos.ams.eulix.xyz,1003,0.06%,1003,0,100.00%
www.a.shifen.com,998,0.06%,1904,906,52.42%
checkappexec.microsoft.com,991,0.06%,991,0,100.00%
qing.wps.cn,989,0.06%,2178,1189,45.41%
www.google.com,985,0.06%,5185,4200,19.00%
server-m.pp.cn,980,0.06%,980,0,100.00%
tuna05.mcddns01.com,978,0.06%,978,0,100.00%
beacons.gcp.gvt2.com,974,0.06%,1020,46,95.49%
lp-push-server-253.lastpass.com,970,0.06%,970,0,100.00%
community-store-packages.deepin.com,957,0.06%,957,0,100.00%
d.docs.live.net,956,0.06%,1646,690,58.08%
www.taobao.com,953,0.06%,1801,848,52.92%
cdn-cn.nekocloud.cn,953,0.06%,953,0,100.00%
api.appstore.deepin.org,952,0.06%,952,0,100.00%
vipapi.wps.cn,951,0.06%,951,0,100.00%
alive.github.com,949,0.06%,949,0,100.00%
frp.zwlin.store,946,0.06%,946,0,100.00%
nexus.officeapps.live.com,945,0.06%,945,0,100.00%
x1.c.lencr.org,943,0.06%,2003,1060,47.08%
tunnel.cfw.trustedsource.org,942,0.06%,942,0,100.00%
h4.trakx.nibba.trade,939,0.06%,939,0,100.00%
firefox.settings.services.mozilla.com,924,0.05%,924,0,100.00%
2.openwrt.pool.ntp.org,917,0.05%,960,43,95.52%
caldav.163.com,914,0.05%,914,0,100.00%
s.360.cn,912,0.05%,912,0,100.00%
imap.gmail.com,907,0.05%,1105,198,82.08%
tracker4.itzmx.com,907,0.05%,1676,769,54.12%
clients4.google.com,892,0.05%,1038,146,85.93%
proxy.client.163.com,890,0.05%,890,0,100.00%
hub5pnc.sandai.net,890,0.05%,890,0,100.00%
www3.l.google.com,871,0.05%,899,28,96.89%
www.msftconnecttest.com,861,0.05%,872,11,98.74%
telemetry-in.battle.net,858,0.05%,858,0,100.00%
ping.avast.com,855,0.05%,1838,983,46.52%
tracker2.itzmx.com,851,0.05%,851,0,100.00%
az764295.vo.msecnd.net,849,0.05%,849,0,100.00%
1hkclu.pronetworklink.net,842,0.05%,842,0,100.00%
mail.bjtu.edu.cn,818,0.05%,818,0,100.00%
dsp.lenovo.com.cn,814,0.05%,814,0,100.00%
www.bitseduce.com,808,0.05%,808,0,100.00%
array808.prod.do.dsp.mp.microsoft.com,806,0.05%,806,0,100.00%
www.biztorrents.com,806,0.05%,806,0,100.00%
1min.pcfg.cache.wpscdn.cn,805,0.05%,805,0,100.00%
play.google.com,804,0.05%,997,193,80.64%
update.wps.cn,802,0.05%,802,0,100.00%
e6858.e19.s.tl88.net,801,0.05%,801,0,100.00%
allall02.baidupcs.com,795,0.05%,1607,812,49.47%
tracker1.itzmx.com,786,0.05%,786,0,100.00%
mirrors.nwafu.edu.cn,786,0.05%,786,0,100.00%
www.googleapis.com,785,0.05%,821,36,95.62%
vscode-sync.trafficmanager.net,783,0.05%,783,0,100.00%
registry-1.docker.io,783,0.05%,783,0,100.00%
dev.ditu.live.com,782,0.05%,782,0,100.00%
update2.sangfor.net,781,0.05%,781,0,100.00%
roaming.wps.cn,776,0.05%,776,0,100.00%
translate.google.com,774,0.05%,776,2,99.74%
api2.firefoxchina.cn.wswebpic.com,773,0.05%,773,0,100.00%
cip.cc,768,0.05%,768,0,100.00%
agt.p.qianxin.com,763,0.04%,763,0,100.00%
hpd.baidu.com,761,0.04%,761,0,100.00%
tsfe.trafficshaping.dsp.mp.microsoft.com,754,0.04%,754,0,100.00%
time.windows.com,753,0.04%,753,0,100.00%
i5.c.eset.com,753,0.04%,753,0,100.00%
socm.dmp.360.cn,752,0.04%,752,0,100.00%
o.andfx.cn,751,0.04%,751,0,100.00%
dcldshlupt.alicdn.com,749,0.04%,749,0,100.00%
account.wps.cn,748,0.04%,748,0,100.00%
ztxdjj-my.sharepoint.com,746,0.04%,746,0,100.00%
isrc.iscas.ac.cn,746,0.04%,746,0,100.00%
bp.335.wdpdk.link,744,0.04%,744,0,100.00%
atm-settingsfe-prod-geo2.trafficmanager.net,735,0.04%,735,0,100.00%
odoooacnz-my.sharepoint.com,733,0.04%,733,0,100.00%
api.apple-cloudkit.com,730,0.04%,730,0,100.00%
h5.do889.com,728,0.04%,728,0,100.00%
hk1-7.nigirocloud.com,724,0.04%,724,0,100.00%
searchrecommend.kugou.com,724,0.04%,724,0,100.00%
zw-roaming.wps.cn,711,0.04%,711,0,100.00%
ntp4.aliyun.com,709,0.04%,709,0,100.00%
translate.google.cn,703,0.04%,1383,680,50.83%
update3.sangfor.net,702,0.04%,702,0,100.00%
api.tabnine.com,702,0.04%,702,0,100.00%
chpm.sangfor.com.cn,700,0.04%,700,0,100.00%
apac-china-courier-4.push-apple.com.akadns.net,697,0.04%,697,0,100.00%
pc-plugin-plg.wpscdn.cn,696,0.04%,1525,829,45.64%
auth.docker.io,694,0.04%,694,0,100.00%
dw-online.ksosoft.com,684,0.04%,684,0,100.00%
softcenter-all.os.nfschina.com,676,0.04%,676,0,100.00%
ts2.qq.com,674,0.04%,674,0,100.00%
u.zyinfotech.com,673,0.04%,673,0,100.00%
dc.services.visualstudio.com,673,0.04%,673,0,100.00%
rs1.qq.com,670,0.04%,670,0,100.00%
drive.wps.cn,667,0.04%,2042,1375,32.66%
apphub.aliyuncs.com,663,0.04%,663,0,100.00%
global.asimov.events.data.trafficmanager.net,662,0.04%,676,14,97.93%
go.microsoft.com,661,0.04%,1476,815,44.78%
bam.nr-data.net,661,0.04%,661,0,100.00%
ocsp.digicert.com,659,0.04%,1241,582,53.10%
sg02.ipv2.xyz,658,0.04%,658,0,100.00%
us-west-las-5.openssl3.com,658,0.04%,658,0,100.00%
discovery-v4-1.verysync.cn,655,0.04%,655,0,100.00%
opencdnmsdl1.jomodns.com,648,0.04%,648,0,100.00%
d2nxq2uap88usk.cloudfront.net,647,0.04%,974,327,66.43%
load-balancing-system.cmy-dns.com,645,0.04%,645,0,100.00%
dd.browser.360.cn,644,0.04%,644,0,100.00%
docer.wps.cn,644,0.04%,644,0,100.00%
www.apple.com,642,0.04%,648,6,99.07%
v1.go2yd.com,641,0.04%,641,0,100.00%
normandy.cdn.mozilla.net,638,0.04%,638,0,100.00%
update.todesk.com,636,0.04%,636,0,100.00%
discovery-v4-3.verysync.cn,635,0.04%,635,0,100.00%
www.tg5tj2cu.com,634,0.04%,634,0,100.00%
www.microvirt.com,632,0.04%,632,0,100.00%
shdf01-iopq.cgroads.com,631,0.04%,631,0,100.00%
smtp.iscas.ac.cn,625,0.04%,625,0,100.00%
push.services.mozilla.com,621,0.04%,621,0,100.00%
assets.msn.com,621,0.04%,621,0,100.00%
content-signature-2.cdn.mozilla.net,618,0.04%,1308,690,47.25%
prod.ingestion-edge.prod.dataops.mozgcp.net,618,0.04%,618,0,100.00%
tracker.ccp.ovh,607,0.04%,607,0,100.00%
ts1.qq.com,605,0.04%,605,0,100.00%
home.wps.cn,605,0.04%,605,0,100.00%
rs2.qq.com,604,0.04%,604,0,100.00%
e13678.ca2.s.tl88.net,601,0.04%,601,0,100.00%
cn-hangzhou.axt.aliyun.com,598,0.04%,598,0,100.00%
vasapi.wps.cn,597,0.04%,597,0,100.00%
d9caa6e02c990b0a.jijifun.com,595,0.04%,595,0,100.00%
mobile.pipe.aria.microsoft.com,594,0.03%,671,77,88.52%
deault-exp-tas-com.e-0014.e-msedge.net,592,0.03%,1126,534,52.58%
honeycomb.wpscdn.cn,592,0.03%,1133,541,52.25%
mainnet.infura.io,589,0.03%,1033,444,57.02%
vip.wps.cn,587,0.03%,587,0,100.00%
api.kylinos.cn,583,0.03%,583,0,100.00%
access.video.qq.com,581,0.03%,581,0,100.00%
cn-qingdao.axt.aliyun.com,578,0.03%,578,0,100.00%
console.cloud.google.com,576,0.03%,576,0,100.00%
rq.wh.cmcm.com,573,0.03%,573,0,100.00%
rinkeby.infura.io,571,0.03%,571,0,100.00%
ioshost.qtlcdn.com,569,0.03%,1133,564,50.22%
cdn-file.ludashi.com,568,0.03%,568,0,100.00%
adashx.ut.dingtalk.com,564,0.03%,564,0,100.00%
www.kanjiantu.com,562,0.03%,562,0,100.00%
signalings.verysync.cn,556,0.03%,556,0,100.00%
cn-beijing.axt.aliyun.com,555,0.03%,555,0,100.00%
docer-api.kdocs.cn,553,0.03%,553,0,100.00%
hp3.mail.netease.com,552,0.03%,552,0,100.00%
pay.wps.cn,550,0.03%,550,0,100.00%
notice.wps.cn,550,0.03%,550,0,100.00%
api.zotero.org,546,0.03%,546,0,100.00%
docer.kdocs.cn,545,0.03%,545,0,100.00%
le.wps.cn,544,0.03%,544,0,100.00%
cmrelay-basic-2.nodesub.com,540,0.03%,540,0,100.00%
lucky.wps.cn,528,0.03%,528,0,100.00%
avatar.qwps.cn,527,0.03%,527,0,100.00%
qr.wps.cn,525,0.03%,525,0,100.00%
download.visualstudio.microsoft.com,522,0.03%,522,0,100.00%
iplc-ji.mielink-dns2.com,521,0.03%,521,0,100.00%
geo.wps.cn,520,0.03%,520,0,100.00%
zlxx.v.lxcvc.com,520,0.03%,1025,505,50.73%
123.sogou.com,520,0.03%,520,0,100.00%
auth.sangfor.com.cn,520,0.03%,520,0,100.00%
ios.ac.cn,519,0.03%,519,0,100.00%
repo.huaweicloud.com,519,0.03%,519,0,100.00%
sms.wps.cn,518,0.03%,518,0,100.00%
discovery-v4-2.verysync.cn,518,0.03%,518,0,100.00%
puv.tt.browser.360.cn,517,0.03%,517,0,100.00%
db-safe.2345.cc,517,0.03%,517,0,100.00%
1-courier.push.apple.com,515,0.03%,515,0,100.00%
iaas.wps.cn,514,0.03%,514,0,100.00%
todolist.redirect.xzdesktop.cqttech.com,512,0.03%,512,0,100.00%
hsk-api.oray.com,511,0.03%,511,0,100.00%
dc1.ksn.kaspersky-labs.com,508,0.03%,508,0,100.00%
vamd.cnode.xyz,505,0.03%,505,0,100.00%
discovery-v4.verysync.cn,502,0.03%,502,0,100.00%
bugly.qq.com,501,0.03%,501,0,100.00%
1-courier.sandbox.push.apple.com,496,0.03%,496,0,100.00%
catalog.gamepass.com,489,0.03%,1057,568,46.26%
gateway.fe.apple-dns.net,489,0.03%,983,494,49.75%
zj-roaming.wps.cn,487,0.03%,487,0,100.00%
pub.idqqimg.com,486,0.03%,1205,719,40.33%
tr.cili001.com,482,0.03%,482,0,100.00%
helpdubaclient.ksmobile.com,480,0.03%,480,0,100.00%
msg.qy.net,480,0.03%,480,0,100.00%
zt.wps.cn,479,0.03%,479,0,100.00%
cdn.packages.deepin.com,477,0.03%,477,0,100.00%
download.windowsupdate.com,476,0.03%,507,31,93.89%
rub.myddns.cyou,476,0.03%,476,0,100.00%
client.dropbox.com,471,0.03%,984,513,47.87%
go.ie.sogou.com,471,0.03%,471,0,100.00%
tracker.1337x.org,470,0.03%,9584,9114,4.90%
wdl1.cache.wps.cn,470,0.03%,774,304,60.72%
search.apps.ubuntu.com,470,0.03%,470,0,100.00%
licensing.mp.microsoft.com,469,0.03%,469,0,100.00%
g.api.mega.co.nz,468,0.03%,1960,1492,23.88%
cn-hongkong.axt.aliyun.com,466,0.03%,466,0,100.00%
tracker.files.fm,465,0.03%,465,0,100.00%
pr.x.hub.sandai.net,465,0.03%,465,0,100.00%
poll.exmail.qq.com,463,0.03%,463,0,100.00%
drive.wpsdns.com,463,0.03%,968,505,47.83%
service.account.weibo.com,463,0.03%,463,0,100.00%
hotfix.lenovo.com.cn,457,0.03%,457,0,100.00%
p0.qhimg.com,456,0.03%,568,112,80.28%
c.go-mpulse.net,454,0.03%,990,536,45.86%
res.wx.qq.com,454,0.03%,515,61,88.16%
comet.jianguoyun.com,454,0.03%,454,0,100.00%
login.microsoftonline.com,448,0.03%,448,0,100.00%
jtypkz2w.sched.d2.tdnsdp1.cn,448,0.03%,448,0,100.00%
goldengate.grammarly.com,448,0.03%,448,0,100.00%
www.sohu.com,446,0.03%,1011,565,44.11%
odobagg-my.sharepoint.com,446,0.03%,446,0,100.00%
shcuac.aag436.ccddns.lol,444,0.03%,444,0,100.00%
zhidao.baidu.com,439,0.03%,826,387,53.15%
mail.google.com,438,0.03%,953,515,45.96%
passport.weibo.com,437,0.03%,437,0,100.00%
vm.gtimg.cn,424,0.02%,522,98,81.23%
yd-02.paofunlink.com,422,0.02%,422,0,100.00%
us-sandbox-courier-4.push-apple.com.akadns.net,419,0.02%,419,0,100.00%
hm.baidu.com,418,0.02%,996,578,41.97%
thetracker.org,417,0.02%,417,0,100.00%
1.courier-push-apple.com.akadns.net,417,0.02%,417,0,100.00%
high-frequency-gray.zhhainiao.com,415,0.02%,415,0,100.00%
api.apple-cloudkit.fe.apple-dns.net,414,0.02%,414,0,100.00%
9.rarbg.me,413,0.02%,413,0,100.00%
mubu.com,413,0.02%,413,0,100.00%
honeycomb.wps.cn,413,0.02%,413,0,100.00%
cstestarea.leagsoft.net,413,0.02%,413,0,100.00%
9.rarbg.to,411,0.02%,411,0,100.00%
zephir.monocul.us,411,0.02%,411,0,100.00%
ksn-file-geo.kaspersky-labs.com,410,0.02%,410,0,100.00%
dlied6.qq.com,409,0.02%,409,0,100.00%
update100.sangfor.com.cn,408,0.02%,779,371,52.37%
apple.com,406,0.02%,406,0,100.00%
infoc2.duba.net,406,0.02%,406,0,100.00%
safebrowsing.urlsec.qq.com,405,0.02%,405,0,100.00%
tracker.zerobytes.xyz,403,0.02%,403,0,100.00%
sadownload.mcafee.com,403,0.02%,403,0,100.00%
br.666.mapow.link,402,0.02%,402,0,100.00%
mail.163.com,400,0.02%,400,0,100.00%
sf.symcb.com,398,0.02%,694,296,57.35%
ib.sin1.geoadnxs.com,396,0.02%,396,0,100.00%
tm-sdk.platinumai.net,395,0.02%,395,0,100.00%
loki.ams.eulix.xyz,394,0.02%,394,0,100.00%
api.mathpix.com,393,0.02%,393,0,100.00%
pagead2.googlesyndication.com,391,0.02%,417,26,93.76%
crl.verisign.com,390,0.02%,705,315,55.32%
browser6.qhimg.com,387,0.02%,412,25,93.93%
cache.tv.qq.com,385,0.02%,472,87,81.57%
admin.kdsec.org,384,0.02%,384,0,100.00%
softcenter.os3.win.nfschina.com,383,0.02%,383,0,100.00%
opentor.org,381,0.02%,719,338,52.99%
usercount.dockernb.com,381,0.02%,381,0,100.00%
adashx.m.taobao.com,380,0.02%,380,0,100.00%
push.hicloud.com,379,0.02%,379,0,100.00%
7a37563370ded05f.jijifun.com,379,0.02%,379,0,100.00%
googlecode.l.googleusercontent.com,374,0.02%,725,351,51.59%
app.huabao.360.cn,373,0.02%,705,332,52.91%
msgsrv01.oray.net,373,0.02%,373,0,100.00%
fs.microsoft.com,372,0.02%,372,0,100.00%
accscdn.m.taobao.com,372,0.02%,372,0,100.00%
api.msn.com,371,0.02%,676,305,54.88%
free.publictracker.xyz,369,0.02%,369,0,100.00%
edu.uifr.ru,368,0.02%,368,0,100.00%
code.osssc.ac.cn,367,0.02%,367,0,100.00%
tracker.v6speed.org,366,0.02%,366,0,100.00%
developer.unity.cn,366,0.02%,366,0,100.00%
init.push.apple.com,366,0.02%,723,357,50.62%
valakas.rollo.dnsabr.com,362,0.02%,362,0,100.00%
interface.music.163.com,362,0.02%,363,1,99.72%
evalai.cn,361,0.02%,361,0,100.00%
tracker0.ufibox.com,360,0.02%,360,0,100.00%
bt.nfshost.com,359,0.02%,359,0,100.00%
hectorstatic.baidu.com,358,0.02%,473,115,75.69%
s.f.360.cn,358,0.02%,626,268,57.19%
fonts.googleapis.com,358,0.02%,370,12,96.76%
newtoncity.org,357,0.02%,357,0,100.00%
tracker.uw0.xyz,357,0.02%,357,0,100.00%
udp-tracker.shittyurl.org,357,0.02%,357,0,100.00%
1595096.sched.d0-dk.tdnsdp1.cn,356,0.02%,729,373,48.83%
skydrive.wns.windows.com,356,0.02%,657,301,54.19%
torrentclub.online,355,0.02%,355,0,100.00%
vibe.community,355,0.02%,355,0,100.00%
engplus.ru,352,0.02%,352,0,100.00%
torrentsmd.com,352,0.02%,352,0,100.00%
dss0.bdstatic.com,352,0.02%,360,8,97.78%
mail.realliferpg.de,351,0.02%,351,0,100.00%
ryrc.ruijienetworks.com,351,0.02%,351,0,100.00%
sp1.sangfor.com.cn,351,0.02%,351,0,100.00%
ts1.cn.mm.bing.net,348,0.02%,348,0,100.00%
update1.sangfor.net.cdn20.com,347,0.02%,347,0,100.00%
crl4.digicert.com,345,0.02%,621,276,55.56%
tracker.shkinev.me,345,0.02%,345,0,100.00%
mobile.events.data.trafficmanager.net,343,0.02%,379,36,90.50%
detectportal.firefox.com,341,0.02%,22983,22642,1.48%
www.jetbrains.com,341,0.02%,782,441,43.61%
substrate.office.com,340,0.02%,756,416,44.97%
googleads.g.doubleclick.net,340,0.02%,357,17,95.24%
ocsp2-lb.apple.com.akadns.net,337,0.02%,374,37,90.11%
e11290.dspg.akamaiedge.net,336,0.02%,688,352,48.84%
ic.wps.cn,336,0.02%,336,0,100.00%
roaming.officeapps.live.com,336,0.02%,336,0,100.00%
autopush.prod.mozaws.net,336,0.02%,336,0,100.00%
papi.funshion.com,336,0.02%,336,0,100.00%
account.jetbrains.com,335,0.02%,335,0,100.00%
www.gsd92gov.com,333,0.02%,333,0,100.00%
static.asm.skype.com,333,0.02%,333,0,100.00%
targetednotifications-tm.trafficmanager.net,332,0.02%,332,0,100.00%
d.pcs.baidu.com,332,0.02%,690,358,48.12%
officeclient.microsoft.com,331,0.02%,331,0,100.00%
imap.sina.com,330,0.02%,330,0,100.00%
notify.tabnine.com,330,0.02%,330,0,100.00%
mathpix.com,329,0.02%,642,313,51.25%
ts2.cn.mm.bing.net,329,0.02%,329,0,100.00%
fanghu.qianxin.com,329,0.02%,329,0,100.00%
mirrors.163.com,329,0.02%,329,0,100.00%
client-api.oray.com,328,0.02%,328,0,100.00%
v4.tiamato.com,327,0.02%,327,0,100.00%
cu005.www.duba.net,326,0.02%,326,0,100.00%
tracker.bt4g.com,325,0.02%,904,579,35.95%
shcu1.myddns.cyou,325,0.02%,325,0,100.00%
classify-client.services.mozilla.com,324,0.02%,324,0,100.00%
kv501.prod.do.dsp.mp.microsoft.com,324,0.02%,324,0,100.00%
gtm-sg-6wr2n62gk0f.gtm-i1d1.com,323,0.02%,323,0,100.00%
trakx.herokuapp.com,323,0.02%,323,0,100.00%
outlook.office365.com,322,0.02%,705,383,45.67%
filetracker.xyz,322,0.02%,789,467,40.81%
time1.apple.com,322,0.02%,322,0,100.00%
pss.bdstatic.com,321,0.02%,425,104,75.53%
uapi.mp.360.cn,320,0.02%,320,0,100.00%
gateway.icloud.com.cn,320,0.02%,320,0,100.00%
img-xlppc-zhan.xunlei.com,319,0.02%,734,415,43.46%
tracker.trackerfix.com,318,0.02%,318,0,100.00%
api.ultimaker.com,318,0.02%,318,0,100.00%
hk1-1.nigirocloud.com,318,0.02%,318,0,100.00%
2.cn.pool.ntp.org,317,0.02%,362,45,87.57%
wu-bg-shim.trafficmanager.net,316,0.02%,316,0,100.00%
nleditor.osi.office.net,315,0.02%,315,0,100.00%
tconf.b.qianxin.com,313,0.02%,313,0,100.00%
img.alicdn.com.danuoyi.alicdn.com,313,0.02%,638,325,49.06%
download.docker.com,313,0.02%,409,96,76.53%
api.atlassian.com,311,0.02%,311,0,100.00%
f062936a96d3c8bd.jijifun.com,311,0.02%,311,0,100.00%
download.windowsupdate.com.a.bdydns.com,310,0.02%,310,0,100.00%
shavar.services.mozilla.com,309,0.02%,309,0,100.00%
de2-4.nigirocloud.com,309,0.02%,309,0,100.00%
df.cache.wpscdn.cn,308,0.02%,501,193,61.48%
wp.mail.qq.com,308,0.02%,308,0,100.00%
datarouter.ol.epicgames.com,307,0.02%,307,0,100.00%
www.xilinx.com,307,0.02%,307,0,100.00%
ns-eh2-prod-dm2-511.cloudapp.net,306,0.02%,306,0,100.00%
pico.eset.com,305,0.02%,305,0,100.00%
video-hw-drcn.dbankcdn.cn,305,0.02%,686,381,44.46%
tracker.nitrix.me,304,0.02%,623,319,48.80%
cloud.streamsets.com,303,0.02%,303,0,100.00%
www.163.com,302,0.02%,775,473,38.97%
array606.prod.do.dsp.mp.microsoft.com,302,0.02%,302,0,100.00%
webquotepic.eastmoney.com,301,0.02%,301,0,100.00%
init.push-apple.com.akadns.net,300,0.02%,655,355,45.80%
www.deepl.com,299,0.02%,299,0,100.00%
tlu.dl.delivery.mp.microsoft.com.w.alikunlun.com,297,0.02%,297,0,100.00%
q.cnblogs.com,296,0.02%,296,0,100.00%
remind.api.weibo.com,296,0.02%,569,273,52.02%
updates.os.nfschina.com,296,0.02%,296,0,100.00%
2535-ipv4e.clump.dprodmgd106.aa-rt.sharepoint.com,296,0.02%,296,0,100.00%
ds.kaspersky.com,295,0.02%,295,0,100.00%
oth.eve.mdt.qq.com,295,0.02%,295,0,100.00%
web-drcn.hispace.dbankcloud.cn,295,0.02%,295,0,100.00%
pki-goog.l.google.com,294,0.02%,335,41,87.76%
sp1.baidu.com,293,0.02%,541,248,54.16%
dl.google.com,293,0.02%,310,17,94.52%
geo.prod.do.dsp.mp.microsoft.com,292,0.02%,299,7,97.66%
p1.ssl.qhimg.com,291,0.02%,301,10,96.68%
dss1.bdstatic.com,288,0.02%,293,5,98.29%
hk1-8.nigirocloud.com,288,0.02%,288,0,100.00%
s.xinshuru.com,288,0.02%,288,0,100.00%
rm.api.weibo.com,287,0.02%,515,228,55.73%
miserupdate.aliyun.com,286,0.02%,286,0,100.00%
client.teamviewer.com,285,0.02%,285,0,100.00%
api-std.sunlogin.oray.com,284,0.02%,284,0,100.00%
task.browser.360.cn,283,0.02%,283,0,100.00%
array513.prod.do.dsp.mp.microsoft.com,282,0.02%,556,274,50.72%
www.google.com.hk,281,0.02%,534,253,52.62%
visualstudio-devdiv-c2s-msedge-net.e-0009.e-msedge.net,280,0.02%,280,0,100.00%
www.m9ynqi6d.com,280,0.02%,280,0,100.00%
msedge.api.cdp.microsoft.com,279,0.02%,614,335,45.44%
usa.cloudv2a.com,279,0.02%,279,0,100.00%
mcs-bd.feishu.cn,278,0.02%,278,0,100.00%
tracker.hama3.net,278,0.02%,561,283,49.55%
clients.l.google.com,278,0.02%,384,106,72.40%
help-tower.2345.cc,277,0.02%,277,0,100.00%
ai1.acciff.com,275,0.02%,275,0,100.00%
filedownload.lenovo.com,275,0.02%,275,0,100.00%
ug.baidu.com,274,0.02%,488,214,56.15%
changer8.net,274,0.02%,274,0,100.00%
nk1.boom.skin,273,0.02%,273,0,100.00%
ue.lenovomm.cn,270,0.02%,270,0,100.00%
tracker.coalition.space,270,0.02%,519,249,52.02%
cs9.wac.phicdn.net,269,0.02%,629,360,42.77%
fm.dl.126.net,267,0.02%,267,0,100.00%
update.code.visualstudio.com,267,0.02%,267,0,100.00%
shmmsns.qpic.cn,266,0.02%,662,396,40.18%
tlu.dl.delivery.mp.microsoft.com,266,0.02%,274,8,97.08%
mail.nfschina.com,266,0.02%,266,0,100.00%
ins-mfa9hirw.ias.tencent-cloud.net,265,0.02%,265,0,100.00%
gecko-bd.feishu.cn,265,0.02%,265,0,100.00%
hk1-5.nigirocloud.com,264,0.02%,264,0,100.00%
t-safe.2345.cc,264,0.02%,264,0,100.00%
runc.myddns.cyou,263,0.02%,263,0,100.00%
k128-mzstatic.gslb.ksyuncdn.com,262,0.02%,262,0,100.00%
softbus-device.wps.cn,262,0.02%,262,0,100.00%
api2.firefoxchina.cn,262,0.02%,262,0,100.00%
us1-2.nigirocloud.com,262,0.02%,262,0,100.00%
vhyifw.top,262,0.02%,262,0,100.00%
ime.sogou.com,261,0.02%,261,0,100.00%
nowpick.nowcoder.com,260,0.02%,260,0,100.00%
flbgpi.meiquankongjian.com,260,0.02%,260,0,100.00%
ck-groups.xyz,260,0.02%,260,0,100.00%
client-office365-tas.msedge.net,258,0.02%,258,0,100.00%
dyn.wps.cn,256,0.02%,256,0,100.00%
hk1-4.nigirocloud.com,256,0.02%,256,0,100.00%
c2.pcs.baidu.com,255,0.02%,469,214,54.37%
l2.hiwifi.com,253,0.01%,253,0,100.00%
mcs-bd.feishu.cn.w.cdngslb.com,252,0.01%,252,0,100.00%
ocsp.entrust.net,252,0.01%,559,307,45.08%
upos-sz-mirrorali.bilivideo.com,252,0.01%,252,0,100.00%
ins-g4ztq7u7.ias.tencent-cloud.net,252,0.01%,252,0,100.00%
r4.res.office365.com,252,0.01%,544,292,46.32%
array607.prod.do.dsp.mp.microsoft.com,251,0.01%,251,0,100.00%
rum.h5.weibo.cn,251,0.01%,251,0,100.00%
imap-mail.outlook.com,250,0.01%,528,278,47.35%
developer.atlassian.com,250,0.01%,250,0,100.00%
de2-1.nigirocloud.com,250,0.01%,250,0,100.00%
ty2-6.nigirocloud.com,249,0.01%,249,0,100.00%
zconfig.alibabausercontent.com,249,0.01%,546,297,45.60%
api.onedrive.com,248,0.01%,390,142,63.59%
pos.baidu.com,248,0.01%,248,0,100.00%
array802.prod.do.dsp.mp.microsoft.com,248,0.01%,248,0,100.00%
gameplay.intel.com,247,0.01%,509,262,48.53%
pgdt.gtimg.cn,247,0.01%,420,173,58.81%
st.todesk.com,247,0.01%,247,0,100.00%
push2.eastmoney.com,247,0.01%,456,209,54.17%
au1-3.nigirocloud.com,247,0.01%,247,0,100.00%
ee1-1.nigirocloud.com,247,0.01%,247,0,100.00%
is.iscas.ac.cn,246,0.01%,246,0,100.00%
cdn.fwupd.org,246,0.01%,246,0,100.00%
tuna02.mcddns01.com,246,0.01%,246,0,100.00%
webquotestaticpic.dfcfw.com,245,0.01%,245,0,100.00%
stream.zotero.org,244,0.01%,459,215,53.16%
sp0.baidu.com,244,0.01%,428,184,57.01%
au1-1.nigirocloud.com,243,0.01%,243,0,100.00%
us1-1.nigirocloud.com,243,0.01%,243,0,100.00%
us2-3.nigirocloud.com,243,0.01%,243,0,100.00%
us2-4.nigirocloud.com,243,0.01%,243,0,100.00%
a.w.bilicdn1.com,242,0.01%,317,75,76.34%
hk1-6.nigirocloud.com,242,0.01%,242,0,100.00%
au2-4.nigirocloud.com,242,0.01%,242,0,100.00%
ty1-4.nigirocloud.com,241,0.01%,241,0,100.00%
imap.cstnet.cn,241,0.01%,241,0,100.00%
gateway.bitrenren.com,240,0.01%,515,275,46.60%
weather-data.apple.com,240,0.01%,470,230,51.06%
os1-5.nigirocloud.com,240,0.01%,240,0,100.00%
os2-2.nigirocloud.com,240,0.01%,240,0,100.00%
us3-3.nigirocloud.com,240,0.01%,240,0,100.00%
au1-2.nigirocloud.com,240,0.01%,240,0,100.00%
de1-2.nigirocloud.com,240,0.01%,240,0,100.00%
de1-3.nigirocloud.com,240,0.01%,240,0,100.00%
de2-3.nigirocloud.com,240,0.01%,240,0,100.00%
csdnimg.cn,240,0.01%,240,0,100.00%
array806.prod.do.dsp.mp.microsoft.com,239,0.01%,239,0,100.00%
us3-7.nigirocloud.com,239,0.01%,239,0,100.00%
nl3-2.nigirocloud.com,239,0.01%,239,0,100.00%
www.tm.a.prd.aadg.trafficmanager.net,239,0.01%,239,0,100.00%
au2-2.nigirocloud.com,239,0.01%,239,0,100.00%
ee1-3.nigirocloud.com,239,0.01%,239,0,100.00%
ty2-3.nigirocloud.com,239,0.01%,239,0,100.00%
us3-6.nigirocloud.com,238,0.01%,238,0,100.00%
ty2-4.nigirocloud.com,238,0.01%,238,0,100.00%
os1-3.nigirocloud.com,238,0.01%,238,0,100.00%
www.msn.cn,238,0.01%,255,17,93.33%
ssl.gstatic.com,237,0.01%,679,442,34.90%
vdwmto3.bdstatic.com,237,0.01%,395,158,60.00%
nl1-1.nigirocloud.com,237,0.01%,237,0,100.00%
nl1-5.nigirocloud.com,237,0.01%,237,0,100.00%
nl1-7.nigirocloud.com,237,0.01%,237,0,100.00%
qbwup.imtt.qq.com,237,0.01%,237,0,100.00%
ee1-4.nigirocloud.com,237,0.01%,237,0,100.00%
t-safe.2345.com,237,0.01%,237,0,100.00%
ty1-1.nigirocloud.com,236,0.01%,236,0,100.00%
au2-1.nigirocloud.com,236,0.01%,236,0,100.00%
os1-6.nigirocloud.com,236,0.01%,236,0,100.00%
us3-2.nigirocloud.com,236,0.01%,236,0,100.00%
internal-api-lark-api.feishu.cn,235,0.01%,235,0,100.00%
os1-7.nigirocloud.com,234,0.01%,234,0,100.00%
nl1-2.nigirocloud.com,234,0.01%,234,0,100.00%
nl1-6.nigirocloud.com,234,0.01%,234,0,100.00%
us3-1.nigirocloud.com,234,0.01%,234,0,100.00%
us3-4.nigirocloud.com,234,0.01%,234,0,100.00%
securetoken.googleapis.com,234,0.01%,246,12,95.12%
ty1-2.nigirocloud.com,233,0.01%,233,0,100.00%
us3-8.nigirocloud.com,233,0.01%,233,0,100.00%
nl1-8.nigirocloud.com,233,0.01%,233,0,100.00%
nl3-6.nigirocloud.com,233,0.01%,233,0,100.00%
device.sangfor.com.cn,233,0.01%,233,0,100.00%
adservice.google.com,233,0.01%,256,23,91.02%
o.lencr.edgesuite.net,233,0.01%,235,2,99.15%
5kong4.com,232,0.01%,232,0,100.00%
mumu.nie.netease.com,232,0.01%,421,189,55.11%
mail.iie.ac.cn,232,0.01%,423,191,54.85%
t8.baidu.com,231,0.01%,293,62,78.84%
uk1-4.nigirocloud.com,231,0.01%,231,0,100.00%
service.fanxing.kugou.com,231,0.01%,481,250,48.02%
au1-4.nigirocloud.com,231,0.01%,231,0,100.00%
ee1-2.nigirocloud.com,231,0.01%,231,0,100.00%
us1-4.nigirocloud.com,231,0.01%,231,0,100.00%
kv601.prod.do.dsp.mp.microsoft.com,231,0.01%,231,0,100.00%
ipv6.l.google.com,231,0.01%,539,308,42.86%
os2-6.nigirocloud.com,230,0.01%,230,0,100.00%
uk1-2.nigirocloud.com,230,0.01%,230,0,100.00%
us2-2.nigirocloud.com,230,0.01%,230,0,100.00%
os2-5.nigirocloud.com,230,0.01%,230,0,100.00%
gcr.io,230,0.01%,431,201,53.36%
tracker.moeblog.cn,229,0.01%,536,307,42.72%
nl3-1.nigirocloud.com,229,0.01%,229,0,100.00%
de1-1.nigirocloud.com,229,0.01%,229,0,100.00%
msedge.b.tlu.dl.delivery.mp.microsoft.com,229,0.01%,230,1,99.57%
ty2-2.nigirocloud.com,228,0.01%,228,0,100.00%
os2-3.nigirocloud.com,228,0.01%,228,0,100.00%
hk1-2.nigirocloud.com,228,0.01%,228,0,100.00%
us3-5.nigirocloud.com,228,0.01%,228,0,100.00%
blades.aliyun.com,227,0.01%,227,0,100.00%
de1-4.nigirocloud.com,227,0.01%,227,0,100.00%
mccontacts.mail.163.com,227,0.01%,227,0,100.00%
outlook.ha.office365.com,226,0.01%,463,237,48.81%
uz95.v.trpcdn.net,226,0.01%,226,0,100.00%
aapl-maps.qtlcdn.com,226,0.01%,436,210,51.83%
os2-8.nigirocloud.com,226,0.01%,226,0,100.00%
au2-3.nigirocloud.com,226,0.01%,226,0,100.00%
gimg3.baidu.com,225,0.01%,286,61,78.67%
t.helper.2345.cc,225,0.01%,225,0,100.00%
os1-4.nigirocloud.com,225,0.01%,225,0,100.00%
os2-1.nigirocloud.com,225,0.01%,225,0,100.00%
nl1-3.nigirocloud.com,225,0.01%,225,0,100.00%
ins-qw3q8ofk.ias.tencent-cloud.net,225,0.01%,225,0,100.00%
lax.link.ac.cn,225,0.01%,225,0,100.00%
de2-2.nigirocloud.com,225,0.01%,225,0,100.00%
api.bilibili.com,225,0.01%,271,46,83.03%
normandy-cdn.services.mozilla.com,224,0.01%,224,0,100.00%
ty2-8.nigirocloud.com,224,0.01%,224,0,100.00%
nl3-7.nigirocloud.com,224,0.01%,224,0,100.00%
ty2-1.nigirocloud.com,224,0.01%,224,0,100.00%
ty2-5.nigirocloud.com,224,0.01%,224,0,100.00%
t7.baidu.com,223,0.01%,300,77,74.33%
vv.video.qq.com,223,0.01%,223,0,100.00%
os1-8.nigirocloud.com,223,0.01%,223,0,100.00%
nl3-8.nigirocloud.com,223,0.01%,223,0,100.00%
gateway.fe.apple-dns.cn,223,0.01%,223,0,100.00%
hk1-3.nigirocloud.com,223,0.01%,223,0,100.00%
us1-3.nigirocloud.com,223,0.01%,223,0,100.00%
us2-1.nigirocloud.com,223,0.01%,223,0,100.00%
api.geetest.com,223,0.01%,223,0,100.00%
smartscreen-prod.microsoft.com,223,0.01%,223,0,100.00%
help.origin-apple.com.akadns.net,223,0.01%,223,0,100.00%
t.undefined-site.top,222,0.01%,222,0,100.00%
emoji.qpic.cn,222,0.01%,264,42,84.09%
g.live.com,222,0.01%,404,182,54.95%
bt2.archive.org,222,0.01%,447,225,49.66%
ntp.aliyun.com,222,0.01%,222,0,100.00%
advanced-cm-1.nodesub.com,222,0.01%,222,0,100.00%
cmrelay-basic-1.nodesub.com,222,0.01%,222,0,100.00%
bsg.w.bilicdn1.com,221,0.01%,221,0,100.00%
uk1-1.nigirocloud.com,221,0.01%,221,0,100.00%
c9b086079795c442.jijifun.com,221,0.01%,221,0,100.00%
alpha-cloud-log.cn-hangzhou.log.aliyuncs.com,221,0.01%,221,0,100.00%
tls-eleme.dingtalk.com,221,0.01%,221,0,100.00%
aus5.mozilla.org,221,0.01%,221,0,100.00%
config.i.duba.net,221,0.01%,221,0,100.00%
yqy2356.melissauvc.com,221,0.01%,221,0,100.00%
app.jianguoyun.com,219,0.01%,219,0,100.00%
nl3-5.nigirocloud.com,219,0.01%,219,0,100.00%
glacial-ravine-7295.morning-tundra-7160.herokuspace.com,219,0.01%,219,0,100.00%
transit1.wslog.chinanetcenter.com,219,0.01%,219,0,100.00%
message.bilibili.com,219,0.01%,351,132,62.39%
os2-7.nigirocloud.com,218,0.01%,218,0,100.00%
uk1-3.nigirocloud.com,218,0.01%,218,0,100.00%
g.csdnimg.cn,218,0.01%,218,0,100.00%
max-l.mediav.com,217,0.01%,217,0,100.00%
nl3-4.nigirocloud.com,217,0.01%,217,0,100.00%
advanced-cm-2.nodesub.com,217,0.01%,217,0,100.00%
nl3-3.nigirocloud.com,216,0.01%,216,0,100.00%
prod.nexusrules.live.com.akadns.net,216,0.01%,428,212,50.47%
api.github.com,215,0.01%,215,0,100.00%
os1-1.nigirocloud.com,215,0.01%,215,0,100.00%
outlook.gogo66.cloud,215,0.01%,414,199,51.93%
ty2-7.nigirocloud.com,215,0.01%,215,0,100.00%
os2-4.nigirocloud.com,214,0.01%,214,0,100.00%
functional.events.data.microsoft.com,214,0.01%,235,21,91.06%
os1-2.nigirocloud.com,213,0.01%,213,0,100.00%
2.debian.pool.ntp.org,213,0.01%,346,133,61.56%
cn-shenzhen.axt.aliyun.com,213,0.01%,213,0,100.00%
pc-plugin.wpscdn.cn,213,0.01%,213,0,100.00%
beacons2.gvt2.com,212,0.01%,221,9,95.93%
arc.trafficmanager.net,212,0.01%,212,0,100.00%
www.sogou.com,212,0.01%,212,0,100.00%
dl.qianxin.com,212,0.01%,212,0,100.00%
prod-classifyclient.normandy.prod.cloudops.mozgcp.net,211,0.01%,211,0,100.00%
pss.alicdn.com,211,0.01%,211,0,100.00%
bugreport.huorong.cn,211,0.01%,633,422,33.33%
vpn.oceanum.cn,211,0.01%,211,0,100.00%
api.docer.wpscdn.cn,211,0.01%,436,225,48.39%
account.sogou.com,211,0.01%,211,0,100.00%
sqm.telemetry.microsoft.com,211,0.01%,211,0,100.00%
api.im.qcloud.com,210,0.01%,210,0,100.00%
vscode-sync-ase-01.azurewebsites.net,210,0.01%,210,0,100.00%
na61-na62.wagbridge.alibaba.alibaba.com,210,0.01%,390,180,53.85%
nk5.boom.skin,210,0.01%,210,0,100.00%
yd-01.paofunlink.com,210,0.01%,210,0,100.00%
tt.browser.360.cn,208,0.01%,208,0,100.00%
packages.microsoft.com,207,0.01%,207,0,100.00%
vpn.ios.ac.cn,207,0.01%,207,0,100.00%
ty1-3.nigirocloud.com,206,0.01%,206,0,100.00%
downloads.upd.kaspersky.com,206,0.01%,206,0,100.00%
array511.prod.do.dsp.mp.microsoft.com,206,0.01%,206,0,100.00%
appsso.oh.isrc.ac.cn,206,0.01%,206,0,100.00%
clients6.google.com,204,0.01%,241,37,84.65%
array506.prod.do.dsp.mp.microsoft.com,204,0.01%,392,188,52.04%
dashenga.com,204,0.01%,204,0,100.00%
evoke-windowsservices-tas.msedge.net,204,0.01%,204,0,100.00%
e4518.dscapi7.akamaiedge.net,204,0.01%,406,202,50.25%
upload.fp.measure.office.com,204,0.01%,367,163,55.59%
ogf.gaoliang.im,204,0.01%,204,0,100.00%
tracker1.myporn.club,203,0.01%,311,108,65.27%
www.wshifen.com,203,0.01%,203,0,100.00%
submit.sb.avast.com,203,0.01%,203,0,100.00%
bt1.archive.org,203,0.01%,411,208,49.39%
ocsp2.apple.com,202,0.01%,231,29,87.45%
t9.baidu.com,202,0.01%,270,68,74.81%
qdyn.wps.cn,202,0.01%,202,0,100.00%
6fe97759aa27a0c9.jijifun.com,202,0.01%,202,0,100.00%
deepl.com,202,0.01%,202,0,100.00%
e-0009.e-msedge.net,201,0.01%,201,0,100.00%
update.cs2c.com.cn,201,0.01%,201,0,100.00%
newtab.firefoxchina.cn,201,0.01%,371,170,54.18%
tracker.bitsearch.to,201,0.01%,315,114,63.81%
mbsug.ssl.so.com,200,0.01%,200,0,100.00%
nl1-4.nigirocloud.com,200,0.01%,200,0,100.00%
docs.google.com,200,0.01%,393,193,50.89%
wss.im.qcloud.com,199,0.01%,199,0,100.00%
cc-api-data.adobe.io,199,0.01%,199,0,100.00%
tracker.pussytorrents.org,199,0.01%,312,113,63.78%
rm-2zelg248g7y2034w7do.mysql.rds.aliyuncs.com,198,0.01%,198,0,100.00%
www.googletagmanager.com,198,0.01%,208,10,95.19%
tw02.ipv2.xyz,198,0.01%,198,0,100.00%
info.lenovo.com.cn,197,0.01%,197,0,100.00%
dig.bdurl.net,197,0.01%,197,0,100.00%
webrtcpunch.video.qq.com,197,0.01%,197,0,100.00%
t.khd.2345.cc,195,0.01%,195,0,100.00%
all.feishu.cn.w.kunluncan.com,195,0.01%,195,0,100.00%
seapp.stat.360safe.com,195,0.01%,195,0,100.00%
cloud-rest.lenovomm.com,194,0.01%,194,0,100.00%
connect.unity.cn,194,0.01%,194,0,100.00%
fb98ab9159f51fd0.jijifun.com,194,0.01%,194,0,100.00%
tpc.googlesyndication.com,194,0.01%,215,21,90.23%
fonts.gstatic.com,194,0.01%,197,3,98.48%
ncc.avast.com,193,0.01%,410,217,47.07%
pcfg.wps.cn,193,0.01%,193,0,100.00%
ocsp.pki.goog,193,0.01%,214,21,90.19%
tp.m-team.cc,192,0.01%,424,232,45.28%
video.yidianzixun.com,192,0.01%,192,0,100.00%
gates.grammarly.com,191,0.01%,191,0,100.00%
dl.pop.www.duba.net,191,0.01%,191,0,100.00%
edge.ivideo.sina.com.cn,190,0.01%,457,267,41.58%
self-events-data.trafficmanager.net,190,0.01%,222,32,85.59%
www.bilibili.com,188,0.01%,224,36,83.93%
miao.baidu.com,188,0.01%,188,0,100.00%
video-tx-drcn.dbankcdn.cn,188,0.01%,399,211,47.12%
mbd.baidu.com,188,0.01%,188,0,100.00%
orange-pcsafe.2345.cc,188,0.01%,188,0,100.00%
webquoteklinepic.eastmoney.com,187,0.01%,187,0,100.00%
pc-api.wondershare.cc,187,0.01%,187,0,100.00%
signaler-pa.clients6.google.com,186,0.01%,349,163,53.30%
inference.location.live.net,186,0.01%,186,0,100.00%
wss.tim.qq.com,186,0.01%,186,0,100.00%
ocsp2-cn-lb.apple.com.akadns.net,185,0.01%,204,19,90.69%
nk2.boom.skin,185,0.01%,185,0,100.00%
al04.bb.wdpdk.link,184,0.01%,184,0,100.00%
dup.baidustatic.com,184,0.01%,184,0,100.00%
notifier-configs.airbrake.io,183,0.01%,390,207,46.92%
t14.baidu.com,183,0.01%,258,75,70.93%
www.n1ui5fms.net,183,0.01%,183,0,100.00%
a1961.g2.akamai.net,181,0.01%,181,0,100.00%
upos-sz-mirrorhwo1.bilivideo.com,181,0.01%,279,98,64.87%
color.docer.wps.cn,181,0.01%,181,0,100.00%
lz4hlmtcf5.feishu.cn,181,0.01%,181,0,100.00%
1.ubuntu.pool.ntp.org,181,0.01%,181,0,100.00%
2.rhel.pool.ntp.org,180,0.01%,186,6,96.77%
b.bdstatic.com,179,0.01%,246,67,72.76%
img0yjvjvvuvw.cdn.cache102.xyz,179,0.01%,179,0,100.00%
f5-ck.zhhainiao.com,179,0.01%,179,0,100.00%
map.baidu.com,179,0.01%,429,250,41.72%
www.jos.org.cn,179,0.01%,179,0,100.00%
ss0.baidu.com,178,0.01%,304,126,58.55%
www.overleaf.com,178,0.01%,178,0,100.00%
www.liebao.cn,178,0.01%,178,0,100.00%
officecdn.microsoft.com,178,0.01%,178,0,100.00%
ss1.baidu.com,177,0.01%,302,125,58.61%
diskapi.n.shifen.com,177,0.01%,350,173,50.57%
mambap2pvodh5.8686c.com,177,0.01%,177,0,100.00%
pic.people.com.cn,177,0.01%,762,585,23.23%
ocsp.apple.com,176,0.01%,196,20,89.80%
activity.windows.com,176,0.01%,176,0,100.00%
ss2.baidu.com,175,0.01%,292,117,59.93%
tracker.tfile.co,174,0.01%,174,0,100.00%
ss3.baidu.com,174,0.01%,289,115,60.21%
am.abc.wdpdk.link,174,0.01%,174,0,100.00%
luckyvideo.peopletech.cn,174,0.01%,174,0,100.00%
shavar.prod.mozaws.net,173,0.01%,173,0,100.00%
hovv.yilanvaas.com,173,0.01%,394,221,43.91%
time-ios.g.aaplimg.com,173,0.01%,173,0,100.00%
fclick.baidu.com,172,0.01%,172,0,100.00%
telemetry-incoming.r53-2.services.mozilla.com,172,0.01%,172,0,100.00%
update.eset.com,171,0.01%,171,0,100.00%
array601.prod.do.dsp.mp.microsoft.com,171,0.01%,171,0,100.00%
c2s3.jamjams3.net,171,0.01%,171,0,100.00%
broadcast.chat.bilibili.com,170,0.01%,170,0,100.00%
wdl1.file.cache.docer.com,170,0.01%,253,83,67.19%
g.ceipmsn.com,170,0.01%,170,0,100.00%
dl.ijinshan.com,169,0.01%,169,0,100.00%
ceea167a5a36dedd.jijifun.com,169,0.01%,169,0,100.00%
waws-prod-sg1-051.sip.azurewebsites.windows.net,168,0.01%,168,0,100.00%
cs22.wpc.v0cdn.net,168,0.01%,168,0,100.00%
tracker.istole.it,168,0.01%,168,0,100.00%
aka.ms,168,0.01%,168,0,100.00%
gsp0.baidu.com,168,0.01%,168,0,100.00%
ins-59d1h3tv.ias.tencent-cloud.net,167,0.01%,316,149,52.85%
www.i0rp1l2j.com,167,0.01%,167,0,100.00%
sl-log.oray.net,166,0.01%,166,0,100.00%
input.shouji.sogou.com,166,0.01%,166,0,100.00%
xcx.www.gov.cn,166,0.01%,166,0,100.00%
slardar-bd.feishu.cn.w.cdngslb.com,165,0.01%,165,0,100.00%
feilian-staging.bytedance.com,165,0.01%,165,0,100.00%
down.anticheatexpert.com,165,0.01%,165,0,100.00%
eu-west-1.axt.aliyun.com,164,0.01%,164,0,100.00%
array615.prod.do.dsp.mp.microsoft.com,164,0.01%,164,0,100.00%
music.163.com,164,0.01%,214,50,76.64%
0.cn.pool.ntp.org,163,0.01%,163,0,100.00%
yuri.app.kdsec.org,163,0.01%,163,0,100.00%
safebrowsing.google.com,162,0.01%,162,0,100.00%
pubsub02.oray.net,162,0.01%,162,0,100.00%
dl.delivery.mp.microsoft.com,162,0.01%,176,14,92.05%
update.nsfocus.com,162,0.01%,162,0,100.00%
opentracker.xyz,161,0.01%,20905,20744,0.77%
metrics1.data.hicloud.com,161,0.01%,161,0,100.00%
gecko-bd.feishu.cn.w.cdngslb.com,161,0.01%,161,0,100.00%
res.ldmnq.com,161,0.01%,161,0,100.00%
clientlogvodp2p.haplat.net,160,0.01%,160,0,100.00%
download.api.bsb.baidu.com,160,0.01%,160,0,100.00%
passport.escience.cn,159,0.01%,159,0,100.00%
5.rlb.router.teamviewer.cn,159,0.01%,159,0,100.00%
crl3.digicert.com,159,0.01%,286,127,55.59%
ts.eset.com,159,0.01%,159,0,100.00%
zhanzhang.toutiao.com,159,0.01%,159,0,100.00%
ts4.cn.mm.bing.net,158,0.01%,158,0,100.00%
stock2.finance.sina.com.cn,158,0.01%,158,0,100.00%
profile-avatar.csdnimg.cn,158,0.01%,158,0,100.00%
openway.guance.com,158,0.01%,158,0,100.00%
china.bing123.com,157,0.01%,157,0,100.00%
api.insight.synology.com,157,0.01%,157,0,100.00%
s.ludashi.com,157,0.01%,157,0,100.00%
ieonlinews.microsoft.com,157,0.01%,284,127,55.28%
e8652.dscx.akamaiedge.net,157,0.01%,317,160,49.53%
new.weibo.cn,157,0.01%,157,0,100.00%
umwatson.events.data.microsoft.com,156,0.01%,181,25,86.19%
ssxd.mediav.com,156,0.01%,156,0,100.00%
wns.notify.trafficmanager.net,156,0.01%,298,142,52.35%
mm.ilovescholar.xyz,156,0.01%,156,0,100.00%
marketplace.opennebula.systems,155,0.01%,155,0,100.00%
www.google-analytics.com,154,0.01%,297,143,51.85%
nk7.boom.skin,154,0.01%,154,0,100.00%
android.l.google.com,153,0.01%,153,0,100.00%
tracker.vanitycore.co,153,0.01%,261,108,58.62%
ss1.bdstatic.com,153,0.01%,153,0,100.00%
t13.baidu.com,153,0.01%,207,54,73.91%
array507.prod.do.dsp.mp.microsoft.com,153,0.01%,153,0,100.00%
nk3.boom.skin,153,0.01%,153,0,100.00%
login.partner.microsoftonline.cn,153,0.01%,153,0,100.00%
wn.pos.baidu.com,152,0.01%,152,0,100.00%
appledownload.qtlcdn.com,152,0.01%,152,0,100.00%
r3.o.lencr.org,152,0.01%,330,178,46.06%
www.qq.com,151,0.01%,2125,1974,7.11%
shuc-other.ksord.com,151,0.01%,151,0,100.00%
gm.mmstat.com,151,0.01%,151,0,100.00%
na61-na62.wagbridge.alibaba.alibaba.com.gds.alibabadns.com,151,0.01%,151,0,100.00%
zhihu-web-analytics.zhihu.com,151,0.01%,182,31,82.97%
3.ubuntu.pool.ntp.org,151,0.01%,151,0,100.00%
dc1-st.ksn.kaspersky-labs.com,151,0.01%,151,0,100.00%
services.addons.mozilla.org,151,0.01%,151,0,100.00%
mail.126.com,150,0.01%,150,0,100.00%
www.mi.com,150,0.01%,321,171,46.73%
mrodevicemgr.officeapps.live.com,150,0.01%,285,135,52.63%
dotbeats.douyucdn.cn,149,0.01%,149,0,100.00%
hashcloud.cz,149,0.01%,149,0,100.00%
a1887.dscq.akamai.net,149,0.01%,299,150,49.83%
nat-port-1.verysync.cn,149,0.01%,149,0,100.00%
readpaper.com,149,0.01%,149,0,100.00%
outlook.ms-acdc.office.com,148,0.01%,323,175,45.82%
gateway.icloud.com,148,0.01%,269,121,55.02%
fsrcn.lenovomm.com,148,0.01%,148,0,100.00%
1.courier-sandbox-push-apple.com.akadns.net,148,0.01%,148,0,100.00%
apis.mosaic.analytics.awscommon.mcafee.com,148,0.01%,148,0,100.00%
4005f8da13f42943.jijifun.com,147,0.01%,147,0,100.00%
live.github.com,147,0.01%,147,0,100.00%
mam.netease.com,147,0.01%,147,0,100.00%
7.rlb.router.teamviewer.cn,147,0.01%,147,0,100.00%
cm-cn-central-00001.albatross.10086.cn,146,0.01%,146,0,100.00%
wdcp.microsoft.com,145,0.01%,145,0,100.00%
imap.163.com,145,0.01%,145,0,100.00%
ocsp.verisign.com,145,0.01%,302,157,48.01%
tracker.internetwarriors.net,144,0.01%,144,0,100.00%
uqhdkynyqiccr0ff-gzo0ffeun6pvl9od-gebf7khwpyapzzta.prprmoe.xyz,144,0.01%,144,0,100.00%
browser.360.cn.qh-cdn.com,143,0.01%,148,5,96.62%
notify.adobe.io,143,0.01%,143,0,100.00%
file.drivergenius.com,143,0.01%,143,0,100.00%
proxy.whaledata.com,143,0.01%,143,0,100.00%
tw01.ipv2.xyz,143,0.01%,143,0,100.00%
HND-efz.ms-acdc.office.com,142,0.01%,316,174,44.94%
gm.gds.mmstat.com,142,0.01%,142,0,100.00%
jp04.v2netapp.com,142,0.01%,142,0,100.00%
e15275.g.akamaiedge.net,142,0.01%,142,0,100.00%
post.ksosoft.com,142,0.01%,142,0,100.00%
dcagent.mecdn.synacast.com,142,0.01%,142,0,100.00%
pcrec.baidu.com,142,0.01%,250,108,56.80%
dynsrv.wps.cn,142,0.01%,142,0,100.00%
14.tlu.dl.delivery.mp.microsoft.com,142,0.01%,142,0,100.00%
www-www.bing.com.trafficmanager.net,141,0.01%,151,10,93.38%
beacons.gvt2.com,141,0.01%,334,193,42.22%
skl.la1.mclqp.link,141,0.01%,141,0,100.00%
res.wx.qq.com.sched.legopic1.tdnsv6.com,140,0.01%,140,0,100.00%
t15.baidu.com,140,0.01%,182,42,76.92%
nk6.boom.skin,140,0.01%,140,0,100.00%
2.pool.ntp.org,139,0.01%,254,115,54.72%
zz.bdstatic.com,139,0.01%,139,0,100.00%
storecatalogrevocation.storequality.microsoft.com,139,0.01%,139,0,100.00%
st.pinyin.sogou.com,138,0.01%,138,0,100.00%
img-home.csdnimg.cn,138,0.01%,138,0,100.00%
kiteweb.b-cdn.net,138,0.01%,322,184,42.86%
mini.360.cn,137,0.01%,163,26,84.05%
fe2cr.update.microsoft.com,137,0.01%,297,160,46.13%
exmail.qq.com,137,0.01%,137,0,100.00%
update-khd.2345.cc,136,0.01%,136,0,100.00%
helpdesktop1.ksmobile.com,136,0.01%,136,0,100.00%
atm-settingsfe-prod-geo2.trafficmanager.NET,136,0.01%,136,0,100.00%
bizapi.csdn.net,136,0.01%,136,0,100.00%
vtnt.cnode.xyz,135,0.01%,135,0,100.00%
api.live.bilibili.com,135,0.01%,151,16,89.40%
ntes53.mail.163.com,135,0.01%,135,0,100.00%
api.appcues.net,135,0.01%,135,0,100.00%
pc.profile.qqpy.sogou.com,135,0.01%,135,0,100.00%
fa000000105.resources.office.net,134,0.01%,277,143,48.38%
objects.githubusercontent.com,134,0.01%,134,0,100.00%
ts.qq.com,134,0.01%,941,807,14.24%
cs.dds.microsoft.com,134,0.01%,134,0,100.00%
dc1-file.ksn.kaspersky-labs.com,134,0.01%,134,0,100.00%
hw-web-player-tracker.biliapi.net,133,0.01%,133,0,100.00%
pis-pcdn.youku.com,133,0.01%,133,0,100.00%
nsl.lenovo.com.cn,133,0.01%,133,0,100.00%
api.weibo.cn,133,0.01%,317,184,41.96%
bgpv4.music.ntes53.netease.com,133,0.01%,133,0,100.00%
datacluster4.cipsup.cn,133,0.01%,133,0,100.00%
array812.prod.do.dsp.mp.microsoft.com,133,0.01%,133,0,100.00%
ts3.cn.mm.bing.net,132,0.01%,132,0,100.00%
beacon.tingyun.com,132,0.01%,132,0,100.00%
c124a10e0db5e4b9.jijifun.com,132,0.01%,132,0,100.00%
pico.gtm.eset.com,131,0.01%,131,0,100.00%
weather-data.apple.com.akadns.net,131,0.01%,261,130,50.19%
www.microsoft.com-c-3.edgekey.net,131,0.01%,131,0,100.00%
geover.prod.do.dsp.mp.microsoft.com,131,0.01%,131,0,100.00%
plugin.browser.qq.com,131,0.01%,131,0,100.00%
array811.prod.do.dsp.mp.microsoft.com,130,0.01%,130,0,100.00%
hao.lenovo.com.cn,130,0.01%,130,0,100.00%
api1.origin.com,130,0.01%,130,0,100.00%
www.freerainbowtables.com,130,0.01%,130,0,100.00%
long.iwifi.360.cn,129,0.01%,129,0,100.00%
pop.ie.sogou.com,129,0.01%,129,0,100.00%
blog.csdn.net,129,0.01%,129,0,100.00%
onedsblobprdwus15.westus.cloudapp.azure.com,129,0.01%,129,0,100.00%
onedsblobprdcus15.centralus.cloudapp.azure.com,129,0.01%,129,0,100.00%
edge.microsoft.com,128,0.01%,5438,5310,2.35%
eclick.baidu.com,128,0.01%,128,0,100.00%
sslbaiduv6.jomodns.com,128,0.01%,155,27,82.58%
disc801.prod.do.dsp.mp.microsoft.com,128,0.01%,128,0,100.00%
diana.ie.sogou.com,128,0.01%,128,0,100.00%
passport.m3guo.com,128,0.01%,128,0,100.00%
datacluster2.cipsup.cn,128,0.01%,128,0,100.00%
8d0968d6458e0ad0.jijifun.com,128,0.01%,128,0,100.00%
dual-spo-0004.spo-msedge.net,128,0.01%,128,0,100.00%
googlehosted.l.googleusercontent.com,127,0.01%,230,103,55.22%
s1.url.cn,127,0.01%,127,0,100.00%
down2.abckantu.com,127,0.01%,127,0,100.00%
stun.voiparound.com,127,0.01%,127,0,100.00%
registry.centos.org,127,0.01%,127,0,100.00%
easylist-downloads.adblockplus.org,126,0.01%,254,128,49.61%
dotserver.douyucdn.cn,126,0.01%,126,0,100.00%
cn-sh.sasg4e.ccddns.lol,126,0.01%,126,0,100.00%
array614.prod.do.dsp.mp.microsoft.com,126,0.01%,126,0,100.00%
sentry.eulix.xyz,125,0.01%,125,0,100.00%
2csvr-basic.wpsdns.com,125,0.01%,125,0,100.00%
mx.cstnet.cn,125,0.01%,125,0,100.00%
prod.balrog.prod.cloudops.mozgcp.net,125,0.01%,125,0,100.00%
d2kaokxjvx18eu.cloudfront.net,125,0.01%,128,3,97.66%
init.itunes.apple.com,124,0.01%,218,94,56.88%
dcache.hub.sandai.net,124,0.01%,124,0,100.00%
ru01.ipv2.xyz,124,0.01%,124,0,100.00%
izn4cyqeu8.feishu.cn,124,0.01%,124,0,100.00%
detectportal.prod.mozaws.net,123,0.01%,16432,16309,0.75%
download.pinyin.sogou.com,123,0.01%,123,0,100.00%
reswx.tc.qq.com,123,0.01%,133,10,92.48%
iris-de-prod-azsc-eas-b.eastasia.cloudapp.azure.com,123,0.01%,123,0,100.00%
list.lvb.eastmoney.com,123,0.01%,123,0,100.00%
firebaselogging-pa.googleapis.com,123,0.01%,141,18,87.23%
mesu.apple.com,123,0.01%,231,108,53.25%
cp601.prod.do.dsp.mp.microsoft.com,123,0.01%,123,0,100.00%
nk4.boom.skin,123,0.01%,123,0,100.00%
ws.666liushen.tk,123,0.01%,123,0,100.00%
gitea.com,122,0.01%,122,0,100.00%
notify3.note.youdao.com,122,0.01%,230,108,53.04%
open.qurl.f.360.cn,122,0.01%,122,0,100.00%
www.gstatic.com,122,0.01%,135,13,90.37%
aoufnebg.dayugslb.com,122,0.01%,122,0,100.00%
cloud.google.com,122,0.01%,122,0,100.00%
cloud.dell.com,122,0.01%,122,0,100.00%
bdwblog.eastmoney.com,122,0.01%,122,0,100.00%
software.drivergenius.com,122,0.01%,122,0,100.00%
dedi.1808.cf,122,0.01%,122,0,100.00%
services.gfe.nvidia.com,122,0.01%,122,0,100.00%
ecn.dev.ditu.live.com,122,0.01%,122,0,100.00%
oracle-001.kaka123.ml,122,0.01%,122,0,100.00%
pietro-pezzani.divisare.pro,122,0.01%,122,0,100.00%
megacrit-metrics.herokuapp.com,122,0.01%,122,0,100.00%
mail.digidown.de,122,0.01%,122,0,100.00%
m.iliveok.com,122,0.01%,122,0,100.00%
downloads.skewed.de,122,0.01%,122,0,100.00%
us9929.azus.ml,122,0.01%,122,0,100.00%
jobs.plenigo.com,122,0.01%,122,0,100.00%
exchange.mercadomedianetwork.do,122,0.01%,122,0,100.00%
webmail.flytowardsthehiddensecret.tk,122,0.01%,122,0,100.00%
mail.travtextgentcesscongju.ml,122,0.01%,122,0,100.00%
mail.forcemail.de,122,0.01%,122,0,100.00%
goya.com.au,122,0.01%,122,0,100.00%
fisher-trails-21.myzeki.com,122,0.01%,122,0,100.00%
v1.skddefi99.cf,122,0.01%,122,0,100.00%
ccsw.ac.uk,122,0.01%,122,0,100.00%
app.d3mnetworks.com,122,0.01%,122,0,100.00%
bluedot.is.autonavi.com.gds.alibabadns.com,121,0.01%,121,0,100.00%
array509.prod.do.dsp.mp.microsoft.com,120,0.01%,120,0,100.00%
waws-prod-sg1-051.cloudapp.net,120,0.01%,120,0,100.00%
cv.duba.net,120,0.01%,120,0,100.00%
archive.kylinos.cn,120,0.01%,120,0,100.00%
0.ubuntu.pool.ntp.org,120,0.01%,120,0,100.00%
be01mr9s.sched.d2.tdnsdp1.cn,119,0.01%,119,0,100.00%
datacluster3.cipsup.cn,119,0.01%,119,0,100.00%
array807.prod.do.dsp.mp.microsoft.com,119,0.01%,119,0,100.00%
partner.googleadservices.com,119,0.01%,120,1,99.17%
stun.counterpath.net,119,0.01%,119,0,100.00%
flux.hcdn.qiyi.com,118,0.01%,118,0,100.00%
info.wps.cn,118,0.01%,118,0,100.00%
repo.openeuler.org,118,0.01%,118,0,100.00%
nat-port-2.verysync.cn,118,0.01%,118,0,100.00%
pushtrs.push.hicloud.com,117,0.01%,117,0,100.00%
messaging.ccs.mcafee.com,117,0.01%,117,0,100.00%
sv.symcb.com,117,0.01%,218,101,53.67%
ddns-checkip.quickconnect.to,117,0.01%,117,0,100.00%
array608.prod.do.dsp.mp.microsoft.com,116,0.01%,116,0,100.00%
sp2.baidu.com,116,0.01%,210,94,55.24%
t11.baidu.com,116,0.01%,154,38,75.32%
guzzoni.apple.com,116,0.01%,116,0,100.00%
image.sinajs.cn,116,0.01%,236,120,49.15%
hk-4.upjs.xyz,116,0.01%,116,0,100.00%
f-log-extension.grammarly.io,115,0.01%,115,0,100.00%
pgyapi.oray.net,115,0.01%,115,0,100.00%
cp501.prod.do.dsp.mp.microsoft.com,115,0.01%,115,0,100.00%
l7-online-self-max.s.dsa.cdnbuild.net,115,0.01%,115,0,100.00%
stun.sipgate.net,115,0.01%,115,0,100.00%
upos-sz-mirrorcoso1.bilivideo.com,114,0.01%,256,142,44.53%
messaging.engagement.office.com,114,0.01%,114,0,100.00%
t12.baidu.com,114,0.01%,150,36,76.00%
init-china.itunes-apple.com.akadns.net,114,0.01%,208,94,54.81%
dcldshlupt.alicdn.com.danuoyi.tbcache.com,114,0.01%,114,0,100.00%
wildcard.weather.microsoft.com.edgekey.net,114,0.01%,114,0,100.00%
gs-loc-cn.apple.com,114,0.01%,114,0,100.00%
hubble.netease.com,114,0.01%,114,0,100.00%
e6913.dscx.akamaiedge.net,114,0.01%,228,114,50.00%
img-blog.csdnimg.cn,114,0.01%,114,0,100.00%
bubble.ic.ksosoft.com,113,0.01%,113,0,100.00%
newvpn.arp.cn,113,0.01%,113,0,100.00%
update.os.nfschina.com,113,0.01%,113,0,100.00%
cn.hncu.1aba.cn,113,0.01%,113,0,100.00%
d.skconf.f.360.cn,112,0.01%,112,0,100.00%
venus.douyucdn.cn,112,0.01%,112,0,100.00%
study.huixiangtiandi.com,112,0.01%,112,0,100.00%
opencdnbd.jomodns.com,112,0.01%,168,56,66.67%
api.mixpanel.com,112,0.01%,112,0,100.00%
pkgupdate7.synology.com,112,0.01%,112,0,100.00%
hdweb.mail.split.netease.com,111,0.01%,111,0,100.00%
v10.vortex-win.data.microsoft.com,111,0.01%,138,27,80.43%
bjbgp01.baidupcs.com,111,0.01%,111,0,100.00%
opentracker.acgnx.se,111,0.01%,229,118,48.47%
ww1.sinaimg.cn.w.alikunlun.com,111,0.01%,236,125,47.03%
sync-1-us-west1-g.sync.services.mozilla.com,111,0.01%,111,0,100.00%
tracking.miui.com,111,0.01%,111,0,100.00%
weixin.sogou.com,111,0.01%,111,0,100.00%
smtp.163.com,111,0.01%,111,0,100.00%
mon.zijieapi.com.bytedns1.com,111,0.01%,111,0,100.00%
k8s.gcr.io,110,0.01%,5462,5352,2.01%
beacons3.gvt2.com,110,0.01%,110,0,100.00%
public-treatment.prod-experimentation.grammarlyaws.com,110,0.01%,110,0,100.00%
tracker.opentrackr.org,110,0.01%,110,0,100.00%
stdtime.gov.hk,110,0.01%,110,0,100.00%
bdstatic.eastmoney.com,110,0.01%,110,0,100.00%
s.symcb.com,110,0.01%,199,89,55.28%
ext.henzanapp.com,110,0.01%,110,0,100.00%
inappcheck-lb.itunes-apple.com.akadns.net,110,0.01%,130,20,84.62%
271509e17755a70d683b7f40cdb3eec6df604067.u.fdmpkg.org,110,0.01%,110,0,100.00%
i.snssdk.com,110,0.01%,110,0,100.00%
comtrade.un.org,109,0.01%,109,0,100.00%
d33vwaa6rdensn.cloudfront.net,109,0.01%,119,10,91.60%
crteam.cn,109,0.01%,109,0,100.00%
alert-cn.battlenet.com.cn,109,0.01%,109,0,100.00%
datarouter-weighted.ol.epicgames.com,109,0.01%,109,0,100.00%
s1.symcb.com,109,0.01%,201,92,54.23%
openjmacs4uc.m.taobao.com,109,0.01%,109,0,100.00%
wildcard.feishu.cn.bytedns1.com,109,0.01%,109,0,100.00%
linux.kite.com,108,0.01%,757,649,14.27%
ris-prod.trafficmanager.net,108,0.01%,108,0,100.00%
ocsp.apple.com.download.ks-cdn.com,108,0.01%,108,0,100.00%
rs-cn.rustdesk.com,108,0.01%,108,0,100.00%
69.push2his.eastmoney.com,108,0.01%,108,0,100.00%
stun.schlund.de,108,0.01%,108,0,100.00%
t10.baidu.com,107,0.01%,149,42,71.81%
bdstatics.eastmoney.com,107,0.01%,107,0,100.00%
cu010.www.duba.net,107,0.01%,107,0,100.00%
21.push2his.eastmoney.com,107,0.01%,107,0,100.00%
6qnz2sy8.sched.d2.tdnsdp1.cn,107,0.01%,107,0,100.00%
soup.v.qq.com,107,0.01%,107,0,100.00%
us01.ptrecord.com,107,0.01%,107,0,100.00%
dl.vas.wpscdn.cn,106,0.01%,235,129,45.11%
9.rarbg.com,106,0.01%,106,0,100.00%
img-s-msn-com.akamaized.net,106,0.01%,230,124,46.09%
62.push2his.eastmoney.com,106,0.01%,106,0,100.00%
array616.prod.do.dsp.mp.microsoft.com,106,0.01%,106,0,100.00%
windows.msn.cn,106,0.01%,120,14,88.33%
ocsp.digicert.cn,106,0.01%,106,0,100.00%
36d3af239dc2ead8aaa059a747d643c0c1645cee.u.fdmpkg.org,106,0.01%,106,0,100.00%
sd2.1dadan.com,106,0.01%,106,0,100.00%
rs-sg.rustdesk.com,106,0.01%,106,0,100.00%
browser.events.data.msn.cn,105,0.01%,139,34,75.54%
www.microsoft.com-c-3.edgekey.net.globalredir.akadns.net,105,0.01%,107,2,98.13%
array801.prod.do.dsp.mp.microsoft.com,105,0.01%,105,0,100.00%
pc-store.lenovomm.cn,105,0.01%,105,0,100.00%
dataflow.biliapi.com.dy.galileo.jcloud-cdn.com,105,0.01%,105,0,100.00%
d.dropbox.com,105,0.01%,214,109,49.07%
profile.firefox.com.cn,105,0.01%,105,0,100.00%
wu-bg-shim.trafficmanager.NET,105,0.01%,107,2,98.13%
blobcollector.events.data.trafficmanager.NET,105,0.01%,123,18,85.37%
rm-bp151dcc75aycqd80to.mysql.rds.aliyuncs.com,105,0.01%,105,0,100.00%
rua.myddns.cyou,105,0.01%,105,0,100.00%
mask-api.icloud.com,105,0.01%,131,26,80.15%
wd-prod-ss.trafficmanager.net,104,0.01%,104,0,100.00%
wxapp.tc.qq.com,104,0.01%,265,161,39.25%
54.push2his.eastmoney.com,104,0.01%,104,0,100.00%
pic4.zhimg.com,104,0.01%,149,45,69.80%
v1-hwllqv.onewsvod.com,104,0.01%,104,0,100.00%
www.vod.lxdns.com,104,0.01%,238,134,43.70%
lb-pkx01-offline.zhihu.com,104,0.01%,104,0,100.00%
e10499.dsce9.akamaiedge.net,103,0.01%,205,102,50.24%
zhushou.huihui.cn,103,0.01%,103,0,100.00%
dtapp-pub.dingtalk.com,103,0.01%,103,0,100.00%
0.pool.ntp.org,103,0.01%,103,0,100.00%
gspe35-ssl.ls.apple.com,103,0.01%,139,36,74.10%
stun.xten.com,103,0.01%,103,0,100.00%
mediator.goodsync.com,103,0.01%,103,0,100.00%
docs2.gtimg.com,102,0.01%,112,10,91.07%
k256.gslb.ksyuncdn.com,102,0.01%,102,0,100.00%
apple-finance.query.yahoo.com,102,0.01%,102,0,100.00%
pic1.zhimg.com,102,0.01%,134,32,76.12%
keyvalueservice.icloud.com.cn,102,0.01%,102,0,100.00%
internal-api-lark-api.feishu.cn.w.cdngslb.com,102,0.01%,102,0,100.00%
sync.firefox.com.cn,102,0.01%,102,0,100.00%
ups.ksmobile.net,102,0.01%,181,79,56.35%
3463d06de0ca9a15.jijifun.com,102,0.01%,102,0,100.00%
www.tm.a.prd.aadg.akadns.net,102,0.01%,102,0,100.00%
inews.gtimg.com,101,0.01%,112,11,90.18%
data.unistream.io,101,0.01%,101,0,100.00%
cdn.content.prod.cms.msn.com,101,0.01%,237,136,42.62%
szmmsns.qpic.cn,101,0.01%,210,109,48.10%
api.dropbox.com,101,0.01%,228,127,44.30%
onedsblobprdeus17.eastus.cloudapp.azure.com,101,0.01%,101,0,100.00%
cdn-node.cn.cm.foshan-02.nekocloud.cn,101,0.01%,101,0,100.00%
news.qhstatic.com,100,0.01%,100,0,100.00%
smartdl.lenovo.com.cn,100,0.01%,100,0,100.00%
ntp.msn.cn,100,0.01%,110,10,90.91%
e8218.dscb1.akamaiedge.net,100,0.01%,200,100,50.00%
xp.apple.com,99,0.01%,151,52,65.56%
clients2.googleusercontent.com,99,0.01%,99,0,100.00%
c.msn.cn,99,0.01%,99,0,100.00%
2.push2his.eastmoney.com,99,0.01%,99,0,100.00%
i0.hdslb.com,99,0.01%,203,104,48.77%
stun.ekiga.net,99,0.01%,99,0,100.00%
cdn-node.cn.cm.ningbo-01.nekocloud.cn,99,0.01%,99,0,100.00%
www.paypal.com,99,0.01%,99,0,100.00%
onedsblobprdcus17.centralus.cloudapp.azure.com,99,0.01%,99,0,100.00%
forw-sfo1.goodsync.com,99,0.01%,99,0,100.00%
channel-account-ssl.xunlei.com,98,0.01%,98,0,100.00%
www.zhihu.com,98,0.01%,224,126,43.75%
feilian-staging.bytedance.com.w.cdngslb.com,98,0.01%,98,0,100.00%
array605.prod.do.dsp.mp.microsoft.com,98,0.01%,98,0,100.00%
ow1.res.office365.com,98,0.01%,98,0,100.00%
bkssl.bdimg.com,98,0.01%,130,32,75.38%
data.hicloud.com,97,0.01%,97,0,100.00%
tim.qq.com,97,0.01%,97,0,100.00%
mqtt-web.zhihu.com,97,0.01%,97,0,100.00%
pic3.zhimg.com,97,0.01%,140,43,69.29%
pic2.zhimg.com,97,0.01%,131,34,74.05%
package-search.services.jetbrains.com,97,0.01%,189,92,51.32%
profile.csdnimg.cn,97,0.01%,97,0,100.00%
1.pool.ntp.org,97,0.01%,97,0,100.00%
78.push2his.eastmoney.com,97,0.01%,97,0,100.00%
shrouded-wave-5410.morning-tundra-7160.herokuspace.com,97,0.01%,97,0,100.00%
ocsp.sca1b.amazontrust.com,96,0.01%,96,0,100.00%
upos-sz-mirrorhw.bilivideo.com,96,0.01%,151,55,63.58%
pop.cstnet.cn,96,0.01%,96,0,100.00%
se.360.cn,96,0.01%,124,28,77.42%
waconatm.officeapps.live.com,96,0.01%,96,0,100.00%
37.push2his.eastmoney.com,96,0.01%,96,0,100.00%
71.push2his.eastmoney.com,96,0.01%,96,0,100.00%
weather.kjjs.360.cn,96,0.01%,96,0,100.00%
cdn-node.cn.cm.foshan-03.nekocloud.cn,96,0.01%,96,0,100.00%
img-prod-cms-rt-microsoft-com.akamaized.net,95,0.01%,195,100,48.72%
contentsec.ac.cn,95,0.01%,95,0,100.00%
s.cn.bing.net,95,0.01%,95,0,100.00%
safebrowsing.googleapis-cn.com,95,0.01%,227,132,41.85%
steamstore-a.akamaihd.net,95,0.01%,95,0,100.00%
storage.googleapis.com,95,0.01%,114,19,83.33%
fc1tn.baidu.com,95,0.01%,95,0,100.00%
3.pool.ntp.org,95,0.01%,95,0,100.00%
imap.mail.me.com.akadns.net,95,0.01%,95,0,100.00%
48.push2his.eastmoney.com,95,0.01%,95,0,100.00%
dgapi.zhhainiao.com,95,0.01%,95,0,100.00%
data.grammarly.com,95,0.01%,95,0,100.00%
expressapisv2.net,94,0.01%,180,86,52.22%
oneclient.sfx.ms,94,0.01%,213,119,44.13%
e28578.d.akamaiedge.net,94,0.01%,94,0,100.00%
beacons-handoff.gcp.gvt2.com,94,0.01%,94,0,100.00%
cdn.cvws.apple-dns.net,94,0.01%,198,104,47.47%
profile.pinyin.sogou.com,94,0.01%,94,0,100.00%
event.csdn.net,94,0.01%,220,126,42.73%
3.asia.pool.ntp.org,94,0.01%,94,0,100.00%
report.uchiha.ltd,94,0.01%,94,0,100.00%
76.push2his.eastmoney.com,94,0.01%,94,0,100.00%
archive2.kylinos.cn,94,0.01%,94,0,100.00%
fp.msedge.net,94,0.01%,94,0,100.00%
cm.nwncd.com,94,0.01%,94,0,100.00%
ntp1.aliyun.com,94,0.01%,94,0,100.00%
usc.cloudv2a.com,94,0.01%,94,0,100.00%
gsp64-ssl.ls.apple.com,93,0.01%,93,0,100.00%
vpn1.bjfu.edu.cn,93,0.01%,93,0,100.00%
v9-hwllqv.onewsvod.com,93,0.01%,93,0,100.00%
cdn.jsdelivr.net,93,0.01%,180,87,51.67%
f.c2r.ts.cdn.office.net,93,0.01%,97,4,95.88%
ipm-klca.kaspersky.com,93,0.01%,93,0,100.00%
common-geo.ha.1drv.com,93,0.01%,93,0,100.00%
pancake.cdn-apple.com.akadns.net,93,0.01%,93,0,100.00%
silkroad.csdn.net,93,0.01%,93,0,100.00%
s1.hdslb.com,93,0.01%,93,0,100.00%
14.push2his.eastmoney.com,93,0.01%,93,0,100.00%
xsts.auth.xboxlive.com,93,0.01%,93,0,100.00%
79.push2his.eastmoney.com,93,0.01%,93,0,100.00%
cdn-node.cn.cm.guangzhou-01.nekocloud.cn,93,0.01%,93,0,100.00%
forw-sfo2.goodsync.com,93,0.01%,93,0,100.00%
prod-w.nexus.live.com.akadns.net,92,0.01%,92,0,100.00%
c.urs.microsoft.com,92,0.01%,92,0,100.00%
restapi.amap.com,92,0.01%,92,0,100.00%
events.gfe.nvidia.com,92,0.01%,92,0,100.00%
66.push2his.eastmoney.com,92,0.01%,92,0,100.00%
upos-sz-mirrorcos.bilivideo.com,92,0.01%,200,108,46.00%
data.bilicdn2.com,92,0.01%,178,86,51.69%
onedsblobprdwus16.westus.cloudapp.azure.com,92,0.01%,92,0,100.00%
42.push2his.eastmoney.com,92,0.01%,92,0,100.00%
time1.cloud.tencent.com,92,0.01%,92,0,100.00%
11.benhuapp.com,92,0.01%,92,0,100.00%
gspe1-ssl.ls.apple.com,91,0.01%,91,0,100.00%
ntes53.mail.yeah.net,91,0.01%,91,0,100.00%
opencdnglobalv6.jomodns.com,91,0.01%,135,44,67.41%
p2.shared.global.fastly.net,91,0.01%,91,0,100.00%
sqimg.qq.com,91,0.01%,91,0,100.00%
ovv.alllook.tv,91,0.01%,91,0,100.00%
disc601.prod.do.dsp.mp.microsoft.com,91,0.01%,91,0,100.00%
config.mobile.kugou.com,91,0.01%,91,0,100.00%
39.push2his.eastmoney.com,91,0.01%,91,0,100.00%
appcfg.v.qq.com,91,0.01%,91,0,100.00%
settings-prod-eus2-2.eastus2.cloudapp.azure.com,90,0.01%,90,0,100.00%
52.push2his.eastmoney.com,90,0.01%,90,0,100.00%
wework.qpic.cn,90,0.01%,98,8,91.84%
array613.prod.do.dsp.mp.microsoft.com,90,0.01%,90,0,100.00%
service.weather.msn.cn,90,0.01%,90,0,100.00%
50.push2his.eastmoney.com,90,0.01%,90,0,100.00%
24.push2his.eastmoney.com,90,0.01%,90,0,100.00%
33.push2his.eastmoney.com,90,0.01%,90,0,100.00%
pc.ximalaya.com,90,0.01%,90,0,100.00%
vinci.ie.sogou.com,90,0.01%,90,0,100.00%
cdn-node.cn.cm.jiangmen-01.nekocloud.cn,90,0.01%,90,0,100.00%
d1ucxc6xi3jabg.cloudfront.net,90,0.01%,90,0,100.00%
fe2cr.update.msft.com.trafficmanager.net,89,0.01%,189,100,47.09%
qurl.f.360.cn,89,0.01%,89,0,100.00%
pgw-tel-cld-sl.alicdn.com,89,0.01%,89,0,100.00%
time.ys7.com,89,0.01%,89,0,100.00%
teams.events.data.microsoft.com,89,0.01%,104,15,85.58%
opencdn.jomodns.com,89,0.01%,89,0,100.00%
93.push2his.eastmoney.com,89,0.01%,89,0,100.00%
0.asia.pool.ntp.org,89,0.01%,89,0,100.00%
17.push2his.eastmoney.com,89,0.01%,89,0,100.00%
38.push2his.eastmoney.com,89,0.01%,89,0,100.00%
seafile.casisd.cn,89,0.01%,89,0,100.00%
rs-ny.rustdesk.com,89,0.01%,89,0,100.00%
cdn-node.cn.cm.guangzhou-02.nekocloud.cn,89,0.01%,89,0,100.00%
mmbiz.qlogo.cn,88,0.01%,88,0,100.00%
cipv6gn.v.trpcdn.net,88,0.01%,179,91,49.16%
browser.360.cn.ucloud.com.cn,88,0.01%,88,0,100.00%
skydrivesync.policies.live.net,88,0.01%,88,0,100.00%
opencdnbdsimage.jomodns.com,88,0.01%,128,40,68.75%
9.push2his.eastmoney.com,88,0.01%,88,0,100.00%
msg.csdn.net,88,0.01%,88,0,100.00%
list.wallpaper.cloud.duba.net,88,0.01%,88,0,100.00%
46.push2his.eastmoney.com,88,0.01%,88,0,100.00%
12.rarbg.me,88,0.01%,88,0,100.00%
settings-prod-sea-1.southeastasia.cloudapp.azure.com,88,0.01%,88,0,100.00%
35.push2his.eastmoney.com,88,0.01%,88,0,100.00%
linux.teamviewer.com,88,0.01%,149,61,59.06%
onedsblobprdeus15.eastus.cloudapp.azure.com,88,0.01%,88,0,100.00%
10.push2his.eastmoney.com,88,0.01%,88,0,100.00%
settings-prod-scus-2.southcentralus.cloudapp.azure.com,87,0.01%,87,0,100.00%
steamcdn-a.akamaihd.net,87,0.01%,87,0,100.00%
tracker.coppersurfer.tk,87,0.01%,87,0,100.00%
up.ijinshan.com,87,0.01%,87,0,100.00%
vweixinf.tc.qq.com,87,0.01%,193,106,45.08%
video-bd-drcn.dbankcdn.cn,87,0.01%,345,258,25.22%
go.microsoft.com.edgekey.net,87,0.01%,191,104,45.55%
repo.zotero.org,87,0.01%,87,0,100.00%
47.push2his.eastmoney.com,87,0.01%,87,0,100.00%
64.push2his.eastmoney.com,87,0.01%,87,0,100.00%
8.push2his.eastmoney.com,87,0.01%,87,0,100.00%
array501.prod.do.dsp.mp.microsoft.com,87,0.01%,87,0,100.00%
log-upload.mihoyo.com,87,0.01%,87,0,100.00%
11.push2his.eastmoney.com,87,0.01%,87,0,100.00%
filedownload.csw.lenovo.com,87,0.01%,87,0,100.00%
www6.53kf.com,87,0.01%,87,0,100.00%
d20wxjqjgi3st.cloudfront.net,86,0.01%,175,89,49.14%
onetag-sys.com,86,0.01%,86,0,100.00%
plussvr.wps.cn,86,0.01%,86,0,100.00%
29.push2his.eastmoney.com,86,0.01%,86,0,100.00%
species.missionsec.io,86,0.01%,86,0,100.00%
mesu-china.apple.com.akadns.net,86,0.01%,164,78,52.44%
bingciservice.koreasouth.cloudapp.azure.com,86,0.01%,86,0,100.00%
tile-service.weather.msn.cn,86,0.01%,86,0,100.00%
70.push2his.eastmoney.com,86,0.01%,86,0,100.00%
63.push2his.eastmoney.com,86,0.01%,86,0,100.00%
59.push2his.eastmoney.com,86,0.01%,86,0,100.00%
zimeiti-eastmoney-com.oss-cn-shanghai.aliyuncs.com,86,0.01%,86,0,100.00%
upmobile.v.qq.com,86,0.01%,86,0,100.00%
api.panfanh.xyz,86,0.01%,86,0,100.00%
clientnotification-userprodscus1-0.servicebus.windows.net,85,0.01%,85,0,100.00%
cdn1.ime.sogou.com,85,0.01%,85,0,100.00%
offlintab.firefoxchina.cn,85,0.01%,85,0,100.00%
eopa.n.shifen.com,85,0.01%,160,75,53.12%
upext.chrome.360.cn,85,0.01%,85,0,100.00%
13.push2his.eastmoney.com,85,0.01%,85,0,100.00%
bvc.bilivideo.com,85,0.01%,101,16,84.16%
cm.bilibili.com,85,0.01%,98,13,86.73%
dss2.bdstatic.com,85,0.01%,89,4,95.51%
cstm.baidu.com,85,0.01%,85,0,100.00%
n09.boom.skin,85,0.01%,85,0,100.00%
n114.boom.skin,85,0.01%,85,0,100.00%
cdn.ghostery.com,85,0.01%,175,90,48.57%
46a2e5c3c5a64e218b60f2c2ee76b750.pacloudflare.com,85,0.01%,85,0,100.00%
stats.g.doubleclick.net,85,0.01%,87,2,97.70%
microsoftgraph.chinacloudapi.cn,85,0.01%,85,0,100.00%
kv801.prod.do.dsp.mp.microsoft.com,85,0.01%,85,0,100.00%
afdo-tas-offload.trafficmanager.net,84,0.00%,84,0,100.00%
configuration.ls.apple.com,84,0.00%,182,98,46.15%
profile.accounts.firefox.com,84,0.00%,84,0,100.00%
storage.live.com,84,0.00%,84,0,100.00%
same.eastmoney.com,84,0.00%,84,0,100.00%
16.push2his.eastmoney.com,84,0.00%,84,0,100.00%
77.push2his.eastmoney.com,84,0.00%,84,0,100.00%
update-drcn.platform.hicloud.com,84,0.00%,84,0,100.00%
c.msn.com,84,0.00%,84,0,100.00%
wss.rest.gti.mcafee.com,84,0.00%,84,0,100.00%
3.push2his.eastmoney.com,84,0.00%,84,0,100.00%
static-pcs-sdk-server.alibaba.com,84,0.00%,120,36,70.00%
60.push2his.eastmoney.com,84,0.00%,84,0,100.00%
dns.rubyfish.cn,83,0.00%,83,0,100.00%
57.push2his.eastmoney.com,83,0.00%,83,0,100.00%
conf.wsm.360.cn,83,0.00%,161,78,51.55%
array612.prod.do.dsp.mp.microsoft.com,83,0.00%,161,78,51.55%
bag.itunes.apple.com,83,0.00%,151,68,54.97%
search-operate.cdn.bcebos.com,83,0.00%,83,0,100.00%
www.apple.com.edgekey.net.globalredir.akadns.net,83,0.00%,83,0,100.00%
n04.boom.skin,83,0.00%,83,0,100.00%
ntemp01.boom.skin,83,0.00%,83,0,100.00%
nk8.boom.skin,83,0.00%,83,0,100.00%
55.push2his.eastmoney.com,83,0.00%,83,0,100.00%
ts.helper.2345.cc,83,0.00%,83,0,100.00%
43.push2his.eastmoney.com,83,0.00%,83,0,100.00%
apis.live.net,83,0.00%,83,0,100.00%
eas.outlook.com,82,0.00%,141,59,58.16%
resources.jetbrains.com,82,0.00%,139,57,58.99%
offlintab.firefoxchina.cn.wscdns.com,82,0.00%,82,0,100.00%
valid.apple.com,82,0.00%,83,1,98.80%
slink.gifshow.com,82,0.00%,82,0,100.00%
google.com,82,0.00%,166,84,49.40%
settings-prod-cin-1.centralindia.cloudapp.azure.com,82,0.00%,82,0,100.00%
kunpeng.csdn.net,82,0.00%,82,0,100.00%
www.tm.ak.prd.aadg.akadns.net,82,0.00%,82,0,100.00%
www36oo.com,82,0.00%,82,0,100.00%
gimg4.baidu.com,82,0.00%,111,29,73.87%
help.apple.com,82,0.00%,82,0,100.00%
jp14.boom.skin,82,0.00%,82,0,100.00%
jp3.boom.skin,82,0.00%,82,0,100.00%
jp5.boom.skin,82,0.00%,82,0,100.00%
n28.boom.skin,82,0.00%,82,0,100.00%
ntemp16.boom.skin,82,0.00%,82,0,100.00%
mail.ios.ac.cn,82,0.00%,82,0,100.00%
81.push2his.eastmoney.com,82,0.00%,82,0,100.00%
filehelper.weixin.qq.com,81,0.00%,10357,10276,0.78%
pan.cstcloud.cn,81,0.00%,81,0,100.00%
settings-prod-eus-1.eastus.cloudapp.azure.com,81,0.00%,81,0,100.00%
array510.prod.do.dsp.mp.microsoft.com,81,0.00%,81,0,100.00%
static.nvidiagrid.net,81,0.00%,101,20,80.20%
redisdatarecall.csdn.net,81,0.00%,81,0,100.00%
n119.boom.skin,81,0.00%,81,0,100.00%
ntemp18.boom.skin,81,0.00%,81,0,100.00%
nf7.boom.skin,81,0.00%,81,0,100.00%
nje.boom.skin,81,0.00%,81,0,100.00%
ksn-tcert-geo.kaspersky-labs.com,81,0.00%,81,0,100.00%
11.rarbg.com,81,0.00%,81,0,100.00%
sdk.split.io,81,0.00%,81,0,100.00%
a.safe.360.cn,80,0.00%,80,0,100.00%
download.comodo.com,80,0.00%,148,68,54.05%
kuaishou.com,80,0.00%,80,0,100.00%
85.push2his.eastmoney.com,80,0.00%,80,0,100.00%
position.csdnimg.cn,80,0.00%,80,0,100.00%
s100.boom.skin,80,0.00%,80,0,100.00%
n06.boom.skin,80,0.00%,80,0,100.00%
n47.boom.skin,80,0.00%,80,0,100.00%
n05.boom.skin,80,0.00%,80,0,100.00%
us2.edge.boom.skin,80,0.00%,80,0,100.00%
n27.boom.skin,80,0.00%,80,0,100.00%
n100.boom.skin,80,0.00%,80,0,100.00%
n63.boom.skin,80,0.00%,80,0,100.00%
nf1.boom.skin,80,0.00%,80,0,100.00%
jp9.boom.skin,80,0.00%,80,0,100.00%
45.push2his.eastmoney.com,80,0.00%,80,0,100.00%
10.rarbg.com,80,0.00%,80,0,100.00%
slink.ksapisrv.com,79,0.00%,79,0,100.00%
crl.certum.pl,79,0.00%,171,92,46.20%
settings-prod-eus2-1.eastus2.cloudapp.azure.com,79,0.00%,79,0,100.00%
n23.boom.skin,79,0.00%,79,0,100.00%
n24.boom.skin,79,0.00%,79,0,100.00%
nn5.boom.skin,79,0.00%,79,0,100.00%
nn6.boom.skin,79,0.00%,79,0,100.00%
jp2.boom.skin,79,0.00%,79,0,100.00%
nn12.boom.skin,79,0.00%,79,0,100.00%
jp4.boom.skin,79,0.00%,79,0,100.00%
ntemp15.boom.skin,79,0.00%,79,0,100.00%
ntemp19.boom.skin,79,0.00%,79,0,100.00%
n57.boom.skin,79,0.00%,79,0,100.00%
ntemp03.boom.skin,79,0.00%,79,0,100.00%
ntemp05.boom.skin,79,0.00%,79,0,100.00%
us5.edge.boom.skin,79,0.00%,79,0,100.00%
n115.boom.skin,79,0.00%,79,0,100.00%
s01.boom.skin,79,0.00%,79,0,100.00%
n30.boom.skin,79,0.00%,79,0,100.00%
opt17.boom.skin,79,0.00%,79,0,100.00%
n110.boom.skin,79,0.00%,79,0,100.00%
n92.boom.skin,79,0.00%,79,0,100.00%
ntemp25.boom.skin,79,0.00%,79,0,100.00%
nkd.boom.skin,79,0.00%,79,0,100.00%
nf10.boom.skin,79,0.00%,79,0,100.00%
nf9.boom.skin,79,0.00%,79,0,100.00%
jp10.boom.skin,79,0.00%,79,0,100.00%
72.push2his.eastmoney.com,79,0.00%,79,0,100.00%
steamcommunity-a.akamaihd.net,79,0.00%,79,0,100.00%
qcloud.gregchan.cn,78,0.00%,78,0,100.00%
www.tm.lg.prod.aadmsa.trafficmanager.net,78,0.00%,78,0,100.00%
asf-ris-prod-easia-azsc.eastasia.cloudapp.azure.com,78,0.00%,78,0,100.00%
browser.360.cn.ucloudnaming.cn,78,0.00%,78,0,100.00%
92.push2his.eastmoney.com,78,0.00%,78,0,100.00%
51.push2his.eastmoney.com,78,0.00%,78,0,100.00%
ac.dun.163.com,78,0.00%,149,71,52.35%
securityapi.d3-pr-tm.com,78,0.00%,78,0,100.00%
settings-prod-cin-2.centralindia.cloudapp.azure.com,78,0.00%,78,0,100.00%
update.gtm.eset.com,78,0.00%,78,0,100.00%
weather-api.extfans.com,78,0.00%,78,0,100.00%
95.push2his.eastmoney.com,78,0.00%,78,0,100.00%
time.asia.apple.com,78,0.00%,78,0,100.00%
e11408.d.akamaiedge.net,78,0.00%,78,0,100.00%
nm7.boom.skin,78,0.00%,78,0,100.00%
nn8.boom.skin,78,0.00%,78,0,100.00%
n11.boom.skin,78,0.00%,78,0,100.00%
opt20.boom.skin,78,0.00%,78,0,100.00%
ntemp17.boom.skin,78,0.00%,78,0,100.00%
ntemp20.boom.skin,78,0.00%,78,0,100.00%
ntemp02.boom.skin,78,0.00%,78,0,100.00%
ntemp07.boom.skin,78,0.00%,78,0,100.00%
ntemp08.boom.skin,78,0.00%,78,0,100.00%
n48.boom.skin,78,0.00%,78,0,100.00%
jp15.boom.skin,78,0.00%,78,0,100.00%
us6.edge.boom.skin,78,0.00%,78,0,100.00%
nmc.boom.skin,78,0.00%,78,0,100.00%
n93.boom.skin,78,0.00%,78,0,100.00%
us4.edge.boom.skin,78,0.00%,78,0,100.00%
s105.boom.skin,78,0.00%,78,0,100.00%
n17.boom.skin,78,0.00%,78,0,100.00%
n96.boom.skin,78,0.00%,78,0,100.00%
opt18.boom.skin,78,0.00%,78,0,100.00%
jp16.boom.skin,78,0.00%,78,0,100.00%
n13.boom.skin,78,0.00%,78,0,100.00%
n60.boom.skin,78,0.00%,78,0,100.00%
jp18.boom.skin,78,0.00%,78,0,100.00%
nf4.boom.skin,78,0.00%,78,0,100.00%
nkc.boom.skin,78,0.00%,78,0,100.00%
nke.boom.skin,78,0.00%,78,0,100.00%
nl4.boom.skin,78,0.00%,78,0,100.00%
nm1.boom.skin,78,0.00%,78,0,100.00%
nf8.boom.skin,78,0.00%,78,0,100.00%
nf11.boom.skin,78,0.00%,78,0,100.00%
nka.boom.skin,78,0.00%,78,0,100.00%
nm6.boom.skin,78,0.00%,78,0,100.00%
fundingchoicesmessages.google.com,78,0.00%,78,0,100.00%
code.eulix.xyz,78,0.00%,78,0,100.00%
20.push2his.eastmoney.com,78,0.00%,78,0,100.00%
hkbn2.doubledou.win,78,0.00%,78,0,100.00%
tsbrowser.xiangtatech.com,77,0.00%,77,0,100.00%
token.services.mozilla.com,77,0.00%,77,0,100.00%
58.push2his.eastmoney.com,77,0.00%,77,0,100.00%
appvolcanoedc.jianguoyun.com,77,0.00%,77,0,100.00%
gy.bzcv.cn,77,0.00%,77,0,100.00%
opencdnbdcharon.jomodns.com,77,0.00%,127,50,60.63%
nkb.boom.skin,77,0.00%,77,0,100.00%
nn2.boom.skin,77,0.00%,77,0,100.00%
nn3.boom.skin,77,0.00%,77,0,100.00%
nn4.boom.skin,77,0.00%,77,0,100.00%
jp1.boom.skin,77,0.00%,77,0,100.00%
nn14.boom.skin,77,0.00%,77,0,100.00%
nn13.boom.skin,77,0.00%,77,0,100.00%
opt14.boom.skin,77,0.00%,77,0,100.00%
nn9.boom.skin,77,0.00%,77,0,100.00%
opt25.boom.skin,77,0.00%,77,0,100.00%
opt7.boom.skin,77,0.00%,77,0,100.00%
opt6.boom.skin,77,0.00%,77,0,100.00%
opt12.boom.skin,77,0.00%,77,0,100.00%
n54.boom.skin,77,0.00%,77,0,100.00%
ntemp04.boom.skin,77,0.00%,77,0,100.00%
n22.boom.skin,77,0.00%,77,0,100.00%
n116.boom.skin,77,0.00%,77,0,100.00%
nm8.boom.skin,77,0.00%,77,0,100.00%
nm9.boom.skin,77,0.00%,77,0,100.00%
n111.boom.skin,77,0.00%,77,0,100.00%
us1.edge.boom.skin,77,0.00%,77,0,100.00%
n37.boom.skin,77,0.00%,77,0,100.00%
s104.boom.skin,77,0.00%,77,0,100.00%
jp7.boom.skin,77,0.00%,77,0,100.00%
nf6.boom.skin,77,0.00%,77,0,100.00%
n77.boom.skin,77,0.00%,77,0,100.00%
jp20.boom.skin,77,0.00%,77,0,100.00%
nf5.boom.skin,77,0.00%,77,0,100.00%
nf3.boom.skin,77,0.00%,77,0,100.00%
nl2.boom.skin,77,0.00%,77,0,100.00%
nl6.boom.skin,77,0.00%,77,0,100.00%
nj6.boom.skin,77,0.00%,77,0,100.00%
nj1.boom.skin,77,0.00%,77,0,100.00%
nj3.boom.skin,77,0.00%,77,0,100.00%
nj5.boom.skin,77,0.00%,77,0,100.00%
nj2.boom.skin,77,0.00%,77,0,100.00%
njc.boom.skin,77,0.00%,77,0,100.00%
nj7.boom.skin,77,0.00%,77,0,100.00%
nj8.boom.skin,77,0.00%,77,0,100.00%
nj9.boom.skin,77,0.00%,77,0,100.00%
jp8.boom.skin,77,0.00%,77,0,100.00%
jp12.boom.skin,77,0.00%,77,0,100.00%
nk9.boom.skin,77,0.00%,77,0,100.00%
opt19.boom.skin,77,0.00%,77,0,100.00%
nm5.boom.skin,77,0.00%,77,0,100.00%
18.push2his.eastmoney.com,77,0.00%,77,0,100.00%
32.push2his.eastmoney.com,77,0.00%,77,0,100.00%
devlog.ys7.com,77,0.00%,77,0,100.00%
array803.prod.do.dsp.mp.microsoft.com,76,0.00%,76,0,100.00%
static-xl.a.88cdn.com,76,0.00%,177,101,42.94%
l5.gslb.ksyuncdn.com,76,0.00%,149,73,51.01%
49.push2his.eastmoney.com,76,0.00%,76,0,100.00%
settings-prod-sea-2.southeastasia.cloudapp.azure.com,76,0.00%,76,0,100.00%
statistic.csdn.net,76,0.00%,76,0,100.00%
spatialsearch.is.autonavi.com,76,0.00%,76,0,100.00%
sec23summer.usenix.hotcrp.com,76,0.00%,76,0,100.00%
f7.baidu.com,76,0.00%,93,17,81.72%
th.bing.com,76,0.00%,77,1,98.70%
pinyin.sogou.com,76,0.00%,76,0,100.00%
n21.boom.skin,76,0.00%,76,0,100.00%
jp13.boom.skin,76,0.00%,76,0,100.00%
opt22.boom.skin,76,0.00%,76,0,100.00%
nn1.boom.skin,76,0.00%,76,0,100.00%
nn7.boom.skin,76,0.00%,76,0,100.00%
opt24.boom.skin,76,0.00%,76,0,100.00%
opt26.boom.skin,76,0.00%,76,0,100.00%
opt8.boom.skin,76,0.00%,76,0,100.00%
opt9.boom.skin,76,0.00%,76,0,100.00%
opt15.boom.skin,76,0.00%,76,0,100.00%
nn11.boom.skin,76,0.00%,76,0,100.00%
opt21.boom.skin,76,0.00%,76,0,100.00%
opt10.boom.skin,76,0.00%,76,0,100.00%
opt11.boom.skin,76,0.00%,76,0,100.00%
opt2.boom.skin,76,0.00%,76,0,100.00%
opt3.boom.skin,76,0.00%,76,0,100.00%
n32.boom.skin,76,0.00%,76,0,100.00%
opt4.boom.skin,76,0.00%,76,0,100.00%
n62.boom.skin,76,0.00%,76,0,100.00%
ntemp06.boom.skin,76,0.00%,76,0,100.00%
ntemp09.boom.skin,76,0.00%,76,0,100.00%
nmb.boom.skin,76,0.00%,76,0,100.00%
nma.boom.skin,76,0.00%,76,0,100.00%
us7.edge.boom.skin,76,0.00%,76,0,100.00%
us9.edge.boom.skin,76,0.00%,76,0,100.00%
us8.edge.boom.skin,76,0.00%,76,0,100.00%
jp6.boom.skin,76,0.00%,76,0,100.00%
opt16.boom.skin,76,0.00%,76,0,100.00%
jp19.boom.skin,76,0.00%,76,0,100.00%
nf2.boom.skin,76,0.00%,76,0,100.00%
n170.boom.skin,76,0.00%,76,0,100.00%
njb.boom.skin,76,0.00%,76,0,100.00%
jp11.boom.skin,76,0.00%,76,0,100.00%
nm4.boom.skin,76,0.00%,76,0,100.00%
nm2.boom.skin,76,0.00%,76,0,100.00%
7.push2his.eastmoney.com,76,0.00%,76,0,100.00%
67.push2his.eastmoney.com,76,0.00%,76,0,100.00%
login.msa.msidentity.com,76,0.00%,76,0,100.00%
26.push2his.eastmoney.com,76,0.00%,76,0,100.00%
router-default.apps.openshift4.gnome.org,76,0.00%,139,63,54.68%
d1tcio87buo4yy.cloudfront.net,76,0.00%,84,8,90.48%
retracker.spb.ru,76,0.00%,76,0,100.00%
aaaa.aaaa.gay,76,0.00%,76,0,100.00%
84.push2his.eastmoney.com,76,0.00%,76,0,100.00%
www.scottyang8math.cn,76,0.00%,76,0,100.00%
azwcus1-client-s.gateway.messenger.live.com,76,0.00%,76,0,100.00%
versioncheck-bg.addons.mozilla.org,76,0.00%,76,0,100.00%
login.im.qcloud.com,75,0.00%,75,0,100.00%
nexus-websocket-a.intercom.io,75,0.00%,75,0,100.00%
tracker.openbittorrent.com,75,0.00%,75,0,100.00%
keyvalueservice.fe.apple-dns.cn,75,0.00%,75,0,100.00%
wildcard46.go-mpulse.net.edgekey.net,75,0.00%,158,83,47.47%
19.push2his.eastmoney.com,75,0.00%,75,0,100.00%
89.push2his.eastmoney.com,75,0.00%,75,0,100.00%
65.push2his.eastmoney.com,75,0.00%,75,0,100.00%
15.push2his.eastmoney.com,75,0.00%,75,0,100.00%
array805.prod.do.dsp.mp.microsoft.com,75,0.00%,75,0,100.00%
array611.prod.do.dsp.mp.microsoft.com,75,0.00%,75,0,100.00%
imgcache.qq.com,75,0.00%,95,20,78.95%
96.push2his.eastmoney.com,75,0.00%,75,0,100.00%
gspe35-cn-ssl.ls-apple.com.akadns.net,75,0.00%,95,20,78.95%
94.push2his.eastmoney.com,75,0.00%,75,0,100.00%
opt23.boom.skin,75,0.00%,75,0,100.00%
nna.boom.skin,75,0.00%,75,0,100.00%
opt13.boom.skin,75,0.00%,75,0,100.00%
opt5.boom.skin,75,0.00%,75,0,100.00%
opt1.boom.skin,75,0.00%,75,0,100.00%
ntemp10.boom.skin,75,0.00%,75,0,100.00%
n43.boom.skin,75,0.00%,75,0,100.00%
nmd.boom.skin,75,0.00%,75,0,100.00%
us10.edge.boom.skin,75,0.00%,75,0,100.00%
us3.edge.boom.skin,75,0.00%,75,0,100.00%
s102.boom.skin,75,0.00%,75,0,100.00%
s103.boom.skin,75,0.00%,75,0,100.00%
jp17.boom.skin,75,0.00%,75,0,100.00%
nl3.boom.skin,75,0.00%,75,0,100.00%
nl5.boom.skin,75,0.00%,75,0,100.00%
nj4.boom.skin,75,0.00%,75,0,100.00%
njd.boom.skin,75,0.00%,75,0,100.00%
nm3.boom.skin,75,0.00%,75,0,100.00%
cntr.wps.cn,75,0.00%,75,0,100.00%
consul-kv.app.kdsec.org,75,0.00%,75,0,100.00%
68.push2his.eastmoney.com,75,0.00%,75,0,100.00%
86.push2his.eastmoney.com,75,0.00%,75,0,100.00%
nsp-contentcenter-h5-drcn.obs.cn-north-2.myhwclouds.com,75,0.00%,75,0,100.00%
investor.shutterstock.com,75,0.00%,114,39,65.79%
puui.qpic.cn,74,0.00%,79,5,93.67%
23.push2his.eastmoney.com,74,0.00%,74,0,100.00%
6.push2his.eastmoney.com,74,0.00%,74,0,100.00%
82.push2his.eastmoney.com,74,0.00%,74,0,100.00%
dc.applicationinsights.microsoft.com,74,0.00%,74,0,100.00%
dc.trafficmanager.net,74,0.00%,74,0,100.00%
pancake-cn.cdn-apple.com.akadns.net,74,0.00%,74,0,100.00%
serviceplus.phytium.com.cn,74,0.00%,74,0,100.00%
87.push2his.eastmoney.com,74,0.00%,74,0,100.00%
portainer-io-assets.sfo2.digitaloceanspaces.com,74,0.00%,74,0,100.00%
n117.boom.skin,74,0.00%,74,0,100.00%
nl1.boom.skin,74,0.00%,74,0,100.00%
nl8.boom.skin,74,0.00%,74,0,100.00%
nja.boom.skin,74,0.00%,74,0,100.00%
41.push2his.eastmoney.com,74,0.00%,74,0,100.00%
ldc-fast.lenovo.com.cn,74,0.00%,74,0,100.00%
fsigns.duba.net,74,0.00%,74,0,100.00%
stun.services.mozilla.com,74,0.00%,74,0,100.00%
telemetry-in.battlenet.com.cn,74,0.00%,74,0,100.00%
99.push2his.eastmoney.com,74,0.00%,74,0,100.00%
5.push2his.eastmoney.com,74,0.00%,74,0,100.00%
retracker.telecom.by,74,0.00%,74,0,100.00%
cdn.weather.hao.360.cn,74,0.00%,88,14,84.09%
commerce.safe.360.cn,73,0.00%,73,0,100.00%
tracker.open-internet.nl,73,0.00%,73,0,100.00%
a1992.dscd.akamai.net,73,0.00%,154,81,47.40%
acstatic-dun.126.net,73,0.00%,73,0,100.00%
global.in.ai.monitor.azure.com,73,0.00%,73,0,100.00%
ocsp.entrust.net.edgekey.net,73,0.00%,157,84,46.50%
miserupdate.aliyun.com.danuoyi.tbcache.com,73,0.00%,73,0,100.00%
assets2.msn.com,73,0.00%,73,0,100.00%
nl9.boom.skin,73,0.00%,73,0,100.00%
nl7.boom.skin,73,0.00%,73,0,100.00%
n61.boom.skin,73,0.00%,73,0,100.00%
s101.boom.skin,73,0.00%,73,0,100.00%
d2kpbcafi909wb.cloudfront.net,73,0.00%,74,1,98.65%
anidex.moe,73,0.00%,73,0,100.00%
slardar-bd.feishu.cn.bytedns1.com,73,0.00%,73,0,100.00%
tsfe.trafficmanager.net,72,0.00%,72,0,100.00%
d28139t0r7hg1k.cloudfront.net,72,0.00%,146,74,49.32%
res.u-tools.cn,72,0.00%,72,0,100.00%
ini.update.360safe.com,72,0.00%,72,0,100.00%
gspe35-ssl.ls-apple.com.akadns.net,72,0.00%,91,19,79.12%
25.push2his.eastmoney.com,72,0.00%,72,0,100.00%
sb.scorecardresearch.com,72,0.00%,72,0,100.00%
fc-ccimage.baidu.com,72,0.00%,72,0,100.00%
36.push2his.eastmoney.com,72,0.00%,72,0,100.00%
97.push2his.eastmoney.com,72,0.00%,72,0,100.00%
nla.boom.skin,72,0.00%,72,0,100.00%
n67.boom.skin,72,0.00%,72,0,100.00%
n74.boom.skin,72,0.00%,72,0,100.00%
tracker2.dler.org,72,0.00%,72,0,100.00%
74.push2his.eastmoney.com,72,0.00%,72,0,100.00%
pancake.apple.com,72,0.00%,72,0,100.00%
28.push2his.eastmoney.com,72,0.00%,72,0,100.00%
meeting.tencent.com,72,0.00%,72,0,100.00%
www.news.cn,72,0.00%,162,90,44.44%
doh.zjurl.cn,72,0.00%,72,0,100.00%
www.update.microsoft.com,71,0.00%,71,0,100.00%
js1.pcfg.cache.wpscdn.cn,71,0.00%,162,91,43.83%
mgtracker.org,71,0.00%,71,0,100.00%
fe2.update.microsoft.com,71,0.00%,150,79,47.33%
onedscolprdcus13.centralus.cloudapp.azure.com,71,0.00%,71,0,100.00%
mcs.snssdk.com,71,0.00%,151,80,47.02%
hpd.a.shifen.com,71,0.00%,71,0,100.00%
dc.applicationinsights.azure.com,71,0.00%,71,0,100.00%
global.in.ai.privatelink.monitor.azure.com,71,0.00%,71,0,100.00%
settings-prod-scus-1.southcentralus.cloudapp.azure.com,71,0.00%,71,0,100.00%
www2.bing.com,71,0.00%,71,0,100.00%
appleimap.163.com,71,0.00%,71,0,100.00%
array609.prod.do.dsp.mp.microsoft.com,71,0.00%,71,0,100.00%
public-cdn.cloud.unitychina.cn,71,0.00%,71,0,100.00%
40.push2his.eastmoney.com,71,0.00%,71,0,100.00%
22.push2his.eastmoney.com,71,0.00%,71,0,100.00%
cp801.prod.do.dsp.mp.microsoft.com,71,0.00%,71,0,100.00%
intf-pc.ludashi.com,71,0.00%,71,0,100.00%
open.acgnxtracker.com,71,0.00%,120,49,59.17%
53.push2his.eastmoney.com,71,0.00%,71,0,100.00%
track.mediav.com,71,0.00%,71,0,100.00%
wpsfile.ks3-cn-beijing.ksyun.com,70,0.00%,70,0,100.00%
quote.eastmoney.com,70,0.00%,161,91,43.48%
34.push2his.eastmoney.com,70,0.00%,70,0,100.00%
newsie.2345.com,70,0.00%,70,0,100.00%
configuration.apple.com,70,0.00%,98,28,71.43%
upos-sz-mirrorali.bilivideo.com.w.kunluncan.com,70,0.00%,70,0,100.00%
tracker.ccc.de,70,0.00%,70,0,100.00%
down.xinshuru.com,70,0.00%,70,0,100.00%
31.push2his.eastmoney.com,70,0.00%,70,0,100.00%
83.push2his.eastmoney.com,70,0.00%,70,0,100.00%
d3pi17oyma2pxs.cloudfront.net,70,0.00%,75,5,93.33%
cn-bing-com.cn.a-0001.a-msedge.net,69,0.00%,77,8,89.61%
browser.pipe.aria.microsoft.com,69,0.00%,73,4,94.52%
pic.rmb.bdstatic.com,69,0.00%,92,23,75.00%
guzzoni-apple-com.v.aaplimg.com,69,0.00%,69,0,100.00%
ts.gtm.eset.com,69,0.00%,69,0,100.00%
73.push2his.eastmoney.com,69,0.00%,69,0,100.00%
mbdp01.bdstatic.com,69,0.00%,69,0,100.00%
emres.dfcfw.com,69,0.00%,156,87,44.23%
gce-beacons.gcp.gvt2.com,69,0.00%,69,0,100.00%
checkip.digitalocean.synology.com,69,0.00%,69,0,100.00%
smtp.nfschina.com,69,0.00%,69,0,100.00%
44.push2his.eastmoney.com,69,0.00%,69,0,100.00%
75.push2his.eastmoney.com,69,0.00%,69,0,100.00%
stat.lianmeng.360.cn,69,0.00%,69,0,100.00%
ssl-google-analytics.l.google.com,69,0.00%,76,7,90.79%
retracker.netbynet.ru,68,0.00%,68,0,100.00%
onedscolprdwus06.westus.cloudapp.azure.com,68,0.00%,68,0,100.00%
onedscolprdeus05.eastus.cloudapp.azure.com,68,0.00%,130,62,52.31%
emcharts.eastmoney.com,68,0.00%,155,87,43.87%
htydhd.wmupd.com,68,0.00%,68,0,100.00%
onedscolprdeus14.eastus.cloudapp.azure.com,68,0.00%,68,0,100.00%
download.jetbrains.com.cn,68,0.00%,111,43,61.26%
vaiwan.com,68,0.00%,68,0,100.00%
ext.baidu.com,68,0.00%,68,0,100.00%
SIN-efz.ms-acdc.office.com,67,0.00%,151,84,44.37%
dsm01pap006.storage.live.com,67,0.00%,111,44,60.36%
p4p.arenabg.com,67,0.00%,67,0,100.00%
waws-prod-sg1-057-feea.southeastasia.cloudapp.azure.com,67,0.00%,67,0,100.00%
bolt.dropbox.com,67,0.00%,138,71,48.55%
cdn.onenote.net,67,0.00%,136,69,49.26%
aladin.wxqcloud.qq.com,67,0.00%,67,0,100.00%
assets.msn.com.edgekey.net,67,0.00%,67,0,100.00%
fsrhk.lenovomm.com,67,0.00%,67,0,100.00%
c.apple.news,67,0.00%,151,84,44.37%
opencdnbdimgtn.jomodns.com,67,0.00%,98,31,68.37%
mam.ntes53.netease.com,67,0.00%,67,0,100.00%
e12437.d.akamaiedge.net,67,0.00%,67,0,100.00%
pc.profile.pinyin.sogou.com,67,0.00%,67,0,100.00%
www.nowcoder.com,67,0.00%,67,0,100.00%
1.push2his.eastmoney.com,67,0.00%,67,0,100.00%
4.push2his.eastmoney.com,67,0.00%,67,0,100.00%
spoon.skyworthdigital.sjxrbj.com,67,0.00%,67,0,100.00%
evolwallpaper-api.papegames.cn,67,0.00%,67,0,100.00%
imap.iscas.ac.cn,67,0.00%,67,0,100.00%
models.gazebosim.org,67,0.00%,67,0,100.00%
ntp.ntsc.ac.cn,67,0.00%,67,0,100.00%
registry.eulix.xyz,67,0.00%,67,0,100.00%
dlswbr.baidu.com,66,0.00%,117,51,56.41%
passport.baidu.com,66,0.00%,204,138,32.35%
extensions.gnome.org,66,0.00%,120,54,55.00%
sv.symcd.com,66,0.00%,139,73,47.48%
emcharts.dftzj.com,66,0.00%,151,85,43.71%
emcharts.dfcfw.com,66,0.00%,147,81,44.90%
zhannei-dm.csdn.net,66,0.00%,66,0,100.00%
api.segment.io,66,0.00%,66,0,100.00%
sqimg.qq.com.cloud.tcdn.qq.com,66,0.00%,66,0,100.00%
oauth.account.jetbrains.com,66,0.00%,66,0,100.00%
dispatcher.is.autonavi.com,66,0.00%,66,0,100.00%
ping.sogou.com,66,0.00%,66,0,100.00%
56.push2his.eastmoney.com,66,0.00%,66,0,100.00%
dmd.metaservices.microsoft.com,66,0.00%,66,0,100.00%
browser.events.data.microsoft.com,66,0.00%,69,3,95.65%
tracker.torrentyorg.pl,66,0.00%,66,0,100.00%
idcdo11948.netvigators.xyz,66,0.00%,66,0,100.00%
www.soupm25.com,66,0.00%,66,0,100.00%
sz-ucloud-ipv4.ucloudnaming.info,65,0.00%,65,0,100.00%
mirrors.huaweicloud.com,65,0.00%,65,0,100.00%
smarthome-drcn.dbankcdn.com,65,0.00%,65,0,100.00%
h-adashx-internal.ut.taobao.com,65,0.00%,65,0,100.00%
fanyi-bfe.n.shifen.com,65,0.00%,65,0,100.00%
80.push2his.eastmoney.com,65,0.00%,65,0,100.00%
kns.duba.net,65,0.00%,65,0,100.00%
path2.xtracloud.net,65,0.00%,65,0,100.00%
gsp64-ssl.ls-apple.com.akadns.net,65,0.00%,65,0,100.00%
settings-prod-wus2-1.westus2.cloudapp.azure.com,65,0.00%,65,0,100.00%
ocws.officeapps.live.com,65,0.00%,65,0,100.00%
onedscolprdeus02.eastus.cloudapp.azure.com,65,0.00%,65,0,100.00%
picx.zhimg.com,65,0.00%,121,56,53.72%
cn-shanghai.axt.aliyun.com,65,0.00%,65,0,100.00%
d4ykqdf81nuuy.cloudfront.net,65,0.00%,75,10,86.67%
tr.gingersoftware.com,65,0.00%,65,0,100.00%
internal-api.feishu.cn,64,0.00%,64,0,100.00%
bn02pap001.storage.live.com,64,0.00%,107,43,59.81%
open.qurl.f.qh-lb.com,64,0.00%,64,0,100.00%
alb-wy5mqfy1o52wprnwel.cn-hangzhou.alb.aliyuncs.com,64,0.00%,64,0,100.00%
learnreport.xiaoeknow.com,64,0.00%,64,0,100.00%
baijiahao.baidu.com,64,0.00%,64,0,100.00%
kjk3jf40.sched.sma-dk.tdnsstic1.cn,64,0.00%,137,73,46.72%
12.push2his.eastmoney.com,64,0.00%,64,0,100.00%
filehouse.zhhainiao.com,64,0.00%,64,0,100.00%
translate.googleapis.com,64,0.00%,84,20,76.19%
settings-prod-uks-2.uksouth.cloudapp.azure.com,64,0.00%,64,0,100.00%
w.deepl.com,64,0.00%,64,0,100.00%
hector.baidu.com,64,0.00%,64,0,100.00%
i3.cwip.eset.com,64,0.00%,64,0,100.00%
builds.parsecgaming.com,64,0.00%,118,54,54.24%
sqimg.qq.com.sched.legopic2.tdnsv6.com,64,0.00%,64,0,100.00%
zh-cn.content.prod.cms.msn.com,64,0.00%,64,0,100.00%
30.push2his.eastmoney.com,64,0.00%,64,0,100.00%
ws-std01.sunlogin.oray.com,64,0.00%,64,0,100.00%
helpdubaservice.ksmobile.com,64,0.00%,64,0,100.00%
ieonline.microsoft.com,64,0.00%,64,0,100.00%
plus.wps.cn,63,0.00%,63,0,100.00%
msgcenter.wps.cn,63,0.00%,63,0,100.00%
l-0003.l-msedge.net,63,0.00%,100,37,63.00%
msg.video.dns.iqiyi.com,63,0.00%,63,0,100.00%
settings-prod-wjp-1.japanwest.cloudapp.azure.com,63,0.00%,63,0,100.00%
90.push2his.eastmoney.com,63,0.00%,63,0,100.00%
onedscolprdwus14.westus.cloudapp.azure.com,63,0.00%,63,0,100.00%
XSP-efz.ms-acdc.office.com,63,0.00%,159,96,39.62%
cdn-file.ludashi.com.m.alikunlun.net,63,0.00%,63,0,100.00%
jtypkz2w.sched.d2.tdnsdp1.cn.cjt.vwnti.yrzhcloud.cn,63,0.00%,63,0,100.00%
61.push2his.eastmoney.com,63,0.00%,63,0,100.00%
91.push2his.eastmoney.com,63,0.00%,63,0,100.00%
acdc-direct.office.com,63,0.00%,137,74,45.99%
down.anticheatexpert.com.wsdvs.com,63,0.00%,63,0,100.00%
sf.symcd.com,63,0.00%,141,78,44.68%
ovv4.alllook.tv,63,0.00%,63,0,100.00%
dasmey87ui65e.cloudfront.net,63,0.00%,65,2,96.92%
tsearch.snssdk.com,63,0.00%,63,0,100.00%
consumerapps.mcafee.com,63,0.00%,63,0,100.00%
show-g.mediav.com,63,0.00%,63,0,100.00%
imap.sina.cn,63,0.00%,63,0,100.00%
data.bilivideo.com,62,0.00%,62,0,100.00%
captcha.gtimg.com,62,0.00%,67,5,92.54%
openapp.wpscdn.cn,62,0.00%,134,72,46.27%
cdp.cloud.unity3d.com,62,0.00%,62,0,100.00%
e19240.ca.s.tl88.net,62,0.00%,62,0,100.00%
ada.baidu.com,62,0.00%,62,0,100.00%
mon.zijieapi.com.dsa.dnsv1.com.cn,62,0.00%,62,0,100.00%
88.push2his.eastmoney.com,62,0.00%,62,0,100.00%
p0.ssl.img.360kuai.com,62,0.00%,70,8,88.57%
displaycatalog.mp.microsoft.com,62,0.00%,62,0,100.00%
developer.download.nvidia.com,62,0.00%,62,0,100.00%
doh.360.cn,62,0.00%,62,0,100.00%
ocsp.dcocsp.cn,62,0.00%,62,0,100.00%
m701.music.126.net,62,0.00%,62,0,100.00%
bj29.cn-beijing.data.alicloudccp.com,62,0.00%,62,0,100.00%
api.goco.io,61,0.00%,61,0,100.00%
www.tm.ak.prd.aadg.trafficmanager.net,61,0.00%,61,0,100.00%
listen1.myradio24.com,61,0.00%,61,0,100.00%
api.aquamedian.com,61,0.00%,61,0,100.00%
mail.pnpitalia.it,61,0.00%,61,0,100.00%
w.isoleader.com.tw,61,0.00%,61,0,100.00%
store-us-uat.motorola.com,61,0.00%,61,0,100.00%
pica.zhimg.com,61,0.00%,135,74,45.19%
test.memryplus.no,61,0.00%,61,0,100.00%
ebook-discount-checker.herokuapp.com,61,0.00%,61,0,100.00%
srv01.got-skills.de,61,0.00%,61,0,100.00%
icu.wjwblog.ml,61,0.00%,61,0,100.00%
msnzlxxglobal.v.lxcvc.com,61,0.00%,61,0,100.00%
ivdu.herokuapp.com,61,0.00%,61,0,100.00%
ocsp.digicert.cn.w.cdngslb.com,61,0.00%,61,0,100.00%
sklep.architekci.pl,61,0.00%,61,0,100.00%
d1w2n8w3obm3k0.cloudfront.net,61,0.00%,61,0,100.00%
botfuel-hermes-backend-bo.herokuapp.com,61,0.00%,61,0,100.00%
hicbrnuxnyozpgtj.ggyy99.tk,61,0.00%,61,0,100.00%
mail.lntaowedgamevn29.tk,61,0.00%,61,0,100.00%
bck65.modsbase.com,61,0.00%,61,0,100.00%
fve818eeb.34er.layo.ml,61,0.00%,61,0,100.00%
files.cloudhdr.com,61,0.00%,61,0,100.00%
kk.eeeqq.tk,61,0.00%,61,0,100.00%
oth.str.mdt.qq.com,61,0.00%,61,0,100.00%
latitudemediation.co.uk,61,0.00%,61,0,100.00%
mail.captrustunivervity.ml,61,0.00%,61,0,100.00%
supplier-service.boilerjuice-staging.com,61,0.00%,61,0,100.00%
miska.sinisagrubor.com,61,0.00%,61,0,100.00%
ybworldtkdhr.kicksite.net,61,0.00%,61,0,100.00%
bridger-production-ecommerce-poiuytre.entabeni.tech,61,0.00%,61,0,100.00%
www.shipcloud.io,61,0.00%,61,0,100.00%
direwolf-b027da35cc.herokuapp.com,61,0.00%,61,0,100.00%
si.eurasip.org,61,0.00%,61,0,100.00%
products.haag-streit-usa.com,61,0.00%,61,0,100.00%
wy.aleteam.cf,61,0.00%,61,0,100.00%
web5803.getambassador.com,61,0.00%,61,0,100.00%
tqovac.b47chang.ml,61,0.00%,61,0,100.00%
yun.tim.qq.com,61,0.00%,61,0,100.00%
d11wkw82a69pyn.cloudfront.net,61,0.00%,61,0,100.00%
6cd41fb5-90fe-440a-a9ef-e4cd8be690cb.assets.booqable.com,61,0.00%,61,0,100.00%
au.download.windowsupdate.com,61,0.00%,63,2,96.83%
socket.hellomedian.com,61,0.00%,61,0,100.00%
4dhsmyy5vfyr.loopd.life,61,0.00%,61,0,100.00%
app.itrends.co.in,61,0.00%,61,0,100.00%
beta.doba.pl,61,0.00%,61,0,100.00%
j.mp,61,0.00%,61,0,100.00%
tz.oneast.ga,61,0.00%,61,0,100.00%
m.xiaoz666.cf,61,0.00%,61,0,100.00%
b1world.beritasatumedia.com,61,0.00%,61,0,100.00%
orders.pvdonuts.com,61,0.00%,61,0,100.00%
dev.creser-sf.com,61,0.00%,61,0,100.00%
a.zimgs.cn.w.alikunlun.com,61,0.00%,61,0,100.00%
ejp1.go2https.com,61,0.00%,61,0,100.00%
work.sunruilin.com,61,0.00%,61,0,100.00%
xxtus1xx.ylfnajort.tk,61,0.00%,61,0,100.00%
mail.arcsoft.com.tw,61,0.00%,61,0,100.00%
admin.simplonpass.maddevs.co,61,0.00%,61,0,100.00%
mail.basketzweaks.ml,61,0.00%,61,0,100.00%
ae.rogue7.ca,61,0.00%,61,0,100.00%
imap.netsergroup.com,61,0.00%,61,0,100.00%
a2plvcpnl383198.prod.iad2.secureserver.net,61,0.00%,61,0,100.00%
api.almaknit.com,61,0.00%,61,0,100.00%
alpha.api.muz.li,61,0.00%,61,0,100.00%
show.3.mediav.com,61,0.00%,61,0,100.00%
broker-api-staging.cowboy.bike,61,0.00%,61,0,100.00%
172-105-21-56.15c9f2e79c4d4beca205766bdb7bc2ea.plex.direct,61,0.00%,61,0,100.00%
grid-arendal.herokuapp.com,61,0.00%,61,0,100.00%
jp-s7.fatvpn.ml,61,0.00%,61,0,100.00%
oracle.yuankk.cf,61,0.00%,61,0,100.00%
mail.neuboxdodorney.tk,61,0.00%,61,0,100.00%
smib-app.herokuapp.com,61,0.00%,61,0,100.00%
krynica-zdroj.org.pl,61,0.00%,61,0,100.00%
ar.susasummit.org,61,0.00%,61,0,100.00%
my-tesmaazzingacavall.socialacademy.me,61,0.00%,61,0,100.00%
xa.sammentik.cf,61,0.00%,61,0,100.00%
1920.1988330.com,61,0.00%,61,0,100.00%
mail.autokeyreplacementsanantonio.com,61,0.00%,61,0,100.00%
gardaalarm.teamtailor.com,61,0.00%,61,0,100.00%
cpanel.redypon.tk,61,0.00%,61,0,100.00%
dev-app.ye.care,61,0.00%,61,0,100.00%
wiki.x2go.org,61,0.00%,61,0,100.00%
mosley.staging.fflegacy.club,61,0.00%,61,0,100.00%
mail.ukknowlegefree36.gq,61,0.00%,61,0,100.00%
hinet02.tr.zsdcloud.xyz,61,0.00%,61,0,100.00%
blog.collegeadvisor.com,61,0.00%,61,0,100.00%
aainternational.com.mx,61,0.00%,61,0,100.00%
sbyv.herokuapp.com,61,0.00%,61,0,100.00%
shopify-pickup-app.herokuapp.com,61,0.00%,61,0,100.00%
tst.cumo.de,61,0.00%,61,0,100.00%
mail.yolomic-likes-cum.cf,61,0.00%,61,0,100.00%
zu.fangzi.fr,61,0.00%,61,0,100.00%
mail.treplongtorredg.cf,61,0.00%,61,0,100.00%
evoskills.kitelabs.it,61,0.00%,61,0,100.00%
labels-webapp.herokuapp.com,61,0.00%,61,0,100.00%
satori-frisco.myzeki.com,61,0.00%,61,0,100.00%
agenda.ubirajara.adv.br,61,0.00%,61,0,100.00%
t98b79u.aee.dseoe.ga,61,0.00%,61,0,100.00%
m.m.adm.xiongwei.club,61,0.00%,61,0,100.00%
mail.fkjkvndkjviofoie.gq,61,0.00%,61,0,100.00%
defis.ordredemaltefrance.org,61,0.00%,61,0,100.00%
maps.djtechtools.com,61,0.00%,61,0,100.00%
xn--www-rp0a.finavia.pelsu.fi,61,0.00%,61,0,100.00%
d32wpxz89tv3uk.cloudfront.net,61,0.00%,61,0,100.00%
staging.sadio.org.ar,61,0.00%,61,0,100.00%
lb78.s400.meetrics.net,61,0.00%,61,0,100.00%
lovewp.teachery.co,61,0.00%,61,0,100.00%
hk.ykbattle.cf,61,0.00%,61,0,100.00%
mail.quemananle.tk,61,0.00%,61,0,100.00%
download.tmssoftware.com,61,0.00%,61,0,100.00%
img.knowll.com,61,0.00%,61,0,100.00%
admin.cubiq.me,61,0.00%,61,0,100.00%
staging.flock.dk,61,0.00%,61,0,100.00%
app.spokehs.com,61,0.00%,61,0,100.00%
api.opal.work,61,0.00%,61,0,100.00%
us2.yesdaddy.win,61,0.00%,61,0,100.00%
vpn.flys.tk,61,0.00%,61,0,100.00%
backup.mindspore.cn,61,0.00%,61,0,100.00%
app.localvoucher.de,61,0.00%,61,0,100.00%
elearning.colaboral.com,61,0.00%,61,0,100.00%
komando.cubo.pe,61,0.00%,61,0,100.00%
stat.teleport.media,61,0.00%,61,0,100.00%
magento.dataanalytics.ml,61,0.00%,61,0,100.00%
hm.bitcoinwisdom.io,61,0.00%,61,0,100.00%
azhk2.joplin.cf,61,0.00%,61,0,100.00%
london-coliseum-live.herokuapp.com,61,0.00%,61,0,100.00%
lauftreff.tgkonz.de,61,0.00%,61,0,100.00%
admin2.staging.speedleasing.com,61,0.00%,61,0,100.00%
app.kolejowa.dev.packhelp.es,61,0.00%,61,0,100.00%
dev.imkerijgrooten.be,61,0.00%,61,0,100.00%
mta-sts.mail.franklinleadership.com,61,0.00%,61,0,100.00%
my.jlhosting.net,61,0.00%,61,0,100.00%
ticker.ligaportal.at,61,0.00%,61,0,100.00%
billing.moonswitch.com,61,0.00%,61,0,100.00%
us-performance-test.evens.eu,61,0.00%,61,0,100.00%
lib.tfai.org.tw,61,0.00%,61,0,100.00%
twfsmdz5fl.nare.dseoe.tk,61,0.00%,61,0,100.00%
mail.tazijgroup.com,61,0.00%,61,0,100.00%
sixthavenuecapital.gmamca.com,61,0.00%,61,0,100.00%
castlemarketing.co.uk,61,0.00%,61,0,100.00%
news.ifox2048.tk,61,0.00%,61,0,100.00%
sc-ocala-fl.herokuapp.com,61,0.00%,61,0,100.00%
m.pokerincome.com,61,0.00%,61,0,100.00%
pop3.teamtailor.com,61,0.00%,61,0,100.00%
versus.lanacion.com.py,61,0.00%,61,0,100.00%
yangyang1107.freeee.ml,61,0.00%,61,0,100.00%
ud.janraincapture.com,61,0.00%,61,0,100.00%
giochidatavolo.altervista.org,61,0.00%,61,0,100.00%
dmhk4.mstld.ml,61,0.00%,61,0,100.00%
test.privy-staging-pr-2575.privy-staging.com,61,0.00%,61,0,100.00%
s108.api.bsplayer-subtitles.com,61,0.00%,61,0,100.00%
recibos.centerbrok.es,61,0.00%,61,0,100.00%
mail.almasezehn.com,61,0.00%,61,0,100.00%
nps.lovehost.ml,61,0.00%,61,0,100.00%
losangeles.niuniu888.ml,61,0.00%,61,0,100.00%
timeline.madebygps.com,61,0.00%,61,0,100.00%
3n.1513ke.ga,61,0.00%,61,0,100.00%
p01330820392.huyacdn.xyz,61,0.00%,61,0,100.00%
loanfin.com.au,61,0.00%,61,0,100.00%
sl-arm2.azure-100.tk,61,0.00%,61,0,100.00%
imap.tgs-mail.de,61,0.00%,61,0,100.00%
panel.cercisnetwork.net,61,0.00%,61,0,100.00%
kt2.pipecandyinc.co,61,0.00%,61,0,100.00%
message.user.camp,61,0.00%,61,0,100.00%
mpb6f6bleezx.qidian.cf,61,0.00%,61,0,100.00%
testapp.stromsy.com,61,0.00%,61,0,100.00%
backoffice.berghauscie.de,61,0.00%,61,0,100.00%
unitedkingdom.nmbrpro.com,61,0.00%,61,0,100.00%
mail.baristtaflower.com,61,0.00%,61,0,100.00%
theoutdoorclub.mymealplan.me,61,0.00%,61,0,100.00%
app.getreditus.com,61,0.00%,61,0,100.00%
sepehrdad.themekhooneh.ir,61,0.00%,61,0,100.00%
cloud.mi-services.ml,61,0.00%,61,0,100.00%
socketio-chat-h9jt.herokuapp.com,61,0.00%,61,0,100.00%
sa.mazadoka.com,61,0.00%,61,0,100.00%
wap.shubaoan.com,61,0.00%,61,0,100.00%
qwertycoin.miner.rocks,61,0.00%,93,32,65.59%
conclusion.ball.ml,61,0.00%,61,0,100.00%
timeline.adammitha.com,61,0.00%,61,0,100.00%
ln.qya71xss.ga,61,0.00%,61,0,100.00%
foo.bar.somewhere.com,61,0.00%,61,0,100.00%
mntom.herokuapp.com,61,0.00%,61,0,100.00%
mail.envo.ga,61,0.00%,61,0,100.00%
eshop.ksdamenities.gr,61,0.00%,61,0,100.00%
d2r6h7ytneza1l.cloudfront.net,61,0.00%,61,0,100.00%
criscarter.kidsprotectionplan.com,61,0.00%,61,0,100.00%
nordvpn.networkice.com,61,0.00%,61,0,100.00%
share.pukkainc.com,61,0.00%,61,0,100.00%
history.sagecreekhs.com,61,0.00%,61,0,100.00%
d7vzdp.mjxxzm7vw.ga,61,0.00%,61,0,100.00%
hidden-mountain-84140.herokuapp.com,61,0.00%,61,0,100.00%
b50.s79.research.de.com,61,0.00%,61,0,100.00%
mail.itslolo280374.tk,61,0.00%,61,0,100.00%
xyz.freeline.cf,61,0.00%,61,0,100.00%
mail.famillebourdon.ga,61,0.00%,61,0,100.00%
mynextcampushostel.at-austria.com,61,0.00%,61,0,100.00%
res40.traffer.net,61,0.00%,61,0,100.00%
dnsdatacheck.87ywgco8f346z76r.b.requestbin.net,61,0.00%,61,0,100.00%
mail.ifoacespain.ml,61,0.00%,61,0,100.00%
static.benibuy.com,61,0.00%,61,0,100.00%
mail.uncashd.org,61,0.00%,61,0,100.00%
totamona.t1.webimpacto.net,61,0.00%,61,0,100.00%
fredensborg.naernatur.dk,61,0.00%,61,0,100.00%
git.codesdream.com,61,0.00%,61,0,100.00%
mystore.msi.com,61,0.00%,61,0,100.00%
gidroplan.beatmaker.tv,61,0.00%,61,0,100.00%
allianzdirect.aklamio.de,61,0.00%,61,0,100.00%
en.yiwugo.com,61,0.00%,61,0,100.00%
alpha.gigapros.com,61,0.00%,61,0,100.00%
es32.mycliplister.com,61,0.00%,61,0,100.00%
cdn-eu08.x5o.org,61,0.00%,61,0,100.00%
en.1speaking.com,61,0.00%,61,0,100.00%
keysmeadow.builtbydamian.com,61,0.00%,61,0,100.00%
backstage.hire.toggl.space,61,0.00%,61,0,100.00%
linode.wsuika.club,61,0.00%,61,0,100.00%
static.usemywarranty.com,61,0.00%,61,0,100.00%
wos32256.herokuapp.com,61,0.00%,61,0,100.00%
webmailkhh.tsrc-global.com,61,0.00%,61,0,100.00%
ts-chat-prod.herokuapp.com,61,0.00%,61,0,100.00%
analytics.elerion.com,61,0.00%,61,0,100.00%
tj0i.herokuapp.com,61,0.00%,61,0,100.00%
api-app.apeiwan.com,61,0.00%,61,0,100.00%
core.hup.chat,61,0.00%,61,0,100.00%
mo.guoba.cf,61,0.00%,61,0,100.00%
student.test.skillgrower.com,61,0.00%,61,0,100.00%
v2ray.emperinter.ga,61,0.00%,61,0,100.00%
motion-studio.danykalmeida.com,61,0.00%,61,0,100.00%
lists.hellasbridge.org,61,0.00%,61,0,100.00%
seednet.tr.zsdcloud.xyz,61,0.00%,61,0,100.00%
gaspumpserver.herokuapp.com,61,0.00%,61,0,100.00%
partners.rentsync.ca,61,0.00%,61,0,100.00%
nerga.herokuapp.com,61,0.00%,61,0,100.00%
pan.mcbebbs.ga,61,0.00%,61,0,100.00%
bw.izocku.ml,61,0.00%,61,0,100.00%
mail.tilcopit.tk,61,0.00%,61,0,100.00%
s74.ipcamlive.com,61,0.00%,61,0,100.00%
parkschool.nutrislice.com,61,0.00%,61,0,100.00%
6954.vrxdy8.com,61,0.00%,61,0,100.00%
mail.ekynox.net,61,0.00%,61,0,100.00%
test.lchecklist.com,61,0.00%,61,0,100.00%
winsel.dynet.com,61,0.00%,61,0,100.00%
compass3.northforest.com,61,0.00%,61,0,100.00%
devapp4.go-oncall.com,61,0.00%,61,0,100.00%
nazivo.myslikonajzbohatni.sk,61,0.00%,61,0,100.00%
us1.feuler.tk,61,0.00%,61,0,100.00%
direwolf-c7a260a2ce.herokuapp.com,61,0.00%,61,0,100.00%
leevanover.sportstalkline.com,61,0.00%,61,0,100.00%
cn.duetdisplay.com,61,0.00%,61,0,100.00%
pukezuobigaoshou.herokuapp.com,61,0.00%,61,0,100.00%
bl.jiashumao.net,61,0.00%,61,0,100.00%
orders.awrswheelrepair.com,61,0.00%,61,0,100.00%
wygew0.a37zhuang.ga,61,0.00%,61,0,100.00%
143-198-169-17.luminatinet.com,61,0.00%,61,0,100.00%
mail.igspaste.ga,61,0.00%,61,0,100.00%
cold-shower-therapy.herokuapp.com,61,0.00%,61,0,100.00%
direwolf-d536be756e.herokuapp.com,61,0.00%,61,0,100.00%
powerfulpoints.com.au,61,0.00%,61,0,100.00%
books.kifle.us,61,0.00%,61,0,100.00%
ccone.ditbok.cf,61,0.00%,61,0,100.00%
identatronics.com.mx,61,0.00%,61,0,100.00%
mail.rankerweb92.ml,61,0.00%,61,0,100.00%
cloud.qovop.cf,61,0.00%,61,0,100.00%
mail.ramsidepigma.cf,61,0.00%,61,0,100.00%
visa.inostranno.ru,61,0.00%,61,0,100.00%
quotes.liberty-tree.ca,61,0.00%,61,0,100.00%
mail.lnage.cf,61,0.00%,61,0,100.00%
janis.livetonight.fr,61,0.00%,61,0,100.00%
robotica-home.inventeaza.ro,61,0.00%,61,0,100.00%
zulu419.rtb.appier.net,61,0.00%,61,0,100.00%
nordicprogress.teamtailor.com,61,0.00%,61,0,100.00%
amers2.gateway.cp.thomsonreuters.com,61,0.00%,61,0,100.00%
bwolvesbabc.teamsitesnow.com,61,0.00%,61,0,100.00%
p3plcpnl0465.prod.phx3.secureserver.net,61,0.00%,61,0,100.00%
ccc.clcrehoboth.com,61,0.00%,61,0,100.00%
alvarezysanchez.com.do,61,0.00%,61,0,100.00%
spondylusdc.kraftor.com,61,0.00%,61,0,100.00%
mail.sendung.tk,61,0.00%,61,0,100.00%
fw.yangjunjie.ml,61,0.00%,61,0,100.00%
yqjqib.b27zhuai.gq,61,0.00%,61,0,100.00%
video.rs.no,61,0.00%,61,0,100.00%
blog.dynana.tk,61,0.00%,61,0,100.00%
999.dongwu.tk,61,0.00%,61,0,100.00%
galerie.opix.ch,61,0.00%,61,0,100.00%
legana.churchsocial.co,61,0.00%,61,0,100.00%
order.diamondespresso.com,61,0.00%,61,0,100.00%
ip-72-167-47-248.ip.secureserver.net,61,0.00%,61,0,100.00%
pan.yidaozhan.ga,61,0.00%,61,0,100.00%
harm.cut.winter.ml,61,0.00%,61,0,100.00%
gsm.gsmoem2020.tk,61,0.00%,61,0,100.00%
m.234xs.cc,61,0.00%,61,0,100.00%
imscared.backerkit.com,61,0.00%,61,0,100.00%
oracle.hellorainman.ga,61,0.00%,61,0,100.00%
portal.autogas-partner.de,61,0.00%,61,0,100.00%
direwolf-fa56b28170.herokuapp.com,61,0.00%,61,0,100.00%
direwolf-7f351fe1d5.herokuapp.com,61,0.00%,61,0,100.00%
scrm-wx.weiling.cn,61,0.00%,61,0,100.00%
someip.synology.me,61,0.00%,61,0,100.00%
streamall.alsolnet.com,61,0.00%,61,0,100.00%
crossfire.zepfree.gq,61,0.00%,61,0,100.00%
mail.quijencichoprunddis.tk,61,0.00%,61,0,100.00%
formacao.clubenaospro.pt,61,0.00%,61,0,100.00%
direwolf-b63607701b.herokuapp.com,61,0.00%,61,0,100.00%
qualifmartinique.digibarre.com,61,0.00%,61,0,100.00%
dogeu2.hivess.xyz,61,0.00%,61,0,100.00%
detikriau.herokuapp.com,61,0.00%,61,0,100.00%
stage-api-linguabee.herokuapp.com,61,0.00%,61,0,100.00%
tramp-v2.herokuapp.com,61,0.00%,61,0,100.00%
wmapi.camerabay.tv,61,0.00%,61,0,100.00%
mail.retrovibes.ga,61,0.00%,61,0,100.00%
ewalton.brojure.com,61,0.00%,61,0,100.00%
jd.ysunic.tk,61,0.00%,61,0,100.00%
blachere.com.mx,61,0.00%,61,0,100.00%
apptmech-server-live.herokuapp.com,61,0.00%,61,0,100.00%
admin-stage.getabite.co,61,0.00%,61,0,100.00%
www4.gogostudy.tk,61,0.00%,61,0,100.00%
jyid.herokuapp.com,61,0.00%,61,0,100.00%
new.weatherbeard.com,61,0.00%,61,0,100.00%
poly.hpmahesh.me,61,0.00%,61,0,100.00%
bwg.scientificladder.tk,61,0.00%,61,0,100.00%
pyktlapyjqez.phone-delivery.com,61,0.00%,61,0,100.00%
help.gainexps.com,61,0.00%,61,0,100.00%
mail.newzblogzart305.cf,61,0.00%,61,0,100.00%
powerswiftmobile-training.getfliptech.com,61,0.00%,61,0,100.00%
test.findeling.com,61,0.00%,61,0,100.00%
www2.diaodaquan.cf,61,0.00%,61,0,100.00%
whitelist.alteryx.com,61,0.00%,61,0,100.00%
la-gia.free2world.cf,61,0.00%,61,0,100.00%
apt.eda-iot.com,61,0.00%,61,0,100.00%
direwolf-39203ed404.herokuapp.com,61,0.00%,61,0,100.00%
preprod.api.blacksheep.app,61,0.00%,61,0,100.00%
antigentestwhetstone.co.uk,61,0.00%,61,0,100.00%
6.ruiolhui.ml,61,0.00%,61,0,100.00%
de1.candy123.top,61,0.00%,61,0,100.00%
shop.gipsyway.com,61,0.00%,61,0,100.00%
adpexceedfertilizers.herokuapp.com,61,0.00%,61,0,100.00%
api.familysafetyproduction.com,61,0.00%,61,0,100.00%
pms.iopsapps.com,61,0.00%,61,0,100.00%
mail.trahisflocawor.ga,61,0.00%,61,0,100.00%
printjs-4de6.kxcdn.com,61,0.00%,61,0,100.00%
divi.junge-tribologen.de,61,0.00%,61,0,100.00%
flowerswithflair.co.uk,61,0.00%,61,0,100.00%
headless.development.ciab.io,61,0.00%,61,0,100.00%
hockeyvm2017.confetti.events,61,0.00%,61,0,100.00%
onedscolprdwus02.westus.cloudapp.azure.com,60,0.00%,60,0,100.00%
ksopush.kdocs.cn,60,0.00%,60,0,100.00%
settings-prod-wus2-2.westus2.cloudapp.azure.com,60,0.00%,60,0,100.00%
update.qnap.com,60,0.00%,60,0,100.00%
onedscolprdeus09.eastus.cloudapp.azure.com,60,0.00%,60,0,100.00%
api.openweathermap.org,60,0.00%,60,0,100.00%
array503.prod.do.dsp.mp.microsoft.com,60,0.00%,117,57,51.28%
config.safedog.cn,60,0.00%,60,0,100.00%
down.safedog.cn,60,0.00%,60,0,100.00%
download.visualstudio.microsoft.com.mwcname.com,60,0.00%,60,0,100.00%
cfw.gti.mcafee.akadns.net,60,0.00%,60,0,100.00%
vconf.f.360.cn,60,0.00%,60,0,100.00%
i2.hdslb.com,60,0.00%,125,65,48.00%
98.push2his.eastmoney.com,60,0.00%,60,0,100.00%
baidubox-emoji.cdn.bcebos.com,60,0.00%,60,0,100.00%
1D.tlu.dl.delivery.mp.microsoft.com,60,0.00%,60,0,100.00%
config.qqpy.sogou.com,60,0.00%,60,0,100.00%
download.microvirt.com,60,0.00%,60,0,100.00%
stun.internetcalls.com,60,0.00%,60,0,100.00%
xp.itunes-apple.com.akadns.net,59,0.00%,90,31,65.56%
onedscolprdwus08.westus.cloudapp.azure.com,59,0.00%,59,0,100.00%
prda.aadg.msidentity.com,59,0.00%,59,0,100.00%
ak.privatelink.msidentity.com,59,0.00%,59,0,100.00%
k53k6ler.sched.sma.tdnsstic1.cn,59,0.00%,59,0,100.00%
h-adashx.ut.taobao.com.gds.alibabadns.com,59,0.00%,59,0,100.00%
update.360safe.com,59,0.00%,59,0,100.00%
bili-dyn-sched.jcloud-cdn.com,59,0.00%,59,0,100.00%
tracker.ddunlimited.net,59,0.00%,59,0,100.00%
i3.c.eset.com,59,0.00%,59,0,100.00%
web.sdk.qcloud.com,59,0.00%,129,70,45.74%
onedscolprdeus10.eastus.cloudapp.azure.com,59,0.00%,59,0,100.00%
APAC05.azure-devices.net,59,0.00%,59,0,100.00%
common.docer.wps.cn,59,0.00%,59,0,100.00%
nav.smartscreen.microsoft.com,59,0.00%,59,0,100.00%
www.edbiji.com,59,0.00%,59,0,100.00%
array508.prod.do.dsp.mp.microsoft.com,59,0.00%,59,0,100.00%
aeventlog.beacon.qq.com,59,0.00%,59,0,100.00%
www.telecommandsvc.microsoft.com,59,0.00%,59,0,100.00%
jx.cdn.qhstatic.com,59,0.00%,69,10,85.51%
app.chime-in.io,59,0.00%,59,0,100.00%
marketplace-staging.torchlite.com,59,0.00%,59,0,100.00%
judy-tollner.luxuryrealestate.com,59,0.00%,59,0,100.00%
referrals.getambassador.com,59,0.00%,59,0,100.00%
hm.e.shifen.com,58,0.00%,290,232,20.00%
vps02.net.orel.ru,58,0.00%,58,0,100.00%
cdn.download.comodo.com,58,0.00%,141,83,41.13%
pmpcdn1.wmupd.com,58,0.00%,58,0,100.00%
pmpcdn1.wmupd.com.cdn.dnsv1.com,58,0.00%,58,0,100.00%
ssl.google-analytics.com,58,0.00%,67,9,86.57%
ms.bdimg.com,58,0.00%,74,16,78.38%
usage.projectcalico.org,58,0.00%,58,0,100.00%
cloudcontrol.ai.xiaomi.com,58,0.00%,58,0,100.00%
api.ad.xiaomi.com,58,0.00%,58,0,100.00%
blog.davideferrero.com,58,0.00%,58,0,100.00%
admin.dev.kelasbersamakita.id,58,0.00%,58,0,100.00%
mt.lenovo.com.cn,58,0.00%,58,0,100.00%
fourteenprova.altervista.org,58,0.00%,58,0,100.00%
sub.adtchrome.com,58,0.00%,58,0,100.00%
accessibility-spark.herokuapp.com,58,0.00%,58,0,100.00%
kgi.kaspad.net,58,0.00%,58,0,100.00%
plughouseshow.shoobs.com,58,0.00%,58,0,100.00%
ssp-api.banqumusic.com,58,0.00%,58,0,100.00%
dig.feishu.cn,57,0.00%,57,0,100.00%
onedscolprdcus00.centralus.cloudapp.azure.com,57,0.00%,57,0,100.00%
weather2db.cmcm.com,57,0.00%,57,0,100.00%
pcmgrmonitor.3g.qq.com,57,0.00%,57,0,100.00%
i1.hdslb.com,57,0.00%,125,68,45.60%
sadownload-new.mcafee.com.edgekey.net,57,0.00%,57,0,100.00%
torr.ws,57,0.00%,57,0,100.00%
hcfy.app,57,0.00%,105,48,54.29%
lbs.mail.163.com,57,0.00%,57,0,100.00%
batch-rgeo.is.autonavi.com,57,0.00%,57,0,100.00%
opencdnqiniustaticv6.jomodns.com,57,0.00%,116,59,49.14%
configserver.hicloud.com,57,0.00%,57,0,100.00%
inappcheck-cn.itunes-apple.com.akadns.net,57,0.00%,74,17,77.03%
als.baidu.com,57,0.00%,57,0,100.00%
www.baidupcs.com,57,0.00%,57,0,100.00%
cdn-ali-file-shc.shanhutech.cn,57,0.00%,57,0,100.00%
vrzk9nuhhsudshnuvgoxfjx8lthwaqxy.yundunwaf2.com,57,0.00%,57,0,100.00%
dcdnhub.xfs.xcloud.sandai.net,57,0.00%,57,0,100.00%
xmpp006.hpeprint.com,57,0.00%,57,0,100.00%
stat.sd.360.cn,57,0.00%,57,0,100.00%
photo.cctv.com,57,0.00%,137,80,41.61%
stun.freeswitch.org,57,0.00%,57,0,100.00%
rc09-fc01.oray.com,56,0.00%,56,0,100.00%
dl-debug.dropbox.com,56,0.00%,116,60,48.28%
vweixinthumb.tc.qq.com,56,0.00%,122,66,45.90%
qtx4xi8lzc.feishu.cn,56,0.00%,56,0,100.00%
hcdnw.bili.c.cdnhwc2.com,56,0.00%,116,60,48.28%
auth.grammarly.com,56,0.00%,56,0,100.00%
www.youtube.com,56,0.00%,113,57,49.56%
stun.voip.aebc.com,56,0.00%,56,0,100.00%
8a78cx75.gus0.buzz,56,0.00%,56,0,100.00%
gss0.bdstatic.com,55,0.00%,55,0,100.00%
vscode-update-sea.azurewebsites.net,55,0.00%,55,0,100.00%
checkip.synology.com,55,0.00%,55,0,100.00%
onedscolprdcus14.centralus.cloudapp.azure.com,55,0.00%,95,40,57.89%
outlook.office.com,55,0.00%,133,78,41.35%
wmgp-update.wmupd.com,55,0.00%,55,0,100.00%
mmbiz.qpic.cn.sched.legopic1.tdnsv6.com,55,0.00%,55,0,100.00%
su.ff.avast.com,55,0.00%,55,0,100.00%
sconf.f.360.cn,55,0.00%,55,0,100.00%
pcstat.kugou.com,55,0.00%,55,0,100.00%
27.push2his.eastmoney.com,55,0.00%,55,0,100.00%
security.bilibili.com,55,0.00%,59,4,93.22%
edf.eset.com,55,0.00%,55,0,100.00%
ocsp05.actalis.it,55,0.00%,55,0,100.00%
d1dagyb1ctngx1.cloudfront.net,55,0.00%,60,5,91.67%
stun.voipbuster.com,55,0.00%,55,0,100.00%
www.csdn.net,54,0.00%,54,0,100.00%
dl.pinyin.sogou.com,54,0.00%,54,0,100.00%
www.mysmth.net,54,0.00%,54,0,100.00%
sp3.baidu.com,54,0.00%,100,46,54.00%
vscode-update.trafficmanager.net,54,0.00%,54,0,100.00%
dldir1.legao.sched.dcloudstc.com,54,0.00%,54,0,100.00%
matomo.360eol.com,54,0.00%,54,0,100.00%
datacenter-web.eastmoney.com,54,0.00%,122,68,44.26%
k1.gslb.ksyuncdn.com,54,0.00%,102,48,52.94%
smp-device-content.apple.com,54,0.00%,59,5,91.53%
kunyu.csdn.net,54,0.00%,54,0,100.00%
baikebcs.bdimg.com,54,0.00%,63,9,85.71%
path3.xtracloud.net,54,0.00%,54,0,100.00%
swallow.apple.com,54,0.00%,54,0,100.00%
tangram-config.gdt.qq.com,54,0.00%,56,2,96.43%
s1.biz.xunlei.com,54,0.00%,54,0,100.00%
api.growingio.com,54,0.00%,54,0,100.00%
policy.ccs.mcafee.com,54,0.00%,54,0,100.00%
stun.counterpath.com,54,0.00%,54,0,100.00%
audiotainment-sw.streamabc.net,54,0.00%,54,0,100.00%
vortex-win.data.microsoft.com,53,0.00%,69,16,76.81%
init-cdn.itunes-apple.com.akadns.net,53,0.00%,84,31,63.10%
wp.safe.360.cn,53,0.00%,53,0,100.00%
cstaticdun.126.net,53,0.00%,53,0,100.00%
bcstobos.jomodns.com,53,0.00%,78,25,67.95%
path1.xtracloud.net,53,0.00%,53,0,100.00%
emres.eastmoney.com,53,0.00%,121,68,43.80%
usa4.666670.xyz,53,0.00%,53,0,100.00%
www.googletagservices.com,53,0.00%,54,1,98.15%
sslzz.jomodns.com,53,0.00%,53,0,100.00%
onedscolprdcus01.centralus.cloudapp.azure.com,53,0.00%,53,0,100.00%
down1.abckantu.com,53,0.00%,53,0,100.00%
firebaseinstallations.googleapis.com,53,0.00%,59,6,89.83%
whoami.akamai.net,53,0.00%,64,11,82.81%
stun.callwithus.com,53,0.00%,53,0,100.00%
prod.fus.aws.intellij.net,53,0.00%,53,0,100.00%
denis.stalker.upeer.me,53,0.00%,53,0,100.00%
tracker.darmowy-torrent.pl,53,0.00%,53,0,100.00%
gw.alipayobjects.com,53,0.00%,59,6,89.83%
tokyo3.link.ac.cn,53,0.00%,53,0,100.00%
windows.jingyeqian.com,53,0.00%,53,0,100.00%
stat.y.qq.com,52,0.00%,52,0,100.00%
onedscolprdwus04.westus.cloudapp.azure.com,52,0.00%,52,0,100.00%
appct.jianguoyun.com,52,0.00%,52,0,100.00%
settings-prod-uks-1.uksouth.cloudapp.azure.com,52,0.00%,52,0,100.00%
doc.wps.cn,52,0.00%,52,0,100.00%
aegis.qq.com,52,0.00%,183,131,28.42%
k1-ipv6.gslb.ksyuncdn.com,52,0.00%,114,62,45.61%
xpgw-xcdn.youku.com,52,0.00%,52,0,100.00%
mailsucasaccn-my.sharepoint.com,52,0.00%,52,0,100.00%
odc.officeapps.live.com,52,0.00%,52,0,100.00%
www.asdjkljfjaowjfq.net,52,0.00%,52,0,100.00%
a-0001.a-msedge.net,51,0.00%,105,54,48.57%
ocsp-lb.apple.com.akadns.net,51,0.00%,62,11,82.26%
onedscolprdcus03.centralus.cloudapp.azure.com,51,0.00%,89,38,57.30%
himg.bdimg.com,51,0.00%,110,59,46.36%
havfw69955.lithium.com,51,0.00%,112,61,45.54%
login.wpscdn.cn,51,0.00%,51,0,100.00%
armmf.adobe.com,51,0.00%,117,66,43.59%
static.zhihu.com,51,0.00%,122,71,41.80%
www.as.com,51,0.00%,51,0,100.00%
mail.mydomain.com,51,0.00%,51,0,100.00%
zqnweb.v.trpcdn.net,51,0.00%,51,0,100.00%
gspe35-ssl.ls.apple.com.w.alikunlun.com,51,0.00%,51,0,100.00%
inappcheck.itunes.apple.com,51,0.00%,58,7,87.93%
onedscolprdwus00.westus.cloudapp.azure.com,51,0.00%,51,0,100.00%
in.appcenter.ms,51,0.00%,54,3,94.44%
cn-huhehaote.axt.aliyun.com,51,0.00%,51,0,100.00%
stun.voipstunt.com,51,0.00%,51,0,100.00%
api.weixin.qq.com,51,0.00%,51,0,100.00%
t.quic.ws,51,0.00%,51,0,100.00%
mirrors.aliyun.com.w.alikunlun.com,51,0.00%,101,50,50.50%
download.mcafee.com,51,0.00%,51,0,100.00%
cds-temp.apple.com.akadns.net,51,0.00%,51,0,100.00%
repo.mysql.com,51,0.00%,51,0,100.00%
typhoon.nmc.cn,51,0.00%,51,0,100.00%
cloudnet.h3c.com,51,0.00%,51,0,100.00%
onedscolprdwus05.westus.cloudapp.azure.com,50,0.00%,94,44,53.19%
c.tmyzer.com,50,0.00%,50,0,100.00%
outlookmobile-office365-tas.msedge.net,50,0.00%,50,0,100.00%
e673.dsce9.akamaiedge.net,50,0.00%,102,52,49.02%
onedscolprdwus03.westus.cloudapp.azure.com,50,0.00%,50,0,100.00%
cdn2.ime.sogou.com,50,0.00%,50,0,100.00%
mbd.n.shifen.com,50,0.00%,50,0,100.00%
query.hicloud.com,50,0.00%,50,0,100.00%
onedscolprdcus09.centralus.cloudapp.azure.com,50,0.00%,50,0,100.00%
16.tlu.dl.delivery.mp.microsoft.com,50,0.00%,79,29,63.29%
fclick.e.shifen.com,50,0.00%,50,0,100.00%
hiya.browser.360.cn,50,0.00%,50,0,100.00%
api.pdfxd.com,50,0.00%,50,0,100.00%
ux70.v.trpcdn.net,50,0.00%,50,0,100.00%
hcdnv.bili.gslb.c.cdnhwc2.com,50,0.00%,56,6,89.29%
api.fanyi.baidu.com,50,0.00%,50,0,100.00%
sovv.yilanvaas.com,50,0.00%,121,71,41.32%
m701.music.126.net.w.alikunlun.com,50,0.00%,54,4,92.59%
dl.360safe.com,49,0.00%,146,97,33.56%
update.pan.n.shifen.com,49,0.00%,49,0,100.00%
cs.weishi.ijinshan.com,49,0.00%,49,0,100.00%
tracker3.itzmx.com,49,0.00%,49,0,100.00%
token.r53-2.services.mozilla.com,49,0.00%,49,0,100.00%
toblog.ctobsnssdk.com,49,0.00%,49,0,100.00%
kt-prod.ess.apple.com,49,0.00%,49,0,100.00%
www.tnas.online,49,0.00%,49,0,100.00%
pan.wps.cn,49,0.00%,49,0,100.00%
onedscolprdwus09.westus.cloudapp.azure.com,49,0.00%,49,0,100.00%
ftp.hp.com,49,0.00%,49,0,100.00%
zhanzhang.toutiao.com.w.cdngslb.com,49,0.00%,49,0,100.00%
sp.10jqka.com.cn,49,0.00%,49,0,100.00%
down.anticheatexpert.com.cdn.ettdnsv.com,49,0.00%,49,0,100.00%
activity-geo.trafficmanager.net,49,0.00%,49,0,100.00%
apne1-bytedance-cn.sentinelone.net,49,0.00%,49,0,100.00%
dellupdater.dell.com,49,0.00%,49,0,100.00%
onedscolprdcus06.centralus.cloudapp.azure.com,49,0.00%,49,0,100.00%
onedscolprdcus02.centralus.cloudapp.azure.com,49,0.00%,49,0,100.00%
c-msn-com-nsatc.trafficmanager.net,49,0.00%,49,0,100.00%
sfstat.lianmeng.360.cn,49,0.00%,49,0,100.00%
opencdnzhihustatic.jomodns.com,49,0.00%,97,48,50.52%
download.mozilla.org,49,0.00%,49,0,100.00%
umengjmacs.m.taobao.com,49,0.00%,49,0,100.00%
cn.overleaf.com,49,0.00%,49,0,100.00%
cdn.odc.officeapps.live.com,49,0.00%,49,0,100.00%
array809.prod.do.dsp.mp.microsoft.com,48,0.00%,92,44,52.17%
dldir1v6.qq.com,48,0.00%,108,60,44.44%
s.bbm0v.cn,48,0.00%,48,0,100.00%
cs-geo-dds.trafficmanager.net,48,0.00%,48,0,100.00%
gaode-jmacs.m.taobao.com,48,0.00%,48,0,100.00%
boss.hdslb.com,48,0.00%,68,20,70.59%
sslbaidu.jomodns.com,48,0.00%,86,38,55.81%
settings-prod-wus3-1.westus3.cloudapp.azure.com,48,0.00%,48,0,100.00%
zmptxy.v.trpcdn.net,48,0.00%,48,0,100.00%
ios.now163.com,48,0.00%,48,0,100.00%
1.cn.pool.ntp.org,48,0.00%,48,0,100.00%
s12.upd.kaspersky.com,48,0.00%,48,0,100.00%
office15client.microsoft.com,48,0.00%,48,0,100.00%
www.mcafee.com,48,0.00%,48,0,100.00%
onedsblobprdwus17.westus.cloudapp.azure.com,48,0.00%,48,0,100.00%
httpdns.n.netease.com,48,0.00%,48,0,100.00%
aqv.hicloud.com,48,0.00%,48,0,100.00%
onedscolprdeus08.eastus.cloudapp.azure.com,47,0.00%,93,46,50.54%
odrs.gnome.org,47,0.00%,88,41,53.41%
newvip.duba.net,47,0.00%,47,0,100.00%
caldav.fe.apple-dns.cn,47,0.00%,47,0,100.00%
e12919.dscd.akamaiedge.net,47,0.00%,95,48,49.47%
onedscolprdeus00.eastus.cloudapp.azure.com,47,0.00%,47,0,100.00%
report.idqqimg.com,47,0.00%,47,0,100.00%
nstool.netease.com,47,0.00%,88,41,53.41%
l5-global.gslb.ksyuncdn.com,47,0.00%,47,0,100.00%
migration-geo-filter-prd.stargate.cse.ss-inf.net,47,0.00%,47,0,100.00%
prod.ingestion-edge.prod.dataops.mozgcp.NET,47,0.00%,47,0,100.00%
nex.163.com,47,0.00%,47,0,100.00%
csdn.log-global.aliyuncs.com.w.cdngslb.com,47,0.00%,95,48,49.47%
m8.music.126.net,47,0.00%,59,12,79.66%
cmmsns.qpic.cn,47,0.00%,111,64,42.34%
show-3.mediav.com,47,0.00%,47,0,100.00%
api.kz.naruto.red,47,0.00%,47,0,100.00%
open.acgtracker.com,47,0.00%,47,0,100.00%
www.annualcreditreport.com,47,0.00%,47,0,100.00%
www.xboxab.com,47,0.00%,47,0,100.00%
blobcollector.events.data.trafficmanager.net,47,0.00%,52,5,90.38%
dpi.networkorder.komect.com,47,0.00%,47,0,100.00%
sp4.tf.360.cn,47,0.00%,47,0,100.00%
iduxzj9.qiniudns.com,46,0.00%,103,57,44.66%
pub.idqqimg.com.sched.legopic1.tdnsv6.com,46,0.00%,46,0,100.00%
down1.xinshuru.com,46,0.00%,46,0,100.00%
passport.bilibili.com,46,0.00%,51,5,90.20%
image6.pubmatic.com,46,0.00%,46,0,100.00%
collect.kugou.com,46,0.00%,82,36,56.10%
wallpaper-redirect-api.cqttech.com,46,0.00%,46,0,100.00%
tracker.kali.org,46,0.00%,46,0,100.00%
client05.pdl.wow.battlenet.com.cn,46,0.00%,46,0,100.00%
update.haozip.2345.com,46,0.00%,46,0,100.00%
mon.snssdk.com,46,0.00%,46,0,100.00%
update.minipage.2345.cc,46,0.00%,46,0,100.00%
home.yxgz.vip,46,0.00%,46,0,100.00%
a5ad128f94f1fd400.awsglobalaccelerator.com,46,0.00%,46,0,100.00%
smart.sug.so.com,46,0.00%,46,0,100.00%
author.baidu.com,46,0.00%,46,0,100.00%
docs.gtimg.com,45,0.00%,101,56,44.55%
wx3.sinaimg.cn,45,0.00%,288,243,15.62%
wd-prod-ss-as-southeast-2-fe.southeastasia.cloudapp.azure.com,45,0.00%,45,0,100.00%
stocks-sparkline.apple.com,45,0.00%,87,42,51.72%
gfs-op.douyucdn.cn,45,0.00%,74,29,60.81%
globalsign.com.w.kunlunar.com,45,0.00%,45,0,100.00%
plugins.jetbrains.com,45,0.00%,45,0,100.00%
ftp.ext.hp.com,45,0.00%,45,0,100.00%
cdn.wwads.cn,45,0.00%,45,0,100.00%
infoc0.duba.net,45,0.00%,45,0,100.00%
xlinfopush.rcv.sandai.net,45,0.00%,45,0,100.00%
updates.cdn-apple.com,45,0.00%,45,0,100.00%
dl.kkdownload.com,45,0.00%,45,0,100.00%
tcloud.tim.qq.com,45,0.00%,45,0,100.00%
g37.update.netease.com,45,0.00%,45,0,100.00%
nodestore-kiros-prod-lb-132549143.us-east-1.elb.amazonaws.com,45,0.00%,45,0,100.00%
www-googletagmanager.l.google.com,45,0.00%,60,15,75.00%
www.doc88.com,45,0.00%,45,0,100.00%
bnz07pap001.storage.live.com,45,0.00%,68,23,66.18%
nav-edge.smartscreen.microsoft.com,45,0.00%,45,0,100.00%
cn.hzcm.1aba.cn,45,0.00%,45,0,100.00%
www.h3c.com.cn,45,0.00%,45,0,100.00%
gtm-cn-zvp2o6fq301.gtm-a4b1.com,45,0.00%,45,0,100.00%
wd-prod-ss-as-southeast-1-fe.southeastasia.cloudapp.azure.com,44,0.00%,44,0,100.00%
cpro.baidustatic.com,44,0.00%,134,90,32.84%
static.mysmth.net,44,0.00%,78,34,56.41%
contacts.fe.apple-dns.cn,44,0.00%,44,0,100.00%
onedscolprdcus10.centralus.cloudapp.azure.com,44,0.00%,44,0,100.00%
h-adashx-internal.ut.taobao.com.gds.alibabadns.com,44,0.00%,44,0,100.00%
wd-prod-ss-as-southeast-4-fe.southeastasia.cloudapp.azure.com,44,0.00%,44,0,100.00%
ins-5i86z7w2.ias.tencent-cloud.net,44,0.00%,44,0,100.00%
webrtcice.video.qq.com,44,0.00%,44,0,100.00%
www.yuque.com,44,0.00%,44,0,100.00%
onedscolprdwus12.westus.cloudapp.azure.com,44,0.00%,79,35,55.70%
ipv6-static.dns.iqiyi.com,44,0.00%,91,47,48.35%
prod.fs.microsoft.com.akadns.NET,44,0.00%,44,0,100.00%
edge.activity.windows.com,44,0.00%,44,0,100.00%
frp.zengwu.com.cn,44,0.00%,44,0,100.00%
onedsblobprdeus16.eastus.cloudapp.azure.com,44,0.00%,88,44,50.00%
bnz05pap001.storage.live.com,44,0.00%,74,30,59.46%
pkgautoupdate7.synology.cn,44,0.00%,44,0,100.00%
www.tm.a.prd.aadg.akadns.NET,44,0.00%,44,0,100.00%
www.comet-ml.com,44,0.00%,44,0,100.00%
hq.sinajs.cn,43,0.00%,43,0,100.00%
gorgon.youdao.com,43,0.00%,43,0,100.00%
log.ys7.com,43,0.00%,43,0,100.00%
qt010.china.line.qiniudns.com,43,0.00%,97,54,44.33%
mcs.zijieapi.com,43,0.00%,91,48,47.25%
docs.live.net,43,0.00%,66,23,65.15%
0.debian.pool.ntp.org,43,0.00%,43,0,100.00%
onedscolprdcus04.centralus.cloudapp.azure.com,43,0.00%,43,0,100.00%
onedscolprdwus11.westus.cloudapp.azure.com,43,0.00%,74,31,58.11%
weibo.cn,43,0.00%,90,47,47.78%
btrace.video.qq.com,43,0.00%,43,0,100.00%
adsmind.ugdtimg.com,43,0.00%,102,59,42.16%
array502.prod.do.dsp.mp.microsoft.com,43,0.00%,43,0,100.00%
compiles.overleaf.com,43,0.00%,43,0,100.00%
onedscolprdaus00.australiasoutheast.cloudapp.azure.com,43,0.00%,43,0,100.00%
onedscolprdwus01.westus.cloudapp.azure.com,43,0.00%,80,37,53.75%
team-speed-cdn-vip.xunlei.com,43,0.00%,43,0,100.00%
s1.cn.bing.net,43,0.00%,43,0,100.00%
cloud.acrobat.com,43,0.00%,43,0,100.00%
yd.9669.me,43,0.00%,43,0,100.00%
int.dpool.sina.com.cn,43,0.00%,43,0,100.00%
www.toutiao.com,43,0.00%,89,46,48.31%
cn.patch.battle.net,42,0.00%,42,0,100.00%
ns-sb2-prod-sn3-010.cloudapp.net,42,0.00%,42,0,100.00%
waws-prod-sg1-057.sip.azurewebsites.windows.net,42,0.00%,42,0,100.00%
onedscolprdeus03.eastus.cloudapp.azure.com,42,0.00%,79,37,53.16%
apic.douyucdn.cn,42,0.00%,58,16,72.41%
sugar.zhihu.com,42,0.00%,102,60,41.18%
e7479.g.akamaiedge.net,42,0.00%,42,0,100.00%
sbeacon.sina.com.cn,42,0.00%,42,0,100.00%
linux-updatepro.wps.cn,42,0.00%,42,0,100.00%
x2.c.lencr.org,42,0.00%,90,48,46.67%
i0.hdslb.com.w.kunlunno.com,42,0.00%,87,45,48.28%
tracker.ai.xiaomi.com,42,0.00%,42,0,100.00%
s00.upd.kaspersky.com,42,0.00%,42,0,100.00%
tracker3.dler.org,42,0.00%,42,0,100.00%
store-drcn.hispace.dbankcloud.cn,42,0.00%,42,0,100.00%
edf.gtm.eset.com,42,0.00%,42,0,100.00%
p.ssl.img.360kuai.com,42,0.00%,48,6,87.50%
onedscolprdaus02.australiasoutheast.cloudapp.azure.com,42,0.00%,42,0,100.00%
grs.dbankcloud.com,42,0.00%,42,0,100.00%
oth.str.beacon.qq.com,42,0.00%,42,0,100.00%
query.rec.360.cn,42,0.00%,42,0,100.00%
dl1.gj.qq.com,42,0.00%,62,20,67.74%
bam.nr-data.net.cdn.cloudflare.net,42,0.00%,42,0,100.00%
bn1305.storage.live.com,41,0.00%,73,32,56.16%
prod.roaming1.live.com.akadns.net,41,0.00%,41,0,100.00%
shortv.cdp.qq.com,41,0.00%,47,6,87.23%
appcdcbjpip2.jianguoyun.com,41,0.00%,41,0,100.00%
onedscolprdeus11.eastus.cloudapp.azure.com,41,0.00%,41,0,100.00%
array512.prod.do.dsp.mp.microsoft.com,41,0.00%,41,0,100.00%
dataflow.biliapi.com,41,0.00%,76,35,53.95%
fd.api.iris.microsoft.com,41,0.00%,41,0,100.00%
stdl.qq.com,41,0.00%,41,0,100.00%
kae.wpsdns.com,41,0.00%,41,0,100.00%
hwvv.yilanvaas.com,41,0.00%,84,43,48.81%
app-measurement.com,41,0.00%,135,94,30.37%
addons-pa.clients6.google.com,41,0.00%,66,25,62.12%
api.wondercv.com,41,0.00%,41,0,100.00%
crl.pki.goog,41,0.00%,41,0,100.00%
iris-de-prod-azsc-eas.eastasia.cloudapp.azure.com,41,0.00%,41,0,100.00%
internal-api-space.feishu.cn,41,0.00%,41,0,100.00%
al.p2p.huya.com,41,0.00%,92,51,44.57%
yt.droid.ac.cn,41,0.00%,41,0,100.00%
gsas.apple.com,40,0.00%,40,0,100.00%
ic3.events.data.microsoft.com,40,0.00%,49,9,81.63%
g.alicdn.com,40,0.00%,83,43,48.19%
ws-keyboard.shouji.sogou.com,40,0.00%,40,0,100.00%
tracker3.torrentino.com,40,0.00%,40,0,100.00%
onedscolprdwus10.westus.cloudapp.azure.com,40,0.00%,72,32,55.56%
h-adashx.dingtalkapps.com,40,0.00%,40,0,100.00%
softm.update.360safe.com,40,0.00%,40,0,100.00%
geo-applefinance-cache.internal.query.g03.yahoodns.net,40,0.00%,40,0,100.00%
ynote-statistic.lx.netease.com,40,0.00%,40,0,100.00%
google.cn,40,0.00%,83,43,48.19%
repper-lb-tokyo.gtinative.cloudplatform.mcafee.com,40,0.00%,40,0,100.00%
shuc-pc-snow.ksord.com,40,0.00%,40,0,100.00%
ah.yd01.paopaocloud.cyou,40,0.00%,40,0,100.00%
apigtwb2c.us.dell.com,40,0.00%,40,0,100.00%
www.sourceinsight.com,40,0.00%,40,0,100.00%
elb-telemetry-prod-external-1332413525.us-west-2.elb.amazonaws.com,40,0.00%,40,0,100.00%
pconf.f.360.cn,40,0.00%,40,0,100.00%
jp_62.antchatxj.com,40,0.00%,40,0,100.00%
phx02pap001.storage.live.com,40,0.00%,65,25,61.54%
tmfsdk4.m.qq.com,40,0.00%,40,0,100.00%
cm.g.doubleclick.net,40,0.00%,40,0,100.00%
pinyin.thunisoft.com,40,0.00%,40,0,100.00%
mailsucasaccn.sharepoint.com,40,0.00%,40,0,100.00%
hao.ssl.dhrest.com,40,0.00%,43,3,93.02%
ipv4.neubt.com,40,0.00%,40,0,100.00%
flux.iqiyi.com,40,0.00%,40,0,100.00%
myip.ipip.net,40,0.00%,43,3,93.02%
arms-retcode.aliyuncs.com,40,0.00%,40,0,100.00%
xtremex.herokuapp.com,40,0.00%,40,0,100.00%
capi.grammarly.com,40,0.00%,40,0,100.00%
pcoma.qq.com,40,0.00%,40,0,100.00%
slardar-bd.feishu.cn,40,0.00%,40,0,100.00%
tracker.jordan.im,40,0.00%,40,0,100.00%
dbe610da.feishu.cn.dsa.dnsv1.com,40,0.00%,40,0,100.00%
onedscolprdcus12.centralus.cloudapp.azure.com,39,0.00%,70,31,55.71%
onedscolprdeus12.eastus.cloudapp.azure.com,39,0.00%,39,0,100.00%
genuine.adobe.com,39,0.00%,75,36,52.00%
www.beian.gov.cn,39,0.00%,39,0,100.00%
c.dun.163.com,39,0.00%,39,0,100.00%
ocsp.globalsign.com,39,0.00%,43,4,90.70%
array610.prod.do.dsp.mp.microsoft.com,39,0.00%,39,0,100.00%
xycrx.net,39,0.00%,39,0,100.00%
emimpcpf.trafficmanager.cn,39,0.00%,39,0,100.00%
m.weibo.cn,39,0.00%,72,33,54.17%
nfs.iscas.ac.cn,39,0.00%,39,0,100.00%
6qnz2sy8.sched.d2.tdnsdp1.cn.cjt.vwnti.yrzhcloud.cn,39,0.00%,39,0,100.00%
klbv2.wpsdns.com,39,0.00%,39,0,100.00%
downloadapi.n.shifen.com,39,0.00%,39,0,100.00%
aefd.nelreports.net,39,0.00%,89,50,43.82%
onedscolprdeus06.eastus.cloudapp.azure.com,39,0.00%,39,0,100.00%
gdmf.apple.com,39,0.00%,39,0,100.00%
s2.symcb.com,39,0.00%,83,44,46.99%
www.zybuluo.com,39,0.00%,39,0,100.00%
atm-fp-direct.office.com,39,0.00%,80,41,48.75%
browser.360.cn.download.ks-cdn.com,39,0.00%,74,35,52.70%
s02.upd.kaspersky.com,39,0.00%,39,0,100.00%
lbdata.tj.ijinshan.com,39,0.00%,39,0,100.00%
scholar.google.com,39,0.00%,39,0,100.00%
stats.l.doubleclick.net,39,0.00%,43,4,90.70%
r2---sn-2x3elnee.gvt1.com,39,0.00%,39,0,100.00%
cds-cdn.v.aaplimg.com,39,0.00%,39,0,100.00%
gateway.kugou.com,39,0.00%,48,9,81.25%
tracker2.torrentino.com,39,0.00%,39,0,100.00%
ins-8y4ghcjp.ias.tencent-cloud.net,38,0.00%,38,0,100.00%
wx2.sinaimg.cn,38,0.00%,268,230,14.18%
gfwsl.geforce.com,38,0.00%,38,0,100.00%
spinfo.wps.cn,38,0.00%,38,0,100.00%
3wabxy9b.sched.sma.tdnsstic1.cn,38,0.00%,38,0,100.00%
telemetry.dropbox.com,38,0.00%,77,39,49.35%
restlbs.map.qq.com,38,0.00%,38,0,100.00%
onedscolprdcus08.centralus.cloudapp.azure.com,38,0.00%,38,0,100.00%
browser-api.2345.cc,38,0.00%,38,0,100.00%
1.debian.pool.ntp.org,38,0.00%,38,0,100.00%
client.docer.wps.cn,38,0.00%,38,0,100.00%
interface.bilibili.com,38,0.00%,46,8,82.61%
report.im.qcloud.com,38,0.00%,38,0,100.00%
vi.xiaohongshu.com,38,0.00%,38,0,100.00%
update-windows.grammarly.com,38,0.00%,38,0,100.00%
api-accounts.firefox.com.cn,38,0.00%,38,0,100.00%
delegation.a.shifen.com,38,0.00%,38,0,100.00%
cdn.ap.bittorrent.com,38,0.00%,61,23,62.30%
feed.wan.360.cn,38,0.00%,38,0,100.00%
configuration.apple.com.akadns.net,38,0.00%,60,22,63.33%
play.itunes.apple.com,38,0.00%,71,33,53.52%
e8203.g.akamaiedge.net,38,0.00%,38,0,100.00%
id.rlcdn.com,38,0.00%,38,0,100.00%
auth.hiwifi.com,38,0.00%,38,0,100.00%
configsvr.msf.3g.qq.com,38,0.00%,38,0,100.00%
valid.origin-apple.com.akadns.net,38,0.00%,38,0,100.00%
bal-edf-pcs-trafmng-failover.trafficmanager.net,38,0.00%,38,0,100.00%
dhupdateprod.blob.core.windows.net,38,0.00%,38,0,100.00%
statics.teams.cdn.office.net,38,0.00%,39,1,97.44%
tbmsg.baidu.com,38,0.00%,38,0,100.00%
aapl-edge0.qtlcdn.com,38,0.00%,38,0,100.00%
common.cnblogs.com,38,0.00%,38,0,100.00%
asimov.vortex.data.trafficmanager.NET,38,0.00%,38,0,100.00%
s1b.time.edu.cn,38,0.00%,38,0,100.00%
hao5.qhimg.com,38,0.00%,43,5,88.37%
pcw-api.iqiyi.com,38,0.00%,79,41,48.10%
animalmobile.happyelements.cn,38,0.00%,72,34,52.78%
ss0.bdstatic.com,38,0.00%,38,0,100.00%
apigate.10jqka.com.cn,38,0.00%,38,0,100.00%
passport.jd.com,37,0.00%,37,0,100.00%
24-courier.push.apple.com,37,0.00%,37,0,100.00%
dldir1.qq.com.tcdn.qq.com,37,0.00%,37,0,100.00%
anv.duba.net,37,0.00%,37,0,100.00%
ac-dun.security.ntes53.netease.com,37,0.00%,76,39,48.68%
k5-toutiao-ml.gslb.ksyuncdn.com,37,0.00%,37,0,100.00%
assets.msn.cn-c.edgekey.net.globalredir.akadns.net,37,0.00%,37,0,100.00%
k128-inapp.gslb.ksyuncdn.com,37,0.00%,67,30,55.22%
be01mr9s.sched.d2.tdnsdp1.cn.cjt.vwnti.yrzhcloud.cn,37,0.00%,37,0,100.00%
static.hdslb.com,37,0.00%,37,0,100.00%
mesu-cdn.apple.com.akadns.net,37,0.00%,76,39,48.68%
inappcheck.itunes.apple.com.w.alikunlun.com,37,0.00%,37,0,100.00%
me.apple-dns.net,37,0.00%,82,45,45.12%
api.accounts.firefox.com,37,0.00%,37,0,100.00%
pc001.download.wh.cmcm.com,37,0.00%,37,0,100.00%
licensing-prod-frontdoor-geomap.trafficmanager.net,37,0.00%,37,0,100.00%
onedscolprdcus05.centralus.cloudapp.azure.com,37,0.00%,68,31,54.41%
logservice1.hicloud.com,37,0.00%,37,0,100.00%
vs.biz.weibo.com,37,0.00%,37,0,100.00%
d19h5bl8fn71bo.cloudfront.net,37,0.00%,41,4,90.24%
proxy.sogou.com,37,0.00%,37,0,100.00%
pic1.zhimg.com.w.alikunlun.com,37,0.00%,51,14,72.55%
bj.linyeming.pub,37,0.00%,37,0,100.00%
aphone.v1.mgtv.com,37,0.00%,37,0,100.00%
httpsdns.baidu.com,37,0.00%,37,0,100.00%
balrog-aus5.r53-2.services.mozilla.com,37,0.00%,37,0,100.00%
b-0008.b-msedge.net,36,0.00%,60,24,60.00%
kstj.baidu.com,36,0.00%,36,0,100.00%
wx1.sinaimg.cn,36,0.00%,267,231,13.48%
wx4.sinaimg.cn,36,0.00%,276,240,13.04%
misc.360buyimg.com,36,0.00%,36,0,100.00%
static.360buyimg.com,36,0.00%,36,0,100.00%
tracker.zemoj.com,36,0.00%,36,0,100.00%
dldir1.qq.com.mid.dcloudstc.com,36,0.00%,36,0,100.00%
3.debian.pool.ntp.org,36,0.00%,36,0,100.00%
onedscolprdeus04.eastus.cloudapp.azure.com,36,0.00%,36,0,100.00%
2v21nxa7.sched.sma-dk.tdnsstic1.cn,36,0.00%,72,36,50.00%
lib.iscas.ac.cn,36,0.00%,36,0,100.00%
sn.webrootcloudav.com,36,0.00%,36,0,100.00%
cb.e.shifen.com,36,0.00%,36,0,100.00%
srtb.msn.com,36,0.00%,61,25,59.02%
bkvv.video.qq.com,36,0.00%,36,0,100.00%
ocsp2.globalsign.com,36,0.00%,42,6,85.71%
account-public-service-prod.ak.epicgames.com,36,0.00%,77,41,46.75%
submit.acsac.org,36,0.00%,36,0,100.00%
api.steampowered.com,36,0.00%,36,0,100.00%
consumer-licensing-aks2aks.md.mp.microsoft.com.akadns.net,36,0.00%,36,0,100.00%
analytics.ff.avast.com,36,0.00%,36,0,100.00%
tracker.nighthawk.pw,36,0.00%,64,28,56.25%
t.minipage.2345.cc,36,0.00%,36,0,100.00%
cds.apple.com,36,0.00%,36,0,100.00%
s3.amazonaws.com,36,0.00%,36,0,100.00%
bd.3.be.mapow.link,36,0.00%,36,0,100.00%
p3.qhimgs0.com,36,0.00%,43,7,83.72%
fengling.7654.com,36,0.00%,36,0,100.00%
ios.rqd.qq.com,35,0.00%,63,28,55.56%
x8.x9.client.api.vpngate2.jp,35,0.00%,57,22,61.40%
dnkeeper.platform.dbankcloud.cn,35,0.00%,35,0,100.00%
skin.se.360.cn,35,0.00%,35,0,100.00%
ecs.office.com,35,0.00%,1356,1321,2.58%
nyaa.tracker.wf,35,0.00%,35,0,100.00%
s3.nzbdw.com,35,0.00%,35,0,100.00%
qiniustaticopencdn.jomodns.com,35,0.00%,35,0,100.00%
chihaya-heroku.120181311.xyz,35,0.00%,60,25,58.33%
zhuanlan.zhihu.com,35,0.00%,74,39,47.30%
p13n.adobe.io,35,0.00%,35,0,100.00%
tracker1.bt.moack.co.kr,35,0.00%,35,0,100.00%
drive.google.com,35,0.00%,70,35,50.00%
ts-helper.2345.cc,35,0.00%,35,0,100.00%
cdn.ark.qq.com,35,0.00%,44,9,79.55%
ali-pc-x-speed-auth-vip.xunlei.com,35,0.00%,35,0,100.00%
beacons4.gvt2.com,35,0.00%,66,31,53.03%
ied-tqos-tgp.qq.com,35,0.00%,35,0,100.00%
onedsblobprdcus16.centralus.cloudapp.azure.com,35,0.00%,35,0,100.00%
ts.minipage.2345.cc,35,0.00%,35,0,100.00%
ex01.ios.ac.cn,35,0.00%,35,0,100.00%
sigma-performance-g37.proxima.nie.netease.com,35,0.00%,35,0,100.00%
api.zhihu.com,35,0.00%,72,37,48.61%
app.grammarly.com,35,0.00%,35,0,100.00%
imap.mail.me.com,35,0.00%,35,0,100.00%
agd.p.360.cn,35,0.00%,35,0,100.00%
200-service-tang-1544055741.us-east-1.elb.amazonaws.com,34,0.00%,34,0,100.00%
at.alicdn.com,34,0.00%,76,42,44.74%
tracker.torrenty.org,34,0.00%,34,0,100.00%
asia.roaming1.live.com.akadns.net,34,0.00%,34,0,100.00%
gfwsl.geforce.cn,34,0.00%,34,0,100.00%
logintcp.wps.cn,34,0.00%,34,0,100.00%
s.deepl.com,34,0.00%,34,0,100.00%
caldav.126.com,34,0.00%,34,0,100.00%
stocks-sparkline-lb.apple.com.akadns.net,34,0.00%,63,29,53.97%
htydhd.wmupd.com.w.kunluncan.com,34,0.00%,34,0,100.00%
1.openwrt.pool.ntp.org,34,0.00%,34,0,100.00%
na61-na62.wagbridge.alibaba.aliyun.com,34,0.00%,34,0,100.00%
spatialsearch.is.autonavi.com.gds.alibabadns.com,34,0.00%,34,0,100.00%
launches.appsflyer.com,34,0.00%,34,0,100.00%
weather.ubuntukylin.com,34,0.00%,34,0,100.00%
iplc-ji.cmy-dns.com,34,0.00%,34,0,100.00%
grafana.net,34,0.00%,34,0,100.00%
33-courier.push.apple.com,34,0.00%,34,0,100.00%
sp3.sangfor.com.cn,34,0.00%,34,0,100.00%
retracker.sevstar.net,34,0.00%,34,0,100.00%
ds.download.windowsupdate.com,34,0.00%,35,1,97.14%
14-courier.push.apple.com,34,0.00%,34,0,100.00%
livenet.video.iqiyi.com,34,0.00%,34,0,100.00%
a16638c16aa17238.natapp.cc,34,0.00%,34,0,100.00%
duba-config-cdn.duba.net,34,0.00%,34,0,100.00%
idx.m.hub.sandai.net,34,0.00%,34,0,100.00%
submit.iacr.org,34,0.00%,34,0,100.00%
i1.c.eset.com,34,0.00%,34,0,100.00%
bk.info.zb.qq.com,34,0.00%,34,0,100.00%
auth.split.io,34,0.00%,34,0,100.00%
14.au.download.windowsupdate.com,34,0.00%,34,0,100.00%
upspinarakor.com,34,0.00%,34,0,100.00%
f-log-editor.grammarly.io,34,0.00%,34,0,100.00%
hub.fastgit.org,34,0.00%,38,4,89.47%
biglmdiag.blob.core.windows.net,34,0.00%,34,0,100.00%
www.kebuena.com.mx,34,0.00%,34,0,100.00%
ssum-sec.casalemedia.com.cdn.cloudflare.net,34,0.00%,34,0,100.00%
ssp.ads.betweendigital.com,33,0.00%,33,0,100.00%
shadowshq.yi.org,33,0.00%,33,0,100.00%
glb-db52c2cf8be544.github.com,33,0.00%,33,0,100.00%
zip.update.360safe.com,33,0.00%,33,0,100.00%
lf-cdn-tos.bytescm.com,33,0.00%,39,6,84.62%
static.googleadsserving.cn,33,0.00%,39,6,84.62%
pgpstatic.games.wanmei.com.cdn.dnsv1.com,33,0.00%,68,35,48.53%
dss3.bdstatic.com,33,0.00%,33,0,100.00%
minor-api.mihoyo.com,33,0.00%,33,0,100.00%
api.lsplayer.com,33,0.00%,33,0,100.00%
down.qq.com,33,0.00%,33,0,100.00%
papi.look.360.cn,33,0.00%,33,0,100.00%
d3ra9679oeq3gx.cloudfront.net,33,0.00%,33,0,100.00%
track.plop.pm,33,0.00%,33,0,100.00%
www.gstatic.cn,33,0.00%,33,0,100.00%
wapi.kuwo.cn,33,0.00%,33,0,100.00%
dsm01pap005.storage.live.com,33,0.00%,59,26,55.93%
v19.stream.tencentmusic.com,33,0.00%,33,0,100.00%
bjacshow.kugou.com,33,0.00%,113,80,29.20%
chennuo.xyz,33,0.00%,33,0,100.00%
nsp-logservice-hiview-p40-drcn.obs.cn-north-2.myhuaweicloud.com,33,0.00%,33,0,100.00%
cloud.gti.mcafee.com,33,0.00%,33,0,100.00%
fanyi.qq.com,33,0.00%,33,0,100.00%
info.zb.qq.com,33,0.00%,33,0,100.00%
metrics.icloud.com,33,0.00%,66,33,50.00%
logintcpnv.wps.cn,33,0.00%,33,0,100.00%
3.openwrt.pool.ntp.org,33,0.00%,33,0,100.00%
onedscolprdwus13.westus.cloudapp.azure.com,33,0.00%,33,0,100.00%
50-courier.push.apple.com,33,0.00%,33,0,100.00%
lcdn-locator.apple.com,33,0.00%,33,0,100.00%
tracker.skyts.cn,33,0.00%,33,0,100.00%
dl.maxthon.cn,33,0.00%,33,0,100.00%
emdl.ws.microsoft.com,33,0.00%,33,0,100.00%
ims-prod06.adobelogin.com,33,0.00%,33,0,100.00%
imgx.mediav.com,33,0.00%,39,6,84.62%
tracker.dler.org,33,0.00%,33,0,100.00%
www.1k3j1blg.com,33,0.00%,33,0,100.00%
update.browser.qq.com,33,0.00%,33,0,100.00%
amcore.rest.gti.mcafee.com,33,0.00%,33,0,100.00%
logs-01.loggly.com,33,0.00%,33,0,100.00%
tracker2.wasabii.com.tw,33,0.00%,33,0,100.00%
prebid-us.creativecdn.com,32,0.00%,32,0,100.00%
ocsp-cn-lb.apple.com.akadns.net,32,0.00%,39,7,82.05%
31-courier.push.apple.com,32,0.00%,32,0,100.00%
c.gj.qq.com,32,0.00%,32,0,100.00%
e15203.dscb.akamaiedge.net,32,0.00%,64,32,50.00%
dc1-pp.ksn.kaspersky-labs.com,32,0.00%,32,0,100.00%
crl.thawte.com,32,0.00%,59,27,54.24%
adashx.ut.amap.com,32,0.00%,32,0,100.00%
setup.fe.apple-dns.net,32,0.00%,66,34,48.48%
cdn.icloud-content.com,32,0.00%,62,30,51.61%
desktop.docker.com,32,0.00%,63,31,50.79%
sz-qiniu-all.volcgtm.com,32,0.00%,66,34,48.48%
suggestion.baidu.com,32,0.00%,60,28,53.33%
data.pendo.io,32,0.00%,35,3,91.43%
partnerad.l.doubleclick.net,32,0.00%,32,0,100.00%
pgpstatic.games.wanmei.com,32,0.00%,69,37,46.38%
fe2.update.msft.com.trafficmanager.net,32,0.00%,70,38,45.71%
wwads.cn,32,0.00%,32,0,100.00%
clientnotification-userprodea1-2.servicebus.windows.net,32,0.00%,32,0,100.00%
accountv2.wpsdns.com,32,0.00%,32,0,100.00%
quota.fe.apple-dns.cn,32,0.00%,32,0,100.00%
yp.ws.126.net,32,0.00%,32,0,100.00%
baidu-cn-north-00001.bj-a.bcebos.com,32,0.00%,32,0,100.00%
us-u.openx.net,32,0.00%,32,0,100.00%
adashx.ut.youku.com,32,0.00%,32,0,100.00%
retracker.akado-ural.ru,32,0.00%,32,0,100.00%
us2221.tomnode.com,32,0.00%,32,0,100.00%
i.hhrspb7.top,32,0.00%,32,0,100.00%
hub5u.wap.sandai.net,32,0.00%,32,0,100.00%
hub5pn.wap.sandai.net,32,0.00%,32,0,100.00%
onedscolprdweu04.westeurope.cloudapp.azure.com,32,0.00%,32,0,100.00%
gsa.apple.com,32,0.00%,32,0,100.00%
torrent-team.net,32,0.00%,59,27,54.24%
cdn.yinxiang.com,32,0.00%,32,0,100.00%
sh-download.weiyun.com,32,0.00%,77,45,41.56%
down-30005.sz.gfp.tencent-cloud.com,32,0.00%,79,47,40.51%
verify.snssdk.com,32,0.00%,32,0,100.00%
connectivitycheck.platform.hihonorcloud.com,32,0.00%,32,0,100.00%
sb-ssl.google.com,32,0.00%,32,0,100.00%
AMER02.azure-devices.net,32,0.00%,32,0,100.00%
0.openwrt.pool.ntp.org,32,0.00%,32,0,100.00%
i.baidu.com,32,0.00%,32,0,100.00%
outfit-v2-exports-production.s3-accelerate.amazonaws.com,32,0.00%,32,0,100.00%
m7.music.126.net,32,0.00%,43,11,74.42%
reports.baidu.com,31,0.00%,31,0,100.00%
bdimg.share.baidu.com,31,0.00%,31,0,100.00%
gbfek.eastmoney.com,31,0.00%,71,40,43.66%
pull-f5-vs.flive.douyincdn.com,31,0.00%,31,0,100.00%
onedscolprduks05.uksouth.cloudapp.azure.com,31,0.00%,31,0,100.00%
windows.policies.live.net,31,0.00%,31,0,100.00%
github.githubassets.com,31,0.00%,31,0,100.00%
g-msn-com-nsatc.trafficmanager.net,31,0.00%,60,29,51.67%
www.apple.com.edgekey.net,31,0.00%,31,0,100.00%
a-0032.a-msedge.net,31,0.00%,61,30,50.82%
tracker.publicbt.com,31,0.00%,31,0,100.00%
app.wpscdn.cn,31,0.00%,68,37,45.59%
sp2.sangfor.com.cn,31,0.00%,31,0,100.00%
o1013tn36u32026o.aliyunddos1010.com,31,0.00%,31,0,100.00%
s03.upd.kaspersky.com,31,0.00%,31,0,100.00%
sb.firefox.com.cn,31,0.00%,65,34,47.69%
cs02-pps-drcn.dbankcdn.com,31,0.00%,31,0,100.00%
dsum-sec.casalemedia.com,31,0.00%,31,0,100.00%
s1.hdslb.com.w.kunlunar.com,31,0.00%,31,0,100.00%
api-takumi.mihoyo.com,31,0.00%,31,0,100.00%
announce.partis.si,31,0.00%,59,28,52.54%
bt.3dmgame.com,31,0.00%,31,0,100.00%
kunpeng-sc.csdnimg.cn,31,0.00%,31,0,100.00%
tracker.mywaifu.best,31,0.00%,31,0,100.00%
15min.pcfg.cache.wpscdn.cn,31,0.00%,31,0,100.00%
j1hqc7ee.sched.d0-dk.tdnsdp1.cn,31,0.00%,65,34,47.69%
ip2072148258.funshion.com,31,0.00%,31,0,100.00%
cube.3600.com,31,0.00%,36,5,86.11%
cjhd.mediav.com,31,0.00%,35,4,88.57%
static-res.qq.com,31,0.00%,35,4,88.57%
s.ssl.qhimg.com,31,0.00%,40,9,77.50%
sslshare.jomodns.com,31,0.00%,31,0,100.00%
www.adobe.com,31,0.00%,31,0,100.00%
sslbdstatic.jomodns.com,31,0.00%,31,0,100.00%
s.tt-1111.com,31,0.00%,31,0,100.00%
k-ring.msedge.net,30,0.00%,30,0,100.00%
tracker.lelux.fi,30,0.00%,30,0,100.00%
api.game.360.cn,30,0.00%,34,4,88.24%
sug.so.360.cn,30,0.00%,30,0,100.00%
www.download.windowsupdate.com.download.ks-cdn.com,30,0.00%,30,0,100.00%
ipv6.china.qiniu.com.trpcdn.net,30,0.00%,64,34,46.88%
tw13.clashcloud.tech,30,0.00%,30,0,100.00%
pub.idqqimg.com.tc.qq.com,30,0.00%,64,34,46.88%
mylittleslaveponny.club,30,0.00%,30,0,100.00%
ocsp.crlocsp.cn,30,0.00%,30,0,100.00%
unpkg.zhimg.com,30,0.00%,66,36,45.45%
dcbrowser.cqttech.com,30,0.00%,30,0,100.00%
wmgp-update.wmupd.com.w.alikunlun.com,30,0.00%,30,0,100.00%
zlxxglobal.v.lxcvc.com,30,0.00%,30,0,100.00%
img0.baidu.com,30,0.00%,30,0,100.00%
onedscolprdeus01.eastus.cloudapp.azure.com,30,0.00%,57,27,52.63%
services.zotero.org,30,0.00%,30,0,100.00%
img1.baidu.com,30,0.00%,30,0,100.00%
launcher-public-service-prod06.ol.epicgames.com,30,0.00%,30,0,100.00%
api.b.qianxin.com,30,0.00%,30,0,100.00%
fa000000005.resources.office.net,30,0.00%,64,34,46.88%
valid-cn.origin-apple.com.akadns.net,30,0.00%,30,0,100.00%
vault.centos.org,30,0.00%,58,28,51.72%
30.courier-push-apple.com.akadns.net,30,0.00%,30,0,100.00%
ip1910235175.funshion.com,30,0.00%,30,0,100.00%
ip462737488.funshion.com,30,0.00%,30,0,100.00%
googlecm.hit.gemius.pl,30,0.00%,30,0,100.00%
41-courier.push.apple.com,30,0.00%,30,0,100.00%
20536-ipv4.gr.global.aa-rt.sharepoint.com,30,0.00%,30,0,100.00%
www.bytedance.com,30,0.00%,30,0,100.00%
sr.m.hub.sandai.net,30,0.00%,30,0,100.00%
imap.mxhichina.com,30,0.00%,30,0,100.00%
tracker.frozen-layer.com,30,0.00%,30,0,100.00%
pc-diffpack.wps.cn,30,0.00%,30,0,100.00%
tconf.f.360.cn,30,0.00%,30,0,100.00%
fxtt.ru,30,0.00%,30,0,100.00%
wan.sogou.com,30,0.00%,30,0,100.00%
cutiegirl.ru,30,0.00%,30,0,100.00%
itunes.apple.com,30,0.00%,31,1,96.77%
iphonesubmissions.apple.com,30,0.00%,30,0,100.00%
cpu.fire.skyworthdigital.jikedata.com,30,0.00%,30,0,100.00%
clientnotification-userprodea1-1.servicebus.windows.net,30,0.00%,30,0,100.00%
jianyi.baidu.com,30,0.00%,30,0,100.00%
service.dg.wps.cn,30,0.00%,30,0,100.00%
d3my7gygxlhw3x.cloudfront.net,30,0.00%,31,1,96.77%
stores1.hispace.hicloud.com,30,0.00%,30,0,100.00%
android.apis.google.com,30,0.00%,32,2,93.75%
broadcast.chat.biliapi.com,29,0.00%,29,0,100.00%
e6987.a.akamaiedge.net,29,0.00%,29,0,100.00%
onedscolprduks03.uksouth.cloudapp.azure.com,29,0.00%,29,0,100.00%
token.rubiconproject.com,29,0.00%,29,0,100.00%
www.ifeng.com,29,0.00%,29,0,100.00%
iie.arp.cn,29,0.00%,29,0,100.00%
s3m6.fenxi.com,29,0.00%,31,2,93.55%
glb.api.prod.dcat.dsp.trafficmanager.net,29,0.00%,54,25,53.70%
wd-prod-ss-as-southeast-3-fe.southeastasia.cloudapp.azure.com,29,0.00%,29,0,100.00%
time.nist.gov,29,0.00%,663,634,4.37%
ieonlinews.trafficmanager.NET,29,0.00%,55,26,52.73%
osupdateservice.yunos.com,29,0.00%,29,0,100.00%
e4094fc1d98c915a.ksyunad.com,29,0.00%,55,26,52.73%
36-courier.push.apple.com,29,0.00%,29,0,100.00%
pull-tsl-l3.douyincdn.com,29,0.00%,29,0,100.00%
api.smoot.apple.com,29,0.00%,29,0,100.00%
748049e45d87b8c7.jijifun.com,29,0.00%,29,0,100.00%
opencdnmsdl3.jomodns.com,29,0.00%,29,0,100.00%
tiny009.china.line.qiniudns.com,29,0.00%,29,0,100.00%
subca.crl.certum.pl,29,0.00%,64,35,45.31%
sns-video-bd.xhscdn.com,29,0.00%,68,39,42.65%
mirrorcoso1.acglego-dk.sched.tdnsv2.com,29,0.00%,63,34,46.03%
ecomcbjs.jomodns.com,29,0.00%,29,0,100.00%
wap.sogou.com,29,0.00%,29,0,100.00%
tools.google.com,29,0.00%,41,12,70.73%
o1069899.ingest.sentry.io,29,0.00%,29,0,100.00%
dcs.foxitreader.cn,29,0.00%,29,0,100.00%
oth.ludashi.com,29,0.00%,29,0,100.00%
www.xwt-classics.net,29,0.00%,29,0,100.00%
artistpicserver.kuwo.cn,29,0.00%,29,0,100.00%
30-courier.push.apple.com,29,0.00%,29,0,100.00%
www.ximalaya.com,29,0.00%,29,0,100.00%
cc.adingo.jp,29,0.00%,29,0,100.00%
logservice.hicloud.com,29,0.00%,29,0,100.00%
crl.microsoft.com,29,0.00%,62,33,46.77%
update-zl.2345.cc,29,0.00%,29,0,100.00%
fcmtoken.googleapis.com,29,0.00%,59,30,49.15%
mobilegw.alipay.com,29,0.00%,29,0,100.00%
eth-mainnet.alchemyapi.io,29,0.00%,29,0,100.00%
data-detect.nie.netease.com,29,0.00%,29,0,100.00%
config.app.yinxiang.com,29,0.00%,29,0,100.00%
wwcdn.weixin.qq.com,29,0.00%,29,0,100.00%
lf3-cdn-tos.bytegoofy.com,29,0.00%,33,4,87.88%
repositorynocdn.eset.com,29,0.00%,29,0,100.00%
e7279.dsce9.akamaiedge.net,29,0.00%,58,29,50.00%
ms-python.gallerycdn.azure.cn,29,0.00%,29,0,100.00%
metadata.templates.cdn.office.net,29,0.00%,29,0,100.00%
dm2305.storage.live.com,29,0.00%,57,28,50.88%
d2335eacoaawg9.cloudfront.net,29,0.00%,33,4,87.88%
top.baidu.com,29,0.00%,29,0,100.00%
smtp.flawcra.cc,29,0.00%,29,0,100.00%
i.snssdk.com.w.kunluncan.com,29,0.00%,29,0,100.00%
e1723.ca.s.tl88.NET,29,0.00%,29,0,100.00%
repos.os.nfschina.com,29,0.00%,29,0,100.00%
clk.lenovo.com.cn,28,0.00%,28,0,100.00%
pbjs.e-planning.net,28,0.00%,28,0,100.00%
c2shb.ssp.yahoo.com,28,0.00%,28,0,100.00%
a-0003.a-msedge.net,28,0.00%,54,26,51.85%
m0.mail.sina.com.cn,28,0.00%,28,0,100.00%
galaxy.safe.360.cn,28,0.00%,28,0,100.00%
beertracker.ml,28,0.00%,28,0,100.00%
cmsjs.eastmoney.com,28,0.00%,63,35,44.44%
appdl.lenovo.com.cn,28,0.00%,28,0,100.00%
pull-lls-spe-l11.douyincdn.com,28,0.00%,28,0,100.00%
bag-smoot.v.aaplimg.com,28,0.00%,28,0,100.00%
1min.pcfg.cache.wpscdn.cn.qiniudns.com,28,0.00%,28,0,100.00%
disc501.prod.do.dsp.mp.microsoft.com,28,0.00%,28,0,100.00%
ajax.googleapis.com,28,0.00%,31,3,90.32%
prod-tp.sumo.mozit.cloud,28,0.00%,28,0,100.00%
support.mozilla.org,28,0.00%,28,0,100.00%
17-courier.push.apple.com,28,0.00%,28,0,100.00%
batch-rgeo.is.autonavi.com.gds.alibabadns.com,28,0.00%,28,0,100.00%
scholar.l.google.com,28,0.00%,28,0,100.00%
wx-love-img.afunapp.com,28,0.00%,28,0,100.00%
pull-rtmp-l1-cny.douyincdn.com,28,0.00%,28,0,100.00%
r2---sn-2x3elnez.gvt1.com,28,0.00%,28,0,100.00%
ws12.gti.mcafee.com,28,0.00%,28,0,100.00%
code.aliyun.com,28,0.00%,28,0,100.00%
visualstudio.download.prss.trafficmanager.net,28,0.00%,28,0,100.00%
swallow-apple-com.v.aaplimg.com,28,0.00%,28,0,100.00%
e7695.dscg.akamaiedge.net,28,0.00%,57,29,49.12%
crl.apple.com,28,0.00%,52,24,53.85%
deepviz-nlb-prod-ap-southeast-1-f64fb66f5d07c49a.elb.ap-southeast-1.amazonaws.com,28,0.00%,28,0,100.00%
dmpstatic.cdn.bcebos.com,28,0.00%,28,0,100.00%
odr.mookie1.com,28,0.00%,53,25,52.83%
gateway.battlenet.com.cn,28,0.00%,28,0,100.00%
tracker.vraphim.com,28,0.00%,28,0,100.00%
ip-info.ff.avast.com,28,0.00%,28,0,100.00%
tracker.torrentbytes.net,28,0.00%,28,0,100.00%
sdk.51.la,28,0.00%,28,0,100.00%
open.touki.ru,28,0.00%,28,0,100.00%
scrootca2.ocsp.secomtrust.net,28,0.00%,42,14,66.67%
s-adashx.ut.uc.cn,28,0.00%,28,0,100.00%
wps-file.obs.cn-north-4.myhuaweicloud.com,28,0.00%,28,0,100.00%
store.steampowered.com,28,0.00%,28,0,100.00%
mesh.if.iqiyi.com,28,0.00%,28,0,100.00%
kms.xspace.in,28,0.00%,28,0,100.00%
acsdk.gameyw.netease.com,28,0.00%,28,0,100.00%
www.worldboxingvideoarchive.com,28,0.00%,28,0,100.00%
cdn-node.cn.cm.foshan-01.nekocloud.cn,28,0.00%,28,0,100.00%
cmshow.gtimg.cn,28,0.00%,31,3,90.32%
conf.f.360.cn,28,0.00%,28,0,100.00%
tracker.frozen-layer.net,28,0.00%,28,0,100.00%
h5.analytics.126.net,28,0.00%,28,0,100.00%
vcs.snssdk.com,28,0.00%,28,0,100.00%
vip.foxitreader.cn,28,0.00%,28,0,100.00%
title.auth.xboxlive.com,28,0.00%,28,0,100.00%
app.axure.cloud,28,0.00%,28,0,100.00%
cn.pool.ntp.org,28,0.00%,28,0,100.00%
developer.download.nvidia.cn,28,0.00%,28,0,100.00%
172-104-107-135.ip.linodeusercontent.com,28,0.00%,28,0,100.00%
pdf-file.pdfxd.com,28,0.00%,28,0,100.00%
jpedu-my.sharepoint.com,28,0.00%,28,0,100.00%
metrics1-drcn.dt.dbankcloud.cn,28,0.00%,28,0,100.00%
android.googleapis.com,28,0.00%,32,4,87.50%
musicstatus.itunes.apple.com,28,0.00%,28,0,100.00%
appstore.uniontech.com,28,0.00%,28,0,100.00%
hub.fastgit.xyz,28,0.00%,28,0,100.00%
zykj2019.oss-cn-hangzhou.aliyuncs.com,28,0.00%,28,0,100.00%
10.rarbg.me,27,0.00%,27,0,100.00%
yuri-websocket-serve.app.kdsec.org,27,0.00%,27,0,100.00%
46.courier-push-apple.com.akadns.net,27,0.00%,27,0,100.00%
edge.api.myqnapcloud.cn,27,0.00%,62,35,43.55%
onedscolprdneu02.northeurope.cloudapp.azure.com,27,0.00%,27,0,100.00%
anti-bot.n.shifen.com,27,0.00%,27,0,100.00%
xtremewrestlingtorrents.net,27,0.00%,27,0,100.00%
tracker.vectahosting.eu,27,0.00%,373,346,7.24%
stocks-data-service.lb-apple.com.akadns.net,27,0.00%,60,33,45.00%
pull-rtmp-l29.douyincdn.com,27,0.00%,27,0,100.00%
pull-f5-mptcp.flive.douyincdn.com,27,0.00%,27,0,100.00%
googleads4.g.doubleclick.net,27,0.00%,27,0,100.00%
na61-na62.wagbridge.alibaba.aliyun.com.gds.alibabadns.com,27,0.00%,27,0,100.00%
assets.leetcode-cn.com.w.kunlungr.com,27,0.00%,27,0,100.00%
e11.dsca.akamaiedge.net,27,0.00%,54,27,50.00%
mirrors.tuna.tsinghua.edu.cn,27,0.00%,1387,1360,1.95%
secfsr.lenovomm.com,27,0.00%,27,0,100.00%
onedscolprdneu00.northeurope.cloudapp.azure.com,27,0.00%,27,0,100.00%
pull-l3-source.douyincdn.com,27,0.00%,27,0,100.00%
bimp.hdslb.com,27,0.00%,63,36,42.86%
cl4-cn.apple.com,27,0.00%,27,0,100.00%
ipv6.msftncsi.com,27,0.00%,67,40,40.30%
i0.hdslb.com.04f6a54d.c.cdnhwc1.com,27,0.00%,57,30,47.37%
onedscolprdweu05.westeurope.cloudapp.azure.com,27,0.00%,54,27,50.00%
mediaclub.tv,27,0.00%,48,21,56.25%
tracker.theempire.bz,27,0.00%,27,0,100.00%
zybuluo.com,27,0.00%,27,0,100.00%
stun.chat.bilibili.com,27,0.00%,49,22,55.10%
pull-f3.douyincdn.com,27,0.00%,27,0,100.00%
tr.highstar.shop,27,0.00%,52,25,51.92%
tracker.publictorrent.net,27,0.00%,27,0,100.00%
rt.optizone.ru,27,0.00%,27,0,100.00%
lb2.overleaf.com,27,0.00%,27,0,100.00%
bt.unionpeer.org,27,0.00%,27,0,100.00%
s23-sync.firefox.com.cn,27,0.00%,27,0,100.00%
policy.video.iqiyi.com,27,0.00%,56,29,48.21%
contacts.fe.apple-dns.net,27,0.00%,56,29,48.21%
freerainbowtables.com,27,0.00%,27,0,100.00%
lf-cdn-tos.bytescm.com.w.kunluncan.com,27,0.00%,30,3,90.00%
tracker.baltracker.net,27,0.00%,27,0,100.00%
api.pcloud.com,27,0.00%,27,0,100.00%
ieonlinews.trafficmanager.net,27,0.00%,49,22,55.10%
openbittorrent.com,27,0.00%,27,0,100.00%
data.hackerwatch.org,27,0.00%,27,0,100.00%
static.mediav.com,27,0.00%,29,2,93.10%
r1---sn-2x3elnez.gvt1.com,27,0.00%,27,0,100.00%
js.aq.qq.com,27,0.00%,27,0,100.00%
bt.firebit.org,27,0.00%,27,0,100.00%
nv00.cdn.bcebos.com,27,0.00%,33,6,81.82%
retracker.baikal-telecom.net,27,0.00%,27,0,100.00%
tracker.grepler.com,27,0.00%,27,0,100.00%
kmr.service.kugou.com,27,0.00%,27,0,100.00%
accwww6.53kf.com,27,0.00%,27,0,100.00%
nfa.jd.com,27,0.00%,27,0,100.00%
gz3.520vpn.us,27,0.00%,27,0,100.00%
teams-events-data.trafficmanager.net,26,0.00%,28,2,92.86%
www.blackcats-games.net,26,0.00%,26,0,100.00%
app.bilibili.com,26,0.00%,31,5,83.87%
prebid.smilewanted.com,26,0.00%,26,0,100.00%
img.qwps.cn,26,0.00%,55,29,47.27%
addinsinstallation.store.office.com,26,0.00%,26,0,100.00%
24.courier-push-apple.com.akadns.net,26,0.00%,26,0,100.00%
pull-rtmp-l11-cny.douyincdn.com,26,0.00%,26,0,100.00%
setup.icloud.com,26,0.00%,52,26,50.00%
stocks-data-service.apple.com,26,0.00%,56,30,46.43%
pull-lls-l11.douyincdn.com,26,0.00%,26,0,100.00%
pull-lls-spe-l3.douyincdn.com,26,0.00%,26,0,100.00%
onedscolprdneu04.northeurope.cloudapp.azure.com,26,0.00%,26,0,100.00%
tiny.china.qiniu.com.trpcdn.net,26,0.00%,26,0,100.00%
hqstats.10jqka.com.cn,26,0.00%,26,0,100.00%
gsp85-cn-ssl.ls.apple.com,26,0.00%,26,0,100.00%
cma.itunes.apple.com,26,0.00%,49,23,53.06%
data.mistat.xiaomi.com,26,0.00%,26,0,100.00%
pull-lls-f5.flive.douyincdn.com,26,0.00%,26,0,100.00%
www.zotero.org,26,0.00%,26,0,100.00%
d2lfklupjnai2b.cloudfront.cn,26,0.00%,43,17,60.47%
9-courier.push.apple.com,26,0.00%,26,0,100.00%
astivysauran.com,26,0.00%,26,0,100.00%
api-access.pangolin-sdk-toutiao.com,26,0.00%,46,20,56.52%
download.virtualbox.org,26,0.00%,26,0,100.00%
cl3.apple.com,26,0.00%,42,16,61.90%
wppkg.baidupcs.com,26,0.00%,55,29,47.27%
33.courier-push-apple.com.akadns.net,26,0.00%,26,0,100.00%
web4.obit.ru,26,0.00%,26,0,100.00%
tracker.supertracker.net,26,0.00%,26,0,100.00%
netmon-control.dropbox.com,26,0.00%,53,27,49.06%
weather-drcn.music.dbankcloud.cn,26,0.00%,26,0,100.00%
api.weathercn.com,26,0.00%,38,12,68.42%
22-courier.push.apple.com,26,0.00%,26,0,100.00%
s01.upd.kaspersky.com,26,0.00%,26,0,100.00%
www.thevault.bz,26,0.00%,26,0,100.00%
hc2.tdm.qq.com,26,0.00%,26,0,100.00%
fex.bdstatic.com,26,0.00%,26,0,100.00%
seal-api.bytedance.net.w.kunluncan.com,26,0.00%,26,0,100.00%
mmbiz.qpic.tc.qq.com,26,0.00%,28,2,92.86%
195863-ipv4e.farm.dprodmgd106.aa-rt.sharepoint.com,26,0.00%,26,0,100.00%
onedscolprdneu01.northeurope.cloudapp.azure.com,26,0.00%,26,0,100.00%
ecdn-aboav7gm.sched.d2.tdnsdp1.cn,26,0.00%,26,0,100.00%
portrait.jomodns.com,26,0.00%,61,35,42.62%
i.glzip.com,26,0.00%,26,0,100.00%
newmail.guazi.com,26,0.00%,26,0,100.00%
tracker.linkomanija.org,26,0.00%,26,0,100.00%
tracker.hiyj.cn,26,0.00%,26,0,100.00%
r1---sn-2x3elnel.gvt1.com,26,0.00%,26,0,100.00%
tracker.trancetraffic.com,26,0.00%,26,0,100.00%
nibba.trade,26,0.00%,26,0,100.00%
tracker.etree.org,26,0.00%,26,0,100.00%
torrent.arjlover.net,26,0.00%,26,0,100.00%
c.cnzz.com,26,0.00%,26,0,100.00%
tehconnection.eu,26,0.00%,26,0,100.00%
bal-kube-westus-02.westus.cloudapp.azure.com,26,0.00%,26,0,100.00%
lf3-cdn-tos.bytegoofy.com.w.alikunlun.com,26,0.00%,30,4,86.67%
lf3-config.bytetcc.com,26,0.00%,30,4,86.67%
xxbg.snssdk.com.w.cdngslb.com,26,0.00%,26,0,100.00%
50.courier-push-apple.com.akadns.net,26,0.00%,26,0,100.00%
federatedml-pa.googleapis.com,26,0.00%,26,0,100.00%
hao.360.com,26,0.00%,26,0,100.00%
p9.qhimg.com,26,0.00%,28,2,92.86%
www.2600.com,26,0.00%,26,0,100.00%
auth2.sangfor.com.cn,26,0.00%,26,0,100.00%
www.eastmoney.com,26,0.00%,55,29,47.27%
tracker.iamhansen.xyz,26,0.00%,26,0,100.00%
act.vip.iqiyi.com,26,0.00%,26,0,100.00%
seupdate.360safe.com,26,0.00%,26,0,100.00%
www.cnblogs.com,26,0.00%,26,0,100.00%
cr.file.cloud.duba.net,26,0.00%,26,0,100.00%
ifzq.finance.qq.com,26,0.00%,26,0,100.00%
ciscobinary.openh264.org,26,0.00%,26,0,100.00%
rd.nstrive.com,26,0.00%,26,0,100.00%
openmsf.msf.tencent-cloud.com,25,0.00%,25,0,100.00%
openlocation-drcn.platform.dbankcloud.com,25,0.00%,46,21,54.35%
as-tlx.3lift.com,25,0.00%,25,0,100.00%
tracker.xfsub.com,25,0.00%,25,0,100.00%
tracker.leechers-paradise.org,25,0.00%,25,0,100.00%
w.cnzz.com,25,0.00%,25,0,100.00%
www.bangkokbank.com,25,0.00%,25,0,100.00%
download.amd.com,25,0.00%,25,0,100.00%
honeycomb.wpscdn.cn.download.ks-cdn.com,25,0.00%,50,25,50.00%
oneocsp.microsoft.com,25,0.00%,40,15,62.50%
pull-rtmp-l11-source.douyincdn.com,25,0.00%,25,0,100.00%
pull-f3-proxy.douyincdn.com,25,0.00%,25,0,100.00%
analysis.leetcode.cn,25,0.00%,25,0,100.00%
nsclick.baidu.com,25,0.00%,58,33,43.10%
common-geo.onedrive.trafficmanager.net,25,0.00%,25,0,100.00%
pull-hls-spe-l26.douyincdn.com,25,0.00%,25,0,100.00%
pull-hls-f13.douyincdn.com,25,0.00%,25,0,100.00%
19.courier-push-apple.com.akadns.net,25,0.00%,25,0,100.00%
40-courier.push.apple.com,25,0.00%,25,0,100.00%
40.courier-push-apple.com.akadns.net,25,0.00%,25,0,100.00%
securepubads.g.doubleclick.net,25,0.00%,32,7,78.12%
sourcegraph.com,25,0.00%,48,23,52.08%
sns.synology.com,25,0.00%,25,0,100.00%
pop3.163.idns.yeah.net,25,0.00%,25,0,100.00%
msn-china.bing123.com,25,0.00%,25,0,100.00%
push.ynote.youdao.com,25,0.00%,25,0,100.00%
pull-rtmp-f11.douyincdn.com,25,0.00%,25,0,100.00%
28.courier-push-apple.com.akadns.net,25,0.00%,25,0,100.00%
47-courier.push.apple.com,25,0.00%,25,0,100.00%
torrents.hikarinokiseki.com,25,0.00%,25,0,100.00%
skyapi.live.net,25,0.00%,25,0,100.00%
msg.csw.lenovo.com,25,0.00%,25,0,100.00%
omg.wtftrackr.pw,25,0.00%,48,23,52.08%
p36-imap.mail.me.com.akadns.net,25,0.00%,25,0,100.00%
cdn.mysql.com,25,0.00%,25,0,100.00%
pull-rtmp-f1.douyincdn.com,25,0.00%,25,0,100.00%
pull-rtmp-l1.ixigua.com,25,0.00%,25,0,100.00%
pull-hs-f5.flive.douyincdn.com,25,0.00%,25,0,100.00%
pull-flv-l11-source.douyincdn.com,25,0.00%,25,0,100.00%
cdnpcwallpaper.zhhainiao.com,25,0.00%,25,0,100.00%
dl.dropbox.com,25,0.00%,50,25,50.00%
www.wegame.com.cn,25,0.00%,50,25,50.00%
t.publictracker.xyz,25,0.00%,51,26,49.02%
itera.bz,25,0.00%,25,0,100.00%
sea.frontdoor.licensing.commerce.microsoft.com,25,0.00%,25,0,100.00%
v19.stream.tencentmusic.com.tcdn.qq.com,25,0.00%,25,0,100.00%
m801.music.126.net,25,0.00%,56,31,44.64%
alltorrents.net,25,0.00%,25,0,100.00%
ip462737487.funshion.com,25,0.00%,25,0,100.00%
api.account.xiaomi.com,25,0.00%,25,0,100.00%
mail2.zelenaya.net,25,0.00%,25,0,100.00%
appdl-1-drcn.dbankcdn.com,25,0.00%,25,0,100.00%
tracker.gigatorrents.ws,25,0.00%,25,0,100.00%
torrentclub.tech,25,0.00%,45,20,55.56%
retracker.maxnet.ua,25,0.00%,25,0,100.00%
aserver-heyi.m.taobao.com,25,0.00%,25,0,100.00%
internalcheck.apple.com,25,0.00%,25,0,100.00%
array813.prod.do.dsp.mp.microsoft.com,25,0.00%,25,0,100.00%
download-installer.cdn.mozilla.net,25,0.00%,48,23,52.08%
update.inter.iqiyi.com,25,0.00%,25,0,100.00%
dsp.mbgcdn.lenovo.com.cn,25,0.00%,25,0,100.00%
m.qpic.cn,25,0.00%,55,30,45.45%
3gimg.qq.com,25,0.00%,33,8,75.76%
urswebzj.nosdn.127.net,25,0.00%,25,0,100.00%
biliv.d.cdn.10086.cn,25,0.00%,62,37,40.32%
bluebird-hd.org,25,0.00%,25,0,100.00%
proaudiotorrents.org,25,0.00%,25,0,100.00%
lupic.cdn.bcebos.com,25,0.00%,56,31,44.64%
ping.ie.sogou.com,25,0.00%,25,0,100.00%
verify.snssdk.com.w.kunluncan.com,25,0.00%,25,0,100.00%
s346.s2022.xyz,25,0.00%,25,0,100.00%
s.weibo.com,25,0.00%,25,0,100.00%
dlassets-ssl.xboxlive.com,25,0.00%,52,27,48.08%
hwid-drcn.platform.hicloud.com,25,0.00%,25,0,100.00%
tracker.tambovnet.org,25,0.00%,25,0,100.00%
kssv-w-yz01.kuaipandata.com,25,0.00%,25,0,100.00%
directory.services.live.com,25,0.00%,39,14,64.10%
user.360kuai.com,25,0.00%,25,0,100.00%
www.dongchedi.com,25,0.00%,25,0,100.00%
video.yidianzixun.com.HOST,25,0.00%,25,0,100.00%
miwifi.com,25,0.00%,25,0,100.00%
onedriveclucproddm20008.blob.core.windows.net,25,0.00%,25,0,100.00%
tr.doogh.club,25,0.00%,46,21,54.35%
api.epicgames.dev,25,0.00%,25,0,100.00%
continuum.dds.microsoft.com,25,0.00%,25,0,100.00%
www.synonym.com,25,0.00%,25,0,100.00%
people.skype.com,24,0.00%,24,0,100.00%
api.aps.skype.com,24,0.00%,24,0,100.00%
iknowpc.bdimg.com,24,0.00%,24,0,100.00%
ipv6.msftconnecttest.com,24,0.00%,922,898,2.60%
apidata.googleusercontent.com,24,0.00%,24,0,100.00%
pull-rtmp-l27.douyincdn.com,24,0.00%,24,0,100.00%
pull-rtmp-l26-cny.douyincdn.com,24,0.00%,24,0,100.00%
pull-rtmp-l6.douyincdn.com,24,0.00%,30,6,80.00%
ocsp.thawte.com,24,0.00%,53,29,45.28%
siambit.org,24,0.00%,45,21,53.33%
sf3-fe-tos.pglstatp-toutiao.com,24,0.00%,25,1,96.00%
cl3-cdn.origin-apple.com.akadns.net,24,0.00%,40,16,60.00%
pull-lls-l26.douyincdn.com,24,0.00%,24,0,100.00%
pull-l3.douyincdn.com,24,0.00%,24,0,100.00%
push-rtmp-f5-hs.pstatp.com,24,0.00%,24,0,100.00%
pull-hls-f5-enc.flive.douyincdn.com,24,0.00%,29,5,82.76%
sub1.bgp.netarch-alisc1-edge-lb.l.bytedns.net,24,0.00%,24,0,100.00%
smp-device-content.lb-apple.com.akadns.net,24,0.00%,27,3,88.89%
dashboard.snapcraft.io,24,0.00%,24,0,100.00%
msn-cn.a-0032.a-msedge.net,24,0.00%,27,3,88.89%
pull-f5-io.flive.douyincdn.com,24,0.00%,24,0,100.00%
pull-flv-f11.douyincdn.com,24,0.00%,24,0,100.00%
gstaticadssl.l.google.com,24,0.00%,29,5,82.76%
torrents.linuxmint.com,24,0.00%,24,0,100.00%
www.theplace.bz,24,0.00%,24,0,100.00%
torrents-nn.cn,24,0.00%,24,0,100.00%
upload-va.synacast.com,24,0.00%,24,0,100.00%
wbapp.uve.weibo.com,24,0.00%,24,0,100.00%
chi01pap002.storage.live.com,24,0.00%,43,19,55.81%
pc-store-lb.lenovomm.cn,24,0.00%,24,0,100.00%
pull-rtmp-f13.douyincdn.com,24,0.00%,24,0,100.00%
pull-hs-f5-encryption.flive.douyincdn.com,24,0.00%,24,0,100.00%
torrent.resonatingmedia.com,24,0.00%,24,0,100.00%
xpis-xcdn.youku.com,24,0.00%,24,0,100.00%
socwxsns.video.qq.com,24,0.00%,49,25,48.98%
v19.stream.tencentmusic.com.dsp.sched.dcloudstc.com,24,0.00%,24,0,100.00%
45-courier.push.apple.com,24,0.00%,24,0,100.00%
license.chinauos.com,24,0.00%,24,0,100.00%
www.sciencenet.cn,24,0.00%,24,0,100.00%
m.baidu.com,24,0.00%,24,0,100.00%
ad.doubleclick.net,24,0.00%,24,0,100.00%
41.courier-push-apple.com.akadns.net,24,0.00%,24,0,100.00%
high-frequency-gray-cdn.duba.net,24,0.00%,24,0,100.00%
www.msftncsi.com.edgesuite.net,24,0.00%,24,0,100.00%
cn-zhangjiakou.axt.aliyun.com,24,0.00%,24,0,100.00%
tracker.tallpenguin.org,24,0.00%,24,0,100.00%
docs.microsoft.com,24,0.00%,24,0,100.00%
d1epqfzld01eon.cloudfront.net,24,0.00%,24,0,100.00%
tracker.filepit.to,24,0.00%,24,0,100.00%
dl.reg.163.com,24,0.00%,24,0,100.00%
lf3-cdn-tos.bytescm.com.w.alikunlun.com,24,0.00%,28,4,85.71%
tracker.nyaa.uk,24,0.00%,24,0,100.00%
checkin.gstatic.com,24,0.00%,24,0,100.00%
pow7.com,24,0.00%,48,24,50.00%
www.theoccult.bz,24,0.00%,24,0,100.00%
bt.ali213.net,24,0.00%,24,0,100.00%
leetcode.cn,24,0.00%,24,0,100.00%
so.toutiao.com.w.cdngslb.com,24,0.00%,24,0,100.00%
helpdesk.bytedance.com.w.cdngslb.com,24,0.00%,24,0,100.00%
rgepodownload.mediatek.com,24,0.00%,24,0,100.00%
bt.zlofenix.org,24,0.00%,24,0,100.00%
match.p4p.1688.com,24,0.00%,24,0,100.00%
sx-common-all.volcgtm.com,24,0.00%,56,32,42.86%
statwup.huya.com,24,0.00%,24,0,100.00%
unah2wel.nodedata.net,24,0.00%,24,0,100.00%
onedriveclucprodbn20037.blob.core.windows.net,24,0.00%,24,0,100.00%
bt-tracker.gamexp.ru,24,0.00%,24,0,100.00%
statuse.digitalcertvalidation.com,24,0.00%,40,16,60.00%
login.chinacloudapi.cn,24,0.00%,24,0,100.00%
onedriveclucprodbn20004.blob.core.windows.net,24,0.00%,24,0,100.00%
sdkapp.uve.weibo.com,24,0.00%,24,0,100.00%
comment.api.163.com,24,0.00%,24,0,100.00%
d31qbv1cthcecs.cloudfront.net,24,0.00%,24,0,100.00%
api.rollbar.com,24,0.00%,24,0,100.00%
api.share.baidu.com,24,0.00%,24,0,100.00%
consumer.entitlement.skype.com,24,0.00%,24,0,100.00%
usage.influxdata.com,24,0.00%,24,0,100.00%
s-ring.msedge.net,23,0.00%,23,0,100.00%
16.courier-push-apple.com.akadns.net,23,0.00%,23,0,100.00%
p218-quota.icloud.com.cn,23,0.00%,23,0,100.00%
log.mmstat.com,23,0.00%,23,0,100.00%
httpdns.alicdn.com,23,0.00%,49,26,46.94%
1266287590.rsc.cdn77.org,23,0.00%,49,26,46.94%
s1.vip.wpscdn.cn,23,0.00%,48,25,47.92%
22.courier-push-apple.com.akadns.net,23,0.00%,23,0,100.00%
pull-hls-vr-l26.douyincdn.com,23,0.00%,23,0,100.00%
pull-flv-l13.douyincdn.com,23,0.00%,23,0,100.00%
ss.wlmnzf.xyz,23,0.00%,45,22,51.11%
p3-sign.toutiaoimg.com.w.alikunlun.com,23,0.00%,25,2,92.00%
pull-flv-l27.douyincdn.com,23,0.00%,23,0,100.00%
pull-rtmp-l1.douyincdn.com,23,0.00%,23,0,100.00%
pc-plugin-plg-wpscdn-cn-idvh11c.qiniudns.com,23,0.00%,55,32,41.82%
bkclick.n.shifen.com,23,0.00%,23,0,100.00%
pwo4tgrz.slt.sched.tdnsv8.com,23,0.00%,23,0,100.00%
a1904.v.akamai.net,23,0.00%,23,0,100.00%
pull-hls-f11.douyincdn.com,23,0.00%,23,0,100.00%
pull-flv-f11-proxy.douyincdn.com,23,0.00%,23,0,100.00%
pull-f5.flive.douyincdn.com,23,0.00%,23,0,100.00%
pull-hls-f96.douyincdn.com,23,0.00%,23,0,100.00%
pull-lls-spe-l26.douyincdn.com,23,0.00%,23,0,100.00%
pull-flv-l11-encryption.douyincdn.com,23,0.00%,23,0,100.00%
e10663.dscg.akamaiedge.net,23,0.00%,46,23,50.00%
livepatch.canonical.com,23,0.00%,23,0,100.00%
iplc.a.hellossr.com,23,0.00%,23,0,100.00%
mixfiend.com,23,0.00%,23,0,100.00%
tracker.shittyurl.org,23,0.00%,41,18,56.10%
tracker.xdvdz.com,23,0.00%,23,0,100.00%
bkimg.cdn.bcebos.com,23,0.00%,23,0,100.00%
38.courier-push-apple.com.akadns.net,23,0.00%,23,0,100.00%
onedscolprdneu03.northeurope.cloudapp.azure.com,23,0.00%,23,0,100.00%
web.push.126.net,23,0.00%,23,0,100.00%
pull-lls-spe-l1.douyincdn.com,23,0.00%,23,0,100.00%
pull-tsl-l11.douyincdn.com,23,0.00%,23,0,100.00%
tracker.msm8916.com,23,0.00%,39,16,58.97%
vip-rec.ksord.com,23,0.00%,23,0,100.00%
torrentzilla.org,23,0.00%,23,0,100.00%
dns.pub,23,0.00%,23,0,100.00%
gwp2-v19.rinet.ru,23,0.00%,23,0,100.00%
local.info.g9hc4.cn,23,0.00%,23,0,100.00%
tracker.bz,23,0.00%,23,0,100.00%
tracker.gcvchp.com,23,0.00%,23,0,100.00%
signal.pod4.avatar.ext.hp.com,23,0.00%,23,0,100.00%
www.thetradersden.org,23,0.00%,23,0,100.00%
bithq.org,23,0.00%,23,0,100.00%
wemeet-da2.qq.com,23,0.00%,23,0,100.00%
collect-v6.51.la,23,0.00%,23,0,100.00%
is.snssdk.com,23,0.00%,24,1,95.83%
flow.wps.cn,23,0.00%,23,0,100.00%
assets-res-cn.c.huawei.com,23,0.00%,23,0,100.00%
dlcdnets.asus.com,23,0.00%,23,0,100.00%
dsm01pap007.storage.live.com,23,0.00%,39,16,58.97%
assets.leetcode-cn.com,23,0.00%,23,0,100.00%
m.toutiao.com,23,0.00%,23,0,100.00%
xxbg.snssdk.com,23,0.00%,23,0,100.00%
ip3026294313.funshion.com,23,0.00%,23,0,100.00%
mvgroup.org,23,0.00%,23,0,100.00%
APAC02.azure-devices.net,23,0.00%,23,0,100.00%
settings.data.microsoft.com,23,0.00%,23,0,100.00%
music-torrent.net,23,0.00%,23,0,100.00%
s9.cnzz.com,23,0.00%,23,0,100.00%
im-x.jd.com,23,0.00%,23,0,100.00%
i.dhrest.com,23,0.00%,23,0,100.00%
cube.dhrest.com,23,0.00%,23,0,100.00%
moe-moe.love,23,0.00%,23,0,100.00%
track.customer.io,23,0.00%,23,0,100.00%
www.hpgamestream.com,23,0.00%,23,0,100.00%
p0.img.360kuai.com,23,0.00%,32,9,71.88%
code.bdstatic.com,23,0.00%,23,0,100.00%
memory.fire.skyworthdigital.jikedata.com,23,0.00%,23,0,100.00%
a-ring.msedge.net,23,0.00%,23,0,100.00%
gcs.sangfor.com,23,0.00%,23,0,100.00%
d2x0118v5hofu3.cloudfront.net,23,0.00%,23,0,100.00%
mss0.bdstatic.com,23,0.00%,23,0,100.00%
mbdp02.bdstatic.com,23,0.00%,29,6,79.31%
y.gtimg.cn,23,0.00%,23,0,100.00%
internal-api-lark-api.feishu.cn.bytedns1.com,23,0.00%,23,0,100.00%
c81s4.jamjams3.net,23,0.00%,23,0,100.00%
fosstorrents.com,23,0.00%,23,0,100.00%
sls.sourceinsight.com,23,0.00%,23,0,100.00%
ip3720517251.funshion.com,23,0.00%,23,0,100.00%
ban.zhengsj.top,23,0.00%,23,0,100.00%
4.perf.msedge.net,22,0.00%,34,12,64.71%
bl6pap003.storage.live.com,22,0.00%,55,33,40.00%
q8daiuc5.sched.sma.tdnsstic1.cn,22,0.00%,22,0,100.00%
eqx.smartadserver.com,22,0.00%,41,19,53.66%
r.bing.com,22,0.00%,22,0,100.00%
tracking.firefox.com.cn.wswebpic.com,22,0.00%,36,14,61.11%
b1.nel.goog,22,0.00%,85,63,25.88%
mapm.douyucdn.cn,22,0.00%,22,0,100.00%
captcha.zhihu.com,22,0.00%,39,17,56.41%
p3-sign.toutiaoimg.com,22,0.00%,26,4,84.62%
tracker.publichd.eu,22,0.00%,22,0,100.00%
p218-caldav.icloud.com.cn,22,0.00%,22,0,100.00%
push-rtmp-l13.douyincdn.com,22,0.00%,22,0,100.00%
push-rtmp-l29.douyincdn.com,22,0.00%,22,0,100.00%
pull-f5-hs.flive.pstatp.com,22,0.00%,22,0,100.00%
smp-device-content-cn.lb-apple.com.akadns.net,22,0.00%,22,0,100.00%
chinaweb292.china.line.qiniudns.com,22,0.00%,49,27,44.90%
onedscolprdneu05.northeurope.cloudapp.azure.com,22,0.00%,22,0,100.00%
c-ring.msedge.net,22,0.00%,22,0,100.00%
gspe35-ssl.ls.apple.com.download.ks-cdn.com,22,0.00%,42,20,52.38%
onedscolprduks00.uksouth.cloudapp.azure.com,22,0.00%,36,14,61.11%
conversions.appsflyer.com,22,0.00%,22,0,100.00%
pull-flv-l3-encryption.douyincdn.com,22,0.00%,22,0,100.00%
pull-rtmp-l11.douyincdn.com,22,0.00%,22,0,100.00%
pull-hls-hs-f5-tsl.douyincdn.com,22,0.00%,22,0,100.00%
pull-tsl-spe-l3.douyincdn.com,22,0.00%,22,0,100.00%
public-cdn.cloud.unity3d.com,22,0.00%,22,0,100.00%
iplc.b.hellossr.com,22,0.00%,22,0,100.00%
subscription.rhsm.redhat.com,22,0.00%,22,0,100.00%
repository.gtm.eset.com,22,0.00%,22,0,100.00%
p218-contacts.icloud.com.cn,22,0.00%,22,0,100.00%
dispatcher.is.autonavi.com.gds.alibabadns.com,22,0.00%,22,0,100.00%
play-china.itunes-apple.com.akadns.net,22,0.00%,39,17,56.41%
themaninashed.com,22,0.00%,22,0,100.00%
torrent.unix-ag.uni-kl.de,22,0.00%,22,0,100.00%
startpage.foxitsoftware.com,22,0.00%,22,0,100.00%
res.qhupdate.com,22,0.00%,22,0,100.00%
p36-imap.mail.me.com,22,0.00%,22,0,100.00%
35.courier-push-apple.com.akadns.net,22,0.00%,22,0,100.00%
pull-f5.douyincdn.com,22,0.00%,22,0,100.00%
pull-rtmp-l1-source.douyincdn.com,22,0.00%,22,0,100.00%
pull-flv-f13.douyincdn.com,22,0.00%,22,0,100.00%
pull-vr-l3.douyincdn.com,22,0.00%,22,0,100.00%
pull-rtmp-f26.douyincdn.com,22,0.00%,22,0,100.00%
pull-f5-hot.flive.douyincdn.com,22,0.00%,22,0,100.00%
pull-flv-vr-l11.douyincdn.com,22,0.00%,22,0,100.00%
a1737.b.akamai.net,22,0.00%,22,0,100.00%
home.penza.com.ru,22,0.00%,22,0,100.00%
geo.prod.do.dsp.trafficmanager.net,22,0.00%,25,3,88.00%
skconf.f.360.cn,22,0.00%,22,0,100.00%
48-courier.push.apple.com,22,0.00%,22,0,100.00%
6-courier.push.apple.com,22,0.00%,22,0,100.00%
www.dvidshub.net,22,0.00%,22,0,100.00%
ip1873674373.funshion.com,22,0.00%,22,0,100.00%
ocsp.godaddy.com,22,0.00%,22,0,100.00%
195863-ipv4.farm.dprodmgd106.aa-rt.sharepoint.com.dual-spo-0004.spo-msedge.net,22,0.00%,22,0,100.00%
abufinzio.monocul.us,22,0.00%,22,0,100.00%
p2.img.360kuai.com,22,0.00%,27,5,81.48%
init.ess.apple.com,22,0.00%,22,0,100.00%
gdfp.gifshow.com,22,0.00%,22,0,100.00%
a.jd.com.gslb.qianxun.com,22,0.00%,22,0,100.00%
aliwsapubv46.suning.com.w.kunluncan.com,22,0.00%,44,22,50.00%
update2.sangfor.net.cdn20.com,22,0.00%,22,0,100.00%
qzonestyle.gtimg.cn,22,0.00%,26,4,84.62%
tracker.fatkhoala.org,22,0.00%,22,0,100.00%
tracker.ali213.net,22,0.00%,22,0,100.00%
watson.microsoft.com,22,0.00%,25,3,88.00%
lf3-cdn-tos.bytescm.com,22,0.00%,27,5,81.48%
lf3-short.bytegoofy.com.w.kunluncan.com,22,0.00%,26,4,84.62%
upfile1.hicloud.com,22,0.00%,22,0,100.00%
tracker.noobsubs.net,22,0.00%,22,0,100.00%
e4518.dscapi7.akamaiedge.net.0.1.cn.akamaiedge.net,22,0.00%,45,23,48.89%
488928.sched.skalego-dk.tdnsstic1.cn,22,0.00%,45,23,48.89%
www.legittorrents.info,22,0.00%,22,0,100.00%
api.interpreter.caiyunai.com,22,0.00%,22,0,100.00%
gw.m.163.com,22,0.00%,22,0,100.00%
11-courier.push.apple.com,22,0.00%,22,0,100.00%
updatecn.maxthon.com,22,0.00%,22,0,100.00%
helpdesk.bytedance.com,22,0.00%,22,0,100.00%
repository.eset.com,22,0.00%,22,0,100.00%
tracker.minglong.org,22,0.00%,22,0,100.00%
big-boss-tracker.net,22,0.00%,22,0,100.00%
user.auth.xboxlive.com,22,0.00%,22,0,100.00%
onedscolprdweu06.westeurope.cloudapp.azure.com,22,0.00%,22,0,100.00%
t0.dynamic.tiles.ditu.live.com,22,0.00%,22,0,100.00%
t1.dynamic.tiles.ditu.live.com,22,0.00%,22,0,100.00%
rcmdsites.dhrest.com,22,0.00%,22,0,100.00%
s.hao.360.com,22,0.00%,22,0,100.00%
legittorrents.info,22,0.00%,22,0,100.00%
us.sinaimg.cn.w.alikunlun.net,22,0.00%,47,25,46.81%
vasapi.wpsdns.com,22,0.00%,22,0,100.00%
widemus.de,22,0.00%,22,0,100.00%
api.niceax.net,22,0.00%,22,0,100.00%
g1.dfcfw.com,22,0.00%,50,28,44.00%
j4.dfcfw.com,22,0.00%,50,28,44.00%
d23iz4esrwkib6.cloudfront.net,22,0.00%,44,22,50.00%
s04.upd.kaspersky.com,22,0.00%,22,0,100.00%
log.dc.cn.happyelements.com,22,0.00%,22,0,100.00%
p1.img.360kuai.com,22,0.00%,26,4,84.62%
openjmacs.m.taobao.com,22,0.00%,22,0,100.00%
ip2100177539.funshion.com,22,0.00%,22,0,100.00%
service.mail.sina.com.cn,22,0.00%,22,0,100.00%
s3m5.fenxi.com,22,0.00%,23,1,95.65%
api.smoot.apple.cn,22,0.00%,22,0,100.00%
insideruser.microsoft.com,22,0.00%,22,0,100.00%
7.courier-push-apple.com.akadns.net,22,0.00%,22,0,100.00%
tracker.pcdn.yximgs.com,22,0.00%,22,0,100.00%
i.ytimg.com,22,0.00%,26,4,84.62%
d20rj4el6vkp4c.cloudfront.net,22,0.00%,44,22,50.00%
clientnotification-userprodea1-8.servicebus.windows.net,22,0.00%,22,0,100.00%
d3d8lrzagfq76q.cloudfront.net,22,0.00%,22,0,100.00%
flow.logitech.io,22,0.00%,22,0,100.00%
bxjbqj09.e0.sched.ovscdns.com,22,0.00%,41,19,53.66%
d3v522mr175zqx.cloudfront.net,22,0.00%,22,0,100.00%
msproduct.download.prss.microsoft.com,22,0.00%,22,0,100.00%
fpc.msedge.net,21,0.00%,31,10,67.74%
any.edge.bing.com,21,0.00%,21,0,100.00%
shb.richaudience.com,21,0.00%,21,0,100.00%
browser5.qhimg.com,21,0.00%,26,5,80.77%
autodiscover.ios.ac.cn,21,0.00%,21,0,100.00%
api.ipify.org,21,0.00%,21,0,100.00%
pull-f3.douyincdn.com.m.alikunlun.net,21,0.00%,21,0,100.00%
push-rtmp-l6-encryption.douyincdn.com,21,0.00%,21,0,100.00%
tags.tiqcdn.com,21,0.00%,21,0,100.00%
t7z.cupid.iqiyi.com,21,0.00%,21,0,100.00%
selfstock.10jqka.com.cn,21,0.00%,21,0,100.00%
e9659.dspg.akamaiedge.net,21,0.00%,44,23,47.73%
pull-rtmp-l13.douyincdn.com,21,0.00%,21,0,100.00%
pull-hls-f29.douyincdn.com,21,0.00%,21,0,100.00%
push-rtmp-f5-cny.douyincdn.com,21,0.00%,21,0,100.00%
pull-rtmp-f29.douyincdn.com,21,0.00%,21,0,100.00%
statistic.live.126.net,21,0.00%,21,0,100.00%
9.courier-push-apple.com.akadns.net,21,0.00%,21,0,100.00%
edge.skype.com,21,0.00%,37,16,56.76%
sukebei.tracker.wf,21,0.00%,21,0,100.00%
sc.icodef.com,21,0.00%,21,0,100.00%
tam.cdn-go.cn,21,0.00%,48,27,43.75%
tv.360.cn,21,0.00%,21,0,100.00%
go.trouter.skype.com,21,0.00%,21,0,100.00%
pull-flv-vr-l26.douyincdn.com,21,0.00%,21,0,100.00%
pull-tsl-hs-spe-f5.douyincdn.com,21,0.00%,21,0,100.00%
pull-flv-l29.douyincdn.com,21,0.00%,21,0,100.00%
flowcontroll.dcdn.sandai.net,21,0.00%,21,0,100.00%
37-courier.push.apple.com,21,0.00%,21,0,100.00%
37.courier-push-apple.com.akadns.net,21,0.00%,21,0,100.00%
48.courier-push-apple.com.akadns.net,21,0.00%,21,0,100.00%
array804.prod.do.dsp.mp.microsoft.com,21,0.00%,21,0,100.00%
43-courier.push.apple.com,21,0.00%,21,0,100.00%
onedscolprdweu02.westeurope.cloudapp.azure.com,21,0.00%,21,0,100.00%
service2.most.gov.cn,21,0.00%,21,0,100.00%
pull-flv-f29.douyincdn.com,21,0.00%,21,0,100.00%
fe-platformcn-maps-atm.trafficmanager.net,21,0.00%,21,0,100.00%
ins-j1yx5oul.ias.tencent-cloud.net,21,0.00%,21,0,100.00%
p6.img.360kuai.com,21,0.00%,23,2,91.30%
lenovo.archive.canonical.com,21,0.00%,21,0,100.00%
hcdnd.wangluojiance.gslb.c.cdnhwc6.com,21,0.00%,44,23,47.73%
update.ruanjian.2345.com,21,0.00%,21,0,100.00%
ishaep1o.nodedata.net,21,0.00%,21,0,100.00%
connectivity.pod1.avatar.ext.hp.com,21,0.00%,21,0,100.00%
onedriveclucprodbn20036.blob.core.windows.net,21,0.00%,21,0,100.00%
vip.dingtalk.com,21,0.00%,21,0,100.00%
sheo4ush.nodedata.net,21,0.00%,21,0,100.00%
tracker.loadbt.com,21,0.00%,42,21,50.00%
v7.stats.avast.com,21,0.00%,21,0,100.00%
pic.cnblogs.com,21,0.00%,21,0,100.00%
www.gditu.net,21,0.00%,21,0,100.00%
a1894.r.akamai.net,21,0.00%,21,0,100.00%
sf3-cdn-tos.toutiaostatic.com,21,0.00%,26,5,80.77%
sf3-cdn-tos.douyinstatic.com.w.cdngslb.com,21,0.00%,26,5,80.77%
chinaeast2-0.in.applicationinsights.azure.cn,21,0.00%,21,0,100.00%
gs-loc.apple.com,21,0.00%,21,0,100.00%
internal-api-space.feishu.cn.w.cdngslb.com,21,0.00%,21,0,100.00%
dailyupdate.wangwang.taobao.com,21,0.00%,21,0,100.00%
unpkg.zhimg.com.w.kunlunar.com,21,0.00%,43,22,48.84%
ip1873674383.funshion.com,21,0.00%,21,0,100.00%
cm.mediav.com,21,0.00%,21,0,100.00%
r4---sn-2x3elnel.gvt1.com,21,0.00%,21,0,100.00%
datacluster1.cipsup.cn,21,0.00%,21,0,100.00%
ip1865976423.funshion.com.HOST,21,0.00%,21,0,100.00%
ip1880706116.funshion.com.HOST,21,0.00%,21,0,100.00%
baidu.com,21,0.00%,21,0,100.00%
p4.img.360kuai.com,21,0.00%,26,5,80.77%
contracts.canonical.com,21,0.00%,21,0,100.00%
p8.img.360kuai.com,21,0.00%,22,1,95.45%
r4---sn-2x3elnee.gvt1.com,21,0.00%,21,0,100.00%
pcdn-proxy-tracker.xxpkg.com,21,0.00%,21,0,100.00%
policyorchestration.ccs.mcafee.com,21,0.00%,21,0,100.00%
v1.cnzz.com,21,0.00%,21,0,100.00%
www.mathworks.com,21,0.00%,21,0,100.00%
ocsp.dcocsp.cn.w.kunlunar.com,21,0.00%,21,0,100.00%
psg.pinyin.sogou.com,21,0.00%,21,0,100.00%
position.dftoutiao.com,21,0.00%,21,0,100.00%
qgepodownload.mediatek.com,21,0.00%,21,0,100.00%
hooks.slack.com,21,0.00%,21,0,100.00%
e6603.g.akamaiedge.net,20,0.00%,20,0,100.00%
m.hotmail.com,20,0.00%,47,27,42.55%
pull-flv-l3-encryption.douyincdn.com.w.alikunlun.net,20,0.00%,20,0,100.00%
pull-hls-f11.douyincdn.com.sched.l8.tdnsv5.com,20,0.00%,20,0,100.00%
pull-f5-hs.pstatp.com,20,0.00%,20,0,100.00%
grpc.biliapi.net,20,0.00%,22,2,90.91%
iknow-pic.cdn.bcebos.com,20,0.00%,20,0,100.00%
fr01.xiaocloud.info,20,0.00%,20,0,100.00%
wlog.ksapisrv.com,20,0.00%,20,0,100.00%
cds.3.cn,20,0.00%,20,0,100.00%
site.browser.360.cn,20,0.00%,20,0,100.00%
opentracker.i2p.rocks,20,0.00%,20,0,100.00%
cloudservice22.kingsoft-office-service.com,20,0.00%,20,0,100.00%
gfe.nvidia.com,20,0.00%,127,107,15.75%
pull-vol-base.s.volcfcdndvs.com,20,0.00%,20,0,100.00%
push-rtmp-l6.ixigua.com,20,0.00%,20,0,100.00%
pull-rtmp-l11.douyincdn.com.sched.l8.tdnsv5.com,20,0.00%,20,0,100.00%
dotcounter.douyucdn.cn,20,0.00%,20,0,100.00%
rtbapi.douyucdn.cn,20,0.00%,22,2,90.91%
center.lanxin.cn,20,0.00%,20,0,100.00%
apps.arp.cn,20,0.00%,20,0,100.00%
mssdk-bu.bytedance.com,20,0.00%,20,0,100.00%
appcdcbjpip1.jianguoyun.com,20,0.00%,20,0,100.00%
p208-caldav.icloud.com.cn,20,0.00%,20,0,100.00%
2.android.pool.ntp.org,20,0.00%,40,20,50.00%
onedscolprdweu00.westeurope.cloudapp.azure.com,20,0.00%,20,0,100.00%
wechat.todesk.com,20,0.00%,20,0,100.00%
pull-l3-hs.pstatp.com.w.alikunlun.net,20,0.00%,20,0,100.00%
pull-rtmp-f11.douyincdn.com.sched.l8.tdnsv5.com,20,0.00%,20,0,100.00%
push-rtmp-f5.douyincdn.com,20,0.00%,20,0,100.00%
pull-rtmp-l1.douyincdn.com.wsdvs.com,20,0.00%,20,0,100.00%
5a880faf6fb5e608.jijifun.com,20,0.00%,20,0,100.00%
s0-2mdn-net.l.google.com,20,0.00%,26,6,76.92%
cohort.ccs.mcafee.com,20,0.00%,20,0,100.00%
array604.prod.do.dsp.mp.microsoft.com,20,0.00%,20,0,100.00%
shee9noh.nodedata.net,20,0.00%,20,0,100.00%
appleimap.126.com,20,0.00%,20,0,100.00%
js-agent.newrelic.com,20,0.00%,20,0,100.00%
query.ess.apple.com,20,0.00%,20,0,100.00%
wx-love-ws.afunapp.com,20,0.00%,20,0,100.00%
wx-love-api.afunapp.com,20,0.00%,20,0,100.00%
pull-flv-l1-cny.douyincdn.com,20,0.00%,20,0,100.00%
cf.iadsdk.apple.com,20,0.00%,20,0,100.00%
APAC01.azure-devices.net,20,0.00%,20,0,100.00%
APAC04.azure-devices.net,20,0.00%,20,0,100.00%
onedscolprduks02.uksouth.cloudapp.azure.com,20,0.00%,20,0,100.00%
ltzproxy.zhxcshop.com,20,0.00%,20,0,100.00%
onedriveclucprodbn20005.blob.core.windows.net,20,0.00%,20,0,100.00%
irrenhaus.dyndns.dk,20,0.00%,20,0,100.00%
gss0.baidu.com,20,0.00%,20,0,100.00%
pull-hls-spe-l11.douyincdn.com,20,0.00%,20,0,100.00%
pull-flv-f96.douyincdn.com,20,0.00%,20,0,100.00%
pull-flv-l11.douyincdn.com,20,0.00%,20,0,100.00%
pull-tsl-vr-l3.douyincdn.com,20,0.00%,20,0,100.00%
pull-hls-f5-tsl.douyincdn.com,20,0.00%,24,4,83.33%
pull-flv-f5-enc.flive.douyincdn.com,20,0.00%,20,0,100.00%
onedscolprdeus13.eastus.cloudapp.azure.com,20,0.00%,20,0,100.00%
log.kuwo.cn,20,0.00%,20,0,100.00%
k128-gspe.gslb.ksyuncdn.com,20,0.00%,34,14,58.82%
d-usa.crispcdn.com,20,0.00%,20,0,100.00%
2.courier-push-apple.com.akadns.net,20,0.00%,20,0,100.00%
prod.configsvc1.live.com.akadns.NET,20,0.00%,20,0,100.00%
dlied6.qq.com.tcdn.qq.com,20,0.00%,20,0,100.00%
26.courier-push-apple.com.akadns.net,20,0.00%,20,0,100.00%
retracker.joxnet.ru,20,0.00%,20,0,100.00%
210194c475687be6.jijifun.com,20,0.00%,20,0,100.00%
sdkconfig.ad.xiaomi.com,20,0.00%,20,0,100.00%
business.qqpy.sogou.com,20,0.00%,20,0,100.00%
fmt1.link.ac.cn,20,0.00%,20,0,100.00%
1106-ipv4e.clump.dprodmgd106.aa-rt.sharepoint.com,20,0.00%,20,0,100.00%
support.content.office.net,20,0.00%,20,0,100.00%
fa000000043.resources.office.net,20,0.00%,42,22,47.62%
nbsdk-baichuan.alicdn.com,20,0.00%,20,0,100.00%
dm.video.qq.com,20,0.00%,20,0,100.00%
netlink-sigma.proxima.nie.netease.com,20,0.00%,20,0,100.00%
proxy-state.nie.netease.com,20,0.00%,20,0,100.00%
lf3-short.bytegoofy.com,20,0.00%,26,6,76.92%
dsm04pap001.storage.live.com,20,0.00%,35,15,57.14%
s13.upd.kaspersky.com,20,0.00%,20,0,100.00%
ipservice.ws.126.net,20,0.00%,20,0,100.00%
11.courier-push-apple.com.akadns.net,20,0.00%,20,0,100.00%
ct.duba.net,20,0.00%,20,0,100.00%
p3-tt.byteimg.com.w.cdngslb.com,20,0.00%,24,4,83.33%
lf3-csp.bytetos.com.w.cdngslb.com,20,0.00%,23,3,86.96%
sf3-cdn-tos.toutiaostatic.com.w.cdngslb.com,20,0.00%,23,3,86.96%
p3.toutiaoimg.com.w.cdngslb.com,20,0.00%,23,3,86.96%
sf3-cdn-tos.douyinstatic.com,20,0.00%,25,5,80.00%
qup.b.360wscdn.com,20,0.00%,20,0,100.00%
consumerapps-prod-53.awscommon.mcafee.com,20,0.00%,20,0,100.00%
ms-toolsai.gallerycdn.azure.cn,20,0.00%,20,0,100.00%
ota.nvidia.com,20,0.00%,20,0,100.00%
r3---sn-2x3elnee.gvt1.com,20,0.00%,20,0,100.00%
s1.ssl.qhres2.com,20,0.00%,27,7,74.07%
applog.uc.cn,20,0.00%,20,0,100.00%
img-blog.csdn.net,20,0.00%,20,0,100.00%
bszs.conac.cn,20,0.00%,20,0,100.00%
datacluster5.cipsup.cn,20,0.00%,20,0,100.00%
fundact.eastmoney.com,20,0.00%,41,21,48.78%
sso.1234567.com.cn,20,0.00%,20,0,100.00%
events-drcn.op.dbankcloud.cn,20,0.00%,20,0,100.00%
pdata.log.mgtv.com,20,0.00%,20,0,100.00%
tracker.skyts.net,20,0.00%,20,0,100.00%
www.sa-update.pccc.com,20,0.00%,20,0,100.00%
kmrcdn.service.kugou.com,20,0.00%,20,0,100.00%
login.psvr.wps.cn,20,0.00%,20,0,100.00%
saascdn.lenovo.com.cn,20,0.00%,20,0,100.00%
pics0.baidu.com,20,0.00%,28,8,71.43%
goproxy.cn,20,0.00%,20,0,100.00%
189-213-210-132.static.axtel.net,20,0.00%,20,0,100.00%
www.zhixi.com,20,0.00%,20,0,100.00%
p204-quota.icloud.com.cn,20,0.00%,20,0,100.00%
250.218.133.34.bc.googleusercontent.com,20,0.00%,20,0,100.00%
16.au.download.windowsupdate.com,20,0.00%,20,0,100.00%
s.ssl.qhres2.com,20,0.00%,26,6,76.92%
228-27.ip.citynet.uz,20,0.00%,20,0,100.00%
opencdnpicrmb.jomodns.com,20,0.00%,29,9,68.97%
debug.anuson.com,20,0.00%,20,0,100.00%
42-200-11-53.static.imsbiz.com,20,0.00%,20,0,100.00%
curlsshop.nl,20,0.00%,20,0,100.00%
dsl-emcali-190.99.178.145.emcali.net.co,20,0.00%,20,0,100.00%
s-0001.s-msedge.net,19,0.00%,36,17,52.78%
gsas.idms-apple.com.akadns.net,19,0.00%,19,0,100.00%
config.edge.skype.com,19,0.00%,1474,1455,1.29%
bl3301.storage.live.com,19,0.00%,29,10,65.52%
prebid.a-mo.net,19,0.00%,19,0,100.00%
apa.vap.lijit.com,19,0.00%,19,0,100.00%
server1.9sheng.cn,19,0.00%,19,0,100.00%
dsp-impr2.youdao.com,19,0.00%,19,0,100.00%
anisaishuu.de,19,0.00%,19,0,100.00%
drive.kdocs.cn,19,0.00%,43,24,44.19%
bubu.mapfactor.com,19,0.00%,19,0,100.00%
learning.u.wpscdn.cn,19,0.00%,39,20,48.72%
v5.360game.360.cn,19,0.00%,19,0,100.00%
dfzximg02.dftoutiao.com,19,0.00%,19,0,100.00%
krgame03.graniterapids.com,19,0.00%,19,0,100.00%
basictransl.wps.cn,19,0.00%,19,0,100.00%
t7.baidu.com.a.bdydns.com,19,0.00%,29,10,65.52%
hectorstatic.baidu.com.a.bdydns.com,19,0.00%,36,17,52.78%
pics3.baidu.com,19,0.00%,26,7,73.08%
mail.arubafin.com,19,0.00%,19,0,100.00%
e11271.dscg.akamaiedge.net,19,0.00%,38,19,50.00%
push-rtmp-l1-cny.douyincdn.com.wsdvs.com,19,0.00%,19,0,100.00%
pull-rtmp-l6-cny.douyincdn.com,19,0.00%,30,11,63.33%
pull-fcdn-douyin-base1.s.bytefcdn.com,19,0.00%,19,0,100.00%
pull-flv-vr-l11.douyincdn.com.sched.l9.tdnsv5.com,19,0.00%,19,0,100.00%
push-rtmp-l1-hs.pstatp.com.wsdvs.com,19,0.00%,19,0,100.00%
client-teamviewer-com.trafficmanager.net,19,0.00%,19,0,100.00%
4.courier-push-apple.com.akadns.net,19,0.00%,19,0,100.00%
44-courier.push.apple.com,19,0.00%,19,0,100.00%
a1834.dscg2.akamai.net,19,0.00%,39,20,48.72%
push-rtmp-vr-l11.douyincdn.com,19,0.00%,19,0,100.00%
push-rtmp-l1.ixigua.com,19,0.00%,19,0,100.00%
push-rtmp-l3.douyincdn.com,19,0.00%,19,0,100.00%
pull-flv-l1.ixigua.com,19,0.00%,19,0,100.00%
25.courier-push-apple.com.akadns.net,19,0.00%,19,0,100.00%
s14-sync.firefox.com.cn,19,0.00%,19,0,100.00%
APAC03.azure-devices.net,19,0.00%,19,0,100.00%
clientnotification-userprodscus1-7.servicebus.windows.net,19,0.00%,19,0,100.00%
findermp.video.qq.com,19,0.00%,45,26,42.22%
member.bilibili.com,19,0.00%,22,3,86.36%
img2.baidu.com,19,0.00%,19,0,100.00%
api.crossref.org,19,0.00%,19,0,100.00%
img1.pcfg.cache.wpscdn.cn,19,0.00%,41,22,46.34%
iadsdk.qtlcdn.com,19,0.00%,19,0,100.00%
47.courier-push-apple.com.akadns.net,19,0.00%,19,0,100.00%
bj-a.bcebos.com.n.shifen.com,19,0.00%,19,0,100.00%
passport.csdn.net,19,0.00%,19,0,100.00%
ws.mmstat.com,19,0.00%,19,0,100.00%
report.meeting.tencent.com,19,0.00%,33,14,57.58%
pull-l3-cny.douyincdn.com,19,0.00%,21,2,90.48%
pull-spe-l3.douyincdn.com,19,0.00%,19,0,100.00%
pull-flv-l1-hs.pstatp.com,19,0.00%,19,0,100.00%
pull-hs-spe-f5.douyincdn.com,19,0.00%,19,0,100.00%
kr10.graniterapids.com,19,0.00%,19,0,100.00%
nplserver.kuwo.cn,19,0.00%,19,0,100.00%
cloud.tenable.com,19,0.00%,19,0,100.00%
e12358.g.akamaiedge.net,19,0.00%,19,0,100.00%
6.courier-push-apple.com.akadns.net,19,0.00%,19,0,100.00%
14.courier-push-apple.com.akadns.net,19,0.00%,19,0,100.00%
45.courier-push-apple.com.akadns.net,19,0.00%,19,0,100.00%
weu015-breeziest-in.cloudapp.net,19,0.00%,19,0,100.00%
a-0019.standard.a-msedge.net,19,0.00%,19,0,100.00%
onedscolprduks01.uksouth.cloudapp.azure.com,19,0.00%,35,16,54.29%
43.courier-push-apple.com.akadns.net,19,0.00%,19,0,100.00%
toolbar-prod-bn01.microsoft.com,19,0.00%,19,0,100.00%
lzupdate.mbgcdn.lenovo.com.cn,19,0.00%,19,0,100.00%
zjueducn.sharepoint.com,19,0.00%,19,0,100.00%
zjueducn-my.sharepoint.com,19,0.00%,19,0,100.00%
opencdnbdfctn.jomodns.com,19,0.00%,19,0,100.00%
startpage.ic.ksosoft.com,19,0.00%,19,0,100.00%
nadvideo2.baidu.com,19,0.00%,26,7,73.08%
32-courier.push.apple.com,19,0.00%,19,0,100.00%
15.courier-push-apple.com.akadns.net,19,0.00%,19,0,100.00%
master.wap.dphub.sandai.net,19,0.00%,19,0,100.00%
g1max.mediav.com,19,0.00%,19,0,100.00%
www.xiaohongshu.com,19,0.00%,19,0,100.00%
pv.sohu.com,19,0.00%,19,0,100.00%
lcdn-locator-usms11.apple.com.akadns.net,19,0.00%,19,0,100.00%
opencdnsslv6.jomodns.com,19,0.00%,41,22,46.34%
wikipedia.firstpartyapps.oaspapps.com,19,0.00%,19,0,100.00%
logincdn.msauth.net,19,0.00%,19,0,100.00%
csd-apt-eas-d-4.eastasia.cloudapp.azure.com,19,0.00%,19,0,100.00%
ib.adnxs.com,19,0.00%,19,0,100.00%
d3e5zkjv0mw5t1.cloudfront.net,19,0.00%,19,0,100.00%
www.douyin.com,19,0.00%,19,0,100.00%
pb.sogou.com,19,0.00%,19,0,100.00%
avee5je0.nodedata.net,19,0.00%,19,0,100.00%
v7event.stats.avast.com,19,0.00%,19,0,100.00%
newstock.finance.qq.com,19,0.00%,19,0,100.00%
onedriveclucprodbn20019.blob.core.windows.net,19,0.00%,19,0,100.00%
stun.hitv.com,19,0.00%,19,0,100.00%
officeci-mauservice.azurewebsites.net,19,0.00%,19,0,100.00%
bnz05pap002.storage.live.com,19,0.00%,35,16,54.29%
javadl-esd-secure.oracle.com,19,0.00%,19,0,100.00%
wm.xiajunhuagong.cn,19,0.00%,19,0,100.00%
www.iqiyi.com,19,0.00%,44,25,43.18%
live-trace.bilibili.com,19,0.00%,21,2,90.48%
radarsubmissions.apple.com,19,0.00%,19,0,100.00%
34.courier-push-apple.com.akadns.net,19,0.00%,19,0,100.00%
api.fund.eastmoney.com,19,0.00%,19,0,100.00%
5d3fe70bad5446adb47e56e9e99c1a97-cn-beijing.alicloudapi.com,19,0.00%,19,0,100.00%
agent.sj.qq.com,19,0.00%,19,0,100.00%
live-s3m.mediav.com,19,0.00%,19,0,100.00%
p212-caldav.icloud.com.cn,19,0.00%,19,0,100.00%
www.scootersoftware.com,19,0.00%,19,0,100.00%
img01.sogoucdn.com,19,0.00%,19,0,100.00%
adashbc.ut.taobao.com,19,0.00%,19,0,100.00%
yt3.ggpht.com,19,0.00%,19,0,100.00%
tb2.bdstatic.com,19,0.00%,20,1,95.00%
ip.lx.netease.com,19,0.00%,19,0,100.00%
opencdnbaiduapp.jomodns.com,19,0.00%,29,10,65.52%
ins-gk5vby51.ias.tencent-cloud.net,19,0.00%,19,0,100.00%
sites.google.com,19,0.00%,38,19,50.00%
gs.apple.com,19,0.00%,19,0,100.00%
s3m4.fenxi.com,19,0.00%,21,2,90.48%
adstrategy.biz.weibo.com,19,0.00%,19,0,100.00%
cpe-173-88-248-240.neo.res.rr.com,19,0.00%,19,0,100.00%
st2-v3-dc.splashtop.com,19,0.00%,19,0,100.00%
tuna03.mcddns01.com,19,0.00%,19,0,100.00%
log.he2d.com,19,0.00%,19,0,100.00%
browser.events.data.trafficmanager.net,18,0.00%,19,1,94.74%
push-vol-base.s.volcfcdndvs.com,18,0.00%,18,0,100.00%
c2shb.one-mobile-prod.aws.oath.cloud,18,0.00%,18,0,100.00%
eddie4.nl,18,0.00%,18,0,100.00%
ads.themoneytizer.com,18,0.00%,48,30,37.50%
mp.360.cn,18,0.00%,18,0,100.00%
onedscolprdjpe04.japaneast.cloudapp.azure.com,18,0.00%,18,0,100.00%
dm2306.storage.live.com,18,0.00%,29,11,62.07%
pull-rtmp-l1-hs.pstatp.com.wsdvs.com,18,0.00%,18,0,100.00%
push-rtmp-spe-l6.douyincdn.com,18,0.00%,18,0,100.00%
push-rtmp-l1.douyincdn.com.wsdvs.com,18,0.00%,18,0,100.00%
playclient.douyucdn.cn,18,0.00%,18,0,100.00%
gift.douyucdn.cn,18,0.00%,23,5,78.26%
adashx.ut.ele.me,18,0.00%,18,0,100.00%
pics7.baidu.com,18,0.00%,28,10,64.29%
e191.b.akamaiedge.net,18,0.00%,18,0,100.00%
apis.google.com,18,0.00%,19,1,94.74%
p208-contacts.icloud.com.cn,18,0.00%,18,0,100.00%
3scpuqeq.sched.sma.tdnsstic1.cn,18,0.00%,18,0,100.00%
kt-prod.v.aaplimg.com,18,0.00%,18,0,100.00%
29-courier.push.apple.com,18,0.00%,18,0,100.00%
push-rtmp-l1-cny.douyincdn.com,18,0.00%,18,0,100.00%
pull-lls-l26.douyincdn.com.c.cdnhwc3.com,18,0.00%,18,0,100.00%
webrtc.liveplay.myqcloud.com,18,0.00%,18,0,100.00%
push-rtmp-l3-cny.douyincdn.com,18,0.00%,18,0,100.00%
push-fcdn-base.s.bytefcdn.com,18,0.00%,18,0,100.00%
pull-flv-f11.douyincdn.com.sched.l8.tdnsv5.com,18,0.00%,18,0,100.00%
push-rtmp-l3-enc.douyincdn.com,18,0.00%,18,0,100.00%
pull-lls-l3.douyincdn.com.w.cdngslb.com,18,0.00%,18,0,100.00%
v1.douyinvod.com,18,0.00%,18,0,100.00%
waws-prod-hk1-037.sip.azurewebsites.windows.net,18,0.00%,18,0,100.00%
dpm.demdex.net,18,0.00%,18,0,100.00%
hk4e-api.mihoyo.com,18,0.00%,18,0,100.00%
onedscolprdneu06.northeurope.cloudapp.azure.com,18,0.00%,18,0,100.00%
mailn2sk.message.cmbchina.com,18,0.00%,18,0,100.00%
mailn3qh.message.cmbchina.com,18,0.00%,18,0,100.00%
mailn7sh.message.cmbchina.com,18,0.00%,18,0,100.00%
mailn6sk.message.cmbchina.com,18,0.00%,18,0,100.00%
mailn3sh.message.cmbchina.com,18,0.00%,18,0,100.00%
mailn5qh.message.cmbchina.com,18,0.00%,18,0,100.00%
mailn5sh.message.cmbchina.com,18,0.00%,18,0,100.00%
mailn8sk.message.cmbchina.com,18,0.00%,18,0,100.00%
mailn3sz.message.cmbchina.com,18,0.00%,18,0,100.00%
mailn4sz.message.cmbchina.com,18,0.00%,18,0,100.00%
pull-flv-spe-l11.douyincdn.com,18,0.00%,18,0,100.00%
push-rtmp-vr-l26.douyincdn.com,18,0.00%,18,0,100.00%
krgame04.graniterapids.com,18,0.00%,18,0,100.00%
array810.prod.do.dsp.mp.microsoft.com,18,0.00%,18,0,100.00%
deff.nelreports.net,18,0.00%,40,22,45.00%
wpvip.duba.net,18,0.00%,18,0,100.00%
realprotect1.mcafee.com,18,0.00%,18,0,100.00%
iadsdk.apple.com,18,0.00%,18,0,100.00%
beacons6.gvt2.com,18,0.00%,34,16,52.94%
www.newsmth.net,18,0.00%,18,0,100.00%
e2875.d.akamaiedge.net,18,0.00%,18,0,100.00%
push-rtmp-l11-cny.douyincdn.com,18,0.00%,18,0,100.00%
push-rtmp-l6-cny.douyincdn.com,18,0.00%,18,0,100.00%
pull-hls-f6.douyincdn.com,18,0.00%,18,0,100.00%
pull-hls-vr-l11.douyincdn.com,18,0.00%,18,0,100.00%
pull-flv-spe-l26.douyincdn.com,18,0.00%,18,0,100.00%
s.search.bilibili.com,18,0.00%,20,2,90.00%
2-courier.push.apple.com,18,0.00%,18,0,100.00%
res.wx.qq.com.sched.legopic1-dk.tdnsv6.com,18,0.00%,38,20,47.37%
mountain.zhidao.baidu.com,18,0.00%,18,0,100.00%
s1.bdstatic.com,18,0.00%,18,0,100.00%
onedscolprduks04.uksouth.cloudapp.azure.com,18,0.00%,36,18,50.00%
is-ssl.mzstatic.com-cn-lb.itunes-apple.com.akadns.net,18,0.00%,19,1,94.74%
ns3.abudhabi.ae,18,0.00%,18,0,100.00%
195863-ipv4e.farm.dprodmgd106.sharepointonline.com.akadns.net,18,0.00%,18,0,100.00%
iesoh0fa.nodedata.net,18,0.00%,18,0,100.00%
repo.scala-sbt.org,18,0.00%,18,0,100.00%
rog-live-service.asus.com,18,0.00%,18,0,100.00%
k128-updates.gslb.ksyuncdn.com,18,0.00%,18,0,100.00%
bf.pinyin.sogou.com,18,0.00%,18,0,100.00%
sdk.ai.wpscdn.cn,18,0.00%,18,0,100.00%
dnhddvnqvvd1g.cloudfront.net,18,0.00%,36,18,50.00%
tls-amap.dingtalk.com,18,0.00%,18,0,100.00%
www.duba.com,18,0.00%,30,12,60.00%
gs-loc-new.ls-apple.com.akadns.net,18,0.00%,18,0,100.00%
adsmind.gdtimg.com,18,0.00%,42,24,42.86%
data.eastmoney.com,18,0.00%,39,21,46.15%
mail.ke.com,18,0.00%,18,0,100.00%
cs500.wpc.phicdn.net,18,0.00%,18,0,100.00%
phsle5-young.oray.net,18,0.00%,18,0,100.00%
adashx.ut.cainiao.com,18,0.00%,18,0,100.00%
opencdnv6.jomodns.com,18,0.00%,39,21,46.15%
api.frdic.com,18,0.00%,18,0,100.00%
registry.npm.taobao.org,18,0.00%,18,0,100.00%
assets.giocdn.com,18,0.00%,18,0,100.00%
lf3-cdn2-tos.bytescm.com,18,0.00%,22,4,81.82%
p3.toutiaoimg.com,18,0.00%,22,4,81.82%
lf3-csp.bytetos.com,18,0.00%,22,4,81.82%
cs.10jqka.com.cn,18,0.00%,18,0,100.00%
wenku.baidu.com,18,0.00%,18,0,100.00%
eyesguard-cdn.cmcm.com,18,0.00%,18,0,100.00%
ipinfo.io,18,0.00%,18,0,100.00%
mask-api.fe.apple-dns.net,18,0.00%,41,23,43.90%
legionzone.lenovo.com,18,0.00%,18,0,100.00%
cdn-ali-file-shfront.shanhutech.cn,18,0.00%,18,0,100.00%
vip.vas.wpsdns.com,18,0.00%,18,0,100.00%
r3---sn-2x3elnes.gvt1.com,18,0.00%,18,0,100.00%
file.cmbimg.com,18,0.00%,18,0,100.00%
seal-api.bytedance.net,18,0.00%,18,0,100.00%
34-courier.push.apple.com,18,0.00%,18,0,100.00%
s4.cnzz.com,18,0.00%,18,0,100.00%
goash5ae.nodedata.net,18,0.00%,18,0,100.00%
mq.dataservices.hp.com,18,0.00%,18,0,100.00%
upd2.sangfor.com.cn,18,0.00%,18,0,100.00%
open.tracker.ink,18,0.00%,18,0,100.00%
webtim.msf.tencent-cloud.com,18,0.00%,18,0,100.00%
hbrt.adobe.com,18,0.00%,18,0,100.00%
s0.2mdn.net,18,0.00%,18,0,100.00%
pics4.baidu.com,18,0.00%,27,9,66.67%
tracker.swarm3.network,18,0.00%,18,0,100.00%
httpsdns.n.shifen.com,18,0.00%,18,0,100.00%
maponline3.bdimg.com,18,0.00%,21,3,85.71%
mediago-static.cdn.bcebos.com,18,0.00%,18,0,100.00%
sep.ucas.ac.cn,18,0.00%,33,15,54.55%
pic2.iqiyipic.com,18,0.00%,34,16,52.94%
cdn.redhat.com,18,0.00%,18,0,100.00%
upload2.fp.measure.office.com,18,0.00%,31,13,58.06%
pcdn-proxy-crc.xxpkg.com,18,0.00%,18,0,100.00%
query.prod.cms.rt.microsoft.com,18,0.00%,18,0,100.00%
juniper,18,0.00%,18,0,100.00%
alibj-sec-compete-registry.cn-beijing.cr.aliyuncs.com,18,0.00%,18,0,100.00%
s8-sync.firefox.com.cn,18,0.00%,18,0,100.00%
s.thsi.cn,18,0.00%,18,0,100.00%
disk.maikebuke.com,18,0.00%,18,0,100.00%
cd.jd.com,17,0.00%,17,0,100.00%
newtab.browser.qq.com,17,0.00%,17,0,100.00%
xms.17win.com,17,0.00%,17,0,100.00%
tracker.tiny-vps.com,17,0.00%,17,0,100.00%
pull-rtmp-l1-hs.pstatp.com,17,0.00%,17,0,100.00%
u01-ml.gslb.ksyuncdn.com,17,0.00%,17,0,100.00%
pull-rtmp-l1.ixigua.com.wsdvs.com,17,0.00%,17,0,100.00%
pull-f3-proxy.douyincdn.com.w.alikunlun.net,17,0.00%,17,0,100.00%
l-rcd.iqiyi.com,17,0.00%,43,26,39.53%
conn.meeting.work.weixin.qq.com,17,0.00%,17,0,100.00%
a.goscreenshotting.com,17,0.00%,17,0,100.00%
prod.odcsm1.live.com.akadns.net,17,0.00%,17,0,100.00%
p2p.hd.sohu.com.cn,17,0.00%,17,0,100.00%
lls-douyin.cloudrtc.myhuaweicloud.com,17,0.00%,17,0,100.00%
webrtc.liveplay.myqcloud.com.sched.webrtc.tdnsv5.com,17,0.00%,17,0,100.00%
pull-fcdn-douyin-base3.s.bytefcdn.com,17,0.00%,17,0,100.00%
pull-flv-spe-l11.douyincdn.com.sched.l9.tdnsv5.com,17,0.00%,17,0,100.00%
2852517.sched.v1lego.tdnsvod1.cn,17,0.00%,17,0,100.00%
pull-hls-vr-l11.douyincdn.com.sched.l9.tdnsv5.com,17,0.00%,17,0,100.00%
pull-flv-l1-hs.pstatp.com.wsdvs.com,17,0.00%,17,0,100.00%
cde-prod-eastasia.azurewebsites.net,17,0.00%,17,0,100.00%
messaging.awsmcafeeccs.mcafee.com,17,0.00%,17,0,100.00%
8-courier.push.apple.com,17,0.00%,17,0,100.00%
cm.everesttech.net,17,0.00%,17,0,100.00%
v.xiaohongshu.com,17,0.00%,32,15,53.12%
kns.cnki.net,17,0.00%,17,0,100.00%
cseupdate.360safe.com,17,0.00%,17,0,100.00%
push-rtmp-l27.douyincdn.com,17,0.00%,17,0,100.00%
push-rtmp-l26-cny.douyincdn.com,17,0.00%,17,0,100.00%
mailn7qh.message.cmbchina.com,17,0.00%,17,0,100.00%
mailn1qh.message.cmbchina.com,17,0.00%,17,0,100.00%
mailn4sh.message.cmbchina.com,17,0.00%,17,0,100.00%
mail2.message.cmbchina.com,17,0.00%,17,0,100.00%
mailh2.message.cmbchina.com,17,0.00%,17,0,100.00%
mailn1sz.message.cmbchina.com,17,0.00%,17,0,100.00%
push-rtmp-l11-encryption.douyincdn.com,17,0.00%,17,0,100.00%
d2us8jqsezvhge.cloudfront.net,17,0.00%,17,0,100.00%
canonical-bos01.cdn.snapcraftcontent.com,17,0.00%,17,0,100.00%
cdn.content.prod.cms.msn.com.edgekey.net,17,0.00%,38,21,44.74%
g.msn.com,17,0.00%,34,17,50.00%
autopush.prod.mozaws.NET,17,0.00%,17,0,100.00%
toutiao.com,17,0.00%,17,0,100.00%
img.nga.178.com,17,0.00%,17,0,100.00%
pull-flv-f26.douyincdn.com,17,0.00%,22,5,77.27%
push-rtmp-f5-enc.douyincdn.com,17,0.00%,17,0,100.00%
pull-lls-l3.douyincdn.com,17,0.00%,17,0,100.00%
m.xinminweekly.com.cn,17,0.00%,17,0,100.00%
csc3-2010-crl.verisign.com,17,0.00%,32,15,53.12%
tracker.hdsky.me,17,0.00%,34,17,50.00%
appdl-2-drcn.dbankcdn.com,17,0.00%,17,0,100.00%
hao1.qhimg.com,17,0.00%,46,29,36.96%
tracker3.ctix.cn,17,0.00%,17,0,100.00%
weu012-breeziest-in.cloudapp.net,17,0.00%,17,0,100.00%
pbg0.market.xiaomi.com,17,0.00%,18,1,94.44%
ns3.cstnet.cn,17,0.00%,17,0,100.00%
wu-fg-shim.trafficmanager.net,17,0.00%,18,1,94.44%
font.docer.wps.cn,17,0.00%,17,0,100.00%
online.user.maxthon.cn,17,0.00%,17,0,100.00%
i1.cwip.eset.com,17,0.00%,17,0,100.00%
store1.hispace.hicloud.com,17,0.00%,17,0,100.00%
csd-apt-eas-d-1.eastasia.cloudapp.azure.com,17,0.00%,17,0,100.00%
4-courier.push.apple.com,17,0.00%,17,0,100.00%
newlyric.kuwo.cn,17,0.00%,17,0,100.00%
btinstall-artifacts.bittorrent.com,17,0.00%,32,15,53.12%
whoami.nie.netease.com,17,0.00%,17,0,100.00%
openweathermap.org,17,0.00%,17,0,100.00%
bai7oobe.nodedata.net,17,0.00%,17,0,100.00%
deb.nodesource.com,17,0.00%,34,17,50.00%
s.url.cn,17,0.00%,34,17,50.00%
crl.globalsign.net,17,0.00%,17,0,100.00%
uci.edog.cdn.office.net,17,0.00%,34,17,50.00%
phfwba-pro-g3.oray.net,17,0.00%,17,0,100.00%
fc5tn.baidu.com,17,0.00%,17,0,100.00%
by3302.storage.live.com,17,0.00%,27,10,62.96%
so.toutiao.com,17,0.00%,17,0,100.00%
p6-sign.toutiaoimg.com,17,0.00%,17,0,100.00%
g.cn.miaozhen.com,17,0.00%,17,0,100.00%
snz04pap001.storage.live.com,17,0.00%,27,10,62.96%
common-us.onedrive.akadns.net,17,0.00%,17,0,100.00%
s5.ssl.qhres2.com,17,0.00%,22,5,77.27%
s0.ssl.qhimg.com,17,0.00%,23,6,73.91%
hao2.qhimg.com,17,0.00%,46,29,36.96%
audid-api.taobao.com,17,0.00%,17,0,100.00%
www.googleadservices.com,17,0.00%,17,0,100.00%
mail.ucas.ac.cn,17,0.00%,17,0,100.00%
evoke-windowsservices-tas-msedge-net.e-0009.e-msedge.net,17,0.00%,17,0,100.00%
upos-sz-mirrorcosb.bilivideo.com,17,0.00%,34,17,50.00%
sat02pap001.storage.live.com,17,0.00%,30,13,56.67%
analytics.cnblogs.com,17,0.00%,17,0,100.00%
wap.n.shifen.com,17,0.00%,17,0,100.00%
2.fedora.pool.ntp.org,17,0.00%,24,7,70.83%
5.courier-push-apple.com.akadns.net,17,0.00%,17,0,100.00%
mixv4-21.194610.xyz,17,0.00%,17,0,100.00%
dp.im.weibo.cn,17,0.00%,17,0,100.00%
perfdata.portswigger.net,17,0.00%,17,0,100.00%
nisc.nfschina.com,17,0.00%,17,0,100.00%
www.iscas.ac.cn,17,0.00%,17,0,100.00%
ada.e.shifen.com,17,0.00%,17,0,100.00%
connectivitycheck.platform.hicloud.com.80800000.c.cdnhwc1.com,17,0.00%,39,22,43.59%
uspider.yuanshen.com,17,0.00%,17,0,100.00%
eclick.e.shifen.com,17,0.00%,17,0,100.00%
wn.pos.e.shifen.com,17,0.00%,17,0,100.00%
oauth-login-drcn.platform.dbankcloud.com,17,0.00%,17,0,100.00%
tracker1.torrentino.com,17,0.00%,17,0,100.00%
win-crashdump-upload-1255554080.cos.ap-beijing.myqcloud.com,17,0.00%,17,0,100.00%
rt.services.visualstudio.com,17,0.00%,17,0,100.00%
ip2091219983.funshion.com,17,0.00%,17,0,100.00%
work.exmail.qq.com,17,0.00%,17,0,100.00%
push-rtmp-vr-l6.douyincdn.com,16,0.00%,16,0,100.00%
u01.gslb.ksyuncdn.com,16,0.00%,16,0,100.00%
henbt.com,16,0.00%,16,0,100.00%
img30.360buyimg.com,16,0.00%,30,14,53.33%
wl.jd.com,16,0.00%,29,13,55.17%
px.ads.linkedin.com,16,0.00%,16,0,100.00%
driverupdate.lenovo.com.cn,16,0.00%,34,18,47.06%
onedriveclucproddm20009.blob.core.windows.net,16,0.00%,16,0,100.00%
7223175.l2.sched.dcloudlive.com,16,0.00%,16,0,100.00%
pull-rtmp-l11-cny.douyincdn.com.sched.l9.tdnsv5.com,16,0.00%,16,0,100.00%
weather.noaa.gov,16,0.00%,16,0,100.00%
rpic.douyucdn.cn,16,0.00%,20,4,80.00%
yuba.douyu.com,16,0.00%,20,4,80.00%
c.s.360.cn,16,0.00%,19,3,84.21%
vpn.xidian.edu.cn,16,0.00%,16,0,100.00%
36.courier-push-apple.com.akadns.net,16,0.00%,16,0,100.00%
hcdnl.push.gslb.c.cdnhwc2.com,16,0.00%,16,0,100.00%
pull-flv-l6-source.douyincdn.com,16,0.00%,28,12,57.14%
hcdnl.pulldyin.f26.gslb.c.cdnhwc2.com,16,0.00%,22,6,72.73%
pull-hls-f5-enc.flive.douyincdn.com.w.kunluncan.com,16,0.00%,20,4,80.00%
push-rtmp-vr-l1.douyincdn.com.wsdvs.com,16,0.00%,16,0,100.00%
pull-hls-f5-vs-tsl.douyincdn.com.w.kunluncan.com,16,0.00%,24,8,66.67%
pull-flv-l29.douyincdn.com.ucloud.com.cn,16,0.00%,16,0,100.00%
push-rtmp-spe-l3.douyincdn.com,16,0.00%,16,0,100.00%
pull-rtmp-l1-cny.douyincdn.com.wsdvs.com,16,0.00%,16,0,100.00%
waws-prod-hk1-037-8347.eastasia.cloudapp.azure.com,16,0.00%,16,0,100.00%
ade.googlesyndication.com,16,0.00%,16,0,100.00%
onedscolprdjpe05.japaneast.cloudapp.azure.com,16,0.00%,16,0,100.00%
app.mcafee.com,16,0.00%,16,0,100.00%
log.cmbchina.com,16,0.00%,16,0,100.00%
settings-ssl.xboxlive.com,16,0.00%,37,21,43.24%
cdn.sstatic.net,16,0.00%,16,0,100.00%
1251524319.vod2.myqcloud.com,16,0.00%,16,0,100.00%
c.jia.mn,16,0.00%,16,0,100.00%
uf-api6-client.ksord.com,16,0.00%,16,0,100.00%
13.courier-push-apple.com.akadns.net,16,0.00%,16,0,100.00%
44.courier-push-apple.com.akadns.net,16,0.00%,16,0,100.00%
lbs.netease.im,16,0.00%,16,0,100.00%
push-rtmp-l6-hs.pstatp.com,16,0.00%,16,0,100.00%
pull-l3-hs.pstatp.com,16,0.00%,16,0,100.00%
pull-flv-l6-enc.douyincdn.com,16,0.00%,26,10,61.54%
mailh1.message.cmbchina.com,16,0.00%,16,0,100.00%
mail.message.cmbchina.com,16,0.00%,16,0,100.00%
push-rtmp-spe-l26.douyincdn.com,16,0.00%,16,0,100.00%
push-rtmp-spe-l1.douyincdn.com,16,0.00%,16,0,100.00%
cn-0001.cn-msedge.net,16,0.00%,16,0,100.00%
client-api.itunes.apple.com,16,0.00%,25,9,64.00%
p212-contacts.icloud.com.cn,16,0.00%,16,0,100.00%
42.courier-push-apple.com.akadns.net,16,0.00%,16,0,100.00%
settings-bd.feishu.cn.w.cdngslb.com,16,0.00%,16,0,100.00%
baikebcs.cdn.bcebos.com,16,0.00%,16,0,100.00%
photocdn.hd.sohu.com,16,0.00%,32,16,50.00%
jtrn.is.autonavi.com.gds.alibabadns.com,16,0.00%,16,0,100.00%
omnatuor.com,16,0.00%,16,0,100.00%
archive1.kylinos.cn,16,0.00%,16,0,100.00%
pull-flv-l3-enc.douyincdn.com,16,0.00%,16,0,100.00%
pull-rtmp-f96.douyincdn.com,16,0.00%,16,0,100.00%
pull-f3-hs.pstatp.com,16,0.00%,16,0,100.00%
odin.adobe.com,16,0.00%,16,0,100.00%
le3-api.game.bilibili.com,16,0.00%,16,0,100.00%
www.douban.com,16,0.00%,16,0,100.00%
misc.xinmin.cn,16,0.00%,16,0,100.00%
tongji.xinmin.cn,16,0.00%,16,0,100.00%
10.courier-push-apple.com.akadns.net,16,0.00%,16,0,100.00%
8.courier-push-apple.com.akadns.net,16,0.00%,16,0,100.00%
umdc.alibaba-inc.com,16,0.00%,16,0,100.00%
31.courier-push-apple.com.akadns.net,16,0.00%,16,0,100.00%
update-haozip.2345.cc,16,0.00%,16,0,100.00%
lh5.googleusercontent.com,16,0.00%,17,1,94.12%
apis.mcafee.com,16,0.00%,16,0,100.00%
scrootca1.ocsp.secomtrust.net,16,0.00%,16,0,100.00%
ali-stats.jpush.cn,16,0.00%,16,0,100.00%
ns2.abudhabi.ae,16,0.00%,16,0,100.00%
content.dellsupportcenter.com,16,0.00%,16,0,100.00%
lzupdate.lenovo.com.cn.trpcdn.net,16,0.00%,16,0,100.00%
webb.jomodns.com,16,0.00%,16,0,100.00%
hao4.qhimg.com,16,0.00%,47,31,34.04%
p7.img.360kuai.com,16,0.00%,19,3,84.21%
s3m.mediav.com,16,0.00%,18,2,88.89%
pr.m.hub.sandai.net,16,0.00%,16,0,100.00%
webstatic.mihoyo.com,16,0.00%,16,0,100.00%
update.gamehall.2345.com,16,0.00%,16,0,100.00%
pc-update-3.wpscdn.cn,16,0.00%,16,0,100.00%
onedscolprdjpe00.japaneast.cloudapp.azure.com,16,0.00%,16,0,100.00%
update3.sangfor.net.cdn20.com,16,0.00%,16,0,100.00%
circlevideo2.photo.qq.com,16,0.00%,35,19,45.71%
dictionary.cambridge.org,16,0.00%,16,0,100.00%
nd8.baidupcs.com,16,0.00%,16,0,100.00%
ncomment.kuwo.cn,16,0.00%,16,0,100.00%
cc.map.qq.com,16,0.00%,16,0,100.00%
qqadapt.qpic.cn,16,0.00%,16,0,100.00%
2076077.sched.d0.tdnsdp1.cn,16,0.00%,16,0,100.00%
msfwifi.3g.qq.com,16,0.00%,16,0,100.00%
dsm01pap002.storage.live.com,16,0.00%,28,12,57.14%
update-ruanjian.2345.com,16,0.00%,16,0,100.00%
www.tm.lg.prod.aadmsa.akadns.net,16,0.00%,16,0,100.00%
encs.wpsdns.com,16,0.00%,16,0,100.00%
cms-bucket.ws.126.net,16,0.00%,16,0,100.00%
cdn.exp.xiaomi.com,16,0.00%,16,0,100.00%
beacon-api.aliyuncs.com,16,0.00%,29,13,55.17%
ice.alibaba-inc.com,16,0.00%,16,0,100.00%
cdnimg.3g.qq.com,16,0.00%,18,2,88.89%
wxa.wxs.qq.com,16,0.00%,17,1,94.12%
title.mgt.xboxlive.com,16,0.00%,32,16,50.00%
dsm01pap003.storage.live.com,16,0.00%,30,14,53.33%
developer.download.nvidia.cn.zengslb.com,16,0.00%,16,0,100.00%
e.so.com,16,0.00%,16,0,100.00%
api.mousegesturesapi.com,16,0.00%,16,0,100.00%
gw.alipayobjects.com.danuoyi.tbcache.com,16,0.00%,21,5,76.19%
onedriveclucprodbn20002.blob.core.windows.net,16,0.00%,16,0,100.00%
h11pqso5c0u27colehiqfve4oea16vh8poaptvd1ktb9k0bnatcfvt85.qc.x.bsgslb.cn,16,0.00%,16,0,100.00%
psg1-collabhubrtc.officeapps.live.com,16,0.00%,16,0,100.00%
p3.ssl.qhimgs0.com,16,0.00%,18,2,88.89%
client.apc.360.cn,16,0.00%,16,0,100.00%
list3.ppstream.com.iqiyi.com,16,0.00%,32,16,50.00%
phx02pap003.storage.live.com,16,0.00%,27,11,59.26%
25-courier.push.apple.com,16,0.00%,16,0,100.00%
st.music.163.com,16,0.00%,16,0,100.00%
hotlist.imtt.qq.com,16,0.00%,16,0,100.00%
theta.sogoucdn.com,16,0.00%,16,0,100.00%
bbs.nga.cn,16,0.00%,16,0,100.00%
ulink-pr-diskhealth.s3.amazonaws.com,16,0.00%,16,0,100.00%
account.cnblogs.com,16,0.00%,16,0,100.00%
count.cnblogs.com,16,0.00%,16,0,100.00%
r1---sn-2x3elnee.gvt1.com,16,0.00%,16,0,100.00%
tc-tct.douyucdn2.cn,16,0.00%,16,0,100.00%
dlswbr.baidu.com.cname3920.yjs-cdn.com,16,0.00%,26,10,61.54%
common-afdrk.fe.1drv.com,16,0.00%,22,6,72.73%
5v96heal.sched.d0.tdnsdp1.cn,16,0.00%,16,0,100.00%
pics5.baidu.com,16,0.00%,23,7,69.57%
maponline0.bdimg.com,16,0.00%,19,3,84.21%
app.smartmailcloud.com,16,0.00%,16,0,100.00%
macime.sogou.com,16,0.00%,16,0,100.00%
ws.mcafee.com,16,0.00%,16,0,100.00%
sub2.bgp.netarch-alisc1-edge-lb.l.bytedns.net,16,0.00%,16,0,100.00%
www.jd.com,16,0.00%,16,0,100.00%
push.zhanzhang.baidu.com,16,0.00%,16,0,100.00%
api.lxqp.360.cn,16,0.00%,16,0,100.00%
69-236-108-191.lightspeed.frokca.sbcglobal.net,16,0.00%,16,0,100.00%
static.qipao.pptv.com,16,0.00%,16,0,100.00%
ip1873674377.funshion.com,16,0.00%,16,0,100.00%
go.microsoft.com.edgekey.NET,16,0.00%,25,9,64.00%
s17.upd.kaspersky.com,16,0.00%,16,0,100.00%
d28dx6y1hfq314.cloudfront.net,16,0.00%,30,14,53.33%
d1ykf07e75w7ss.cloudfront.net,16,0.00%,16,0,100.00%
osr.pingan.com,16,0.00%,16,0,100.00%
quickpulse.prod.applicationinsights.trafficmanager.net,16,0.00%,16,0,100.00%
s16.upd.kaspersky.com,16,0.00%,16,0,100.00%
wemeet-log-1256380422.cos.ap-guangzhou.myqcloud.com,16,0.00%,16,0,100.00%
ledger.bt.co,16,0.00%,16,0,100.00%
news.sciencenet.cn,16,0.00%,16,0,100.00%
lcs-cops.adobe.io,15,0.00%,15,0,100.00%
mercury.jd.com,15,0.00%,26,11,57.69%
gia.jd.com,15,0.00%,27,12,55.56%
img14.360buyimg.com,15,0.00%,32,17,46.88%
movies.zsw.ca,15,0.00%,15,0,100.00%
yxdt.game.keniub.com,15,0.00%,21,6,71.43%
hub.upyun.com,15,0.00%,3502,3487,0.43%
pull-hs-f5.flive.huoshanlive.com.c.volcfcdndvs.com,15,0.00%,15,0,100.00%
4532841.pack.tcdnlive.com,15,0.00%,15,0,100.00%
pull-rtmp-f1.douyincdn.com.wsdvs.com,15,0.00%,15,0,100.00%
pull-rtmp-l1-source.douyincdn.com.wsdvs.com,15,0.00%,15,0,100.00%
a1488.dscd.akamai.net,15,0.00%,30,15,50.00%
www.meituan.com,15,0.00%,1134,1119,1.32%
apm.douyucdn.cn,15,0.00%,15,0,100.00%
mobile-gtalk.l.google.com,15,0.00%,38,23,39.47%
trackers.ibzu.me,15,0.00%,27,12,55.56%
api.msn.cn,15,0.00%,18,3,83.33%
cloudfont.docer.wps.cn,15,0.00%,15,0,100.00%
fanyi.baidu.com,15,0.00%,51,36,29.41%
bgp.netarch-bjlgy-edge-lb-v3.bjlgy.bytedns.net,15,0.00%,15,0,100.00%
docerad.wps.cn,15,0.00%,15,0,100.00%
pull-flv-l11-encryption.douyincdn.com.sched.l9.tdnsv5.com,15,0.00%,15,0,100.00%
jt.tlivepush3soct1douyin.tcdn.qq.com,15,0.00%,15,0,100.00%
push-rtmp-l1.ixigua.com.wsdvs.com,15,0.00%,15,0,100.00%
play.ulive.ugslb.com,15,0.00%,15,0,100.00%
pull-flv-l6-cny.douyincdn.com,15,0.00%,24,9,62.50%
pull-tsl-vr-l3.douyincdn.com.bytedns1.com,15,0.00%,15,0,100.00%
push-rtmp-l3-hs.pstatp.com,15,0.00%,15,0,100.00%
pull-hls-f5-tsl.douyincdn.com.w.cdngslb.com,15,0.00%,23,8,65.22%
pull-rtmp-f1-hs.pstatp.com.wsdvs.com,15,0.00%,15,0,100.00%
ipcdn.apple.com,15,0.00%,27,12,55.56%
xueshu.baidu.com,15,0.00%,27,12,55.56%
tracker.pimp4003.net,15,0.00%,15,0,100.00%
pull-hs-f5.flive.huoshanlive.com,15,0.00%,15,0,100.00%
push-rtmp-l11.douyincdn.com,15,0.00%,15,0,100.00%
mail1.message.cmbchina.com,15,0.00%,15,0,100.00%
pull-flv-l6.douyincdn.com,15,0.00%,18,3,83.33%
pull-tsl-vr-l1.douyincdn.com,15,0.00%,18,3,83.33%
pull-lls-spe-l6.douyincdn.com,15,0.00%,25,10,60.00%
ac.dun.163yun.com,15,0.00%,30,15,50.00%
onedriveclucprodbn20003.blob.core.windows.net,15,0.00%,15,0,100.00%
pay.bilibili.com,15,0.00%,16,1,93.75%
share.jomodns.com,15,0.00%,15,0,100.00%
qing.wpsdns.com,15,0.00%,15,0,100.00%
wechat.intelcupid.com,15,0.00%,15,0,100.00%
upos-sz-staticcos-cmask.bilivideo.com,15,0.00%,39,24,38.46%
open.e.kuaishou.com,15,0.00%,15,0,100.00%
ts-ocsp.ws.symantec.com,15,0.00%,30,15,50.00%
push-rtmp-l6-enc.douyincdn.com,15,0.00%,15,0,100.00%
push-rtmp-f5.ihuoshanlive.com,15,0.00%,15,0,100.00%
pull-rtmp-l6-source.douyincdn.com,15,0.00%,22,7,68.18%
push-rtmp-hs-vr-f5.douyincdn.com,15,0.00%,15,0,100.00%
search.bilibili.com,15,0.00%,20,5,75.00%
union-click.jd.com,15,0.00%,15,0,100.00%
gspe79-cn-ssl.ls.apple.com,15,0.00%,25,10,60.00%
msg-frontier-lf.feishu.cn,15,0.00%,15,0,100.00%
sunwk.fun,15,0.00%,15,0,100.00%
interface3.music.163.com,15,0.00%,20,5,75.00%
onedscolprdweu01.westeurope.cloudapp.azure.com,15,0.00%,28,13,53.57%
notices.mattermost.com,15,0.00%,15,0,100.00%
p4.music.126.net.w.alikunlun.com,15,0.00%,33,18,45.45%
res.baoshiyun.com,15,0.00%,15,0,100.00%
d.xfinfr.com,15,0.00%,15,0,100.00%
default.tracking.miui.com,15,0.00%,15,0,100.00%
e28.g.akamaiedge.net,15,0.00%,15,0,100.00%
is-ssl.mzstatic.com.itunes-apple.com.akadns.net,15,0.00%,16,1,93.75%
g.search.live.com,15,0.00%,15,0,100.00%
xiyou.cloud,15,0.00%,15,0,100.00%
legionzone.mbgcdn.lenovo.com.cn,15,0.00%,15,0,100.00%
lzupdate.lenovo.com.cn,15,0.00%,15,0,100.00%
l-ring.msedge.net,15,0.00%,15,0,100.00%
p0.ssl.qhimg.com,15,0.00%,20,5,75.00%
hao3.qhimg.com,15,0.00%,42,27,35.71%
adashx4yt.m.taobao.com,15,0.00%,15,0,100.00%
cl4-cn.ls-apple.com.akadns.net,15,0.00%,15,0,100.00%
cl4-cn.apple.com.download.ks-cdn.com,15,0.00%,15,0,100.00%
rp.m.hub.sandai.net,15,0.00%,15,0,100.00%
onedscolprdweu03.westeurope.cloudapp.azure.com,15,0.00%,15,0,100.00%
t.co,15,0.00%,15,0,100.00%
bam-cell.nr-data.net,15,0.00%,25,10,60.00%
oaagent.baidu.com,15,0.00%,15,0,100.00%
www.catererglobal.com,15,0.00%,15,0,100.00%
id6.me,15,0.00%,29,14,51.72%
dsm01pap001.storage.live.com,15,0.00%,24,9,62.50%
caldav.fe.apple-dns.net,15,0.00%,31,16,48.39%
astrategy.beacon.qq.com,15,0.00%,15,0,100.00%
cdn.ynuf.aliapp.org,15,0.00%,34,19,44.12%
csd-apt-eas-d-3.eastasia.cloudapp.azure.com,15,0.00%,15,0,100.00%
mime.baidu.com,15,0.00%,15,0,100.00%
ip1880706122.funshion.com,15,0.00%,15,0,100.00%
v.qq.com,15,0.00%,18,3,83.33%
xcast.netcond.qq.com,15,0.00%,15,0,100.00%
library-service.live.use1a.on.epicgames.com,15,0.00%,15,0,100.00%
push.khd.2345.cc,15,0.00%,15,0,100.00%
finder.video.qq.com,15,0.00%,31,16,48.39%
routerahs.asus.com,15,0.00%,15,0,100.00%
sat02pap004.storage.live.com,15,0.00%,26,11,57.69%
archive2.kylinos.cn.w.kunlunpi.com,15,0.00%,15,0,100.00%
cdn-9f456ph4.slt.sched.tdnsv8.com,15,0.00%,15,0,100.00%
images.newsmth.net,15,0.00%,15,0,100.00%
ws2.leetcode.cn,15,0.00%,15,0,100.00%
p3-tt.byteimg.com,15,0.00%,19,4,78.95%
cronus.ie.sogou.com,15,0.00%,15,0,100.00%
collector-hpn.ghostery.net,15,0.00%,15,0,100.00%
d.la1-c2-cdg.salesforceliveagent.com,15,0.00%,15,0,100.00%
app.terra-master.com,15,0.00%,15,0,100.00%
onedriveclucprodbn20038.blob.core.windows.net,15,0.00%,15,0,100.00%
connperf.immomo.com,15,0.00%,15,0,100.00%
v.baoshiyun.com,15,0.00%,15,0,100.00%
49.courier-push-apple.com.akadns.net,15,0.00%,15,0,100.00%
twc.trafficmanager.net,15,0.00%,15,0,100.00%
adv.sec.miui.com,15,0.00%,15,0,100.00%
cdn-go.cn,15,0.00%,15,0,100.00%
ip2091219971.funshion.com,15,0.00%,15,0,100.00%
t.wg.360-api.cn,15,0.00%,15,0,100.00%
ohg5xoot.nodedata.net,15,0.00%,15,0,100.00%
upos-sz-estgoss.bilivideo.com,15,0.00%,15,0,100.00%
dl.static.iqiyi.com,15,0.00%,34,19,44.12%
knicks.jd.com,15,0.00%,29,14,51.72%
github-cloud.s3.amazonaws.com,15,0.00%,15,0,100.00%
storecatalogrevocation.storequality.microsoft.com.edgekey.net,15,0.00%,15,0,100.00%
cdnimg.3g.qq.com.sched.legopic2.tdnsv6.com,15,0.00%,15,0,100.00%
39.courier-push-apple.com.akadns.net,15,0.00%,15,0,100.00%
img.alicdn.com,15,0.00%,36,21,41.67%
5-courier.push.apple.com,15,0.00%,15,0,100.00%
e10370.g.akamaiedge.net,15,0.00%,15,0,100.00%
avator.eastmoney.com,15,0.00%,33,18,45.45%
pla-prod-tm-ingest-01.trafficmanager.net,15,0.00%,15,0,100.00%
sb-ssl.l.google.com,15,0.00%,15,0,100.00%
passport-client.bitcomet.com,15,0.00%,15,0,100.00%
y.qq.com,15,0.00%,18,3,83.33%
maponline1.bdimg.com,15,0.00%,17,2,88.24%
haokan.baidu.com,15,0.00%,15,0,100.00%
context-enroll.ccs.mcafee.com,15,0.00%,15,0,100.00%
httpdns.kwd.inkuai.com,15,0.00%,15,0,100.00%
giefaiz4.nodedata.net,15,0.00%,15,0,100.00%
cnc.hub5pnc.sandai.net,15,0.00%,15,0,100.00%
httpdns.c.cdnhwc2.com,15,0.00%,15,0,100.00%
46-courier.push.apple.com,15,0.00%,15,0,100.00%
lapi.jd.com,15,0.00%,15,0,100.00%
mobi2.hexin.cn,15,0.00%,28,13,53.57%
onedriveclucproddm20029.blob.core.windows.net,15,0.00%,15,0,100.00%
p1r5chsp3tslt4o10h0db2p4t6t2l947nbm6h41ikij076ibulmfvj1d.qc.x.bsgslb.cn,15,0.00%,15,0,100.00%
upd.sangfor.com.cn,15,0.00%,15,0,100.00%
iosapps.itunes.apple.com,15,0.00%,31,16,48.39%
apd-d0abb49c9eefbf000b7a6e2a3e1fcbf2.v.smtcdns.com,15,0.00%,15,0,100.00%
archive.ubuntukylin.com,15,0.00%,15,0,100.00%
su.itunes.apple.com,15,0.00%,27,12,55.56%
blob.bl6prdstr05a.store.core.windows.net,15,0.00%,15,0,100.00%
iepl.52168.org,15,0.00%,15,0,100.00%
d3uniwo7xqjvhe.cloudfront.net,15,0.00%,16,1,93.75%
10-courier.push.apple.com,15,0.00%,15,0,100.00%
st-v3-stp-src-win-3503-g3.api.splashtop.com,15,0.00%,15,0,100.00%
s1-sync.firefox.com.cn,15,0.00%,15,0,100.00%
ins-5776sx9h.ias.tencent-cloud.net,15,0.00%,15,0,100.00%
edge-skype-com.s-0001.s-msedge.net,14,0.00%,28,14,50.00%
init-p01st.push.apple.com,14,0.00%,26,12,53.85%
push-rtmp-l1.douyincdn.com,14,0.00%,14,0,100.00%
pull-flv-l3-enc.douyincdn.com.w.alikunlun.net,14,0.00%,14,0,100.00%
pull-hls-f11.douyincdn.com.tcdnlive.com,14,0.00%,14,0,100.00%
bcelive.jomodns.com,14,0.00%,14,0,100.00%
push-rtmp-l6-enc.douyincdn.com.upvcloud.ks-cdn.com,14,0.00%,14,0,100.00%
onedriveclucprodbn20039.blob.core.windows.net,14,0.00%,14,0,100.00%
onedscolprdfrc06.francecentral.cloudapp.azure.com,14,0.00%,14,0,100.00%
fts.jd.com,14,0.00%,14,0,100.00%
onedscolprdfrc01.francecentral.cloudapp.azure.com,14,0.00%,14,0,100.00%
www.download.windowsupdate.com,14,0.00%,15,1,93.33%
0i4k7t9l.sched.sma-dk.tdnsstic1.cn,14,0.00%,36,22,38.89%
wd-prod-cp.trafficmanager.net,14,0.00%,14,0,100.00%
p0.qhimg.com.webcdn.360qhcdn.com,14,0.00%,28,14,50.00%
loc.map.baidu.com,14,0.00%,65,51,21.54%
pull-hs-f5.flive.ihuoshanlive.com,14,0.00%,14,0,100.00%
hcdnl.pulldyin.iptv.gslb.c.cdnhwc2.com,14,0.00%,14,0,100.00%
pull-flv-vr-l26.douyincdn.com.c.cdnhwc3.com,14,0.00%,14,0,100.00%
pull-flv-spe-l6.douyincdn.com,14,0.00%,24,10,58.33%
bcedyflvq.jomodns.com,14,0.00%,14,0,100.00%
pull-rtmp-l11-cny.douyincdn.com.tcdnlive.com,14,0.00%,14,0,100.00%
pull-rtmp-l26-cny.douyincdn.com.c.cdnhwc3.com,14,0.00%,14,0,100.00%
msg-push.duba.net,14,0.00%,14,0,100.00%
ss.gb1.se.sx.cn,14,0.00%,14,0,100.00%
torrent.centos.org,14,0.00%,14,0,100.00%
www.hostbuf.com,14,0.00%,14,0,100.00%
29.courier-push-apple.com.akadns.net,14,0.00%,14,0,100.00%
static.dataservices.hp.com,14,0.00%,28,14,50.00%
pull-flv-f11-proxy.douyincdn.com.sched.l8.tdnsv5.com,14,0.00%,14,0,100.00%
bcefdyflvq.jomodns.com,14,0.00%,14,0,100.00%
toutiao.uplive.ks-cdn.com,14,0.00%,14,0,100.00%
push-rtmp-l26-cny.douyincdn.com.c.cdnhwc3.com,14,0.00%,14,0,100.00%
pull-flv-l1-cny.douyincdn.com.wsdvs.com,14,0.00%,14,0,100.00%
pull-f5-vs.flive.douyincdn.com.c.bytefcdn.com,14,0.00%,14,0,100.00%
pull-hls-f13.douyincdn.com.a.bdydns.com,14,0.00%,14,0,100.00%
pull-rtmp-l29.douyincdn.com.ucloud.com.cn,14,0.00%,14,0,100.00%
pull-fcdn-mptcpdouyin.s.bytefcdn.com,14,0.00%,14,0,100.00%
push-rtmp-l6-encryption.douyincdn.com.upvcloud.ks-cdn.com,14,0.00%,14,0,100.00%
pull-flv-l1.ixigua.com.wsdvs.com,14,0.00%,14,0,100.00%
push-rtmp-l1-hs.pstatp.com,14,0.00%,14,0,100.00%
us02.graniterapids.com,14,0.00%,14,0,100.00%
sns-video-hw.xhscdn.com,14,0.00%,43,29,32.56%
sns-video-qc.xhscdn.com,14,0.00%,39,25,35.90%
dart.l.doubleclick.net,14,0.00%,14,0,100.00%
apm.hexin.cn,14,0.00%,14,0,100.00%
v6-default.365yg.com,14,0.00%,14,0,100.00%
p111-fmip.icloud.com,14,0.00%,14,0,100.00%
ts2.cn.mm.bing.chinacache.net,14,0.00%,14,0,100.00%
subscription.iqiyi.com,14,0.00%,32,18,43.75%
ts1.cn.mm.bing.chinacache.net,14,0.00%,14,0,100.00%
ts2.cn.mm.bing.net.lxcvc.com,14,0.00%,14,0,100.00%
intel11.cn.edgekey.net,14,0.00%,28,14,50.00%
iphone-ld.origin-apple.com.akadns.net,14,0.00%,25,11,56.00%
inappcheck.itunes.apple.com.download.ks-cdn.com,14,0.00%,26,12,53.85%
pull-f5-hs.pstatp.com.c.bytefcdn.com,14,0.00%,14,0,100.00%
push-rtmp-f5-vs.douyincdn.com,14,0.00%,14,0,100.00%
push-rtmp-f5-io.flive.douyincdn.com,14,0.00%,14,0,100.00%
pull-rtmp-f6.douyincdn.com,14,0.00%,22,8,63.64%
push-rtmp-l29.douyincdn.com.ucloud.com.cn,14,0.00%,14,0,100.00%
yunxin-data-live-126-net-yq.ntes53.netease.com,14,0.00%,14,0,100.00%
s3a.pstatp.com,14,0.00%,34,20,41.18%
r2---sn-ni5een7l.gvt1.com,14,0.00%,14,0,100.00%
transit2.wslog.chinanetcenter.com,14,0.00%,14,0,100.00%
69-46-75-53.nhost.00cdn.com,14,0.00%,14,0,100.00%
ip1880706120.funshion.com,14,0.00%,14,0,100.00%
beacons5.gvt3.com,14,0.00%,35,21,40.00%
qinfo.wps.cn,14,0.00%,14,0,100.00%
toblog.ctobsnssdk.com.w.cdngslb.com,14,0.00%,14,0,100.00%
play-cdn.itunes-apple.com.akadns.net,14,0.00%,21,7,66.67%
s-iavs9x.avcdn.net,14,0.00%,31,17,45.16%
gdmf.v.aaplimg.com,14,0.00%,14,0,100.00%
swscan.apple.com,14,0.00%,25,11,56.00%
s2.hdslb.com,14,0.00%,14,0,100.00%
dasheng03.com,14,0.00%,14,0,100.00%
ping-edge.smartscreen.microsoft.com,14,0.00%,14,0,100.00%
ws.mmstat.com.gds.alibabadns.com,14,0.00%,14,0,100.00%
oauth.intservices.aws.intellij.net,14,0.00%,14,0,100.00%
pull-hls-f1.douyincdn.com,14,0.00%,18,4,77.78%
pull-rtmp-l95.douyincdn.com,14,0.00%,23,9,60.87%
pull-hls-f5-vs-tsl.douyincdn.com,14,0.00%,20,6,70.00%
57.newspush.eastmoney.com,14,0.00%,14,0,100.00%
jfhwnewvideos.peopletech.cn,14,0.00%,14,0,100.00%
d3blkd4k0wk9oj.cloudfront.net,14,0.00%,14,0,100.00%
newclient.map.baidu.com,14,0.00%,43,29,32.56%
dig.lianjia.com,14,0.00%,14,0,100.00%
view.csslcloud.net,14,0.00%,14,0,100.00%
3.courier-push-apple.com.akadns.net,14,0.00%,14,0,100.00%
ihsu-japaneast-2.japaneast.cloudapp.azure.com,14,0.00%,14,0,100.00%
dss3.baidu.com,14,0.00%,19,5,73.68%
inz5jaqbqg.feishu.cn,14,0.00%,14,0,100.00%
client-server3.safedog.cn,14,0.00%,14,0,100.00%
ssl.ptlogin2.weiyun.com,14,0.00%,14,0,100.00%
nbsdk-baichuan.alicdn.com.danuoyi.alicdn.com,14,0.00%,14,0,100.00%
s17-sync.firefox.com.cn,14,0.00%,14,0,100.00%
12.courier-push-apple.com.akadns.net,14,0.00%,14,0,100.00%
b-ring.msedge.net,14,0.00%,14,0,100.00%
sdkapp.mobile.sina.cn,14,0.00%,14,0,100.00%
chi01pap001.storage.live.com,14,0.00%,20,6,70.00%
wa.qq.com,14,0.00%,32,18,43.75%
pss.alicdn.com.gds.alibabadns.com,14,0.00%,14,0,100.00%
public.gdtimg.com,14,0.00%,34,20,41.18%
soso-xzdesktop-api.cqttech.com,14,0.00%,14,0,100.00%
g52.p4.webrootcloudav.com,14,0.00%,14,0,100.00%
service.mkey.163.com,14,0.00%,14,0,100.00%
nos.gameyw.netease.com,14,0.00%,14,0,100.00%
config.mail.163.com,14,0.00%,14,0,100.00%
42-courier.push.apple.com,14,0.00%,14,0,100.00%
ftp.de.debian.org,14,0.00%,14,0,100.00%
www.oschina.net,14,0.00%,14,0,100.00%
versioncheck.prod.mozaws.net,14,0.00%,14,0,100.00%
addons.firefox.com.cn.wswebpic.com,14,0.00%,14,0,100.00%
py.ucas.ac.cn,14,0.00%,14,0,100.00%
routerfeedback.asus.com,14,0.00%,14,0,100.00%
imohy4to.nodedata.net,14,0.00%,14,0,100.00%
www.hdw66.com,14,0.00%,14,0,100.00%
static.leetcode.cn,14,0.00%,14,0,100.00%
pic.leetcode-cn.com,14,0.00%,14,0,100.00%
onedriveclucproddm20044.blob.core.windows.net,14,0.00%,14,0,100.00%
tracker2.dler.com,14,0.00%,14,0,100.00%
ccm-frontier.feishu.cn,14,0.00%,14,0,100.00%
edu-wenku.bdimg.com,14,0.00%,19,5,73.68%
pingjs.qq.com,14,0.00%,17,3,82.35%
storage.360buyimg.com,14,0.00%,28,14,50.00%
www.onlineregister.com,14,0.00%,14,0,100.00%
download.parallels.com,14,0.00%,14,0,100.00%
crl.digicert.cn,14,0.00%,14,0,100.00%
mediadata.api.weibo.com,14,0.00%,14,0,100.00%
www.is.cas.cn,14,0.00%,14,0,100.00%
xd.x3.client.api.vpngate2.jp,14,0.00%,24,10,58.33%
1year.pcfg.cache.wpscdn.cn,14,0.00%,14,0,100.00%
webadvisorc.rest.gti.mcafee.com,14,0.00%,14,0,100.00%
adash.man.aliyuncs.com,14,0.00%,14,0,100.00%
pcmanager.microsoft.com,14,0.00%,14,0,100.00%
msg.video.qiyi.com,14,0.00%,14,0,100.00%
us.sogou.com,14,0.00%,14,0,100.00%
topnews.imtt.qq.com,14,0.00%,14,0,100.00%
19-courier.push.apple.com,14,0.00%,14,0,100.00%
hao.360.cn,14,0.00%,14,0,100.00%
blocklist.operachina.com,14,0.00%,14,0,100.00%
p3.img.360kuai.com,14,0.00%,19,5,73.68%
v26-web.douyinvod.com,14,0.00%,14,0,100.00%
images.nvidia.cn,14,0.00%,14,0,100.00%
sat02pap002.storage.live.com,14,0.00%,21,7,66.67%
p2pchunk-ws.douyucdn.cn,14,0.00%,14,0,100.00%
cfw.gti.mcafee.akadns.NET,14,0.00%,14,0,100.00%
goblin.hupu.com,14,0.00%,14,0,100.00%
vscode-update.azurewebsites.net,14,0.00%,14,0,100.00%
odc-commonafdrk-geo.onedrive.akadns.net,14,0.00%,17,3,82.35%
httpring.qq.com,14,0.00%,14,0,100.00%
www.ctrip.com,14,0.00%,14,0,100.00%
show.bilibili.com,14,0.00%,14,0,100.00%
pics1.baidu.com,14,0.00%,20,6,70.00%
grs-iot.platform.dbankcloud.com,14,0.00%,14,0,100.00%
max-dr.mdvdns.qihucdn.cn,14,0.00%,14,0,100.00%
rpc.znly.co,14,0.00%,14,0,100.00%
gateway.im.weibo.cn,14,0.00%,14,0,100.00%
tm-prod-wd-csp-edge.trafficmanager.net,14,0.00%,14,0,100.00%
pcvideoaliyun.titan.mgtv.com,14,0.00%,14,0,100.00%
roaming.officeapps.partner.office365.cn,14,0.00%,14,0,100.00%
api.uve.weibo.com,14,0.00%,14,0,100.00%
onedriveclucprodbn20048.blob.core.windows.net,14,0.00%,14,0,100.00%
relay-b8d08ecc.net.anydesk.com,14,0.00%,14,0,100.00%
followservice.kugou.com,14,0.00%,14,0,100.00%
d.jd.com,14,0.00%,14,0,100.00%
tbskip.taobao.com,14,0.00%,14,0,100.00%
oraybox-tk.oray.com,14,0.00%,14,0,100.00%
sensors.ibreader.com,14,0.00%,14,0,100.00%
dldir2.qq.com,14,0.00%,14,0,100.00%
app.getsentry.com,14,0.00%,14,0,100.00%
cu004.www.duba.net,14,0.00%,14,0,100.00%
g-aicloud.alibaba.com,14,0.00%,14,0,100.00%
tracker.edkj.club,14,0.00%,14,0,100.00%
line3-h5-mobile-api.biligame.com,14,0.00%,14,0,100.00%
vdn6.vzuu.com,14,0.00%,28,14,50.00%
musicstatus-apac-n.edge-itunes-apple.com.akadns.net,14,0.00%,14,0,100.00%
downloaddispatch.itunes.apple.com,14,0.00%,26,12,53.85%
myip.opendns.com,14,0.00%,25,11,56.00%
dockerauth.cn-beijing.aliyuncs.com,14,0.00%,14,0,100.00%
daka.dafa-dns.com,14,0.00%,14,0,100.00%
static-asm-skype.trafficmanager.net,14,0.00%,14,0,100.00%
s3.cn-north-1.amazonaws.com.cn,14,0.00%,14,0,100.00%
applog.lanxin.cn,14,0.00%,14,0,100.00%
tracker.bluefrog.pw,14,0.00%,21,7,66.67%
8e8lbgse.sched.d2.tdnsdp1.cn,14,0.00%,14,0,100.00%
every.bestcasinotactics.com,14,0.00%,14,0,100.00%
actually.abc-vv.com,14,0.00%,14,0,100.00%
possibly.djblueturntup.com,14,0.00%,14,0,100.00%
info.52pcfree.com,14,0.00%,14,0,100.00%
img03.sogoucdn.com,14,0.00%,14,0,100.00%
img04.sogoucdn.com,14,0.00%,14,0,100.00%
apps-mzstatic-cdn.itunes-apple.com.akadns.net,14,0.00%,24,10,58.33%
discovery.razerapi.com,14,0.00%,14,0,100.00%
finance.eastmoney.com,14,0.00%,32,18,43.75%
ip2091219981.funshion.com,14,0.00%,14,0,100.00%
drive.mycom.world,14,0.00%,14,0,100.00%
k-ring.k-9999.k-msedge.net,13,0.00%,13,0,100.00%
push-rtmp-vr-l6.douyincdn.com.upvcloud.ks-cdn.com,13,0.00%,13,0,100.00%
www.letv.com,13,0.00%,13,0,100.00%
www.iie.cas.cn,13,0.00%,13,0,100.00%
chat1.jd.com,13,0.00%,23,10,56.52%
img13.360buyimg.com,13,0.00%,28,15,46.43%
b1h.zemanta.com,13,0.00%,13,0,100.00%
maxineapi.razersynapse.com,13,0.00%,13,0,100.00%
mts.tvbit.co,13,0.00%,13,0,100.00%
asia.configsvc1.live.com.akadns.net,13,0.00%,13,0,100.00%
push-rtmp-spe-l6.douyincdn.com.upvcloud.ks-cdn.com,13,0.00%,13,0,100.00%
pull-hs-f5.flive.ihuoshanlive.com.c.volcfcdndvs.com,13,0.00%,13,0,100.00%
k5-toutiao-ipv6-ml.gslb.ksyuncdn.com,13,0.00%,27,14,48.15%
pull-fcdn-douyin-base2.s.bytefcdn.com,13,0.00%,13,0,100.00%
pull-hls-spe-l11.douyincdn.com.sched.l9.tdnsv5.com,13,0.00%,13,0,100.00%
pull-rtmp-l11.douyincdn.com.tcdnlive.com,13,0.00%,13,0,100.00%
common-afd.fe.1drv.com,13,0.00%,18,5,72.22%
shark.douyucdn.cn,13,0.00%,16,3,81.25%
t13.baidu.com.a.bdydns.com,13,0.00%,20,7,65.00%
t8.baidu.com.a.bdydns.com,13,0.00%,20,7,65.00%
weu010-breeziest-in.cloudapp.net,13,0.00%,13,0,100.00%
kb.vmware.com,13,0.00%,29,16,44.83%
s6130-ml.gslb.ksyuncdn.com,13,0.00%,25,12,52.00%
hcdnv.zjv6.zjtd.c.cdnhwc2.com,13,0.00%,26,13,50.00%
push-rtmp-l26.douyincdn.com,13,0.00%,13,0,100.00%
push-rtmp-hs-f5.huoshanlive.com.c.volcfcdndvs.com,13,0.00%,13,0,100.00%
push-rtmp-l11-cny.douyincdn.com.livepush.myqcloud.com,13,0.00%,13,0,100.00%
push-rtmp-vr-l11.douyincdn.com.tlivepush.com,13,0.00%,13,0,100.00%
pull-hls-f6.douyincdn.com.hlsvcloud.ks-cdn.com,13,0.00%,13,0,100.00%
push-rtmp-hs-f5.douyincdn.com.c.volcfcdndvs.com,13,0.00%,13,0,100.00%
pull-hls-f29.douyincdn.com.ucloud.com.cn,13,0.00%,13,0,100.00%
pull-rtmp-f11.douyincdn.com.tcdnlive.com,13,0.00%,13,0,100.00%
pull-f3-hs.pstatp.com.w.alikunlun.net,13,0.00%,13,0,100.00%
pull-tsl-hs-spe-f5.douyincdn.com.bytedns1.com,13,0.00%,13,0,100.00%
pull-hls-f96.douyincdn.com.d.live.cdn.chinamobile.com,13,0.00%,13,0,100.00%
stream.cadmore.media,13,0.00%,13,0,100.00%
servicediscovery.ccs.mcafee.com,13,0.00%,30,17,43.33%
cxcs.microsoft.net,13,0.00%,13,0,100.00%
tracker.monitorit4.me,13,0.00%,13,0,100.00%
myou.cvte.com,13,0.00%,13,0,100.00%
push-rtmp-spe-l11.douyincdn.com,13,0.00%,13,0,100.00%
pull-flv-f6.douyincdn.com,13,0.00%,26,13,50.00%
pull-flv-l6-encryption.douyincdn.com,13,0.00%,22,9,59.09%
push-rtmp-vr-l3.douyincdn.com,13,0.00%,13,0,100.00%
krgame02.graniterapids.com,13,0.00%,13,0,100.00%
pss.bdstatic.com.a.bdydns.com,13,0.00%,26,13,50.00%
nocdn-repository.gtm.eset.com,13,0.00%,13,0,100.00%
v5-j.douyinvod.com,13,0.00%,13,0,100.00%
connect.rom.miui.com,13,0.00%,13,0,100.00%
assets.msn.cn-c.edgekey.net,13,0.00%,13,0,100.00%
any.cdn-go.cn.sched.legopic1-dk.tdnsv6.com,13,0.00%,27,14,48.15%
telecommand.telemetry.microsoft.com,13,0.00%,13,0,100.00%
suggestion.a.shifen.com,13,0.00%,25,12,52.00%
push-rtmp-hs-spe-f5.douyincdn.com,13,0.00%,13,0,100.00%
pull-flv-vr-l6.douyincdn.com,13,0.00%,22,9,59.09%
pull-rtmp-f1-hs.pstatp.com,13,0.00%,13,0,100.00%
44.newspush.eastmoney.com,13,0.00%,13,0,100.00%
3.rlb.router.teamviewer.cn,13,0.00%,13,0,100.00%
mail.zasaonsk.ga,13,0.00%,13,0,100.00%
ue.mbgstore.lenovo.com.cn,13,0.00%,13,0,100.00%
mirrors163.ntes53.netease.com,13,0.00%,13,0,100.00%
skconf.f.qh-lb.com,13,0.00%,13,0,100.00%
t-ruanjian.2345.cc,13,0.00%,13,0,100.00%
18-courier.push.apple.com,13,0.00%,13,0,100.00%
appoptimize-drcn.dbankcdn.cn,13,0.00%,13,0,100.00%
learn.kaikeba.com,13,0.00%,13,0,100.00%
pc-store.mbgstore.lenovo.com.cn,13,0.00%,13,0,100.00%
iknow-base.cdn.bcebos.com,13,0.00%,13,0,100.00%
fc4tn.baidu.com,13,0.00%,13,0,100.00%
imap.mail-aipo.apple-dns.cn,13,0.00%,13,0,100.00%
v2.cs3.duba.net,13,0.00%,13,0,100.00%
contacts.126.com,13,0.00%,13,0,100.00%
platformcn.maps.glbdns2.microsoft.com,13,0.00%,13,0,100.00%
hcdnw.nozj.bili.c.cdnhwc2.com,13,0.00%,13,0,100.00%
lcdn-locator.apple.com.akadns.net,13,0.00%,13,0,100.00%
updates.cdn-apple.com.akadns.net,13,0.00%,13,0,100.00%
updates-china-lb.dl-apple.com.akadns.net,13,0.00%,13,0,100.00%
sdkserver-drcn.op.dbankcloud.cn,13,0.00%,13,0,100.00%
bstatic.hdslb.com,13,0.00%,13,0,100.00%
um.simpli.fi,13,0.00%,13,0,100.00%
pcwallpaper.zhhainiao.com,13,0.00%,13,0,100.00%
maven.aliyun.com,13,0.00%,13,0,100.00%
groupclient.qq.com,13,0.00%,13,0,100.00%
pigai.youdao.com,13,0.00%,13,0,100.00%
b.mail.163.com,13,0.00%,13,0,100.00%
proxy.golang.org,13,0.00%,24,11,54.17%
uri6.com,13,0.00%,13,0,100.00%
updates.cdn-apple.com.w.kunlunca.com,13,0.00%,13,0,100.00%
api.dida365.com,13,0.00%,13,0,100.00%
archive.kylinos.cn.w.kunlunca.com,13,0.00%,13,0,100.00%
steam-chat.com,13,0.00%,13,0,100.00%
baoshi.qq.com.x2.sched.dcloudstc.com,13,0.00%,13,0,100.00%
smarthome.hicloud.com,13,0.00%,13,0,100.00%
open-search.docer.wps.cn,13,0.00%,13,0,100.00%
lf3-cdn2-tos.bytescm.com.w.alikunlun.com,13,0.00%,17,4,76.47%
common.be.1drv.com.l-0003.dc-msedge.net.l-0003.l-msedge.net,13,0.00%,17,4,76.47%
secure.gravatar.com,13,0.00%,46,33,28.26%
d78fikflryjgj.cloudfront.net,13,0.00%,13,0,100.00%
na61-na62.wagbridge.alibaba.taobao.com.gds.alibabadns.com,13,0.00%,13,0,100.00%
uo6zook8.nodedata.net,13,0.00%,13,0,100.00%
gnar.grammarly.com,13,0.00%,13,0,100.00%
upos-sz-mirrorhwb.bilivideo.com,13,0.00%,19,6,68.42%
qq.com,13,0.00%,13,0,100.00%
s2.cn.bing.net,13,0.00%,13,0,100.00%
acstatic-dun.126.net.w.kunluncan.com,13,0.00%,13,0,100.00%
t.go.sohu.com,13,0.00%,13,0,100.00%
api.ssl.so.com,13,0.00%,13,0,100.00%
e.dop.mediav.com,13,0.00%,13,0,100.00%
mall.bilibili.com,13,0.00%,14,1,92.86%
kbgp.wpsdns.com,13,0.00%,13,0,100.00%
profile.se.360.cn,13,0.00%,23,10,56.52%
hub5pr.sandai.net,13,0.00%,13,0,100.00%
uci.cdn.office.net,13,0.00%,30,17,43.33%
c.y.qq.com,13,0.00%,13,0,100.00%
r3---sn-2x3elnel.gvt1.com,13,0.00%,13,0,100.00%
tieba.baidu.com,13,0.00%,25,12,52.00%
blog.gitee.com,13,0.00%,13,0,100.00%
chineseime.chinauos.com,13,0.00%,13,0,100.00%
all.cnzz.com.danuoyi.tbcache.com,13,0.00%,13,0,100.00%
mirrors.almalinux.org,13,0.00%,25,12,52.00%
comets.blog.sina.com.cn,13,0.00%,13,0,100.00%
www.sinfors.com.cn,13,0.00%,13,0,100.00%
analyticspixel.microsoft.com,13,0.00%,13,0,100.00%
p5.img.360kuai.com,13,0.00%,13,0,100.00%
scootersoftware.com,13,0.00%,13,0,100.00%
v1.go2yd.com.wjgslb.com,13,0.00%,13,0,100.00%
mobilegw.bridge.alipaydns.com,13,0.00%,13,0,100.00%
ppt.pptsupermarket.com,13,0.00%,13,0,100.00%
dsm01pap004.storage.live.com,13,0.00%,13,0,100.00%
maponline2.bdimg.com,13,0.00%,15,2,86.67%
webmap0.bdimg.com,13,0.00%,14,1,92.86%
ddms.jd.com,13,0.00%,13,0,100.00%
ta.trs.cn,13,0.00%,13,0,100.00%
c.clarity.ms,13,0.00%,13,0,100.00%
apps.apple.com.cdn30.com,13,0.00%,13,0,100.00%
bytedance.feishu.cn,13,0.00%,13,0,100.00%
center.rising.com.cn,13,0.00%,13,0,100.00%
hb.apis.dell.com,13,0.00%,13,0,100.00%
cn-jiangsu001-g3.edge.dbankedge.cn,13,0.00%,13,0,100.00%
api.money.126.net,13,0.00%,13,0,100.00%
h5speed.m.jd.com,13,0.00%,13,0,100.00%
ddf.1proh.com,13,0.00%,13,0,100.00%
wlog.gifshow.com,13,0.00%,13,0,100.00%
sound-ks-cdn-cn.maoercdn.com,13,0.00%,25,12,52.00%
d5nxst8fruw4z.cloudfront.net,13,0.00%,13,0,100.00%
mdtj.17win.com,13,0.00%,13,0,100.00%
3c1w7cb7.sched.vip-dk.tdnsvod1.cn,13,0.00%,27,14,48.15%
www.bytedance.com.w.cdngslb.com,13,0.00%,13,0,100.00%
retracker.lanta.me,13,0.00%,13,0,100.00%
a-0019.a.dns.azurefd.net,13,0.00%,13,0,100.00%
them.takeofftonewdreams.com,13,0.00%,13,0,100.00%
both.xcsmk.com,13,0.00%,13,0,100.00%
www.xml-journal.cn,13,0.00%,13,0,100.00%
iplc01.my1188.org,13,0.00%,13,0,100.00%
d21wlyhffxxqkt.cloudfront.net,13,0.00%,13,0,100.00%
duer-news.cdn.bcebos.com,13,0.00%,13,0,100.00%
d1zkz3k4cclnv6.cloudfront.net,13,0.00%,13,0,100.00%
pixel.rubiconproject.net.akadns.net,12,0.00%,12,0,100.00%
pull-flv-f29.douyincdn.com.ucloud.com.cn,12,0.00%,12,0,100.00%
pull-rtmp-f96.douyincdn.com.d.live.cdn.chinamobile.com,12,0.00%,12,0,100.00%
pull-rtmp-f13.douyincdn.com.a.bcelive.com,12,0.00%,12,0,100.00%
www.chinaz.com,12,0.00%,12,0,100.00%
puncher.dcdn.baidu.com,12,0.00%,12,0,100.00%
club.jd.com,12,0.00%,22,10,54.55%
gias.jd.com,12,0.00%,12,0,100.00%
img11.360buyimg.com,12,0.00%,27,15,44.44%
stackoverflow.com,12,0.00%,12,0,100.00%
vibe.sleepyinternetfun.xyz,12,0.00%,12,0,100.00%
fe.dealclub.de,12,0.00%,12,0,100.00%
tracking.firefox.com.cn,12,0.00%,20,8,60.00%
adu.g-fox.cn,12,0.00%,12,0,100.00%
cbjs.baidu.com,12,0.00%,12,0,100.00%
cn.archive.ubuntu.com,12,0.00%,1355,1343,0.89%
api.cdp.microsoft.com,12,0.00%,25,13,48.00%
prod.configsvc1.live.com.akadns.net,12,0.00%,12,0,100.00%
pull-f5.douyincdn.com.c.bytefcdn.com,12,0.00%,12,0,100.00%
pull-f5-io.flive.douyincdn.com.c.bytefcdn.com,12,0.00%,12,0,100.00%
yunlivepush.msf.tencent-cloud.com,12,0.00%,12,0,100.00%
cdn.jwplayer.com,12,0.00%,23,11,52.17%
sta-op.douyucdn.cn,12,0.00%,27,15,44.44%
ww1097.smartadserver.com,12,0.00%,16,4,75.00%
cmonitor.iqiyi.com,12,0.00%,42,30,28.57%
mobilegw.alipaydns.com,12,0.00%,12,0,100.00%
v3-be-pack.pglstatp-toutiao.com,12,0.00%,12,0,100.00%
lsw-fast.lenovo.com.cn,12,0.00%,12,0,100.00%
tracker.pomf.se,12,0.00%,12,0,100.00%
a1091.dscb.akamai.net,12,0.00%,24,12,50.00%
rc10-linux.oray.com,12,0.00%,12,0,100.00%
pull-flv-l11-encryption.douyincdn.com.tcdnlive.com,12,0.00%,12,0,100.00%
s03-ml.gslb.ksyuncdn.com,12,0.00%,25,13,48.00%
yun.livepush.myqcloud.com,12,0.00%,12,0,100.00%
hcdnl.pulldyin.gslb.c.cdnhwc2.com,12,0.00%,24,12,50.00%
pull-l3.douyincdn.com.w.alikunlun.net,12,0.00%,12,0,100.00%
pull-flv-spe-l11.douyincdn.com.tlivecdn.com,12,0.00%,12,0,100.00%
push-rtmp-l13.douyincdn.com.b.bcelive.com,12,0.00%,12,0,100.00%
bceliveup2.jomodns.com,12,0.00%,12,0,100.00%
pull-l3-cny.douyincdn.com.w.alikunlun.com,12,0.00%,20,8,60.00%
pull-hs-f5.flive.douyincdn.com.c.volcfcdndvs.com,12,0.00%,12,0,100.00%
push-rtmp-f5-cny.douyincdn.com.c.bytefcdn.com,12,0.00%,12,0,100.00%
pull-tsl-l11.douyincdn.com.cdn.dnsv1.com,12,0.00%,12,0,100.00%
pull-lls-f5.flive.douyincdn.com.c.bytefcdn.com,12,0.00%,12,0,100.00%
push-rtmp-hs-vr-f5.douyincdn.com.c.volcfcdndvs.com,12,0.00%,12,0,100.00%
pull-flv-l11-cny.douyincdn.com.sched.l9-dk.tdnsv5.com,12,0.00%,25,13,48.00%
push-rtmp-spe-l1.douyincdn.com.wsdvs.com,12,0.00%,12,0,100.00%
pull-f5-hs.flive.pstatp.com.c.bytefcdn.com,12,0.00%,12,0,100.00%
pull-flv-l6.ixigua.com,12,0.00%,22,10,54.55%
pull-f5-hot.flive.douyincdn.com.c.bytefcdn.com,12,0.00%,12,0,100.00%
pull-fcdn-base.s.bytefcdn.com,12,0.00%,12,0,100.00%
pull-flv-vr-l11.douyincdn.com.tlivecdn.com,12,0.00%,12,0,100.00%
pull-rtmp-f29.douyincdn.com.ucloud.com.cn,12,0.00%,12,0,100.00%
push-rtmp-vr-l3.douyincdn.com.230b2a2545cfa773.queniufm.com,12,0.00%,12,0,100.00%
weu09-breeziest-in.cloudapp.net,12,0.00%,12,0,100.00%
rum8.perf.linkedin.com,12,0.00%,12,0,100.00%
home.mcafee.com,12,0.00%,12,0,100.00%
log-api.pangolin-sdk-toutiao-b.com,12,0.00%,26,14,46.15%
vmss-clarity-ingest-eus.eastus.cloudapp.azure.com,12,0.00%,12,0,100.00%
hk4e-sdk.mihoyo.com,12,0.00%,12,0,100.00%
api.docer.wpscdn.cn.qiniudns.com,12,0.00%,24,12,50.00%
api.docer.wpscdn.china.line.qiniudns.com,12,0.00%,24,12,50.00%
down.anticheatexpert.com.akamaized.net,12,0.00%,12,0,100.00%
21-courier.push.apple.com,12,0.00%,12,0,100.00%
newdoc.docer.wps.cn,12,0.00%,12,0,100.00%
pcmgr.lenovo.com.cn,12,0.00%,12,0,100.00%
link.netease.im,12,0.00%,12,0,100.00%
onedscolprdfrc00.francecentral.cloudapp.azure.com,12,0.00%,12,0,100.00%
push-rtmp-l3-encryption.douyincdn.com,12,0.00%,12,0,100.00%
pull-flv-l95.douyincdn.com,12,0.00%,21,9,57.14%
push-rtmp-spe-l26.douyincdn.com.c.cdnhwc3.com,12,0.00%,12,0,100.00%
prdwss-prod-nlb-wss-b8099ab1e72f69ce.elb.us-west-2.amazonaws.com,12,0.00%,12,0,100.00%
api.ghostery.net,12,0.00%,12,0,100.00%
cl.vd.f.360.cn,12,0.00%,12,0,100.00%
v5-j.douyinvod.com.zjgslb.com,12,0.00%,12,0,100.00%
pdc.micloud.xiaomi.net,12,0.00%,12,0,100.00%
root.skype-edf.akadns.net,12,0.00%,12,0,100.00%
d2h67oheeuigaw.cloudfront.net,12,0.00%,27,15,44.44%
push-rtmp-hs-f5.huoshanlive.com,12,0.00%,12,0,100.00%
pull-hls-spe-l1.douyincdn.com,12,0.00%,25,13,48.00%
91.newspush.eastmoney.com,12,0.00%,12,0,100.00%
95.newspush.eastmoney.com,12,0.00%,12,0,100.00%
discovery-v4-4.syncthing.net,12,0.00%,12,0,100.00%
ic-business.ks3-cn-beijing.ksyun.com,12,0.00%,12,0,100.00%
jzed1uig.sched.sma.tdnsstic1.cn.cjt.krcdn.idatacube.com,12,0.00%,12,0,100.00%
contentcenter-videovali-drcn.dbankcdn.cn,12,0.00%,24,12,50.00%
rq1jxvp7.sched.sma.tdnsstic1.cn,12,0.00%,12,0,100.00%
study.163.com,12,0.00%,12,0,100.00%
prod.mrodevicemgr.live.com.akadns.net,12,0.00%,23,11,52.17%
cdn.pcsoftconfig.eastmoney.com.w.kunlunpi.com,12,0.00%,12,0,100.00%
12-courier.push.apple.com,12,0.00%,12,0,100.00%
inference-location-livenet.trafficmanager.net,12,0.00%,12,0,100.00%
e-0014.e-msedge.NET,12,0.00%,12,0,100.00%
ts-crl.ws.symantec.com,12,0.00%,24,12,50.00%
s3m5.nzwgs.com,12,0.00%,15,3,80.00%
dt4oxny0f90is.cloudfront.net,12,0.00%,26,14,46.15%
api.cloud.huawei.com,12,0.00%,12,0,100.00%
soft2020.17rd.com,12,0.00%,12,0,100.00%
ip.xinshuru.com,12,0.00%,12,0,100.00%
release.kite.com,12,0.00%,25,13,48.00%
music.ntes53.netease.com,12,0.00%,16,4,75.00%
cn.voice.gcloudcs.com,12,0.00%,12,0,100.00%
fc6tn.baidu.com,12,0.00%,12,0,100.00%
bds-data-sat.oss-cn-beijing.aliyuncs.com,12,0.00%,12,0,100.00%
service.cqttech.com,12,0.00%,12,0,100.00%
toolbar.search.msn.com.trafficmanager.net,12,0.00%,12,0,100.00%
opencloud.wostore.cn,12,0.00%,12,0,100.00%
www.sciencedirect.com,12,0.00%,12,0,100.00%
updates.cdn-apple.com.mwcname.com,12,0.00%,12,0,100.00%
upos-sz-mirrorhwo1.bilivideo.com.c.cdnhwc1.com,12,0.00%,17,5,70.59%
ins-jnd35913.ias.tencent-cloud.net,12,0.00%,12,0,100.00%
adashx.m.taobao.com.gds.alibabadns.com,12,0.00%,12,0,100.00%
work.medialab.qq.com,12,0.00%,12,0,100.00%
sogo.com,12,0.00%,12,0,100.00%
api-msn-com.a-0003.a-msedge.net,12,0.00%,23,11,52.17%
27-courier.push.apple.com,12,0.00%,12,0,100.00%
27.courier-push-apple.com.akadns.net,12,0.00%,12,0,100.00%
s-gm.mmstat.com,12,0.00%,12,0,100.00%
bilibilihelper.com,12,0.00%,12,0,100.00%
upos-sz-mirrorcoso1.bilivideo.com.cdn.dnsv1.com,12,0.00%,28,16,42.86%
downv6.qq.com,12,0.00%,13,1,92.31%
string.xy.163.com,12,0.00%,12,0,100.00%
mimg.127.net,12,0.00%,12,0,100.00%
onegoods.nosdn.127.net,12,0.00%,12,0,100.00%
utility.mail.163.com,12,0.00%,12,0,100.00%
api2.mubu.com,12,0.00%,12,0,100.00%
update.khd.2345.cc,12,0.00%,12,0,100.00%
c2shb.pubgw.yahoo.com,12,0.00%,12,0,100.00%
download.firefox.com.cn.w.kunlunca.com,12,0.00%,12,0,100.00%
hazel-server-pxufsrwofl.now.sh,12,0.00%,12,0,100.00%
p06-caldav.icloud.com,12,0.00%,24,12,50.00%
krsk02.graniterapids.com,12,0.00%,12,0,100.00%
krgame09.graniterapids.com,12,0.00%,12,0,100.00%
conn1.oppomobile.com,12,0.00%,12,0,100.00%
ohchaeb8.nodedata.net,12,0.00%,12,0,100.00%
static.hdslb.com.w.kunlunhuf.com,12,0.00%,12,0,100.00%
55.newspush.eastmoney.com,12,0.00%,12,0,100.00%
onedscolprdcus11.centralus.cloudapp.azure.com,12,0.00%,12,0,100.00%
cnzz.mmstat.com,12,0.00%,12,0,100.00%
img2018.cnblogs.com,12,0.00%,12,0,100.00%
onedriveclucproddm20042.blob.core.windows.net,12,0.00%,12,0,100.00%
loginserver.kuwo.cn,12,0.00%,12,0,100.00%
sslbaidu.gshifen.com,12,0.00%,22,10,54.55%
opencdnssl.jomodns.com,12,0.00%,12,0,100.00%
www.ysgc.cc,12,0.00%,12,0,100.00%
lf3-static.bytednsdoc.com,12,0.00%,20,8,60.00%
odc-commonafd-brs.onedrive.akadns.net,12,0.00%,16,4,75.00%
www.cnki.net,12,0.00%,12,0,100.00%
vfiles.gtimg.cn,12,0.00%,12,0,100.00%
liveupdate01s.asus.com.cn,12,0.00%,12,0,100.00%
wkbjcloudbos.bdimg.com,12,0.00%,14,2,85.71%
wkdsp.baidu.com,12,0.00%,12,0,100.00%
memberapi.bjx.com.cn,12,0.00%,12,0,100.00%
streaming.split.io,12,0.00%,12,0,100.00%
hwvipkid.vipkidcdn.com,12,0.00%,12,0,100.00%
1101576.sched.sma.tdnsstic1.cn,12,0.00%,12,0,100.00%
c-dun.security.ntes53.netease.com,12,0.00%,12,0,100.00%
cf.3g.qq.com,12,0.00%,12,0,100.00%
dl.winehq.org,12,0.00%,12,0,100.00%
home.vas.wpsdns.com,12,0.00%,12,0,100.00%
25.newspush.eastmoney.com,12,0.00%,12,0,100.00%
amer02.azure-devices.net,12,0.00%,12,0,100.00%
ip1880706116.funshion.com,12,0.00%,12,0,100.00%
service.weibo.com,12,0.00%,12,0,100.00%
recommend.docer.wps.cn,12,0.00%,12,0,100.00%
canonical-lgw01.cdn.snapcraftcontent.com,12,0.00%,12,0,100.00%
certs.apple.com,12,0.00%,22,10,54.55%
r2---sn-2x3elnes.gvt1.com,12,0.00%,12,0,100.00%
sub.kongfz.com,12,0.00%,12,0,100.00%
p4.music.126.net,12,0.00%,27,15,44.44%
s6.music.126.net,12,0.00%,24,12,50.00%
markets.businessinsider.com,12,0.00%,22,10,54.55%
gua8.qhimg.com,12,0.00%,13,1,92.31%
appimg.dbankcdn.com,12,0.00%,12,0,100.00%
ets99n9a.sched.sma.tdnsstic1.cn,12,0.00%,12,0,100.00%
einoo4ai.nodedata.net,12,0.00%,12,0,100.00%
bizaladdin-image.baidu.com,12,0.00%,12,0,100.00%
pcvideohwyunott.titan.mgtv.com,12,0.00%,12,0,100.00%
pics6.baidu.com,12,0.00%,20,8,60.00%
weather.mail.163.com,12,0.00%,12,0,100.00%
tycs.hpccube.com,12,0.00%,12,0,100.00%
emoji.qpic.cn.sched.legopic1.tdnsv6.com,12,0.00%,12,0,100.00%
www.xqqxs8.com,12,0.00%,12,0,100.00%
16-courier.push.apple.com,12,0.00%,12,0,100.00%
yeet4iel.nodedata.net,12,0.00%,12,0,100.00%
bili.acglego-dk.sched.tdnsv2.com,12,0.00%,26,14,46.15%
a1.cnblogs.com,12,0.00%,12,0,100.00%
line3-h5-mobile-api.biligame.com.dsa.dnsv1.com,12,0.00%,12,0,100.00%
collector.github.com,12,0.00%,12,0,100.00%
downloaddispatch-cdn.itunes-apple.com.akadns.net,12,0.00%,24,12,50.00%
sa1-authgw.cloudapp.net,12,0.00%,12,0,100.00%
query.aliyun.com,12,0.00%,12,0,100.00%
global.prd.cdn.globalsign.com,12,0.00%,18,6,66.67%
static.hotjar.com,12,0.00%,12,0,100.00%
humb.apple.com,12,0.00%,12,0,100.00%
fclog.baidu.com,12,0.00%,12,0,100.00%
forum.taichi.graphics,12,0.00%,12,0,100.00%
copycat.gitee.com,12,0.00%,12,0,100.00%
g.alicdn.com.danuoyi.alicdn.com,12,0.00%,23,11,52.17%
a1838.dscb.akamai.net,12,0.00%,32,20,37.50%
at.idqqimg.com,12,0.00%,12,0,100.00%
verify.zijieapi.com,12,0.00%,12,0,100.00%
grs.dbankcloud.asia,12,0.00%,12,0,100.00%
userlink.alicdn.com,12,0.00%,12,0,100.00%
l.gm.mob.com,12,0.00%,12,0,100.00%
v26.bdxiguavod.com,12,0.00%,17,5,70.59%
vdn5-1.vzuu.com,12,0.00%,16,4,75.00%
dynamic.api.tiles.ditu.live.com,12,0.00%,12,0,100.00%
www.so.com,12,0.00%,12,0,100.00%
p5.ssl.qhimg.com,12,0.00%,17,5,70.59%
p419.ssl.qhimgs4.com,12,0.00%,15,3,80.00%
ec.razer.com,12,0.00%,12,0,100.00%
7-courier.push.apple.com,12,0.00%,12,0,100.00%
simpledesktops.azurewebsites.net,12,0.00%,12,0,100.00%
ase2022.hotcrp.com,12,0.00%,12,0,100.00%
erp.dianbabyshop.id,12,0.00%,12,0,100.00%
www.soso.com,12,0.00%,12,0,100.00%
ddf.udpgetip.com,12,0.00%,12,0,100.00%
dy.xiajunhuagong.cn,12,0.00%,12,0,100.00%
ips-gw.gbd.hp10.us,12,0.00%,12,0,100.00%
p210-keyvalueservice.icloud.com.cn,12,0.00%,12,0,100.00%
logotool.hexun.com,12,0.00%,12,0,100.00%
ip1865110019.funshion.com,12,0.00%,12,0,100.00%
boot-02.net.anydesk.com,12,0.00%,12,0,100.00%
news.hexun.com,12,0.00%,12,0,100.00%
www.estrongs.com,12,0.00%,12,0,100.00%
krsk05.graniterapids.com,12,0.00%,12,0,100.00%
dict.iciba.com,12,0.00%,12,0,100.00%
onedriveclucproddm20030.blob.core.windows.net,12,0.00%,12,0,100.00%
s3m6.nzwgs.com,12,0.00%,13,1,92.31%
g7.biz.weibo.com,12,0.00%,12,0,100.00%
llvm.org,12,0.00%,12,0,100.00%
www.maxima.fm,12,0.00%,12,0,100.00%
tracker.0x.tf,12,0.00%,12,0,100.00%
download.get.live.cn,12,0.00%,12,0,100.00%
azwus2-client-s.gateway.messenger.live.com,12,0.00%,12,0,100.00%
union.video.qq.com,12,0.00%,12,0,100.00%
nbrecsys.4paradigm.com,12,0.00%,12,0,100.00%
triangle.mushtaqstakeaway.com,12,0.00%,12,0,100.00%
dx.3.cn,12,0.00%,12,0,100.00%
skunotify.jd.com,12,0.00%,12,0,100.00%
lwlog.laiwang.com,12,0.00%,12,0,100.00%
img02.sogoucdn.com,12,0.00%,12,0,100.00%
manifest.razerapi.com,12,0.00%,12,0,100.00%
onedriveclucproddm20004.blob.core.windows.net,12,0.00%,12,0,100.00%
yybadaccess.3g.qq.com,12,0.00%,12,0,100.00%
hnop.vicp.net,12,0.00%,12,0,100.00%
task.smartjump.pptv.com,12,0.00%,12,0,100.00%
ga.yiche.com,12,0.00%,12,0,100.00%
daws.azurewebsites.net,12,0.00%,12,0,100.00%
people-lucky-videos.obs.cn-north-4.myhuaweicloud.com,12,0.00%,12,0,100.00%
www.missevan.com,12,0.00%,12,0,100.00%
gaiic.caai.cn,12,0.00%,12,0,100.00%
ccai.caai.cn,12,0.00%,12,0,100.00%
data.crosscite.org,12,0.00%,12,0,100.00%
1d.tlu.dl.delivery.mp.microsoft.com,12,0.00%,12,0,100.00%
s107.gslb.ksyuncdn.com,11,0.00%,21,10,52.38%
zjcdnl.pullcmcc.gslb.d.live.cdn.chinamobile.com,11,0.00%,11,0,100.00%
hcdnl.pulldyin.hls.gslb.c.cdnhwc2.com,11,0.00%,23,12,47.83%
push-rtmp-vr-f5.s.bytefcdn.com,11,0.00%,11,0,100.00%
www.ifeng.com.cdn.dnsv1.com,11,0.00%,11,0,100.00%
img12.360buyimg.com,11,0.00%,26,15,42.31%
img20.360buyimg.com,11,0.00%,11,0,100.00%
ms-ceintl.gallerycdn.azure.cn,11,0.00%,11,0,100.00%
pptsgs.officeapps.live.com,11,0.00%,11,0,100.00%
asia.odcsm1.live.com.akadns.net,11,0.00%,11,0,100.00%
configuration-server-lb-1105093370.us-east-1.elb.amazonaws.com,11,0.00%,11,0,100.00%
pull-rtmp-l27.douyincdn.com.live-play.galileo.jcloud-cdn.com,11,0.00%,11,0,100.00%
pull-flv-l13.douyincdn.com.a.bcelive.com,11,0.00%,11,0,100.00%
www.douyu.com,11,0.00%,23,12,47.83%
api.vip.iqiyi.com,11,0.00%,11,0,100.00%
t9.baidu.com.a.bdydns.com,11,0.00%,16,5,68.75%
41.newspush.eastmoney.com,11,0.00%,11,0,100.00%
p205-contacts.icloud.com.cn,11,0.00%,11,0,100.00%
c.apple.news.edgekey.net,11,0.00%,23,12,47.83%
pull-hls-hs-f5-tsl.douyincdn.com.w.cdngslb.com,11,0.00%,16,5,68.75%
pull-flv-f96.douyincdn.com.d.live.cdn.chinamobile.com,11,0.00%,11,0,100.00%
pull-flv-f13.douyincdn.com.a.bcelive.com,11,0.00%,11,0,100.00%
hcdnl.pulldyin.rtm.gslb.c.cdnhwc2.com,11,0.00%,11,0,100.00%
pull-flv-l27.douyincdn.com.live-play.galileo.jcloud-cdn.com,11,0.00%,11,0,100.00%
push-rtmp-l95.douyincdn.com,11,0.00%,18,7,61.11%
push-rtmp-l95.douyincdn.com.ctdns.cn,11,0.00%,20,9,55.00%
push-rtmp-l3-enc.douyincdn.com.w.kunlunso.com,11,0.00%,11,0,100.00%
push-rtmp-l3-hs.pstatp.com.w.kunlunso.com,11,0.00%,11,0,100.00%
pull-tsl-spe-l26.douyincdn.com,11,0.00%,29,18,37.93%
prod.registrar.skype.com,11,0.00%,11,0,100.00%
match.deepintent.com,11,0.00%,11,0,100.00%
w.usabilla.com,11,0.00%,11,0,100.00%
snz04pap002.storage.live.com,11,0.00%,20,9,55.00%
store.xiaohongshu.com,11,0.00%,38,27,28.95%
jp.cloudss.online,11,0.00%,11,0,100.00%
s3a.pstatp.com.w.kunlungr.com,11,0.00%,38,27,28.95%
ipv6.open-internet.nl,11,0.00%,11,0,100.00%
tracker.leech.ie,11,0.00%,11,0,100.00%
pagead-googlehosted.l.google.com,11,0.00%,12,1,91.67%
13-courier.push.apple.com,11,0.00%,11,0,100.00%
ts1.cn.mm.bing.net.lxcvc.com,11,0.00%,11,0,100.00%
uptime.sangfor.net,11,0.00%,11,0,100.00%
iphone-ld.apple.com,11,0.00%,24,13,45.83%
pull-hls-vr-l26.douyincdn.com.c.cdnhwc3.com,11,0.00%,11,0,100.00%
push-rtmp-l26.douyincdn.com.c.cdnhwc3.com,11,0.00%,11,0,100.00%
push-rtmp-l6-cny.douyincdn.com.upvcloud.ks-cdn.com,11,0.00%,11,0,100.00%
push-rtmp-f5-hs.pstatp.com.c.bytefcdn.com,11,0.00%,11,0,100.00%
wx-love-img.afunapp.com.w.alikunlun.com,11,0.00%,11,0,100.00%
push-rtmp-f5.douyincdn.com.c.bytefcdn.com,11,0.00%,11,0,100.00%
p1.music.126.net,11,0.00%,22,11,50.00%
sat02pap003.storage.live.com,11,0.00%,21,10,52.38%
tracker.sjtu.edu.cn,11,0.00%,11,0,100.00%
v2.sohu.com,11,0.00%,19,8,57.89%
skeyword.browser.qq.com,11,0.00%,11,0,100.00%
baas.browser.qq.com,11,0.00%,11,0,100.00%
e2820.g.akamaiedge.net,11,0.00%,11,0,100.00%
cl5-cdn.origin-apple.com.akadns.net,11,0.00%,21,10,52.38%
ns1-proddns.glbdns.o365filtering.com,11,0.00%,11,0,100.00%
ns2-proddns.glbdns.o365filtering.com,11,0.00%,11,0,100.00%
baike.baidu.com,11,0.00%,27,16,40.74%
zhuanjia.cdn.bcebos.com,11,0.00%,11,0,100.00%
qb5x4edlyistb6qd2xzmaoe97c1s2aoo.yundunwaf5.com,11,0.00%,11,0,100.00%
s3.ssl.qhres2.com,11,0.00%,14,3,78.57%
push-rtmp-hs-f5-encryption.douyincdn.com,11,0.00%,11,0,100.00%
push-rtmp-hs-f5-encryption.douyincdn.com.c.volcfcdndvs.com,11,0.00%,11,0,100.00%
pull-flv-l11.douyincdn.com.sched.l10.tdnsv5.com,11,0.00%,11,0,100.00%
pull-hs-f5-encryption.flive.douyincdn.com.c.volcfcdndvs.com,11,0.00%,11,0,100.00%
push-rtmp-hs-f5.douyincdn.com,11,0.00%,11,0,100.00%
push-rtmp-vr-l1.douyincdn.com,11,0.00%,11,0,100.00%
pull-flv-l11-cny.douyincdn.com,11,0.00%,23,12,47.83%
push-rtmp-f5-enc.douyincdn.com.c.bytefcdn.com,11,0.00%,11,0,100.00%
21.newspush.eastmoney.com,11,0.00%,11,0,100.00%
www.homecookedgadgets.com,11,0.00%,11,0,100.00%
gspe79-cn-ssl.ls-apple.com.akadns.net,11,0.00%,17,6,64.71%
kanjiantu.com,11,0.00%,21,10,52.38%
onedscolprdfrc03.francecentral.cloudapp.azure.com,11,0.00%,11,0,100.00%
swscan-cdn.apple.com.akadns.net,11,0.00%,20,9,55.00%
us05.graniterapids.com,11,0.00%,11,0,100.00%
update-minipage.2345.cc,11,0.00%,11,0,100.00%
download.sublimetext.com,11,0.00%,11,0,100.00%
start.desktopcal.com,11,0.00%,11,0,100.00%
fc2tn.baidu.com,11,0.00%,11,0,100.00%
report-uri.baidu.com,11,0.00%,11,0,100.00%
exp-new.bdstatic.com,11,0.00%,14,3,78.57%
appdl-11-drcn.dbankcdn.com,11,0.00%,11,0,100.00%
195863-ipv4.farm.dprodmgd106.aa-rt.sharepoint.com,11,0.00%,11,0,100.00%
yuri-tracing.app.kdsec.org,11,0.00%,11,0,100.00%
ps.qhupdate.com,11,0.00%,11,0,100.00%
onedriveclucproddm20038.blob.core.windows.net,11,0.00%,11,0,100.00%
weu07-breeziest-in.cloudapp.net,11,0.00%,11,0,100.00%
calendars.fe.apple-dns.net,11,0.00%,22,11,50.00%
appdlc-drcn.hispace.dbankcloud.cn,11,0.00%,11,0,100.00%
aserver-heyi.m.taobao.com.gds.alibabadns.com,11,0.00%,11,0,100.00%
hiboardng.hicloud.com,11,0.00%,13,2,84.62%
msgacs.m.taobao.com,11,0.00%,11,0,100.00%
guide-acs.m.taobao.com,11,0.00%,22,11,50.00%
archiva-maven-storage-prod.oss-cn-beijing.aliyuncs.com,11,0.00%,11,0,100.00%
appcdcbj.jianguoyun.com,11,0.00%,11,0,100.00%
sync.search.spotxchange.com,11,0.00%,11,0,100.00%
eduall.buzzline.org,11,0.00%,11,0,100.00%
uu.update.netease.com,11,0.00%,11,0,100.00%
win.uu.163.com,11,0.00%,11,0,100.00%
g-fox.cn.w.kunlungr.com,11,0.00%,11,0,100.00%
time.ustc.edu.cn,11,0.00%,11,0,100.00%
ip1905173513.funshion.com,11,0.00%,11,0,100.00%
api.naea1.uds.lenovo.com,11,0.00%,11,0,100.00%
static.ws.126.net,11,0.00%,26,15,42.31%
c.m.163.com,11,0.00%,11,0,100.00%
static.cnblogs.com,11,0.00%,11,0,100.00%
28.newspush.eastmoney.com,11,0.00%,11,0,100.00%
c1.adform.net,11,0.00%,11,0,100.00%
digitalassetlinks.googleapis.com,11,0.00%,12,1,91.67%
assets.leetcode.cn,11,0.00%,11,0,100.00%
m.toutiao.com.w.kunlunle.com,11,0.00%,11,0,100.00%
lib.baomitu.com,11,0.00%,16,5,68.75%
www.toutiao.com.w.kunluncan.com,11,0.00%,19,8,57.89%
62.newspush.eastmoney.com,11,0.00%,11,0,100.00%
odc-commonafd-geo.onedrive.akadns.net,11,0.00%,15,4,73.33%
ip2100177547.funshion.com,11,0.00%,11,0,100.00%
bn1301.storage.live.com,11,0.00%,20,9,55.00%
ip.taobao.com,11,0.00%,11,0,100.00%
na61-na62.wagbridge.alibaba.taobao.com,11,0.00%,11,0,100.00%
40.newspush.eastmoney.com,11,0.00%,11,0,100.00%
26.newspush.eastmoney.com,11,0.00%,11,0,100.00%
wappass.baidu.com,11,0.00%,26,15,42.31%
fsoe.happyelements.cn,11,0.00%,11,0,100.00%
cis.sohu.com,11,0.00%,11,0,100.00%
sgp10.graniterapids.com,11,0.00%,11,0,100.00%
cstaticdun.126.net.w.kunluncan.com,11,0.00%,11,0,100.00%
www.aliyun.com,11,0.00%,11,0,100.00%
tiku.dhrest.com,11,0.00%,11,0,100.00%
www.infoq.cn,11,0.00%,11,0,100.00%
d0.awsstatic.com,11,0.00%,13,2,84.62%
quicpro.jd.com,11,0.00%,11,0,100.00%
clientnotification-userprodscus1-4.servicebus.windows.net,11,0.00%,11,0,100.00%
english.is.cas.cn,11,0.00%,11,0,100.00%
p2plog.douyucdn.cn,11,0.00%,30,19,36.67%
hcdnw.nozj.bili6.c.cdnhwc2.com,11,0.00%,16,5,68.75%
vd3.bdstatic.com,11,0.00%,23,12,47.83%
cdata.browser.360.cn,11,0.00%,11,0,100.00%
fides-pol.apple.com,11,0.00%,11,0,100.00%
btlr.sharethrough.com,11,0.00%,11,0,100.00%
onedriveclucproddm20027.blob.core.windows.net,11,0.00%,11,0,100.00%
baoku-safe.2345.cc,11,0.00%,11,0,100.00%
15.newspush.eastmoney.com,11,0.00%,11,0,100.00%
agoo-report.m.taobao.com,11,0.00%,11,0,100.00%
static.iqiyi.com,11,0.00%,22,11,50.00%
www.2.newsmth.net,11,0.00%,11,0,100.00%
apps.apple.com,11,0.00%,11,0,100.00%
ad.newsmth.net,11,0.00%,11,0,100.00%
267.bshl.ieplgia9929.net,11,0.00%,11,0,100.00%
onedriveclucprodbn20040.blob.core.windows.net,11,0.00%,11,0,100.00%
hermes.hupu.com,11,0.00%,11,0,100.00%
tp-b.pinduoduo.com,11,0.00%,11,0,100.00%
healthdata.hicloud.com,11,0.00%,11,0,100.00%
space.bilibili.com,11,0.00%,13,2,84.62%
sea-displaycatalogrp.frontdoor.bigcatalog.commerce.microsoft.com,11,0.00%,11,0,100.00%
onedscolprdfrc02.francecentral.cloudapp.azure.com,11,0.00%,11,0,100.00%
rq.kpcct.cloud.duba.net,11,0.00%,11,0,100.00%
mail-online.nosdn.127.net,11,0.00%,11,0,100.00%
provision.ccs.mcafee.com,11,0.00%,11,0,100.00%
lgincdnvzeuno.azureedge.net,11,0.00%,11,0,100.00%
calendars.icloud.com,11,0.00%,21,10,52.38%
www.iie.ac.cn,11,0.00%,11,0,100.00%
29.push2.eastmoney.com,11,0.00%,19,8,57.89%
oschina.gitee.io,11,0.00%,11,0,100.00%
mqtt.zhihu.com,11,0.00%,11,0,100.00%
api.amplitude.com,11,0.00%,18,7,61.11%
pic6.iqiyipic.com,11,0.00%,22,11,50.00%
p3.dcarimg.com,11,0.00%,11,0,100.00%
p207-contacts.icloud.com.cn,11,0.00%,11,0,100.00%
edivideo.grid.sinaedge.com,11,0.00%,23,12,47.83%
v3.bdxiguavod.com,11,0.00%,12,1,91.67%
laserver.logitech.io,11,0.00%,11,0,100.00%
puui.qpic.cn.sched.legopic1.tdnsv6.com,11,0.00%,11,0,100.00%
u999.v.bsclink.cn,11,0.00%,11,0,100.00%
eulixos.com,11,0.00%,11,0,100.00%
p.ssl.qhimg.com,11,0.00%,16,5,68.75%
p418.ssl.qhimgs4.com,11,0.00%,15,4,73.33%
p420.ssl.qhimgs4.com,11,0.00%,15,4,73.33%
bbs.nga.cn.wswebcdn.com,11,0.00%,11,0,100.00%
img4.nga.178.com,11,0.00%,11,0,100.00%
img4.nga.178.com.wscdns.com,11,0.00%,11,0,100.00%
garry.sgaas.net,11,0.00%,11,0,100.00%
a1815.co.w.tl88.net,11,0.00%,11,0,100.00%
d3u8eo6n4jxbvx.cloudfront.net,11,0.00%,11,0,100.00%
cphv-cdn-play.funshion.com,11,0.00%,11,0,100.00%
d28n7yywqog3r7.cloudfront.net,11,0.00%,11,0,100.00%
apoll.m.taobao.com,11,0.00%,11,0,100.00%
xueji.ucas.ac.cn,11,0.00%,11,0,100.00%
onedriveclucprodbn20026.blob.core.windows.net,11,0.00%,11,0,100.00%
log5-applog-lf.fqnovel.com,11,0.00%,11,0,100.00%
chifsr.lenovomm.com,11,0.00%,11,0,100.00%
monitor.e-cology.cn,11,0.00%,11,0,100.00%
fbs.smoot.apple.com,11,0.00%,11,0,100.00%
onedriveclucproddm20039.blob.core.windows.net,11,0.00%,11,0,100.00%
jcew-748738.pilot-supports.net,11,0.00%,11,0,100.00%
updatecollect.wps.cn,11,0.00%,11,0,100.00%
api.weibo.com,11,0.00%,11,0,100.00%
comet.blog.sina.com.cn,11,0.00%,11,0,100.00%
1.perf.msedge.net,11,0.00%,11,0,100.00%
ad.3.cn,11,0.00%,11,0,100.00%
diviner.jd.com,11,0.00%,11,0,100.00%
z163picipv6.v.bsclink.cn,11,0.00%,29,18,37.93%
th-a.pinduoduo.com,11,0.00%,11,0,100.00%
updatepro.wps.cn,11,0.00%,11,0,100.00%
alibaba.cdn.servers.hbly0592.com.cn,11,0.00%,11,0,100.00%
opencdnmbdstatic.jomodns.com,11,0.00%,11,0,100.00%
g.yccdn.com,11,0.00%,11,0,100.00%
m8.music.126.net.w.kunlungr.com,11,0.00%,14,3,78.57%
gaitc.caai.cn,11,0.00%,11,0,100.00%
ciis.caai.cn,11,0.00%,11,0,100.00%
info.lu.com,11,0.00%,11,0,100.00%
onedscolprdfrc04.francecentral.cloudapp.azure.com,10,0.00%,10,0,100.00%
pull-rtmp-l6-hs.pstatp.com,10,0.00%,18,8,55.56%
fyzbgp.a.sohu.com,10,0.00%,21,11,47.62%
chidc2.outbrain.org,10,0.00%,10,0,100.00%
img10.360buyimg.com,10,0.00%,23,13,43.48%
c-pay.lingkou.com,10,0.00%,10,0,100.00%
wxsnsdy.wxs.qq.com,10,0.00%,22,12,45.45%
hcdnw101.gslb.c.cdnhwc2.com,10,0.00%,10,0,100.00%
p209-contacts.icloud.com.cn,10,0.00%,10,0,100.00%
yiyun.n.shifen.com,10,0.00%,379,369,2.64%
swupmf.adobe.com,10,0.00%,19,9,52.63%
s03.gslb.ksyuncdn.com,10,0.00%,21,11,47.62%
pull-rtmp-l11.douyincdn.com.livecdn.liveplay.myqcloud.com,10,0.00%,10,0,100.00%
www2.deepl.com,10,0.00%,10,0,100.00%
webconf.douyucdn.cn,10,0.00%,20,10,50.00%
apiv2.douyucdn.cn,10,0.00%,12,2,83.33%
t14.baidu.com.a.bdydns.com,10,0.00%,16,6,62.50%
baijiahao.n.shifen.com,10,0.00%,10,0,100.00%
market.wsskj520.cn,10,0.00%,10,0,100.00%
7.newspush.eastmoney.com,10,0.00%,10,0,100.00%
dl.360safe.com.dl.360qhcdn.com,10,0.00%,18,8,55.56%
k128.gslb.ksyuncdn.com,10,0.00%,20,10,50.00%
dcbrowser.cqttech.com.w.kunlungr.com,10,0.00%,10,0,100.00%
ee15ba61-wschat-wschatalb-6fcf-2062696737.us-east-1.elb.amazonaws.com,10,0.00%,10,0,100.00%
pull-tsl-vr-l26.douyincdn.com,10,0.00%,23,13,43.48%
source-fcdn-spe-push.s.bytefcdn.com,10,0.00%,10,0,100.00%
push-rtmp-l27.douyincdn.com.live-publish.galileo.jcloud-cdn.com,10,0.00%,10,0,100.00%
push-rtmp-l3-cny.douyincdn.com.w.kunlunso.com,10,0.00%,10,0,100.00%
pull-rtmp-l6-source.douyincdn.com.rtmpvcloud.ks-cdn.com,10,0.00%,14,4,71.43%
push-rtmp-l11.douyincdn.com.livepush.myqcloud.com,10,0.00%,10,0,100.00%
pull-flv-l95.douyincdn.com.ctdns.cn,10,0.00%,17,7,58.82%
bcedyhls.jomodns.com,10,0.00%,10,0,100.00%
pull-lls-spe-l1.douyincdn.com.wsdvs.com,10,0.00%,10,0,100.00%
pull-tsl-spe-l3.douyincdn.com.230b2a2545cfa773.queniubg.com,10,0.00%,10,0,100.00%
push-rtmp-l3.douyincdn.com.w.kunlunso.com,10,0.00%,10,0,100.00%
pull-tsl-vr-l3.douyincdn.com.230b2a2545cfa773.queniubg.com,10,0.00%,10,0,100.00%
pull-flv-f1-proxy.douyincdn.com,10,0.00%,24,14,41.67%
pull-rtmp-l6.ixigua.com,10,0.00%,17,7,58.82%
pull-l3-source.douyincdn.com.w.cdngslb.com,10,0.00%,10,0,100.00%
pull-flv-spe-l26.douyincdn.com.c.cdnhwc3.com,10,0.00%,10,0,100.00%
ns5-65.akam.net,10,0.00%,10,0,100.00%
v1.douyinvod.com.wsdvs.com,10,0.00%,10,0,100.00%
s.f.qh-lb.com,10,0.00%,19,9,52.63%
queipo3w.nodedata.net,10,0.00%,10,0,100.00%
ieeexplore.demdex.net,10,0.00%,10,0,100.00%
upos-sz-staticcos.bilivideo.com,10,0.00%,23,13,43.48%
instruaccess.mcafee.com,10,0.00%,10,0,100.00%
gzjg.casholdings.com.cn,10,0.00%,10,0,100.00%
open.facedatabg.net,10,0.00%,10,0,100.00%
radarsubmissions.apple.com.akadns.net,10,0.00%,10,0,100.00%
cma-china.itunes-apple.com.akadns.net,10,0.00%,18,8,55.56%
cma-china-cdn.itunes-apple.com.akadns.net,10,0.00%,19,9,52.63%
onedscolprdfrc05.francecentral.cloudapp.azure.com,10,0.00%,10,0,100.00%
pull-tsl-spe-l1.douyincdn.com,10,0.00%,20,10,50.00%
pull-hls-spe-l26.douyincdn.com.c.cdnhwc3.com,10,0.00%,10,0,100.00%
push-rtmp-f5-io.flive.douyincdn.com.c.bytefcdn.com,10,0.00%,10,0,100.00%
pull-tsl-vr-l11.douyincdn.com,10,0.00%,27,17,37.04%
pull-flv-f1.douyincdn.com,10,0.00%,26,16,38.46%
pull-flv-l1-source.douyincdn.com,10,0.00%,24,14,41.67%
pull-tsl-spe-l3.douyincdn.com.bytedns1.com,10,0.00%,10,0,100.00%
pull-rtmp-f26.douyincdn.com.c.cdnhwc3.com,10,0.00%,10,0,100.00%
partiality.itunes.apple.com,10,0.00%,19,9,52.63%
krgame08.graniterapids.com,10,0.00%,10,0,100.00%
csdn.log-global.aliyuncs.com,10,0.00%,22,12,45.45%
ca.iadsdk.apple.com,10,0.00%,10,0,100.00%
ldc-open.lenovo.com.cn,10,0.00%,10,0,100.00%
iadsdk.apple.com.akadns.net,10,0.00%,10,0,100.00%
telemetry.rancher.io,10,0.00%,10,0,100.00%
weu011-breeziest-in.cloudapp.net,10,0.00%,10,0,100.00%
api-access.pangolin-sdk-toutiao.com.w.cdngslb.com,10,0.00%,10,0,100.00%
in2-prod-east-us2-23fa330.trafficmanager.net,10,0.00%,11,1,90.91%
swdist.apple.com,10,0.00%,15,5,66.67%
gecko-pangle-lf.snssdk.com,10,0.00%,10,0,100.00%
newtab.firefoxchina.cn.lxcvc.com,10,0.00%,18,8,55.56%
arch.ver.input.yunbiaosoft.com,10,0.00%,32,22,31.25%
firefox-settings-attachments.cdn.mozilla.net,10,0.00%,10,0,100.00%
ccc.hpeprint.com,10,0.00%,10,0,100.00%
35-courier.push.apple.com,10,0.00%,10,0,100.00%
pull-flv-l11.douyincdn.com.live.qcloudcdn.com,10,0.00%,10,0,100.00%
captcha.gtimg.com.sched.legopic1.tdnsv6.com,10,0.00%,10,0,100.00%
94.newspush.eastmoney.com,10,0.00%,10,0,100.00%
keke.re,10,0.00%,10,0,100.00%
gspe79-cn-ssl.ls.apple.com.download.ks-cdn.com,10,0.00%,16,6,62.50%
community.adobe.com,10,0.00%,23,13,43.48%
njtbcsp2p.n.shifen.com,10,0.00%,10,0,100.00%
api.islide.cc,10,0.00%,10,0,100.00%
tcbox.baidu.com,10,0.00%,10,0,100.00%
ossapi.baidu.com,10,0.00%,10,0,100.00%
18.courier-push-apple.com.akadns.net,10,0.00%,10,0,100.00%
onedriveclucproddm20012.blob.core.windows.net,10,0.00%,10,0,100.00%
archiva-maven-storage-prod.oss-cn-beijing.aliyuncs.com.gds.alibabadns.com,10,0.00%,10,0,100.00%
reswx.mid.tdnsv6.com,10,0.00%,22,12,45.45%
sgp06.graniterapids.com,10,0.00%,10,0,100.00%
appdl6-drcn.dbankcdn.cn,10,0.00%,15,5,66.67%
appdl-12-drcn.dbankcdn.com,10,0.00%,10,0,100.00%
appdl-3-drcn.dbankcdn.com,10,0.00%,10,0,100.00%
gsp10-ssl.apple.com,10,0.00%,10,0,100.00%
17.courier-push-apple.com.akadns.net,10,0.00%,10,0,100.00%
opencdnmsdl.jomodns.com,10,0.00%,10,0,100.00%
profile.blzstatic.cn,10,0.00%,10,0,100.00%
195863-ipv4.gr.global.aa-rt.sharepoint.com,10,0.00%,10,0,100.00%
teams-staticscdn.trafficmanager.net,10,0.00%,11,1,90.91%
a1813.cn.w.tl88.net,10,0.00%,10,0,100.00%
config.fp.measure.office.com,10,0.00%,14,4,71.43%
jkbxcx-static.yqgz.beijing.gov.cn,10,0.00%,10,0,100.00%
devicemetadataservice.prod.trafficmanager.net,10,0.00%,10,0,100.00%
a1858.dscd.akamai.net,10,0.00%,20,10,50.00%
waws-prod-bay-045a.cloudapp.net,10,0.00%,10,0,100.00%
oaagent.n.shifen.com,10,0.00%,10,0,100.00%
download.lenovo.com.edgekey.net,10,0.00%,10,0,100.00%
api.addins.omex.office.net,10,0.00%,10,0,100.00%
vcs.zijieapi.com,10,0.00%,10,0,100.00%
a239.gi3.akamai.net,10,0.00%,10,0,100.00%
356297.sched.dma.tdnsdl1.cn,10,0.00%,10,0,100.00%
cu1pehnsmps01.servicebus.windows.net,10,0.00%,10,0,100.00%
ip1865976393.funshion.com,10,0.00%,10,0,100.00%
file.cdn.cqttech.com,10,0.00%,10,0,100.00%
download.gluster.org,10,0.00%,10,0,100.00%
log.gds.mmstat.com,10,0.00%,10,0,100.00%
only-285968-218-107-55-252.nstool.haowu.link,10,0.00%,10,0,100.00%
passport.126.com,10,0.00%,10,0,100.00%
iplocator.mail.163.com,10,0.00%,10,0,100.00%
q.reg.163.com,10,0.00%,10,0,100.00%
buy.itunes-apple.com.akadns.net,10,0.00%,10,0,100.00%
sconsentit9.trafficmanager.net,10,0.00%,10,0,100.00%
pgy-api.oray.com,10,0.00%,10,0,100.00%
yz.ijianji.com,10,0.00%,10,0,100.00%
dev.virtualearth.net,10,0.00%,10,0,100.00%
www.las.ac.cn,10,0.00%,10,0,100.00%
csi.gstatic.com,10,0.00%,10,0,100.00%
fc1tn.baidu.com.a.bdydns.com,10,0.00%,10,0,100.00%
platform.mcafee.com,10,0.00%,10,0,100.00%
crl.globalsign.com,10,0.00%,10,0,100.00%
googlecn-lopri.l.google.com,10,0.00%,22,12,45.45%
asia.configsvc1.live.com.akadns.NET,10,0.00%,10,0,100.00%
softbus-msg.wps.cn,10,0.00%,10,0,100.00%
usstartus2.eucdurl.me,10,0.00%,10,0,100.00%
opencdnglobal.jomodns.com,10,0.00%,10,0,100.00%
g.163.com,10,0.00%,10,0,100.00%
centertime.ksyun.com,10,0.00%,10,0,100.00%
15.push2.eastmoney.com,10,0.00%,17,7,58.82%
53.newspush.eastmoney.com,10,0.00%,10,0,100.00%
3.cn.pool.ntp.org,10,0.00%,10,0,100.00%
conn-im.xiaoeknow.com,10,0.00%,10,0,100.00%
static.leetcode-cn.com,10,0.00%,10,0,100.00%
sf1-cdn-tos.toutiaostatic.com,10,0.00%,19,9,52.63%
lf9-static.bytednsdoc.com,10,0.00%,20,10,50.00%
p1.toutiaoimg.com,10,0.00%,19,9,52.63%
sf6-cdn-tos.toutiaostatic.com,10,0.00%,19,9,52.63%
lf3-beecdn.bytetos.com,10,0.00%,20,10,50.00%
3.newspush.eastmoney.com,10,0.00%,10,0,100.00%
cnallaz.eucdurl.me,10,0.00%,10,0,100.00%
u4.trakx.crim.ist,10,0.00%,10,0,100.00%
slb-p2p.vcloud.ks-live.com,10,0.00%,22,12,45.45%
static.nowcoder.com,10,0.00%,10,0,100.00%
waws-prod-bay-045a.sip.azurewebsites.windows.net,10,0.00%,10,0,100.00%
70.newspush.eastmoney.com,10,0.00%,10,0,100.00%
pollserver.lastpass.com,10,0.00%,10,0,100.00%
api.51ifonts.com,10,0.00%,10,0,100.00%
s4.cn.bing.net,10,0.00%,10,0,100.00%
3492994106-server.va.huya.com,10,0.00%,10,0,100.00%
torrentclub.space,10,0.00%,10,0,100.00%
s.qhupdate.com,10,0.00%,10,0,100.00%
china3-lb.itunes-apple.com.akadns.net,10,0.00%,10,0,100.00%
zntlqjq2sysuepfiwbyuvlvuog9tprst.aliyundunwaf.com,10,0.00%,10,0,100.00%
auth-sl.oray.com,10,0.00%,10,0,100.00%
img.kaikeba.com,10,0.00%,10,0,100.00%
ajax.aspnetcdn.com,10,0.00%,10,0,100.00%
ctlogin2.qq.com,10,0.00%,10,0,100.00%
seed-siri-apple-com.v.aaplimg.com,10,0.00%,10,0,100.00%
pool.nto.org,10,0.00%,10,0,100.00%
s24-sync.firefox.com.cn,10,0.00%,10,0,100.00%
p122-contacts.icloud.com,10,0.00%,18,8,55.56%
ins-giuzhgwa.ias.tencent-cloud.net,10,0.00%,10,0,100.00%
gsa.idms-apple.com.akadns.net,10,0.00%,10,0,100.00%
51.newspush.eastmoney.com,10,0.00%,10,0,100.00%
asia.ocws1.live.com.akadns.net,10,0.00%,10,0,100.00%
data.video.iqiyi.com,10,0.00%,10,0,100.00%
datax.baidu.com,10,0.00%,10,0,100.00%
i.vip.iqiyi.com,10,0.00%,10,0,100.00%
img8.file.cache.docer.com,10,0.00%,10,0,100.00%
contacts.icloud.com,10,0.00%,20,10,50.00%
cs1137261584.wpc.phicdn.net,10,0.00%,10,0,100.00%
prod.intellicode.vsengsaas.visualstudio.com,10,0.00%,10,0,100.00%
au.qq.com,10,0.00%,10,0,100.00%
mobilep2.douyucdn2.cn,10,0.00%,10,0,100.00%
mobilep1.douyucdn2.cn,10,0.00%,10,0,100.00%
cloud.10jqka.com.cn,10,0.00%,10,0,100.00%
link.zhihu.com,10,0.00%,19,9,52.63%
pcvideoctyun.titan.mgtv.com,10,0.00%,10,0,100.00%
us10.graniterapids.com,10,0.00%,10,0,100.00%
w.irs03.com,10,0.00%,10,0,100.00%
pingtas.qq.com,10,0.00%,10,0,100.00%
20-courier.push.apple.com,10,0.00%,10,0,100.00%
jvod.300hu.com,10,0.00%,20,10,50.00%
s2.music.126.net,10,0.00%,10,0,100.00%
render.alipay.com,10,0.00%,10,0,100.00%
sofire.baidu.com,10,0.00%,22,12,45.45%
streamingaudio.itunes.apple.com,10,0.00%,12,2,83.33%
na61-na62.wagbridge.alibaba.tanx.com,10,0.00%,10,0,100.00%
amp-api-edge-lb.itunes-apple.com.akadns.net,10,0.00%,18,8,55.56%
ups.analytics.yahoo.com,10,0.00%,10,0,100.00%
device-provisioning.googleapis.com,10,0.00%,18,8,55.56%
shugcup.music.qq.com,10,0.00%,10,0,100.00%
u.y.qq.com,10,0.00%,10,0,100.00%
pics2.baidu.com,10,0.00%,16,6,62.50%
s.conf.wsm.360.cn,10,0.00%,11,1,90.91%
66.newspush.eastmoney.com,10,0.00%,10,0,100.00%
e4578.dscb.akamaiedge.net,10,0.00%,23,13,43.48%
cms.tanx.com,10,0.00%,10,0,100.00%
46.newspush.eastmoney.com,10,0.00%,10,0,100.00%
98.newspush.eastmoney.com,10,0.00%,10,0,100.00%
firefox.com.cn,10,0.00%,10,0,100.00%
cmshow.gtimg.cn.cloud.tc.qq.com,10,0.00%,11,1,90.91%
mcloud.mcafee.com,10,0.00%,10,0,100.00%
datahub.zhihu.com,10,0.00%,10,0,100.00%
lvs.52tt.com,10,0.00%,10,0,100.00%
crs.cr.adobe.com,10,0.00%,10,0,100.00%
cdn-wx-v6-lds.ludashi.com,10,0.00%,10,0,100.00%
a1806.dscb.akamai.net,10,0.00%,30,20,33.33%
le3-api.game.bilibili.com.dsa.dnsv1.com,10,0.00%,10,0,100.00%
boss.hdslb.com.04f6a54d.c.cdnhwc1.com,10,0.00%,11,1,90.91%
onedscolprdjpw03.japanwest.cloudapp.azure.com,10,0.00%,10,0,100.00%
www.01os.org,10,0.00%,10,0,100.00%
rdp.duetdisplay.com,10,0.00%,20,10,50.00%
musicps.p2p.qq.com,10,0.00%,10,0,100.00%
tmead.y.qq.com,10,0.00%,10,0,100.00%
p3-be-pack-sign.pglstatp-toutiao.com,10,0.00%,12,2,83.33%
play-tx-ugcpub.douyucdn2.cn,10,0.00%,10,0,100.00%
csd-apt-eas-d-2.eastasia.cloudapp.azure.com,10,0.00%,10,0,100.00%
onedriveclucprodbn20030.blob.core.windows.net,10,0.00%,10,0,100.00%
vcheck.f.360.cn,10,0.00%,10,0,100.00%
24.newspush.eastmoney.com,10,0.00%,10,0,100.00%
chouchou.top,10,0.00%,10,0,100.00%
bs5.360sres.com,10,0.00%,10,0,100.00%
bs4.360sres.com,10,0.00%,10,0,100.00%
se4.360simg.com,10,0.00%,10,0,100.00%
p13.upd.kaspersky.com,10,0.00%,10,0,100.00%
doc.weixin.qq.com,10,0.00%,10,0,100.00%
api.wordpress.org,10,0.00%,10,0,100.00%
musicstatus.edge-itunes-apple.com.akadns.net,10,0.00%,10,0,100.00%
musicstatus-apac.edge-itunes-apple.com.akadns.net,10,0.00%,10,0,100.00%
onedriveclucproddm20043.blob.core.windows.net,10,0.00%,10,0,100.00%
wgo.mmstat.com,10,0.00%,10,0,100.00%
dy.163.com,10,0.00%,10,0,100.00%
mail24.dot.gov.ae,10,0.00%,10,0,100.00%
s.union.360.cn,10,0.00%,10,0,100.00%
cds.apple.com.akadns.net,10,0.00%,10,0,100.00%
x.bidswitch.net,10,0.00%,10,0,100.00%
www.comet.com,10,0.00%,10,0,100.00%
www.onenote.com,10,0.00%,10,0,100.00%
lx.microvirt.com,10,0.00%,10,0,100.00%
gss3.bdstatic.com,10,0.00%,10,0,100.00%
support.amd.com,10,0.00%,10,0,100.00%
print-data.houston.hp.com,10,0.00%,10,0,100.00%
kuaikan.netmon.360safe.com,10,0.00%,10,0,100.00%
azwus2-client-s.msnmessenger.msn.com.akadns.net,10,0.00%,10,0,100.00%
jcm.jd.com,10,0.00%,10,0,100.00%
cdp-tlu-shim.trafficmanager.net,10,0.00%,10,0,100.00%
orderop.jd.com,10,0.00%,10,0,100.00%
socket-message.zhixi.com,10,0.00%,10,0,100.00%
qbuniplugin.html5.qq.com,10,0.00%,10,0,100.00%
iscas.arp.cn,10,0.00%,10,0,100.00%
cap.easypass.cn,10,0.00%,10,0,100.00%
my.jjwxc.net,10,0.00%,10,0,100.00%
s08.upd.kaspersky.com,10,0.00%,10,0,100.00%
nsl.mbgcdn.lenovo.com.cn,10,0.00%,10,0,100.00%
xdssp.mediav.com,10,0.00%,10,0,100.00%
internal-api-lark-api.feishu.cn.dsa.dnsv1.com.cn,10,0.00%,10,0,100.00%
wegame.gtimg.com,10,0.00%,10,0,100.00%
www.medra.org,10,0.00%,10,0,100.00%
h2tcbox.baidu.com,10,0.00%,10,0,100.00%
pull-hls-f26.douyincdn.com,9,0.00%,24,15,37.50%
jnn-pa.googleapis.com,9,0.00%,18,9,50.00%
tj.psvr.wps.cn,9,0.00%,9,0,100.00%
tracker.lilithraws.cf,9,0.00%,400,391,2.25%
blackhole-m.m.jd.com,9,0.00%,14,5,64.29%
www.360kuai.com,9,0.00%,9,0,100.00%
darwin.qianxin.com,9,0.00%,9,0,100.00%
appsforoffice.microsoft.com,9,0.00%,9,0,100.00%
pull-fcdn-douyin-base.s.bytefcdn.com,9,0.00%,9,0,100.00%
39-courier.push.apple.com,9,0.00%,9,0,100.00%
26-courier.push.apple.com,9,0.00%,9,0,100.00%
onedscolprdjpw00.japanwest.cloudapp.azure.com,9,0.00%,9,0,100.00%
t15.baidu.com.a.bdydns.com,9,0.00%,15,6,60.00%
pubgw.api.ddxq.mobi,9,0.00%,18,9,50.00%
public.tracker.vraphim.com,9,0.00%,9,0,100.00%
tracker.army,9,0.00%,9,0,100.00%
metok.sys.miui.com,9,0.00%,9,0,100.00%
38.newspush.eastmoney.com,9,0.00%,9,0,100.00%
32.newspush.eastmoney.com,9,0.00%,9,0,100.00%
27.newspush.eastmoney.com,9,0.00%,9,0,100.00%
s6110-ml.gslb.ksyuncdn.com,9,0.00%,22,13,40.91%
pull-rtmp-f6-hs.pstatp.com.rtmpvcloud.ks-cdn.com,9,0.00%,17,8,52.94%
pull-rtmp-l13.douyincdn.com.a.bcelive.com,9,0.00%,9,0,100.00%
pull-tsl-l3.douyincdn.com.w.alikunlun.net,9,0.00%,9,0,100.00%
push-rtmp-l3-encryption.douyincdn.com.w.kunlunso.com,9,0.00%,9,0,100.00%
pull-flv-l6-enc.douyincdn.com.hdlvcloud.ks-cdn.com,9,0.00%,13,4,69.23%
pull-hls-f1.douyincdn.com.wsdvs.com,9,0.00%,18,9,50.00%
pull-spe-l3.douyincdn.com.230b2a2545cfa773.queniucf.com,9,0.00%,9,0,100.00%
pull-fcdn-rts.s.bytefcdn.com,9,0.00%,9,0,100.00%
pull-rtmp-l95.douyincdn.com.ctdns.cn,9,0.00%,18,9,50.00%
pull-tsl-spe-l6.douyincdn.com,9,0.00%,23,14,39.13%
pull-tsl-vr-l1.douyincdn.com.wsdvs.com,9,0.00%,23,14,39.13%
pull-flv-f1-hs.pstatp.com.wsdvs.com,9,0.00%,17,8,52.94%
push.ulive.ugslb.com,9,0.00%,9,0,100.00%
s6120-ml.gslb.ksyuncdn.com,9,0.00%,17,8,52.94%
pull-fcdn-huoshan-base.s.bytefcdn.com,9,0.00%,9,0,100.00%
toutiao.hdllive.ks-cdn.com,9,0.00%,14,5,64.29%
push-rtmp-spe-l3.douyincdn.com.230b2a2545cfa773.queniufm.com,9,0.00%,9,0,100.00%
pull-flv-f5-enc.flive.douyincdn.com.c.bytefcdn.com,9,0.00%,9,0,100.00%
production.skype-registar.akadns.net,9,0.00%,9,0,100.00%
ieeexplore.ieee.org,9,0.00%,20,11,45.00%
app.cadmoremedia.com,9,0.00%,9,0,100.00%
nydc1.outbrain.org,9,0.00%,9,0,100.00%
csm.sg1.vip.prod.criteo.net,9,0.00%,9,0,100.00%
sdk.iad-05.braze.com,9,0.00%,9,0,100.00%
recsys.cnki.net,9,0.00%,9,0,100.00%
gameplayapi.intel.com,9,0.00%,22,13,40.91%
tracker.swateam.org.uk,9,0.00%,9,0,100.00%
push-rtmp-f5-vs.douyincdn.com.c.bytefcdn.com,9,0.00%,9,0,100.00%
pull-hls-vr-l1.douyincdn.com,9,0.00%,20,11,45.00%
push-rtmp-spe-l11.douyincdn.com.tlivepush.com,9,0.00%,9,0,100.00%
pull-flv-f11-proxy.douyincdn.com.tcdnlive.com,9,0.00%,9,0,100.00%
pull-hls-hs-f5-tsl.douyincdn.com.bytedns1.com,9,0.00%,12,3,75.00%
pull-rtmp-f6-hs.pstatp.com,9,0.00%,17,8,52.94%
pull-flv-l6-hs.pstatp.com,9,0.00%,14,5,64.29%
push-rtmp-l11-encryption.douyincdn.com.tlivepush.com,9,0.00%,9,0,100.00%
gimg3.baidu.com.a.bdydns.com,9,0.00%,15,6,60.00%
api.crush.163.com,9,0.00%,9,0,100.00%
weu014-breeziest-in.cloudapp.net,9,0.00%,9,0,100.00%
i.w.bilicdn1.com,9,0.00%,19,10,47.37%
sl-collection.oray.net,9,0.00%,9,0,100.00%
security.ie.sogou.com,9,0.00%,9,0,100.00%
mat1.gtimg.com,9,0.00%,18,9,50.00%
a.shentonggo.cn,9,0.00%,9,0,100.00%
antispam.wanmei.com,9,0.00%,9,0,100.00%
tools.l.google.com,9,0.00%,30,21,30.00%
p209-quota.icloud.com.cn,9,0.00%,9,0,100.00%
in1-gw2-01-ce7dd027.eastus2.cloudapp.azure.com,9,0.00%,17,8,52.94%
sgp11.graniterapids.com,9,0.00%,9,0,100.00%
static.geetest.com,9,0.00%,25,16,36.00%
med-fe.cdn.bcebos.com,9,0.00%,12,3,75.00%
cache.video.iqiyi.com,9,0.00%,27,18,33.33%
prod-oauth-public-alb-939786626.eu-west-1.elb.amazonaws.com,9,0.00%,9,0,100.00%
pull-flv-vr-l1.douyincdn.com,9,0.00%,21,12,42.86%
pull-flv-f6-hs.pstatp.com,9,0.00%,15,6,60.00%
pull-flv-f1-hs.pstatp.com,9,0.00%,16,7,56.25%
pull-hls-vr-l6.douyincdn.com,9,0.00%,22,13,40.91%
pull-tsl-spe-l11.douyincdn.com,9,0.00%,21,12,42.86%
72.newspush.eastmoney.com,9,0.00%,9,0,100.00%
krsk01.graniterapids.com,9,0.00%,9,0,100.00%
m.ykimg.com,9,0.00%,19,10,47.37%
ext.se.360.cn,9,0.00%,9,0,100.00%
hivoice-drcn.emui.dbankcloud.com,9,0.00%,9,0,100.00%
arxiv.org,9,0.00%,9,0,100.00%
extie.sogoucdn.com,9,0.00%,9,0,100.00%
jzed1uig.sched.sma.tdnsstic1.cn,9,0.00%,9,0,100.00%
4xbn6851.sched.sma.tdnsstic1.cn,9,0.00%,9,0,100.00%
20.courier-push-apple.com.akadns.net,9,0.00%,9,0,100.00%
seupdate.360qhcdn.com,9,0.00%,9,0,100.00%
api.pixso.cn,9,0.00%,9,0,100.00%
cloudphoto-drcn.cloud.dbankcloud.cn,9,0.00%,9,0,100.00%
sec.sginput.qq.com,9,0.00%,9,0,100.00%
s3m1.fenxi.com,9,0.00%,9,0,100.00%
onedriveclucprodbn20029.blob.core.windows.net,9,0.00%,9,0,100.00%
dlied6.qq.com.yyb.sched.dcloudstc.com,9,0.00%,9,0,100.00%
b.nstool.ntes53.netease.com,9,0.00%,9,0,100.00%
discussion.evernote.com,9,0.00%,9,0,100.00%
counter.ksosoft.com,9,0.00%,9,0,100.00%
qosidc.gcloudsdk.com,9,0.00%,9,0,100.00%
cdn.staticfile.org,9,0.00%,24,15,37.50%
ns1.abudhabi.ae,9,0.00%,9,0,100.00%
b23.tv,9,0.00%,10,1,90.00%
radio.itunes.apple.com,9,0.00%,25,16,36.00%
iyes.youku.com,9,0.00%,9,0,100.00%
www.wjx.cn,9,0.00%,9,0,100.00%
kvt.sddan.com,9,0.00%,9,0,100.00%
httpdns.huaweicloud.com,9,0.00%,9,0,100.00%
video.zhihu.com,9,0.00%,14,5,64.29%
nearby-drcn.platform.dbankcloud.com,9,0.00%,9,0,100.00%
dsp.lenovo.com.cn.trpcdn.net,9,0.00%,9,0,100.00%
d2-toutiao-ipv6-ml.gslb.ksyuncdn.com,9,0.00%,27,18,33.33%
conf-drcn.cloud.dbankcloud.cn,9,0.00%,9,0,100.00%
m804.music.126.net,9,0.00%,9,0,100.00%
nsp-logservice-hiview-p41-drcn.obs.cn-north-2.myhuaweicloud.com,9,0.00%,9,0,100.00%
cn-pek-ali-r001.router.teamviewer.cn,9,0.00%,9,0,100.00%
www.holidayiq.com,9,0.00%,9,0,100.00%
world.qpic.cn,9,0.00%,23,14,39.13%
scdown.qq.com,9,0.00%,9,0,100.00%
vcl-brain.snssdk.com,9,0.00%,9,0,100.00%
ms.bdimg.com.a.bdydns.com,9,0.00%,13,4,69.23%
vl.ff.avast.com,9,0.00%,9,0,100.00%
filerep-replica.ff.avast.com,9,0.00%,9,0,100.00%
a2047.dscb.akamai.net,9,0.00%,18,9,50.00%
onedriveclucproddm20014.blob.core.windows.net,9,0.00%,9,0,100.00%
statics.teams.cdn.office.net-c.edgesuite.net.globalredir.akadns.net,9,0.00%,9,0,100.00%
us04.graniterapids.com,9,0.00%,9,0,100.00%
14.push2.eastmoney.com,9,0.00%,18,9,50.00%
uk.pool.ntp.org,9,0.00%,9,0,100.00%
scenario-drcn.things.dbankcloud.cn,9,0.00%,9,0,100.00%
opencdnbdbaike.jomodns.com,9,0.00%,27,18,33.33%
smarturl.sync.maxthon.cn,9,0.00%,9,0,100.00%
p1-tt.byteimg.com.wsglb0.com,9,0.00%,17,8,52.94%
p9-tt.byteimg.com,9,0.00%,16,7,56.25%
apps.bdimg.com,9,0.00%,9,0,100.00%
sgepodownload.mediatek.com,9,0.00%,19,10,47.37%
23.newspush.eastmoney.com,9,0.00%,9,0,100.00%
81.newspush.eastmoney.com,9,0.00%,9,0,100.00%
bl6pap004.storage.live.com,9,0.00%,18,9,50.00%
canary.mask.apple-dns.net,9,0.00%,21,12,42.86%
qtstm32fan.ru,9,0.00%,9,0,100.00%
s95.cnzz.com,9,0.00%,9,0,100.00%
rs.sinajs.cn,9,0.00%,9,0,100.00%
iduy64c.qiniudns.com,9,0.00%,20,11,45.00%
20.newspush.eastmoney.com,9,0.00%,9,0,100.00%
56.newspush.eastmoney.com,9,0.00%,9,0,100.00%
interface.sina.cn,9,0.00%,9,0,100.00%
j.bs.twlxxl.cn,9,0.00%,9,0,100.00%
h5.ssp.qq.com,9,0.00%,12,3,75.00%
track.sohu.com,9,0.00%,9,0,100.00%
vdn6-1.vzuu.com.w.kunluncan.com,9,0.00%,10,1,90.00%
p203-quota.icloud.com.cn,9,0.00%,9,0,100.00%
open.work.weixin.qq.com,9,0.00%,15,6,60.00%
jwxk.ucas.ac.cn,9,0.00%,9,0,100.00%
admin.videoenpoche.info,9,0.00%,9,0,100.00%
onedriveclucproddm20007.blob.core.windows.net,9,0.00%,9,0,100.00%
pm.w55c.net,9,0.00%,9,0,100.00%
diagnosis.ludashi.com,9,0.00%,9,0,100.00%
cdn-ali-img-shstaticbz.shanhutech.cn,9,0.00%,9,0,100.00%
sh.jd.com,9,0.00%,9,0,100.00%
js.stripe.com,9,0.00%,9,0,100.00%
weu016-breeziest-in.cloudapp.net,9,0.00%,9,0,100.00%
68.push2.eastmoney.com,9,0.00%,16,7,56.25%
87.newspush.eastmoney.com,9,0.00%,9,0,100.00%
iphonesubmissions.v.aaplimg.com,9,0.00%,9,0,100.00%
ip-api.com,9,0.00%,9,0,100.00%
class.csslcloud.net,9,0.00%,9,0,100.00%
in1-gw2-02-ce7dd027.eastus2.cloudapp.azure.com,9,0.00%,9,0,100.00%
bimp.hdslb.com.w.cdngslb.com,9,0.00%,22,13,40.91%
m7.music.126.net.w.alikunlun.com,9,0.00%,10,1,90.00%
mip.api.mcafeewebadvisor.com,9,0.00%,9,0,100.00%
fpdownload2.macromedia.com,9,0.00%,18,9,50.00%
imapi.douyin.com,9,0.00%,9,0,100.00%
update10.sangfor.net,9,0.00%,9,0,100.00%
pgdt.ugdtimg.com,9,0.00%,10,1,90.00%
sdk-open-phone.getui.com,9,0.00%,17,8,52.94%
upos-sz-mirrorhw.bilivideo.com.c.cdnhwc1.com,9,0.00%,10,1,90.00%
locate.ie.sogou.com,9,0.00%,9,0,100.00%
ie.sogou.com,9,0.00%,9,0,100.00%
pic1.iqiyipic.com,9,0.00%,18,9,50.00%
48.push2.eastmoney.com,9,0.00%,16,7,56.25%
e10198.b.akamaiedge.net,9,0.00%,9,0,100.00%
api.open.360-game.net,9,0.00%,11,2,81.82%
admin.iscas.ac.cn,9,0.00%,9,0,100.00%
activations.devmate.com,9,0.00%,9,0,100.00%
image2.pubmatic.com,9,0.00%,9,0,100.00%
cm.adgrx.com,9,0.00%,9,0,100.00%
jspassport.ssl.qhimg.com,9,0.00%,14,5,64.29%
orc.veryamt.com,9,0.00%,9,0,100.00%
img20.jcloud-cdn.com,9,0.00%,9,0,100.00%
a-0003.dc-msedge.net,9,0.00%,9,0,100.00%
stat.wup.huya.com,9,0.00%,9,0,100.00%
v6-default.ixigua.com,9,0.00%,9,0,100.00%
weu08-breeziest-in.cloudapp.net,9,0.00%,9,0,100.00%
32.courier-push-apple.com.akadns.net,9,0.00%,9,0,100.00%
push2.trafficmanager.cn,9,0.00%,18,9,50.00%
f7.baidu.com.a.bdydns.com,9,0.00%,14,5,64.29%
waws-prod-hk1-007.cloudapp.net,9,0.00%,9,0,100.00%
priceengine-public-service-ecomprod01.ol.epicgames.com,9,0.00%,9,0,100.00%
miniapp.bilibili.com,9,0.00%,10,1,90.00%
api-lequ.iqiyi.com,9,0.00%,9,0,100.00%
res.servicewechat.com.sched.legopic1.tdnsv6.com,9,0.00%,9,0,100.00%
p-th.bing.com.trafficmanager.net,9,0.00%,9,0,100.00%
page.aliyun.com,9,0.00%,9,0,100.00%
tracker.filemail.com,9,0.00%,9,0,100.00%
hk.bdstatic.com,9,0.00%,9,0,100.00%
gomediago.baidu.com,9,0.00%,9,0,100.00%
udpolimeok.baidu.com,9,0.00%,9,0,100.00%
cmshow.gtimg.cn.sched.legopic2.tdnsv6.com,9,0.00%,9,0,100.00%
wxsnsdythumb.wxs.qq.com,9,0.00%,20,11,45.00%
8m87j88z.sched.d0.tdnsdp1.cn,9,0.00%,9,0,100.00%
p7.biz.weibo.com,9,0.00%,9,0,100.00%
cdn.overleaf.com,9,0.00%,12,3,75.00%
iask.gslb.sinaedge.com,9,0.00%,20,11,45.00%
api.equinox.io,9,0.00%,9,0,100.00%
onedriveclucproddm20011.blob.core.windows.net,9,0.00%,9,0,100.00%
54.newspush.eastmoney.com,9,0.00%,9,0,100.00%
vdn6-1.vzuu.com,9,0.00%,11,2,81.82%
is4-ssl.mzstatic.com,9,0.00%,10,1,90.00%
68.newspush.eastmoney.com,9,0.00%,9,0,100.00%
scholar.google.com.hk,9,0.00%,10,1,90.00%
ssum-sec.casalemedia.com,9,0.00%,9,0,100.00%
work.iscas.ac.cn,9,0.00%,9,0,100.00%
pay.zhihu.com,9,0.00%,17,8,52.94%
ecmb.bdimg.com,9,0.00%,10,1,90.00%
p.3.cn,9,0.00%,9,0,100.00%
inf.ldmnq.com,9,0.00%,9,0,100.00%
onedriveclucproddm20037.blob.core.windows.net,9,0.00%,9,0,100.00%
18.newspush.eastmoney.com,9,0.00%,9,0,100.00%
secure.adnxs.com,9,0.00%,9,0,100.00%
50.newspush.eastmoney.com,9,0.00%,9,0,100.00%
cms-bucket.nosdn.127.net,9,0.00%,9,0,100.00%
api.termius.com,9,0.00%,9,0,100.00%
tower.webcgi.163.com,9,0.00%,9,0,100.00%
cutscloud.duckdns.org,9,0.00%,9,0,100.00%
laze.cc,9,0.00%,9,0,100.00%
ssltieba.jomodns.com,9,0.00%,10,1,90.00%
sfp.safe.baidu.com,9,0.00%,9,0,100.00%
best.sched.skalego-dk.tdnsstic1.cn,9,0.00%,18,9,50.00%
contacts.163.com,9,0.00%,9,0,100.00%
onedriveclucproddm20045.blob.core.windows.net,9,0.00%,9,0,100.00%
v1-play.log.mgtv.com,9,0.00%,9,0,100.00%
api.mendeley.com,9,0.00%,9,0,100.00%
v6-novelapp.fqnovelvod.com,9,0.00%,9,0,100.00%
dev,9,0.00%,9,0,100.00%
na1e-acc.services.adobe.com,9,0.00%,9,0,100.00%
p10445-ob-hotfix-tfe2.ejoy.com,9,0.00%,9,0,100.00%
updatecdn.meeting.qq.com,9,0.00%,9,0,100.00%
www.btmovi.plus,9,0.00%,9,0,100.00%
tracker.altrosky.nl,9,0.00%,9,0,100.00%
vdwmto3.bdstatic.com.a.bdydns.com,9,0.00%,18,9,50.00%
media.lu.com,9,0.00%,9,0,100.00%
picx.zhimg.com.volcgslb.com,9,0.00%,16,7,56.25%
www.schemastore.org,9,0.00%,9,0,100.00%
a-0019.a-msedge.net,9,0.00%,9,0,100.00%
i.gtimg.cn,9,0.00%,11,2,81.82%
oscar.reyesleon.xyz,9,0.00%,9,0,100.00%
hmcdn.baidu.com,9,0.00%,9,0,100.00%
ecs-workbench.aliyun.com,9,0.00%,9,0,100.00%
newbuz.360buyimg.com,9,0.00%,9,0,100.00%
cm.jd.com,9,0.00%,9,0,100.00%
odo.jd.com,9,0.00%,9,0,100.00%
ldc.lenovo.com.cn.trpcdn.net,9,0.00%,9,0,100.00%
uk01vms.pgfhub.com,9,0.00%,9,0,100.00%
bv.lnk0.com,9,0.00%,9,0,100.00%
adservice.google.com.hk,9,0.00%,13,4,69.23%
cs95619.wpc.psicdn.net,9,0.00%,9,0,100.00%
onedriveclucprodbn20022.blob.core.windows.net,9,0.00%,9,0,100.00%
a22-67.akam.net,9,0.00%,9,0,100.00%
v3-opensdkv.onewsvod.com,9,0.00%,17,8,52.94%
aod-cn-lb.itunes-apple.com.akadns.net,9,0.00%,9,0,100.00%
luna-imgcache.qq.com.tcdn.qq.com,9,0.00%,10,1,90.00%
onedriveclucproddm20002.blob.core.windows.net,9,0.00%,9,0,100.00%
net-2-42-138-122.cust.vodafonedsl.it,9,0.00%,9,0,100.00%
1036149.sched.kslego.tdnsv5.com,9,0.00%,9,0,100.00%
wifiad.ggsafe.com,9,0.00%,9,0,100.00%
bjacshow2.kugou.com,9,0.00%,9,0,100.00%
k-9999.k-msedge.net,8,0.00%,8,0,100.00%
init-p01st-lb.push-apple.com.akadns.net,8,0.00%,15,7,53.33%
pull-flv-l6-encryption.douyincdn.com.hdlvcloud.ks-cdn.com,8,0.00%,13,5,61.54%
pull-flv-vr-l1.douyincdn.com.wsdvs.com,8,0.00%,18,10,44.44%
www.cntv.cn,8,0.00%,15,7,53.33%
tv.sohu.com,8,0.00%,18,10,44.44%
www.chinaz.com.cdn20.com,8,0.00%,8,0,100.00%
moneytizer-d.openx.net,8,0.00%,8,0,100.00%
asst-api.ksord.com,8,0.00%,8,0,100.00%
mscareers.b2clogin.com,8,0.00%,8,0,100.00%
recruitapi.microsoft.com,8,0.00%,8,0,100.00%
careers.microsoft.com,8,0.00%,8,0,100.00%
hcdndyn.zjtd01.gslb.c.cdnhwc2.com,8,0.00%,16,8,50.00%
addons.g-fox.cn,8,0.00%,8,0,100.00%
addons.g-fox.cn.w.kunlunca.com,8,0.00%,8,0,100.00%
home.firefoxchina.cn,8,0.00%,8,0,100.00%
bookmarks-ssl.firefoxchina.cn,8,0.00%,8,0,100.00%
bookmarks-ssl.firefoxchina.cn.wswebpic.com,8,0.00%,8,0,100.00%
minipc.eastday.com,8,0.00%,19,11,42.11%
img.yiqikan8.com,8,0.00%,8,0,100.00%
k-static.xsfaya.com,8,0.00%,8,0,100.00%
eo91y88m.sched.sma.tdnsstic1.cn,8,0.00%,8,0,100.00%
astat.bugly.qq.com,8,0.00%,259,251,3.09%
config.teams.microsoft.com,8,0.00%,260,252,3.08%
push-rtmp-l6.ixigua.com.upvcloud.ks-cdn.com,8,0.00%,8,0,100.00%
u104-ml.gslb.ksyuncdn.com,8,0.00%,15,7,53.33%
pull-flv-spe-l6.douyincdn.com.hdlvcloud.ks-cdn.com,8,0.00%,14,6,57.14%
jp1.gmdns.net,8,0.00%,8,0,100.00%
video.leetcode-cn.com,8,0.00%,8,0,100.00%
urs.microsoft.com,8,0.00%,8,0,100.00%
fe3cr.delivery.mp.microsoft.com,8,0.00%,1117,1109,0.72%
api.flash.cn,8,0.00%,8,0,100.00%
search.namequery.com,8,0.00%,8,0,100.00%
pc.lenovomm.cn,8,0.00%,8,0,100.00%
push.zhihu.com,8,0.00%,10,2,80.00%
84.newspush.eastmoney.com,8,0.00%,8,0,100.00%
dl.360safe.com.qh-cdn.com,8,0.00%,16,8,50.00%
bdns-dy-vod.bytegslb.com,8,0.00%,8,0,100.00%
bcedyrtmp.jomodns.com,8,0.00%,8,0,100.00%
pull-flv-vr-l6.douyincdn.com.hdlvcloud.ks-cdn.com,8,0.00%,13,5,61.54%
pull-flv-l11.douyincdn.com.sched.l10.tdnsv5.com.clive.vwnti.yrzhcloud.cn,8,0.00%,8,0,100.00%
tlivepush3soct1douyin.tcdn.qq.com,8,0.00%,8,0,100.00%
pull-vr-l3.douyincdn.com.230b2a2545cfa773.queniucf.com,8,0.00%,8,0,100.00%
erh4gbw3.sched.v1lego-dk.tdnsvod1.cn,8,0.00%,17,9,47.06%
pull-rtmp-l6.ixigua.com.rtmpvcloud.ks-cdn.com,8,0.00%,13,5,61.54%
pull-flv-l6.ixigua.com.hdlvcloud.ks-cdn.com,8,0.00%,13,5,61.54%
pull-lls-spe-l3.douyincdn.com.230b2a2545cfa773.queniucf.com,8,0.00%,8,0,100.00%
pull-lls-spe-l6.douyincdn.com.hdlvcloud.ks-cdn.com,8,0.00%,13,5,61.54%
v11.douyinvod.com,8,0.00%,17,9,47.06%
tlu.dl.delivery.mp.microsoft.com.a.bdydns.com,8,0.00%,8,0,100.00%
database.clamav.net,8,0.00%,2376,2368,0.34%
www.ieee.org,8,0.00%,8,0,100.00%
control.mna.qq.com,8,0.00%,8,0,100.00%
camera.lei001.com,8,0.00%,8,0,100.00%
fantuantanshu.datasink.sensorsdata.cn,8,0.00%,8,0,100.00%
wcdn.17win.com,8,0.00%,8,0,100.00%
userinfo.docer.wps.cn,8,0.00%,8,0,100.00%
pull-flv-f26-proxy.douyincdn.com,8,0.00%,21,13,38.10%
pull-flv-f11.douyincdn.com.live.qcloudcdn.com,8,0.00%,8,0,100.00%
passport.n.shifen.com,8,0.00%,39,31,20.51%
shift.is.autonavi.com,8,0.00%,8,0,100.00%
amp-api-edge.apps.apple.com,8,0.00%,16,8,50.00%
res.browser.qq.com,8,0.00%,8,0,100.00%
v18.toutiaovod.com,8,0.00%,8,0,100.00%
sis.jpush.io,8,0.00%,8,0,100.00%
play2.cp21.ott.cibntv.net,8,0.00%,8,0,100.00%
hw-prod-pub-alb-245537193.us-west-2.elb.amazonaws.com,8,0.00%,8,0,100.00%
api-access.pangolin-sdk-toutiao.com.bytedns1.com,8,0.00%,8,0,100.00%
tnc3-aliec2.snssdk.com.w.cdngslb.com,8,0.00%,8,0,100.00%
de756e7cb5050f7a-cl2.qcloudcjgj.com,8,0.00%,8,0,100.00%
i-resv.meituan.com,8,0.00%,8,0,100.00%
s.mzstatic.com,8,0.00%,14,6,57.14%
oauthaccountmanager.googleapis.com,8,0.00%,19,11,42.11%
aeu.alicdn.com,8,0.00%,19,11,42.11%
sec.cmbchina.com,8,0.00%,8,0,100.00%
wwwlb.newsmth.net,8,0.00%,8,0,100.00%
push-rtmp-hs-spe-f5.douyincdn.com.c.volcfcdndvs.com,8,0.00%,8,0,100.00%
push-rtmp-f5.ihuoshanlive.com.c.volcfcdndvs.com,8,0.00%,8,0,100.00%
pull-hls-spe-l6.douyincdn.com,8,0.00%,23,15,34.78%
pull-flv-spe-l1.douyincdn.com,8,0.00%,23,15,34.78%
pull-flv-l1.douyincdn.com,8,0.00%,21,13,38.10%
ocsp.godaddy.com.akadns.net,8,0.00%,8,0,100.00%
77.newspush.eastmoney.com,8,0.00%,8,0,100.00%
o4175vz27.qnssl.com,8,0.00%,16,8,50.00%
signlr-prod.core.vsengsaas.visualstudio.com,8,0.00%,8,0,100.00%
iepl-node-gab.wowvip.xyz,8,0.00%,8,0,100.00%
data.ie.sogou.com,8,0.00%,8,0,100.00%
dgss0.bdstatic.com,8,0.00%,13,5,61.54%
vp.hexin.cn,8,0.00%,8,0,100.00%
ftp-hpcom.glb1.hp.com,8,0.00%,8,0,100.00%
cdn.ext.hp.com.c.footprint.net,8,0.00%,8,0,100.00%
banjo.canonical.com,8,0.00%,8,0,100.00%
emupdate.avcdn.net,8,0.00%,18,10,44.44%
tnsvmts.qqngzh.xyz,8,0.00%,8,0,100.00%
www.uniontech.com,8,0.00%,8,0,100.00%
mail.inglyur.com,8,0.00%,8,0,100.00%
kms.library.hk,8,0.00%,8,0,100.00%
push-rest.zui.com,8,0.00%,8,0,100.00%
tyjr-common-cn-beijing.aliyun.com,8,0.00%,8,0,100.00%
mini.wps.cn,8,0.00%,8,0,100.00%
liveheart.video.iqiyi.com,8,0.00%,8,0,100.00%
gsp1.baidu.com,8,0.00%,8,0,100.00%
www.runoob.com,8,0.00%,8,0,100.00%
gsp10-ssl.ls-apple.com.akadns.net,8,0.00%,8,0,100.00%
dsadata.intel.com,8,0.00%,16,8,50.00%
apigtwb2c.ins.dell.com,8,0.00%,8,0,100.00%
ir05.graniterapids.com,8,0.00%,8,0,100.00%
sgp02.graniterapids.com,8,0.00%,8,0,100.00%
p3.ssl.qhimg.com,8,0.00%,9,1,88.89%
ceuswatcab01.blob.core.windows.net,8,0.00%,8,0,100.00%
sslcom.crl.certum.pl,8,0.00%,18,10,44.44%
sbc.firefox.com.cn,8,0.00%,15,7,53.33%
a2f905133e04e4d35ade9cd4751dd35b-4fd69d4b6621dbbd.elb.us-east-1.amazonaws.com,8,0.00%,8,0,100.00%
dl-cdn.oray.com,8,0.00%,8,0,100.00%
www.oray.com,8,0.00%,8,0,100.00%
weu06-breeziest-in.cloudapp.net,8,0.00%,8,0,100.00%
v5-i.douyinvod.com,8,0.00%,8,0,100.00%
p.adsymptotic.com,8,0.00%,8,0,100.00%
assets.adobedtm.com,8,0.00%,26,18,30.77%
updates.cdn-apple.com.download.ks-cdn.com,8,0.00%,8,0,100.00%
browsercfg-drcn.cloud.dbankcloud.cn,8,0.00%,8,0,100.00%
terms1.hicloud.com,8,0.00%,8,0,100.00%
vdn3.vzuu.com,8,0.00%,23,15,34.78%
quic.conn.wemeet.qq.com,8,0.00%,8,0,100.00%
update.delivery.autodesk.com,8,0.00%,8,0,100.00%
datacollector-drcn.dt.hicloud.com,8,0.00%,8,0,100.00%
uc-drcn.hispace.dbankcloud.cn,8,0.00%,8,0,100.00%
appdl-1-drcn.dbankcdn.com.c.cdnhwc1.com,8,0.00%,8,0,100.00%
appdl.glb.c.cdnhwc1.com,8,0.00%,8,0,100.00%
apt-geofence-parent.trafficmanager.net,8,0.00%,8,0,100.00%
mhcc-web.maxhub.vip,8,0.00%,8,0,100.00%
s1.cn.bing.net.lxcvc.com,8,0.00%,8,0,100.00%
v5-e.douyinvod.com,8,0.00%,8,0,100.00%
r3---sn-ni5een7s.gvt1.com,8,0.00%,8,0,100.00%
harib-eir.info,8,0.00%,8,0,100.00%
downloads.metasploit.com,8,0.00%,8,0,100.00%
e11744.g.akamaiedge.net,8,0.00%,8,0,100.00%
t2.xiaohongshu.com,8,0.00%,17,9,47.06%
ip1865976387.funshion.com,8,0.00%,8,0,100.00%
pixel.mathtag.com,8,0.00%,8,0,100.00%
weiboimgwx.grid.sinaedge.com,8,0.00%,44,36,18.18%
ise.sapi.so.com,8,0.00%,8,0,100.00%
zgrefgd03.standurl.xyz,8,0.00%,8,0,100.00%
weather-drcn.music.hicloud.com,8,0.00%,8,0,100.00%
onedriveclucproddm20013.blob.core.windows.net,8,0.00%,8,0,100.00%
dns.update.netease.com,8,0.00%,8,0,100.00%
ir3.mail.163.com,8,0.00%,8,0,100.00%
cdn.bootcss.com,8,0.00%,25,17,32.00%
ra.gtimg.com,8,0.00%,15,7,53.33%
libmini.duba.net,8,0.00%,8,0,100.00%
ecn.dev.virtualearth.net,8,0.00%,16,8,50.00%
ns1.etisalatdomains.ae,8,0.00%,8,0,100.00%
ns3.etisalatdomains.ae,8,0.00%,8,0,100.00%
cn-ms.galaxyappstore.com,8,0.00%,8,0,100.00%
resource-lib.docer.wps.cn,8,0.00%,8,0,100.00%
recom.docer.wps.cn,8,0.00%,8,0,100.00%
iris-de-ppe-azsc-eas.eastasia.cloudapp.azure.com,8,0.00%,8,0,100.00%
cdn-file.peasrch.com,8,0.00%,8,0,100.00%
onedriveclucprodbn20028.blob.core.windows.net,8,0.00%,8,0,100.00%
s-vps18.avcdn.net,8,0.00%,18,10,44.44%
onedriveclucproddm20020.blob.core.windows.net,8,0.00%,8,0,100.00%
telemetry.malwarebytes.com,8,0.00%,8,0,100.00%
cdn.login.wanfangdata.com.cn,8,0.00%,8,0,100.00%
s18-sync.firefox.com.cn,8,0.00%,8,0,100.00%
93.newspush.eastmoney.com,8,0.00%,8,0,100.00%
onedriveclucproddm20023.blob.core.windows.net,8,0.00%,8,0,100.00%
sqt.gtimg.cn,8,0.00%,8,0,100.00%
vmonitor.ws.netease.com,8,0.00%,21,13,38.10%
api.kingdata.ksyun.com,8,0.00%,8,0,100.00%
config.officeapps.live.com,8,0.00%,8,0,100.00%
47.newspush.eastmoney.com,8,0.00%,8,0,100.00%
39.newspush.eastmoney.com,8,0.00%,8,0,100.00%
zotero-repo.s3.amazonaws.com,8,0.00%,8,0,100.00%
tags.growingio.com,8,0.00%,8,0,100.00%
48.newspush.eastmoney.com,8,0.00%,8,0,100.00%
members.3322.org,8,0.00%,8,0,100.00%
56.push2.eastmoney.com,8,0.00%,16,8,50.00%
public.publictracker.xyz,8,0.00%,8,0,100.00%
video.weibo.com,8,0.00%,8,0,100.00%
wedocare.com,8,0.00%,8,0,100.00%
a5.behance.net,8,0.00%,16,8,50.00%
a2pssl-drcn.dbankcdn.cn,8,0.00%,8,0,100.00%
images.nowcoder.com,8,0.00%,8,0,100.00%
gw-c.nowcoder.com,8,0.00%,8,0,100.00%
uploadfiles.nowcoder.com,8,0.00%,8,0,100.00%
downloadnonchinacdnenabled.mcafee.com.edgekey.net,8,0.00%,8,0,100.00%
chinadownload114.china.line.qiniudns.com,8,0.00%,17,9,47.06%
vod-all.qiniu.com.volcgslb.com,8,0.00%,18,10,44.44%
96.newspush.eastmoney.com,8,0.00%,8,0,100.00%
85.newspush.eastmoney.com,8,0.00%,8,0,100.00%
36.newspush.eastmoney.com,8,0.00%,8,0,100.00%
onedriveclucprodbn20024.blob.core.windows.net,8,0.00%,8,0,100.00%
js.bd.dhsz.cn,8,0.00%,8,0,100.00%
zxgghn.25ku.com,8,0.00%,8,0,100.00%
v83-016.douyinvod.com,8,0.00%,11,3,72.73%
lfghub-anonymous.xboxlive.com,8,0.00%,8,0,100.00%
ns4.etisalatdomains.ae,8,0.00%,8,0,100.00%
www.google.cn,8,0.00%,8,0,100.00%
in06.graniterapids.com,8,0.00%,8,0,100.00%
kr08.graniterapids.com,8,0.00%,8,0,100.00%
m.360buyimg.com,8,0.00%,16,8,50.00%
top.ssl.dhrest.com,8,0.00%,8,0,100.00%
r2---sn-2x3elnel.gvt1.com,8,0.00%,8,0,100.00%
ns2.mopa.ae,8,0.00%,8,0,100.00%
itunes-cdn.itunes-apple.com.akadns.net,8,0.00%,8,0,100.00%
autoupdate.synology.cn,8,0.00%,8,0,100.00%
cdn.orayimg.com,8,0.00%,8,0,100.00%
update-pcsafe.2345.cc,8,0.00%,8,0,100.00%
sso.toutiao.com,8,0.00%,8,0,100.00%
ipv4.tracker.harry.lu,8,0.00%,8,0,100.00%
ctlogin6.qq.com,8,0.00%,8,0,100.00%
dk3.ache.pdf.officeoncloud.cn,8,0.00%,15,7,53.33%
h20572.www2.hp.com,8,0.00%,8,0,100.00%
ip1973518533.funshion.com,8,0.00%,8,0,100.00%
seed.siri.apple.com,8,0.00%,8,0,100.00%
ip1865976423.funshion.com,8,0.00%,8,0,100.00%
m6815.talk99.cn,8,0.00%,8,0,100.00%
123p3.sogoucdn.com,8,0.00%,8,0,100.00%
i3fneen3irt7ibp8car9551gmg147fue33vkv523hpqa6uofl7av.qc.x.bsgslb.cn,8,0.00%,8,0,100.00%
ys.mihoyo.com,8,0.00%,8,0,100.00%
ns1.canonical.com,8,0.00%,8,0,100.00%
th-b.pinduoduo.com,8,0.00%,8,0,100.00%
onedriveclucprodbn20010.blob.core.windows.net,8,0.00%,8,0,100.00%
c-uaa.if.iqiyi.com,8,0.00%,8,0,100.00%
settings-bd.feishu.cn,8,0.00%,8,0,100.00%
32.push2.eastmoney.com,8,0.00%,15,7,53.33%
88.newspush.eastmoney.com,8,0.00%,8,0,100.00%
phfwba-ent-e04.oray.net,8,0.00%,8,0,100.00%
phfw-g3.oray.net,8,0.00%,8,0,100.00%
izy.updrv.com,8,0.00%,8,0,100.00%
binaries.templates.cdn.office.net,8,0.00%,17,9,47.06%
wan01.sogoucdn.com,8,0.00%,8,0,100.00%
kds.wps.cn,8,0.00%,8,0,100.00%
beacon.walmart.com,8,0.00%,8,0,100.00%
adsdk.vivo.com.cn,8,0.00%,8,0,100.00%
31.newspush.eastmoney.com,8,0.00%,8,0,100.00%
jp20.graniterapids.com,8,0.00%,8,0,100.00%
rv74e4cqic.feishu.cn,8,0.00%,8,0,100.00%
svr.sangfor.com.cn,8,0.00%,8,0,100.00%
a2p-s01-drcn.cloud.dbankcloud.cn,8,0.00%,8,0,100.00%
cs1137.wpc.ea55a.phicdn.net,8,0.00%,8,0,100.00%
p9.img.360kuai.com,8,0.00%,9,1,88.89%
ali-origin.pull.yximgs.com,8,0.00%,10,2,80.00%
version.gitlab.com,8,0.00%,8,0,100.00%
cdnws.api.huya.com,8,0.00%,8,0,100.00%
updates.devmate.com,8,0.00%,8,0,100.00%
cdnimg.3g.qq.com.cloud.tc.qq.com,8,0.00%,8,0,100.00%
onedriveclucprodbn20025.blob.core.windows.net,8,0.00%,8,0,100.00%
count.pcauto.com.cn,8,0.00%,8,0,100.00%
qidian.gtimg.com,8,0.00%,16,8,50.00%
link.csdn.net,8,0.00%,8,0,100.00%
playweb.douyu.com,8,0.00%,8,0,100.00%
rtb0.doubleverify.com,8,0.00%,8,0,100.00%
bbs.hupu.com,8,0.00%,8,0,100.00%
h20593.www2.hp.com,8,0.00%,8,0,100.00%
pudn-static.oss-cn-beijing.aliyuncs.com,8,0.00%,8,0,100.00%
uple.qq.com,8,0.00%,8,0,100.00%
log.voicecloud.cn,8,0.00%,8,0,100.00%
kr02.graniterapids.com,8,0.00%,8,0,100.00%
bgappservices.microsoft.com,8,0.00%,8,0,100.00%
p2.qhimg.com,8,0.00%,10,2,80.00%
52.newspush.eastmoney.com,8,0.00%,8,0,100.00%
n47yc0ab.sched.skalego-dk.tdnsstic1.cn,8,0.00%,17,9,47.06%
video-tx-drcn.dbankcdn.cn.cdn.dnsv1.com,8,0.00%,17,9,47.06%
apkgf5hg.sched.v1hw-dk.tdnsvod1.cn,8,0.00%,21,13,38.10%
pf001.v.bsclink.cn,8,0.00%,21,13,38.10%
store.iqiyi.com,8,0.00%,8,0,100.00%
static2.sharepointonline.com,8,0.00%,8,0,100.00%
krgame07.graniterapids.com,8,0.00%,8,0,100.00%
wnsmusic.qq.com,8,0.00%,8,0,100.00%
f10.baidu.com,8,0.00%,11,3,72.73%
www.it610.com,8,0.00%,8,0,100.00%
szugcup.music.qq.com,8,0.00%,8,0,100.00%
browser.events.data.msn.com,8,0.00%,8,0,100.00%
jb-dap-test.s3.eu-central-1.amazonaws.com,8,0.00%,16,8,50.00%
sw.symcd.com,8,0.00%,17,9,47.06%
dellupdater.dell.com.edgekey.net,8,0.00%,8,0,100.00%
p0.qhimg.com.qh-cdn.com,8,0.00%,16,8,50.00%
res.servicewechat.com.cloud.tc.qq.com,8,0.00%,8,0,100.00%
a1851.dscg2.akamai.net,8,0.00%,18,10,44.44%
mc.manuscriptcentral.com,8,0.00%,8,0,100.00%
access1.tpns.tencent.com,8,0.00%,8,0,100.00%
image.qwps.cn,8,0.00%,8,0,100.00%
tracker.zer0day.to,8,0.00%,15,7,53.33%
e.gitee.com,8,0.00%,8,0,100.00%
files.gitee.com,8,0.00%,8,0,100.00%
toscode.gitee.com,8,0.00%,8,0,100.00%
12377.cn,8,0.00%,8,0,100.00%
crash2.zhihu.com,8,0.00%,14,6,57.14%
appdl-drcn.dbankcdn.com,8,0.00%,8,0,100.00%
aop-pic-drcn.dbankcdn.com,8,0.00%,8,0,100.00%
h.m.mpl.dutils.com,8,0.00%,8,0,100.00%
static-s.iqiyi.com,8,0.00%,16,8,50.00%
e1723.ca.s.tl88.net,8,0.00%,8,0,100.00%
ols.officeapps.live.com,8,0.00%,8,0,100.00%
uranus.jd.com,8,0.00%,8,0,100.00%
vod.bytedanceapi.com,8,0.00%,8,0,100.00%
s3.us-east-1.amazonaws.com,8,0.00%,8,0,100.00%
adl.windows.com,8,0.00%,8,0,100.00%
ad.winrar.com.cn,8,0.00%,8,0,100.00%
www.recaptcha.net,8,0.00%,8,0,100.00%
darkreader.org,8,0.00%,8,0,100.00%
lf1-cdn-tos.bytegoofy.com.wsglb0.com,8,0.00%,16,8,50.00%
www.1905.com.wscdns.com,8,0.00%,8,0,100.00%
www.douyin.com.w.kunluncan.com,8,0.00%,8,0,100.00%
one-second-campaign.cn-hangzhou.log.aliyuncs.com,8,0.00%,8,0,100.00%
vdn.vzuu.com,8,0.00%,20,12,40.00%
pica.zhimg.com.download.ks-cdn.com,8,0.00%,17,9,47.06%
impression.biligame.com,8,0.00%,8,0,100.00%
8667973.sched.sma.tdnsstic1.cn,8,0.00%,8,0,100.00%
onedriveclucprodbn20012.blob.core.windows.net,8,0.00%,8,0,100.00%
sphapi-pro.oray.net,8,0.00%,8,0,100.00%
kr09.graniterapids.com,8,0.00%,8,0,100.00%
statics-marketingsites-eas-ms-com.akamaized.net,8,0.00%,8,0,100.00%
bg1.market.xiaomi.com,8,0.00%,8,0,100.00%
v9-be-pack.pglstatp-toutiao.com,8,0.00%,8,0,100.00%
zttvad.v.bsgslb.com,8,0.00%,8,0,100.00%
elmhovdu.sched.sma.tdnsstic1.cn,8,0.00%,8,0,100.00%
probe.icloud.com,8,0.00%,17,9,47.06%
zendesk.tv,8,0.00%,8,0,100.00%
e1805.g.akamaiedge.net,8,0.00%,8,0,100.00%
h5static.m.jd.com,8,0.00%,8,0,100.00%
baozhang.jd.com,8,0.00%,8,0,100.00%
r1---sn-j5o7dn76.gvt1.com,8,0.00%,8,0,100.00%
www.casmooc.cn,8,0.00%,8,0,100.00%
shuc-js.ksord.com,8,0.00%,8,0,100.00%
git.ffmpeg.org,8,0.00%,8,0,100.00%
pop.vip.sina.com,8,0.00%,8,0,100.00%
cs.rssx.hp.com,8,0.00%,8,0,100.00%
ifeng3.yylady.cn,8,0.00%,8,0,100.00%
mmjs.adutp.com,8,0.00%,8,0,100.00%
apptrace.hexun.com,8,0.00%,8,0,100.00%
secgw-default.wagbridge.ws.alibabacorp.com.gds.alibabadns.com,8,0.00%,8,0,100.00%
maps.gstatic.cn,8,0.00%,8,0,100.00%
hwid.platform.hicloud.com,8,0.00%,8,0,100.00%
bank.hexun.com,8,0.00%,8,0,100.00%
ip1905173512.funshion.com,8,0.00%,8,0,100.00%
futures.hexun.com,8,0.00%,8,0,100.00%
pe.hexun.com,8,0.00%,8,0,100.00%
quote.hexun.com,8,0.00%,8,0,100.00%
gt2.baidu.com,8,0.00%,8,0,100.00%
s11tdvrpj5gmlm3u98u2h57fh4sd0pbgtdtt9h6k9h1om945qacfvr65.qc.x.bsgslb.cn,8,0.00%,8,0,100.00%
g-fox.cn,8,0.00%,8,0,100.00%
sofire.bdstatic.com,8,0.00%,15,7,53.33%
discovery.lenovo.com.cn,8,0.00%,8,0,100.00%
k1.com.br,8,0.00%,8,0,100.00%
tb1.bdstatic.com,8,0.00%,8,0,100.00%
tb5.bdstatic.com,8,0.00%,8,0,100.00%
tb3.bdstatic.com,8,0.00%,8,0,100.00%
vc-mirror.snssdk.com,8,0.00%,8,0,100.00%
ping.qcloud.com,8,0.00%,8,0,100.00%
thina8ae.nodedata.net,8,0.00%,8,0,100.00%
registry.npmmirror.com,8,0.00%,9,1,88.89%
eip7ahzi.nodedata.net,8,0.00%,8,0,100.00%
extend.vimeocdn.com,8,0.00%,8,0,100.00%
a.c.eset.com,8,0.00%,8,0,100.00%
pcvideotx.titan.mgtv.com,8,0.00%,8,0,100.00%
nsp-contentcenter-h5-drcn.obs.cn-north-2.myhuaweicloud.cn,8,0.00%,8,0,100.00%
security.snssdk.com,8,0.00%,8,0,100.00%
p216-caldav.icloud.com.cn,8,0.00%,8,0,100.00%
www.evtrust.com,8,0.00%,8,0,100.00%
p4.ssl.qhimg.com,8,0.00%,15,7,53.33%
onedriveclucprodbn20013.blob.core.windows.net,8,0.00%,8,0,100.00%
alldomain.f.tlu.dl.delivery.mp.microsoft.com.a.bdydns.com,8,0.00%,8,0,100.00%
www.eclzy.com,8,0.00%,8,0,100.00%
www.mmkx8.cc,8,0.00%,8,0,100.00%
is1-ssl.mzstatic.com.download.ks-cdn.com,8,0.00%,8,0,100.00%
i0.hdslb.com.download.ks-cdn.com,8,0.00%,17,9,47.06%
dv-ap-southeast-1-prod.sentinelone.net,8,0.00%,8,0,100.00%
line1-log.biligame.net,8,0.00%,8,0,100.00%
comment6.sina.cn,8,0.00%,8,0,100.00%
alb00000053.dpool.sina.com.cn,8,0.00%,8,0,100.00%
k2-ml.gslb.ksyuncdn.com,8,0.00%,8,0,100.00%
preview.mail.163.com,8,0.00%,8,0,100.00%
avatar.skype.com,8,0.00%,8,0,100.00%
i.gtimg.cn.sched.legopic2.tdnsv6.com,8,0.00%,8,0,100.00%
62971.bodis.com,8,0.00%,8,0,100.00%
www.eddie4.nl,8,0.00%,8,0,100.00%
xxxtor.com,8,0.00%,8,0,100.00%
tracker.yoshi210.com,8,0.00%,8,0,100.00%
bench.utorrent.com,8,0.00%,16,8,50.00%
richmedia.video.qq.com,8,0.00%,8,0,100.00%
reg.163.com,8,0.00%,8,0,100.00%
2.push2.eastmoney.com,8,0.00%,12,4,66.67%
jshop-rec.jd.com,8,0.00%,8,0,100.00%
rtb-x.jd.com,8,0.00%,14,6,57.14%
mmbiz.qpic.cn.sched.legopic1-dk.tdnsv6.com,8,0.00%,15,7,53.33%
sb.l.google.com,8,0.00%,8,0,100.00%
mygiftcard.jd.com,8,0.00%,8,0,100.00%
vdn5-1.vzuu.com.w.cdngslb.com,8,0.00%,9,1,88.89%
passport.bigfunapp.cn,8,0.00%,8,0,100.00%
erigon-mainnet--rpc.datahub.figment.io,8,0.00%,8,0,100.00%
mssdk-bu.snssdk.com,8,0.00%,8,0,100.00%
p211-caldav.icloud.com.cn,8,0.00%,8,0,100.00%
awdb.nickname-vocals.net,8,0.00%,8,0,100.00%
storage.jd.com,8,0.00%,8,0,100.00%
www.sdde.cn,8,0.00%,8,0,100.00%
ai.feishu.cn.w.cdngslb.com,8,0.00%,8,0,100.00%
lumrswmi.mirror.aliyuncs.com,8,0.00%,8,0,100.00%
opencdnmsdl2.jomodns.com,8,0.00%,8,0,100.00%
iscas.ac.cn,8,0.00%,8,0,100.00%
krsk03.graniterapids.com,8,0.00%,8,0,100.00%
edu.51cto.com,8,0.00%,8,0,100.00%
api.iplay.163.com,8,0.00%,12,4,66.67%
captcha.pcauto.com.cn,8,0.00%,8,0,100.00%
webmap1.bdimg.com,8,0.00%,9,1,88.89%
iethie6i.nodedata.net,8,0.00%,8,0,100.00%
hz-jp.transit.freework.cyou,8,0.00%,8,0,100.00%
hd-jp.transit.freework.cyou,8,0.00%,8,0,100.00%
dict.deepl.com,8,0.00%,8,0,100.00%
w5.dpool.sina.com.cn,8,0.00%,8,0,100.00%
antenna.streamsets.com,8,0.00%,8,0,100.00%
static.jjwxc.net,8,0.00%,8,0,100.00%
adashxgc.ut.taobao.com,8,0.00%,8,0,100.00%
www.jjwxc.net,8,0.00%,8,0,100.00%
tangram-config.gdt.qq.com.sched.legopic1.tdnsv6.com,8,0.00%,8,0,100.00%
nmtest.bdstatic.com,8,0.00%,8,0,100.00%
ap4.agora.io,8,0.00%,8,0,100.00%
infinitedata-pa.googleapis.com,8,0.00%,16,8,50.00%
s1.maoercdn.com,8,0.00%,8,0,100.00%
static.maoercdn.com,8,0.00%,8,0,100.00%
onedriveclucprodbn20050.blob.core.windows.net,8,0.00%,8,0,100.00%
smartdl.mbgcdn.lenovo.com.cn,8,0.00%,8,0,100.00%
smartdl.lenovo.com.cn.trpcdn.net,8,0.00%,8,0,100.00%
tqos.anticheatexpert.com,8,0.00%,16,8,50.00%
api.1gg001.com,8,0.00%,8,0,100.00%
oss.weread.qq.com,8,0.00%,8,0,100.00%
browserkernel.baidu.com,8,0.00%,8,0,100.00%
mirrors.cloud.tencent.com,8,0.00%,8,0,100.00%
adx.yiche.com,8,0.00%,8,0,100.00%
packages.dmd.metaservices.microsoft.com,8,0.00%,8,0,100.00%
public-repo-1.hortonworks.com,8,0.00%,8,0,100.00%
upass.10jqka.com.cn,8,0.00%,8,0,100.00%
img.sogoucdn.com,8,0.00%,8,0,100.00%
mozilla.org,7,0.00%,7,0,100.00%
s-9999.s-msedge.net,7,0.00%,7,0,100.00%
api-aps-teams.trafficmanager.net,7,0.00%,7,0,100.00%
pull-flv-f1-proxy.douyincdn.com.wsdvs.com,7,0.00%,19,12,36.84%
voice.baidu.com,7,0.00%,21,14,33.33%
ali2.a.yximgs.com,7,0.00%,7,0,100.00%
f-mall.jd.com,7,0.00%,7,0,100.00%
client.mail.163.com,7,0.00%,534,527,1.31%
www.vip.com,7,0.00%,7,0,100.00%
cloudtips.1360.com,7,0.00%,7,0,100.00%
apps.mzstatic.com,7,0.00%,11,4,63.64%
lqimg.dftoutiao.com,7,0.00%,7,0,100.00%
hp.sched.legohp-dk.tdnsstic1.cn,7,0.00%,12,5,58.33%
dailyupdate.wangwang.taobao.com.danuoyi.tbcache.com,7,0.00%,7,0,100.00%
pull-hls-spe-l6.douyincdn.com.hlsvcloud.ks-cdn.com,7,0.00%,16,9,43.75%
live-df-sched.jcloudimg.com,7,0.00%,7,0,100.00%
t11.baidu.com.a.bdydns.com,7,0.00%,12,5,58.33%
docteamapi.wps.cn,7,0.00%,7,0,100.00%
nsp-hicloud-cloudphotonorth4-p03-drcn.obs.cn-north-4.myhuaweicloud.cn,7,0.00%,7,0,100.00%
nsp-hicloud-cloudphotonorth4-p02-drcn.obs.cn-north-4.myhuaweicloud.cn,7,0.00%,7,0,100.00%
dblp.uni-trier.de,7,0.00%,7,0,100.00%
78.push2.eastmoney.com,7,0.00%,13,6,53.85%
14.newspush.eastmoney.com,7,0.00%,7,0,100.00%
86.push2.eastmoney.com,7,0.00%,12,5,58.33%
yb-safe.2345.cc,7,0.00%,7,0,100.00%
pull-flv-f6-hs.pstatp.com.hdlvcloud.ks-cdn.com,7,0.00%,10,3,70.00%
48l6nsax.sched.v1lego-dk.tdnsvod1.cn,7,0.00%,16,9,43.75%
pull-flv-f1.douyincdn.com.gccdn.net,7,0.00%,18,11,38.89%
pull-rtmp-f6.douyincdn.com.rtmpvcloud.ks-cdn.com,7,0.00%,11,4,63.64%
pull-flv-l1-source.douyincdn.com.wsdvs.com,7,0.00%,18,11,38.89%
pull-flv-l1.douyincdn.com.gccdn.net,7,0.00%,17,10,41.18%
kjk3jf40.sched.sma-dk.tdnsstic1.cn.cjt.krcdn.idatacube.com,7,0.00%,14,7,50.00%
smetrics-ieeexplore.ieee.org,7,0.00%,7,0,100.00%
t.cnki.net,7,0.00%,7,0,100.00%
a.cnki.net,7,0.00%,7,0,100.00%
bidder.sg1.vip.prod.criteo.com,7,0.00%,7,0,100.00%
21.courier-push-apple.com.akadns.net,7,0.00%,7,0,100.00%
link-dit3la5z.gaapqcloud.com,7,0.00%,7,0,100.00%
v26-cold.douyinvod.com,7,0.00%,14,7,50.00%
pull-flv-l6-cny.douyincdn.com.hdlvcloud.ks-cdn.com,7,0.00%,11,4,63.64%
pull-f5.flive.douyincdn.com.c.bytefcdn.com,7,0.00%,7,0,100.00%
push-rtmp-vr-l26.douyincdn.com.c.cdnhwc3.com,7,0.00%,7,0,100.00%
play-dy.ulive.ugslb.com,7,0.00%,7,0,100.00%
pull-tsl-hs-spe-f5.douyincdn.com.volcgslb.com,7,0.00%,7,0,100.00%
prod-streaming-video-msn-com.akamaized.net,7,0.00%,13,6,53.85%
snowplow-elb-prod1-clarivate-470512675.us-west-2.elb.amazonaws.com,7,0.00%,7,0,100.00%
apifox.cn-hangzhou.log.aliyuncs.com,7,0.00%,7,0,100.00%
offline.specialcdnstatus.com,7,0.00%,7,0,100.00%
a1887.dscq.akamai.net.0.1.cn.akamaitech.net,7,0.00%,14,7,50.00%
pcdownaliyun.titan.mgtv.com,7,0.00%,7,0,100.00%
cloudconfig.jetbrains.com,7,0.00%,7,0,100.00%
alb-krmaiwe3bwhbkec015.cn-beijing.alb.aliyuncs.com,7,0.00%,7,0,100.00%
xlog.jd.com,7,0.00%,7,0,100.00%
tnc3-aliec2.snssdk.com,7,0.00%,7,0,100.00%
hcdnw.zjtd01.gslb.c.cdnhwc2.com,7,0.00%,12,5,58.33%
bj-a.bcebos.com,7,0.00%,7,0,100.00%
hr15.graniterapids.com,7,0.00%,7,0,100.00%
idp.springer.com,7,0.00%,7,0,100.00%
selfpage-gips.cdn.bcebos.com,7,0.00%,7,0,100.00%
vcode-od.vivo.com.cn,7,0.00%,7,0,100.00%
galleryapi.micloud.xiaomi.net,7,0.00%,7,0,100.00%
download.oracle.com.edgekey.net,7,0.00%,7,0,100.00%
pull-tsl-vr-l6.douyincdn.com,7,0.00%,19,12,36.84%
pull-flv-l26.douyincdn.com,7,0.00%,20,13,35.00%
pull-flv-l26-cny.douyincdn.com,7,0.00%,19,12,36.84%
pugm-sgc.pubmnet.com,7,0.00%,7,0,100.00%
pull-hs-spe-f5.douyincdn.com.c.volcfcdndvs.com,7,0.00%,7,0,100.00%
70.push2.eastmoney.com,7,0.00%,13,6,53.85%
swr.cn-north-4.myhuaweicloud.com,7,0.00%,7,0,100.00%
d1--cn-gotcha208.bilivideo.com,7,0.00%,14,7,50.00%
mqtt.xbase.cloud,7,0.00%,7,0,100.00%
appexorch.bestsdwan.com,7,0.00%,7,0,100.00%
p203-caldav.icloud.com.cn,7,0.00%,7,0,100.00%
e1553.dspg.akamaiedge.net,7,0.00%,15,8,46.67%
configdownload.dbankcdn.cn,7,0.00%,7,0,100.00%
sr.kaikeba.com,7,0.00%,14,7,50.00%
ubacollect-drcn.cloud.dbankcloud.cn,7,0.00%,7,0,100.00%
cname.micloud.xiaomi.net,7,0.00%,7,0,100.00%
hpkaj.deepl.com,7,0.00%,7,0,100.00%
prod-data.acquisition.grammarlyaws.com,7,0.00%,7,0,100.00%
ssldev.oes.avira.com,7,0.00%,7,0,100.00%
smtp1.fdf.gov.ae,7,0.00%,7,0,100.00%
onedriveclucprodbn20009.blob.core.windows.net,7,0.00%,7,0,100.00%
onedscolprdjpe02.japaneast.cloudapp.azure.com,7,0.00%,11,4,63.64%
loki.delve.office.com,7,0.00%,7,0,100.00%
ss.shanhutech.cn,7,0.00%,7,0,100.00%
www.iduba.com,7,0.00%,7,0,100.00%
aqqmusic.tc.qq.com,7,0.00%,15,8,46.67%
cambrian-images.cdn.bcebos.com,7,0.00%,17,10,41.18%
apppush.xiaohongshu.com,7,0.00%,7,0,100.00%
rtb-csync.smartadserver.com,7,0.00%,7,0,100.00%
passwordsleakcheck-pa.googleapis.com,7,0.00%,9,2,77.78%
e7741.ca.s.tl88.net,7,0.00%,7,0,100.00%
rest.gti.mcafee.akadns.net,7,0.00%,7,0,100.00%
appdlv4.glb.c.cdnhwc2.com,7,0.00%,8,1,87.50%
store-drcn-hispace-dbankcloud-cn-drcn.appacc.dbankedge.cn,7,0.00%,7,0,100.00%
2039200236.wjsq.online,7,0.00%,7,0,100.00%
fmfmobile.fe.apple-dns.cn,7,0.00%,7,0,100.00%
p2pupdate.inter.dns.iqiyi.com,7,0.00%,7,0,100.00%
v5-e.douyinvod.com.yangyi19.com,7,0.00%,7,0,100.00%
discourse.itk.org,7,0.00%,7,0,100.00%
repo.mongodb.org,7,0.00%,11,4,63.64%
img-all.qiniu.com.volcgslb.com,7,0.00%,17,10,41.18%
log-reyun-com-for-redirect-1246077432.cn-north-1.elb.amazonaws.com.cn,7,0.00%,7,0,100.00%
api.amemv.com,7,0.00%,7,0,100.00%
circlephotokd.photo.qq.com,7,0.00%,7,0,100.00%
ip1905173507.funshion.com,7,0.00%,7,0,100.00%
playerhotfix.douyucdn.cn,7,0.00%,7,0,100.00%
sync-v3.getpostman.com,7,0.00%,14,7,50.00%
dcat-nlu-fg-shim.trafficmanager.net,7,0.00%,7,0,100.00%
dl.delivery.mp.microsoft.com.a.bdydns.com,7,0.00%,7,0,100.00%
update-ruanjian.2345.cc,7,0.00%,7,0,100.00%
kr03.graniterapids.com,7,0.00%,7,0,100.00%
fc3tn.baidu.com,7,0.00%,7,0,100.00%
s.w.org,7,0.00%,7,0,100.00%
bd.chiq-cloud.com,7,0.00%,7,0,100.00%
img-operation.csdnimg.cn,7,0.00%,7,0,100.00%
10.newspush.eastmoney.com,7,0.00%,7,0,100.00%
us.pool.ntp.org,7,0.00%,7,0,100.00%
unmc.cdn.bcebos.com,7,0.00%,7,0,100.00%
api-drcn.theme.dbankcloud.cn,7,0.00%,7,0,100.00%
www.ccps.gov.cn,7,0.00%,7,0,100.00%
www.600dvd.com,7,0.00%,7,0,100.00%
pc.stgowan.com,7,0.00%,7,0,100.00%
releases.mattermost.com,7,0.00%,14,7,50.00%
cucshk4.debugex.xyz,7,0.00%,7,0,100.00%
sanincode.com,7,0.00%,7,0,100.00%
zs.xiazai.sogou.com,7,0.00%,7,0,100.00%
fp-it.fengkongcloud.com,7,0.00%,7,0,100.00%
29.newspush.eastmoney.com,7,0.00%,7,0,100.00%
opencdnspy.jomodns.com,7,0.00%,7,0,100.00%
m.mxguan5.com,7,0.00%,7,0,100.00%
davidkirkevans.com,7,0.00%,7,0,100.00%
youtrack.jetbrains.com,7,0.00%,7,0,100.00%
smtp-relay.odysseylabel.com.au,7,0.00%,7,0,100.00%
ess.leju.com,7,0.00%,7,0,100.00%
comment.sina.com.cn,7,0.00%,7,0,100.00%
beacon.sina.com.cn,7,0.00%,7,0,100.00%
j.bd.dhsz.cn,7,0.00%,7,0,100.00%
log-api.pangolin-sdk-toutiao.com,7,0.00%,7,0,100.00%
qpb0.sohu.com,7,0.00%,7,0,100.00%
appstore.browser.qq.com,7,0.00%,7,0,100.00%
tj.b.qq.com,7,0.00%,7,0,100.00%
ru03.ptrecord.com,7,0.00%,7,0,100.00%
v.casmooc.cn,7,0.00%,7,0,100.00%
ms-vscode.gallerycdn.azure.cn,7,0.00%,7,0,100.00%
crcdn.ydstatic.com,7,0.00%,7,0,100.00%
api.map.baidu.com,7,0.00%,33,26,21.21%
diagnosis.ad.xiaomi.com,7,0.00%,7,0,100.00%
osff.map.fastly.net,7,0.00%,7,0,100.00%
qt001.china.line.qiniudns.com,7,0.00%,14,7,50.00%
v26.douyinvod.com,7,0.00%,14,7,50.00%
k1-global.gslb.ksyuncdn.com,7,0.00%,14,7,50.00%
ip3546021121.funshion.com,7,0.00%,7,0,100.00%
api.fd.mob.com,7,0.00%,7,0,100.00%
huizhou.gallerycdn.azure.cn,7,0.00%,7,0,100.00%
2.newspush.eastmoney.com,7,0.00%,7,0,100.00%
bshare.optimix.cn,7,0.00%,7,0,100.00%
scan.call.f.360.cn,7,0.00%,13,6,53.85%
slp2p-east-std1068.oray.net,7,0.00%,7,0,100.00%
onedriveclucprodbn20017.blob.core.windows.net,7,0.00%,7,0,100.00%
weu017-breeziest-in.cloudapp.net,7,0.00%,7,0,100.00%
www.internet.apps.samsung.com,7,0.00%,7,0,100.00%
profile.chrome.360.cn,7,0.00%,7,0,100.00%
qzs.gdtimg.com,7,0.00%,17,10,41.18%
discovery-v4.syncthing.net,7,0.00%,7,0,100.00%
xugeed0e.nodedata.net,7,0.00%,7,0,100.00%
hk-vid-events.taboola.com,7,0.00%,7,0,100.00%
img.douyucdn.cn,7,0.00%,8,1,87.50%
stat.tpns.tencent.com,7,0.00%,7,0,100.00%
snsvideo.c2c.wechat.com,7,0.00%,14,7,50.00%
s3-us-west-2.amazonaws.com,7,0.00%,7,0,100.00%
omex.cdn.office.net,7,0.00%,7,0,100.00%
www.iqiyipic.com,7,0.00%,14,7,50.00%
twemoji.maxcdn.com,7,0.00%,7,0,100.00%
update.helper.2345.cc,7,0.00%,7,0,100.00%
extention.ie.sogou.com,7,0.00%,7,0,100.00%
ca01.graniterapids.com,7,0.00%,7,0,100.00%
wbapp.mobile.sina.cn,7,0.00%,7,0,100.00%
ns3-04.azure-dns.org,7,0.00%,26,19,26.92%
img7.file.cache.docer.com,7,0.00%,8,1,87.50%
www.letpub.com.cn,7,0.00%,14,7,50.00%
webim.tim.qq.com,7,0.00%,7,0,100.00%
bsync3-normal-lf.zijieapi.com,7,0.00%,14,7,50.00%
ejewq6b2.sched.sma.tdnsstic1.cn,7,0.00%,7,0,100.00%
stat.funshion.net,7,0.00%,7,0,100.00%
m.mysmth.net,7,0.00%,7,0,100.00%
www.goodsync.com,7,0.00%,7,0,100.00%
195685-ipv4.farm.dprodmgd106.aa-rt.sharepoint.com,7,0.00%,7,0,100.00%
shark2.douyucdn.cn,7,0.00%,8,1,87.50%
in2-gw2-01-ce7dd027.eastus2.cloudapp.azure.com,7,0.00%,7,0,100.00%
overleaf.cipsup.cn,7,0.00%,7,0,100.00%
fp-it.portal101.cn,7,0.00%,7,0,100.00%
1332791409-server.va.huya.com,7,0.00%,7,0,100.00%
widget.cdn.bcebos.com,7,0.00%,8,1,87.50%
onedriveclucprodbn20021.blob.core.windows.net,7,0.00%,7,0,100.00%
iknow.n.shifen.com,7,0.00%,22,15,31.82%
dscache.tencent-cloud.cn,7,0.00%,7,0,100.00%
prod-commercial-systems.kubernetes-ingress.canonical.com,7,0.00%,7,0,100.00%
fides-pol.cdn-apple.com.akadns.net,7,0.00%,7,0,100.00%
fems.wps.cn,7,0.00%,7,0,100.00%
you.163.com,7,0.00%,7,0,100.00%
xnuca.erangelab.com,7,0.00%,7,0,100.00%
12.newspush.eastmoney.com,7,0.00%,7,0,100.00%
api.m.gds.taobao.com,7,0.00%,7,0,100.00%
pm.funshion.com,7,0.00%,7,0,100.00%
m.121du.cc,7,0.00%,7,0,100.00%
jp-amz.abuxiaoxi.xyz,7,0.00%,7,0,100.00%
bjbgp01.n.shifen.com,7,0.00%,7,0,100.00%
radio-activity.itunes.apple.com,7,0.00%,15,8,46.67%
fms.ipinyou.com,7,0.00%,7,0,100.00%
intake-analytics.wikimedia.ahau.cf,7,0.00%,7,0,100.00%
fmip.fe.apple-dns.cn,7,0.00%,7,0,100.00%
ooc.tm-2.office.com,7,0.00%,14,7,50.00%
renew.console.aliyun.com,7,0.00%,7,0,100.00%
tianshu.gtimg.cn,7,0.00%,15,8,46.67%
17.newspush.eastmoney.com,7,0.00%,7,0,100.00%
vd2.bdstatic.com,7,0.00%,11,4,63.64%
wd-prod-cp-as-southeast-2-fe.southeastasia.cloudapp.azure.com,7,0.00%,7,0,100.00%
89.newspush.eastmoney.com,7,0.00%,7,0,100.00%
boot-01.net.anydesk.com,7,0.00%,7,0,100.00%
sqdd.myapp.com,7,0.00%,13,6,53.85%
phx02pap002.storage.live.com,7,0.00%,13,6,53.85%
hk27.zxcv.men,7,0.00%,7,0,100.00%
pic8.iqiyipic.com,7,0.00%,14,7,50.00%
in03.graniterapids.com,7,0.00%,7,0,100.00%
c.3.cn,7,0.00%,13,6,53.85%
res.servicewechat.com,7,0.00%,10,3,70.00%
contentsync.onenote.com,7,0.00%,7,0,100.00%
stocks-edge.apple.com,7,0.00%,7,0,100.00%
jp07.graniterapids.com,7,0.00%,7,0,100.00%
stls.adobe.com-cn.edgesuite.net.globalredir.akadns.net,7,0.00%,7,0,100.00%
grs.dbankcloud.cn,7,0.00%,7,0,100.00%
lib.sinaapp.com,7,0.00%,7,0,100.00%
match.adsrvr.org,7,0.00%,7,0,100.00%
youtubei.googleapis.com,7,0.00%,15,8,46.67%
login.sina.com.cn,7,0.00%,7,0,100.00%
www.jipinyouwu.com,7,0.00%,7,0,100.00%
www.dlzdm.com,7,0.00%,7,0,100.00%
d2cb5ad7002c4066.huaweisafedns.cn,7,0.00%,7,0,100.00%
tc.forward.douban.com,7,0.00%,7,0,100.00%
www.ku6.com,7,0.00%,7,0,100.00%
vdn1.vzuu.com,7,0.00%,15,8,46.67%
s2.ssl.qhres2.com,7,0.00%,12,5,58.33%
api.wandb.ai,7,0.00%,7,0,100.00%
scontent.xx.fbcdn.net,7,0.00%,14,7,50.00%
opencdncloudv6.jomodns.com,7,0.00%,8,1,87.50%
userk-drcn.cloud.dbankcloud.cn,7,0.00%,7,0,100.00%
ss-lb.mdvdns.qhcdn.com,7,0.00%,7,0,100.00%
35.newspush.eastmoney.com,7,0.00%,7,0,100.00%
kinesis.us-east-1.amazonaws.com,7,0.00%,7,0,100.00%
windows.microsoft.com,7,0.00%,7,0,100.00%
opencdnbaiduwm.jomodns.com,7,0.00%,35,28,20.00%
p214-quota.icloud.com.cn,7,0.00%,7,0,100.00%
ocsp.rootg2.amazontrust.com,7,0.00%,14,7,50.00%
telemetry.pod5.prod.avatar.ext.hp.com,7,0.00%,7,0,100.00%
help-ar.apple.com.edgekey.net,7,0.00%,7,0,100.00%
item.jd.com,7,0.00%,13,6,53.85%
x.jd.com,7,0.00%,7,0,100.00%
gd-e-stage.cdn.sogou.com,7,0.00%,7,0,100.00%
tracker.shipyard-project.com,7,0.00%,7,0,100.00%
www.icbc-ltd.com,7,0.00%,12,5,58.33%
api.zhaomishijie.com,7,0.00%,7,0,100.00%
open.onebox.so.com,7,0.00%,7,0,100.00%
krsk10.graniterapids.com,7,0.00%,7,0,100.00%
pixel.rubiconproject.com,7,0.00%,7,0,100.00%
us08.graniterapids.com,7,0.00%,7,0,100.00%
e.dlx.addthis.com,7,0.00%,7,0,100.00%
dht.aelitis.com,7,0.00%,10,3,70.00%
revive.outin.cn,7,0.00%,7,0,100.00%
calendar.safe.360.cn,7,0.00%,7,0,100.00%
sec.umeng.com,7,0.00%,7,0,100.00%
i8.hexun.com,7,0.00%,7,0,100.00%
roll.hexun.com,7,0.00%,7,0,100.00%
iof.hexun.com,7,0.00%,7,0,100.00%
gmscompliance-pa.googleapis.com,7,0.00%,8,1,87.50%
api.tw06.xlmc.sec.miui.com,7,0.00%,7,0,100.00%
download.firefox.com.cn,7,0.00%,7,0,100.00%
escrowproxy.fe.apple-dns.cn,7,0.00%,7,0,100.00%
psyco.fr,7,0.00%,7,0,100.00%
onedscolprdjpe01.japaneast.cloudapp.azure.com,7,0.00%,7,0,100.00%
fh2.cmp-gaming.com,7,0.00%,7,0,100.00%
tags.bluekai.com,7,0.00%,7,0,100.00%
epns.eset.com,7,0.00%,7,0,100.00%
bl6pap003.settings.live.net,7,0.00%,7,0,100.00%
auth2.sangfor.com.cn.localdomain,7,0.00%,7,0,100.00%
p43-contacts.icloud.com,7,0.00%,11,4,63.64%
applog.ucdns.uc.cn,7,0.00%,7,0,100.00%
p215-keyvalueservice.icloud.com.cn,7,0.00%,7,0,100.00%
hr01.graniterapids.com,7,0.00%,7,0,100.00%
ogs.google.com,7,0.00%,7,0,100.00%
duba-triton-srv.zhhainiao.com,7,0.00%,7,0,100.00%
glb.api.prod.dcat.dsp.trafficmanager.NET,7,0.00%,16,9,43.75%
37.newspush.eastmoney.com,7,0.00%,7,0,100.00%
upload_data.qq.com,7,0.00%,7,0,100.00%
o.ss2.us,7,0.00%,7,0,100.00%
gecko5-lf.zijieapi.com,7,0.00%,7,0,100.00%
hg03.ptrecord.com,7,0.00%,7,0,100.00%
ads.stickyadstv.com,7,0.00%,7,0,100.00%
onedriveclucproddm20016.blob.core.windows.net,7,0.00%,7,0,100.00%
api-iam.intercom.io,7,0.00%,7,0,100.00%
e8203.g.akamaiedge.NET,7,0.00%,7,0,100.00%
www.carbon60.com,7,0.00%,7,0,100.00%
stls.adobe.com-cn.edgesuite.net,7,0.00%,7,0,100.00%
www.eclzz.plus,7,0.00%,7,0,100.00%
www.wangpans.com,7,0.00%,7,0,100.00%
www.epanso.com,7,0.00%,7,0,100.00%
www.ciligogo.vip,7,0.00%,7,0,100.00%
www.xbqgxs.net,7,0.00%,7,0,100.00%
f001.backblazeb2.com,7,0.00%,7,0,100.00%
upos-sz-mirrorcos.bilivideo.com.cdn.dnsv1.com,7,0.00%,14,7,50.00%
pop3.nfschina.com,7,0.00%,7,0,100.00%
tracker.skynetcloud.site,7,0.00%,7,0,100.00%
jeremylee.sh,7,0.00%,7,0,100.00%
weatherapi.market.xiaomi.com,7,0.00%,7,0,100.00%
onedriveclucproddm20036.blob.core.windows.net,7,0.00%,7,0,100.00%
r4---sn-2x3elnes.gvt1.com,7,0.00%,7,0,100.00%
retracker.nts.su,7,0.00%,7,0,100.00%
peerfect.org,7,0.00%,7,0,100.00%
bt2.54new.com,7,0.00%,7,0,100.00%
488928.sched.skalego-dk.tdnsstic1.cn.cjt.vwnti.yrzhcloud.cn,7,0.00%,18,11,38.89%
analytics.ccs.mcafee.com,7,0.00%,7,0,100.00%
sdkmonitor.biz.weibo.com,7,0.00%,7,0,100.00%
auth-v2.oray.com,7,0.00%,7,0,100.00%
a.cwip.eset.com,7,0.00%,7,0,100.00%
sa-update.spamassassin.org,7,0.00%,7,0,100.00%
netron.app,7,0.00%,7,0,100.00%
btshow.jd.com,7,0.00%,7,0,100.00%
bugou.jd.com,7,0.00%,7,0,100.00%
quan.jd.com,7,0.00%,7,0,100.00%
gslb-offline-pkx01.zhihu.com,7,0.00%,7,0,100.00%
uk02.graniterapids.com,7,0.00%,7,0,100.00%
ai.jd.com,7,0.00%,7,0,100.00%
assessmonitor.ceping.com,7,0.00%,7,0,100.00%
ins-2ybret5v.ias.tencent-cloud.net,7,0.00%,15,8,46.67%
luas.im.ke.com,7,0.00%,7,0,100.00%
i-lq.snssdk.com,7,0.00%,7,0,100.00%
jpaz03.ptrecord.com,7,0.00%,7,0,100.00%
cdn-qwb-hz.wxb.com,7,0.00%,7,0,100.00%
onedriveclucprodbn20014.blob.core.windows.net,7,0.00%,7,0,100.00%
clientstream.launchdarkly.com,7,0.00%,7,0,100.00%
prod.ocws1.live.com.akadns.net,7,0.00%,7,0,100.00%
www.jjckb.cn,7,0.00%,14,7,50.00%
init.sandbox.push.apple.com,7,0.00%,7,0,100.00%
tos.razerapi.com,7,0.00%,7,0,100.00%
frontier-toutiao.snssdk.com,7,0.00%,7,0,100.00%
api.dropboxapi.com,7,0.00%,15,8,46.67%
rpm.nodesource.com,7,0.00%,8,1,87.50%
t0.tiles.ditu.live.com,7,0.00%,7,0,100.00%
nl6.chuqianglai.com,7,0.00%,7,0,100.00%
paimgcdn.baidu.com,7,0.00%,10,3,70.00%
uinfo.mail.163.com,7,0.00%,7,0,100.00%
tim.tencent-cloud-gslb.com,7,0.00%,7,0,100.00%
s15.upd.kaspersky.com,7,0.00%,7,0,100.00%
nvidia.tt.omtrdc.net,7,0.00%,7,0,100.00%
tqos.gamesafe.qq.com,7,0.00%,14,7,50.00%
ip3546021124.funshion.com,7,0.00%,7,0,100.00%
sconsentit911.cloudapp.net,6,0.00%,6,0,100.00%
s-ring.s-9999.s-msedge.net,6,0.00%,6,0,100.00%
toutiao.rtmplive.ks-cdn.com,6,0.00%,10,4,60.00%
www.126.com,6,0.00%,6,0,100.00%
octopus.jovcloud.com,6,0.00%,6,0,100.00%
geo-eu-us-sticky.delivery-prod-sas.akadns.net,6,0.00%,9,3,66.67%
gocart-web-prod-ue1-477818442.us-east-1.elb.amazonaws.com,6,0.00%,6,0,100.00%
tvax2.sinaimg.cn,6,0.00%,274,268,2.19%
tvax4.sinaimg.cn,6,0.00%,228,222,2.63%
oimagec1.ydstatic.com,6,0.00%,6,0,100.00%
wd-prod-cp-as-southeast-4-fe.southeastasia.cloudapp.azure.com,6,0.00%,6,0,100.00%
cf.aliyun.com,6,0.00%,11,5,54.55%
conf.cipsup.cn,6,0.00%,6,0,100.00%
extshort.weixin.qq.com,6,0.00%,1320,1314,0.45%
isee.weishi.qq.com,6,0.00%,6,0,100.00%
spoprod-a.akamaihd.net,6,0.00%,6,0,100.00%
data.osdknw.com,6,0.00%,6,0,100.00%
k-static.xsfaya.com.wswebcdn.com,6,0.00%,6,0,100.00%
img1.wywyx.com,6,0.00%,6,0,100.00%
www.amss.cas.cn,6,0.00%,6,0,100.00%
28-courier.push.apple.com,6,0.00%,6,0,100.00%
push-rtmp-l6.douyincdn.com.upvcloud.ks-cdn.com,6,0.00%,11,5,54.55%
pull-fcdn-douyin-base4.s.bytefcdn.com,6,0.00%,6,0,100.00%
p.clkservice.youdao.com,6,0.00%,6,0,100.00%
cn2.gmdns.net,6,0.00%,6,0,100.00%
sg1.gmdns.net,6,0.00%,6,0,100.00%
cn9.gmdns.net,6,0.00%,6,0,100.00%
cn14.gmdns.net,6,0.00%,6,0,100.00%
cn5.gmdns.net,6,0.00%,6,0,100.00%
www.focustodo.net,6,0.00%,6,0,100.00%
alt4-mtalk.google.com,6,0.00%,6,0,100.00%
capi.douyucdn.cn,6,0.00%,12,6,50.00%
sploit-edge.smartscreen.microsoft.com,6,0.00%,6,0,100.00%
t12.baidu.com.a.bdydns.com,6,0.00%,9,3,66.67%
hkg03.bch.baidu-itm.com,6,0.00%,6,0,100.00%
pu-kos.ks3-cn-beijing.ksyun.com,6,0.00%,6,0,100.00%
nsp-hicloud-cloudbackupnorth4-p01-drcn.obs.cn-north-4.myhuaweicloud.cn,6,0.00%,6,0,100.00%
nsp-hicloud-cloudphotonorth4-p03-drcn.obs.cn-north-4.myhuaweicloud.com,6,0.00%,6,0,100.00%
onedriveclucprodbn20011.blob.core.windows.net,6,0.00%,6,0,100.00%
cnc.quickconnect.cn,6,0.00%,6,0,100.00%
47.push2.eastmoney.com,6,0.00%,10,4,60.00%
83.newspush.eastmoney.com,6,0.00%,6,0,100.00%
63.newspush.eastmoney.com,6,0.00%,6,0,100.00%
akn.safe.360.cn,6,0.00%,6,0,100.00%
hub5sr.v6.shub.sandai.net,6,0.00%,151,145,3.97%
dls2.bigdata.samsung.com.cn,6,0.00%,6,0,100.00%
pull-rtmp-l6-cny.douyincdn.com.rtmpvcloud.ks-cdn.com,6,0.00%,9,3,66.67%
pull-tsl-spe-l6.douyincdn.com.hlsvcloud.ks-cdn.com,6,0.00%,15,9,40.00%
sx-common-v4.volcgtm.com,6,0.00%,6,0,100.00%
pull-fcdn-douyin-hot3.s.bytefcdn.com,6,0.00%,6,0,100.00%
v11.douyinvod.com.cdn.dnsv1.com,6,0.00%,12,6,50.00%
v11.sched.v4lego-dk.tdnsvod1.cn,6,0.00%,12,6,50.00%
user-data-apac-jp.bidswitch.net,6,0.00%,6,0,100.00%
krgame06.graniterapids.com,6,0.00%,6,0,100.00%
ml314.com,6,0.00%,6,0,100.00%
ags.privatelink.msidentity.com,6,0.00%,25,19,24.00%
kunpeng-sc.csdnimg.cn.w.cdngslb.com,6,0.00%,6,0,100.00%
piccache.cnki.net,6,0.00%,6,0,100.00%
qa.sockets.stackexchange.com,6,0.00%,6,0,100.00%
yl.zh.cmbchina.com,6,0.00%,6,0,100.00%
s3gw.cmbimg.com,6,0.00%,6,0,100.00%
u.zhugeapi.net,6,0.00%,6,0,100.00%
query.ess-apple.com.akadns.net,6,0.00%,6,0,100.00%
v26-cold.douyinvod.com.c.cdnhwc1.com,6,0.00%,12,6,50.00%
ipv46.fanyi-bfe.n.shifen.com,6,0.00%,12,6,50.00%
nim-lbs-netease-im.ntes53.netease.com,6,0.00%,6,0,100.00%
api.k.163.com,6,0.00%,9,3,66.67%
fmf.fe.apple-dns.cn,6,0.00%,6,0,100.00%
api.sobot.com,6,0.00%,6,0,100.00%
skin.browser.qq.com,6,0.00%,6,0,100.00%
cdn.apifox.cn,6,0.00%,12,6,50.00%
fm.dl.126.net.w.cdngslb.com,6,0.00%,6,0,100.00%
um01.eset.com,6,0.00%,6,0,100.00%
download.proxmox.com,6,0.00%,63,57,9.52%
account-public-service-prod03.ol.epicgames.com,6,0.00%,6,0,100.00%
dsp-x.jd.com,6,0.00%,6,0,100.00%
static-dxospf.split.netease.com,6,0.00%,6,0,100.00%
janapi.jd.com,6,0.00%,6,0,100.00%
e-p4p.163.com,6,0.00%,6,0,100.00%
toblog.ctobsnssdk.com.c.dsa.cdnbuild.net,6,0.00%,6,0,100.00%
dy-vod-j.bytegslb.com,6,0.00%,6,0,100.00%
ecn.dev.ditu.live.com.lxcvc.com,6,0.00%,6,0,100.00%
pccw08.graniterapids.com,6,0.00%,6,0,100.00%
g1xd.mediav.com,6,0.00%,6,0,100.00%
s0.ssl.qhres2.com,6,0.00%,7,1,85.71%
s19.cnzz.com,6,0.00%,6,0,100.00%
s.symcd.com,6,0.00%,15,9,40.00%
telemetry.influxdata.com,6,0.00%,6,0,100.00%
doh.pub,6,0.00%,6,0,100.00%
push-rtmp-l6.douyincdn.com,6,0.00%,10,4,60.00%
pull-hls-spe-l11.douyincdn.com.tlivecdn.com,6,0.00%,6,0,100.00%
35.push2.eastmoney.com,6,0.00%,9,3,66.67%
92.newspush.eastmoney.com,6,0.00%,6,0,100.00%
match.prod.bidr.io,6,0.00%,6,0,100.00%
api-cname.growingio.com,6,0.00%,6,0,100.00%
p5.qhimg.com,6,0.00%,8,2,75.00%
xlab.baidu.com,6,0.00%,6,0,100.00%
disc601.prod.do.dsp.mp.microsoft.com.edgekey.net,6,0.00%,6,0,100.00%
library-service.beee.live.use1a.on.epicgames.com,6,0.00%,6,0,100.00%
ichannel.snssdk.com,6,0.00%,6,0,100.00%
66.ucp-ntfy.kaspersky-labs.com,6,0.00%,6,0,100.00%
mirrorcos.sched.stsoclegoby2-dk.tdnsvod1.cn,6,0.00%,12,6,50.00%
ntp.msn.com,6,0.00%,8,2,75.00%
connect-drcn.dbankcloud.cn,6,0.00%,6,0,100.00%
sg.bls.mdt.qq.com,6,0.00%,6,0,100.00%
38-courier.push.apple.com,6,0.00%,6,0,100.00%
b.6sc.co,6,0.00%,6,0,100.00%
sg01.graniterapids.com,6,0.00%,6,0,100.00%
1b5e7de2ce344d8a.huaweisafedns.cn,6,0.00%,6,0,100.00%
api.flicker.vifird.com,6,0.00%,6,0,100.00%
p3.music.126.net.163jiasu.com,6,0.00%,12,6,50.00%
my.hideu.org,6,0.00%,6,0,100.00%
p.bokecc.com,6,0.00%,6,0,100.00%
api.lequ.dns.iqiyi.com,6,0.00%,6,0,100.00%
nsp-hicloud-cloudbackupsouth1-p01-drcn.obs.cn-south-1.myhuaweicloud.cn,6,0.00%,6,0,100.00%
nsp-hicloud-cloudbackupsouth1-p02-drcn.obs.cn-south-1.myhuaweicloud.cn,6,0.00%,6,0,100.00%
push-rtmp-vr-f5.douyincdn.com,6,0.00%,6,0,100.00%
game.str.mdt.qq.com,6,0.00%,6,0,100.00%
yxzjfaas.native.qq.com,6,0.00%,6,0,100.00%
vt.ipinyou.com,6,0.00%,6,0,100.00%
static.runoob.com,6,0.00%,6,0,100.00%
static.ads-twitter.com,6,0.00%,6,0,100.00%
is3-ssl.mzstatic.com,6,0.00%,6,0,100.00%
prod.adobegenuine.com,6,0.00%,13,7,46.15%
onedscolprdfrc07.francecentral.cloudapp.azure.com,6,0.00%,6,0,100.00%
statics.teams.cdn.office.net-c.edgesuite.net,6,0.00%,6,0,100.00%
wns2-sg2p.wns.windows.com,6,0.00%,6,0,100.00%
krgame05.graniterapids.com,6,0.00%,6,0,100.00%
adashx4yt.m.taobao.com.gds.alibabadns.com,6,0.00%,6,0,100.00%
xcx-static.yqgz.beijing.gov.cn,6,0.00%,6,0,100.00%
2195708.sched.d0.tdnsdp1.cn,6,0.00%,6,0,100.00%
account.synology.com,6,0.00%,6,0,100.00%
p203-contacts.icloud.com.cn,6,0.00%,6,0,100.00%
www.bingapis.com,6,0.00%,6,0,100.00%
retcode.taobao.com,6,0.00%,6,0,100.00%
cdn.taboola.com,6,0.00%,6,0,100.00%
se2.itunes.apple.com,6,0.00%,11,5,54.55%
acw.sciencedirect.com,6,0.00%,6,0,100.00%
acw.elsevier.com,6,0.00%,6,0,100.00%
smetrics.elsevier.com,6,0.00%,6,0,100.00%
elsevier.demdex.net,6,0.00%,6,0,100.00%
e87.dspg.akamaiedge.net,6,0.00%,11,5,54.55%
service-cn.hwccpc.com,6,0.00%,6,0,100.00%
images-eu.ssl-images-amazon.com,6,0.00%,7,1,85.71%
upos-sz-static.bilivideo.com,6,0.00%,14,8,42.86%
zconfig.alibabausercontent.com.w.cdngslb.com,6,0.00%,13,7,46.15%
identity.ess.apple.com,6,0.00%,6,0,100.00%
ip.geo.iqiyi.com,6,0.00%,6,0,100.00%
cloudrest.mbgcdn.lenovo.com.cn,6,0.00%,6,0,100.00%
s.cn.bing.chinacache.net,6,0.00%,6,0,100.00%
dl.pinyin.sogou.com.cdn.dnsv1.com,6,0.00%,6,0,100.00%
ssdkauth.hpplay.cn,6,0.00%,6,0,100.00%
twgame06.graniterapids.com,6,0.00%,6,0,100.00%
gw.alicdn.com,6,0.00%,12,6,50.00%
connect-drcn.hispace.hicloud.com,6,0.00%,6,0,100.00%
zerossl.ocsp.sectigo.com,6,0.00%,371,365,1.62%
d2ws9o8vfrpkyk.cloudfront.net,6,0.00%,6,0,100.00%
cognito-identity.us-east-1.amazonaws.com,6,0.00%,14,8,42.86%
onmyoji.fp.ps.netease.com,6,0.00%,16,10,37.50%
urswebzj-v6.nosdn.127.net,6,0.00%,6,0,100.00%
r.mail.163.com,6,0.00%,6,0,100.00%
open.snssdk.com,6,0.00%,6,0,100.00%
ejp1-authgw.cloudapp.net,6,0.00%,6,0,100.00%
mqtt-web.zhihu.com.dsa.dnsv1.com,6,0.00%,6,0,100.00%
officecdn.trafficmanager.net,6,0.00%,6,0,100.00%
officecdn.microsoft.com.a.bdydns.com,6,0.00%,6,0,100.00%
mesu-cdn.origin-apple.com.akadns.net,6,0.00%,12,6,50.00%
usstartus1.eucdurl.me,6,0.00%,6,0,100.00%
vas.samsungapps.com,6,0.00%,6,0,100.00%
chart.docer.wps.cn,6,0.00%,6,0,100.00%
fanyi.sogou.com,6,0.00%,11,5,54.55%
mercury-sdk.snssdk.com.w.cdngslb.com,6,0.00%,6,0,100.00%
onedrive.live.com,6,0.00%,14,8,42.86%
twct02.graniterapids.com,6,0.00%,6,0,100.00%
lf26-orange.byteorge.com,6,0.00%,6,0,100.00%
us01.graniterapids.com,6,0.00%,6,0,100.00%
images-na.ssl-images-amazon.com,6,0.00%,8,2,75.00%
com.wf.pub,6,0.00%,6,0,100.00%
cdn.advert.wanfangdata.com.cn,6,0.00%,6,0,100.00%
pmmtk-a.pinduoduo.com,6,0.00%,6,0,100.00%
8.tlu.dl.delivery.mp.microsoft.com,6,0.00%,11,5,54.55%
60.newspush.eastmoney.com,6,0.00%,6,0,100.00%
s10.upd.kaspersky.com,6,0.00%,6,0,100.00%
rj-ts.2345.cc,6,0.00%,6,0,100.00%
cloud.safe.360.cn,6,0.00%,6,0,100.00%
d2rb60829qiz9y.cloudfront.net,6,0.00%,70,64,8.57%
nimg.ws.126.net,6,0.00%,15,9,40.00%
22.newspush.eastmoney.com,6,0.00%,6,0,100.00%
1.newspush.eastmoney.com,6,0.00%,6,0,100.00%
64.newspush.eastmoney.com,6,0.00%,6,0,100.00%
ns3.canonical.com,6,0.00%,6,0,100.00%
s14.upd.kaspersky.com,6,0.00%,6,0,100.00%
nos.ns1.ff.avast.com,6,0.00%,6,0,100.00%
skyversion.webrootcloudav.com,6,0.00%,6,0,100.00%
face.t.sinajs.cn,6,0.00%,36,30,16.67%
en.wikipedia.org,6,0.00%,16,10,37.50%
unionsug.baidu.com,6,0.00%,6,0,100.00%
opencdnjd.jomodns.com,6,0.00%,9,3,66.67%
quantcast.mgr.consensu.org,6,0.00%,12,6,50.00%
pic5.iqiyipic.com,6,0.00%,11,5,54.55%
p.hnnzwhyy.com,6,0.00%,6,0,100.00%
v.sogowan.com,6,0.00%,6,0,100.00%
p0.meituan.net,6,0.00%,13,7,46.15%
hey03.cjkypo.com,6,0.00%,6,0,100.00%
9.newspush.eastmoney.com,6,0.00%,6,0,100.00%
down1.xinshuru.com.wsdvs.com,6,0.00%,6,0,100.00%
mask-canary.icloud.com,6,0.00%,14,8,42.86%
4.newspush.eastmoney.com,6,0.00%,6,0,100.00%
portal.arp.cn,6,0.00%,6,0,100.00%
g37.gdl.netease.com,6,0.00%,6,0,100.00%
g37-capsule-toys.webapp.163.com,6,0.00%,6,0,100.00%
71.newspush.eastmoney.com,6,0.00%,6,0,100.00%
twgame05.graniterapids.com,6,0.00%,6,0,100.00%
wkimg.bdimg.com,6,0.00%,13,7,46.15%
wkctj.baidu.com,6,0.00%,22,16,27.27%
tg35.syscdn.zjsxlt.com,6,0.00%,6,0,100.00%
saxn.sina.com.cn,6,0.00%,6,0,100.00%
j.bd.twlxyx.cn,6,0.00%,6,0,100.00%
cre.mix.sina.com.cn,6,0.00%,6,0,100.00%
s.u7u9.com,6,0.00%,6,0,100.00%
st.douding.cn,6,0.00%,6,0,100.00%
www.docin.com,6,0.00%,6,0,100.00%
zx.docin.com,6,0.00%,6,0,100.00%
router.bittorrent.cloud,6,0.00%,6,0,100.00%
license.vod2.myqcloud.com,6,0.00%,6,0,100.00%
yyb.eve.mdt.qq.com,6,0.00%,6,0,100.00%
mdn.alipay.com,6,0.00%,6,0,100.00%
r1---sn-ni5eln7l.gvt1.com,6,0.00%,6,0,100.00%
script.hotjar.com,6,0.00%,6,0,100.00%
c.disquscdn.com,6,0.00%,11,5,54.55%
ccflbs.m.jd.com,6,0.00%,6,0,100.00%
anti-sdk-report.m.jd.com,6,0.00%,6,0,100.00%
livewebbs2.msstatic.com,6,0.00%,13,7,46.15%
p2.ssl.qhimg.com,6,0.00%,7,1,85.71%
s.tslsmart.com,6,0.00%,6,0,100.00%
eeth9boh.nodedata.net,6,0.00%,6,0,100.00%
jobs.bytedance.com,6,0.00%,6,0,100.00%
blackhole.m.jd.com,6,0.00%,6,0,100.00%
m.stripe.network,6,0.00%,6,0,100.00%
live.bilibili.com,6,0.00%,7,1,85.71%
outlookmobile-office365-tas-msedge-net.e-0009.e-msedge.net,6,0.00%,6,0,100.00%
login-wpscdn-cn-idvas7z.qiniudns.com,6,0.00%,6,0,100.00%
tencent-doc.cdn-go.cn,6,0.00%,14,8,42.86%
58.newspush.eastmoney.com,6,0.00%,6,0,100.00%
onedriveclucprodbn20001.blob.core.windows.net,6,0.00%,6,0,100.00%
offline.aps.amap.com,6,0.00%,12,6,50.00%
access-domain.ks3-cn-beijing-wan-wps.ksyun.com,6,0.00%,6,0,100.00%
push2.msgpush.ccb.com,6,0.00%,6,0,100.00%
r3---sn-2x3elnez.gvt1.com,6,0.00%,6,0,100.00%
123p0.sogoucdn.com,6,0.00%,6,0,100.00%
api-static.mihoyo.com,6,0.00%,6,0,100.00%
e2820.g.akamaiedge.NET,6,0.00%,6,0,100.00%
xueqiu.com,6,0.00%,6,0,100.00%
private-alipayobjects.alipay.com,6,0.00%,6,0,100.00%
msginfo.rising.com.cn,6,0.00%,6,0,100.00%
gbfek.dfcfw.com,6,0.00%,13,7,46.15%
wdr160gz.dayugslb.com,6,0.00%,6,0,100.00%
hk-vip001.taboola.com,6,0.00%,6,0,100.00%
iface2.iqiyi.com,6,0.00%,6,0,100.00%
mpaas.iqiyi.com,6,0.00%,6,0,100.00%
pic3.iqiyipic.com,6,0.00%,12,6,50.00%
clang.llvm.org,6,0.00%,6,0,100.00%
lyrics.kugou.com,6,0.00%,17,11,35.29%
ip3720517260.funshion.com,6,0.00%,6,0,100.00%
i.91duba.com,6,0.00%,6,0,100.00%
update.pc.mi.com,6,0.00%,6,0,100.00%
contentcenter-drcn.dbankcdn.com,6,0.00%,12,6,50.00%
union.infoc.duba.net,6,0.00%,6,0,100.00%
rhc.sonatype.com,6,0.00%,6,0,100.00%
udp.ping.teamviewer.com,6,0.00%,14,8,42.86%
upd10.sogoucdn.com,6,0.00%,6,0,100.00%
athena.wan.sogou.com,6,0.00%,6,0,100.00%
activity.docer.wps.cn,6,0.00%,6,0,100.00%
appsec.hicloud.com,6,0.00%,6,0,100.00%
mini.group.qq.com,6,0.00%,6,0,100.00%
51.push2.eastmoney.com,6,0.00%,11,5,54.55%
8.newspush.eastmoney.com,6,0.00%,6,0,100.00%
19.newspush.eastmoney.com,6,0.00%,6,0,100.00%
e83157.dscb.akamaiedge.net,6,0.00%,12,6,50.00%
kcn-deal.kaikeba.com,6,0.00%,6,0,100.00%
relay-6556aec6.net.anydesk.com,6,0.00%,6,0,100.00%
gua2.qhimg.com,6,0.00%,6,0,100.00%
onedriveclucproddm20025.blob.core.windows.net,6,0.00%,6,0,100.00%
p7.qhimg.com,6,0.00%,7,1,85.71%
21.push2.eastmoney.com,6,0.00%,11,5,54.55%
p3.fx.kgimg.com,6,0.00%,10,4,60.00%
gtm-sg-6wr2shjbe03.gtm-i1d2.com,6,0.00%,6,0,100.00%
m.addthis.com,6,0.00%,6,0,100.00%
target.microsoft.com,6,0.00%,6,0,100.00%
afdconf.baidu.com,6,0.00%,6,0,100.00%
gu.dyntrk.com,6,0.00%,6,0,100.00%
yccdn3.douyucdn2.cn,6,0.00%,6,0,100.00%
hlsh5p2.douyucdn2.cn,6,0.00%,6,0,100.00%
dyp2p-hw.douyucdn.cn,6,0.00%,6,0,100.00%
a179.b.akamai.net,6,0.00%,6,0,100.00%
i.int.dpool.sina.com.cn,6,0.00%,6,0,100.00%
rtclbs.xdrtc.com,6,0.00%,6,0,100.00%
static.doubleclick.net,6,0.00%,6,0,100.00%
msedge.f.dl.delivery.mp.microsoft.com,6,0.00%,6,0,100.00%
v.hoopchina.com.cn,6,0.00%,12,6,50.00%
p3.music.126.net,6,0.00%,17,11,35.29%
msg.douyu.com,6,0.00%,6,0,100.00%
msgstatic.douyu.com,6,0.00%,6,0,100.00%
tiebapic.baidu.com,6,0.00%,8,2,75.00%
sync-tm.everesttech.net,6,0.00%,6,0,100.00%
track.adformnet.akadns.net,6,0.00%,6,0,100.00%
fennec-catalog-cdn.prod.mozaws.net,6,0.00%,6,0,100.00%
mail-activity.nosdn.127.net,6,0.00%,6,0,100.00%
vod.cn-shanghai.aliyuncs.com,6,0.00%,6,0,100.00%
dsplog-adnet.vivo.com.cn,6,0.00%,6,0,100.00%
ip2100177548.funshion.com,6,0.00%,6,0,100.00%
p208-quota.icloud.com.cn,6,0.00%,6,0,100.00%
23-courier.push.apple.com,6,0.00%,6,0,100.00%
23.courier-push-apple.com.akadns.net,6,0.00%,6,0,100.00%
ru01.ptrecord.com,6,0.00%,6,0,100.00%
p1.qhimg.com,6,0.00%,9,3,66.67%
r4---sn-2x3elnez.gvt1.com,6,0.00%,6,0,100.00%
media.adaware.com,6,0.00%,6,0,100.00%
utclient.utorrent.com,6,0.00%,9,3,66.67%
in02.graniterapids.com,6,0.00%,6,0,100.00%
v1.go2yd.com.a.vvipcdn.com,6,0.00%,6,0,100.00%
httpdns.alicdn.com.danuoyi.tbcache.com,6,0.00%,11,5,54.55%
odc-commonafdrk-brs.onedrive.akadns.net,6,0.00%,9,3,66.67%
www.computer.org,6,0.00%,6,0,100.00%
aistudio.baidu.com,6,0.00%,6,0,100.00%
engage.anu.edu.au,6,0.00%,6,0,100.00%
qqmail.tencent.com,6,0.00%,6,0,100.00%
ipagave.azurewebsites.net,6,0.00%,6,0,100.00%
manage.devcenter.microsoft.com,6,0.00%,6,0,100.00%
tmfsdktcpv4.m.qq.com,6,0.00%,6,0,100.00%
onedriveclucprodbn20045.blob.core.windows.net,6,0.00%,6,0,100.00%
e4478.dscb.akamaiedge.net,6,0.00%,12,6,50.00%
catalog-public-service-prod.ak.epicgames.com,6,0.00%,16,10,37.50%
na61-na62.wagbridge.alibaba.tanx.com.gds.alibabadns.com,6,0.00%,6,0,100.00%
show.bilibili.com.w.kunlunar.com,6,0.00%,6,0,100.00%
szc.y.qq.com,6,0.00%,6,0,100.00%
jingyan.baidu.com,6,0.00%,15,9,40.00%
pim-drcn.cloud.dbankcloud.cn,6,0.00%,6,0,100.00%
app-site-association-cn-lb.cdn-apple.com.akadns.net,6,0.00%,6,0,100.00%
ns4-04.azure-dns.info,6,0.00%,24,18,25.00%
zqhd.eastmoney.com,6,0.00%,6,0,100.00%
releases.rancher.com,6,0.00%,8,2,75.00%
compatm.tplay.qq.com,6,0.00%,6,0,100.00%
cybersecurity.springeropen.com,6,0.00%,6,0,100.00%
poi-pic-gz.cdn.bcebos.com,6,0.00%,6,0,100.00%
img.cdn.house,6,0.00%,6,0,100.00%
aliyun-web-tracker.cn-zhangjiakou.log.aliyuncs.com,6,0.00%,6,0,100.00%
i.alicdn.com,6,0.00%,6,0,100.00%
console-base.log-global.aliyuncs.com,6,0.00%,6,0,100.00%
b.alicdn.com,6,0.00%,6,0,100.00%
ecs-buy.aliyun.com,6,0.00%,6,0,100.00%
ocsp-ds.ws.symantec.com.edgekey.net,6,0.00%,15,9,40.00%
tracker.tricitytorrents.com,6,0.00%,6,0,100.00%
gimg0.baidu.com,6,0.00%,6,0,100.00%
feeds-drcn.dbankcdn.cn,6,0.00%,6,0,100.00%
cdn-global-api.trafficmanager.cn,6,0.00%,6,0,100.00%
keyrotate.qq.com,6,0.00%,6,0,100.00%
guid.tpns.tencent.com,6,0.00%,6,0,100.00%
snowplow.apps.clarivate.com,6,0.00%,6,0,100.00%
edge.activity.windows.com.akadns.net,6,0.00%,6,0,100.00%
gitee.cn,6,0.00%,6,0,100.00%
www.openatom.org,6,0.00%,6,0,100.00%
uddxy.shiyiyx.com,6,0.00%,6,0,100.00%
aeu.alicdn.com.danuoyi.alicdn.com,6,0.00%,13,7,46.15%
pic0.iqiyipic.com,6,0.00%,12,6,50.00%
serv.vip.iqiyi.com,6,0.00%,6,0,100.00%
userpref.iqiyi.com,6,0.00%,6,0,100.00%
rc10-fc08.oray.com,6,0.00%,6,0,100.00%
cdn-file.cchytech.com,6,0.00%,6,0,100.00%
adashbc.m.taobao.com,6,0.00%,6,0,100.00%
m.mpl.dutils.com,6,0.00%,6,0,100.00%
p3.dcarimg.com.w.kunluncan.com,6,0.00%,6,0,100.00%
www.dongchedi.com.w.cdngslb.com,6,0.00%,6,0,100.00%
p5-auto.dcarimg.com,6,0.00%,6,0,100.00%
p3-dcd-sign.byteimg.com,6,0.00%,6,0,100.00%
msg.iqiyi.com,6,0.00%,6,0,100.00%
ts3.cn.mm.bing.chinacache.net,6,0.00%,6,0,100.00%
f7yzbgp.a.sohu.com,6,0.00%,6,0,100.00%
c.gsc.qq.com,6,0.00%,6,0,100.00%
uz91.v.bsgslb.com,6,0.00%,11,5,54.55%
cdn-api-verify.mob.com,6,0.00%,6,0,100.00%
67.newspush.eastmoney.com,6,0.00%,6,0,100.00%
static-d.iqiyi.com,6,0.00%,12,6,50.00%
e7695.g.akamaiedge.net,6,0.00%,6,0,100.00%
p.cpx.to,6,0.00%,6,0,100.00%
pic2.zhimg.com.a.bdydns.com,6,0.00%,19,13,31.58%
p60-buy.itunes.apple.com,6,0.00%,6,0,100.00%
guoguouser.cainiao.com,6,0.00%,6,0,100.00%
impression.biligame.com.cdn.dnsv1.com,6,0.00%,6,0,100.00%
market.android.com,6,0.00%,6,0,100.00%
gimg4.baidu.com.a.bdydns.com,6,0.00%,8,2,75.00%
gv1.xdrig.com.td.fusion.iaas.jdcloud.com,6,0.00%,6,0,100.00%
amp-api.apps-lb-cn.itunes-apple.com.akadns.net,6,0.00%,10,4,60.00%
cloudcache.tencent-cloud.com,6,0.00%,6,0,100.00%
www.wedocare.com,6,0.00%,6,0,100.00%
as.xiaohongshu.com,6,0.00%,6,0,100.00%
eq.10jqka.com.cn,6,0.00%,6,0,100.00%
ads.service.kugou.com,6,0.00%,6,0,100.00%
app-site-association.cdn-apple.com,6,0.00%,6,0,100.00%
aisdk.wps.cn,6,0.00%,6,0,100.00%
hiswd.jd.com,6,0.00%,6,0,100.00%
fe1.hdfimg.com,6,0.00%,6,0,100.00%
i2.hdfimg.com,6,0.00%,6,0,100.00%
www.haodf.com,6,0.00%,6,0,100.00%
i1.hdfimg.com,6,0.00%,6,0,100.00%
TranSIT1.WSlOg.ChinaNeTceNtEr.cOm,6,0.00%,6,0,100.00%
zoo.haodf.com,6,0.00%,6,0,100.00%
sg06.graniterapids.com,6,0.00%,6,0,100.00%
pgy-tk.oray.com,6,0.00%,6,0,100.00%
sgp03.graniterapids.com,6,0.00%,6,0,100.00%
xiaoyouxi.360.cn,6,0.00%,6,0,100.00%
router.bittorrent.com,6,0.00%,10,4,60.00%
ds1.devicevm.com,6,0.00%,6,0,100.00%
rust-lang.gallerycdn.azure.cn,6,0.00%,6,0,100.00%
3g.163.com,6,0.00%,6,0,100.00%
channel.m.163.com,6,0.00%,6,0,100.00%
agps.location.live.net,6,0.00%,6,0,100.00%
beacon.krxd.net,6,0.00%,6,0,100.00%
api-xiuxiupro.meitu.com,6,0.00%,6,0,100.00%
hxjstool.hexun.com,6,0.00%,6,0,100.00%
reg.tool.hexun.com,6,0.00%,6,0,100.00%
i0.hexun.com,6,0.00%,6,0,100.00%
s13.cnzz.com,6,0.00%,6,0,100.00%
comment.tool.hexun.com,6,0.00%,6,0,100.00%
stock.hexun.com,6,0.00%,6,0,100.00%
nj.hexun.com,6,0.00%,6,0,100.00%
xianhuo.hexun.com,6,0.00%,6,0,100.00%
zhongchou.hexun.com,6,0.00%,6,0,100.00%
www.estrongs.com.wtxcdn.com,6,0.00%,6,0,100.00%
ds.hexun.com,6,0.00%,6,0,100.00%
gold.hexun.com,6,0.00%,6,0,100.00%
licaike.hexun.com,6,0.00%,6,0,100.00%
vdn5.vzuu.com,6,0.00%,12,6,50.00%
wifi.360.cn,6,0.00%,6,0,100.00%
new-line.net,6,0.00%,6,0,100.00%
aarsen.me,6,0.00%,6,0,100.00%
gt1.baidu.com,6,0.00%,6,0,100.00%
addons.firefox.com.cn,6,0.00%,6,0,100.00%
bt.ktrackers.com,6,0.00%,6,0,100.00%
tracker.dler.com,6,0.00%,6,0,100.00%
conn2.oppomobile.com,6,0.00%,6,0,100.00%
sg-feed.r-tb.com,6,0.00%,6,0,100.00%
archive-systems.ethz.ch,6,0.00%,6,0,100.00%
onedriveclucproddm20017.blob.core.windows.net,6,0.00%,6,0,100.00%
puncher.dcdn.n.shifen.com,6,0.00%,6,0,100.00%
ppui-static-pc.cdn.bcebos.com,6,0.00%,6,0,100.00%
cloudtim.msf.tencent-cloud.com,6,0.00%,6,0,100.00%
iosapps.itunes.apple.com.m.alikunlun.net,6,0.00%,6,0,100.00%
orch.isrc.ac.cn,6,0.00%,6,0,100.00%
sf3-fe-tos.pglstatp-toutiao.com.w.cdngslb.com,6,0.00%,7,1,85.71%
img.d1xz.net,6,0.00%,6,0,100.00%
onegoods.nosdn.127.net.w.cdngslb.com,6,0.00%,6,0,100.00%
downloadnonchinacdnenabled.mcafee.com.edgekey.NET,6,0.00%,6,0,100.00%
u966.v.bsgslb.cn,6,0.00%,6,0,100.00%
k128-iosapps-all.gslb.ksyuncdn.com,6,0.00%,6,0,100.00%
onedriveclucprodbn20008.blob.core.windows.net,6,0.00%,6,0,100.00%
gspe1-ssl.ls.apple.com.edgekey.net,6,0.00%,6,0,100.00%
d3-pr-cu-sb-ns-primary.servicebus.windows.net,6,0.00%,6,0,100.00%
shadow.elemecdn.com,6,0.00%,13,7,46.15%
onedriveclucproddm20003.blob.core.windows.net,6,0.00%,6,0,100.00%
x8.xb.client.api.vpngate2.jp,6,0.00%,8,2,75.00%
helpx.adobe.com,6,0.00%,6,0,100.00%
static.tianyaui.com,6,0.00%,6,0,100.00%
frog.wix.com,6,0.00%,6,0,100.00%
blog.tianya.cn,6,0.00%,6,0,100.00%
p213-contacts.icloud.com.cn,6,0.00%,6,0,100.00%
npay.meituan.com,6,0.00%,6,0,100.00%
p212-keyvalueservice.icloud.com.cn,6,0.00%,6,0,100.00%
ggpt.sunlands.com,6,0.00%,6,0,100.00%
outlook.live.com,6,0.00%,14,8,42.86%
tnc11-alisc1.zijieapi.com,6,0.00%,6,0,100.00%
d.f.ip6.arpa,6,0.00%,6,0,100.00%
vulnerability-search.europe-north1-gke.intellij.net,6,0.00%,6,0,100.00%
b.scorecardresearch.com,6,0.00%,6,0,100.00%
uo9aech2.nodedata.net,6,0.00%,6,0,100.00%
down.appol.com,6,0.00%,6,0,100.00%
webadvisorcr3.rest.gti.mcafee.com,6,0.00%,6,0,100.00%
b.cqttech.com,6,0.00%,6,0,100.00%
prod-rel-ffc-ccm.oobesaas.adobe.com,6,0.00%,6,0,100.00%
cl2-cn.apple.com,6,0.00%,6,0,100.00%
slapi-prm.oray.net,6,0.00%,6,0,100.00%
uclient.yonyou.com,6,0.00%,6,0,100.00%
zh.savefrom.net,6,0.00%,6,0,100.00%
65.newspush.eastmoney.com,6,0.00%,6,0,100.00%
youtube-ui.l.google.com,6,0.00%,11,5,54.55%
www.valadygators.com,6,0.00%,6,0,100.00%
ben.kerbertools.xyz,6,0.00%,6,0,100.00%
tracker.4.babico.name.tr,6,0.00%,6,0,100.00%
tn-api-prod-southcentralus.azurewebsites.net,6,0.00%,6,0,100.00%
static-res.qq.com.sched.legopic2.tdnsv6.com,6,0.00%,6,0,100.00%
hcdnv.cbg.c.cdnhwc1.com,6,0.00%,8,2,75.00%
mmbiz.qlogo.cn.tc.qq.com,6,0.00%,6,0,100.00%
ganmin-wrr.qhcdn.com,6,0.00%,6,0,100.00%
qurl.b.qianxin.com,6,0.00%,6,0,100.00%
shortv.cdp.qq.com.cdn.dcloudstc.com,6,0.00%,6,0,100.00%
shortv.cdp.qq.com.svideolego.sched.dcloudstc.com,6,0.00%,6,0,100.00%
c82j9a2q.sched.d0.tdnsdp1.cn,6,0.00%,6,0,100.00%
petropluvialis.apple.com,6,0.00%,6,0,100.00%
ins-tgrfs7t3.ias.tencent-cloud.net,6,0.00%,6,0,100.00%
www.c-s-a.org.cn,6,0.00%,6,0,100.00%
acdn.adnxs.com,6,0.00%,6,0,100.00%
135.205.78.34.bc.googleusercontent.com,6,0.00%,6,0,100.00%
vd4.bdstatic.com,6,0.00%,11,5,54.55%
chat.xboxlive.com,6,0.00%,6,0,100.00%
peoplehub.xboxlive.com,6,0.00%,6,0,100.00%
notificationinbox.xboxlive.com,6,0.00%,6,0,100.00%
m.ctrip.com,6,0.00%,6,0,100.00%
down.xinshuru.com.wscdns.com,6,0.00%,6,0,100.00%
45.newspush.eastmoney.com,6,0.00%,6,0,100.00%
59.newspush.eastmoney.com,6,0.00%,6,0,100.00%
adashx.ut.uc.cn,6,0.00%,6,0,100.00%
s3-1-w.amazonaws.com,6,0.00%,6,0,100.00%
a-ring.a-9999.a-msedge.net,6,0.00%,6,0,100.00%
api.flightproxy.skype.com,6,0.00%,6,0,100.00%
api3-normal-lq.fqnovel.com,6,0.00%,6,0,100.00%
docs2.gtimg.com.sched.legopic2.tdnsv6.com,6,0.00%,6,0,100.00%
p204-caldav.icloud.com.cn,6,0.00%,6,0,100.00%
retracker.coltel.ru,6,0.00%,6,0,100.00%
tracker.ex.ua,6,0.00%,6,0,100.00%
tracker.zum.bi,6,0.00%,6,0,100.00%
datacenter.eastmoney.com,6,0.00%,14,8,42.86%
t.zoukankan.com,6,0.00%,6,0,100.00%
mark.l.qq.com,6,0.00%,6,0,100.00%
id.163.com,6,0.00%,6,0,100.00%
cm.fastapi.net,6,0.00%,6,0,100.00%
api.ithome.com,6,0.00%,6,0,100.00%
amp-api-edge-lb-cn.itunes-apple.com.akadns.net,6,0.00%,11,5,54.55%
cdn.exp.xiaomi.com.mgslb.com,6,0.00%,6,0,100.00%
online-msgacs.m.taobao.com,6,0.00%,6,0,100.00%
kingsoftspark.fg.tlu.download.ks-cdn.com,6,0.00%,6,0,100.00%
h5static.jd.com,6,0.00%,6,0,100.00%
awcas.jd.com,6,0.00%,6,0,100.00%
open.kuaishouzt.com,6,0.00%,6,0,100.00%
a2f3e71d9181a67b.jijifun.com,6,0.00%,6,0,100.00%
assets.activity.windows.com,6,0.00%,6,0,100.00%
miaosha.jd.com,6,0.00%,6,0,100.00%
passport.biligame.com,6,0.00%,6,0,100.00%
passport.shanghaihuanli.com,6,0.00%,6,0,100.00%
prod.mrodevicemgr.live.com.akadns.NET,6,0.00%,12,6,50.00%
onedriveclucprodbn20049.blob.core.windows.net,6,0.00%,6,0,100.00%
s3m7.fenxi.com,6,0.00%,6,0,100.00%
b0.bdstatic.com,6,0.00%,6,0,100.00%
gms.razersynapse.com,6,0.00%,6,0,100.00%
p209-caldav.icloud.com.cn,6,0.00%,6,0,100.00%
news.baidu.com,6,0.00%,6,0,100.00%
mail.sina.com.cn,6,0.00%,6,0,100.00%
wifibbs.ggsafe.com,6,0.00%,6,0,100.00%
stock.eastmoney.com,6,0.00%,14,8,42.86%
hot.browser.miui.com,6,0.00%,6,0,100.00%
api-new.bignox.com,6,0.00%,6,0,100.00%
rangahr6.nodedata.net,6,0.00%,6,0,100.00%
campus.kuaishou.cn,6,0.00%,6,0,100.00%
www2023.thewebconf.org,6,0.00%,6,0,100.00%
p213-caldav.icloud.com.cn,6,0.00%,6,0,100.00%
ossweb-img.qq.com,6,0.00%,6,0,100.00%
top-static.zhan.com,6,0.00%,6,0,100.00%
smobaasst.broker.tplay.qq.com,6,0.00%,6,0,100.00%
free.sinaimg.cn.w.kunlunea.com,6,0.00%,6,0,100.00%
ant.pingan.com.cn,6,0.00%,6,0,100.00%
onedriveclucprodbn20007.blob.core.windows.net,6,0.00%,6,0,100.00%
ai.feishu.cn,6,0.00%,6,0,100.00%
www.zhhbqg.com,6,0.00%,6,0,100.00%
wxa.wxs.qq.com.cloud.tc.qq.com,6,0.00%,6,0,100.00%
wxa.wxs.qq.com.sched.legopic1.tdnsv6.com,6,0.00%,6,0,100.00%
file.market.xiaomi.com,6,0.00%,6,0,100.00%
p19.upd.kaspersky.com,6,0.00%,6,0,100.00%
zh.flightaware.com,6,0.00%,6,0,100.00%
check02.51y5.net,6,0.00%,6,0,100.00%
oauth2.razer.com,6,0.00%,6,0,100.00%
elrepo.org,6,0.00%,6,0,100.00%
newimg.17qiche.com,6,0.00%,6,0,100.00%
tangram-config.gdt.qq.com.cloud.tc.qq.com,6,0.00%,7,1,85.71%
act-api.cloud.tencent.com,6,0.00%,6,0,100.00%
hmcdn.baidu.com.a.jomodns.com,6,0.00%,6,0,100.00%
otbs.azurewebsites.net,6,0.00%,6,0,100.00%
cnlp.lp.cs.quickconnect.cn,6,0.00%,6,0,100.00%
stadig.ifeng.com,6,0.00%,6,0,100.00%
datapipeline.logitech.io,6,0.00%,6,0,100.00%
s8-static.jjwxc.net,6,0.00%,6,0,100.00%
baichuan-sdk.alicdn.com,6,0.00%,6,0,100.00%
gateway.lianjia.com,6,0.00%,6,0,100.00%
scene.ke.com,6,0.00%,6,0,100.00%
www.jhssd.com,6,0.00%,6,0,100.00%
img.zenyou.71360.com,6,0.00%,6,0,100.00%
seq.jd.com,6,0.00%,6,0,100.00%
upos-sz-mirrorhw.bilivideo.com.ctdns.cn,6,0.00%,15,9,40.00%
p217-caldav-china.icloud.com,6,0.00%,12,6,50.00%
codol.qq.com,6,0.00%,6,0,100.00%
im-api-vip6-v2.easecdn.com,6,0.00%,6,0,100.00%
ap5.agora.io,6,0.00%,6,0,100.00%
xcimg.szwego.com,6,0.00%,6,0,100.00%
www.wsxcme.com,6,0.00%,6,0,100.00%
configserver-drcn.platform.hihonorcloud.com,6,0.00%,6,0,100.00%
wp.shanhutech.cn,6,0.00%,6,0,100.00%
vipmail.163.com,6,0.00%,6,0,100.00%
oimagea1.ydstatic.com,6,0.00%,6,0,100.00%
map-mobile-static.cdn.bcebos.com,6,0.00%,6,0,100.00%
map-mobile-opnimg.cdn.bcebos.com,6,0.00%,6,0,100.00%
www.dygang.tv,6,0.00%,6,0,100.00%
t.quandangdang.net,6,0.00%,6,0,100.00%
munchkin.marketo.net,6,0.00%,6,0,100.00%
tts.baidu.com,6,0.00%,6,0,100.00%
r4---sn-j5o7dn7d.gvt1.com,6,0.00%,6,0,100.00%
i-43.b-46206.ut.bench.utorrent.com,6,0.00%,11,5,54.55%
sdkaction.biz.weibo.com,6,0.00%,6,0,100.00%
schemastore.azurewebsites.net,6,0.00%,6,0,100.00%
lnk0.com,6,0.00%,6,0,100.00%
z2.vivian.asia,6,0.00%,6,0,100.00%
passport.zhan.com,6,0.00%,6,0,100.00%
wn-x.jd.com,6,0.00%,6,0,100.00%
mbdp03.bdstatic.com,6,0.00%,6,0,100.00%
h01hxsame.hexun.com,6,0.00%,6,0,100.00%
de.minexmr.com,6,0.00%,6,0,100.00%
msgsearch.skype.com,6,0.00%,6,0,100.00%
www.fanruan.com,6,0.00%,6,0,100.00%
pla-prod-sea-sb-ns-ingest-02.servicebus.windows.net,6,0.00%,6,0,100.00%
slp2p-east-std31.oray.net,6,0.00%,6,0,100.00%
comment.10jqka.com.cn,6,0.00%,6,0,100.00%
simage2.pubmatic.com,6,0.00%,6,0,100.00%
ap.lijit.com,6,0.00%,6,0,100.00%
careers.oppo.com,6,0.00%,6,0,100.00%
onedriveclucproddm20021.blob.core.windows.net,6,0.00%,6,0,100.00%
openadapi.ibreader.com,6,0.00%,6,0,100.00%
azeus1-client-s.gateway.messenger.live.com,5,0.00%,5,0,100.00%
azeus1-client-s.msnmessenger.msn.com.akadns.net,5,0.00%,5,0,100.00%
b-aps-asea-01-skype.cloudapp.net,5,0.00%,5,0,100.00%
dsum-sec.casalemedia.com.cdn.cloudflare.net,5,0.00%,5,0,100.00%
onedscolprdgwc05.germanywestcentral.cloudapp.azure.com,5,0.00%,5,0,100.00%
jscss.360buyimg.com,5,0.00%,6,1,83.33%
h5.360buyimg.com,5,0.00%,13,8,38.46%
cn-zjk-ali-r001.router.teamviewer.cn,5,0.00%,5,0,100.00%
t.vip.com,5,0.00%,5,0,100.00%
tracker.gbitt.info,5,0.00%,396,391,1.26%
home.firefoxchina.cn.wswebpic.com,5,0.00%,5,0,100.00%
news-bos.cdn.bcebos.com,5,0.00%,5,0,100.00%
twct09.graniterapids.com,5,0.00%,5,0,100.00%
bingwallpaper.microsoft.com,5,0.00%,5,0,100.00%
cn6.gmdns.net,5,0.00%,5,0,100.00%
cn12.gmdns.net,5,0.00%,5,0,100.00%
pic.rmb.bdstatic.com.a.bdydns.com,5,0.00%,8,3,62.50%
t10.baidu.com.a.bdydns.com,5,0.00%,10,5,50.00%
pcsdata.baidu.com,5,0.00%,17,12,29.41%
nsp-hicloud-cloudbackupnorth4-p03-drcn.obs.cn-north-4.myhuaweicloud.com,5,0.00%,5,0,100.00%
jgw-drcn.jos.dbankcloud.cn,5,0.00%,5,0,100.00%
80.newspush.eastmoney.com,5,0.00%,5,0,100.00%
api.vps315.com,5,0.00%,10,5,50.00%
pull-hls-hs-f5-tsl.douyincdn.com.yangyi19.com,5,0.00%,5,0,100.00%
pull-tsl-vr-l26.douyincdn.com.51296c5e.c.cdnhwc1.com,5,0.00%,13,8,38.46%
pull-tsl-vr-l6.douyincdn.com.hlsvcloud.ks-cdn.com,5,0.00%,14,9,35.71%
pull-tsl-vr-l11.douyincdn.com.cdn.dnsv1.com,5,0.00%,13,8,38.46%
pull-flv-spe-l1.douyincdn.com.wsdvs.com,5,0.00%,16,11,31.25%
pull-hls-vr-l6.douyincdn.com.hlsvcloud.ks-cdn.com,5,0.00%,13,8,38.46%
pull-tsl-spe-l26.douyincdn.com.51296c5e.c.cdnhwc1.com,5,0.00%,13,8,38.46%
emp-api.baidu.com,5,0.00%,5,0,100.00%
e7248.dscb.akamaiedge.net,5,0.00%,10,5,50.00%
ipcdn-lb.apple.com.akadns.net,5,0.00%,9,4,55.56%
m702.music.126.net,5,0.00%,11,6,45.45%
askubuntu.com,5,0.00%,5,0,100.00%
sjc-direct-bgp.contextweb.com,5,0.00%,5,0,100.00%
alps.51y5.net,5,0.00%,5,0,100.00%
global.sns.cs.quickconnect.to,5,0.00%,5,0,100.00%
dotplayer.coldlake1.com,5,0.00%,10,5,50.00%
dotplayer.coldlake1.com.w.cdngslb.com,5,0.00%,10,5,50.00%
hcdnv.zjtd04.v6.c.cdnhwc1.com,5,0.00%,10,5,50.00%
link.ntes53.netease.com,5,0.00%,5,0,100.00%
pull-flv-l6-source.douyincdn.com.hdlvcloud.ks-cdn.com,5,0.00%,8,3,62.50%
pull-fcdn-douyin-hot1.s.bytefcdn.com,5,0.00%,5,0,100.00%
v3-cold4.douyinvod.com,5,0.00%,5,0,100.00%
feeds.qq.com,5,0.00%,5,0,100.00%
mambap2pvodmobile.8686c.com,5,0.00%,14,9,35.71%
schemastore.org,5,0.00%,5,0,100.00%
um04.eset.com,5,0.00%,5,0,100.00%
um02.eset.com,5,0.00%,5,0,100.00%
um16.eset.com,5,0.00%,5,0,100.00%
um06.eset.com,5,0.00%,5,0,100.00%
um12.eset.com,5,0.00%,5,0,100.00%
toblog.ctobsnssdk.com.bytedns1.com,5,0.00%,5,0,100.00%
s-china.mzstatic.itunes-apple.com.akadns.net,5,0.00%,9,4,55.56%
extranet-alllines-pub-c3-c4.alb.xiaomi.com,5,0.00%,5,0,100.00%
s.jpush.cn,5,0.00%,5,0,100.00%
ssl.look.360.cn,5,0.00%,5,0,100.00%
appportal2.cmy.network,5,0.00%,5,0,100.00%
goldendict.org,5,0.00%,5,0,100.00%
vconf.f.qh-lb.com,5,0.00%,5,0,100.00%
www.skeimg.com,5,0.00%,5,0,100.00%
crl-symcprod.digicert.com,5,0.00%,10,5,50.00%
push-fcdn-base1.s.bytefcdn.com,5,0.00%,5,0,100.00%
pull-flv-f26.douyincdn.com.c.cdnhwc3.com,5,0.00%,9,4,55.56%
pull-tsl-hs-spe-f5.douyincdn.com.230b2a2545cfa773.queniubg.com,5,0.00%,5,0,100.00%
tagr-gcp-lb1-ase1.mookie1.com,5,0.00%,5,0,100.00%
pull-hls-vr-l11.douyincdn.com.tlivecdn.com,5,0.00%,5,0,100.00%
98.push2.eastmoney.com,5,0.00%,10,5,50.00%
gasprice-proxy.herokuapp.com,5,0.00%,5,0,100.00%
oe2203.oepkgs.cn,5,0.00%,5,0,100.00%
hubciddata.sandai.net,5,0.00%,5,0,100.00%
gecko-pangle-hl.snssdk.com,5,0.00%,5,0,100.00%
img9.doubanio.com,5,0.00%,8,3,62.50%
nd-static.bdstatic.com,5,0.00%,5,0,100.00%
webpush.pan.baidu.com,5,0.00%,5,0,100.00%
qd.baidupcs.com,5,0.00%,5,0,100.00%
api.ldmnq.com,5,0.00%,5,0,100.00%
fp-as.azureedge.net,5,0.00%,10,5,50.00%
ccm-frontier-hl.feishu.cn,5,0.00%,5,0,100.00%
vip.asus.com,5,0.00%,5,0,100.00%
hr17.graniterapids.com,5,0.00%,5,0,100.00%
ads-video-al.xhscdn.com,5,0.00%,14,9,35.71%
upgrades.verysync.cn,5,0.00%,9,4,55.56%
test01.alderlake.gay,5,0.00%,5,0,100.00%
security.browser.miui.com,5,0.00%,10,5,50.00%
dblp.org,5,0.00%,5,0,100.00%
pcdn-proxy-config.xxpkg.com,5,0.00%,5,0,100.00%
e751.dscd.akamaiedge.net,5,0.00%,9,4,55.56%
p1.music.126.net.163jiasu.com,5,0.00%,12,7,41.67%
e8652.dscx.akamaiedge.net.0.1.cn.akamaiedge.net,5,0.00%,10,5,50.00%
pdns196.ultradns.org,5,0.00%,16,11,31.25%
play-fe.googleapis.com,5,0.00%,17,12,29.41%
ins-vcomefk6.ias.tencent-cloud.net,5,0.00%,5,0,100.00%
a-9999.a-msedge.net,5,0.00%,5,0,100.00%
download.2.1212338883.wz.gcloudgbs.com,5,0.00%,5,0,100.00%
sync.srv.stackadapt.com,5,0.00%,5,0,100.00%
is2-ssl.mzstatic.com,5,0.00%,5,0,100.00%
eu.pushmeup.art,5,0.00%,5,0,100.00%
cu1pehnswad01.servicebus.windows.net,5,0.00%,5,0,100.00%
analytics.wondershare.cc,5,0.00%,5,0,100.00%
docs.oracle.com,5,0.00%,5,0,100.00%
ios-informationplatform.wps.cn,5,0.00%,5,0,100.00%
lf.snssdk.com,5,0.00%,5,0,100.00%
a1449.dscg2.akamai.net,5,0.00%,10,5,50.00%
dl.bintray.com,5,0.00%,5,0,100.00%
api.natfrp.com,5,0.00%,11,6,45.45%
cmlayer02.debugex.xyz,5,0.00%,5,0,100.00%
init-p01md-lb.push-apple.com.akadns.net,5,0.00%,10,5,50.00%
js2.a.yximgs.com,5,0.00%,12,7,41.67%
e.cn.miaozhen.com,5,0.00%,5,0,100.00%
fp-as-nocache.azureedge.net,5,0.00%,14,9,35.71%
pop-vsh1.www.linkedin.com,5,0.00%,5,0,100.00%
www.91duba.com,5,0.00%,5,0,100.00%
static.dingtalk.com,5,0.00%,12,7,41.67%
localhost.ptlogin2.qq.com,5,0.00%,5,0,100.00%
sg-trc-events.taboola.com,5,0.00%,5,0,100.00%
trc-events.taboola.com,5,0.00%,5,0,100.00%
cdn.pendo.io,5,0.00%,13,8,38.46%
grs.platform.dbankcloud.ru,5,0.00%,5,0,100.00%
download.lenovo.com.akadns.net,5,0.00%,5,0,100.00%
tcws-ipc.mercuryclouds.com.cn,5,0.00%,5,0,100.00%
s1.url.cn.sched.legopic2.tdnsv6.com,5,0.00%,5,0,100.00%
api2.amplitude.com,5,0.00%,5,0,100.00%
imasdk.googleapis.com,5,0.00%,13,8,38.46%
humb.v.aaplimg.com,5,0.00%,5,0,100.00%
appdlcbak-drcn.hispace.hicloud.com,5,0.00%,5,0,100.00%
appdl6-drcn.dbankcdn.80800000.globalsign.c.cdnhwc1.cn,5,0.00%,6,1,83.33%
store-drcn-hispace-dbankcloud-cn-drcn.appacc-region.dbankedge.cn,5,0.00%,5,0,100.00%
appdl-2-drcn.dbankcdn.com.cdn.dnsv1.com,5,0.00%,5,0,100.00%
4pnrexg6.sched.dma.tdnsdl1.cn,5,0.00%,5,0,100.00%
rest-lb-tokyo.gtinative.cloudplatform.mcafee.com,5,0.00%,5,0,100.00%
sdk.open.talk.getui.com,5,0.00%,10,5,50.00%
easytomessage.com,5,0.00%,5,0,100.00%
edith.xiaohongshu.com,5,0.00%,10,5,50.00%
cdn2.ghostery.com,5,0.00%,10,5,50.00%
sigkg.cn,5,0.00%,5,0,100.00%
bookcover.yuewen.com,5,0.00%,10,5,50.00%
cngdcm.debugex.xyz,5,0.00%,5,0,100.00%
twct08.graniterapids.com,5,0.00%,5,0,100.00%
ca03.graniterapids.com,5,0.00%,5,0,100.00%
passport.aliyundrive.com,5,0.00%,10,5,50.00%
onmyoji.pyq.netease.com,5,0.00%,5,0,100.00%
nos.netease.com,5,0.00%,5,0,100.00%
conn3.coloros.com,5,0.00%,5,0,100.00%
title.mgt.xboxlive.com.akadns.net,5,0.00%,10,5,50.00%
xsts.auth.xboxlive.com.akadns.net,5,0.00%,5,0,100.00%
d.url.cn,5,0.00%,10,5,50.00%
sqimg.qq.com.sched.legopic2.tdnsv6.com.tpic.vwnti.yrzhcloud.cn,5,0.00%,5,0,100.00%
fc-ccimage.baidu.com.a.bdydns.com,5,0.00%,5,0,100.00%
mercury-sdk.snssdk.com,5,0.00%,5,0,100.00%
template.dongqiudi.com,5,0.00%,5,0,100.00%
fc-video.cdn.bcebos.com,5,0.00%,5,0,100.00%
baobao.sohu.com,5,0.00%,5,0,100.00%
r6726306.iavs9x.u.avast.com,5,0.00%,10,5,50.00%
f3461309.vps18.u.avcdn.net,5,0.00%,10,5,50.00%
kazooie.canonical.com,5,0.00%,5,0,100.00%
updates.webroot.com,5,0.00%,5,0,100.00%
pvcc01.graniterapids.com,5,0.00%,5,0,100.00%
cloudconsole-pa.clients6.google.com,5,0.00%,10,5,50.00%
repo.idechajian.com,5,0.00%,8,3,62.50%
api.samsungcloudcn.com,5,0.00%,5,0,100.00%
s.wanfangdata.com.cn,5,0.00%,5,0,100.00%
cdn.s.wanfangdata.com.cn,5,0.00%,5,0,100.00%
www.jianshu.com,5,0.00%,11,6,45.45%
ndct-data.video.iqiyi.com,5,0.00%,5,0,100.00%
34.push2.eastmoney.com,5,0.00%,9,4,55.56%
16.newspush.eastmoney.com,5,0.00%,5,0,100.00%
cn4.monolink.net,5,0.00%,5,0,100.00%
udc-service.mathworks.com,5,0.00%,5,0,100.00%
jd-abroad.cdn20.com,5,0.00%,13,8,38.46%
ipv4.gdt.qq.com,5,0.00%,5,0,100.00%
www.myhuiban.com,5,0.00%,5,0,100.00%
rules.quantcount.com,5,0.00%,9,4,55.56%
slp2p-east-std1025.oray.net,5,0.00%,5,0,100.00%
5.newspush.eastmoney.com,5,0.00%,5,0,100.00%
77.push2.eastmoney.com,5,0.00%,10,5,50.00%
9.push2.eastmoney.com,5,0.00%,10,5,50.00%
76.newspush.eastmoney.com,5,0.00%,5,0,100.00%
df.cache.wpscdn.cn.qiniudns.com,5,0.00%,14,9,35.71%
captive.apple.com.edgekey.net,5,0.00%,11,6,45.45%
au01.graniterapids.com,5,0.00%,5,0,100.00%
lws.xuexi.cn,5,0.00%,5,0,100.00%
tnc11-aliec2.zijieapi.com,5,0.00%,5,0,100.00%
storeedgefd.dsx.mp.microsoft.com,5,0.00%,5,0,100.00%
jifen.netease.com,5,0.00%,5,0,100.00%
tuijian.cnki.net,5,0.00%,5,0,100.00%
c.clicktale.net,5,0.00%,5,0,100.00%
k-aus1.clicktale.net,5,0.00%,5,0,100.00%
pluto.sina.cn,5,0.00%,5,0,100.00%
sax.sina.com.cn,5,0.00%,5,0,100.00%
tunion-api.m.taobao.com,5,0.00%,5,0,100.00%
api.6666ppt.com,5,0.00%,5,0,100.00%
officeredir.microsoft.com,5,0.00%,5,0,100.00%
s21.cnzz.com,5,0.00%,5,0,100.00%
pc.push.126.net,5,0.00%,5,0,100.00%
dht.libtorrent.org,5,0.00%,10,5,50.00%
officecdnmac.microsoft.com,5,0.00%,10,5,50.00%
sg05.graniterapids.com,5,0.00%,5,0,100.00%
ru04.ptrecord.com,5,0.00%,5,0,100.00%
in08.graniterapids.com,5,0.00%,5,0,100.00%
dldir1v6.qq.com.legodlied1-dk.sched.dcloudstc.com,5,0.00%,18,13,27.78%
mars.jd.com,5,0.00%,10,5,50.00%
gecko-pangle-lq.snssdk.com,5,0.00%,5,0,100.00%
restapi.amap.com.gds.alibabadns.com,5,0.00%,5,0,100.00%
ssp-sync.criteo.com,5,0.00%,5,0,100.00%
wkbrs1.tingyun.com,5,0.00%,5,0,100.00%
correctxt.baidu.com,5,0.00%,9,4,55.56%
lf1-cdn-tos.bytegoofy.com,5,0.00%,13,8,38.46%
pc-index-static.cdn.bcebos.com,5,0.00%,5,0,100.00%
imgservices-1252317822.image.myqcloud.com,5,0.00%,10,5,50.00%
noah2-1252317822.file.myqcloud.com,5,0.00%,11,6,45.45%
wq.360buyimg.com,5,0.00%,6,1,83.33%
img.nfa.qq.com,5,0.00%,6,1,83.33%
agsupdate.adobe.com,5,0.00%,9,4,55.56%
apac05.azure-devices.net,5,0.00%,5,0,100.00%
web1.china.line.qiniudns.com,5,0.00%,5,0,100.00%
ctlogin.qq.com,5,0.00%,5,0,100.00%
ctlogin3.qq.com,5,0.00%,5,0,100.00%
ctlogin5.qq.com,5,0.00%,5,0,100.00%
paint.ludashi.com,5,0.00%,5,0,100.00%
adss.video.qq.com,5,0.00%,5,0,100.00%
golang.gallerycdn.azure.cn,5,0.00%,5,0,100.00%
e19233.dsca.akamaiedge.net,5,0.00%,9,4,55.56%
phsle5-std01.oray.net,5,0.00%,5,0,100.00%
phfwba-std-g1.oray.net,5,0.00%,5,0,100.00%
www.techweb.com.cn,5,0.00%,5,0,100.00%
videocloud.cn-hangzhou.log.aliyuncs.com,5,0.00%,5,0,100.00%
d35aqihjxzbj2q.cloudfront.cn,5,0.00%,5,0,100.00%
kstjorp.n.shifen.com,5,0.00%,5,0,100.00%
haoqq.browser.qq.com,5,0.00%,5,0,100.00%
sdk-static.mihoyo.com,5,0.00%,5,0,100.00%
api-sdk.mihoyo.com,5,0.00%,5,0,100.00%
0-courier.push.apple.com,5,0.00%,5,0,100.00%
gos-api.gos-gsp.io,5,0.00%,5,0,100.00%
th.pinduoduo.com,5,0.00%,5,0,100.00%
udc.neo4j.org,5,0.00%,5,0,100.00%
ad.360yield.com,5,0.00%,5,0,100.00%
pdf.sciencedirectassets.com,5,0.00%,5,0,100.00%
stock.xueqiu.com,5,0.00%,5,0,100.00%
pc-mon.snssdk.com,5,0.00%,5,0,100.00%
liveupdate5.drivergenius.com,5,0.00%,5,0,100.00%
19.push2.eastmoney.com,5,0.00%,10,5,50.00%
78.newspush.eastmoney.com,5,0.00%,5,0,100.00%
phsle5-adv01.oray.net,5,0.00%,5,0,100.00%
st.music.163.com.w.kunluncan.com,5,0.00%,5,0,100.00%
pdns196.ultradns.info,5,0.00%,11,6,45.45%
csearchc.xuri.sogou.com,5,0.00%,5,0,100.00%
chatlink-yqsx06.netease.im,5,0.00%,5,0,100.00%
worldwide.sogou.com,5,0.00%,5,0,100.00%
pr-bh.ybp.yahoo.com,5,0.00%,11,6,45.45%
msch.f.360.cn,5,0.00%,5,0,100.00%
chatlink-yqsx12.netease.im,5,0.00%,5,0,100.00%
dmp.brand-display.com,5,0.00%,5,0,100.00%
emarketing.sina.com.cn,5,0.00%,5,0,100.00%
help.sina.com.cn,5,0.00%,5,0,100.00%
b.c2r.ts.cdn.office.net,5,0.00%,5,0,100.00%
g1.tagtic.cn,5,0.00%,5,0,100.00%
ad-static-xg.tagtic.cn,5,0.00%,5,0,100.00%
px.ads.linkedin.cn,5,0.00%,5,0,100.00%
swdist.apple.com.akadns.net,5,0.00%,8,3,62.50%
hao0.qhimg.com,5,0.00%,13,8,38.46%
tw01.graniterapids.com,5,0.00%,5,0,100.00%
gw5.push.mcp.weibo.cn,5,0.00%,5,0,100.00%
grs.hihonorcloud.com,5,0.00%,5,0,100.00%
www.mmcs.org.cn,5,0.00%,5,0,100.00%
stat.10jqka.com.cn,5,0.00%,5,0,100.00%
www.hailiangxinxi.com,5,0.00%,5,0,100.00%
hys.people-health.cn,5,0.00%,5,0,100.00%
qr04.cn,5,0.00%,5,0,100.00%
exp.mysmth.net,5,0.00%,5,0,100.00%
dxbans1.ecompany.ae,5,0.00%,5,0,100.00%
auhans2.ecompany.ae,5,0.00%,5,0,100.00%
auhans1.ecompany.ae,5,0.00%,5,0,100.00%
dxbans2.ecompany.ae,5,0.00%,5,0,100.00%
ab55d6d981d3643928ac0cb3847f3848-1432757414.eu-west-1.elb.amazonaws.com,5,0.00%,5,0,100.00%
js.3conline.com.ctadns.cn,5,0.00%,5,0,100.00%
www.pconline.com.cn.ctdns.cn,5,0.00%,5,0,100.00%
webfontsource.yuewen.com,5,0.00%,11,6,45.45%
www.mozilla.org,5,0.00%,5,0,100.00%
microsoftmscompoc.tt.omtrdc.net,5,0.00%,5,0,100.00%
developer.nvidia.com,5,0.00%,5,0,100.00%
ajax.microsoft.com,5,0.00%,5,0,100.00%
onedriveclucproddm20022.blob.core.windows.net,5,0.00%,5,0,100.00%
99.newspush.eastmoney.com,5,0.00%,5,0,100.00%
collect.hupu.com,5,0.00%,5,0,100.00%
bbs.mobileapi.hupu.com,5,0.00%,8,3,62.50%
msgstatic.douyucdn.cn,5,0.00%,6,1,83.33%
dlweb.sogoucdn.com,5,0.00%,5,0,100.00%
op.ssp.qq.com,5,0.00%,10,5,50.00%
firehose.us-east-1.amazonaws.com,5,0.00%,5,0,100.00%
bh.contextweb.com,5,0.00%,5,0,100.00%
cdnfile2.msstatic.com,5,0.00%,5,0,100.00%
f2.video.weibocdn.com,5,0.00%,10,5,50.00%
ip3720517253.funshion.com,5,0.00%,5,0,100.00%
58.push2.eastmoney.com,5,0.00%,9,4,55.56%
53.push2.eastmoney.com,5,0.00%,10,5,50.00%
s4.music.126.net,5,0.00%,5,0,100.00%
encrypted-tbn0.gstatic.com,5,0.00%,14,9,35.71%
web-player-tracker.biliapi.net,5,0.00%,5,0,100.00%
13.newspush.eastmoney.com,5,0.00%,5,0,100.00%
update.utorrent.li,5,0.00%,5,0,100.00%
ca04.graniterapids.com,5,0.00%,5,0,100.00%
upos-sz-staticcos-cmask.bilivideo.com.cdn.dnsv1.com,5,0.00%,12,7,41.67%
985liteu.sched.skalego-dk.tdnsstic1.cn.cjt.vwnti.yrzhcloud.cn,5,0.00%,16,11,31.25%
video-hw-drcn.dbankcdn.globalsign.c.cdnhwc1.cn,5,0.00%,11,6,45.45%
sz-huawei-all.volcgtm.com,5,0.00%,14,9,35.71%
apidns.kwd.inkuai.com,5,0.00%,5,0,100.00%
inappcheck-ak.itunes-apple.com.akadns.net,5,0.00%,5,0,100.00%
mmx-ds.cdn.whatsapp.net,5,0.00%,15,10,33.33%
httpdns1.cc.cdnhwc5.com,5,0.00%,5,0,100.00%
a1158.g.akamai.net,5,0.00%,5,0,100.00%
shell.cdn.office.net,5,0.00%,5,0,100.00%
osiprod-krc-celadon-000.cloudapp.net,5,0.00%,5,0,100.00%
epicgames-download1-1251447533.file.myqcloud.com,5,0.00%,5,0,100.00%
render.alipay.com.danuoyi.tbcache.com,5,0.00%,8,3,62.50%
wns.y.qq.com,5,0.00%,5,0,100.00%
ecma.bdimg.com,5,0.00%,5,0,100.00%
opencdnbdsucaiku.jomodns.com,5,0.00%,6,1,83.33%
www.xinhuanet.com,5,0.00%,11,6,45.45%
fm.ipinyou.com,5,0.00%,5,0,100.00%
dlgzith499dss.cloudfront.net,5,0.00%,5,0,100.00%
shc.y.qq.com,5,0.00%,5,0,100.00%
szu.y.qq.com,5,0.00%,5,0,100.00%
shu.y.qq.com,5,0.00%,5,0,100.00%
isure.stream.qqmusic.qq.com,5,0.00%,10,5,50.00%
mail.iscas.ac.cn,5,0.00%,5,0,100.00%
cstat.apple.com,5,0.00%,9,4,55.56%
cn.cn-0001.cn-msedge.net,5,0.00%,5,0,100.00%
m804.music.126.net.163jiasu.com,5,0.00%,5,0,100.00%
ads.flurry.com,5,0.00%,5,0,100.00%
j.map.baidu.com,5,0.00%,13,8,38.46%
vars.hotjar.com,5,0.00%,5,0,100.00%
proapi.azurewebsites.net,5,0.00%,5,0,100.00%
37.push2.eastmoney.com,5,0.00%,10,5,50.00%
onedriveclucproddm20026.blob.core.windows.net,5,0.00%,5,0,100.00%
onedriveclucprodbn20041.blob.core.windows.net,5,0.00%,5,0,100.00%
75.newspush.eastmoney.com,5,0.00%,5,0,100.00%
lowes.com,5,0.00%,5,0,100.00%
ip1882349061.funshion.com,5,0.00%,5,0,100.00%
udpolimenew.baidu.com,5,0.00%,5,0,100.00%
decisionhub-drcn.emui.dbankcloud.com,5,0.00%,5,0,100.00%
43.newspush.eastmoney.com,5,0.00%,5,0,100.00%
86.newspush.eastmoney.com,5,0.00%,5,0,100.00%
tracker.piratepublic.com,5,0.00%,5,0,100.00%
plus.l.google.com,5,0.00%,6,1,83.33%
i11.hoopchina.com.cn,5,0.00%,10,5,50.00%
p.data.cctv.com,5,0.00%,5,0,100.00%
pic9.iqiyipic.com,5,0.00%,10,5,50.00%
passport.iqiyi.com,5,0.00%,10,5,50.00%
pic4.zhimg.com.a.bdydns.com,5,0.00%,9,4,55.56%
prod.fs.microsoft.com.akadns.net,5,0.00%,5,0,100.00%
cse.google.com,5,0.00%,6,1,83.33%
p1.meituan.net,5,0.00%,10,5,50.00%
lf3-config.bytetcc.com.w.cdngslb.com,5,0.00%,5,0,100.00%
vod.bytedanceapi.com.w.kunluncan.com,5,0.00%,5,0,100.00%
pdata.log.mgtv.com.HOST,5,0.00%,5,0,100.00%
map.sogou.com,5,0.00%,5,0,100.00%
so.csdn.net,5,0.00%,5,0,100.00%
uss.lenovomm.com,5,0.00%,5,0,100.00%
js.intercomcdn.com,5,0.00%,5,0,100.00%
a1943.g2.akamai.net,5,0.00%,5,0,100.00%
userlink.alicdn.com.danuoyi.tbcache.com,5,0.00%,5,0,100.00%
sgp12.graniterapids.com,5,0.00%,5,0,100.00%
e428b87fea828a0a.huaweisafedns.cn,5,0.00%,5,0,100.00%
g1.ctc.cctvcdn.net.lxdns.com,5,0.00%,10,5,50.00%
www.110.com,5,0.00%,5,0,100.00%
wwwbaidu.jomodns.com,5,0.00%,5,0,100.00%
at.alicdn.com.danuoyi.alicdn.com,5,0.00%,12,7,41.67%
relay-6e9f8523.net.anydesk.com,5,0.00%,5,0,100.00%
sgp07.graniterapids.com,5,0.00%,5,0,100.00%
sw.symcb.com,5,0.00%,10,5,50.00%
p207-quota.icloud.com.cn,5,0.00%,5,0,100.00%
www-msn-com.a-0003.a-msedge.net,5,0.00%,9,4,55.56%
7e1w8x45.dayugslb.com,5,0.00%,5,0,100.00%
s3m4.fenxi.com.webcdn.360qhcdn.com,5,0.00%,5,0,100.00%
30.push2.eastmoney.com,5,0.00%,7,2,71.43%
23.push2.eastmoney.com,5,0.00%,8,3,62.50%
63.push2.eastmoney.com,5,0.00%,9,4,55.56%
gslb-pek01.zhihu.com,5,0.00%,8,3,62.50%
img.nga.178.com.a.bdydns.com,5,0.00%,5,0,100.00%
api.share.n.shifen.com,5,0.00%,5,0,100.00%
news.163.com,5,0.00%,17,12,29.41%
p215-contacts.icloud.com.cn,5,0.00%,5,0,100.00%
mini.ffnews.cn,5,0.00%,5,0,100.00%
all.lv2.qnydns.com,5,0.00%,5,0,100.00%
mbdp02.bdstatic.com.a.bdydns.com,5,0.00%,9,4,55.56%
ovv4.alllook.tv.w.cdngslb.com,5,0.00%,5,0,100.00%
s1cp.xyz,5,0.00%,5,0,100.00%
mapsp0.bdimg.com,5,0.00%,9,4,55.56%
analytics.vdo.ai,5,0.00%,5,0,100.00%
s4.vip.wpscdn.cn,5,0.00%,10,5,50.00%
cread.jd.com,5,0.00%,5,0,100.00%
popup.browser.360.cn,5,0.00%,5,0,100.00%
stat.adtchrome.com,5,0.00%,5,0,100.00%
pixel.everesttech.net,5,0.00%,5,0,100.00%
ocsp.certum.pl,5,0.00%,10,5,50.00%
krgame10.graniterapids.com,5,0.00%,5,0,100.00%
twgame08.graniterapids.com,5,0.00%,5,0,100.00%
router.utorrent.com,5,0.00%,10,5,50.00%
cdn.apc.360.cn,5,0.00%,5,0,100.00%
11762090.fls.doubleclick.net,5,0.00%,5,0,100.00%
gs.apple.com.v.aaplimg.com,5,0.00%,5,0,100.00%
www.tm.mc.prd.aadg.akadns.net,5,0.00%,5,0,100.00%
idsync.rlcdn.com,5,0.00%,5,0,100.00%
bakwebrtcpunch.video.qq.com,5,0.00%,5,0,100.00%
m.hexun.com,5,0.00%,5,0,100.00%
www.homeway.com.cn,5,0.00%,5,0,100.00%
g1.hub5pn.sandai.net,5,0.00%,5,0,100.00%
v9.douyinvod.com,5,0.00%,10,5,50.00%
www.zhihu.com.dsa.dnsv1.com,5,0.00%,13,8,38.46%
lb3d.tj.ijinshan.com,5,0.00%,5,0,100.00%
data.flurry.com,5,0.00%,10,5,50.00%
qizhi.hexun.com,5,0.00%,5,0,100.00%
tv.hexun.com,5,0.00%,5,0,100.00%
deepin-wine.i-m.dev,5,0.00%,5,0,100.00%
hr10.graniterapids.com,5,0.00%,5,0,100.00%
yahor.ftp.sh,5,0.00%,5,0,100.00%
v2.iperson.xyz,5,0.00%,5,0,100.00%
transkaroo.joustasie.net,5,0.00%,5,0,100.00%
id.google.com,5,0.00%,6,1,83.33%
dav.jianguoyun.com,5,0.00%,5,0,100.00%
sgp04.graniterapids.com,5,0.00%,5,0,100.00%
p27-contacts.icloud.com,5,0.00%,8,3,62.50%
sg-t.r-tb.net,5,0.00%,10,5,50.00%
imgsa.baidu.com,5,0.00%,8,3,62.50%
www.ludashi.com,5,0.00%,5,0,100.00%
apu.tianxiang.com,5,0.00%,5,0,100.00%
analysis.tianxiang.com,5,0.00%,5,0,100.00%
ib.snssdk.com,5,0.00%,5,0,100.00%
online-msgacs.m.taobao.com.gds.alibabadns.com,5,0.00%,5,0,100.00%
onedriveclucproddm20001.blob.core.windows.net,5,0.00%,5,0,100.00%
97.push2.eastmoney.com,5,0.00%,9,4,55.56%
im-x.jd.com.gslb.qianxun.com,5,0.00%,5,0,100.00%
cs02-pps-drcn.dbankcdn.cn,5,0.00%,5,0,100.00%
onedscolprdjpe03.japaneast.cloudapp.azure.com,5,0.00%,5,0,100.00%
sea.frontdoor.collections.commerce.microsoft.com,5,0.00%,5,0,100.00%
bp.repo.eulix.xyz,5,0.00%,5,0,100.00%
collector-hpn.privacy.ghostery.net,5,0.00%,5,0,100.00%
42.newspush.eastmoney.com,5,0.00%,5,0,100.00%
hls.itunes.apple.com.mwcname.com,5,0.00%,5,0,100.00%
kxp-sru.k10plus.de,5,0.00%,5,0,100.00%
ir01.graniterapids.com,5,0.00%,5,0,100.00%
hr16.graniterapids.com,5,0.00%,5,0,100.00%
reading.snssdk.com,5,0.00%,5,0,100.00%
http-inputs-notion.splunkcloud.com,5,0.00%,5,0,100.00%
aa.google.com,5,0.00%,6,1,83.33%
api.linkquad.net,5,0.00%,5,0,100.00%
o324374.ingest.sentry.io,5,0.00%,5,0,100.00%
widget.intercom.io,5,0.00%,5,0,100.00%
sgp01.graniterapids.com,5,0.00%,5,0,100.00%
tel.hub5p.sandai.net,5,0.00%,5,0,100.00%
www.xmind.cn,5,0.00%,5,0,100.00%
cdn-ffc.oobesaas.adobe.com,5,0.00%,5,0,100.00%
mqtt-internal-public.zhihu.com,5,0.00%,13,8,38.46%
ckdatabase.fe.apple-dns.cn,5,0.00%,5,0,100.00%
ts4.cn.mm.bing.chinacache.net,5,0.00%,5,0,100.00%
crossmark-cdn.crossref.org,5,0.00%,5,0,100.00%
960303.xyz,5,0.00%,5,0,100.00%
astrr.ru,5,0.00%,5,0,100.00%
run-2.publictracker.xyz,5,0.00%,5,0,100.00%
rep-art.ynh.fr,5,0.00%,5,0,100.00%
www.ctcbs.ximalaya.com,5,0.00%,5,0,100.00%
static-cdn.hotjar.com,5,0.00%,5,0,100.00%
su-china.itunes-apple.com.akadns.net,5,0.00%,9,4,55.56%
ifeng3.yylady.cn.w.kunlungr.com,5,0.00%,5,0,100.00%
fixed-187-189-37-179.totalplay.net,5,0.00%,5,0,100.00%
p40-buy.itunes.apple.com,5,0.00%,5,0,100.00%
t1.daumcdn.net,5,0.00%,7,2,71.43%
line3-realtime-api.biligame.net,5,0.00%,5,0,100.00%
line3-realtime-api.biligame.net.dsa.dnsv1.com,5,0.00%,5,0,100.00%
push2his.trafficmanager.cn,5,0.00%,5,0,100.00%
ipv6test.photo.store.qq.com,5,0.00%,12,7,41.67%
517ap08y.sched.d0-dk.tdnsdp1.cn,5,0.00%,15,10,33.33%
24.136.90.149.rev.vodafone.pt,5,0.00%,5,0,100.00%
broadcast.tx.xmcdn.com,5,0.00%,5,0,100.00%
www.01os.cn,5,0.00%,5,0,100.00%
t.bilibili.com,5,0.00%,6,1,83.33%
gslb-dsa-tc.zhihu.com,5,0.00%,10,5,50.00%
e589fa51.zhihu.com.dsa.dnsv1.com,5,0.00%,12,7,41.67%
gecko5-lq.zijieapi.com,5,0.00%,5,0,100.00%
gecko5-lq.zijieapi.com.c.dsa.cdnbuild.net,5,0.00%,5,0,100.00%
clientnotification-userprodscus1-3.servicebus.windows.net,5,0.00%,5,0,100.00%
ip.azwus2-client-s.msnmessenger.msn.com.akadns.net,5,0.00%,5,0,100.00%
apic.douyucdn.cn.w.kunlunar.com,5,0.00%,6,1,83.33%
tracker-2.msm8916.com,5,0.00%,5,0,100.00%
bt.ruxox.ru,5,0.00%,5,0,100.00%
bjk.163.com,5,0.00%,5,0,100.00%
apps.game.qq.com,5,0.00%,5,0,100.00%
ckm.aty.sohu.com,5,0.00%,5,0,100.00%
interface3.music.ntes53.netease.com,5,0.00%,8,3,62.50%
adobecorp.sc.omtrdc.net,5,0.00%,5,0,100.00%
item-soa.jd.com,5,0.00%,5,0,100.00%
68906qf0.sched.dma.tdnsdl1.cn,5,0.00%,5,0,100.00%
mprd-txc-sh-1-7-mercuryclouds-com-cn-1255623871.cos.ap-shanghai.myqcloud.com,5,0.00%,5,0,100.00%
client-api-cdn-cn.itunes-apple.com.akadns.net,5,0.00%,9,4,55.56%
prod-campaignaggregator.omexexternallfb.office.net.akadns.net,5,0.00%,5,0,100.00%
msgacs.m.taobao.com.gds.alibabadns.com,5,0.00%,5,0,100.00%
b-plus.jd.com,5,0.00%,5,0,100.00%
browser2.qhimg.com,5,0.00%,9,4,55.56%
us-or-rly101.zwift.com,5,0.00%,5,0,100.00%
18.push2.eastmoney.com,5,0.00%,9,4,55.56%
r.avlab.qq.com,5,0.00%,5,0,100.00%
tencent-i.work.weixin.qq.com,5,0.00%,5,0,100.00%
api.pinduoduo.com,5,0.00%,5,0,100.00%
cn-jiangsu001.edge.dbankedge.cn,5,0.00%,5,0,100.00%
fr01.graniterapids.com,5,0.00%,5,0,100.00%
acroipm2.adobe.com,5,0.00%,11,6,45.45%
r2---sn-ni5eln7e.gvt1.com,5,0.00%,5,0,100.00%
amp-api.apps.apple.com,5,0.00%,8,3,62.50%
mars.jd.com.gslb.qianxun.com,5,0.00%,10,5,50.00%
baikevideo.cdn.bcebos.com,5,0.00%,6,1,83.33%
mssdk-bu.snssdk.com.w.cdngslb.com,5,0.00%,5,0,100.00%
mime.n.shifen.com,5,0.00%,5,0,100.00%
weread.qq.com,5,0.00%,5,0,100.00%
update.synology.com,5,0.00%,5,0,100.00%
imgcache.qq.com.sched.legopic1.tdnsv6.com,5,0.00%,5,0,100.00%
hk.pool.ntp.org,5,0.00%,5,0,100.00%
jp.pool.ntp.org,5,0.00%,5,0,100.00%
ip2100177549.funshion.com,5,0.00%,5,0,100.00%
meta.pinduoduo.com,5,0.00%,5,0,100.00%
e2682.g.akamaiedge.net,5,0.00%,5,0,100.00%
a18-67.akam.net,5,0.00%,5,0,100.00%
64.push2.eastmoney.com,5,0.00%,9,4,55.56%
bp.conf.f.360.cn,5,0.00%,5,0,100.00%
apd-77d66e805bdd26a5d76effc449f5f6d9.v.smtcdns.com,5,0.00%,5,0,100.00%
upos-sz-mirrorhw.bilivideo.com.mwyzhcdn.com,5,0.00%,6,1,83.33%
onedriveclucprodbn20020.blob.core.windows.net,5,0.00%,5,0,100.00%
fund.eastmoney.com,5,0.00%,13,8,38.46%
ads5-normal-lf.zijieapi.com,5,0.00%,5,0,100.00%
api5-normal-lf.fqnovel.com,5,0.00%,5,0,100.00%
ivy.pcauto.com.cn,5,0.00%,5,0,100.00%
ivy.pcbaby.com.cn,5,0.00%,5,0,100.00%
pwapp.qunar.com,5,0.00%,5,0,100.00%
intf-pc.shanhutech.cn,5,0.00%,5,0,100.00%
err.ifengcloud.ifeng.com,5,0.00%,5,0,100.00%
pdb.5hte21mz.com,5,0.00%,5,0,100.00%
shankapi.ifeng.com,5,0.00%,5,0,100.00%
ip2091219978.funshion.com,5,0.00%,5,0,100.00%
txt.go.sohu.com,5,0.00%,5,0,100.00%
autopatchcn.yuanshen.com,5,0.00%,5,0,100.00%
interest.mix.sina.com.cn,5,0.00%,5,0,100.00%
global.gti.mcafee.akadns.net,5,0.00%,5,0,100.00%
slb-browser-traffic.mbgcdn.lenovo.com.cn,5,0.00%,5,0,100.00%
http.popo.netease.com,5,0.00%,5,0,100.00%
imap.mail.rice.edu,5,0.00%,5,0,100.00%
newmhzxupd1.wmupd.com,5,0.00%,5,0,100.00%
hcdnd.gslb.c.cdnhwc2.com,5,0.00%,5,0,100.00%
cm.browser.qq.com,5,0.00%,5,0,100.00%
analysis.szwego.com,5,0.00%,5,0,100.00%
d2k1ftgv7pobq7.cloudfront.net,5,0.00%,5,0,100.00%
jprp01.admamax.com,5,0.00%,5,0,100.00%
push-gw.zhixi.com,5,0.00%,5,0,100.00%
p3-be-pack-sign.pglstatp-toutiao.com.w.kunluncan.com,5,0.00%,5,0,100.00%
m704.music.126.net,5,0.00%,5,0,100.00%
huichuan-materialcenter-file.oss.aliyuncs.com,5,0.00%,5,0,100.00%
oimageb4.ydstatic.com,5,0.00%,5,0,100.00%
menghuanxinzhuxian-1251008858.file.myqcloud.com,5,0.00%,5,0,100.00%
www.redhat.com,5,0.00%,5,0,100.00%
4e3fbc91775832759f33b21e514bb29c.dlied1.cdntips.net,5,0.00%,5,0,100.00%
0wkoqygn64x5mqz2lwfned1eph2cjx5q.yundunwaf1.com,5,0.00%,5,0,100.00%
sdkclick.biz.weibo.com,5,0.00%,5,0,100.00%
amd-infra.itunes.apple.com,5,0.00%,6,1,83.33%
static.hotcrp.com,5,0.00%,5,0,100.00%
conext22.hotcrp.com,5,0.00%,5,0,100.00%
forum-api-drcn.jos.dbankcloud.cn,5,0.00%,5,0,100.00%
trust.hexun.com,5,0.00%,5,0,100.00%
tousu.sina.com.cn,5,0.00%,5,0,100.00%
shark.dianping.com,5,0.00%,5,0,100.00%
s0.ssl.res.360kuai.com,5,0.00%,5,0,100.00%
s5.ssl.res.360kuai.com,5,0.00%,5,0,100.00%
s4.ssl.res.360kuai.com,5,0.00%,5,0,100.00%
xavatar.imedao.com,5,0.00%,5,0,100.00%
wifi-ad.ggsafe.com,5,0.00%,5,0,100.00%
xml-eu.realtime-bid.com,5,0.00%,5,0,100.00%
statusapi.micloud.xiaomi.net,5,0.00%,5,0,100.00%
d.10jqka.com.cn,5,0.00%,5,0,100.00%
get.skype.com,4,0.00%,4,0,100.00%
prod.msgsearch.trafficmanager.net,4,0.00%,4,0,100.00%
liveget.trafficmanager.net,4,0.00%,4,0,100.00%
people-service-prod.trafficmanager.net,4,0.00%,4,0,100.00%
pull-hls-f26.douyincdn.com.c.cdnhwc1.com,4,0.00%,11,7,36.36%
bigdata.g60.letvlb.com,4,0.00%,4,0,100.00%
www.kuaishou.com,4,0.00%,5,1,80.00%
sns-avatar-qc.xhscdn.com,4,0.00%,15,11,26.67%
ib.anycast.adnxs.com,4,0.00%,4,0,100.00%
hag-drcn.op.hicloud.com,4,0.00%,4,0,100.00%
cart.jd.com,4,0.00%,6,2,66.67%
v1.kwaicdn.com,4,0.00%,10,6,40.00%
vis.vip.com,4,0.00%,4,0,100.00%
www.12377.cn,4,0.00%,10,6,40.00%
alog.iclick.com.cn,4,0.00%,4,0,100.00%
static.firefoxchina.cn,4,0.00%,8,4,50.00%
p0.qhimgs4.com,4,0.00%,4,0,100.00%
home.360game.360.cn,4,0.00%,4,0,100.00%
i3.ytimg.com,4,0.00%,7,3,57.14%
raw.githubusercontent.com,4,0.00%,2031,2027,0.20%
fg.download.windowsupdate.com.mwcname.com,4,0.00%,12,8,33.33%
oneocsp-microsoft-com.a-0003.a-msedge.net,4,0.00%,8,4,50.00%
graph.microsoft.com,4,0.00%,270,266,1.48%
mq.focustodo.net,4,0.00%,4,0,100.00%
onedriveclubprodbn20029.blob.core.windows.net,4,0.00%,4,0,100.00%
tvax3.sinaimg.cn,4,0.00%,245,241,1.63%
bt.mp4ba.com,4,0.00%,17,13,23.53%
gh.bdstatic.com,4,0.00%,4,0,100.00%
download.ffnews.cn,4,0.00%,4,0,100.00%
ip2100177538.funshion.com,4,0.00%,4,0,100.00%
vcode-or.vivo.com.cn,4,0.00%,4,0,100.00%
11.newspush.eastmoney.com,4,0.00%,4,0,100.00%
17.push2.eastmoney.com,4,0.00%,8,4,50.00%
43.push2.eastmoney.com,4,0.00%,6,2,66.67%
73.newspush.eastmoney.com,4,0.00%,4,0,100.00%
pull-flv-f26-proxy.douyincdn.com.c.cdnhwc3.com,4,0.00%,11,7,36.36%
pull-flv-l11-cny.douyincdn.com.tcdnlive.com,4,0.00%,12,8,33.33%
pull-fcdn-douyin-hot2.s.bytefcdn.com,4,0.00%,4,0,100.00%
stocks-edge.news.apple-dns.net,4,0.00%,4,0,100.00%
report.fantuants.com,4,0.00%,4,0,100.00%
mbads.paas.cmbchina.com,4,0.00%,4,0,100.00%
v3-default.365yg.com,4,0.00%,14,10,28.57%
jkcloud.net,4,0.00%,8,4,50.00%
096j513y4u62dz90.aliyunddos1017.com,4,0.00%,4,0,100.00%
cn-hbcd-cu-02-07.bilivideo.com,4,0.00%,4,0,100.00%
launcher-public-service-prod.ak.epicgames.com,4,0.00%,8,4,50.00%
17hs.servyou.com.cn,4,0.00%,4,0,100.00%
pull-fcdn-douyin-base5.s.bytefcdn.com,4,0.00%,4,0,100.00%
push-fcdn-base2.s.bytefcdn.com,4,0.00%,4,0,100.00%
v11-cold1.douyinvod.com,4,0.00%,8,4,50.00%
pull-tsl-spe-l11.douyincdn.com.cdn.dnsv1.com,4,0.00%,10,6,40.00%
v3-cold4.douyinvod.com.w.kunluncan.com,4,0.00%,6,2,66.67%
eihie4vi.nodedata.net,4,0.00%,4,0,100.00%
thu0thei.nodedata.net,4,0.00%,4,0,100.00%
tw02.graniterapids.com,4,0.00%,4,0,100.00%
cn15.gmdns.net,4,0.00%,4,0,100.00%
cn1.gmdns.net,4,0.00%,4,0,100.00%
clientnotification-userprodea1-11.servicebus.windows.net,4,0.00%,4,0,100.00%
c0.wp.com,4,0.00%,4,0,100.00%
clientnotification-userprodcus1-6.servicebus.windows.net,4,0.00%,4,0,100.00%
crush.ntes53.netease.com,4,0.00%,4,0,100.00%
p216-fmf.icloud.com.cn,4,0.00%,4,0,100.00%
metrics.hub.caaws.services,4,0.00%,4,0,100.00%
cinema-pics-drcn.dbankcdn.com,4,0.00%,8,4,50.00%
play4.cp21.ott.cibntv.net,4,0.00%,8,4,50.00%
cdn.ark.qq.com.cloud.tc.qq.com,4,0.00%,4,0,100.00%
cdn.ark.qq.com.sched.legopic1.tdnsv6.com,4,0.00%,4,0,100.00%
cl5.apple.com,4,0.00%,8,4,50.00%
partiality.itunes-apple.com.akadns.net,4,0.00%,8,4,50.00%
um10.eset.com,4,0.00%,4,0,100.00%
mssdk-bu.bytedance.com.w.cdngslb.com,4,0.00%,4,0,100.00%
xlog.jd.com.gslb.qianxun.com,4,0.00%,4,0,100.00%
ad.ntes53.netease.com,4,0.00%,4,0,100.00%
up.f.360.cn,4,0.00%,4,0,100.00%
daodian.vip.meituan.com,4,0.00%,4,0,100.00%
v5-coldb.douyinvod.com,4,0.00%,4,0,100.00%
busuanzi.ibruce.info,4,0.00%,4,0,100.00%
ip1865110026.funshion.com,4,0.00%,4,0,100.00%
link.springer.com,4,0.00%,4,0,100.00%
vip24-ws-tls.jsssline.top,4,0.00%,4,0,100.00%
report.banyunjuhe.com,4,0.00%,4,0,100.00%
api.banyunjuhe.com,4,0.00%,4,0,100.00%
ad.foxitreader.cn,4,0.00%,4,0,100.00%
globe-request.foxitservice.com,4,0.00%,4,0,100.00%
www.gov.cn,4,0.00%,8,4,50.00%
www.baomi.org.cn,4,0.00%,4,0,100.00%
www.nsstec.org.cn,4,0.00%,4,0,100.00%
app.market.xiaomi.com,4,0.00%,9,5,44.44%
wifiapi.micloud.xiaomi.net,4,0.00%,4,0,100.00%
tracker.openzim.org,4,0.00%,184,180,2.17%
26.push2.eastmoney.com,4,0.00%,7,3,57.14%
85.push2.eastmoney.com,4,0.00%,7,3,57.14%
73.push2.eastmoney.com,4,0.00%,8,4,50.00%
manga.bilibili.com,4,0.00%,4,0,100.00%
res-scanner.zhhainiao.com,4,0.00%,8,4,50.00%
moiawsorigin.clo.footprintdns.com,4,0.00%,4,0,100.00%
spt.service.kugou.com,4,0.00%,4,0,100.00%
m.douban.com,4,0.00%,4,0,100.00%
fundin.douban.com,4,0.00%,4,0,100.00%
dl.acm.org,4,0.00%,4,0,100.00%
rb122n.jomodns.com,4,0.00%,4,0,100.00%
yuanshen.xin,4,0.00%,4,0,100.00%
inference-location-southeastasia.southeastasia.cloudapp.azure.com,4,0.00%,4,0,100.00%
kv601.prod.do.dsp.mp.microsoft.com.edgekey.net,4,0.00%,4,0,100.00%
hkt.rexinshimin.xyz,4,0.00%,4,0,100.00%
apac-tw-khh-04-edgecast-v1.qdns.live,4,0.00%,4,0,100.00%
search.maven.org,4,0.00%,4,0,100.00%
weu013-breeziest-in.cloudapp.net,4,0.00%,4,0,100.00%
cc.f.360.cn,4,0.00%,4,0,100.00%
pdf.update.wps.cn,4,0.00%,4,0,100.00%
www.sinfors.com,4,0.00%,4,0,100.00%
p4.music.126.net.163jiasu.com,4,0.00%,9,5,44.44%
p3.music.126.net.w.alikunlun.com,4,0.00%,8,4,50.00%
p9.itc.cn,4,0.00%,8,4,50.00%
img2.kwcdn.kuwo.cn,4,0.00%,11,7,36.36%
e8091.a.akamaiedge.net,4,0.00%,4,0,100.00%
api-learn-progress.kaikeba.com,4,0.00%,4,0,100.00%
play-lh.googleusercontent.com,4,0.00%,13,9,30.77%
default.sdkconfig.ad.xiaomi.com,4,0.00%,4,0,100.00%
v6-x.douyinvod.com,4,0.00%,10,6,40.00%
exp-picture.cdn.bcebos.com,4,0.00%,10,6,40.00%
find.api.micloud.xiaomi.net,4,0.00%,4,0,100.00%
report-stats.ad.jiguang.cn,4,0.00%,4,0,100.00%
is5-ssl.mzstatic.com,4,0.00%,4,0,100.00%
p209-imap.mail.icloud.com.cn,4,0.00%,4,0,100.00%
e10370.d.akamaiedge.net,4,0.00%,4,0,100.00%
pkm-01.huohuacdn.com,4,0.00%,4,0,100.00%
static.wywyx.com,4,0.00%,4,0,100.00%
hao7.qhimg.com,4,0.00%,6,2,66.67%
kikyo-rest.app.kdsec.org,4,0.00%,4,0,100.00%
search3-search-hl.toutiaoapi.com,4,0.00%,4,0,100.00%
api-drcn.music.dbankcloud.cn,4,0.00%,4,0,100.00%
tmge.alicdn.com,4,0.00%,4,0,100.00%
tmge.alicdn.com.danuoyi.tbcache.com,4,0.00%,4,0,100.00%
typora.io,4,0.00%,9,5,44.44%
v5-i.douyinvod.com.zjgslb.com,4,0.00%,4,0,100.00%
collections.mp.microsoft.com,4,0.00%,4,0,100.00%
vmss-prod-weu.westeurope.cloudapp.azure.com,4,0.00%,4,0,100.00%
trace.rtbasia.com,4,0.00%,4,0,100.00%
www.facebook.com,4,0.00%,14,10,28.57%
ads-bid.l.doubleclick.net,4,0.00%,4,0,100.00%
bid.g.doubleclick.net,4,0.00%,4,0,100.00%
cookie-matching.mediarithmics.com,4,0.00%,4,0,100.00%
mon.snssdk.com.dsa.dnsv1.com,4,0.00%,4,0,100.00%
sdfestaticassets-us-east-1.sciencedirectassets.com,4,0.00%,4,0,100.00%
se2-cdn.itunes-apple.com.akadns.net,4,0.00%,7,3,57.14%
onedriveclucproddm20005.blob.core.windows.net,4,0.00%,4,0,100.00%
pendo-static-5661679399600128.storage.googleapis.com,4,0.00%,8,4,50.00%
www.strava.com,4,0.00%,6,2,66.67%
mini.360.cn.webcdn.360qhcdn.com,4,0.00%,7,3,57.14%
camo.githubusercontent.com,4,0.00%,4,0,100.00%
hcdnw.gslb.ipv6.c.cdnhwc2.com,4,0.00%,5,1,80.00%
api.cloud.hicloud.com,4,0.00%,4,0,100.00%
vectormap0.bdimg.com,4,0.00%,6,2,66.67%
partner46.googleadservices.com,4,0.00%,4,0,100.00%
wa.qq.com.sched.legopic2-dk.tdnsv6.com,4,0.00%,8,4,50.00%
tnc3-aliec2.zijieapi.com,4,0.00%,4,0,100.00%
configdownload.dbankcdn.cn.c.cdnhwc1.com,4,0.00%,4,0,100.00%
mcaldav.mail.163.com,4,0.00%,4,0,100.00%
api.qrserver.com,4,0.00%,4,0,100.00%
pns.alicdn.com,4,0.00%,4,0,100.00%
init.ess.apple.com.edgesuite.net,4,0.00%,4,0,100.00%
pixel-origin.mathtag.com,4,0.00%,4,0,100.00%
wsall.maxhub.vip.wswebcdn.com,4,0.00%,4,0,100.00%
e2c53.gcp.gvt2.com,4,0.00%,4,0,100.00%
sf6-cdn-tos.douyinstatic.com,4,0.00%,9,5,44.44%
bttrack.com,4,0.00%,4,0,100.00%
vipauth.hpplay.cn,4,0.00%,4,0,100.00%
rc10-fc12.oray.com,4,0.00%,4,0,100.00%
tw06.graniterapids.com,4,0.00%,4,0,100.00%
ir04.graniterapids.com,4,0.00%,4,0,100.00%
fullscreen-detail.alicdn.com,4,0.00%,10,6,40.00%
hybrid.miniapp.taobao.com,4,0.00%,4,0,100.00%
ip1880706121.funshion.com,4,0.00%,4,0,100.00%
ip3746756449.funshion.com,4,0.00%,4,0,100.00%
druidv6.if.qidian.com,4,0.00%,8,4,50.00%
bossaudioandcomic-1252317822.image.myqcloud.com,4,0.00%,8,4,50.00%
qdstatic-1252317822.file.myqcloud.com,4,0.00%,8,4,50.00%
public-1252317822.image.myqcloud.com,4,0.00%,8,4,50.00%
qdreaderpic-1252317822.file.myqcloud.com,4,0.00%,8,4,50.00%
us05web.zoom.us,4,0.00%,4,0,100.00%
gateway.facebook.com,4,0.00%,8,4,50.00%
sd.cname6.getui.com,4,0.00%,4,0,100.00%
lf1-cdn-tos.bytescm.com,4,0.00%,7,3,57.14%
lf1-cdn-tos.bytescm.com.wsglb0.com,4,0.00%,7,3,57.14%
p58-buy.itunes.apple.com,4,0.00%,4,0,100.00%
api.plu.mx,4,0.00%,4,0,100.00%
docker.dovov.com,4,0.00%,4,0,100.00%
user.auth.xboxlive.com.akadns.net,4,0.00%,4,0,100.00%
scdown.tcdn.qq.com,4,0.00%,4,0,100.00%
e-0012.e-msedge.net,4,0.00%,4,0,100.00%
partners.tremorhub.com,4,0.00%,8,4,50.00%
img.galaxyappstore.com,4,0.00%,4,0,100.00%
krsk08.graniterapids.com,4,0.00%,4,0,100.00%
udpolimeok.n.shifen.com,4,0.00%,4,0,100.00%
e2c45.gcp.gvt2.com,4,0.00%,4,0,100.00%
api.twitter.com,4,0.00%,8,4,50.00%
p39-buy.itunes-apple.com.akadns.net,4,0.00%,4,0,100.00%
v6-be-pack.pglstatp-toutiao.com,4,0.00%,8,4,50.00%
n4291289.iavs9x.u.avast.com,4,0.00%,8,4,50.00%
r9319236.vps18.u.avcdn.net,4,0.00%,8,4,50.00%
h4305360.vps18.u.avcdn.net,4,0.00%,8,4,50.00%
g1928587.iavs9x.u.avast.com,4,0.00%,8,4,50.00%
w5805295.iavs9x.u.avast.com,4,0.00%,8,4,50.00%
router.uu.163.com,4,0.00%,4,0,100.00%
e1329.g.akamaiedge.net,4,0.00%,4,0,100.00%
t.kaiji.2345.com,4,0.00%,4,0,100.00%
wvcfg.alicdn.com,4,0.00%,8,4,50.00%
logserver-cn-ty.obs.cn-north1.ctyun.cn,4,0.00%,4,0,100.00%
live-im.blued.cn,4,0.00%,4,0,100.00%
blued.irisdt.cn,4,0.00%,4,0,100.00%
appoptimize-drcn.dbankcdn.com,4,0.00%,4,0,100.00%
idm.iot.mi.com,4,0.00%,4,0,100.00%
connectivity.samsung.com.cn,4,0.00%,4,0,100.00%
cdn.wanfangdata.com.cn,4,0.00%,4,0,100.00%
cdn.w.wanfangdata.com.cn,4,0.00%,4,0,100.00%
api.wf.pub,4,0.00%,4,0,100.00%
img.wf.pub,4,0.00%,4,0,100.00%
activity.hdslb.com.w.kunlungr.com,4,0.00%,4,0,100.00%
nowcoder.cn-hangzhou.log.aliyuncs.com,4,0.00%,4,0,100.00%
33.newspush.eastmoney.com,4,0.00%,4,0,100.00%
api.bspapp.com,4,0.00%,4,0,100.00%
open.ys7.com,4,0.00%,4,0,100.00%
dsany2.sgnic.sg,4,0.00%,12,8,33.33%
dsany.sgnic.sg,4,0.00%,12,8,33.33%
dsany3.sgnic.sg,4,0.00%,12,8,33.33%
login.incites.clarivate.com,4,0.00%,4,0,100.00%
logs.game.qq.com,4,0.00%,4,0,100.00%
16.push2.eastmoney.com,4,0.00%,7,3,57.14%
api.webroot.com,4,0.00%,4,0,100.00%
s73.cnzz.com,4,0.00%,4,0,100.00%
tools.jb51.net,4,0.00%,4,0,100.00%
udiab1.jianshu.com,4,0.00%,4,0,100.00%
spynet2.microsoft.com,4,0.00%,4,0,100.00%
addonlist.sync.maxthon.cn,4,0.00%,4,0,100.00%
sz-spring-img.volcgtm.com,4,0.00%,11,7,36.36%
static.leetcode.cn.w.cdngslb.com,4,0.00%,4,0,100.00%
xacu07.baidupcs.com,4,0.00%,4,0,100.00%
open.tingjiandan.com,4,0.00%,4,0,100.00%
www.duku.cn,4,0.00%,8,4,50.00%
pic.leetcode-cn.com.w.kunlungr.com,4,0.00%,4,0,100.00%
csm.sg1.as.criteo.net,4,0.00%,4,0,100.00%
appktavsiei5995.pc.xiaoe-tech.com,4,0.00%,4,0,100.00%
mg.yrqwnc.cn,4,0.00%,4,0,100.00%
pic.wujinpp.com,4,0.00%,4,0,100.00%
api2.branch.io,4,0.00%,7,3,57.14%
vkceyugu.cdn.bspapp.com,4,0.00%,4,0,100.00%
lf26-cdn-tos.bytecdntp.com,4,0.00%,4,0,100.00%
v.qisaoba.com,4,0.00%,4,0,100.00%
s1.zoubuting.com,4,0.00%,4,0,100.00%
yys.v.netease.com,4,0.00%,4,0,100.00%
service-cdn.qiqiuyun.net,4,0.00%,4,0,100.00%
ese3a9b6c5d0ic-pub.pubssl.qiqiuyun.net,4,0.00%,8,4,50.00%
79.push2.eastmoney.com,4,0.00%,8,4,50.00%
45.push2.eastmoney.com,4,0.00%,8,4,50.00%
utyupdate.synology.com,4,0.00%,4,0,100.00%
utyautoupdate.synology.cn,4,0.00%,4,0,100.00%
login.microsoft.com,4,0.00%,4,0,100.00%
public-family.api.account.microsoft.com,4,0.00%,4,0,100.00%
chinaweb119.china.line.qiniudns.com,4,0.00%,12,8,33.33%
captive-cidr.origin-apple.com.akadns.net,4,0.00%,34,30,11.76%
l9518228.iavs9x.avg.u.avcdn.net,4,0.00%,8,4,50.00%
y7637820.iavs9x.avg.u.avcdn.net,4,0.00%,8,4,50.00%
b0017156.avi18.u.avcdn.net,4,0.00%,8,4,50.00%
knicks.jd.com.gslb.qianxun.com,4,0.00%,10,6,40.00%
f3.video.weibocdn.com,4,0.00%,8,4,50.00%
a1.espncdn.com,4,0.00%,4,0,100.00%
down.znyshurufa.com,4,0.00%,4,0,100.00%
grow.nowcoder.com,4,0.00%,4,0,100.00%
login.cnki.net,4,0.00%,4,0,100.00%
docdown.cnki.net,4,0.00%,4,0,100.00%
liveupdate01s.asus.com.cn.cdnudns.com,4,0.00%,4,0,100.00%
75.push2.eastmoney.com,4,0.00%,7,3,57.14%
99.push2.eastmoney.com,4,0.00%,8,4,50.00%
69.push2.eastmoney.com,4,0.00%,7,3,57.14%
6.newspush.eastmoney.com,4,0.00%,4,0,100.00%
hg02.ptrecord.com,4,0.00%,4,0,100.00%
wkretype.bdimg.com,4,0.00%,12,8,33.33%
wkstatic.bdimg.com,4,0.00%,12,8,33.33%
q-aus1.clicktale.net,4,0.00%,4,0,100.00%
ip.leju.com,4,0.00%,4,0,100.00%
api.tdp.u7u9.com,4,0.00%,4,0,100.00%
fav.mix.sina.com.cn,4,0.00%,4,0,100.00%
stats.grafana.org,4,0.00%,4,0,100.00%
v20.vortex-win.data.microsoft.com,4,0.00%,4,0,100.00%
stat.centbrowser.cn,4,0.00%,4,0,100.00%
web.vortex.data.microsoft.com,4,0.00%,4,0,100.00%
oimagec8.ydstatic.com,4,0.00%,4,0,100.00%
news.sohu.com,4,0.00%,6,2,66.67%
sso.ptlogin2.qq.com,4,0.00%,4,0,100.00%
imap.googlemail.com,4,0.00%,8,4,50.00%
onedriveclucproddm20006.blob.core.windows.net,4,0.00%,4,0,100.00%
hkgame06.graniterapids.com,4,0.00%,4,0,100.00%
sg07.graniterapids.com,4,0.00%,4,0,100.00%
hkt04.graniterapids.com,4,0.00%,4,0,100.00%
gspe79-ssl.ls.apple.com,4,0.00%,12,8,33.33%
hmma.baidu.com,4,0.00%,13,9,30.77%
cschlosser.gallerycdn.azure.cn,4,0.00%,4,0,100.00%
jeff-hykin.gallerycdn.azure.cn,4,0.00%,4,0,100.00%
twxs.gallerycdn.azure.cn,4,0.00%,4,0,100.00%
davidanson.gallerycdn.azure.cn,4,0.00%,4,0,100.00%
r3---sn-ni5een7e.gvt1.com,4,0.00%,4,0,100.00%
cdn.heapanalytics.com,4,0.00%,4,0,100.00%
api.webtest.net,4,0.00%,4,0,100.00%
ccc-x.jd.com,4,0.00%,4,0,100.00%
ip2072148257.funshion.com,4,0.00%,4,0,100.00%
basic-enroll.ccs.mcafee.com,4,0.00%,4,0,100.00%
pixel-sync.sitescout.com,4,0.00%,4,0,100.00%
stream41.forexpros.com,4,0.00%,4,0,100.00%
update7.synology.com,4,0.00%,4,0,100.00%
rr.office.microsoft.com,4,0.00%,4,0,100.00%
flowvip.wps.cn,4,0.00%,4,0,100.00%
fanyiapp.cdn.bcebos.com,4,0.00%,6,2,66.67%
firestore.googleapis.com,4,0.00%,7,3,57.14%
uedas.qidian.com,4,0.00%,4,0,100.00%
cpt.9136.com,4,0.00%,4,0,100.00%
ex.m.jd.com,4,0.00%,8,4,50.00%
jpushsc.m.jd.com,4,0.00%,4,0,100.00%
imgcps.jd.com,4,0.00%,4,0,100.00%
analytics.map.qq.com,4,0.00%,4,0,100.00%
m.stripe.com,4,0.00%,4,0,100.00%
qmas.xueqiu.com,4,0.00%,4,0,100.00%
music.baidu.com,4,0.00%,4,0,100.00%
www.itrust.org.cn,4,0.00%,4,0,100.00%
p216-contacts.icloud.com.cn,4,0.00%,4,0,100.00%
wdl1.file.cache.wpscdn.cn,4,0.00%,7,3,57.14%
ctlogin4.qq.com,4,0.00%,4,0,100.00%
sub2.bgp.netarch-aliec2-edge-lb.l.bytedns.net,4,0.00%,4,0,100.00%
structured-data.qq.com,4,0.00%,4,0,100.00%
f816mtichs2n08nq70sr8ak29cotl5tk5ub720qskun3h73jn4kvuibf.qc.x.bsgslb.cn,4,0.00%,4,0,100.00%
e2c11.gcp.gvt2.com,4,0.00%,4,0,100.00%
thor.weidian.com,4,0.00%,4,0,100.00%
sso.weidian.com,4,0.00%,4,0,100.00%
read.qidian.com,4,0.00%,9,5,44.44%
vimg-1251882982.cos.ap-beijing.myqcloud.com,4,0.00%,4,0,100.00%
v.geilicdn.com,4,0.00%,4,0,100.00%
init-p01md.apple.com,4,0.00%,8,4,50.00%
api-vod.baoshiyun.com,4,0.00%,4,0,100.00%
api.df.mob.com,4,0.00%,4,0,100.00%
tls10.newrelic.com.cdn.cloudflare.NET,4,0.00%,4,0,100.00%
api-eu.mixpanel.com,4,0.00%,4,0,100.00%
os-mon.snssdk.com,4,0.00%,4,0,100.00%
member-oss-cdn.topsports.com.cn,4,0.00%,4,0,100.00%
mobads.baidu.com,4,0.00%,4,0,100.00%
cn-auth2.samsungosp.com.cn,4,0.00%,4,0,100.00%
p208-fmfmobile.icloud.com.cn,4,0.00%,4,0,100.00%
api.juhedx.com,4,0.00%,4,0,100.00%
ymapi.haokunwangluokj.cn,4,0.00%,4,0,100.00%
img.go.mail.ru,4,0.00%,4,0,100.00%
pushmis.cdn.bcebos.com,4,0.00%,4,0,100.00%
search.video.iqiyi.com,4,0.00%,4,0,100.00%
vinfo.vip.iqiyi.com,4,0.00%,4,0,100.00%
helpdaohang1.ksmobile.com,4,0.00%,4,0,100.00%
12306.ie.sogou.com,4,0.00%,4,0,100.00%
athena.ie.sogou.com,4,0.00%,4,0,100.00%
mmres-sslauth.mingchuanxx.com,4,0.00%,4,0,100.00%
onedriveclucprodbn20023.blob.core.windows.net,4,0.00%,4,0,100.00%
sync.1rx.io,4,0.00%,4,0,100.00%
phsle5-std04.oray.net,4,0.00%,4,0,100.00%
jp02.graniterapids.com,4,0.00%,4,0,100.00%
maMbaP2pvOdh5.8686C.coM,4,0.00%,4,0,100.00%
img-s.msn.cn,4,0.00%,9,5,44.44%
www.jb51.net,4,0.00%,4,0,100.00%
b2b.lenovo.com.cn,4,0.00%,4,0,100.00%
fereport.qidian.qq.com,4,0.00%,4,0,100.00%
24.push2.eastmoney.com,4,0.00%,7,3,57.14%
fsandroid.hw.kugou.com,4,0.00%,10,6,40.00%
www.tm.ak.prd.aadg.trafficmanager.NET,4,0.00%,4,0,100.00%
detectportal.prod.mozaws.NET,4,0.00%,6,2,66.67%
chatlink-yqsx07.netease.im,4,0.00%,4,0,100.00%
e17513.dscd.akamaiedge.net,4,0.00%,8,4,50.00%
cm-supply-web.gammaplatform.com,4,0.00%,4,0,100.00%
dldir1.legodlied1.sched.dcloudstc.com,4,0.00%,4,0,100.00%
kr05.graniterapids.com,4,0.00%,4,0,100.00%
s3plus.meituan.net,4,0.00%,9,5,44.44%
qmac.f.360.cn,4,0.00%,4,0,100.00%
slide.ent.sina.com.cn,4,0.00%,4,0,100.00%
interaction.kaikeba.com,4,0.00%,4,0,100.00%
xueqiu.glsc.com.cn,4,0.00%,4,0,100.00%
wss.dida365.com,4,0.00%,4,0,100.00%
phsle5-std05.oray.net,4,0.00%,4,0,100.00%
ssl.adobe.com.edgekey.net,4,0.00%,8,4,50.00%
china4-lb.itunes-apple.com.akadns.net,4,0.00%,6,2,66.67%
telecommandsvcfabricv4.westus2.cloudapp.azure.com,4,0.00%,4,0,100.00%
api.dhrest.com,4,0.00%,4,0,100.00%
ip-97-74-92-195.ip.secureserver.net,4,0.00%,4,0,100.00%
bbs.cipsup.cn,4,0.00%,4,0,100.00%
dig-ec.bdurl.net,4,0.00%,4,0,100.00%
sus.lex.lenovo.com.cn,4,0.00%,4,0,100.00%
e2c31.gcp.gvt2.com,4,0.00%,4,0,100.00%
metric.huya.com,4,0.00%,4,0,100.00%
packages.unity.com,4,0.00%,4,0,100.00%
www.301hospital.com.cn,4,0.00%,4,0,100.00%
pic.ikafan.com,4,0.00%,4,0,100.00%
rss.neosmart.net,4,0.00%,8,4,50.00%
ckgroups.xyz,4,0.00%,4,0,100.00%
rtb-csync-apac1.smartadserver.com,4,0.00%,4,0,100.00%
34.newspush.eastmoney.com,4,0.00%,4,0,100.00%
36.push2.eastmoney.com,4,0.00%,6,2,66.67%
fspc.hw.kugou.com,4,0.00%,7,3,57.14%
ivy.pconline.com.cn.dnsgtm.com,4,0.00%,4,0,100.00%
qdfront.pcauto.com.cn,4,0.00%,4,0,100.00%
countad.pconline.com.cn,4,0.00%,4,0,100.00%
refhub.elsevier.com,4,0.00%,4,0,100.00%
www.reddit.com,4,0.00%,6,2,66.67%
twitter.com,4,0.00%,6,2,66.67%
mscom.demdex.net,4,0.00%,4,0,100.00%
geoip.svc.nvidia.com,4,0.00%,4,0,100.00%
www.appinn.com,4,0.00%,4,0,100.00%
xne1ocient87zxz.360doc.cn,4,0.00%,4,0,100.00%
conf.qvb.qcloud.com,4,0.00%,4,0,100.00%
scala.jfrog.io,4,0.00%,4,0,100.00%
pool.admedo.com,4,0.00%,4,0,100.00%
hkgame01.graniterapids.com,4,0.00%,4,0,100.00%
w1.hoopchina.com.cn,4,0.00%,8,4,50.00%
b1.hoopchina.com.cn,4,0.00%,4,0,100.00%
i2.hoopchina.com.cn,4,0.00%,8,4,50.00%
t1.hoopchina.com.cn,4,0.00%,4,0,100.00%
i4.hoopchina.com.cn,4,0.00%,8,4,50.00%
my.hupu.com,4,0.00%,4,0,100.00%
cc-api-behance.adobe.io,4,0.00%,4,0,100.00%
geo2.adobe.com,4,0.00%,8,4,50.00%
ia.51.la,4,0.00%,4,0,100.00%
pslice.douyucdn.cn,4,0.00%,4,0,100.00%
g.wan.douyu.com,4,0.00%,4,0,100.00%
dotab.douyucdn.cn,4,0.00%,4,0,100.00%
tags.tiqcdn.cn,4,0.00%,4,0,100.00%
3773406.fls.doubleclick.net,4,0.00%,4,0,100.00%
cd001.www.duba.net,4,0.00%,4,0,100.00%
www.wifigx.com,4,0.00%,4,0,100.00%
vdgif.bdstatic.com,4,0.00%,4,0,100.00%
dgvip.ijinshan.com,4,0.00%,4,0,100.00%
hky-sdk.kaikeba.com,4,0.00%,4,0,100.00%
dh1.cmcmcdn.com,4,0.00%,4,0,100.00%
file.mydrivers.com,4,0.00%,4,0,100.00%
pdf.duba.com,4,0.00%,4,0,100.00%
ppt.dasuancai.com,4,0.00%,4,0,100.00%
p.ssp.qq.com,4,0.00%,11,7,36.36%
xz.sogou.com,4,0.00%,4,0,100.00%
a4-67.akam.net,4,0.00%,4,0,100.00%
ai.52learn.online,4,0.00%,4,0,100.00%
console-api.apipost.cn,4,0.00%,4,0,100.00%
bottle.laohu.com,4,0.00%,4,0,100.00%
s3.music.126.net,4,0.00%,7,3,57.14%
ali-web-player-tracker.biliapi.net,4,0.00%,4,0,100.00%
update.bittorrent.com,4,0.00%,8,4,50.00%
llsw.download3.utorrent.com,4,0.00%,7,3,57.14%
krsk09.graniterapids.com,4,0.00%,4,0,100.00%
emoji.qpic.tc.qq.com,4,0.00%,4,0,100.00%
tw04.graniterapids.com,4,0.00%,4,0,100.00%
jp22.graniterapids.com,4,0.00%,4,0,100.00%
hwid-drcn-platform-hicloud-com-drcn.appacc-region.dbankedge.net,4,0.00%,4,0,100.00%
application.ieeecomputer.org,4,0.00%,4,0,100.00%
key1.computer.org,4,0.00%,4,0,100.00%
ir02.graniterapids.com,4,0.00%,4,0,100.00%
twct05.graniterapids.com,4,0.00%,4,0,100.00%
hiai-mars-drcn.emui.hicloud.com,4,0.00%,4,0,100.00%
flow.lavasoft.com,4,0.00%,12,8,33.33%
aistudio-fe-online.cdn.bcebos.com,4,0.00%,6,2,66.67%
qring-tms.qq.com,4,0.00%,4,0,100.00%
ns4-64.akam.net,4,0.00%,4,0,100.00%
qqshow-ufs.tencent.com,4,0.00%,4,0,100.00%
nur.hupu.com,4,0.00%,4,0,100.00%
image.wjx.cn,4,0.00%,4,0,100.00%
mesu.g.aaplimg.com,4,0.00%,9,5,44.44%
a.privatelink.msidentity.com,4,0.00%,4,0,100.00%
api-glb-apne1d.smoot.apple.com,4,0.00%,4,0,100.00%
tracert.alipay.com,4,0.00%,6,2,66.67%
tracert.alipay.com.danuoyi.alicdn.com,4,0.00%,6,2,66.67%
j2.fund.eastmoney.com,4,0.00%,5,1,80.00%
ntp.api.bz,4,0.00%,4,0,100.00%
p10445-user-info.ejoy.com,4,0.00%,4,0,100.00%
res7.vmallres.com,4,0.00%,4,0,100.00%
baiduzm.37.com,4,0.00%,4,0,100.00%
www.9377.com,4,0.00%,4,0,100.00%
www.cpta.com.cn,4,0.00%,4,0,100.00%
www.gaodun.com,4,0.00%,4,0,100.00%
quanmin.baidu.com,4,0.00%,4,0,100.00%
e13678.dscb.akamaiedge.net,4,0.00%,8,4,50.00%
stats.ipinyou.com,4,0.00%,4,0,100.00%
sjy.stream.qqmusic.qq.com,4,0.00%,4,0,100.00%
contentsync.onenote.trafficmanager.net,4,0.00%,4,0,100.00%
openapi-drcn.cloud.dbankcloud.cn,4,0.00%,4,0,100.00%
en.wikipedia.ahau.cf,4,0.00%,4,0,100.00%
www.msn.com,4,0.00%,7,3,57.14%
sp.sangfor.com.cn,4,0.00%,4,0,100.00%
p205-fmip.icloud.com.cn,4,0.00%,4,0,100.00%
onedscolprdjpw01.japanwest.cloudapp.azure.com,4,0.00%,4,0,100.00%
mixv4-34.194610.xyz,4,0.00%,4,0,100.00%
dcs.conac.cn,4,0.00%,4,0,100.00%
jcs.iie.ac.cn,4,0.00%,4,0,100.00%
api.codelife.cc,4,0.00%,6,2,66.67%
c.biancheng.net,4,0.00%,4,0,100.00%
fudao.biancheng.net,4,0.00%,4,0,100.00%
vip.biancheng.net,4,0.00%,4,0,100.00%
onedriveclucproddm20048.blob.core.windows.net,4,0.00%,4,0,100.00%
taojin-his.cdn.bcebos.com,4,0.00%,4,0,100.00%
static.bshare.cn,4,0.00%,4,0,100.00%
qex.conf.f.360.cn,4,0.00%,4,0,100.00%
verification.console.aliyun.com,4,0.00%,4,0,100.00%
media8.smartstudy.com,4,0.00%,4,0,100.00%
i.g-fox.cn.wscdns.com,4,0.00%,4,0,100.00%
aliyun-page.cn-hangzhou.log.aliyuncs.com,4,0.00%,4,0,100.00%
alioth.alicdn.com,4,0.00%,4,0,100.00%
uaction.alicdn.com,4,0.00%,4,0,100.00%
bh4d9od16a-dsn.algolia.net,4,0.00%,4,0,100.00%
publish.u-tools.cn,4,0.00%,4,0,100.00%
p205-caldav.icloud.com.cn,4,0.00%,4,0,100.00%
feeds-drcn.dbankcdn.globalsign.c.cdnhwc1.cn,4,0.00%,4,0,100.00%
hcdnw.gslb.ipv4.c.cdnhwc2.com,4,0.00%,4,0,100.00%
track.primerclicks.com,4,0.00%,4,0,100.00%
edge-global.activity.windows.com.akadns.net,4,0.00%,4,0,100.00%
edge-apac1.activity.windows.com.akadns.net,4,0.00%,4,0,100.00%
skin.docer.wps.cn,4,0.00%,4,0,100.00%
download.qnap.com,4,0.00%,8,4,50.00%
e.juejin.cn,4,0.00%,4,0,100.00%
juejin.cn,4,0.00%,4,0,100.00%
sensors.xeknow.com,4,0.00%,4,0,100.00%
api-dd.jd.com,4,0.00%,4,0,100.00%
sqdd.myapp.com.legodlied1-dk.sched.dcloudstc.com,4,0.00%,8,4,50.00%
ddms.jd.com.gslb.qianxun.com,4,0.00%,4,0,100.00%
phx02pcor002-meta.fe.1drv.com,4,0.00%,8,4,50.00%
www-bingapis-com.e-0001.e-msedge.net,4,0.00%,4,0,100.00%
mcloud-prod-r53.awscommon.mcafee.com,4,0.00%,4,0,100.00%
uz95.v.bsgslb.cn,4,0.00%,4,0,100.00%
open.kwaizt.com,4,0.00%,4,0,100.00%
feed.dongqiudi.com,4,0.00%,4,0,100.00%
ef-dongfeng.tanx.com,4,0.00%,4,0,100.00%
appbackupapi.micloud.xiaomi.net,4,0.00%,4,0,100.00%
api.comm.miui.com,4,0.00%,4,0,100.00%
status.geotrust.com,4,0.00%,8,4,50.00%
pic7.iqiyipic.com,4,0.00%,8,4,50.00%
qiyu.iqiyi.com,4,0.00%,4,0,100.00%
api.afdback.ppsimg.com,4,0.00%,4,0,100.00%
time.video.iqiyi.com,4,0.00%,4,0,100.00%
stc.iqiyipic.com,4,0.00%,8,4,50.00%
qiquan.if.iqiyi.com,4,0.00%,4,0,100.00%
codeload.github.com,4,0.00%,4,0,100.00%
tw05.graniterapids.com,4,0.00%,4,0,100.00%
cdn-file.peasrch.com.cdn.dnsv1.com.cn,4,0.00%,4,0,100.00%
dxra5xll.sched.sma.tdnsstic1.cn,4,0.00%,4,0,100.00%
www.youxiaohou.com,4,0.00%,4,0,100.00%
c.mipcdn.com,4,0.00%,8,4,50.00%
fs-wildcard.microsoft.com.edgekey.net.globalredir.akadns.net,4,0.00%,4,0,100.00%
api.foxitreader.cn,4,0.00%,4,0,100.00%
ai.alimebot.taobao.com,4,0.00%,4,0,100.00%
im.alimebot.com,4,0.00%,4,0,100.00%
sdk.congyicn.com,4,0.00%,4,0,100.00%
aliyun-pcdnts.douyucdn.cn,4,0.00%,4,0,100.00%
pss-s.alicdn.com,4,0.00%,4,0,100.00%
pcdnlive-slicerd-s.alicdn.com,4,0.00%,4,0,100.00%
hdl3a.douyucdn.cn,4,0.00%,4,0,100.00%
jstatic.3.cn,4,0.00%,4,0,100.00%
yx.3.cn,4,0.00%,4,0,100.00%
pe.3.cn,4,0.00%,4,0,100.00%
st.jingxi.com,4,0.00%,4,0,100.00%
dreport.meituan.net,4,0.00%,4,0,100.00%
p26-sign.douyinpic.com,4,0.00%,7,3,57.14%
wx.gtimg.com,4,0.00%,4,0,100.00%
tnc3-bjlgy.snssdk.com,4,0.00%,4,0,100.00%
images2015.cnblogs.com,4,0.00%,4,0,100.00%
hkaia01.graniterapids.com,4,0.00%,4,0,100.00%
adashbc.m.taobao.com.gds.alibabadns.com,4,0.00%,4,0,100.00%
cmp.quantcast.com,4,0.00%,8,4,50.00%
ip2091219980.funshion.com,4,0.00%,4,0,100.00%
api.fc.mob.com,4,0.00%,4,0,100.00%
pub.taptapdada.com,4,0.00%,4,0,100.00%
v26-ipv6.bdxiguavod.com,4,0.00%,4,0,100.00%
v3-ipv6.bdxiguavod.com,4,0.00%,8,4,50.00%
mdm.oneplus.net,4,0.00%,4,0,100.00%
fr04.graniterapids.com,4,0.00%,4,0,100.00%
30.newspush.eastmoney.com,4,0.00%,4,0,100.00%
aojxxqus.slt.sched.tdnsv8.com,4,0.00%,4,0,100.00%
ad.rxjiasu.com.cdn.fun,4,0.00%,4,0,100.00%
d2bytcopxu066p.cloudfront.net,4,0.00%,4,0,100.00%
v.qq.com.sched.ssd.tdnsv6.com,4,0.00%,4,0,100.00%
www.acfun.cn.w.kunlunar.com,4,0.00%,4,0,100.00%
www.cecdc.com,4,0.00%,4,0,100.00%
3z4qr0nn.slt-dk.sched.tdnsv8.com,4,0.00%,8,4,50.00%
www.kxnet.cn,4,0.00%,4,0,100.00%
b7q53cqj.slt.sched.tdnsv8.com,4,0.00%,4,0,100.00%
q.bjbkh.net,4,0.00%,4,0,100.00%
metrics-drcn.dt.hicloud.com,4,0.00%,4,0,100.00%
dn6m9t4qll5h.cloudfront.net,4,0.00%,8,4,50.00%
vmss-prod-eus.eastus.cloudapp.azure.com,4,0.00%,4,0,100.00%
v5-coldy.douyinvod.com,4,0.00%,8,4,50.00%
img.da.mgtv.com,4,0.00%,4,0,100.00%
s5.ssl.qhimg.com,4,0.00%,8,4,50.00%
lb.e.so.com,4,0.00%,4,0,100.00%
a.nstool.ntes53.netease.com,4,0.00%,4,0,100.00%
search.aust.cf,4,0.00%,4,0,100.00%
pic3.zhimg.com.a.bdydns.com,4,0.00%,9,5,44.44%
disqus.com,4,0.00%,8,4,50.00%
fenwan.cdn.bcebos.com,4,0.00%,6,2,66.67%
69.newspush.eastmoney.com,4,0.00%,4,0,100.00%
sphapi.oray.net,4,0.00%,4,0,100.00%
packages.swupdates.saas.ixiacom.com,4,0.00%,4,0,100.00%
41.push2.eastmoney.com,4,0.00%,8,4,50.00%
microsoftedgewelcome.microsoft.com,4,0.00%,4,0,100.00%
mwf-service.akamaized.net,4,0.00%,4,0,100.00%
profile-avatar.csdnimg.cn.download.ks-cdn.com,4,0.00%,4,0,100.00%
hk30.zxcv.men,4,0.00%,4,0,100.00%
ping.cloud.tencent.com,4,0.00%,4,0,100.00%
cjwxqz.dianpusoft.cn,4,0.00%,4,0,100.00%
aa.agkn.com,4,0.00%,4,0,100.00%
play-tx-recpub.douyucdn2.cn,4,0.00%,4,0,100.00%
vip.asus.com.cn,4,0.00%,4,0,100.00%
gspe11-ssl.ls.apple.com.edgekey.net,4,0.00%,9,5,44.44%
apponline.research.qq.com,4,0.00%,4,0,100.00%
p38-buy.itunes.apple.com,4,0.00%,4,0,100.00%
res2.kongfz.com,4,0.00%,4,0,100.00%
campus.meituan.com,4,0.00%,4,0,100.00%
lx.meituan.net,4,0.00%,4,0,100.00%
vaserviece.10jqka.com.cn,4,0.00%,4,0,100.00%
odc.officeapps.partner.office365.cn,4,0.00%,4,0,100.00%
pptpluginppt.keniu.com,4,0.00%,4,0,100.00%
news.stcn.com,4,0.00%,4,0,100.00%
finance.stcn.com,4,0.00%,4,0,100.00%
space.stcn.com,4,0.00%,4,0,100.00%
video.stcn.com,4,0.00%,4,0,100.00%
redirect.prod.experiment.routing.cloudfront.aws.a2z.com,4,0.00%,4,0,100.00%
cp801.prod.do.dsp.mp.microsoft.com.edgekey.net,4,0.00%,4,0,100.00%
k256-cedexis.gslb.ksyuncdn.com,4,0.00%,8,4,50.00%
d.3.cn,4,0.00%,4,0,100.00%
pjapi.jd.com,4,0.00%,4,0,100.00%
c.liepin.com,4,0.00%,4,0,100.00%
app.yinxiang.com,4,0.00%,4,0,100.00%
twgame04.graniterapids.com,4,0.00%,4,0,100.00%
clIeNtloGVoDP2p.HAPLaT.nEt,4,0.00%,4,0,100.00%
maMBAP2pvOdh5.8686c.cOm,4,0.00%,4,0,100.00%
xmpp003.hpeprint.com,4,0.00%,4,0,100.00%
vas.liepin.com,4,0.00%,4,0,100.00%
rtcapi.xdrtc.com,4,0.00%,4,0,100.00%
traNsit1.WsLog.cHInAnEtcEnter.coM,4,0.00%,4,0,100.00%
MAmbAP2pVOdH5.8686c.coM,4,0.00%,4,0,100.00%
CLiEnTlOGVODP2p.HapLaT.net,4,0.00%,4,0,100.00%
weus2watcab01.blob.core.windows.net,4,0.00%,4,0,100.00%
huajiakeji.com,4,0.00%,4,0,100.00%
aax-eu.amazon-adsystem.com,4,0.00%,4,0,100.00%
akmer.aikucun.com,4,0.00%,4,0,100.00%
twgame03.graniterapids.com,4,0.00%,4,0,100.00%
sg03.graniterapids.com,4,0.00%,4,0,100.00%
trial-eum-clientnsv4-s.akamaihd.net,4,0.00%,4,0,100.00%
a248.b.akamai.net,4,0.00%,4,0,100.00%
sts.online.visualstudio.com,4,0.00%,4,0,100.00%
cscasha2.ocsp-certum.com,4,0.00%,8,4,50.00%
m802.music.126.net,4,0.00%,8,4,50.00%
a12-67.akam.net,4,0.00%,4,0,100.00%
fulfillment-prod.ixiacom.com,4,0.00%,4,0,100.00%
46.push2.eastmoney.com,4,0.00%,7,3,57.14%
59.push2.eastmoney.com,4,0.00%,7,3,57.14%
ps3di31nsnbvo5m9f33tl1lkjr5k2pkgvtanon0lje2je08m9eafubbe.qc.x.bsgslb.cn,4,0.00%,4,0,100.00%
sn.splashtop.com,4,0.00%,4,0,100.00%
updates.3t.io,4,0.00%,4,0,100.00%
overseasv4.music.ntes53.netease.com,4,0.00%,6,2,66.67%
www.zhibo8.cc,4,0.00%,8,4,50.00%
static4style.duoduocdn.com,4,0.00%,8,4,50.00%
ns1.mopa.ae,4,0.00%,4,0,100.00%
live.video.weibocdn.com,4,0.00%,8,4,50.00%
ahtai3ie.nodedata.net,4,0.00%,4,0,100.00%
img.hexun.com,4,0.00%,4,0,100.00%
bond.hexun.com,4,0.00%,4,0,100.00%
i7.hexun.com,4,0.00%,4,0,100.00%
so.hexun.com,4,0.00%,4,0,100.00%
www.hexun.com,4,0.00%,4,0,100.00%
itv.hexun.com,4,0.00%,4,0,100.00%
opentool.hexun.com,4,0.00%,4,0,100.00%
pcookie.cnzz.com,4,0.00%,4,0,100.00%
house.hexun.com,4,0.00%,4,0,100.00%
caidao.homeway.com.cn,4,0.00%,4,0,100.00%
corp.hexun.com,4,0.00%,4,0,100.00%
kf.hexun.com,4,0.00%,4,0,100.00%
news.mydrivers.com,4,0.00%,7,3,57.14%
bschool.hexun.com,4,0.00%,4,0,100.00%
inference-location-centralindia.centralindia.cloudapp.azure.com,4,0.00%,4,0,100.00%
hlddz.huanle.qq.com,4,0.00%,4,0,100.00%
open.dstud.io,4,0.00%,4,0,100.00%
epay.hexun.com,4,0.00%,4,0,100.00%
forex.hexun.com,4,0.00%,4,0,100.00%
funds.hexun.com,4,0.00%,4,0,100.00%
i.hexun.com,4,0.00%,4,0,100.00%
insurance.hexun.com,4,0.00%,4,0,100.00%
money.hexun.com,4,0.00%,4,0,100.00%
opinion.hexun.com,4,0.00%,4,0,100.00%
p2p.hexun.com,4,0.00%,4,0,100.00%
i-dm3-cor005.api.p001.1drv.com,4,0.00%,4,0,100.00%
phfwba-std-g3.oray.net,4,0.00%,4,0,100.00%
redirector.japaneast.cloudapp.azure.com,4,0.00%,4,0,100.00%
onedscolprdjpw02.japanwest.cloudapp.azure.com,4,0.00%,4,0,100.00%
www.cnpython.com,4,0.00%,4,0,100.00%
upload-images.jianshu.io.w.cdngslb.com,4,0.00%,8,4,50.00%
mobilecrashreporting.googleapis.com,4,0.00%,4,0,100.00%
mdh-pa.googleapis.com,4,0.00%,8,4,50.00%
pkhcchlfofjid49b1f1gvvsn6ol94ilm9v123jdiuod1geopvkfvuo82.qc.x.bsgslb.cn,4,0.00%,4,0,100.00%
www.sublimetext.com,4,0.00%,4,0,100.00%
hkt01.graniterapids.com,4,0.00%,4,0,100.00%
media.springernature.com,4,0.00%,4,0,100.00%
developers.google.cn,4,0.00%,4,0,100.00%
nv01-gzip.cdn.bcebos.com,4,0.00%,4,0,100.00%
m.adnxs.com,4,0.00%,4,0,100.00%
www.qemu.org,4,0.00%,4,0,100.00%
onedriveclubproddm20051.blob.core.windows.net,4,0.00%,4,0,100.00%
pds.ess.apple.com,4,0.00%,4,0,100.00%
n547d93flqeqa0grfrdspfv4fi93su32lioq32ejeno878gnvp5vupgc.qc.x.bsgslb.cn,4,0.00%,4,0,100.00%
opencdnbaiduvdse.d.jomodns.com,4,0.00%,6,2,66.67%
ogepodownload.mediatek.com,4,0.00%,4,0,100.00%
doc.rust-lang.org,4,0.00%,7,3,57.14%
alb-fqpg5b5fb7n0izq8et.cn-hangzhou.alb.aliyuncs.com,4,0.00%,4,0,100.00%
services.bingapis.com,4,0.00%,4,0,100.00%
ns-strategy.cdn.bcebos.com,4,0.00%,4,0,100.00%
photoshare-drcn.cloud.dbankcloud.cn,4,0.00%,4,0,100.00%
ipm-provider.ff.avast.com,4,0.00%,4,0,100.00%
creator.zoho.com,4,0.00%,4,0,100.00%
3g.d1xz.net,4,0.00%,4,0,100.00%
onrt-stsdk.vivo.com.cn,4,0.00%,4,0,100.00%
imapi2.snssdk.com,4,0.00%,4,0,100.00%
www.hbja.cn,4,0.00%,4,0,100.00%
m.sogo.com,4,0.00%,4,0,100.00%
phfwba-std-g2.oray.net,4,0.00%,4,0,100.00%
ws-prod-r53.awscommon.mcafee.com,4,0.00%,4,0,100.00%
55.push2.eastmoney.com,4,0.00%,7,3,57.14%
time1.bytedance.com,4,0.00%,4,0,100.00%
img0.pconline.com.cn.ctadns.cn,4,0.00%,4,0,100.00%
m.baike.com,4,0.00%,4,0,100.00%
rc10-fc13.oray.com,4,0.00%,4,0,100.00%
push.douban.com,4,0.00%,4,0,100.00%
mdn.alipay.com.danuoyi.tbcache.com,4,0.00%,4,0,100.00%
74.push2.eastmoney.com,4,0.00%,6,2,66.67%
6.push2.eastmoney.com,4,0.00%,7,3,57.14%
apiim.systoon.com,4,0.00%,4,0,100.00%
api.starwalk.space,4,0.00%,4,0,100.00%
pay-cloud.duba.net,4,0.00%,4,0,100.00%
oca.telemetry.microsoft.com,4,0.00%,4,0,100.00%
fg.download.windowsupdate.com.c.footprint.net,4,0.00%,8,4,50.00%
a1954.dscd.akamai.NET,4,0.00%,5,1,80.00%
cx-im.westonecloud.com,4,0.00%,4,0,100.00%
d3-pr-cu-sb-ns-primary-err.servicebus.windows.net,4,0.00%,4,0,100.00%
d3-pr-cu-app-gcrapicore.azurewebsites.net,4,0.00%,4,0,100.00%
wd-prod-ss-edge.trafficmanager.net,4,0.00%,4,0,100.00%
jp15.graniterapids.com,4,0.00%,4,0,100.00%
iosapps.itunes.apple.com.download.ks-cdn.com,4,0.00%,4,0,100.00%
v83-017.douyinvod.com,4,0.00%,4,0,100.00%
onedriveclucproddm20049.blob.core.windows.net,4,0.00%,4,0,100.00%
a28-67.akam.net,4,0.00%,4,0,100.00%
dida365.com,4,0.00%,4,0,100.00%
wisedevice-drcn.things.hicloud.com,4,0.00%,4,0,100.00%
p6.qhimg.com,4,0.00%,6,2,66.67%
msitepp-fm.jd.com,4,0.00%,4,0,100.00%
40.push2.eastmoney.com,4,0.00%,6,2,66.67%
pufferstatis.xdrtc.com,4,0.00%,4,0,100.00%
market.m.taobao.com,4,0.00%,4,0,100.00%
p216-keyvalueservice.icloud.com.cn,4,0.00%,4,0,100.00%
p3.qhimg.com,4,0.00%,4,0,100.00%
psg1-vipcollabrtc.officeapps.live.com,4,0.00%,4,0,100.00%
pd.itunes.apple.com,4,0.00%,9,5,44.44%
hkt03.graniterapids.com,4,0.00%,4,0,100.00%
clogin.lianjia.com,4,0.00%,4,0,100.00%
catalogue.bnf.fr,4,0.00%,4,0,100.00%
im-link-server-82.csdn.net,4,0.00%,4,0,100.00%
im.58.com,4,0.00%,4,0,100.00%
hwf-health-chk.hiwifi.com,4,0.00%,4,0,100.00%
pc.work.taobao.com,4,0.00%,4,0,100.00%
ads.yieldmo.com,4,0.00%,4,0,100.00%
cs.media.net,4,0.00%,4,0,100.00%
sync.inmobi.com,4,0.00%,4,0,100.00%
serve.somplo.com,4,0.00%,4,0,100.00%
ads.creative-serving.com,4,0.00%,4,0,100.00%
id5-sync.com,4,0.00%,4,0,100.00%
a.vidoomy.com,4,0.00%,4,0,100.00%
ad.lkqd.net,4,0.00%,4,0,100.00%
cnki.net,4,0.00%,4,0,100.00%
mirrors.cn99.com,4,0.00%,4,0,100.00%
s4.ssl.qhimg.com,4,0.00%,5,1,80.00%
onedriveclucproddm20028.blob.core.windows.net,4,0.00%,4,0,100.00%
open.demonii.si,4,0.00%,4,0,100.00%
www.aec188.com,4,0.00%,4,0,100.00%
app.aec188.com,4,0.00%,4,0,100.00%
hierarchyapi.onenote.com,4,0.00%,4,0,100.00%
so.haodf.com,4,0.00%,4,0,100.00%
n3.hdfimg.com,4,0.00%,4,0,100.00%
n2.hdfimg.com,4,0.00%,4,0,100.00%
n1.hdfimg.com,4,0.00%,4,0,100.00%
pvstat.haodf.com,4,0.00%,4,0,100.00%
n4.hdfimg.com,4,0.00%,4,0,100.00%
aih7aso6.nodedata.net,4,0.00%,4,0,100.00%
update.b.cqttech.com,4,0.00%,4,0,100.00%
safe.track.uc.360.cn,4,0.00%,4,0,100.00%
blog.sciencenet.cn,4,0.00%,4,0,100.00%
www.jsr10.com,4,0.00%,4,0,100.00%
tt-a-vod-sched.jcloudimg.com,4,0.00%,4,0,100.00%
lens.zhihu.com,4,0.00%,14,10,28.57%
oauth-login-drcn-platform-dbankcloud-com-drcn.appacc-region.dbankedge.net,4,0.00%,4,0,100.00%
tyjr-common-cn-shanghai.aliyun.com,4,0.00%,7,3,57.14%
p10445-ob-hotfix.ejoy.com,4,0.00%,4,0,100.00%
oauth-login-drcn-platform-dbankcloud-com-drcn.appacc.dbankedge.net,4,0.00%,4,0,100.00%
na61-na62.wagbridge.work.alibabacorp.com.gds.alibabadns.com,4,0.00%,4,0,100.00%
tracking.icims.com,4,0.00%,4,0,100.00%
1703698.sched.dma.tdnsdl1.cn,4,0.00%,4,0,100.00%
iceprime.a-0003.dc-msedge.net,4,0.00%,4,0,100.00%
eclso.me,4,0.00%,4,0,100.00%
img2.baidu.com.a.bdydns.com,4,0.00%,4,0,100.00%
img1.baidu.com.a.bdydns.com,4,0.00%,4,0,100.00%
img0.baidu.com.a.bdydns.com,4,0.00%,4,0,100.00%
uz95.v.bsclink.cn,4,0.00%,4,0,100.00%
prod-china.fs.microsoft.com.akadns.net,4,0.00%,4,0,100.00%
lf3-short.ibytedapm.com.w.kunluncan.com,4,0.00%,4,0,100.00%
waws-prod-sn1-111.sip.azurewebsites.windows.net,4,0.00%,4,0,100.00%
certs-lb.apple.com.akadns.net,4,0.00%,8,4,50.00%
certs-cn-lb.apple.com.akadns.net,4,0.00%,9,5,44.44%
sf-api-token-service-lb.itunes-apple.com.akadns.net,4,0.00%,7,3,57.14%
su-cdn.itunes-apple.com.akadns.net,4,0.00%,7,3,57.14%
dss2.baidu.com,4,0.00%,4,0,100.00%
dss1.baidu.com,4,0.00%,4,0,100.00%
dss0.baidu.com,4,0.00%,4,0,100.00%
cdn-home-packages.chinauos.com,4,0.00%,4,0,100.00%
wx.conn.wemeet.tencent.com,4,0.00%,4,0,100.00%
dralot.ie.sogou.com,4,0.00%,4,0,100.00%
oa.yghcwy.com,4,0.00%,4,0,100.00%
update.equinox.io,4,0.00%,4,0,100.00%
experiments.apple.com,4,0.00%,8,4,50.00%
amp-api.media.apple.com,4,0.00%,8,4,50.00%
wordnetweb.princeton.edu,4,0.00%,4,0,100.00%
0mthgo1d.sched.d2.tdnsdp1.cn,4,0.00%,4,0,100.00%
club.bilibili.com,4,0.00%,5,1,80.00%
petropluvialis-apple-com.v.aaplimg.com,4,0.00%,4,0,100.00%
jos.org.cn,4,0.00%,4,0,100.00%
im-drcn.platform.dbankcloud.cn,4,0.00%,4,0,100.00%
www.ijsi.org,4,0.00%,4,0,100.00%
as-eb2.3lift.com,4,0.00%,4,0,100.00%
cdn.wup.huya.com,4,0.00%,6,2,66.67%
log-sdk.ksapisrv.com,4,0.00%,4,0,100.00%
u2-000.ecukwai.com,4,0.00%,4,0,100.00%
planet.com.ro,4,0.00%,4,0,100.00%
live.ximalaya.com,4,0.00%,4,0,100.00%
e7528.d.akamaiedge.net,4,0.00%,4,0,100.00%
trace.qq.com,4,0.00%,4,0,100.00%
e13630.ca2.s.tl88.net,4,0.00%,4,0,100.00%
sc0.hao123img.com,4,0.00%,6,2,66.67%
hao123-static.cdn.bcebos.com,4,0.00%,6,2,66.67%
as1.m.hao123.com,4,0.00%,4,0,100.00%
dgss1.baidu.com,4,0.00%,6,2,66.67%
cstaticdun.126.net.163jiasu.com,4,0.00%,4,0,100.00%
gslb-gf-online.zhihu.com,4,0.00%,7,3,57.14%
a1958.r.akamai.net,4,0.00%,4,0,100.00%
www.bytedance.com.edgesuite.net,4,0.00%,4,0,100.00%
slb-03-xy5-rb5-c11954.ctripgslb.com,4,0.00%,4,0,100.00%
i.koolearn.com,4,0.00%,4,0,100.00%
m1.51kaowang.com,4,0.00%,4,0,100.00%
logservice1.dbankcloud.cn,4,0.00%,4,0,100.00%
slack.com,4,0.00%,4,0,100.00%
qzonestyle.gtimg.cn.sched.legopic2.tdnsv6.com,4,0.00%,4,0,100.00%
ins-flxvccoj.ias.tencent-cloud.net,4,0.00%,4,0,100.00%
templatesmetadata.office.net.edgekey.net,4,0.00%,4,0,100.00%
api-flightproxy-skype.trafficmanager.net,4,0.00%,4,0,100.00%
asm-api-prod-version-skype.trafficmanager.net,4,0.00%,4,0,100.00%
templatesmetadata.office.net,4,0.00%,4,0,100.00%
i.gtimg.tc.qq.com,4,0.00%,4,0,100.00%
v2.oskwai.com,4,0.00%,4,0,100.00%
ali-proxy.pull.yximgs.com,4,0.00%,4,0,100.00%
d2.a.kwimgs.com,4,0.00%,4,0,100.00%
d2-magic.static.yximgs.com,4,0.00%,4,0,100.00%
ali.static.yximgs.com,4,0.00%,4,0,100.00%
d2-yoda.a.kwimgs.com,4,0.00%,4,0,100.00%
entitlement-public-service-prod08.ol.epicgames.com,4,0.00%,4,0,100.00%
smtp.nfs-china.com,4,0.00%,4,0,100.00%
version.hybrid.api.heremaps.cn,4,0.00%,4,0,100.00%
t0.ssl.ak.dynamic.tiles.virtualearth.net,4,0.00%,8,4,50.00%
3439454584-server.va.huya.com,4,0.00%,4,0,100.00%
image.video.qpic.cn,4,0.00%,4,0,100.00%
m.reachmax.cn,4,0.00%,4,0,100.00%
i5.weather.oppomobile.com,4,0.00%,4,0,100.00%
t-khd.2345.cc,4,0.00%,4,0,100.00%
uif.microsoft.com,4,0.00%,4,0,100.00%
keeperapi.izaodao.com,4,0.00%,4,0,100.00%
www.izaodao.com,4,0.00%,4,0,100.00%
5al6ec7yfhqkwikrip63inxedk2mcuub.yundunwaf4.com,4,0.00%,4,0,100.00%
collector.newrelic.com,4,0.00%,4,0,100.00%
searchrecommendretry.kugou.com,4,0.00%,4,0,100.00%
povv.yilanvaas.com,4,0.00%,8,4,50.00%
www.jiqizhixin.com,4,0.00%,4,0,100.00%
test-ali-urswebzj.nosdn.127.net,4,0.00%,4,0,100.00%
test-baidu-urswebzj.nosdn.127.net,4,0.00%,4,0,100.00%
nvideo.n.shifen.com,4,0.00%,4,0,100.00%
ehs.cas.cn,4,0.00%,4,0,100.00%
img.ithome.com,4,0.00%,7,3,57.14%
p204-contacts.icloud.com.cn,4,0.00%,4,0,100.00%
analyticsdcs.awsmcafeeccs.mcafee.com,4,0.00%,8,4,50.00%
collector-007.newrelic.com,4,0.00%,4,0,100.00%
pf.3.cn,4,0.00%,4,0,100.00%
sd-static.1dadan.com,4,0.00%,4,0,100.00%
onedscolprdgwc01.germanywestcentral.cloudapp.azure.com,4,0.00%,4,0,100.00%
u966.v.bsclink.cn,4,0.00%,4,0,100.00%
ug.snssdk.com,4,0.00%,4,0,100.00%
analyticsdcs.ccs.mcafee.com,4,0.00%,8,4,50.00%
gameapp.qq.com,4,0.00%,8,4,50.00%
show.g.mediav.com,4,0.00%,4,0,100.00%
news.ifeng.com,4,0.00%,4,0,100.00%
bjxb.cessp.org.cn,4,0.00%,4,0,100.00%
sf-api-token-service.itunes.apple.com,4,0.00%,7,3,57.14%
t3.a.market.xiaomi.com,4,0.00%,4,0,100.00%
cdn.exp.xiaomi.com.cdn.dnsv1.com,4,0.00%,4,0,100.00%
app-ss-ipc.mercuryclouds.com.cn,4,0.00%,4,0,100.00%
prd-txc-sh-1-snapshot-1-common-com-cn-1255623871.cos.ap-shanghai.myqcloud.com,4,0.00%,4,0,100.00%
e9126.x.akamaiedge.net,4,0.00%,4,0,100.00%
pccw04.graniterapids.com,4,0.00%,4,0,100.00%
49-courier.push.apple.com,4,0.00%,4,0,100.00%
steamstore-a.akamaihd.net.edgesuite.net,4,0.00%,4,0,100.00%
grs-dbankcloud-com-drcn.appacc.dbankedge.net,4,0.00%,4,0,100.00%
grs-dbankcloud-com-drcn.appacc-region.dbankedge.net,4,0.00%,4,0,100.00%
prd-lender.cdp.internal.unity3d.com,4,0.00%,4,0,100.00%
order.jd.com,4,0.00%,7,3,57.14%
payrisk.jd.com,4,0.00%,4,0,100.00%
cn-android.cliapi.microfun.cn,4,0.00%,4,0,100.00%
mc.corel.com,4,0.00%,4,0,100.00%
kgnop2.kugou.com,4,0.00%,4,0,100.00%
f.gm.mob.com,4,0.00%,4,0,100.00%
hkt06.graniterapids.com,4,0.00%,4,0,100.00%
79.newspush.eastmoney.com,4,0.00%,4,0,100.00%
passport.bigfun.cn,4,0.00%,4,0,100.00%
passport.bilibili.cn,4,0.00%,4,0,100.00%
lhpay.gzcl999.com,4,0.00%,4,0,100.00%
360fenxi.mediav.com,4,0.00%,4,0,100.00%
ali-bj-pcdn-30.biliapi.net,4,0.00%,4,0,100.00%
stcglobal.beisen.com,4,0.00%,4,0,100.00%
ww3.mediaclub.tv,4,0.00%,4,0,100.00%
i-5600.b-2372.helper.bench.utorrent.com,4,0.00%,8,4,50.00%
desktop.cloud.nfschina.com,4,0.00%,4,0,100.00%
fortune.com,4,0.00%,4,0,100.00%
conf-drcn-cloud-dbankcloud-cn-drcn.appacc.dbankedge.net,4,0.00%,4,0,100.00%
conf-drcn-cloud-dbankcloud-cn-drcn.edge.dbankedge.cn,4,0.00%,4,0,100.00%
3-courier.push.apple.com,4,0.00%,4,0,100.00%
sdkconfig.video.qq.com,4,0.00%,4,0,100.00%
qqshow2-ufs.qq.com,4,0.00%,4,0,100.00%
nodeyun.video.qq.com,4,0.00%,4,0,100.00%
www.arkcomputing.com.cn,4,0.00%,4,0,100.00%
www.anjuke.com,4,0.00%,4,0,100.00%
u.jd.com,4,0.00%,4,0,100.00%
xqimg.imedao.com,4,0.00%,4,0,100.00%
img.ljcdn.com,4,0.00%,8,4,50.00%
p1-play.edge4k.com,4,0.00%,4,0,100.00%
web.50bangzh.com,4,0.00%,4,0,100.00%
www.2345.com,4,0.00%,4,0,100.00%
n.clarity.ms,4,0.00%,4,0,100.00%
google.com.hk,4,0.00%,8,4,50.00%
b2b.baidu.com,4,0.00%,10,6,40.00%
ncsi-geo.trafficmanager.net,4,0.00%,4,0,100.00%
amp-api.apps-lb.itunes-apple.com.akadns.net,4,0.00%,6,2,66.67%
hotfix.lenovo.com.cn.trpcdn.net,4,0.00%,4,0,100.00%
service.shyonghui.xyz,4,0.00%,4,0,100.00%
bd4b0m0l.sched.v1lego-dk.tdnsvod1.cn,4,0.00%,10,6,40.00%
supportapi.lenovo.com,4,0.00%,4,0,100.00%
bundle.bh3.com,4,0.00%,4,0,100.00%
lh6.googleusercontent.com,4,0.00%,4,0,100.00%
workbench.data.aliyun.com,4,0.00%,4,0,100.00%
ins-t00s81j9.ias.tencent-cloud.net,4,0.00%,4,0,100.00%
static-res.qq.com.cloud.tc.qq.com,4,0.00%,4,0,100.00%
intellicode-toplevel-prod-tm.trafficmanager.net,4,0.00%,4,0,100.00%
apd-cc9eb85339661710dcce8e468b6e9a70.v.smtcdns.com,4,0.00%,4,0,100.00%
adv.l7.34.sec.miui.com,4,0.00%,4,0,100.00%
bkimg.cdn.bcebos.com.a.bdydns.com,4,0.00%,4,0,100.00%
sg.pool.ntp.org,4,0.00%,4,0,100.00%
sugoi.pomf.se,4,0.00%,4,0,100.00%
free.sinaimg.cn,4,0.00%,4,0,100.00%
pingan.com,4,0.00%,4,0,100.00%
docs.feishu.cn,4,0.00%,4,0,100.00%
event.wps.com,4,0.00%,4,0,100.00%
urswebzj.nosdn.127.net.w.alikunlun.com,4,0.00%,4,0,100.00%
pxy.video.qq.com,4,0.00%,4,0,100.00%
www-xboxab-com.e-0012.e-msedge.net,4,0.00%,4,0,100.00%
s1.ssl.qhimg.com,4,0.00%,8,4,50.00%
www.amss.ac.cn,4,0.00%,4,0,100.00%
dcat-tlu-bg-shim.trafficmanager.net,4,0.00%,4,0,100.00%
kingsoftspark.bg.tlu.download.ks-cdn.com,4,0.00%,4,0,100.00%
kinqbxzx.sched.v1lego-dk.tdnsvod1.cn,4,0.00%,8,4,50.00%
get.shouji.sogou.com,4,0.00%,4,0,100.00%
daohang.qq.com,4,0.00%,4,0,100.00%
upd11.sogoucdn.com,4,0.00%,4,0,100.00%
internal-api.feishu.cn.w.cdngslb.com,4,0.00%,4,0,100.00%
noteapi.micloud.xiaomi.net,4,0.00%,4,0,100.00%
mobile.ximalaya.com,4,0.00%,4,0,100.00%
m.ximalaya.com,4,0.00%,5,1,80.00%
pz.antsysht.com,4,0.00%,4,0,100.00%
cl.antsysht.com,4,0.00%,4,0,100.00%
coupon.xmluren.com,4,0.00%,4,0,100.00%
v3-default.ixigua.com,4,0.00%,4,0,100.00%
mirrors.openanolis.cn,4,0.00%,4,0,100.00%
check02.51y5.net.cdn20.com,4,0.00%,4,0,100.00%
init-sb.push-apple.com.akadns.net,4,0.00%,4,0,100.00%
jspassport.ssl.qhimg.com.webcdn.360qhcdn.com,4,0.00%,6,2,66.67%
mirrors.elrepo.org,4,0.00%,4,0,100.00%
wr.yiyouliao.com,4,0.00%,4,0,100.00%
msn-img-nos.yiyouliao.com,4,0.00%,4,0,100.00%
forecast.weather.com.cn,4,0.00%,4,0,100.00%
price.pcauto.com.cn,4,0.00%,4,0,100.00%
js.3conline.com,4,0.00%,4,0,100.00%
r4---sn-ni5een7l.gvt1.com,4,0.00%,4,0,100.00%
www.pcauto.com.cn,4,0.00%,4,0,100.00%
www1.pcauto.com.cn,4,0.00%,4,0,100.00%
img.pcauto.com.cn,4,0.00%,4,0,100.00%
jwz.3conline.com,4,0.00%,4,0,100.00%
www.pconline.com.cn,4,0.00%,4,0,100.00%
bbs.pcauto.com.cn,4,0.00%,4,0,100.00%
imgad0.pcauto.com.cn,4,0.00%,4,0,100.00%
imgad0.pconline.com.cn,4,0.00%,4,0,100.00%
www1.pconline.com.cn,4,0.00%,4,0,100.00%
life.pcbaby.com.cn,4,0.00%,4,0,100.00%
eaus2watcab01.blob.core.windows.net,4,0.00%,4,0,100.00%
js.17qiche.com,4,0.00%,4,0,100.00%
images2.17qiche.com,4,0.00%,4,0,100.00%
www.17qiche.com,4,0.00%,4,0,100.00%
newsapi.yiche.com,4,0.00%,7,3,57.14%
p54-ckdatabase.icloud.com,4,0.00%,15,11,26.67%
s05.upd.kaspersky.com,4,0.00%,4,0,100.00%
popo.wan.ijinshan.com,4,0.00%,4,0,100.00%
scicollection.las.ac.cn,4,0.00%,4,0,100.00%
web.cs.dal.ca,4,0.00%,4,0,100.00%
www.linkedin.com,4,0.00%,4,0,100.00%
bytedance.feishu.cn.bytedns1.com,4,0.00%,4,0,100.00%
hz-tw.transit.freework.cyou,4,0.00%,4,0,100.00%
hd-tw.transit.freework.cyou,4,0.00%,4,0,100.00%
hk-5.transit.freework.cyou,4,0.00%,4,0,100.00%
hn-tw.transit.freework.cyou,4,0.00%,4,0,100.00%
hd-hk.transit.freework.cyou,4,0.00%,4,0,100.00%
hn-hk.transit.freework.cyou,4,0.00%,4,0,100.00%
hz-hk.transit.freework.cyou,4,0.00%,4,0,100.00%
hz-kr.transit.freework.cyou,4,0.00%,4,0,100.00%
hn-kr.transit.freework.cyou,4,0.00%,4,0,100.00%
hn-jp.transit.freework.cyou,4,0.00%,4,0,100.00%
hd-kr.transit.freework.cyou,4,0.00%,4,0,100.00%
hn-sgp.transit.freework.cyou,4,0.00%,4,0,100.00%
hz-sgp.transit.freework.cyou,4,0.00%,4,0,100.00%
hn-us.transit.freework.cyou,4,0.00%,4,0,100.00%
hd-sgp.transit.freework.cyou,4,0.00%,4,0,100.00%
hz-us.transit.freework.cyou,4,0.00%,4,0,100.00%
hd-us.transit.freework.cyou,4,0.00%,4,0,100.00%
hn-au.transit.freework.cyou,4,0.00%,4,0,100.00%
hz-au.transit.freework.cyou,4,0.00%,4,0,100.00%
hd-au.transit.freework.cyou,4,0.00%,4,0,100.00%
hn-ca.transit.freework.cyou,4,0.00%,4,0,100.00%
hz-ca.transit.freework.cyou,4,0.00%,4,0,100.00%
hd-ca.transit.freework.cyou,4,0.00%,4,0,100.00%
hn-gb.transit.freework.cyou,4,0.00%,4,0,100.00%
hz-gb.transit.freework.cyou,4,0.00%,4,0,100.00%
hd-gb.transit.freework.cyou,4,0.00%,4,0,100.00%
hn-fr.transit.freework.cyou,4,0.00%,4,0,100.00%
hz-fr.transit.freework.cyou,4,0.00%,4,0,100.00%
hd-fr.transit.freework.cyou,4,0.00%,4,0,100.00%
hn-de.transit.freework.cyou,4,0.00%,4,0,100.00%
hz-de.transit.freework.cyou,4,0.00%,4,0,100.00%
hd-de.transit.freework.cyou,4,0.00%,4,0,100.00%
hn-in.transit.freework.cyou,4,0.00%,4,0,100.00%
hz-in.transit.freework.cyou,4,0.00%,4,0,100.00%
hd-in.transit.freework.cyou,4,0.00%,4,0,100.00%
kr-1-1.transit.freework.cyou,4,0.00%,4,0,100.00%
kr-2-1.transit.freework.cyou,4,0.00%,4,0,100.00%
kr-3-1.transit.freework.cyou,4,0.00%,4,0,100.00%
kr-4-1.transit.freework.cyou,4,0.00%,4,0,100.00%
kr-5-1.transit.freework.cyou,4,0.00%,4,0,100.00%
kr-6-1.transit.freework.cyou,4,0.00%,4,0,100.00%
jp-1-1.transit.freework.cyou,4,0.00%,4,0,100.00%
jp-2-1.transit.freework.cyou,4,0.00%,4,0,100.00%
jp-3-1.transit.freework.cyou,4,0.00%,4,0,100.00%
jp-4-1.transit.freework.cyou,4,0.00%,4,0,100.00%
jp-5-1.transit.freework.cyou,4,0.00%,4,0,100.00%
jp-6-1.transit.freework.cyou,4,0.00%,4,0,100.00%
sgp-1-1.transit.freework.cyou,4,0.00%,4,0,100.00%
sgp-2-1.transit.freework.cyou,4,0.00%,4,0,100.00%
sgp-3-1.transit.freework.cyou,4,0.00%,4,0,100.00%
sgp-4-1.transit.freework.cyou,4,0.00%,4,0,100.00%
us-1-1.transit.freework.cyou,4,0.00%,4,0,100.00%
us-2-1.transit.freework.cyou,4,0.00%,4,0,100.00%
us-3-1.transit.freework.cyou,4,0.00%,4,0,100.00%
us-4-1.transit.freework.cyou,4,0.00%,4,0,100.00%
us-5-1.transit.freework.cyou,4,0.00%,4,0,100.00%
us-6-1.transit.freework.cyou,4,0.00%,4,0,100.00%
au-1-1.transit.freework.cyou,4,0.00%,4,0,100.00%
au-2-1.transit.freework.cyou,4,0.00%,4,0,100.00%
ca-1-1.transit.freework.cyou,4,0.00%,4,0,100.00%
ca-2-1.transit.freework.cyou,4,0.00%,4,0,100.00%
gb-1-1.transit.freework.cyou,4,0.00%,4,0,100.00%
gb-2-1.transit.freework.cyou,4,0.00%,4,0,100.00%
fr-1-1.transit.freework.cyou,4,0.00%,4,0,100.00%
fr-2-1.transit.freework.cyou,4,0.00%,4,0,100.00%
de-1-1.transit.freework.cyou,4,0.00%,4,0,100.00%
de-2-1.transit.freework.cyou,4,0.00%,4,0,100.00%
in-1-1.transit.freework.cyou,4,0.00%,4,0,100.00%
in-2-1.transit.freework.cyou,4,0.00%,4,0,100.00%
tw-1.transit.freework.cyou,4,0.00%,4,0,100.00%
tw-2.transit.freework.cyou,4,0.00%,4,0,100.00%
tw-3.transit.freework.cyou,4,0.00%,4,0,100.00%
tw-4.transit.freework.cyou,4,0.00%,4,0,100.00%
tw-5.transit.freework.cyou,4,0.00%,4,0,100.00%
hk-1.transit.freework.cyou,4,0.00%,4,0,100.00%
hk-2.transit.freework.cyou,4,0.00%,4,0,100.00%
hk-3.transit.freework.cyou,4,0.00%,4,0,100.00%
hk-4.transit.freework.cyou,4,0.00%,4,0,100.00%
cs3.ifengcdn.com,4,0.00%,4,0,100.00%
ax.ifeng.com,4,0.00%,4,0,100.00%
big1.ifengcdn.com,4,0.00%,4,0,100.00%
console.zhibo.ifeng.com,4,0.00%,4,0,100.00%
e9qw5a14.sched.sma.tdnsstic1.cn,4,0.00%,4,0,100.00%
ip2072148261.funshion.com,4,0.00%,4,0,100.00%
ip2072148264.funshion.com,4,0.00%,4,0,100.00%
tr.jd.com,4,0.00%,4,0,100.00%
f12.baidu.com,4,0.00%,8,4,50.00%
login.gjzwfw.gov.cn,4,0.00%,4,0,100.00%
hitcount.jjwxc.net,4,0.00%,4,0,100.00%
s9-static.jjwxc.net,4,0.00%,8,4,50.00%
dl17.wdk6534.com,4,0.00%,4,0,100.00%
log-verify.mob.com,4,0.00%,4,0,100.00%
wxapp.api.ke.com,4,0.00%,4,0,100.00%
devs.data.mob.com,4,0.00%,4,0,100.00%
s11.upd.kaspersky.com,4,0.00%,4,0,100.00%
img2.fonts.cache.wps.cn,4,0.00%,4,0,100.00%
tvpic.gtimg.cn,4,0.00%,4,0,100.00%
wpapi.shanhutech.cn,4,0.00%,4,0,100.00%
passport.lenovo.com,4,0.00%,4,0,100.00%
api.sina.com.cn,4,0.00%,4,0,100.00%
blog.sina.com.cn,4,0.00%,4,0,100.00%
control.blog.sina.com.cn,4,0.00%,4,0,100.00%
interface.blog.sina.com.cn,4,0.00%,4,0,100.00%
baidubox-emoji.cdn.bcebos.com.a.bdydns.com,4,0.00%,4,0,100.00%
static.zhipin.com,4,0.00%,8,4,50.00%
gameapi-account.mihoyo.com,4,0.00%,4,0,100.00%
capd.ii.uj.edu.pl,4,0.00%,4,0,100.00%
cd.qq.com,4,0.00%,4,0,100.00%
sz4.tencent.com,4,0.00%,4,0,100.00%
sz2.tencent.com,4,0.00%,4,0,100.00%
74.newspush.eastmoney.com,4,0.00%,4,0,100.00%
www.yoojia.com,4,0.00%,4,0,100.00%
scholar.google.com.sg,4,0.00%,6,2,66.67%
www.wumii.com,4,0.00%,4,0,100.00%
sso.chaoxing.com,4,0.00%,4,0,100.00%
noteyd.chaoxing.com,4,0.00%,4,0,100.00%
photo.chaoxing.com,4,0.00%,4,0,100.00%
img1.16q.cn,4,0.00%,4,0,100.00%
ap1.agora.io,4,0.00%,4,0,100.00%
ap-universal-proxy.agora.io,4,0.00%,4,0,100.00%
service-upload.agora.io,4,0.00%,4,0,100.00%
www.gdtxt.net,4,0.00%,4,0,100.00%
weishangxiangce.sfn-tx-guangzhou-01.saas.sensorsdata.cn,4,0.00%,4,0,100.00%
0jyrcvkr.slt.sched.tdnsv8.com,4,0.00%,4,0,100.00%
wzrypclog.dftoutiao.com,4,0.00%,4,0,100.00%
uclient.yonyoucloud.com,4,0.00%,4,0,100.00%
dc.wifishenqi.com,4,0.00%,4,0,100.00%
contentcenter-drcn.dbankcdn.cn,4,0.00%,6,2,66.67%
firebaseremoteconfig.mihoyo.com,4,0.00%,4,0,100.00%
api.bt.co,4,0.00%,4,0,100.00%
slog.trackingio.com,4,0.00%,4,0,100.00%
sockjs-ap1.pusher.com,4,0.00%,4,0,100.00%
pdds-pn-cdn.uc.cn.w.alikunlun.com,4,0.00%,4,0,100.00%
gips2.baidu.com,4,0.00%,4,0,100.00%
emsfs.autodesk.com,4,0.00%,4,0,100.00%
66.push2.eastmoney.com,4,0.00%,6,2,66.67%
f-log-win-extension.grammarly.io,4,0.00%,4,0,100.00%
hkt07.graniterapids.com,4,0.00%,4,0,100.00%
pcstatic.2345.com,4,0.00%,4,0,100.00%
help.mail.163.com,4,0.00%,4,0,100.00%
v.mail.163.com,4,0.00%,4,0,100.00%
exmail.wechatos.net,4,0.00%,4,0,100.00%
ce.lijit.com,4,0.00%,4,0,100.00%
sanycampus.zhiye.com,4,0.00%,4,0,100.00%
adashx.ut.shuqi.com,4,0.00%,4,0,100.00%
y.gtimg.cn.sched.ssd.tdnsv6.com,4,0.00%,4,0,100.00%
na1r.services.adobe.com,4,0.00%,4,0,100.00%
sa.zhixi.com,4,0.00%,4,0,100.00%
www.heiyunxitong.com,4,0.00%,4,0,100.00%
api-mayi.django.t.taobao.com,4,0.00%,4,0,100.00%
onedriveclucprodbn20046.blob.core.windows.net,4,0.00%,4,0,100.00%
31.push2.eastmoney.com,4,0.00%,8,4,50.00%
90.newspush.eastmoney.com,4,0.00%,4,0,100.00%
www.piaohua.com,4,0.00%,4,0,100.00%
i-29.b-46206.ut.bench.utorrent.com,4,0.00%,8,4,50.00%
i-139.b-46206.ut.bench.utorrent.com,4,0.00%,8,4,50.00%
i-32.b-46206.ut.bench.utorrent.com,4,0.00%,8,4,50.00%
rmcsdf.qunar.com,4,0.00%,4,0,100.00%
dplusapi.hexun.com,4,0.00%,4,0,100.00%
log.news.baidu.com,4,0.00%,4,0,100.00%
bg0.market.xiaomi.com,4,0.00%,4,0,100.00%
log3-applog-lf.fqnovel.com,4,0.00%,4,0,100.00%
order.hexun.com,4,0.00%,4,0,100.00%
brokerzhibo.homeway.com.cn,4,0.00%,4,0,100.00%
wuji.video.qq.com,4,0.00%,4,0,100.00%
uslys.edgehelper.com,4,0.00%,4,0,100.00%
lnk0-1037157404.cn-north-1.elb.amazonaws.com.cn,4,0.00%,4,0,100.00%
scs.openspeech.cn,4,0.00%,4,0,100.00%
upichq.v.trpcdn.net,4,0.00%,4,0,100.00%
p209-escrowproxy.icloud.com.cn,4,0.00%,4,0,100.00%
p28-buy.itunes.apple.com,4,0.00%,4,0,100.00%
p28-buy.itunes-apple.com.akadns.net,4,0.00%,4,0,100.00%
onedriveclucprodbn20042.blob.core.windows.net,4,0.00%,4,0,100.00%
api.kjjs.360.cn,4,0.00%,4,0,100.00%
bytedancecampus1.feishu.cn,4,0.00%,4,0,100.00%
s7.addthis.com,4,0.00%,4,0,100.00%
down.dingtalk.com,4,0.00%,4,0,100.00%
top.zhan.com,4,0.00%,4,0,100.00%
channel-service.zhan.com,4,0.00%,4,0,100.00%
p9-open-sign.byteimg.com,4,0.00%,8,4,50.00%
p3-open-sign.byteimg.com,4,0.00%,4,0,100.00%
p3-open-sign.byteimg.com.w.kunluncan.com,4,0.00%,4,0,100.00%
intldlgs.qq.com,4,0.00%,4,0,100.00%
light-cfg-1251626029.file.myqcloud.com,4,0.00%,4,0,100.00%
tqt.weibo.cn,4,0.00%,4,0,100.00%
phi4thuo.nodedata.net,4,0.00%,4,0,100.00%
logintool.hexun.com,4,0.00%,4,0,100.00%
web.hexun.com,4,0.00%,4,0,100.00%
i6.hexun.com,4,0.00%,4,0,100.00%
wuye.hexun.com,4,0.00%,4,0,100.00%
data.hexun.com,4,0.00%,4,0,100.00%
hk.stock.hexun.com,4,0.00%,4,0,100.00%
tech.hexun.com,4,0.00%,4,0,100.00%
pdown.stat.360safe.com,4,0.00%,4,0,100.00%
node2033849174.api.steamgamepowered.com,4,0.00%,4,0,100.00%
mtrace.qq.com,4,0.00%,4,0,100.00%
dgvip.duba.net,4,0.00%,4,0,100.00%
nrc.tapas.net,4,0.00%,4,0,100.00%
fr.minexmr.com,4,0.00%,4,0,100.00%
ca.minexmr.com,4,0.00%,4,0,100.00%
sg.minexmr.com,4,0.00%,4,0,100.00%
monitor.uu.qq.com,4,0.00%,4,0,100.00%
ins-3c6flx36.ias.tencent-cloud.net,4,0.00%,4,0,100.00%
cmp-push.lu.com,4,0.00%,4,0,100.00%
rcxnavi.lu.com,4,0.00%,4,0,100.00%
appmonlife.pingan.com.cn,4,0.00%,4,0,100.00%
pinst.360.cn,4,0.00%,4,0,100.00%
drpf-g37.proxima.nie.netease.com,4,0.00%,4,0,100.00%
data.chsmarttv.com,4,0.00%,4,0,100.00%
ghcr.io,4,0.00%,4,0,100.00%
kzx2.360kan.com,4,0.00%,4,0,100.00%
v7.dious.cc,4,0.00%,4,0,100.00%
alive-interactive.xiaoeknow.com,4,0.00%,4,0,100.00%
vpic.video.qq.com,4,0.00%,4,0,100.00%
adobelogin.prod.ims.adobejanus.com,4,0.00%,4,0,100.00%
filedownload.lenovo.com.akadns.net,4,0.00%,4,0,100.00%
aladin.wxqcloud.qq.com.cdn.dnsv1.com,4,0.00%,4,0,100.00%
aladin.wxqcloud.mid.tdnsv6.com,4,0.00%,4,0,100.00%
p214-caldav.icloud.com.cn,4,0.00%,4,0,100.00%
static-spartan-ks-s-msn-com.akamaized.net,4,0.00%,4,0,100.00%
15-courier.push.apple.com,4,0.00%,4,0,100.00%
feedquic.jomodns.com,4,0.00%,4,0,100.00%
minipro.baidu.com,4,0.00%,4,0,100.00%
spcsz.cdn.bcebos.com,4,0.00%,4,0,100.00%
camorope-client-a.meiqia.com,4,0.00%,4,0,100.00%
n1.szjal.cn,4,0.00%,4,0,100.00%
keeplive.jd.com,4,0.00%,4,0,100.00%
gdown.baidu.com,4,0.00%,4,0,100.00%
dsm01pcor004-com.be.1drv.com,4,0.00%,4,0,100.00%
buy.itunes.apple.com,4,0.00%,4,0,100.00%
frontapi.easypass.cn,4,0.00%,4,0,100.00%
pgm-2zep75rx2cr79ej3ao.pg.rds.aliyuncs.com,4,0.00%,4,0,100.00%
jupiter.sys.miui.com,4,0.00%,4,0,100.00%
tongji.flash.cn,4,0.00%,4,0,100.00%
mqq-plugin.qq.com,4,0.00%,4,0,100.00%
quan-1259287960.cos.ap-guangzhou.myqcloud.com,4,0.00%,4,0,100.00%
cpsiotweek.neslab.it,4,0.00%,4,0,100.00%
bidder.criteo.com,4,0.00%,4,0,100.00%
dps.jp.cinarra.com,4,0.00%,4,0,100.00%
match.taboola.com,4,0.00%,4,0,100.00%
image4.pubmatic.com,4,0.00%,4,0,100.00%
data-beacons.s-onetag.com,4,0.00%,4,0,100.00%
info.tigera.io,4,0.00%,4,0,100.00%
ww3.appgate.com,4,0.00%,4,0,100.00%
search.sohu.com,4,0.00%,4,0,100.00%
cont.jd.com,4,0.00%,4,0,100.00%
drflavio.hostlab.tk,4,0.00%,4,0,100.00%
oa.junengjiaoyu.com,4,0.00%,4,0,100.00%
client.10jqka.com.cn,4,0.00%,4,0,100.00%
qqi18n.qq.com,4,0.00%,4,0,100.00%
www.zoomus.cn,4,0.00%,4,0,100.00%
cfg-2.pddpic.com,4,0.00%,4,0,100.00%
static2.servyou.com.cn,4,0.00%,4,0,100.00%
crl.startssl.com,4,0.00%,4,0,100.00%
apigateway.hpgamestream.com,4,0.00%,4,0,100.00%
x.clearbitjs.com,4,0.00%,4,0,100.00%
people-service-prod-asse-arm-a.southeastasia.cloudapp.azure.com,3,0.00%,3,0,100.00%
ip.azeus1-client-s.msnmessenger.msn.com.akadns.net,3,0.00%,3,0,100.00%
gs.a.sohu.com,3,0.00%,9,6,33.33%
mmsvg.n.shifen.com,3,0.00%,7,4,42.86%
mms-voice.cdn.bcebos.com,3,0.00%,3,0,100.00%
p5.a.yximgs.com,3,0.00%,5,2,60.00%
question.jd.com,3,0.00%,3,0,100.00%
dm.video.weibocdn.com,3,0.00%,8,5,37.50%
mall.jd.com,3,0.00%,3,0,100.00%
qrimg.jd.com,3,0.00%,3,0,100.00%
mapi.vip.com,3,0.00%,3,0,100.00%
mst.vip.com,3,0.00%,3,0,100.00%
vtmhz.ys7.com,3,0.00%,3,0,100.00%
smtp.cstnet.cn,3,0.00%,3,0,100.00%
uhf.microsoft.com,3,0.00%,5,2,60.00%
captive.apple.com,3,0.00%,1093,1090,0.27%
wd-prod-cp-as-southeast-1-fe.southeastasia.cloudapp.azure.com,3,0.00%,3,0,100.00%
aps.amap.com,3,0.00%,136,133,2.21%
jp3.gmdns.net,3,0.00%,3,0,100.00%
tw2.gmdns.net,3,0.00%,3,0,100.00%
in1.gmdns.net,3,0.00%,3,0,100.00%
gb.gmdns.net,3,0.00%,3,0,100.00%
stats.norton.com,3,0.00%,3,0,100.00%
publicassets.cdn-apple.com,3,0.00%,6,3,50.00%
pull-rtmp-l6.douyincdn.com.rtmpvcloud.ks-cdn.com,3,0.00%,10,7,30.00%
eu-u.openx.net,3,0.00%,3,0,100.00%
twct01.graniterapids.com,3,0.00%,3,0,100.00%
s.go-mpulse.net,3,0.00%,12,9,25.00%
a-0005.a-msedge.net,3,0.00%,3,0,100.00%
search.cnki.net,3,0.00%,3,0,100.00%
entitlement.auth.adobe.com,3,0.00%,3,0,100.00%
sp.auth.adobe.com,3,0.00%,3,0,100.00%
lynxbee.com,3,0.00%,3,0,100.00%
platform.bing.com,3,0.00%,163,160,1.84%
ns3-38.azure-dns.org,3,0.00%,16,13,18.75%
link-yqsx02.netease.im,3,0.00%,3,0,100.00%
oneclient.sfx.ms.edgekey.net,3,0.00%,6,3,50.00%
pull-flv-l6.douyincdn.com.hdlvcloud.ks-cdn.com,3,0.00%,8,5,37.50%
pccw02.graniterapids.com,3,0.00%,3,0,100.00%
ns-sb2-prod-hk2-005.cloudapp.net,3,0.00%,3,0,100.00%
geo-drcn.platform.hicloud.com,3,0.00%,3,0,100.00%
e4805.dsca.akamaiedge.net,3,0.00%,7,4,42.86%
vasvip-pub.wpscdn.cn,3,0.00%,7,4,42.86%
s-adashx.ut.taobao.com,3,0.00%,3,0,100.00%
p26-be-pack-sign.pglstatp-toutiao.com,3,0.00%,7,4,42.86%
cloudconfig-prod-alb-280729742.eu-west-1.elb.amazonaws.com,3,0.00%,3,0,100.00%
enterprise.proxmox.com,3,0.00%,11,8,27.27%
dsp-x.jd.com.gslb.qianxun.com,3,0.00%,3,0,100.00%
janapi.jd.com.gslb.qianxun.com,3,0.00%,3,0,100.00%
yqws126-dxospf.split.netease.com,3,0.00%,3,0,100.00%
s.mzstatic.itunes-apple.com.akadns.net,3,0.00%,5,2,60.00%
v5-colde.douyinvod.com,3,0.00%,6,3,50.00%
voipfinderliveplay.wxqcloud.qq.com,3,0.00%,8,5,37.50%
www.xbooktxt.net,3,0.00%,3,0,100.00%
db.auto.sina.com.cn,3,0.00%,3,0,100.00%
www.gjbmj.gov.cn,3,0.00%,6,3,50.00%
cl2.webterren.com,3,0.00%,3,0,100.00%
d.webterren.com,3,0.00%,3,0,100.00%
cl0.webterren.com,3,0.00%,3,0,100.00%
search.gjbmj.gov.cn,3,0.00%,3,0,100.00%
v11-x.douyinvod.com,3,0.00%,7,4,42.86%
any.cdn-go.cn.cloud.tc.qq.com,3,0.00%,9,6,33.33%
any.cdn-go.cn.mid.tdnsv6.com,3,0.00%,10,7,30.00%
a.svtrd.com,3,0.00%,3,0,100.00%
pull-flv-l26-cny.douyincdn.com.c.cdnhwc3.com,3,0.00%,8,5,37.50%
pixel-a.sitescout.com,3,0.00%,3,0,100.00%
ums.acuityplatform.com,3,0.00%,3,0,100.00%
c.statcounter.com,3,0.00%,3,0,100.00%
signal-prod-signal-prod-rel-asse-signalr-primary-2.service.signalr.net,3,0.00%,3,0,100.00%
api.my.avira.com,3,0.00%,3,0,100.00%
m.eyagu.com,3,0.00%,3,0,100.00%
p6-be-pack-sign.pglstatp-toutiao.com,3,0.00%,6,3,50.00%
ad.doubanio.com,3,0.00%,3,0,100.00%
p9-be-pack-sign.pglstatp-toutiao.com,3,0.00%,6,3,50.00%
pcs.baidu.com,3,0.00%,5,2,60.00%
yun.baidu.com,3,0.00%,5,2,60.00%
bj.baidupcs.com,3,0.00%,5,2,60.00%
e96286.i.akamaiedge.net,3,0.00%,3,0,100.00%
ftp.riken.jp,3,0.00%,3,0,100.00%
gn.symcb.com,3,0.00%,6,3,50.00%
se.symcb.com,3,0.00%,6,3,50.00%
p1.itc.cn,3,0.00%,8,5,37.50%
ip1865976420.funshion.com,3,0.00%,3,0,100.00%
arxiv-org.atlassian.net,3,0.00%,3,0,100.00%
gz-lb1.internet-g.spanner.alipaydns.com,3,0.00%,189,186,1.59%
h5hosting-drcn.dbankcdn.cn,3,0.00%,7,4,42.86%
deb.nodesource.com-v2.akamaized.NET,3,0.00%,3,0,100.00%
ru02.ptrecord.com,3,0.00%,3,0,100.00%
e1630.c.akamaiedge.net,3,0.00%,3,0,100.00%
waws-prod-blu-107.cloudapp.net,3,0.00%,3,0,100.00%
waws-prod-blu-171.eastus.cloudapp.azure.com,3,0.00%,3,0,100.00%
cdn.cnbj1.fds.api.mi-img.com,3,0.00%,9,6,33.33%
ns7.gdnsdef.com,3,0.00%,3,0,100.00%
ns10.gdnsdef.com,3,0.00%,3,0,100.00%
e10007.t.akamaiedge.net,3,0.00%,3,0,100.00%
blob.dsz04prdstr11a.store.core.windows.net,3,0.00%,3,0,100.00%
jp06.graniterapids.com,3,0.00%,3,0,100.00%
sg04.graniterapids.com,3,0.00%,3,0,100.00%
parent-api.huohua.cn,3,0.00%,3,0,100.00%
bifrost.vivaldi.com,3,0.00%,6,3,50.00%
p20.ssl.qhimgs3.com,3,0.00%,4,1,75.00%
p19.ssl.qhimgs3.com,3,0.00%,4,1,75.00%
md5.hackerwatch.org,3,0.00%,3,0,100.00%
api5-normal-hl.toutiaoapi.com,3,0.00%,3,0,100.00%
res.imtt.qq.com,3,0.00%,6,3,50.00%
api-drcn-music-dbankcloud-cn-drcn.appacc.dbankedge.net,3,0.00%,3,0,100.00%
mef7s4cr.sched.sma.tdnsstic1.cn,3,0.00%,3,0,100.00%
radio.itunes.apple.com.edgekey.net,3,0.00%,6,3,50.00%
pdns99.ultradns.org,3,0.00%,8,5,37.50%
krsk06.graniterapids.com,3,0.00%,3,0,100.00%
px.moatads.com,3,0.00%,3,0,100.00%
rum-collector-2.pingdom.net,3,0.00%,3,0,100.00%
vc.qpic.cn,3,0.00%,3,0,100.00%
www.hp.com,3,0.00%,8,5,37.50%
s.safe.360.cn,3,0.00%,10,7,30.00%
ads.betweendigital.com,3,0.00%,3,0,100.00%
sin3-ib.adnxs.com,3,0.00%,3,0,100.00%
e7808.dscg.akamaiedge.net,3,0.00%,6,3,50.00%
www.elsevier.com,3,0.00%,3,0,100.00%
cdn.plu.mx,3,0.00%,3,0,100.00%
cat.sg1.as.criteo.com,3,0.00%,3,0,100.00%
csm.as.criteo.net,3,0.00%,3,0,100.00%
browserr-drcn.dbankcdn.cn,3,0.00%,7,4,42.86%
browsercfg-drcn-cloud-dbankcloud-cn-drcn.appacc.dbankedge.net,3,0.00%,3,0,100.00%
browsercfg-drcn-cloud-dbankcloud-cn-drcn.appacc-region.dbankedge.net,3,0.00%,3,0,100.00%
s1.hdslb.com.04f6a54d.c.cdnhwc1.com,3,0.00%,3,0,100.00%
o59183.ingest.sentry.io,3,0.00%,3,0,100.00%
appdlc-drcn.hispace.hicloud.com,3,0.00%,3,0,100.00%
tyjr-cn-zhangjiakou.aliyun.com,3,0.00%,3,0,100.00%
mails.tsinghua.edu.cn,3,0.00%,3,0,100.00%
settings-ssl.xboxlive.com.edgekey.net,3,0.00%,6,3,50.00%
e87.dspb.akamaiedge.net,3,0.00%,6,3,50.00%
vm.gtimg.cn.cloud.tc.qq.com,3,0.00%,4,1,75.00%
s.amazon-adsystem.com,3,0.00%,3,0,100.00%
apiprx.ins.dell.com,3,0.00%,3,0,100.00%
www.icloud.com,3,0.00%,28,25,10.71%
hg05.ptrecord.com,3,0.00%,3,0,100.00%
sdk.open.talk.getui.net,3,0.00%,6,3,50.00%
sdk.open.talk.gepush.com,3,0.00%,6,3,50.00%
p3.qhmsg.com,3,0.00%,4,1,75.00%
fundmobapi.eastmoney.com,3,0.00%,3,0,100.00%
druid.if.qidian.com,3,0.00%,6,3,50.00%
www.weibo.com,3,0.00%,367,364,0.82%
yys.res.netease.com,3,0.00%,6,3,50.00%
p63-contacts.icloud.com,3,0.00%,6,3,50.00%
e17437.dsct.akamaiedge.net,3,0.00%,8,5,37.50%
us04-logfiles-va-6.zoom.us,3,0.00%,3,0,100.00%
allcdn.lv2.qnydns.com,3,0.00%,7,4,42.86%
nadvideo2.baidu.com.a.bdydns.com,3,0.00%,4,1,75.00%
pics0.baidu.com.a.bdydns.com,3,0.00%,5,2,60.00%
inews.gtimg.com.sched.legopic2.tdnsv6.com,3,0.00%,3,0,100.00%
title.auth.xboxlive.com.akadns.net,3,0.00%,3,0,100.00%
pba.v.aaplimg.com,3,0.00%,3,0,100.00%
n47yc0ab.sched.skalego-dk.tdnsstic1.cn.cjt.vwnti.yrzhcloud.cn,3,0.00%,6,3,50.00%
api.momentumdash.com,3,0.00%,3,0,100.00%
mirrors.tencent.com,3,0.00%,3,0,100.00%
hr14.graniterapids.com,3,0.00%,3,0,100.00%
um23.eset.com,3,0.00%,3,0,100.00%
mall.dongqiudi.com,3,0.00%,3,0,100.00%
xyimg1.qunliao.info,3,0.00%,4,1,75.00%
link-qiyu.netease.im,3,0.00%,3,0,100.00%
e2c26.gcp.gvt2.com,3,0.00%,3,0,100.00%
r3802239.iavs9x.u.avast.com,3,0.00%,6,3,50.00%
l7814800.iavs9x.u.avast.com,3,0.00%,8,5,37.50%
pkg.origin.jenkins.io,3,0.00%,3,0,100.00%
nextkg-base.app.kdsec.org,3,0.00%,3,0,100.00%
lf6-orange.byteorge.com,3,0.00%,6,3,50.00%
lf3-article.toutiaostatic.com,3,0.00%,6,3,50.00%
dlcdnets.asus.com.cn,3,0.00%,3,0,100.00%
advertnew.wanfangdata.com.cn,3,0.00%,3,0,100.00%
login.wanfangdata.com.cn,3,0.00%,3,0,100.00%
tls10.newrelic.com.cdn.cloudflare.net,3,0.00%,3,0,100.00%
top-widgets-api.xiaozujian.com,3,0.00%,3,0,100.00%
a.tampermonkey.net,3,0.00%,3,0,100.00%
jnvtm.ys7.com,3,0.00%,3,0,100.00%
r4---sn-j5o7dn7l.gvt1.com,3,0.00%,3,0,100.00%
twct04.graniterapids.com,3,0.00%,3,0,100.00%
sg08.graniterapids.com,3,0.00%,3,0,100.00%
923038.smushcdn.com,3,0.00%,3,0,100.00%
bg3.market.xiaomi.com,3,0.00%,3,0,100.00%
www.chinanews.com.cn,3,0.00%,159,156,1.89%
proxy.finance.qq.com,3,0.00%,3,0,100.00%
photo.home.163.com,3,0.00%,3,0,100.00%
temp.163.com,3,0.00%,3,0,100.00%
house.163.com,3,0.00%,3,0,100.00%
ssl.mail.163.com,3,0.00%,3,0,100.00%
stun-2.chat.bilibili.com,3,0.00%,3,0,100.00%
stun-1.chat.bilibili.com,3,0.00%,3,0,100.00%
cdn-go.cn.sched.legopic1.tdnsv6.com,3,0.00%,3,0,100.00%
76.push2.eastmoney.com,3,0.00%,5,2,60.00%
72.push2.eastmoney.com,3,0.00%,5,2,60.00%
twgame01.graniterapids.com,3,0.00%,3,0,100.00%
hub-mirror.c.163.com,3,0.00%,3,0,100.00%
rc10-fc.oray.com,3,0.00%,3,0,100.00%
www.desmos.com,3,0.00%,3,0,100.00%
mercury.jd.com.gslb.qianxun.com,3,0.00%,5,2,60.00%
lf3-cdn-tos.bytecdntp.com,3,0.00%,4,1,75.00%
p9.toutiaoimg.com,3,0.00%,4,1,75.00%
www.intelrealsense.com,3,0.00%,6,3,50.00%
et-ae.mail.protection.outlook.com,3,0.00%,3,0,100.00%
d3g.qq.com,3,0.00%,8,5,37.50%
captive-cdn.origin-apple.com.akadns.net,3,0.00%,29,26,10.34%
captive.g.aaplimg.com,3,0.00%,38,35,7.89%
cn-jssz-cm-02-08.bilivideo.com,3,0.00%,3,0,100.00%
a.cdd5090t.tk,3,0.00%,3,0,100.00%
osiprod-krs-manatee-000.cloudapp.net,3,0.00%,3,0,100.00%
gzcm.maikrappss.xyz,3,0.00%,3,0,100.00%
recom.cnki.net,3,0.00%,3,0,100.00%
bar.cnki.net,3,0.00%,3,0,100.00%
cohort.awsmcafeeccs.mcafee.com,3,0.00%,3,0,100.00%
policy.awsmcafeeccs.mcafee.com,3,0.00%,3,0,100.00%
49.newspush.eastmoney.com,3,0.00%,3,0,100.00%
4.push2.eastmoney.com,3,0.00%,6,3,50.00%
91.push2.eastmoney.com,3,0.00%,6,3,50.00%
in01.graniterapids.com,3,0.00%,3,0,100.00%
ts.yle888.vip,3,0.00%,3,0,100.00%
gnar-writr.data.grammarlyaws.com,3,0.00%,3,0,100.00%
top.news.sina.com.cn,3,0.00%,3,0,100.00%
js.dhsz.cn,3,0.00%,3,0,100.00%
r.dmp.sina.cn,3,0.00%,3,0,100.00%
i-sat02p-cor003.api.p001.1drv.com,3,0.00%,3,0,100.00%
v5.douyinvod.com,3,0.00%,3,0,100.00%
fund.cingta.com,3,0.00%,3,0,100.00%
s5.cnzz.com,3,0.00%,3,0,100.00%
img.douding.cn,3,0.00%,3,0,100.00%
apm.yun.hihonor.com,3,0.00%,3,0,100.00%
ai-drcn.op.hihonorcloud.com,3,0.00%,3,0,100.00%
rtpingback.qq.ime.sogou.com,3,0.00%,3,0,100.00%
adsfilebssdlbig.ali.kugou.com,3,0.00%,6,3,50.00%
statics.itc.cn,3,0.00%,6,3,50.00%
s.go.sohu.com,3,0.00%,3,0,100.00%
p8.itc.cn,3,0.00%,7,4,42.86%
softfile.3g.qq.com,3,0.00%,4,1,75.00%
id.razer.com,3,0.00%,3,0,100.00%
cnc-excel.partner.officewebapps.cn,3,0.00%,3,0,100.00%
o7oo35.bytedance.com,3,0.00%,3,0,100.00%
hkgame04.graniterapids.com,3,0.00%,3,0,100.00%
pccw07.graniterapids.com,3,0.00%,3,0,100.00%
kr07.graniterapids.com,3,0.00%,3,0,100.00%
index-cdn.jetbrains.com,3,0.00%,6,3,50.00%
www.current.a.prd.aadg.akadns.net,3,0.00%,3,0,100.00%
promotion.aliyun.com,3,0.00%,3,0,100.00%
im.tieba.baidu.com,3,0.00%,3,0,100.00%
update.baidu.com,3,0.00%,3,0,100.00%
scc.bytedance.com,3,0.00%,3,0,100.00%
cn-jssz-cm-02-12.bilivideo.com,3,0.00%,3,0,100.00%
soft.qianxin.com,3,0.00%,5,2,60.00%
imp.optaim.com,3,0.00%,3,0,100.00%
imp.go.sohu.com,3,0.00%,3,0,100.00%
update.platform.hihonorcloud.com,3,0.00%,3,0,100.00%
s4.ssl.qhres2.com,3,0.00%,5,2,60.00%
shared.ydstatic.com,3,0.00%,3,0,100.00%
hubble-js-bucket.nosdn.127.net,3,0.00%,3,0,100.00%
shared-https.ydstatic.com,3,0.00%,3,0,100.00%
safe-browsing-quorum.privacy.ghostery.net,3,0.00%,8,5,37.50%
mp-activity.csdn.net,3,0.00%,3,0,100.00%
stun.l.google.com,3,0.00%,6,3,50.00%
zt.baidu.com,3,0.00%,7,4,42.86%
img.qidian.com,3,0.00%,6,3,50.00%
agusiq-torrents.pl,3,0.00%,3,0,100.00%
www.anquan.org,3,0.00%,3,0,100.00%
qypxcwweb.dongao.com,3,0.00%,3,0,100.00%
pgy-pubsub01.oray.net,3,0.00%,3,0,100.00%
cnrefhk01.standurl.xyz,3,0.00%,3,0,100.00%
iduxi4y.qiniudns.com,3,0.00%,8,5,37.50%
tiny57.china.line.qiniudns.com,3,0.00%,7,4,42.86%
guide-acs.m.taobao.com.gds.alibabadns.com,3,0.00%,6,3,50.00%
ironbank-guide-v6-publish.m.taobao.com,3,0.00%,6,3,50.00%
ironbank-guide-v6-publish.m.taobao.com.gds.alibabadns.com,3,0.00%,6,3,50.00%
cd.xdplt.com,3,0.00%,3,0,100.00%
shop205905979.v.weidian.com,3,0.00%,3,0,100.00%
s.geilicdn.com,3,0.00%,3,0,100.00%
assets.geilicdn.com,3,0.00%,3,0,100.00%
80.push2.eastmoney.com,3,0.00%,6,3,50.00%
phsle5-std03.oray.net,3,0.00%,3,0,100.00%
bili.cold.c.cdnhwc2.com,3,0.00%,6,3,50.00%
pd.ads.cn.miaozhen.com,3,0.00%,3,0,100.00%
h5hosting.dbankcdn.com,3,0.00%,6,3,50.00%
seccloud.ipd.hihonor.com,3,0.00%,3,0,100.00%
api.fayin.donglin.org,3,0.00%,3,0,100.00%
p33-ckdatabase.icloud.com,3,0.00%,5,2,60.00%
ns5.cstnet.cn,3,0.00%,3,0,100.00%
trending-prd.internet.apps.samsung.com,3,0.00%,6,3,50.00%
config.jpush.cn,3,0.00%,3,0,100.00%
wannos.127.net,3,0.00%,3,0,100.00%
signaler-pa.googleapis.com,3,0.00%,6,3,50.00%
hkgame02.graniterapids.com,3,0.00%,3,0,100.00%
jp29.graniterapids.com,3,0.00%,3,0,100.00%
pushbos.baidu.com,3,0.00%,3,0,100.00%
api-shb1.pinduoduo.com,3,0.00%,3,0,100.00%
toolbar3.diigo.com,3,0.00%,3,0,100.00%
trace.threatbook.cn,3,0.00%,3,0,100.00%
s.threatbook.com,3,0.00%,3,0,100.00%
ossimg.hitv.com,3,0.00%,3,0,100.00%
seed-swallow.siri.apple.com,3,0.00%,3,0,100.00%
ua2ahgha.nodedata.net,3,0.00%,3,0,100.00%
onedriveclucproddm20050.blob.core.windows.net,3,0.00%,3,0,100.00%
mmapi3.mcxxkjs.cn,3,0.00%,3,0,100.00%
push-resources.sched.dma.tdnsdl1.cn.cdl.vwnti.yrzhcloud.cn,3,0.00%,3,0,100.00%
mstat.tpns.tencent.com,3,0.00%,3,0,100.00%
image.9xsecndns.cn.w.cdngslb.com,3,0.00%,8,5,37.50%
www.ieee-security.org,3,0.00%,3,0,100.00%
image.laifeng.com,3,0.00%,5,2,60.00%
image.laifeng.com.w.cdngslb.com,3,0.00%,5,2,60.00%
p5.music.126.net.163jiasu.com,3,0.00%,6,3,50.00%
cmts.iqiyi.com,3,0.00%,6,3,50.00%
tpa-hcdn.iqiyi.com,3,0.00%,6,3,50.00%
bohuiws.tywangcai.com,3,0.00%,3,0,100.00%
ers.baidu.com,3,0.00%,3,0,100.00%
accwww11c1.53kf.com,3,0.00%,3,0,100.00%
09046df9c5214c40b90721aa531f96fa.fp.measure.office.com,3,0.00%,3,0,100.00%
intf-pc.pdfxd.com,3,0.00%,3,0,100.00%
pdns196.ultradns.biz,3,0.00%,9,6,33.33%
downctrl.wan.sogou.com,3,0.00%,3,0,100.00%
manage.mcxxkjs.cn,3,0.00%,3,0,100.00%
i.gridsumdissector.com,3,0.00%,3,0,100.00%
vi.l.qq.com,3,0.00%,3,0,100.00%
magpie.xhscdn.com,3,0.00%,6,3,50.00%
skpselect.skp-beijing.com,3,0.00%,3,0,100.00%
fanyi-cdn.cdn.bcebos.com,3,0.00%,8,5,37.50%
sz-qiniu-v4.volcgtm.com,3,0.00%,3,0,100.00%
tender-bucket.oss-cn-beijing.aliyuncs.com,3,0.00%,3,0,100.00%
cdn.akamai.steamstatic.com,3,0.00%,3,0,100.00%
49.push2.eastmoney.com,3,0.00%,5,2,60.00%
chatlink-yqsx04.netease.im,3,0.00%,3,0,100.00%
checkpoint-api.weave.works,3,0.00%,3,0,100.00%
chatlink-yqsx10.netease.im,3,0.00%,3,0,100.00%
u.openx.net,3,0.00%,3,0,100.00%
pkg.jenkins-ci.org,3,0.00%,3,0,100.00%
d2h67oheeuigaw.cloudfront.NET,3,0.00%,4,1,75.00%
c45fe124bbee464b9b4829d6d2df53bb.fp.measure.office.com,3,0.00%,3,0,100.00%
dnd.tools.avast.com,3,0.00%,6,3,50.00%
english.sina.com,3,0.00%,5,2,60.00%
api.xueqiu.com,3,0.00%,3,0,100.00%
crl.sca1b.amazontrust.com,3,0.00%,3,0,100.00%
WWW.SLAShDoT.ORG,3,0.00%,3,0,100.00%
www.mIt.EdU,3,0.00%,3,0,100.00%
www.SlAShdot.OrG,3,0.00%,3,0,100.00%
www.MiT.eDu,3,0.00%,3,0,100.00%
pccw06.graniterapids.com,3,0.00%,3,0,100.00%
aweme.snssdk.com,3,0.00%,3,0,100.00%
config.uca.cloud.unity3d.com,3,0.00%,3,0,100.00%
fplus.funshion.com,3,0.00%,3,0,100.00%
developer.android.com,3,0.00%,4,1,75.00%
www.zhenpin.com,3,0.00%,3,0,100.00%
cloud.tgpa.qq.com,3,0.00%,3,0,100.00%
WWW.sLasHdOt.ORg,3,0.00%,3,0,100.00%
Www.mIT.eDu,3,0.00%,3,0,100.00%
updates.istatmenus.app,3,0.00%,3,0,100.00%
d2zur9cc2gf1tx.cloudfront.net,3,0.00%,3,0,100.00%
ced.sascdn.com,3,0.00%,3,0,100.00%
p9-sign.douyinpic.com,3,0.00%,6,3,50.00%
p3-pc.douyinpic.com,3,0.00%,8,5,37.50%
updates.ghub.logitechg.com,3,0.00%,6,3,50.00%
www.pcauto.com.cn.ctdns.cn,3,0.00%,3,0,100.00%
drlt.irs03.com,3,0.00%,3,0,100.00%
windows.msn.com,3,0.00%,5,2,60.00%
api-prod.nvidia.com,3,0.00%,3,0,100.00%
p2psdk.wscdns.com,3,0.00%,3,0,100.00%
dq33tynpwunh.cloudfront.net,3,0.00%,3,0,100.00%
apt.repos.intel.com,3,0.00%,5,2,60.00%
ns4-38.azure-dns.info,3,0.00%,16,13,18.75%
WWW.MIT.Edu,3,0.00%,3,0,100.00%
Www.sLASHdot.Org,3,0.00%,3,0,100.00%
i-dsm01p-cor007.api.p001.1drv.com,3,0.00%,3,0,100.00%
hcdnd101.gslb.c.cdnhwc2.com,3,0.00%,3,0,100.00%
kr06.graniterapids.com,3,0.00%,3,0,100.00%
static-doubleclick-net.l.google.com,3,0.00%,4,1,75.00%
p3-sign.douyinpic.com,3,0.00%,8,5,37.50%
ccdace.hupu.com,3,0.00%,3,0,100.00%
i1.hoopchina.com.cn,3,0.00%,6,3,50.00%
i3.hoopchina.com.cn,3,0.00%,6,3,50.00%
w4.hoopchina.com.cn,3,0.00%,6,3,50.00%
shence.hupu.com,3,0.00%,3,0,100.00%
msa.hupu.com,3,0.00%,6,3,50.00%
themis.hupu.com,3,0.00%,6,3,50.00%
wsproxy.douyu.com,3,0.00%,3,0,100.00%
wappass.bdimg.com,3,0.00%,6,3,50.00%
ali-cyb-cdn.kaikeba.com,3,0.00%,3,0,100.00%
www.xiazaiba.com,3,0.00%,3,0,100.00%
www.uqidong.com,3,0.00%,3,0,100.00%
act.cmcmcdn.com,3,0.00%,3,0,100.00%
www.keniu.com,3,0.00%,3,0,100.00%
sentry.jianguoyun.com,3,0.00%,3,0,100.00%
phsle5-std06.oray.net,3,0.00%,3,0,100.00%
sync.crwdcntrl.net,3,0.00%,3,0,100.00%
zemanta-nychi.zemanta.com,3,0.00%,3,0,100.00%
mobile.api.hunantv.com,3,0.00%,3,0,100.00%
kr01.graniterapids.com,3,0.00%,3,0,100.00%
res.mail.qq.com,3,0.00%,3,0,100.00%
jqmt.qq.com,3,0.00%,3,0,100.00%
update.dbankcdn.com,3,0.00%,6,3,50.00%
um08.eset.com,3,0.00%,3,0,100.00%
s5.music.126.net,3,0.00%,6,3,50.00%
geo.hicloud.com,3,0.00%,3,0,100.00%
login.360.com,3,0.00%,3,0,100.00%
osiprod-krc-blush-azsc-004.koreacentral.cloudapp.azure.com,3,0.00%,3,0,100.00%
flink-learning.org.cn,3,0.00%,3,0,100.00%
video-hw-drcn.dbankcdn.cn.volcgslb.com,3,0.00%,8,5,37.50%
ip1973517769.funshion.com,3,0.00%,3,0,100.00%
hwvv.yilanvaas.com.bsclink.cn,3,0.00%,7,4,42.86%
dsm04pap002.storage.live.com,3,0.00%,3,0,100.00%
v5.kwaicdn.com,3,0.00%,5,2,60.00%
imgx.kwd.inkuai.com,3,0.00%,3,0,100.00%
p2-live.a.yximgs.com,3,0.00%,3,0,100.00%
ali2-course.video.yximgs.com,3,0.00%,3,0,100.00%
alimov6.a.yximgs.com,3,0.00%,3,0,100.00%
services10.ieee.org,3,0.00%,3,0,100.00%
api.kmovie.gifshow.com,3,0.00%,3,0,100.00%
app.kwaixiaodian.com,3,0.00%,3,0,100.00%
cny-pro.kwd.inkuai.com,3,0.00%,3,0,100.00%
ec.kwd.inkuai.com,3,0.00%,3,0,100.00%
hybrid.kwd.inkuai.com,3,0.00%,3,0,100.00%
js-im-simi.xxpkg.com,3,0.00%,3,0,100.00%
js-im.xxpkg.com,3,0.00%,3,0,100.00%
keep-so.kwd.inkuai.com,3,0.00%,3,0,100.00%
kkd.kwd.inkuai.com,3,0.00%,3,0,100.00%
push.kwd.inkuai.com,3,0.00%,3,0,100.00%
tx-p2p.pull.yximgs.com,3,0.00%,3,0,100.00%
dq.sched.vip-dk.tdnsvod1.cn,3,0.00%,8,5,37.50%
tx-game.push.yximgs.com,3,0.00%,3,0,100.00%
yoda.kwd.inkuai.com,3,0.00%,3,0,100.00%
zt-sup.kwd.inkuai.com,3,0.00%,3,0,100.00%
wcnc2023.ieee-wcnc.org,3,0.00%,3,0,100.00%
notion-indexers-916662305.us-east-1.elb.amazonaws.com,3,0.00%,3,0,100.00%
www2.kugou.kugou.com,3,0.00%,7,4,42.86%
h2tcbox.n.shifen.com,3,0.00%,3,0,100.00%
gpgw2.anu.edu.au,3,0.00%,3,0,100.00%
wc-update-service.lavasoft.com,3,0.00%,3,0,100.00%
gbl9837ws.proctor.io,3,0.00%,3,0,100.00%
jsdk.baidu.com,3,0.00%,3,0,100.00%
files.outfit.io,3,0.00%,3,0,100.00%
ns7-66.akam.net,3,0.00%,3,0,100.00%
i-bl6p-cor001.api.p001.1drv.com,3,0.00%,3,0,100.00%
us03.graniterapids.com,3,0.00%,3,0,100.00%
mobilegw.src.alipaydns.com,3,0.00%,3,0,100.00%
avator.eastmoney.com.m.alikunlun.com,3,0.00%,6,3,50.00%
p10445-holo.ejoy.com,3,0.00%,3,0,100.00%
na61-na62.wagbridge.work.alibabacorp.com,3,0.00%,3,0,100.00%
dotserver.douyucdn.cn.w.cdngslb.com,3,0.00%,3,0,100.00%
sfcpwg.gifshow.com,3,0.00%,3,0,100.00%
focus.tianya.cn,3,0.00%,3,0,100.00%
www.huya.com,3,0.00%,7,4,42.86%
code.bdstatic.com.a.bdydns.com,3,0.00%,3,0,100.00%
mbdp01.bdstatic.com.a.bdydns.com,3,0.00%,3,0,100.00%
conn.wemeet.tencent.com,3,0.00%,3,0,100.00%
provcs-prod-r53-ext.awscommon.mcafee.com,3,0.00%,3,0,100.00%
api.ticktick.com,3,0.00%,3,0,100.00%
upos-sz-staticcos.bilivideo.com.cdn.dnsv1.com,3,0.00%,6,3,50.00%
omu3uk94.sched.dma-dk.tdnsdl1.cn,3,0.00%,6,3,50.00%
mv6.music.tc.qq.com,3,0.00%,6,3,50.00%
sjy6.stream.qqmusic.qq.com,3,0.00%,6,3,50.00%
boot-video2.xuexi.cn,3,0.00%,3,0,100.00%
p3-buy.itunes-apple.com.akadns.net,3,0.00%,3,0,100.00%
logv2.ireader.com,3,0.00%,3,0,100.00%
pjp1-word-eap.officeapps.live.com,3,0.00%,3,0,100.00%
mixv4-12.194610.xyz,3,0.00%,3,0,100.00%
mixv4-28.194610.xyz,3,0.00%,3,0,100.00%
i-bnz05p-cor001.api.p001.1drv.com,3,0.00%,3,0,100.00%
med-fe.cdn.bcebos.com.a.bdydns.com,3,0.00%,4,1,75.00%
eyeprotect-wallpaper-theme.duba.com,3,0.00%,3,0,100.00%
e.customeriomail.com,3,0.00%,3,0,100.00%
static.n.shifen.com,3,0.00%,14,11,21.43%
opencdnbdimgtn.gshifen.com,3,0.00%,3,0,100.00%
ynuf.alipay.com,3,0.00%,3,0,100.00%
12.push2.eastmoney.com,3,0.00%,5,2,60.00%
88.push2.eastmoney.com,3,0.00%,4,1,75.00%
gslb-dsa.zhihu.com,3,0.00%,12,9,25.00%
api.weathercn.com.mcchcdn.com,3,0.00%,5,2,60.00%
api.weathercn.com.azchcdna.com,3,0.00%,5,2,60.00%
vsassetscdn.azure.cn,3,0.00%,3,0,100.00%
extensions.redeviation.com,3,0.00%,3,0,100.00%
xnet-flv264.liveplay.egame.qq.com,3,0.00%,3,0,100.00%
txpcdn-direct.liveplay.egame.qq.com,3,0.00%,3,0,100.00%
txp2p2.liveplay.egame.qq.com,3,0.00%,3,0,100.00%
flv265-txpcdn.liveplay.egame.qq.com,3,0.00%,3,0,100.00%
txp2p1.liveplay.egame.qq.com,3,0.00%,3,0,100.00%
log.qvb.qcloud.com,3,0.00%,3,0,100.00%
m8.music.126.net.163jiasu.com,3,0.00%,5,2,60.00%
ms-toolsai.gallery.vsassets.io,3,0.00%,3,0,100.00%
ms-vscode.gallery.vsassets.io,3,0.00%,3,0,100.00%
acd.op.hicloud.com,3,0.00%,3,0,100.00%
api.huangye.miui.com,3,0.00%,3,0,100.00%
jjxxw.cq.gov.cn,3,0.00%,7,4,42.86%
hw-origin.pull.yximgs.com,3,0.00%,6,3,50.00%
a18-64.akam.net,3,0.00%,3,0,100.00%
pf2sg2-edge.activity.windows.com.akadns.net,3,0.00%,3,0,100.00%
27.push2.eastmoney.com,3,0.00%,5,2,60.00%
87.push2.eastmoney.com,3,0.00%,5,2,60.00%
phsle5-adv02.oray.net,3,0.00%,3,0,100.00%
amigacity.xyz,3,0.00%,3,0,100.00%
tracker.mg64.net,3,0.00%,3,0,100.00%
z.crazyhd.com,3,0.00%,3,0,100.00%
tracker.halfchub.club,3,0.00%,3,0,100.00%
slp2p-east-std40.oray.net,3,0.00%,3,0,100.00%
api.juejin.cn,3,0.00%,3,0,100.00%
sqdd.myapptc.qq.com,3,0.00%,6,3,50.00%
e-0001.e-msedge.net,3,0.00%,3,0,100.00%
odc-phx02pap002-meta-geo.onedrive.akadns.net,3,0.00%,6,3,50.00%
www.sobot.com,3,0.00%,3,0,100.00%
appcloud2.zhihu.com,3,0.00%,6,3,50.00%
forum-api-drcn.jos.hicloud.com,3,0.00%,3,0,100.00%
i5.hoopchina.com.cn,3,0.00%,6,3,50.00%
zm.hoopchina.com,3,0.00%,6,3,50.00%
zm-ipv4.hoopchina.com,3,0.00%,3,0,100.00%
r.img.cctvpic.com,3,0.00%,6,3,50.00%
puma-api.iqiyi.com,3,0.00%,8,5,37.50%
cooperation.ssports.com,3,0.00%,6,3,50.00%
security.iqiyi.com,3,0.00%,6,3,50.00%
www.sinfors.com.cn.cdn20.com,3,0.00%,3,0,100.00%
obs.lz03-br-dy-009.cn-north-2.myhuaweicloud.com,3,0.00%,3,0,100.00%
h12o01dt.sched.sma.tdnsstic1.cn,3,0.00%,3,0,100.00%
cdn-file.cchytech.com.cdn.dnsv1.com.cn,3,0.00%,3,0,100.00%
static.youlai.cn,3,0.00%,3,0,100.00%
fs-wildcard.microsoft.com.edgekey.net,3,0.00%,3,0,100.00%
hdl5.douyucdn.cn,3,0.00%,3,0,100.00%
stat.tiara.kakao.com,3,0.00%,6,3,50.00%
vcs.snssdk.com.w.cdngslb.com,3,0.00%,3,0,100.00%
sso.toutiao.com.w.cdngslb.com,3,0.00%,3,0,100.00%
zttapk.v.bsgslb.com,3,0.00%,5,2,60.00%
cos.wtaluo.com,3,0.00%,3,0,100.00%
t-haozip.2345.com,3,0.00%,3,0,100.00%
e2c35.gcp.gvt2.com,3,0.00%,3,0,100.00%
zhushou.ludashi.com,3,0.00%,3,0,100.00%
api.staticj.top,3,0.00%,3,0,100.00%
services.mathworks.com,3,0.00%,3,0,100.00%
p3-dcd-sign.byteimg.com.w.kunluncan.com,3,0.00%,3,0,100.00%
ip2091219979.funshion.com,3,0.00%,3,0,100.00%
api-fd.dutils.com,3,0.00%,3,0,100.00%
v6.bdxiguavod.com,3,0.00%,6,3,50.00%
v9.bdxiguavod.com,3,0.00%,6,3,50.00%
e1324.dscd.akamaiedge.net,3,0.00%,6,3,50.00%
u5.iqiyipic.com,3,0.00%,6,3,50.00%
api.97bike.com,3,0.00%,3,0,100.00%
o58bvl93.sched.sma-dk.tdnsstic1.cn,3,0.00%,7,4,42.86%
v.sogowan.com.w.kunlunaq.com,3,0.00%,3,0,100.00%
iqiyi6.top,3,0.00%,3,0,100.00%
plus.uploadtu.cn.cdn.fun,3,0.00%,3,0,100.00%
www.mgtv.com.wscdns.com,3,0.00%,6,3,50.00%
fs.fspcdn.com,3,0.00%,3,0,100.00%
www.isc.org.cn,3,0.00%,3,0,100.00%
www.gzjiasida.com,3,0.00%,3,0,100.00%
qqtv1.xyz,3,0.00%,3,0,100.00%
bouncer-bouncer-elb.prod.mozaws.net,3,0.00%,3,0,100.00%
i.alicdn.com.danuoyi.tbcache.com,3,0.00%,3,0,100.00%
playhistory.bz.mgtv.com,3,0.00%,3,0,100.00%
v2.da.mgtv.com,3,0.00%,3,0,100.00%
b-gtc.gepush.com,3,0.00%,6,3,50.00%
s.ssl.qhimg.com.webcdn.360qhcdn.com,3,0.00%,6,3,50.00%
max.mdvdns.qhcdn.com,3,0.00%,3,0,100.00%
us07.graniterapids.com,3,0.00%,3,0,100.00%
s.cpx.to,3,0.00%,3,0,100.00%
v10-win.vortex.data.trafficmanager.net,3,0.00%,3,0,100.00%
s-gm.mmstat.com.gds.alibabadns.com,3,0.00%,3,0,100.00%
displaycatalog-rp.md.mp.microsoft.com.akadns.net,3,0.00%,3,0,100.00%
api.hpbp.io,3,0.00%,3,0,100.00%
aphone.v1.mgtv.com.HOST,3,0.00%,3,0,100.00%
overseavivo.chinanetcenter.com,3,0.00%,3,0,100.00%
images.cnblogs.com,3,0.00%,3,0,100.00%
q8daiuc5.sched.sma.tdnsstic1.cn.cjt.krcdn.idatacube.com,3,0.00%,3,0,100.00%
sofire.jomodns.com,3,0.00%,6,3,50.00%
71.push2.eastmoney.com,3,0.00%,6,3,50.00%
geo-drcn.platform.dbankcloud.cn,3,0.00%,3,0,100.00%
wss.ticktick.com,3,0.00%,3,0,100.00%
img-home.csdnimg.cn.trpcdn.net,3,0.00%,3,0,100.00%
res.cjyun.org,3,0.00%,5,2,60.00%
event-drcn.push.dbankcloud.com,3,0.00%,3,0,100.00%
a1830.dscg2.akamai.net,3,0.00%,7,4,42.86%
upfile-drcn.platform.hicloud.com,3,0.00%,3,0,100.00%
cloudcache.tencent-cloud.cn,3,0.00%,3,0,100.00%
hivision-drcn.emui.hicloud.com,3,0.00%,3,0,100.00%
m-cloud.zhihu.com,3,0.00%,7,4,42.86%
p3-open.byteimg.com,3,0.00%,4,1,75.00%
rtb.openx.net,3,0.00%,3,0,100.00%
lupic.cdn.bcebos.com.a.bdydns.com,3,0.00%,6,3,50.00%
kenshi.huijiwiki.com,3,0.00%,3,0,100.00%
taiwu.huijiwiki.com,3,0.00%,3,0,100.00%
gbf.huijiwiki.com,3,0.00%,3,0,100.00%
opencdn00.jomodns.com,3,0.00%,3,0,100.00%
iknowstatic.jomodns.com,3,0.00%,3,0,100.00%
82.newspush.eastmoney.com,3,0.00%,3,0,100.00%
e2c2.gcp.gvt2.com,3,0.00%,3,0,100.00%
musicpunch.p2p.qq.com,3,0.00%,3,0,100.00%
tb-video.bdstatic.com,3,0.00%,4,1,75.00%
figshare.com,3,0.00%,6,3,50.00%
ip.azscus1-client-s.msnmessenger.msn.com.akadns.net,3,0.00%,3,0,100.00%
e4016.a.akamaiedge.net,3,0.00%,3,0,100.00%
m.addthisedge.com,3,0.00%,3,0,100.00%
ds-m.addthisedge.com.edgekey.net,3,0.00%,3,0,100.00%
shop.kongfz.com,3,0.00%,3,0,100.00%
wwc.alicdn.com.danuoyi.tbcache.com,3,0.00%,5,2,60.00%
zhstatic.zhihu.com,3,0.00%,8,5,37.50%
e4578.dscg.akamaiedge.net,3,0.00%,6,3,50.00%
fpdownload.macromedia.com,3,0.00%,6,3,50.00%
sdn.kugou.com,3,0.00%,3,0,100.00%
global_wrr.mask.apple-dns.net,3,0.00%,6,3,50.00%
company.stcn.com,3,0.00%,3,0,100.00%
certify.alexametrics.com,3,0.00%,3,0,100.00%
tlu.dl.delivery.mp.microsoft.com.download.ks-cdn.com,3,0.00%,6,3,50.00%
bifrost-public-v4.gw.postman.com,3,0.00%,6,3,50.00%
sentry-app.postmanlabs.com,3,0.00%,3,0,100.00%
dd-search.jd.com,3,0.00%,5,2,60.00%
csc.jd.com,3,0.00%,6,3,50.00%
list.jd.com,3,0.00%,5,2,60.00%
buildlogs.centos.org,3,0.00%,3,0,100.00%
datarouter-prod.ak.epicgames.com,3,0.00%,6,3,50.00%
WwW.MIT.EDu,3,0.00%,3,0,100.00%
Www.slaSHdot.org,3,0.00%,3,0,100.00%
qpsearch.jd.com,3,0.00%,5,2,60.00%
consent.cookiebot.com,3,0.00%,5,2,60.00%
blade.liepin.com,3,0.00%,3,0,100.00%
apic.liepin.com,3,0.00%,3,0,100.00%
ir.liepin.com,3,0.00%,3,0,100.00%
vap.liepin.com,3,0.00%,3,0,100.00%
tls13.taboola.map.fastly.net,3,0.00%,3,0,100.00%
wWW.vOD.LxdNS.coM,3,0.00%,6,3,50.00%
static.kesci.com,3,0.00%,3,0,100.00%
www.12306.cn,3,0.00%,5,2,60.00%
fsoufsou.com,3,0.00%,6,3,50.00%
hkgame03.graniterapids.com,3,0.00%,3,0,100.00%
studio.youtube.com,3,0.00%,6,3,50.00%
e11410.a.akamaiedge.net,3,0.00%,3,0,100.00%
trial-eum-clienttons-s.akamaihd.net,3,0.00%,6,3,50.00%
prod.liveshare.vsengsaas.visualstudio.com,3,0.00%,3,0,100.00%
retcode.alicdn.com,3,0.00%,6,3,50.00%
sg02.graniterapids.com,3,0.00%,3,0,100.00%
jp24.graniterapids.com,3,0.00%,3,0,100.00%
d1.weather.com.cn,3,0.00%,3,0,100.00%
mpadmin.browser.360.cn,3,0.00%,3,0,100.00%
hao9.qhimg.com,3,0.00%,4,1,75.00%
jp23.graniterapids.com,3,0.00%,3,0,100.00%
rust-lang.gallery.vsassets.io,3,0.00%,3,0,100.00%
tu.duoduocdn.com,3,0.00%,6,3,50.00%
sportsuggest.hicloud.com,3,0.00%,3,0,100.00%
pccw03.graniterapids.com,3,0.00%,3,0,100.00%
onedriveclucprodbn20043.blob.core.windows.net,3,0.00%,3,0,100.00%
onedriveclucprodbn20006.blob.core.windows.net,3,0.00%,3,0,100.00%
cn4-rtc.partner.officewebapps.cn,3,0.00%,3,0,100.00%
n48scu3p.n.sudun-cname.com,3,0.00%,3,0,100.00%
gw.homeway.com.cn,3,0.00%,3,0,100.00%
photo27.hexun.com,3,0.00%,5,2,60.00%
g-api.csdn.net,3,0.00%,3,0,100.00%
jp10.graniterapids.com,3,0.00%,3,0,100.00%
sdkapiv2.bizport.cn,3,0.00%,3,0,100.00%
pcweb.bz.mgtv.com,3,0.00%,3,0,100.00%
emoji-dm.nie.netease.com,3,0.00%,3,0,100.00%
red-dot.webapp.163.com,3,0.00%,3,0,100.00%
partnerweb.vmware.com,3,0.00%,6,3,50.00%
twgame09.graniterapids.com,3,0.00%,3,0,100.00%
o1075689.ingest.sentry.io,3,0.00%,3,0,100.00%
canonical-lcy01.cdn.snapcraftcontent.com,3,0.00%,3,0,100.00%
aliyunzixunbucket.oss-cn-beijing.aliyuncs.com,3,0.00%,3,0,100.00%
puf6no0k.nodedata.net,3,0.00%,3,0,100.00%
cdn.meeting.tencent.com,3,0.00%,6,3,50.00%
push-content.springernature.io,3,0.00%,3,0,100.00%
pypi.douban.com,3,0.00%,3,0,100.00%
8e8lbgse.sched.d2.tdnsdp1.cn.cjt.vwnti.yrzhcloud.cn,3,0.00%,3,0,100.00%
p211-escrowproxy.icloud.com.cn,3,0.00%,3,0,100.00%
api.bestedm.net,3,0.00%,3,0,100.00%
yptqys.tianqistatic.com.cname4426.yjs-cdn.com,3,0.00%,3,0,100.00%
ps.eyeota.net,3,0.00%,3,0,100.00%
e2c30.gcp.gvt2.com,3,0.00%,3,0,100.00%
play.kakao.com,3,0.00%,6,3,50.00%
post.n.shifen.com,3,0.00%,9,6,33.33%
opencdnbaidutbpic.jomodns.com,3,0.00%,3,0,100.00%
passport.bdimg.com,3,0.00%,6,3,50.00%
iosapps.itunes.g.aaplimg.com,3,0.00%,5,2,60.00%
medal.tv,3,0.00%,3,0,100.00%
www.ledmu.com,3,0.00%,3,0,100.00%
wenming.cjyun.org,3,0.00%,3,0,100.00%
ipm.atm.youku.com,3,0.00%,3,0,100.00%
web-de1-25m24vtq.frp.cool,3,0.00%,3,0,100.00%
web-hk1-07vftt8m.frp.cool,3,0.00%,3,0,100.00%
g1.163.com,3,0.00%,3,0,100.00%
qzs.gdtimg.com.cdn.dnsv1.com,3,0.00%,7,4,42.86%
mimg.127.net.w.cdngslb.com,3,0.00%,3,0,100.00%
v5-f.douyinvod.com,3,0.00%,3,0,100.00%
in04.graniterapids.com,3,0.00%,3,0,100.00%
pccw05.graniterapids.com,3,0.00%,3,0,100.00%
rocky-everglades-gabrah569us145jdo1e0u4ej.herokudns.com,3,0.00%,3,0,100.00%
d.adroll.com,3,0.00%,3,0,100.00%
onedriveclucproddm20018.blob.core.windows.net,3,0.00%,3,0,100.00%
rp-consumer-prod-displaycatalog-geomap.trafficmanager.net,3,0.00%,3,0,100.00%
metrics1.data.dbankcloud.cn,3,0.00%,3,0,100.00%
shcuzxhk.eucdurl.me,3,0.00%,3,0,100.00%
api.pictureknow.com,3,0.00%,3,0,100.00%
in2-gw2-02-ce7dd027.eastus2.cloudapp.azure.com,3,0.00%,3,0,100.00%
apt-geofence-parent.trafficmanager.NET,3,0.00%,3,0,100.00%
org.repo.release.build.10gen.cc,3,0.00%,4,1,75.00%
e2c18.gcp.gvt2.com,3,0.00%,3,0,100.00%
pgw-cld-ml.alicdn.com,3,0.00%,3,0,100.00%
mirrors.aliyuncs.com,3,0.00%,3,0,100.00%
wenda.tianya.cn,3,0.00%,3,0,100.00%
rta.xboxlive.com,3,0.00%,6,3,50.00%
api.weather.com,3,0.00%,6,3,50.00%
pay-payment.vip.meituan.com,3,0.00%,3,0,100.00%
springer2.map.fastly.net,3,0.00%,3,0,100.00%
83.push2.eastmoney.com,3,0.00%,6,3,50.00%
www.mIt.edu,3,0.00%,3,0,100.00%
WwW.SlAShDOt.OrG,3,0.00%,3,0,100.00%
live-G378183JcnPC.ws.gamesparks.net,3,0.00%,3,0,100.00%
ssp-sync.sg1.vip.prod.criteo.com,3,0.00%,3,0,100.00%
59dl0074bk08tcqnavvdfpfhn2vt9vom1kikasqa1igko8uqdquvvjlh.qc.x.bsgslb.cn,3,0.00%,3,0,100.00%
gbc7.sg1.as.criteo.com,3,0.00%,3,0,100.00%
csi-china.l.google.com,3,0.00%,6,3,50.00%
lx2.loc.gov,3,0.00%,3,0,100.00%
hkt05.graniterapids.com,3,0.00%,3,0,100.00%
qqadapt.qpic.cn.sched.legopic2.tdnsv6.com,3,0.00%,3,0,100.00%
60dc0ac37e0c45b28c616b484b1c6ea6.vip1.huaweicloudwaf.com,3,0.00%,3,0,100.00%
maimai.cn,3,0.00%,3,0,100.00%
onedscolprdgwc07.germanywestcentral.cloudapp.azure.com,3,0.00%,3,0,100.00%
ip1905173511.funshion.com,3,0.00%,3,0,100.00%
ktv54011e46.fixip.t-online.hu,3,0.00%,3,0,100.00%
gitlab.icip.org.cn,3,0.00%,3,0,100.00%
oss.hinapower.cn,3,0.00%,3,0,100.00%
crls.pki.goog,3,0.00%,3,0,100.00%
content.hpgamestream.com,3,0.00%,6,3,50.00%
bing.net,3,0.00%,3,0,100.00%
ffc-static-cdn.oobesaas.adobe.com,3,0.00%,3,0,100.00%
scss.adobesc.com,3,0.00%,3,0,100.00%
ims-na1.adobelogin.com,3,0.00%,3,0,100.00%
udps.adobe.com,3,0.00%,3,0,100.00%
ars.oobesaas.adobe.com,3,0.00%,3,0,100.00%
material.mediav.com,3,0.00%,3,0,100.00%
s2.ssl.qhimg.com,3,0.00%,3,0,100.00%
d3agi7vo7cz11p.cloudfront.net,3,0.00%,3,0,100.00%
ww2.mathworks.cn,3,0.00%,3,0,100.00%
pianyuan.org,3,0.00%,6,3,50.00%
65.push2.eastmoney.com,3,0.00%,5,2,60.00%
log-forward.mid.ejoy.com,3,0.00%,3,0,100.00%
smarthome-drcn.dbankcdn.com.c.cdnhwc1.com,3,0.00%,3,0,100.00%
smarthome.dbankcloud.cn,3,0.00%,3,0,100.00%
huyaimg.msstatic.com,3,0.00%,8,5,37.50%
tieba-ares.cdn.bcebos.com,3,0.00%,3,0,100.00%
updatecdn.meeting.qq.com.cdn.dnsv1.com,3,0.00%,3,0,100.00%
midas.gtimg.cn.cloud.tc.qq.com,3,0.00%,4,1,75.00%
api.share.mob.com,3,0.00%,3,0,100.00%
tracker.auctor.tv,3,0.00%,3,0,100.00%
ut85.v.bsclink.cn,3,0.00%,3,0,100.00%
zkres1.myzaker.com.bsclink.cn,3,0.00%,3,0,100.00%
stat.myzaker.com,3,0.00%,3,0,100.00%
waws-prod-sn1-111.cloudapp.net,3,0.00%,3,0,100.00%
k5-v6-meituan.gslb.ksyuncdn.com,3,0.00%,6,3,50.00%
dit.whatsapp.net,3,0.00%,6,3,50.00%
audio.ali.xmcdn.com,3,0.00%,6,3,50.00%
ejp1-authgw-azsc.cloudapp.net,3,0.00%,3,0,100.00%
astraeus.feralhosting.com,3,0.00%,3,0,100.00%
pro-driver-packages.uniontech.com,3,0.00%,3,0,100.00%
lb.sae.sina.com.cn,3,0.00%,3,0,100.00%
udiab1.jianshu.com.cname2235.yjs-cdn.com,3,0.00%,3,0,100.00%
p207-caldav.icloud.com.cn,3,0.00%,3,0,100.00%
t1.market.mi-img.com.xiaomi.cdn.dnsv1.com,3,0.00%,3,0,100.00%
line1-log.biligame.net.w.cdngslb.com,3,0.00%,3,0,100.00%
rmyt6pch.sched.sma-dk.tdnsstic1.cn.cjt.krcdn.idatacube.com,3,0.00%,6,3,50.00%
7jv8x5b3.n.gaofangz.com,3,0.00%,3,0,100.00%
apps.bdimg.jomodns.com,3,0.00%,3,0,100.00%
widget.sg1.vip.prod.criteo.com,3,0.00%,3,0,100.00%
u1-000.ecukwai.com,3,0.00%,6,3,50.00%
ip2026469127.funshion.com,3,0.00%,3,0,100.00%
grow.safe.360.cn,3,0.00%,3,0,100.00%
rmyt6pch.sched.sma-dk.tdnsstic1.cn,3,0.00%,6,3,50.00%
c83s3.jamjams3.net,3,0.00%,3,0,100.00%
dgss2.bdstatic.com,3,0.00%,5,2,60.00%
dgss3.bdstatic.com,3,0.00%,6,3,50.00%
dgss0.baidu.com,3,0.00%,6,3,50.00%
dgss2.baidu.com,3,0.00%,6,3,50.00%
9mhewc7p.sched.sma-dk.tdnsstic1.cn,3,0.00%,6,3,50.00%
zgovweb.v.bsgslb.cn,3,0.00%,6,3,50.00%
slb-bgp-xy-03.ctripgslb.com,3,0.00%,3,0,100.00%
web.da.mgtv.com,3,0.00%,3,0,100.00%
a1779.dscd.akamai.net,3,0.00%,6,3,50.00%
p1-q.mafengwo.net,3,0.00%,7,4,42.86%
cstat.cdn-apple.com,3,0.00%,6,3,50.00%
96.push2.eastmoney.com,3,0.00%,6,3,50.00%
97.newspush.eastmoney.com,3,0.00%,3,0,100.00%
www.ppchart.com,3,0.00%,3,0,100.00%
imap.126.com,3,0.00%,3,0,100.00%
p26-buy.itunes.apple.com,3,0.00%,3,0,100.00%
movie.hupu.com,3,0.00%,6,3,50.00%
docs2.gtimg.com.cloud.tc.qq.com,3,0.00%,3,0,100.00%
imgheybox.max-c.com.cdn.dnsv1.com,3,0.00%,3,0,100.00%
cmshow.qq.mid.tdnsv6.com,3,0.00%,4,1,75.00%
static.yximgs.com,3,0.00%,7,4,42.86%
www-dida-313720269.cn-north-1.elb.amazonaws.com.cn,3,0.00%,3,0,100.00%
jp1.chuqiangtou.net,3,0.00%,3,0,100.00%
time2.aliyun.com,3,0.00%,3,0,100.00%
cm-udmp.gridsumdissector.com,3,0.00%,3,0,100.00%
its.fugetech.com,3,0.00%,3,0,100.00%
bx01.optimix.cn,3,0.00%,3,0,100.00%
analytics.awsmcafeeccs.mcafee.com,3,0.00%,3,0,100.00%
promotion.1dadan.com,3,0.00%,3,0,100.00%
i.exmail.qq.com,3,0.00%,3,0,100.00%
linux.cn,3,0.00%,3,0,100.00%
avatars1.githubusercontent.com,3,0.00%,3,0,100.00%
ads.pubmatic.com,3,0.00%,3,0,100.00%
ns3.gdnsec.com,3,0.00%,3,0,100.00%
sms.ads.oppomobile.com,3,0.00%,3,0,100.00%
email.prnewswire.com,3,0.00%,3,0,100.00%
location.dftoutiao.com,3,0.00%,3,0,100.00%
pic.sogou.com,3,0.00%,3,0,100.00%
www.4399.com,3,0.00%,3,0,100.00%
search-x.jd.com,3,0.00%,3,0,100.00%
config.ie.sogou.com,3,0.00%,3,0,100.00%
mos.m.taobao.com,3,0.00%,3,0,100.00%
education.github.com,3,0.00%,3,0,100.00%
navi.cnki.net,3,0.00%,3,0,100.00%
check.cnki.net,3,0.00%,3,0,100.00%
silverbullet-external-ats.itunes.apple.com,3,0.00%,3,0,100.00%
v9.douyinvod.com.bsgslb.com,3,0.00%,6,3,50.00%
zttvp.v.bsgslb.com,3,0.00%,6,3,50.00%
kylin.im.weibo.cn,3,0.00%,3,0,100.00%
t4.a.market.xiaomi.com,3,0.00%,3,0,100.00%
t1.a.market.xiaomi.com,3,0.00%,3,0,100.00%
t5.a.market.xiaomi.com,3,0.00%,3,0,100.00%
cover-ipc-txc-sh.mercuryclouds.com.cn,3,0.00%,3,0,100.00%
local.sched.v1lego-dk.tdnsvod1.cn,3,0.00%,7,4,42.86%
binapi.pcloud.com,3,0.00%,3,0,100.00%
81.push2.eastmoney.com,3,0.00%,4,1,75.00%
1453639.sched.sma.tdnsstic1.cn,3,0.00%,3,0,100.00%
cf.qq.com,3,0.00%,6,3,50.00%
api.im.weibo.cn,3,0.00%,3,0,100.00%
v3-fq-tts.fqnovelvod.com.230b2a2545cfa773.queniubg.com,3,0.00%,6,3,50.00%
vdn.vzuu.com.w.kunlunar.com,3,0.00%,7,4,42.86%
zt.cn.gifshow.com,3,0.00%,3,0,100.00%
main.m.taobao.com.w.alikunlun.com,3,0.00%,10,7,30.00%
docs.gtimg.com.cdn.dnsv1.com,3,0.00%,6,3,50.00%
pdns99.ultradns.biz,3,0.00%,6,3,50.00%
e1ad1d43d1c151537d39e6385a4cce91.qcloudwzgj.com,3,0.00%,3,0,100.00%
acm-prod.disqus.com,3,0.00%,6,3,50.00%
in.hotjar.com,3,0.00%,3,0,100.00%
funimg.pddpic.com,3,0.00%,4,1,75.00%
gsp10-ssl-cn.ls-apple.com.akadns.net,3,0.00%,3,0,100.00%
mailn8sh.message.cmbchina.com,3,0.00%,3,0,100.00%
mailn2sh.message.cmbchina.com,3,0.00%,3,0,100.00%
mailn5sz.message.cmbchina.com,3,0.00%,3,0,100.00%
61.newspush.eastmoney.com,3,0.00%,3,0,100.00%
cb10bdfbd90f88db560d0ad1e8f78722.dlied1.cdntips.net,3,0.00%,3,0,100.00%
mapp.3g.qq.com,3,0.00%,3,0,100.00%
www.wenxm.cn,3,0.00%,3,0,100.00%
dsum.casalemedia.com,3,0.00%,3,0,100.00%
smad.ms.zhangyue.net,3,0.00%,3,0,100.00%
c0678bbfbefc124a8e4a9f3106efdb05.dlied1.cdntips.net,3,0.00%,3,0,100.00%
qzonestyle.gtimg.cn.sched.legopic2.tdnsv6.com.tpic.vwnti.yrzhcloud.cn,3,0.00%,3,0,100.00%
htdata3.qq.com,3,0.00%,3,0,100.00%
htdata4.qq.com,3,0.00%,3,0,100.00%
circlepic.upqzfile.com,3,0.00%,3,0,100.00%
circlevideo.upqzfile.com,3,0.00%,3,0,100.00%
push-s.maxthon.com,3,0.00%,3,0,100.00%
ns9.gdnsec.com,3,0.00%,3,0,100.00%
latex.codecogs.com,3,0.00%,3,0,100.00%
graph.facebook.com,3,0.00%,6,3,50.00%
google.co.jp,3,0.00%,6,3,50.00%
bing.ming92.cf,3,0.00%,3,0,100.00%
e2c34.gcp.gvt2.com,3,0.00%,3,0,100.00%
map-mobile-resource.cdn.bcebos.com,3,0.00%,6,3,50.00%
hbrcv.adobe.com,3,0.00%,3,0,100.00%
stmp.fikuu.com.wswebpic.com,3,0.00%,3,0,100.00%
sh.wagbridge.1688.com,3,0.00%,3,0,100.00%
e6156.dscf.akamaiedge.net,3,0.00%,6,3,50.00%
mssdk-bu.snssdk.com.bytedns1.com,3,0.00%,3,0,100.00%
s2-11760.kwimgs.com,3,0.00%,6,3,50.00%
is-log-collector.corp.kuaishou.com,3,0.00%,3,0,100.00%
rili.wps.cn,3,0.00%,3,0,100.00%
prd-mcafee-mosaic-pub.azurewebsites.net,3,0.00%,3,0,100.00%
837b9c2eb969c463a018a6d69cdb2076.dlied1.cdntips.net,3,0.00%,3,0,100.00%
main.d1sm.net,3,0.00%,3,0,100.00%
aod.itunes.g.aaplimg.com,3,0.00%,5,2,60.00%
m.360buyimg.com.gslb.qianxun.com,3,0.00%,6,3,50.00%
m.360buyimg.com.s.galileo.jcloud-cdn.com,3,0.00%,6,3,50.00%
reports.a.shifen.com,3,0.00%,3,0,100.00%
baikebcs.cdn.bcebos.com.a.bdydns.com,3,0.00%,3,0,100.00%
62.push2.eastmoney.com,3,0.00%,7,4,42.86%
apd-567cfcb9fb2e93b541dbb4c6daaa53a7.v.smtcdns.com,3,0.00%,3,0,100.00%
nlb-ws-8c0370aeafe8050f.elb.us-west-2.amazonaws.com,3,0.00%,3,0,100.00%
25.push2.eastmoney.com,3,0.00%,6,3,50.00%
fai3ahch.nodedata.net,3,0.00%,3,0,100.00%
diy-assets.msstatic.com,3,0.00%,3,0,100.00%
ip2100177541.funshion.com,3,0.00%,3,0,100.00%
sslvpn.idea.edu.cn,3,0.00%,3,0,100.00%
getnode.dksb.store,3,0.00%,3,0,100.00%
gepwh1dw9p.feishu.cn,3,0.00%,3,0,100.00%
mmsns.c2c.wechat.com,3,0.00%,6,3,50.00%
msgpush3.yun.ccb.com,3,0.00%,3,0,100.00%
wwW.SlAshdot.ORG,3,0.00%,3,0,100.00%
WwW.mit.EDu,3,0.00%,3,0,100.00%
conn4.coloros.com,3,0.00%,3,0,100.00%
analytics.getpostman.com,3,0.00%,3,0,100.00%
s6.music.126.net.w.kunluncan.com,3,0.00%,6,3,50.00%
mssdk3-normal-lf.zijieapi.com,3,0.00%,6,3,50.00%
ins-3rwdn7ul.ias.tencent-cloud.net,3,0.00%,3,0,100.00%
dlassets-ssl.xboxlive.com.edgekey.net,3,0.00%,6,3,50.00%
video4-2.pddpic.com,3,0.00%,3,0,100.00%
hispaceclt.hicloud.com,3,0.00%,3,0,100.00%
wildcard.gallerycdn.azure.cn.mcchcdn.com,3,0.00%,3,0,100.00%
alldomain.gallerycdn.azure.cn.a.bdydns.com,3,0.00%,3,0,100.00%
us06.graniterapids.com,3,0.00%,3,0,100.00%
hg04.ptrecord.com,3,0.00%,3,0,100.00%
analytics.51ifonts.com,3,0.00%,3,0,100.00%
lib.math.ac.cn,3,0.00%,3,0,100.00%
online.amss.ac.cn,3,0.00%,3,0,100.00%
v3-be-pack.pglstatp-toutiao.com.w.cdngslb.com,3,0.00%,4,1,75.00%
es.kibana.cipsup.cn,3,0.00%,3,0,100.00%
ex.m.jd.com.gslb.qianxun.com,3,0.00%,6,3,50.00%
v5-g.douyinvod.com.zjgslb.com,3,0.00%,3,0,100.00%
v5.douyinvod.com.zjgslb.com,3,0.00%,3,0,100.00%
content.fe.apple-dns.cn,3,0.00%,3,0,100.00%
allall01.n.shifen.com,3,0.00%,6,3,50.00%
gz.file.myqcloud.com,3,0.00%,3,0,100.00%
c.51y5.net,3,0.00%,3,0,100.00%
v3-gray.toutiaovod.com,3,0.00%,4,1,75.00%
uk03.graniterapids.com,3,0.00%,3,0,100.00%
cdns.gigya.com,3,0.00%,3,0,100.00%
dt.netease.im,3,0.00%,3,0,100.00%
poi-pic-gz.cdn.bcebos.com.a.bdydns.com,3,0.00%,3,0,100.00%
main.m.taobao.com,3,0.00%,6,3,50.00%
youjia-image.cdn.bcebos.com,3,0.00%,6,3,50.00%
ip1873674382.funshion.com,3,0.00%,3,0,100.00%
upgrade.luyou.360.cn,3,0.00%,3,0,100.00%
cr.3conline.com,3,0.00%,3,0,100.00%
cdn.17qiche.com,3,0.00%,3,0,100.00%
b3f23744e6e9003a-cl2.qcloudcjgj.com,3,0.00%,3,0,100.00%
d2pbcviywxotf2.cloudfront.net,3,0.00%,5,2,60.00%
public.gdtimg.com.cdn.dnsv1.com,3,0.00%,7,4,42.86%
best.sched.sma-dk.tdnsstic1.cn,3,0.00%,8,5,37.50%
d2gatte9o95jao.cloudfront.net,3,0.00%,3,0,100.00%
d3iocdherrxqfc.cloudfront.net,3,0.00%,5,2,60.00%
hcdnw.gslb.c.cdnhwc2.com,3,0.00%,3,0,100.00%
dsm01pcor007-meta.fe.1drv.com,3,0.00%,5,2,60.00%
odc-dsm01pap007-meta-geo.onedrive.akadns.net,3,0.00%,5,2,60.00%
dsm01pcor007-meta.be.1drv.com.l-0003.dc-msedge.net.l-0003.l-msedge.net,3,0.00%,5,2,60.00%
www.xbbshuwu.com,3,0.00%,3,0,100.00%
mail.nfs-china.com,3,0.00%,3,0,100.00%
e7479.g.akamaiedge.NET,3,0.00%,3,0,100.00%
react-admin-telemetry.marmelab.com,3,0.00%,6,3,50.00%
mucp.api.account.microsoft.com,3,0.00%,3,0,100.00%
reportus.parallels.com,3,0.00%,3,0,100.00%
aedns.weixin.qq.com,3,0.00%,3,0,100.00%
tw03.graniterapids.com,3,0.00%,3,0,100.00%
uk04.graniterapids.com,3,0.00%,3,0,100.00%
slog.sina.com.cn,3,0.00%,3,0,100.00%
adx.ke.com,3,0.00%,3,0,100.00%
wwW.sLAshdot.orG,3,0.00%,3,0,100.00%
cdn.ampproject.org,3,0.00%,6,3,50.00%
wpad.shanhutech.cn,3,0.00%,3,0,100.00%
b.zenyou.71360.com,3,0.00%,3,0,100.00%
cas.ys7.com,3,0.00%,3,0,100.00%
prt.jss.com.cn,3,0.00%,3,0,100.00%
bgp.netarch-alisc1-edge-lb.l.bytedns.net,3,0.00%,3,0,100.00%
m704.music.126.net.163jiasu.com,3,0.00%,3,0,100.00%
tongji.mafengwo.cn,3,0.00%,3,0,100.00%
pagelet.mafengwo.cn,3,0.00%,3,0,100.00%
msg.mail.126.com,3,0.00%,3,0,100.00%
theme.ssl.dhrest.com,3,0.00%,3,0,100.00%
imap.netfu.rice.edu,3,0.00%,3,0,100.00%
asia.pool.ntp.org,3,0.00%,3,0,100.00%
tw.pool.ntp.org,3,0.00%,3,0,100.00%
qiye.gongchang.com,3,0.00%,3,0,100.00%
sz.tencent.com,3,0.00%,3,0,100.00%
50.push2.eastmoney.com,3,0.00%,4,1,75.00%
d3.music.126.net,3,0.00%,6,3,50.00%
d2nxq2uap88usk.cloudfront.NET,3,0.00%,6,3,50.00%
s.ssl.qhres2.com.webcdn.360qhcdn.com,3,0.00%,4,1,75.00%
ben.crxmouse.com,3,0.00%,3,0,100.00%
i.mi.com,3,0.00%,3,0,100.00%
ap-tls-universal-proxy.agora.io,3,0.00%,3,0,100.00%
WWW.miT.EDU,3,0.00%,3,0,100.00%
WWw.slasHdot.OrG,3,0.00%,3,0,100.00%
wns.windows.com,3,0.00%,5,2,60.00%
cube.www.so.com,3,0.00%,3,0,100.00%
umessage.yonyou.com,3,0.00%,3,0,100.00%
ip2051929363.funshion.com,3,0.00%,3,0,100.00%
p1043812.iavs9x.u.avast.com,3,0.00%,6,3,50.00%
qa.1r1g.com,3,0.00%,3,0,100.00%
mvp.mediav.com,3,0.00%,3,0,100.00%
huoqibao.1234567.com.cn,3,0.00%,7,4,42.86%
uth8waiw.nodedata.net,3,0.00%,3,0,100.00%
abnp.ironport.com,3,0.00%,3,0,100.00%
sdk.open.extension.getui.com,3,0.00%,3,0,100.00%
e2c25.gcp.gvt2.com,3,0.00%,3,0,100.00%
na61-rmbsync-upaas.uc.cn,3,0.00%,3,0,100.00%
i-sat02p-cor005.api.p001.1drv.com,3,0.00%,3,0,100.00%
mail.alkuhaimi.com,3,0.00%,3,0,100.00%
greatest-side-violet.discover.quiknode.pro,3,0.00%,3,0,100.00%
42.push2.eastmoney.com,3,0.00%,5,2,60.00%
hc.reg.163.com,3,0.00%,3,0,100.00%
hw.mail.163.com,3,0.00%,3,0,100.00%
uapi.ads.heytapmobi.com,3,0.00%,3,0,100.00%
operatorhub.io,3,0.00%,3,0,100.00%
ssd.tcdn.qq.com,3,0.00%,3,0,100.00%
p3-webcast.douyinpic.com,3,0.00%,6,3,50.00%
pccw01.graniterapids.com,3,0.00%,3,0,100.00%
accelerator.tencent-cloud-gslb.com,3,0.00%,3,0,100.00%
p215-caldav.icloud.com.cn,3,0.00%,3,0,100.00%
www.lenovo.com,3,0.00%,3,0,100.00%
imap.sina.com.cn,3,0.00%,3,0,100.00%
down.qq.com.legodlied1.sched.dcloudstc.com,3,0.00%,3,0,100.00%
www.dygangs.com,3,0.00%,3,0,100.00%
www.66tutup.com,3,0.00%,3,0,100.00%
contentcms-bj.cdn.bcebos.com,3,0.00%,3,0,100.00%
v2.euqq.cn,3,0.00%,3,0,100.00%
waws-prod-mwh-083-46eb.westus2.cloudapp.azure.com,3,0.00%,3,0,100.00%
rtlog3-applog-lf.fqnovel.com,3,0.00%,3,0,100.00%
skin.wsm.360.cn,3,0.00%,3,0,100.00%
c.nstool.ntes53.netease.com,3,0.00%,3,0,100.00%
u1-204.ecukwai.com,3,0.00%,6,3,50.00%
captcha.gtimg.com.cloud.tc.qq.com,3,0.00%,3,0,100.00%
vdn6-1.vzuu.com.v1.ksydns.com,3,0.00%,3,0,100.00%
apd-967ba12da5a0ed4560941a7046e84651.v.smtcdns.com,3,0.00%,3,0,100.00%
gv1.xdrig.com,3,0.00%,3,0,100.00%
forum-api-drcn-jos-dbankcloud-cn-drcn.appacc.dbankedge.cn,3,0.00%,3,0,100.00%
ab.apple.com.akadns.net,3,0.00%,6,3,50.00%
amd-infra.apps-apple.com.akadns.net,3,0.00%,4,1,75.00%
pba.apple.com,3,0.00%,3,0,100.00%
jxs-drcn.jos.dbankcloud.cn,3,0.00%,3,0,100.00%
appimg.dbankcdn.com.c.cdnhwc1.com,3,0.00%,3,0,100.00%
c1bj.mail.163.com,3,0.00%,3,0,100.00%
uploader.shimo.im,3,0.00%,3,0,100.00%
wetransfer.com,3,0.00%,3,0,100.00%
wpsfile.ksyun.com,3,0.00%,3,0,100.00%
xxport.shimo.im,3,0.00%,3,0,100.00%
fla.83.mclqp.link,3,0.00%,3,0,100.00%
aod.itunes.apple.com.w.alikunlun.com,3,0.00%,3,0,100.00%
p9-open-sign.byteimg.com.bsgslb.com,3,0.00%,6,3,50.00%
wn-x.jd.com.gslb.qianxun.com,3,0.00%,3,0,100.00%
api-access.pangolin-sdk-toutiao.com.dsa.dnsv1.com.cn,3,0.00%,3,0,100.00%
3valw9gt.sched.d2.tdnsdp1.cn,3,0.00%,3,0,100.00%
psstatic.cdn.bcebos.com,3,0.00%,4,1,75.00%
zhibo.homeway.com.cn,3,0.00%,3,0,100.00%
packages.osrfoundation.org,3,0.00%,3,0,100.00%
e2c22.gcp.gvt2.com,3,0.00%,3,0,100.00%
hw.zuimeitianqi.com,3,0.00%,3,0,100.00%
imgcdn.zhibo8.cc,3,0.00%,3,0,100.00%
topology.le5le.com,3,0.00%,3,0,100.00%
www.pantum.cn,3,0.00%,3,0,100.00%
vi.bls.mdt.qq.com,3,0.00%,3,0,100.00%
alt1-mtalk.google.com,3,0.00%,7,4,42.86%
api5-normal-quic-lq.ixigua.com,3,0.00%,4,1,75.00%
us09.graniterapids.com,3,0.00%,3,0,100.00%
cgi.twns.qq.com,3,0.00%,3,0,100.00%
filerep.ff.avast.com,3,0.00%,3,0,100.00%
cx.cnki.net,3,0.00%,3,0,100.00%
xmpp009.hpeprint.com,3,0.00%,3,0,100.00%
multimedia.api.weibo.com,3,0.00%,3,0,100.00%
registry.aliyuncs.com,3,0.00%,3,0,100.00%
media.ludashi.com,3,0.00%,3,0,100.00%
wWw.SlaSHDOT.ORg,3,0.00%,3,0,100.00%
wwW.mIT.eDU,3,0.00%,3,0,100.00%
wwW.slAsHdot.oRg,3,0.00%,3,0,100.00%
WwW.MIt.eDu,3,0.00%,3,0,100.00%
login.mdpi.com,3,0.00%,3,0,100.00%
sina.cn,3,0.00%,3,0,100.00%
noc1.wordfence.com,3,0.00%,3,0,100.00%
pp107718022.netvigatorscdn.com,3,0.00%,3,0,100.00%
s.syzs.qq.com,3,0.00%,3,0,100.00%
d3hndmbr6e28d5.cloudfront.net,3,0.00%,3,0,100.00%
human-tarantula-wy3gj0btg9vmv5qgdfoaab1p.herokudns.com,3,0.00%,3,0,100.00%
sync.mathtag.com,3,0.00%,3,0,100.00%
yscres.dfcfw.com,3,0.00%,3,0,100.00%
gbcdn.dfcfw.com,3,0.00%,3,0,100.00%
scone-pa.clients6.google.com,3,0.00%,6,3,50.00%
wWW.sLAShDot.oRG,3,0.00%,3,0,100.00%
WwW.mit.eDU,3,0.00%,3,0,100.00%
cmhk.tcpbbr.xyz,3,0.00%,3,0,100.00%
lh3.googleusercontent.com,3,0.00%,4,1,75.00%
qdsdk.jd.com,3,0.00%,3,0,100.00%
8136128.fls.doubleclick.net,3,0.00%,3,0,100.00%
file.gsxservice.com,3,0.00%,3,0,100.00%
texample.net,3,0.00%,3,0,100.00%
ad.xwdsp.com,3,0.00%,3,0,100.00%
stun.12voip.com,3,0.00%,3,0,100.00%
stun.3cx.com,3,0.00%,3,0,100.00%
api.dongqiudi.com,3,0.00%,3,0,100.00%
im-ap.dongqiudi.com,3,0.00%,3,0,100.00%
mysdk.37.com,3,0.00%,3,0,100.00%
h.zzhkgw.cn,3,0.00%,3,0,100.00%
gocm.c.appier.net,3,0.00%,3,0,100.00%
dwukvnsla9f3j6cqza9peeaipoucwqyg.alicloudwaf.com,3,0.00%,3,0,100.00%
dl-wh.vipguanjia.net,3,0.00%,3,0,100.00%
www.SLaShDOT.OrG,3,0.00%,3,0,100.00%
wWw.MiT.eDu,3,0.00%,3,0,100.00%
open.feishu.cn,3,0.00%,6,3,50.00%
conferences.sigcomm.org,3,0.00%,3,0,100.00%
api.gfe.nvidia.com,3,0.00%,3,0,100.00%
www.slaShdot.ORG,3,0.00%,3,0,100.00%
www.mit.edu,3,0.00%,3,0,100.00%
414-xmy-838.mktoresp.com,3,0.00%,3,0,100.00%
livegetwesteurope.cloudapp.net,2,0.00%,2,0,100.00%
cn-sdyt-cu-01-26.bilivideo.com,2,0.00%,2,0,100.00%
p3.a.yximgs.com,2,0.00%,5,3,40.00%
v4-vod.kwaicdn.com,2,0.00%,5,3,40.00%
p4.a.yximgs.com,2,0.00%,6,4,33.33%
ac-mqgidvz-shard-00-00.nmmxpgl.mongodb.net,2,0.00%,2,0,100.00%
ac-mqgidvz-shard-00-02.nmmxpgl.mongodb.net,2,0.00%,2,0,100.00%
rc10-g5.oray.com,2,0.00%,2,0,100.00%
h5.sinaimg.cn,2,0.00%,215,213,0.93%
www.amap.com,2,0.00%,2,0,100.00%
a.amap.com,2,0.00%,2,0,100.00%
mar.vip.com,2,0.00%,2,0,100.00%
captcha.vip.com,2,0.00%,2,0,100.00%
bootstrap.vipstatic.com,2,0.00%,2,0,100.00%
common.vip.com,2,0.00%,2,0,100.00%
cart.vip.com,2,0.00%,2,0,100.00%
fav.vip.com,2,0.00%,2,0,100.00%
myi.vip.com,2,0.00%,2,0,100.00%
list.vip.com,2,0.00%,2,0,100.00%
feedback.vip.com,2,0.00%,2,0,100.00%
rule.vip.com,2,0.00%,2,0,100.00%
stock.vip.com,2,0.00%,2,0,100.00%
h5charity.vip.com,2,0.00%,2,0,100.00%
184-15-25-249.dr01.chtn.wv.frontiernet.net,2,0.00%,2,0,100.00%
etax.shenzhen.chinatax.gov.cn,2,0.00%,2,0,100.00%
www.81.cn,2,0.00%,4,2,50.00%
h.trace.qq.com,2,0.00%,835,833,0.24%
asst-stat.ksord.com,2,0.00%,2,0,100.00%
api.ivideo.sina.com.cn,2,0.00%,476,474,0.42%
www.amazon.co,2,0.00%,2,0,100.00%
p0.qhimgs4.com.webcdn.360qhcdn.com,2,0.00%,2,0,100.00%
cispa-de.zoom.us,2,0.00%,2,0,100.00%
recruit.nimte.ac.cn,2,0.00%,2,0,100.00%
security.ubuntu.com,2,0.00%,1648,1646,0.12%
config.edge.skype.com.trafficmanager.net,2,0.00%,211,209,0.95%
config-edge-skype.l-0007.l-msedge.net,2,0.00%,159,157,1.26%
blob.dsm07prdstr09a.store.core.windows.net,2,0.00%,2,0,100.00%
win10-trt.msedge.net,2,0.00%,243,241,0.82%
pull-tsl-spe-l1.douyincdn.com.wsdvs.com,2,0.00%,20,18,10.00%
cn-pek-ali-r009.router.teamviewer.cn,2,0.00%,2,0,100.00%
tw1ssltide.gmdns.net,2,0.00%,2,0,100.00%
us3.gmdns.net,2,0.00%,2,0,100.00%
in2.gmdns.net,2,0.00%,2,0,100.00%
cn13.gmdns.net,2,0.00%,2,0,100.00%
img.bq233.com,2,0.00%,2,0,100.00%
tRAnsiT1.WSLOg.chiNAneTCENTEr.coM,2,0.00%,2,0,100.00%
CLieNTlogVODp2P.hapLaT.NET,2,0.00%,2,0,100.00%
mambap2PVoDh5.8686C.com,2,0.00%,2,0,100.00%
latexlive-resourse.oss-cn-beijing.aliyuncs.com,2,0.00%,2,0,100.00%
qszhang.com,2,0.00%,2,0,100.00%
api-game.flash.cn,2,0.00%,2,0,100.00%
lc.tencent.com,2,0.00%,2,0,100.00%
c.pc.qq.com,2,0.00%,2,0,100.00%
tracker.torrentsnows.com,2,0.00%,2,0,100.00%
bigfoot1942.sektori.org,2,0.00%,3,1,66.67%
ort.stsdk.vivo.com.cn,2,0.00%,2,0,100.00%
na1e.services.adobe.com,2,0.00%,2,0,100.00%
hq.cjsc.com.cn,2,0.00%,2,0,100.00%
outlook-com.olc.protection.outlook.com,2,0.00%,2,0,100.00%
dsm01pcor005-com.be.1drv.com,2,0.00%,2,0,100.00%
i-dsm01p-cor005.api.p001.1drv.com,2,0.00%,2,0,100.00%
hkt.test.gotochinatown.net,2,0.00%,2,0,100.00%
us2.test.gotochinatown.net,2,0.00%,2,0,100.00%
pccw.test.gotochinatown.net,2,0.00%,2,0,100.00%
hcdnl.pulldouyincmccssp.gslb.d.live.cdn.chinamobile.com,2,0.00%,2,0,100.00%
push-fcdn-base3.s.bytefcdn.com,2,0.00%,2,0,100.00%
v5-coldc.douyinvod.com,2,0.00%,5,3,40.00%
aidc.origin-apple.com.akadns.net,2,0.00%,2,0,100.00%
dcat-tlu-fg-shim.trafficmanager.net,2,0.00%,2,0,100.00%
inv-nets-sg-s1.admixer.net,2,0.00%,2,0,100.00%
mail.116bestwork.cf,2,0.00%,2,0,100.00%
sync.adotmob.com,2,0.00%,2,0,100.00%
instantmessaging-pa.googleapis.com,2,0.00%,4,2,50.00%
speed.gsdk.qq.com,2,0.00%,2,0,100.00%
appstream.ubuntu.com,2,0.00%,2,0,100.00%
ishufang.cnki.net,2,0.00%,2,0,100.00%
mbmodule-openapi.paas.cmbchina.com,2,0.00%,2,0,100.00%
webappcfg.paas.cmbchina.com,2,0.00%,2,0,100.00%
ai.cmbchina.com,2,0.00%,2,0,100.00%
appinfocdn.cmbimg.com,2,0.00%,2,0,100.00%
netpay.cmbchina.com,2,0.00%,2,0,100.00%
static.m.cmbchina.com,2,0.00%,2,0,100.00%
img.mb.cmbimg.com,2,0.00%,2,0,100.00%
i.stack.imgur.com,2,0.00%,6,4,33.33%
pb-server.ezoic.com,2,0.00%,2,0,100.00%
prebid.media.net,2,0.00%,2,0,100.00%
rw-yieldmo-com-1673518954.ap-southeast-1.elb.amazonaws.com,2,0.00%,2,0,100.00%
g2.gumgum.com,2,0.00%,2,0,100.00%
blog.jobfie.es,2,0.00%,2,0,100.00%
ak.epicgames.com.edgekey.net,2,0.00%,4,2,50.00%
v6-cold1.douyinvod.com,2,0.00%,6,4,33.33%
v6-cold1.douyinvod.com.download.ks-cdn.com,2,0.00%,4,2,50.00%
k2-dy-cold1-ml.gslb.ksyuncdn.com,2,0.00%,4,2,50.00%
outsea.yun-app.net,2,0.00%,2,0,100.00%
v11-cold1.douyinvod.com.cdn.dnsv1.com,2,0.00%,4,2,50.00%
seal-inner.bytedance.net,2,0.00%,93,91,2.15%
tt-vod-sched.jcloudimg.com,2,0.00%,4,2,50.00%
au02.graniterapids.com,2,0.00%,2,0,100.00%
fr02.graniterapids.com,2,0.00%,2,0,100.00%
cn4.gmdns.net,2,0.00%,2,0,100.00%
cn3.gmdns.net,2,0.00%,2,0,100.00%
r4---sn-ni5eln7l.gvt1.com,2,0.00%,2,0,100.00%
qd-update.qq.com,2,0.00%,2,0,100.00%
s0.wp.com,2,0.00%,2,0,100.00%
stats.wp.com,2,0.00%,2,0,100.00%
i0.wp.com,2,0.00%,2,0,100.00%
pixel.wp.com,2,0.00%,2,0,100.00%
s8.files.wordpress.com,2,0.00%,2,0,100.00%
v9-cold.douyinvod.com,2,0.00%,4,2,50.00%
weather-edge.apple.com,2,0.00%,2,0,100.00%
shift.is.autonavi.com.gds.alibabadns.com,2,0.00%,2,0,100.00%
crossmark.crossref.org,2,0.00%,2,0,100.00%
e2581.dscx.akamaiedge.net,2,0.00%,3,1,66.67%
wis.qq.com,2,0.00%,2,0,100.00%
ad.browser.qq.com,2,0.00%,2,0,100.00%
ustc-edu-cn.mirror.aliyuncs.com,2,0.00%,2,0,100.00%
www.rndlgch.com,2,0.00%,2,0,100.00%
195.sammentik.cf,2,0.00%,2,0,100.00%
sqm.telemetry.microsoft.com.nsatc.net,2,0.00%,2,0,100.00%
mail.persbywepocad.tk,2,0.00%,2,0,100.00%
access.fluidx.ai,2,0.00%,2,0,100.00%
releases.turnkeylinux.org,2,0.00%,40,38,5.00%
p26-be-pack-sign.pglstatp-toutiao.com.51296c5e.c.cdnhwc1.com,2,0.00%,4,2,50.00%
log-api.pangolin-sdk-toutiao-b.com.bytedns1.com,2,0.00%,4,2,50.00%
p47-fmf.icloud.com.cn,2,0.00%,2,0,100.00%
weather-analytics-events.apple.com,2,0.00%,2,0,100.00%
v5-colde.douyinvod.com.yangyi19.com,2,0.00%,4,2,50.00%
v5-coldb.douyinvod.com.yangyi19.com,2,0.00%,2,0,100.00%
dy-vod-coldb.bytegslb.com,2,0.00%,2,0,100.00%
dy-vod-colde.bytegslb.com,2,0.00%,4,2,50.00%
j4501229.iavs9x.u.avast.com,2,0.00%,4,2,50.00%
k9290131.iavs9x.u.avast.com,2,0.00%,4,2,50.00%
b1477563.iavs9x.u.avast.com,2,0.00%,4,2,50.00%
b3156325.iavs9x.u.avast.com,2,0.00%,4,2,50.00%
t7758057.iavs9x.u.avast.com,2,0.00%,4,2,50.00%
cd.file.myqcloud.com,2,0.00%,2,0,100.00%
oedlyege.slt.sched.tdnsv8.com,2,0.00%,2,0,100.00%
api-ucloud.leancloud.cn,2,0.00%,2,0,100.00%
youjia.cdn.bcebos.com,2,0.00%,4,2,50.00%
youjia-video.cdn.bcebos.com,2,0.00%,4,2,50.00%
show.chuangyi.taobao.com,2,0.00%,3,1,66.67%
s.auto.sina.com.cn,2,0.00%,2,0,100.00%
lookup-api.apple.com.edgekey.net,2,0.00%,2,0,100.00%
image.mybank.icbc.com.cn,2,0.00%,4,2,50.00%
xmpp007.hpeprint.com,2,0.00%,2,0,100.00%
www.jccb.com.cn,2,0.00%,2,0,100.00%
zgbmxh.cn,2,0.00%,2,0,100.00%
predownload-admin.g.mi.com,2,0.00%,2,0,100.00%
smsapi.micloud.xiaomi.net,2,0.00%,2,0,100.00%
alfonsino.top,2,0.00%,2,0,100.00%
p213-quota.icloud.com.cn,2,0.00%,2,0,100.00%
mail.consearchgiffipic.ml,2,0.00%,2,0,100.00%
v11-x.sched.v4lego-dk.tdnsvod1.cn,2,0.00%,5,3,40.00%
pull-flv-l26.douyincdn.com.c.cdnhwc3.com,2,0.00%,5,3,40.00%
pull-fcdn-douyin-b1.b.bytefcdn.com,2,0.00%,2,0,100.00%
image6v2.pubmnet.com,2,0.00%,2,0,100.00%
www.megatorrents.kg,2,0.00%,73,71,2.74%
liangcang-material.alicdn.com,2,0.00%,4,2,50.00%
chipmunk.grammarly.com,2,0.00%,2,0,100.00%
ilce.alicdn.com,2,0.00%,4,2,50.00%
hub5pn.sandai.net,2,0.00%,2,0,100.00%
e6e8c2dbaa69376ff90536bbc0eec4a0.clo.footprintdns.com,2,0.00%,2,0,100.00%
d3661cdf4a1387e40907d880475ef37e.nrb.footprintdns.com,2,0.00%,4,2,50.00%
img3.doubanio.com,2,0.00%,4,2,50.00%
movie.douban.com,2,0.00%,2,0,100.00%
erebor.douban.com,2,0.00%,2,0,100.00%
api.health.comm.miui.com,2,0.00%,2,0,100.00%
p2.shared.global.fastly.NET,2,0.00%,2,0,100.00%
www.aminer.cn,2,0.00%,2,0,100.00%
www.ict.ac.cn,2,0.00%,2,0,100.00%
v9-default.365yg.com,2,0.00%,2,0,100.00%
staticiot.cdn.bcebos.com,2,0.00%,5,3,40.00%
staticwx.cdn.bcebos.com,2,0.00%,5,3,40.00%
staticsns.cdn.bcebos.com,2,0.00%,5,3,40.00%
thumbnail0.baidupcs.com,2,0.00%,4,2,50.00%
nv1.baidupcs.com,2,0.00%,4,2,50.00%
clickstream-data.srcgsre.com,2,0.00%,2,0,100.00%
blob.dsm08prdstr14a.store.core.windows.net,2,0.00%,2,0,100.00%
api.webtest.net.edgekey.net,2,0.00%,2,0,100.00%
r.edtd.eset.com,2,0.00%,2,0,100.00%
mirrorlist.centos.org,2,0.00%,436,434,0.46%
onedriveclucprodbn20027.blob.core.windows.net,2,0.00%,2,0,100.00%
beta.audiobro.com,2,0.00%,2,0,100.00%
slp2p-east-std1061.oray.net,2,0.00%,2,0,100.00%
q.quora.com,2,0.00%,4,2,50.00%
blob.bnz13prdstr09a.store.core.windows.net,2,0.00%,2,0,100.00%
clIenTloGvOdp2P.hAplaT.neT,2,0.00%,2,0,100.00%
tRAnsit1.wsLog.cHiNAnEtCeNTeR.cOm,2,0.00%,2,0,100.00%
mambAP2PVODh5.8686c.cOM,2,0.00%,2,0,100.00%
CLIeNtlogvOdp2P.HAPLAT.nET,2,0.00%,2,0,100.00%
TRansIt1.wSlOG.cHInAneTcENTEr.COm,2,0.00%,2,0,100.00%
maMbAP2pvoDh5.8686C.Com,2,0.00%,2,0,100.00%
tva1.sinaimg.cn,2,0.00%,104,102,1.92%
p5.itc.cn,2,0.00%,13,11,15.38%
hjne-420e0a.debate-cents.net,2,0.00%,2,0,100.00%
updates.thingsboard.io,2,0.00%,2,0,100.00%
ip3746756454.funshion.com,2,0.00%,2,0,100.00%
feed-navi.cdn.bcebos.com,2,0.00%,2,0,100.00%
daa2ks08y5ls.cloudfront.net,2,0.00%,2,0,100.00%
www.twitter.com,2,0.00%,5,3,40.00%
upg-api.blackshark.com,2,0.00%,2,0,100.00%
search-aws.maven.org,2,0.00%,2,0,100.00%
search-maven-org-prod-env.us-east-1.elasticbeanstalk.com,2,0.00%,2,0,100.00%
limoconnect.ridebitsapp.com,2,0.00%,2,0,100.00%
cdn.onenote.net.edgekey.net,2,0.00%,5,3,40.00%
eur2.akam.net,2,0.00%,2,0,100.00%
eur6.akam.net,2,0.00%,2,0,100.00%
use4.akam.net,2,0.00%,2,0,100.00%
usw2.akam.net,2,0.00%,2,0,100.00%
boss1.laobanfacai.cf,2,0.00%,2,0,100.00%
v3-x.douyinvod.com,2,0.00%,2,0,100.00%
v3-x.douyinvod.com.w.cdngslb.com,2,0.00%,2,0,100.00%
hkgame05.graniterapids.com,2,0.00%,2,0,100.00%
tilldawn.yxingfan.com,2,0.00%,2,0,100.00%
p2.music.126.net.163jiasu.com,2,0.00%,4,2,50.00%
www.googleapis.cn,2,0.00%,8,6,25.00%
e1539.dscb.akamaiedge.net,2,0.00%,3,1,66.67%
download.zotero.org,2,0.00%,2,0,100.00%
passcommon-drcn.wallet.hicloud.com,2,0.00%,2,0,100.00%
bank-drcn.wallet.hicloud.com,2,0.00%,2,0,100.00%
tsm.95516.com,2,0.00%,2,0,100.00%
external-content.duckduckgo.com,2,0.00%,2,0,100.00%
event-report.kaikeba.com,2,0.00%,2,0,100.00%
tjtv3.wn51.com,2,0.00%,2,0,100.00%
api.transfer.sec.miui.com,2,0.00%,2,0,100.00%
miui-fxcse.avlyun.com,2,0.00%,2,0,100.00%
k2-dy-x-ml.gslb.ksyuncdn.com,2,0.00%,6,4,33.33%
c-9999.c-msedge.net,2,0.00%,2,0,100.00%
mpvideo.qpic.cn,2,0.00%,11,9,18.18%
note.ue-y.me,2,0.00%,2,0,100.00%
lc.map.baidu.com,2,0.00%,6,4,33.33%
lbsnavi.cdn.bcebos.com,2,0.00%,2,0,100.00%
static-cdn-test-shared-fastly.springer.com,2,0.00%,2,0,100.00%
delivery.pbgrd.com,2,0.00%,2,0,100.00%
neofeng04-my.sharepoint.com,2,0.00%,2,0,100.00%
autoupdate.geo.opera.com,2,0.00%,23,21,8.70%
lhr-mvp.trafficmanager.net,2,0.00%,4,2,50.00%
saservices.dell.com,2,0.00%,4,2,50.00%
config.wn51.com,2,0.00%,2,0,100.00%
eu.rollserver.xyz,2,0.00%,2,0,100.00%
statsfe2.update.microsoft.com,2,0.00%,2,0,100.00%
teams.microsoft.com,2,0.00%,26,24,7.69%
its.huohua.cn,2,0.00%,2,0,100.00%
growth.ecombdapi.com,2,0.00%,2,0,100.00%
mazu.3g.qq.com,2,0.00%,2,0,100.00%
pubapi5.bizport.cn,2,0.00%,2,0,100.00%
pubapi.bizport.cn,2,0.00%,2,0,100.00%
xcx.yqgz.beijing.gov.cn,2,0.00%,2,0,100.00%
xcx-static.yqgz.beijing.gov.cn.dsa.dnsv1.com,2,0.00%,2,0,100.00%
aa48356a767c4c470780ab8d6386430d.qcloudzygj.com,2,0.00%,2,0,100.00%
jkbxcx-static.yqgz.beijing.gov.cn.cdn.dnsv1.com.cn,2,0.00%,2,0,100.00%
jp2.kingss.me,2,0.00%,2,0,100.00%
analytics.twitter.com,2,0.00%,6,4,33.33%
prod-dem-collector-elb-611025824.eu-west-1.elb.amazonaws.com,2,0.00%,2,0,100.00%
ru.wikipedia.org,2,0.00%,5,3,40.00%
a2129670914.cdn.optimizely.com,2,0.00%,2,0,100.00%
se2-cdn-cn.itunes-apple.com.akadns.net,2,0.00%,3,1,66.67%
prod-m-node-2113.ssp.advertising.com,2,0.00%,2,0,100.00%
elsevier.com.ssl.d1.sc.omtrdc.net,2,0.00%,2,0,100.00%
chi01pcor001-meta.fe.1drv.com,2,0.00%,3,1,66.67%
odc-chi01pap001-meta-geo.onedrive.akadns.net,2,0.00%,3,1,66.67%
odc-chi01pap001-meta-brs.onedrive.akadns.net,2,0.00%,3,1,66.67%
blob.dsm10prdstr03a.store.core.windows.net,2,0.00%,2,0,100.00%
dcs-edge-tyo3-624150721.ap-northeast-1.elb.amazonaws.com,2,0.00%,2,0,100.00%
tls12.newrelic.com.cdn.cloudflare.net,2,0.00%,2,0,100.00%
upos-sz-mirrorhwo1.bilivideo.com.ctdns.cn,2,0.00%,6,4,33.33%
api-prod.plu.mx,2,0.00%,2,0,100.00%
ads.as.criteo.com,2,0.00%,6,4,33.33%
i6.weather.oppomobile.com,2,0.00%,2,0,100.00%
pix.as.criteo.net,2,0.00%,2,0,100.00%
iwww.www.webofscience.com.akadns.net,2,0.00%,4,2,50.00%
www.webofknowledge.com,2,0.00%,2,0,100.00%
steamcommunity.com,2,0.00%,5,3,40.00%
terms1-hicloud-com-drcn.edge.dbankedge.cn,2,0.00%,2,0,100.00%
cs02-pps-drcn.dbankcdn.com.cdn.dnsv1.com,2,0.00%,2,0,100.00%
dnkeeper.hicloud.com,2,0.00%,2,0,100.00%
pixso.cn,2,0.00%,2,0,100.00%
log.umsns.com,2,0.00%,4,2,50.00%
newloc.map.n.shifen.com,2,0.00%,15,13,13.33%
wkimg.bdimg.com.a.bdydns.com,2,0.00%,3,1,66.67%
accountcapabilities-pa.googleapis.com,2,0.00%,4,2,50.00%
www.zryhyy.com.cn,2,0.00%,2,0,100.00%
cfgver.font.wps.cn,2,0.00%,2,0,100.00%
sporthealth-drcn.dbankcdn.com.c.cdnhwc1.com,2,0.00%,2,0,100.00%
sporthealth-drcn.dbankcdn.com.cdn.dnsv1.com,2,0.00%,2,0,100.00%
log3-normal-hl.toutiaoapi.com,2,0.00%,2,0,100.00%
gecko-hl.snssdk.com,2,0.00%,2,0,100.00%
dmd-ilp-hd.youku.com.w.cdngslb.com,2,0.00%,6,4,33.33%
blob.bn6prdstr04a.store.core.windows.net,2,0.00%,2,0,100.00%
i.ys7.com,2,0.00%,2,0,100.00%
appsforoffice.microsoft.com.edgekey.net,2,0.00%,2,0,100.00%
evcs-ocsp.ws.symantec.com,2,0.00%,4,2,50.00%
p47-fmfmobile.icloud.com.cn,2,0.00%,2,0,100.00%
cache.tv.qq.com.edgekey.net,2,0.00%,2,0,100.00%
bl6pcor002-com.be.1drv.com,2,0.00%,2,0,100.00%
i-bl6p-cor002.api.p001.1drv.com,2,0.00%,2,0,100.00%
vm.gtimg.cn.sched.legopic1.tdnsv6.com,2,0.00%,2,0,100.00%
mt.mbgcdn.lenovo.com.cn,2,0.00%,2,0,100.00%
mt.lenovo.com.cn.trpcdn.net,2,0.00%,2,0,100.00%
u996.v.trpcdn.net,2,0.00%,2,0,100.00%
sa.apis.dell.com,2,0.00%,2,0,100.00%
img.gamecenter.qq.com,2,0.00%,4,2,50.00%
r3.sn-ni5een7s.gvt1.com,2,0.00%,2,0,100.00%
blob.bn9prdstr13a.store.core.windows.net,2,0.00%,2,0,100.00%
dsm01pcor002-com.be.1drv.com,2,0.00%,2,0,100.00%
onedriveclubprodbn20018.blob.core.windows.net,2,0.00%,2,0,100.00%
hkt02.graniterapids.com,2,0.00%,2,0,100.00%
acs-mum.alibabachengdun.com,2,0.00%,2,0,100.00%
client-upload.cn-shanghai.log.aliyuncs.com,2,0.00%,2,0,100.00%
impaas-for-client.cn-shanghai.log.aliyuncs.com,2,0.00%,2,0,100.00%
mum.alibabachengdun.com,2,0.00%,2,0,100.00%
phonef-drcn.cloud.dbankcloud.cn,2,0.00%,2,0,100.00%
wxsnsad.tc.qq.com,2,0.00%,2,0,100.00%
hbopenbid.pubmatic.com,2,0.00%,2,0,100.00%
gcdn.2mdn.net,2,0.00%,2,0,100.00%
e2c21.gcp.gvt2.com,2,0.00%,2,0,100.00%
shoppingcampaigns-api-drcn.ai.dbankcloud.com,2,0.00%,2,0,100.00%
clIeNtLogvOdP2P.hAPlat.NEt,2,0.00%,2,0,100.00%
trANSIt1.wsLog.ChiNAneTCeNtER.coM,2,0.00%,2,0,100.00%
mamBAp2pvoDh5.8686c.com,2,0.00%,2,0,100.00%
d16fk4ms6rqz1v.cloudfront.net,2,0.00%,2,0,100.00%
extensionwebstorebase.edgesv.net,2,0.00%,4,2,50.00%
3scpuqeq.sched.sma.tdnsstic1.cn.cjt.krcdn.idatacube.com,2,0.00%,2,0,100.00%
jp18.graniterapids.com,2,0.00%,2,0,100.00%
geoip.ubuntu.com,2,0.00%,2,0,100.00%
r3---sn-ni5eln7e.gvt1.com,2,0.00%,2,0,100.00%
cast.google.com,2,0.00%,2,0,100.00%
us04logfiles.zoom.us,2,0.00%,2,0,100.00%
us04-logfiles-va.zoom.us,2,0.00%,2,0,100.00%
changdunovel.com,2,0.00%,2,0,100.00%
lf-cdn-tos.bytescm.com.bytedns1.com,2,0.00%,2,0,100.00%
open.snssdk.com.gtm.byte008.com,2,0.00%,2,0,100.00%
www.aigei.com,2,0.00%,2,0,100.00%
kefu.easemob.com,2,0.00%,2,0,100.00%
webim.kefu.easemob.com,2,0.00%,2,0,100.00%
985liteu.sched.skalego-dk.tdnsstic1.cn,2,0.00%,8,6,25.00%
posthog.momentumdash.com,2,0.00%,2,0,100.00%
query.dcdn.baidu.com,2,0.00%,2,0,100.00%
cdn-ali-file-shc.dolphinpaper.com,2,0.00%,2,0,100.00%
graph.print.microsoft.com,2,0.00%,4,2,50.00%
apt.dockerproject.org,2,0.00%,2,0,100.00%
kobe.lakersggg.tk,2,0.00%,2,0,100.00%
ns2.etisalatdomains.ae,2,0.00%,2,0,100.00%
changelogs.ubuntu.com,2,0.00%,84,82,2.38%
i-dsm01p-cor004.api.p001.1drv.com,2,0.00%,2,0,100.00%
gap.work.weixin.qq.com,2,0.00%,71,69,2.82%
v.map.baidu.com,2,0.00%,4,2,50.00%
www.transifex.com,2,0.00%,2,0,100.00%
p9854759.iavs9x.u.avast.com,2,0.00%,6,4,33.33%
p1043812.vps18.u.avcdn.net,2,0.00%,4,2,50.00%
c3978047.vps18.u.avcdn.net,2,0.00%,4,2,50.00%
l4691727.iavs9x.u.avast.com,2,0.00%,4,2,50.00%
l7814800.vps18.u.avcdn.net,2,0.00%,4,2,50.00%
m0658849.vps18.u.avcdn.net,2,0.00%,4,2,50.00%
r6726306.vps18.u.avcdn.net,2,0.00%,4,2,50.00%
y8002308.vps18.u.avcdn.net,2,0.00%,6,4,33.33%
1610064307.D4EE073C2A20.device.hiwifi.com,2,0.00%,2,0,100.00%
swcdn.apple.com,2,0.00%,4,2,50.00%
krsk04.graniterapids.com,2,0.00%,2,0,100.00%
ksc-bj.ag.wps.cn,2,0.00%,2,0,100.00%
www.ijcai.org,2,0.00%,2,0,100.00%
image.tingmall.com,2,0.00%,2,0,100.00%
api3-normal-hl.toutiaoapi.com,2,0.00%,2,0,100.00%
logservice-drcn.dt.hihonorcloud.com,2,0.00%,2,0,100.00%
ns.dewa.gov.ae,2,0.00%,2,0,100.00%
ns2.dewa.gov.ae,2,0.00%,2,0,100.00%
tbm-auth.alicdn.com,2,0.00%,4,2,50.00%
fqdu9p4j444uaeqmgvurgiudomd6eggr8npungst0karq886t4pfucpu.qc.x.bsgslb.cn,2,0.00%,2,0,100.00%
www.wanfangdata.com.cn,2,0.00%,4,2,50.00%
apps.wanfangdata.com.cn,2,0.00%,2,0,100.00%
w.wanfangdata.com.cn,2,0.00%,2,0,100.00%
hw-gz-live-p2p-04.chat.bilibili.com,2,0.00%,2,0,100.00%
tx-bj-live-comet-02.chat.bilibili.com,2,0.00%,2,0,100.00%
log.avlyun.com,2,0.00%,2,0,100.00%
ads.aipress.ro,2,0.00%,2,0,100.00%
eif7aet4.nodedata.net,2,0.00%,2,0,100.00%
phaiqu4l.nodedata.net,2,0.00%,2,0,100.00%
krsk07.graniterapids.com,2,0.00%,2,0,100.00%
b7210692.iavs9x.u.avast.com,2,0.00%,6,4,33.33%
n8283613.vps18.u.avcdn.net,2,0.00%,6,4,33.33%
s1843811.vps18.u.avcdn.net,2,0.00%,6,4,33.33%
jcr.clarivate.com,2,0.00%,2,0,100.00%
cdn.digital-experience.clarivate.io,2,0.00%,4,2,50.00%
hongcai.163.com,2,0.00%,2,0,100.00%
relottery.nosdn.127.net,2,0.00%,2,0,100.00%
icon.cnzz.com,2,0.00%,2,0,100.00%
CLIEntloGVoDP2p.haplaT.NET,2,0.00%,2,0,100.00%
TraNsIt1.wSLoG.CHINANETcentER.coM,2,0.00%,2,0,100.00%
MaMbAp2pVodh5.8686c.COM,2,0.00%,2,0,100.00%
n.guanjia.qq.com,2,0.00%,339,337,0.59%
activity.hdslb.com,2,0.00%,2,0,100.00%
www.blueswans.com,2,0.00%,2,0,100.00%
www.fastly-insights.com,2,0.00%,2,0,100.00%
1610057047.D4EE073C2A20.device.hiwifi.com,2,0.00%,2,0,100.00%
game.gtimg.cn.sched.legopic2.tdnsv6.com,2,0.00%,2,0,100.00%
ams.game.qq.com,2,0.00%,2,0,100.00%
rc10-fc07.oray.com,2,0.00%,2,0,100.00%
touch.kaspersky.com,2,0.00%,2,0,100.00%
s07.upd.kaspersky.com,2,0.00%,2,0,100.00%
services.ucp.kaspersky-labs.com,2,0.00%,2,0,100.00%
d9217321.avi18.u.avcdn.net,2,0.00%,6,4,33.33%
y7637820.avi18.u.avcdn.net,2,0.00%,6,4,33.33%
man7.org,2,0.00%,2,0,100.00%
shepherd.ff.avast.com,2,0.00%,3,1,66.67%
shepherd.avcdn.net,2,0.00%,3,1,66.67%
s-nuistatic.avcdn.net,2,0.00%,7,5,28.57%
img2.xs.cdnyes.com,2,0.00%,2,0,100.00%
img1.xs.cdnyes.com,2,0.00%,2,0,100.00%
www.szfs168.com,2,0.00%,2,0,100.00%
www.7e.hk,2,0.00%,4,2,50.00%
google-maps.gosur.com,2,0.00%,2,0,100.00%
paimgcdn.jomodns.com,2,0.00%,5,3,40.00%
open.a.shifen.com,2,0.00%,7,5,28.57%
leads.e.shifen.com,2,0.00%,2,0,100.00%
floor.jd.com.gslb.qianxun.com,2,0.00%,6,4,33.33%
pjapi.jd.com.gslb.qianxun.com,2,0.00%,2,0,100.00%
assets.leetcode.cn.w.kunluncan.com,2,0.00%,2,0,100.00%
assets.giocdn.com.wswebpic.com,2,0.00%,2,0,100.00%
vals.atm.youku.com,2,0.00%,11,9,18.18%
cc-api-teamprojects.adobe.io,2,0.00%,2,0,100.00%
cdn.babakan.xyz,2,0.00%,2,0,100.00%
c7.4199tv.com,2,0.00%,2,0,100.00%
landing.adobe.com,2,0.00%,4,2,50.00%
postoffice.adobe.com,2,0.00%,2,0,100.00%
487e1e9ab8894eed892c47b9452120c7.fp.measure.office.com,2,0.00%,2,0,100.00%
play.qiqiuyun.net,2,0.00%,2,0,100.00%
service-stats.qiqiuyun.net,2,0.00%,2,0,100.00%
snippets.cdn.mozilla.net,2,0.00%,2,0,100.00%
www.majorgeeks.com,2,0.00%,2,0,100.00%
ff.kis.v2.scr.kaspersky-labs.com,2,0.00%,2,0,100.00%
cnrefhk2.standurl.xyz,2,0.00%,2,0,100.00%
ind-aws.onlineto.xyz,2,0.00%,2,0,100.00%
mmgame.qpic.cn,2,0.00%,2,0,100.00%
mmgame.qpic.cn.cloud.tc.qq.com,2,0.00%,2,0,100.00%
mmgame.qpic.cn.sched.px.tdnsv6.com,2,0.00%,2,0,100.00%
pvstat.qihoo.com,2,0.00%,2,0,100.00%
tw07.graniterapids.com,2,0.00%,2,0,100.00%
k8136955.iavs9x.avg.u.avcdn.net,2,0.00%,4,2,50.00%
z3477431.iavs9x.avg.u.avcdn.net,2,0.00%,4,2,50.00%
b5006751.avi18.u.avcdn.net,2,0.00%,4,2,50.00%
l9346865.avi18.u.avcdn.net,2,0.00%,4,2,50.00%
z3477431.avi18.u.avcdn.net,2,0.00%,4,2,50.00%
voipfinderliveplay.wxqcloud.qq.com.l4vip-dk.sched.dcloudlive.com.clive.cdncloud.idc400.com,2,0.00%,4,2,50.00%
apt.llvm.org,2,0.00%,33,31,6.06%
a.gtld-servers.net,2,0.00%,10,8,20.00%
nel.fastly-insights.com,2,0.00%,4,2,50.00%
wbpctips.uve.weibo.com,2,0.00%,2,0,100.00%
contentrecommend-out.uve.weibo.com,2,0.00%,2,0,100.00%
api.cognitive.microsofttranslator.com,2,0.00%,2,0,100.00%
download01.ino.qq.com,2,0.00%,2,0,100.00%
xiyou360.net,2,0.00%,3,1,66.67%
alsc-ug-monitor-callback.alibaba.com,2,0.00%,3,1,66.67%
mpa.autodesk.com,2,0.00%,2,0,100.00%
transIT1.wSlog.chInaNETcEnTeR.cOM,2,0.00%,2,0,100.00%
cLieNtlOgVodp2P.hAplaT.Net,2,0.00%,2,0,100.00%
maMbaP2Pvodh5.8686c.com,2,0.00%,2,0,100.00%
dlsvr04.huashuo.cdnudns.com,2,0.00%,2,0,100.00%
api.changbalive.com,2,0.00%,2,0,100.00%
apis.changbalive.com,2,0.00%,2,0,100.00%
yd-tc.changba.com,2,0.00%,2,0,100.00%
live.api.changba.com,2,0.00%,2,0,100.00%
edge.wshttpdns.com,2,0.00%,2,0,100.00%
aliimg.changbalive.com,2,0.00%,2,0,100.00%
92.push2.eastmoney.com,2,0.00%,3,1,66.67%
89.push2.eastmoney.com,2,0.00%,4,2,50.00%
download.wireguard.com,2,0.00%,5,3,40.00%
c-73-77-194-42.hsd1.tx.comcast.net,2,0.00%,2,0,100.00%
capi.core-prod.grammarlyaws.com,2,0.00%,2,0,100.00%
i2.sinaimg.cn,2,0.00%,4,2,50.00%
log.mix.sina.com.cn,2,0.00%,2,0,100.00%
MAmbAP2PVOdh5.8686C.COm,2,0.00%,2,0,100.00%
CLiENTLoGVOdP2P.HapLaT.NET,2,0.00%,2,0,100.00%
tRansIT1.WsLOg.CHINaneTcenter.cOm,2,0.00%,2,0,100.00%
lcs-ulecs.adobe.io,2,0.00%,2,0,100.00%
bdsp.x.jd.com,2,0.00%,2,0,100.00%
api5-normal-lf.toutiaoapi.com,2,0.00%,2,0,100.00%
lf9-open-ma-pkg-sign.bytemastatic.com,2,0.00%,4,2,50.00%
lf26-open-ma-pkg-sign.bytemastatic.com,2,0.00%,4,2,50.00%
lf3-open-ma-pkg-sign.bytemastatic.com,2,0.00%,4,2,50.00%
lf6-open-ma-pkg-sign.bytemastatic.com,2,0.00%,4,2,50.00%
o15.officeredir.microsoft.com,2,0.00%,2,0,100.00%
c.s-microsoft.com,2,0.00%,6,4,33.33%
xuewen.cnki.net,2,0.00%,2,0,100.00%
r1---sn-2x3elnes.gvt1.com,2,0.00%,2,0,100.00%
dl.qqpy.sogou.com,2,0.00%,2,0,100.00%
p4.itc.cn,2,0.00%,5,3,40.00%
sucimg.itc.cn,2,0.00%,5,3,40.00%
apiv2.sohu.com,2,0.00%,2,0,100.00%
capi-tier-2-us-east-2.connatix.com,2,0.00%,2,0,100.00%
dns3.gov.il,2,0.00%,2,0,100.00%
conn-service-cn-05.allawntech.com,2,0.00%,2,0,100.00%
conn-service-cn-04.allawntech.com,2,0.00%,2,0,100.00%
hg01.ptrecord.com,2,0.00%,2,0,100.00%
p206-imap.mail.icloud.com.cn,2,0.00%,2,0,100.00%
apparticle.longhuvip.com,2,0.00%,2,0,100.00%
apphis.longhuvip.com,2,0.00%,2,0,100.00%
applhb.longhuvip.com,2,0.00%,2,0,100.00%
applog.longhuvip.com,2,0.00%,2,0,100.00%
appsockapp.longhuvip.com,2,0.00%,2,0,100.00%
appupchina.longhuvip.com,2,0.00%,2,0,100.00%
appimgcdn.longhuvip.com,2,0.00%,2,0,100.00%
gahfueby.sched.sma.tdnsstic1.cn,2,0.00%,2,0,100.00%
gahfueby.sched.sma.tdnsstic1.cn.cjt.krcdn.idatacube.com,2,0.00%,2,0,100.00%
iosstatic.taoguba.com.cn,2,0.00%,2,0,100.00%
1101576.sched.sma.tdnsstic1.cn.cjt.krcdn.idatacube.com,2,0.00%,2,0,100.00%
nws.taoguba.com.cn,2,0.00%,2,0,100.00%
bgg.baidu.com,2,0.00%,2,0,100.00%
js.taoguba.com.cn,2,0.00%,2,0,100.00%
fngateway.bangdao-tech.com,2,0.00%,2,0,100.00%
pay.cnki.net,2,0.00%,2,0,100.00%
ts.bdimg.com,2,0.00%,2,0,100.00%
ms-vscode-remote.gallerycdn.azure.cn,2,0.00%,2,0,100.00%
api.m.jd.com,2,0.00%,27,25,7.41%
m15.360buyimg.com,2,0.00%,4,2,50.00%
homepage-gw.jd.com,2,0.00%,2,0,100.00%
vod.300hu.com,2,0.00%,4,2,50.00%
adsfile.bssdlbig.kugou.com,2,0.00%,4,2,50.00%
api.interaction.sohu.com,2,0.00%,2,0,100.00%
ohd8oi6c.nodedata.net,2,0.00%,2,0,100.00%
openapi.baidu.com,2,0.00%,9,7,22.22%
guess.mediav.com,2,0.00%,45,43,4.44%
ke.study.163.com,2,0.00%,2,0,100.00%
live.study.163.com,2,0.00%,2,0,100.00%
ke.youdao.com,2,0.00%,2,0,100.00%
oimagea5.ydstatic.com,2,0.00%,2,0,100.00%
www.tslsmart.com,2,0.00%,2,0,100.00%
usersync.getpublica.com,2,0.00%,2,0,100.00%
www.storygize.net,2,0.00%,2,0,100.00%
icon.nosdn.127.net,2,0.00%,2,0,100.00%
oimagec5.ydstatic.com,2,0.00%,2,0,100.00%
oimagea2.ydstatic.com,2,0.00%,2,0,100.00%
oimagec3.ydstatic.com,2,0.00%,2,0,100.00%
oimageb2.ydstatic.com,2,0.00%,2,0,100.00%
oimageb8.ydstatic.com,2,0.00%,2,0,100.00%
oimagea6.ydstatic.com,2,0.00%,2,0,100.00%
oimageb3.ydstatic.com,2,0.00%,2,0,100.00%
icourse163.soboten.com,2,0.00%,2,0,100.00%
weblink05.netease.im,2,0.00%,2,0,100.00%
p2pupdate.inter.iqiyi.com,2,0.00%,2,0,100.00%
objekte.jmberlin.de,2,0.00%,2,0,100.00%
pgyapi-adv.oray.net,2,0.00%,2,0,100.00%
dls-udc.dqa.samsung.com.cn,2,0.00%,2,0,100.00%
api.map.n.shifen.com,2,0.00%,9,7,22.22%
haijia.xuechebu.com,2,0.00%,2,0,100.00%
blob.dsm08prdstr03a.store.core.windows.net,2,0.00%,2,0,100.00%
ad-sh-sz-zb.wagbridge.tanx.alimama.com.gds.alibabadns.com,2,0.00%,2,0,100.00%
user-api-v2.oray.com,2,0.00%,2,0,100.00%
download.csdn.net,2,0.00%,2,0,100.00%
mp-luckydraw1.csdn.net,2,0.00%,2,0,100.00%
163mx01.mxmail.netease.com,2,0.00%,2,0,100.00%
163mx02.mxmail.netease.com,2,0.00%,2,0,100.00%
163mx03.mxmail.netease.com,2,0.00%,2,0,100.00%
163mx00.mxmail.netease.com,2,0.00%,2,0,100.00%
backend.devrank.cn,2,0.00%,2,0,100.00%
live.ixigua.com,2,0.00%,2,0,100.00%
s3a.bytecdn.cn,2,0.00%,2,0,100.00%
s3.bytecdn.cn,2,0.00%,2,0,100.00%
unpkg.byted-static.com,2,0.00%,2,0,100.00%
js.yjbys.com,2,0.00%,4,2,50.00%
www.ruiwen.com,2,0.00%,2,0,100.00%
bt.dl1234.com,2,0.00%,2,0,100.00%
eid.jd.com,2,0.00%,2,0,100.00%
ccfjma.m.jd.com,2,0.00%,2,0,100.00%
rjsb-token-m.jd.com,2,0.00%,2,0,100.00%
anti-sdk-ccs.m.jd.com,2,0.00%,2,0,100.00%
fireactive.jd.com,2,0.00%,2,0,100.00%
firevent.jd.com,2,0.00%,2,0,100.00%
lbsapi.m.jd.com,2,0.00%,2,0,100.00%
ngw.m.jd.com,2,0.00%,2,0,100.00%
st.360buyimg.com,2,0.00%,2,0,100.00%
pfga0.market.xiaomi.com,2,0.00%,2,0,100.00%
sasinator.realestate.com.au,2,0.00%,2,0,100.00%
edgetippingservice.webxtsvc.microsoft.com,2,0.00%,2,0,100.00%
slapi-biz.oray.net,2,0.00%,2,0,100.00%
crl.crlocsp.cn,2,0.00%,2,0,100.00%
www.webhek.com,2,0.00%,2,0,100.00%
netsmell.com,2,0.00%,2,0,100.00%
pgy-prm02.oray.net,2,0.00%,2,0,100.00%
mail.computerguysusa.com,2,0.00%,2,0,100.00%
www.current.a.prd.aadg.akadns.NET,2,0.00%,2,0,100.00%
aweme-eagle-hl.snssdk.com,2,0.00%,2,0,100.00%
v2.ghelper.net,2,0.00%,2,0,100.00%
survey-smiles.com,2,0.00%,2,0,100.00%
clc.stackoverflow.com,2,0.00%,2,0,100.00%
pheecws.foxitsoftware.cn,2,0.00%,2,0,100.00%
note.ntes53.netease.com,2,0.00%,2,0,100.00%
content.map.baidu.com,2,0.00%,2,0,100.00%
bn1303.storage.live.com,2,0.00%,3,1,66.67%
si.geilicdn.com,2,0.00%,2,0,100.00%
logtake.weidian.com,2,0.00%,2,0,100.00%
static.weidian.com,2,0.00%,2,0,100.00%
try.speed.cdn.vip.xunlei.com,2,0.00%,2,0,100.00%
clog.iclick.com.cn,2,0.00%,2,0,100.00%
ihsu-southeastasia-3.southeastasia.cloudapp.azure.com,2,0.00%,2,0,100.00%
82.push2.eastmoney.com,2,0.00%,4,2,50.00%
git.cipsup.cn,2,0.00%,2,0,100.00%
rc10-fc10.oray.com,2,0.00%,2,0,100.00%
admin.quikly-ejh-untouched-br-ekyq53.quiklydemo.com,2,0.00%,2,0,100.00%
api.pagenote.cn,2,0.00%,2,0,100.00%
iristech.co,2,0.00%,2,0,100.00%
dcs.mspcloud.cn,2,0.00%,2,0,100.00%
iemeith7.nodedata.net,2,0.00%,2,0,100.00%
soh5quik.nodedata.net,2,0.00%,2,0,100.00%
cfg.pcfg.cache.wpscdn.cn,2,0.00%,5,3,40.00%
updates.jenkins.io,2,0.00%,2,0,100.00%
aicloud-obs.op.hihonorcloud.com,2,0.00%,2,0,100.00%
fgm.sq581.com,2,0.00%,2,0,100.00%
lgm.sq581.com,2,0.00%,2,0,100.00%
devsdata.sq581.com,2,0.00%,2,0,100.00%
update-0001.jindianle.com,2,0.00%,2,0,100.00%
dfemic.sq581.com,2,0.00%,2,0,100.00%
mobile.sug.so.com,2,0.00%,2,0,100.00%
zx.da.mgtv.com,2,0.00%,2,0,100.00%
cp.bz.mgtv.com,2,0.00%,2,0,100.00%
hubmirror.v2raya.org,2,0.00%,4,2,50.00%
sdk.open.phone.igexin.com,2,0.00%,4,2,50.00%
psbi.cname.getui.com,2,0.00%,4,2,50.00%
os-mon.snssdk.com.w.cdngslb.com,2,0.00%,2,0,100.00%
wxmall-lv.topsports.com.cn,2,0.00%,2,0,100.00%
ubc.topsports.com.cn,2,0.00%,2,0,100.00%
fayin.donglin.org,2,0.00%,2,0,100.00%
dispatchcnglobal.yuanshen.com,2,0.00%,2,0,100.00%
store-037-lb.blobstore-apple.com.akadns.net,2,0.00%,2,0,100.00%
m.sdsgwy.com,2,0.00%,2,0,100.00%
ns6.cstnet.cn,2,0.00%,2,0,100.00%
config-api.internet.apps.samsung.com,2,0.00%,2,0,100.00%
sm01.alicdn.com,2,0.00%,2,0,100.00%
sm.bdimg.com,2,0.00%,2,0,100.00%
sia.internet.apps.samsung.com,2,0.00%,4,2,50.00%
publish-pic-cpu.baidu.com,2,0.00%,2,0,100.00%
caclick.baidu.com,2,0.00%,2,0,100.00%
di-prd.samsung.com.cn,2,0.00%,2,0,100.00%
report-v2.samsung.japps.cn,2,0.00%,2,0,100.00%
tdapi.srcgsre.com,2,0.00%,2,0,100.00%
img.samsungapps.com,2,0.00%,2,0,100.00%
wdl1.file.cache.docer.com.qiniudns.com,2,0.00%,4,2,50.00%
api.whchenxiang.com,2,0.00%,2,0,100.00%
sfxtcs.mynatapp.cc,2,0.00%,2,0,100.00%
commimg-2.pddpic.com,2,0.00%,2,0,100.00%
avatar2-2.pddpic.com,2,0.00%,3,1,66.67%
www.inderscience.com,2,0.00%,2,0,100.00%
evilpan.com,2,0.00%,2,0,100.00%
vopeic0v.nodedata.net,2,0.00%,2,0,100.00%
leancloud.evilpan.com,2,0.00%,2,0,100.00%
ins-9wmttp48.ias.tencent-cloud.net,2,0.00%,2,0,100.00%
frontier-im.douyin.com,2,0.00%,2,0,100.00%
update.pdfarchitect.org,2,0.00%,2,0,100.00%
duckduckgo.com,2,0.00%,4,2,50.00%
search.naver.com,2,0.00%,2,0,100.00%
5446985da9f84af8b9827350f8e638b0.fp.measure.office.com,2,0.00%,2,0,100.00%
p66-caldav.icloud.com.cn,2,0.00%,2,0,100.00%
p42-caldav.icloud.com.cn,2,0.00%,2,0,100.00%
8.push2.eastmoney.com,2,0.00%,3,1,66.67%
11.push2.eastmoney.com,2,0.00%,4,2,50.00%
mgxhtj.kuwo.cn,2,0.00%,2,0,100.00%
images-2.pinduoduo.com,2,0.00%,2,0,100.00%
push-resources-1258344701.file.myqcloud.com,2,0.00%,2,0,100.00%
dl-oss-wanju.youku.com,2,0.00%,5,3,40.00%
zhushou.officeaid02.com,2,0.00%,2,0,100.00%
log.officeaid.com,2,0.00%,2,0,100.00%
guzzoni-smoot.v.aaplimg.com,2,0.00%,2,0,100.00%
d.wanfangdata.com.cn,2,0.00%,2,0,100.00%
sensors.cloud.tencent.com,2,0.00%,2,0,100.00%
bohuitalent.com,2,0.00%,2,0,100.00%
www.66rpg.com,2,0.00%,2,0,100.00%
pub.funshion.com,2,0.00%,2,0,100.00%
eleanor.oceanwatersport.com,2,0.00%,2,0,100.00%
blog3.doneone.tk,2,0.00%,2,0,100.00%
pdns124.ultradns.biz,2,0.00%,5,3,40.00%
so.ie.sogou.com,2,0.00%,2,0,100.00%
123.sogo.com,2,0.00%,2,0,100.00%
so.ie.sogo.com,2,0.00%,2,0,100.00%
mmres.mingchuanxx.com,2,0.00%,2,0,100.00%
mvd.bzcqly.com,2,0.00%,2,0,100.00%
res-cdn-sslauth.sxystxx.top,2,0.00%,2,0,100.00%
mmresw-cdn-sslaut.mingchuanxx.com,2,0.00%,2,0,100.00%
res-cdns.sxjpdxx.top,2,0.00%,2,0,100.00%
mmrest-sslauth.mingchuanxx.com,2,0.00%,2,0,100.00%
h5cdns.tbrbz.com,2,0.00%,2,0,100.00%
res-cdns-gift.sxjpdxx.top,2,0.00%,2,0,100.00%
CLIeNTlOGVODp2p.haPLaT.nEt,2,0.00%,2,0,100.00%
tranSiT1.wsLOG.ChinaNeTCENter.com,2,0.00%,2,0,100.00%
imgconvert.csdnimg.cn,2,0.00%,2,0,100.00%
community.iqiyi.com,2,0.00%,6,4,33.33%
mm4.365dmp.com,2,0.00%,2,0,100.00%
adxlog-adnet.vivo.com.cn,2,0.00%,2,0,100.00%
resource.chunyu.mobi,2,0.00%,2,0,100.00%
wps.processon.com,2,0.00%,2,0,100.00%
clientweb.docer.wps.cn,2,0.00%,2,0,100.00%
dl.op.wpscdn.cn,2,0.00%,2,0,100.00%
picture.docer.wps.cn,2,0.00%,2,0,100.00%
photo-static-api.fotomore.com,2,0.00%,2,0,100.00%
ixav-cse.avlyun.com,2,0.00%,2,0,100.00%
tag.lenovo.com,2,0.00%,2,0,100.00%
bqq.gtimg.com,2,0.00%,2,0,100.00%
click.lenovo.com,2,0.00%,2,0,100.00%
admin.qidian.qq.com,2,0.00%,2,0,100.00%
v.qidian.qq.com,2,0.00%,2,0,100.00%
webpage.qidian.qq.com,2,0.00%,2,0,100.00%
chat.qidian.qq.com,2,0.00%,2,0,100.00%
5.push2.eastmoney.com,2,0.00%,4,2,50.00%
canada.swingtradebot.com,2,0.00%,2,0,100.00%
oraybox.com,2,0.00%,2,0,100.00%
chatlink-yqsx03.netease.im,2,0.00%,2,0,100.00%
chatlink-yqsx09.netease.im,2,0.00%,2,0,100.00%
chatlink-yqsx05.netease.im,2,0.00%,2,0,100.00%
chatlink-yqsx11.netease.im,2,0.00%,2,0,100.00%
ssltj.huixiaobao.net,2,0.00%,2,0,100.00%
a303.dscd.akamai.net,2,0.00%,4,2,50.00%
au03.graniterapids.com,2,0.00%,2,0,100.00%
portal-portm.meituan.com,2,0.00%,15,13,13.33%
my.sina.com.cn,2,0.00%,2,0,100.00%
wp.news.sina.com.cn,2,0.00%,2,0,100.00%
slide.sc.sina.com.cn,2,0.00%,2,0,100.00%
0bf1d300bafeafb279fe9a0655ce1535.safeframe.googlesyndication.com,2,0.00%,2,0,100.00%
www.vocabulary.com,2,0.00%,2,0,100.00%
open2.kaikeba.com,2,0.00%,2,0,100.00%
eh17.foot5176.cf,2,0.00%,2,0,100.00%
slp2p-east-std24.oray.net,2,0.00%,2,0,100.00%
ad-s2s.fengmanginfo.cn,2,0.00%,2,0,100.00%
server-notifications.atlassian.com,2,0.00%,2,0,100.00%
whisper-gateway.services.atlassian.com,2,0.00%,2,0,100.00%
fr03.graniterapids.com,2,0.00%,2,0,100.00%
m.xingyiqi.tk,2,0.00%,2,0,100.00%
frontier-aweme-lf-ipainner.amemv.com,2,0.00%,2,0,100.00%
139.cn,2,0.00%,2,0,100.00%
aeccutvaq66clcmw.node.ppio.cloud,2,0.00%,2,0,100.00%
aeccz42khmpfj4kh.node.ppio.cloud,2,0.00%,2,0,100.00%
stat.funshion.com,2,0.00%,2,0,100.00%
neirong.funshion.com,2,0.00%,2,0,100.00%
aecalsrpy7fxct4w.node.ppio.cloud,2,0.00%,2,0,100.00%
www.extrabux.cn,2,0.00%,2,0,100.00%
p.extrabux.top,2,0.00%,2,0,100.00%
copilot-telemetry-service.githubusercontent.com,2,0.00%,2,0,100.00%
pixel.tapad.com,2,0.00%,2,0,100.00%
www.shuzhiduo.com,2,0.00%,2,0,100.00%
www.zhenai.com,2,0.00%,2,0,100.00%
nsp-hicloud-cloudphotoeast3-p02-drcn.obs.cn-east-3.myhuaweicloud.cn,2,0.00%,2,0,100.00%
nsp-hicloud-cloudbackupeast3-p01-drcn.obs.cn-east-3.myhuaweicloud.cn,2,0.00%,2,0,100.00%
nsp-hicloud-cloudbackupeast3-p03-drcn.obs.cn-east-3.myhuaweicloud.cn,2,0.00%,2,0,100.00%
imagesync-sgc.pubmnet.com,2,0.00%,2,0,100.00%
a1184.b.akamai.net,2,0.00%,2,0,100.00%
adtrack-php-loadbalancer-1729355303.eu-west-1.elb.amazonaws.com,2,0.00%,2,0,100.00%
pug-sgc.pubmnet.com,2,0.00%,2,0,100.00%
dsm01pcor007-com.be.1drv.com,2,0.00%,2,0,100.00%
1.push2.eastmoney.com,2,0.00%,4,2,50.00%
22.push2.eastmoney.com,2,0.00%,3,1,66.67%
el5o9gfc2lc4hsphnupeknor001drj00bvk287hrnde5khqougvvuiuo.qc.x.bsgslb.cn,2,0.00%,2,0,100.00%
imge.kugou.com,2,0.00%,8,6,25.00%
kan.cc,2,0.00%,2,0,100.00%
afliplc.getxlx.com,2,0.00%,2,0,100.00%
aflzz-hk.meiquankongjian.com,2,0.00%,2,0,100.00%
aflzz-tw.meiquankongjian.com,2,0.00%,2,0,100.00%
aflzz-jp.meiquankongjian.com,2,0.00%,2,0,100.00%
aflzz-kr.meiquankongjian.com,2,0.00%,2,0,100.00%
aflcn.meiquankongjian.com,2,0.00%,2,0,100.00%
aflzz-sg.meiquankongjian.com,2,0.00%,2,0,100.00%
aflzz-us.meiquankongjian.com,2,0.00%,2,0,100.00%
aflzzul.meiquankongjian.com,2,0.00%,2,0,100.00%
aflzzdl.meiquankongjian.com,2,0.00%,2,0,100.00%
baike.pcauto.com.cn,2,0.00%,2,0,100.00%
m.youchejiuxing.com,2,0.00%,2,0,100.00%
www.youchejiuxing.com,2,0.00%,2,0,100.00%
facepic.qidian.com,2,0.00%,2,0,100.00%
api-report.baoshiyun.com,2,0.00%,2,0,100.00%
www.zh.wikipedia.org,2,0.00%,5,3,40.00%
www.omgubuntu.co.uk,2,0.00%,2,0,100.00%
css.360doc.com,2,0.00%,2,0,100.00%
pubimage.360doc.com,2,0.00%,2,0,100.00%
recommend.360doc.com,2,0.00%,2,0,100.00%
www.colorgg.com,2,0.00%,2,0,100.00%
www.360doc.com,2,0.00%,2,0,100.00%
thumbnail1.360doc.com,2,0.00%,2,0,100.00%
wpa.qq.com,2,0.00%,2,0,100.00%
product.360doc.com,2,0.00%,2,0,100.00%
apmconfig.douyucdn.cn,2,0.00%,2,0,100.00%
clientLOgvodp2P.hAPLat.nEt,2,0.00%,2,0,100.00%
TrAnSIt1.WSLOg.ChInanETceNTeR.COM,2,0.00%,2,0,100.00%
MaMBaP2PvoDH5.8686C.COM,2,0.00%,2,0,100.00%
V3-GraY.tOutIaOVoD.COM,2,0.00%,2,0,100.00%
TRANSIt2.wSLoG.ChINanETcentEr.Com,2,0.00%,2,0,100.00%
sync.richaudience.com,2,0.00%,2,0,100.00%
csync.smilewanted.com,2,0.00%,2,0,100.00%
m.ib.sin1.geoadnxs.com,2,0.00%,2,0,100.00%
iduyhov.qiniudns.com,2,0.00%,4,2,50.00%
tinyipv6.china.line.qiniudns.com,2,0.00%,4,2,50.00%
phsle5-std02.oray.net,2,0.00%,2,0,100.00%
nba.hupu.com,2,0.00%,4,2,50.00%
b3.hoopchina.com.cn,2,0.00%,4,2,50.00%
b2.hoopchina.com.cn,2,0.00%,2,0,100.00%
img1.hupucdn.com,2,0.00%,2,0,100.00%
img2.hupucdn.com,2,0.00%,2,0,100.00%
remind.hupu.com,2,0.00%,4,2,50.00%
www.mhnew.xyz,2,0.00%,2,0,100.00%
ieg-channel.douyucdn.cn,2,0.00%,2,0,100.00%
danmuproxy.douyu.com,2,0.00%,2,0,100.00%
uact.douyucdn.cn,2,0.00%,2,0,100.00%
forum.huawei.com,2,0.00%,4,2,50.00%
socket.pan.baidu.com,2,0.00%,6,4,33.33%
eg-cloud.lanxin.cn,2,0.00%,2,0,100.00%
eg.lx.qianxin.com,2,0.00%,2,0,100.00%
eg-stage.e.lanxin.cn,2,0.00%,2,0,100.00%
www.nvidia.com,2,0.00%,2,0,100.00%
passport.itechs.ac.cn,2,0.00%,2,0,100.00%
xmpp005.hpeprint.com,2,0.00%,2,0,100.00%
p4-ckk3rsd42zmcw-azudxrngnvxms3r4-if-v6exp3-v4.metric.gstatic.com,2,0.00%,2,0,100.00%
www.nvidia.cn,2,0.00%,2,0,100.00%
t.influ2.com,2,0.00%,2,0,100.00%
www.drivergenius.com,2,0.00%,2,0,100.00%
app.hushly.com,2,0.00%,2,0,100.00%
kmos-api.kaikeba.com,2,0.00%,2,0,100.00%
www.oneplusbbs.com,2,0.00%,2,0,100.00%
appc.baidu.com,2,0.00%,6,4,33.33%
www.pc6.com,2,0.00%,2,0,100.00%
www.xzking.com,2,0.00%,2,0,100.00%
11.mydrivers.com,2,0.00%,2,0,100.00%
www.elecfans.com,2,0.00%,2,0,100.00%
www.57616.com,2,0.00%,2,0,100.00%
www.cr173.com,2,0.00%,2,0,100.00%
www.antutu.com,2,0.00%,2,0,100.00%
dl.dell.com,2,0.00%,4,2,50.00%
h2.shared.global.fastly.net,2,0.00%,2,0,100.00%
cdn.cnblogs.com,2,0.00%,2,0,100.00%
qcc-static.qichacha.com,2,0.00%,2,0,100.00%
co-image.qcc.com,2,0.00%,2,0,100.00%
qcc-static.qcc.com,2,0.00%,2,0,100.00%
co-image.qichacha.com,2,0.00%,2,0,100.00%
eciapp-img.qichacha.com,2,0.00%,2,0,100.00%
statistics.qcc.com,2,0.00%,2,0,100.00%
a.shentonggo.cn.w.kunlunaq.com,2,0.00%,2,0,100.00%
rescdn.qqmail.com,2,0.00%,6,4,33.33%
ip1910235161.funshion.com,2,0.00%,2,0,100.00%
ip2072148266.funshion.com,2,0.00%,2,0,100.00%
img-tx-recimg.douyucdn2.cn,2,0.00%,2,0,100.00%
ydsjjs.paperopen.com,2,0.00%,2,0,100.00%
letstalkmercedes.podigee.io,2,0.00%,2,0,100.00%
sgp08.graniterapids.com,2,0.00%,2,0,100.00%
www.yuoimg.com,2,0.00%,2,0,100.00%
amgql04.zbcsvip.com,2,0.00%,2,0,100.00%
newspush.sinajs.cn,2,0.00%,2,0,100.00%
iepl01.789jiasu.com,2,0.00%,2,0,100.00%
www.aaai.org,2,0.00%,2,0,100.00%
login.360.cn,2,0.00%,2,0,100.00%
access-cf-prod.caauth.caaws.services,2,0.00%,2,0,100.00%
streamdot.douyucdn.cn,2,0.00%,2,0,100.00%
wbstatic.douyu.com,2,0.00%,2,0,100.00%
ip0467472090.livehwc3.cn,2,0.00%,2,0,100.00%
t.in-neo.cn,2,0.00%,2,0,100.00%
nc.qzone.qq.com,2,0.00%,2,0,100.00%
ns2.cuhk.hk,2,0.00%,2,0,100.00%
i-29.b-46304.ut.bench.utorrent.com,2,0.00%,3,1,66.67%
i-139.b-46304.ut.bench.utorrent.com,2,0.00%,3,1,66.67%
i-32.b-46304.ut.bench.utorrent.com,2,0.00%,3,1,66.67%
i-43.b-46304.ut.bench.utorrent.com,2,0.00%,3,1,66.67%
uk01.graniterapids.com,2,0.00%,2,0,100.00%
socket.pan.n.shifen.com,2,0.00%,6,4,33.33%
in05.graniterapids.com,2,0.00%,2,0,100.00%
c969e059-fb71-44c0-ba62-ea3a6b460f2b.cloudapp.net,2,0.00%,2,0,100.00%
www.xzgedu.com,2,0.00%,2,0,100.00%
cdnws.api.huya.com.w.kunlungr.com,2,0.00%,2,0,100.00%
dyn.fspcdn.com,2,0.00%,2,0,100.00%
osiprod-krc-vulpecula-001.cloudapp.net,2,0.00%,2,0,100.00%
video-bd-drcn.dbankcdn.cn.a.bdydns.com,2,0.00%,23,21,8.70%
ali-adaptive.pull.yximgs.com,2,0.00%,3,1,66.67%
v4.oskwai.com,2,0.00%,5,3,40.00%
alicmvod.a.etoote.com,2,0.00%,3,1,66.67%
jsqcmmov.a.etoote.com,2,0.00%,3,1,66.67%
14.ultralab.club,2,0.00%,2,0,100.00%
ks-p2p.pull.yximgs.com,2,0.00%,3,1,66.67%
business.bing.com,2,0.00%,5,3,40.00%
res.cdn.office.net,2,0.00%,5,3,40.00%
acs.lavasoft.com,2,0.00%,2,0,100.00%
ktneiwang.360cdnjiasu.com,2,0.00%,2,0,100.00%
tmfmazu-wangka.m.qq.com,2,0.00%,2,0,100.00%
games.mobileapi.hupu.com,2,0.00%,4,2,50.00%
reverseproxy.onenote.trafficmanager.net,2,0.00%,2,0,100.00%
www.fmfcc.net,2,0.00%,2,0,100.00%
iwdw.site,2,0.00%,2,0,100.00%
www.dfjic.org,2,0.00%,2,0,100.00%
safebrowsing.qq.com,2,0.00%,2,0,100.00%
captcha.qq.com,2,0.00%,2,0,100.00%
oohas7ou.nodedata.net,2,0.00%,2,0,100.00%
ww1.srss.xyz,2,0.00%,2,0,100.00%
6b4200a66f1d4d9b8be7a7b32dd6cee4.fp.measure.office.com,2,0.00%,2,0,100.00%
ppe.activity.windows.com,2,0.00%,2,0,100.00%
justgetflux.com,2,0.00%,2,0,100.00%
mdn.alipayobjects.com.danuoyi.tbcache.com,2,0.00%,2,0,100.00%
j3.dfcfw.com,2,0.00%,4,2,50.00%
j5.dfcfw.com,2,0.00%,4,2,50.00%
fundmobapi.tiantianfunds.com,2,0.00%,2,0,100.00%
res5.vmallres.com,2,0.00%,2,0,100.00%
hwid-drcn-platform-hicloud-com-drcn.region.dbankedge.cn,2,0.00%,2,0,100.00%
fundcomapi.tiantianfunds.com,2,0.00%,2,0,100.00%
ecma.bdimg.com.a.bdydns.com,2,0.00%,2,0,100.00%
res.vmallres.com,2,0.00%,2,0,100.00%
res.vmallres.com.c.cdnhwc1.com,2,0.00%,2,0,100.00%
res2.vmallres.com,2,0.00%,2,0,100.00%
res6.vmallres.com,2,0.00%,2,0,100.00%
res8.vmallres.com,2,0.00%,2,0,100.00%
res2.vmallres.com.c.cdnhwc1.com,2,0.00%,2,0,100.00%
res8.vmallres.com.c.cdnhwc1.com,2,0.00%,2,0,100.00%
link-yqsx03.netease.im,2,0.00%,2,0,100.00%
res3.vmallres.com,2,0.00%,2,0,100.00%
res3.vmallres.com.c.cdnhwc1.com,2,0.00%,2,0,100.00%
res5.vmallres.com.c.cdnhwc1.com,2,0.00%,2,0,100.00%
oss.intelcupid.com,2,0.00%,2,0,100.00%
res1.vmallres.com,2,0.00%,2,0,100.00%
cn.chinadaily.com.cn,2,0.00%,5,3,40.00%
code.51.com,2,0.00%,2,0,100.00%
www.chsi.com.cn,2,0.00%,2,0,100.00%
www.icbc.com.cn,2,0.00%,4,2,50.00%
www.mgtv.com,2,0.00%,6,4,33.33%
shark-tracer.netease.com,2,0.00%,2,0,100.00%
www.ce.cn,2,0.00%,5,3,40.00%
www.china.com.cn,2,0.00%,4,2,50.00%
notes-analytics-events.apple.com,2,0.00%,2,0,100.00%
analytics-prod-gcp.ff.avast.com,2,0.00%,2,0,100.00%
fyb-pc-static.cdn.bcebos.com,2,0.00%,2,0,100.00%
fyb-pc-static.cdn.bcebos.com.a.bdydns.com,2,0.00%,2,0,100.00%
f10.baidu.com.a.bdydns.com,2,0.00%,2,0,100.00%
nlb-external-provcs-b4eb602d91cf3c92.elb.us-west-2.amazonaws.com,2,0.00%,2,0,100.00%
cm.ipinyou.com,2,0.00%,2,0,100.00%
sync.mookie1.cn,2,0.00%,2,0,100.00%
paymentinstruments.mp.microsoft.com,2,0.00%,2,0,100.00%
tm-pifd-prod-gbl-weight.trafficmanager.net,2,0.00%,2,0,100.00%
st-pifd-prod-seas.azurewebsites.net,2,0.00%,2,0,100.00%
waws-prod-sg1-065.sip.azurewebsites.windows.net,2,0.00%,2,0,100.00%
cddp-track.aligames.com,2,0.00%,2,0,100.00%
util.geeksforgeeks.org,2,0.00%,2,0,100.00%
ds-pr-bh.ybp.gysm.yahoodns.net,2,0.00%,4,2,50.00%
sqdsp-vod.smzdm.com,2,0.00%,2,0,100.00%
cube.weixinbridge.com,2,0.00%,7,5,28.57%
pic6.y.qq.com,2,0.00%,4,2,50.00%
isure6.stream.qqmusic.qq.com,2,0.00%,4,2,50.00%
bs.nakanohito.jp,2,0.00%,2,0,100.00%
mail.hotmail.com,2,0.00%,2,0,100.00%
business-drcn.cloud.dbankcloud.cn,2,0.00%,2,0,100.00%
datasync-drcn.cloud.dbankcloud.cn,2,0.00%,2,0,100.00%
cloudbackupv3-drcn.cloud.dbankcloud.cn,2,0.00%,2,0,100.00%
cloudbackup-drcn.cloud.dbankcloud.cn,2,0.00%,2,0,100.00%
travelservice-drcn.emui.hicloud.com,2,0.00%,2,0,100.00%
p213-fmf.icloud.com.cn,2,0.00%,2,0,100.00%
only-39260-124-16-139-61.nstool.321fenx.com,2,0.00%,2,0,100.00%
setonna.com,2,0.00%,2,0,100.00%
ai.tencent.com,2,0.00%,2,0,100.00%
67.push2.eastmoney.com,2,0.00%,3,1,66.67%
img.sogoucdn.com.sched.sma.tdnsstic1.cn,2,0.00%,2,0,100.00%
amiunique.org,2,0.00%,2,0,100.00%
mixv4-13.194610.xyz,2,0.00%,2,0,100.00%
mixv4-15.194610.xyz,2,0.00%,2,0,100.00%
mixv4-14.194610.xyz,2,0.00%,2,0,100.00%
v4-13.hiaoxui.work,2,0.00%,2,0,100.00%
mixv4-37.194610.xyz,2,0.00%,2,0,100.00%
mixv4-38.194610.xyz,2,0.00%,2,0,100.00%
mixv4-31.194610.xyz,2,0.00%,2,0,100.00%
baa9c3ed9f92fdc069247645b6f2b483.dlied1.cdntips.net,2,0.00%,2,0,100.00%
lf9-cdn-tos.bytegecko.com,2,0.00%,4,2,50.00%
gurd.snssdk.com,2,0.00%,2,0,100.00%
gurd.snssdk.com.w.cdngslb.com,2,0.00%,2,0,100.00%
edgeservices.bing.com,2,0.00%,4,2,50.00%
events-drcn.op.dbankcloud.com,2,0.00%,2,0,100.00%
open.feishu.cn.w.cdngslb.com,2,0.00%,4,2,50.00%
api.meeting.work.weixin.qq.com,2,0.00%,2,0,100.00%
gsp57-ssl-revgeo.ls.apple.com,2,0.00%,2,0,100.00%
images.scalero.io,2,0.00%,3,1,66.67%
boot-video.xuexi.cn,2,0.00%,2,0,100.00%
media-router-flurry7.prod.media.wg1.b.yahoo.com,2,0.00%,2,0,100.00%
f86d2b585c6b495f1f344bd739632416.safeframe.googlesyndication.com,2,0.00%,2,0,100.00%
config.scm.windowsphone.com,2,0.00%,2,0,100.00%
scholar.lanfanshu.cn,2,0.00%,2,0,100.00%
lang.alicdn.com,2,0.00%,2,0,100.00%
i.g-fox.cn,2,0.00%,2,0,100.00%
33.push2.eastmoney.com,2,0.00%,4,2,50.00%
kva.idf.ua,2,0.00%,2,0,100.00%
task-safe.2345.cc,2,0.00%,2,0,100.00%
i2.fastpic.org,2,0.00%,2,0,100.00%
mmtkm.zsincer.com.wsdvs.com,2,0.00%,2,0,100.00%
gspe19-cn-ssl.ls.apple.com,2,0.00%,2,0,100.00%
api.weathercn.com.azchcdnh.com,2,0.00%,5,3,40.00%
weather-drcn-music-dbankcloud-cn-drcn.appacc.dbankedge.cn,2,0.00%,2,0,100.00%
weather-drcn-music-dbankcloud-cn-drcn.appacc-region.dbankedge.cn,2,0.00%,2,0,100.00%
f2b680b8904e1e58.icloudwaf.com,2,0.00%,2,0,100.00%
tracker-01.qvb.qcloud.com,2,0.00%,2,0,100.00%
flv265-txpcdn-direct.liveplay.egame.qq.com,2,0.00%,2,0,100.00%
ms-python.gallery.vsassets.io,2,0.00%,2,0,100.00%
github.gallerycdn.azure.cn,2,0.00%,2,0,100.00%
api.feedback.us.pendo.io,2,0.00%,2,0,100.00%
pqiiwpixy6demyyfq7oa-f-89fef4199-clientnsv4-s.akamaihd.net,2,0.00%,2,0,100.00%
wiley.data.adobedc.net,2,0.00%,2,0,100.00%
sdkserver.op.hicloud.com,2,0.00%,2,0,100.00%
files.codelife.cc,2,0.00%,4,2,50.00%
fancycrab.net,2,0.00%,2,0,100.00%
app.sefcb.co,2,0.00%,2,0,100.00%
usnode1.freedomnode.tk,2,0.00%,2,0,100.00%
wps-account-avatar.ks3-cn-beijing.ksyun.com,2,0.00%,2,0,100.00%
docer.wpsdns.com,2,0.00%,2,0,100.00%
tardis.tiny-vps.com,2,0.00%,2,0,100.00%
api-dd.jd.com.gslb.qianxun.com,2,0.00%,2,0,100.00%
storage.360buyimg.com.gslb.qianxun.com,2,0.00%,4,2,50.00%
e4518.dscx.akamaiedge.net,2,0.00%,4,2,50.00%
tags.tiqcdn.com.edgekey.net,2,0.00%,2,0,100.00%
appmcacom-prod-r53.awscommon.mcafee.com,2,0.00%,2,0,100.00%
api-drcn-theme-dbankcloud-cn-drcn.appacc.dbankedge.net,2,0.00%,2,0,100.00%
platformmca-prod-r53.awscommon.mcafee.com,2,0.00%,2,0,100.00%
nlb-mcloud-f4d605e9b006d0c9.elb.us-west-2.amazonaws.com,2,0.00%,2,0,100.00%
bjt.beijing.gov.cn,2,0.00%,3,1,66.67%
xapi.ticktick.com,2,0.00%,2,0,100.00%
p204-fmip.icloud.com.cn,2,0.00%,2,0,100.00%
yjume6mh2qwcdsoskqwujcglcnwtcltg.yundunwaf1.com,2,0.00%,2,0,100.00%
imws.sobot.com,2,0.00%,2,0,100.00%
crumb.sobot.com,2,0.00%,2,0,100.00%
j.clarity.ms,2,0.00%,2,0,100.00%
support.microsoft.com,2,0.00%,2,0,100.00%
statics-marketingsites-neu-ms-com.akamaized.net,2,0.00%,2,0,100.00%
aadcdn.msftauth.net,2,0.00%,2,0,100.00%
account.ai.xiaomi.com,2,0.00%,2,0,100.00%
grayconfig.ai.xiaomi.com,2,0.00%,2,0,100.00%
static.fengkongcloud.com,2,0.00%,2,0,100.00%
assets-football.hoopchina.com.cn,2,0.00%,4,2,50.00%
6utyzxk9.sched.sma.tdnsstic1.cn,2,0.00%,2,0,100.00%
p1.hoopchina.com.cn,2,0.00%,4,2,50.00%
i10.hoopchina.com.cn,2,0.00%,4,2,50.00%
activity-static.hoopchina.com.cn,2,0.00%,4,2,50.00%
doh.iqiyi.com,2,0.00%,2,0,100.00%
time.iqiyi.com,2,0.00%,2,0,100.00%
pic4.iqiyipic.com,2,0.00%,4,2,50.00%
cook.iqiyi.com,2,0.00%,4,2,50.00%
hotchat-im.iqiyi.com,2,0.00%,2,0,100.00%
tc.vip.iqiyi.com,2,0.00%,2,0,100.00%
img7.iqiyipic.com,2,0.00%,4,2,50.00%
cache.m.iqiyi.com,2,0.00%,2,0,100.00%
m.iqiyipic.com,2,0.00%,4,2,50.00%
static.portal101.cn,2,0.00%,2,0,100.00%
e03sh8qj.sched.sma.tdnsstic1.cn,2,0.00%,2,0,100.00%
app.cxztelematics.com,2,0.00%,2,0,100.00%
apiv2.zenguard.biz,2,0.00%,2,0,100.00%
linuxdownload.adobe.com,2,0.00%,2,0,100.00%
onedriveclubprodbn20022.blob.core.windows.net,2,0.00%,2,0,100.00%
static.xf.qq.com,2,0.00%,2,0,100.00%
www.baiduyun.wiki,2,0.00%,2,0,100.00%
m.youlai.cn,2,0.00%,2,0,100.00%
mipcache.bdstatic.com,2,0.00%,4,2,50.00%
mipengine.baidu.com,2,0.00%,4,2,50.00%
file.youlai.cn,2,0.00%,2,0,100.00%
hm.youlai.cn,2,0.00%,2,0,100.00%
i.imgur.com,2,0.00%,4,2,50.00%
obs.lz03-br-dy.cn-north-2.myhuaweicloud.com,2,0.00%,2,0,100.00%
cloud.tencent.com,2,0.00%,3,1,66.67%
m2.cn.bing.com,2,0.00%,2,0,100.00%
messaging.office.com,2,0.00%,2,0,100.00%
down-update.qq.com,2,0.00%,2,0,100.00%
pis-s.alicdn.com,2,0.00%,2,0,100.00%
tap-android-logs.cn-beijing.log.aliyuncs.com,2,0.00%,2,0,100.00%
butterfly.douyucdn.cn,2,0.00%,2,0,100.00%
iv6.gtimg.cn,2,0.00%,4,2,50.00%
wqs.jd.com,2,0.00%,4,2,50.00%
token.safebrowsing.apple,2,0.00%,3,1,66.67%
safebrowsing-re.aaplimg.com,2,0.00%,2,0,100.00%
hlx.meituan.com,2,0.00%,2,0,100.00%
leopard.vip.meituan.com,2,0.00%,2,0,100.00%
1126359.sched.skalego-dk.tdnsstic1.cn.cjt.vwnti.yrzhcloud.cn,2,0.00%,4,2,50.00%
met_mobile_sniffer.dreport.meituan.net,2,0.00%,2,0,100.00%
lf3-motor.dcarstatic.com,2,0.00%,3,1,66.67%
lf3-motor.dcarstatic.com.w.kunluncan.com,2,0.00%,3,1,66.67%
p1-dcd.byteimg.com,2,0.00%,3,1,66.67%
p1-dcd.byteimg.com.wsglb0.com,2,0.00%,3,1,66.67%
lf3-static.bytednsdoc.com.w.alikunlun.com,2,0.00%,3,1,66.67%
v26-default.365yg.com,2,0.00%,3,1,66.67%
p9-dcd-sign.byteimg.com,2,0.00%,3,1,66.67%
p6-dcd-sign.byteimg.com,2,0.00%,3,1,66.67%
lf-rc1.yhgfb-cn-static.com,2,0.00%,3,1,66.67%
hcdnv.zjtd.v6.c.cdnhwc1.com,2,0.00%,3,1,66.67%
dl-static.iqiyi.com,2,0.00%,4,2,50.00%
api-feedback.iqiyi.com,2,0.00%,2,0,100.00%
p2p.ehome.21cn.com,2,0.00%,2,0,100.00%
hub5emu.v6.shub.sandai.net,2,0.00%,4,2,50.00%
fwupd.org,2,0.00%,2,0,100.00%
bj.d.vplink.link,2,0.00%,2,0,100.00%
hk1.d.vplink.link,2,0.00%,2,0,100.00%
hk2.d.vplink.link,2,0.00%,2,0,100.00%
dcce-ae.mail.protection.outlook.com,2,0.00%,2,0,100.00%
r4.res.office365.com.edgekey.net,2,0.00%,4,2,50.00%
tm1-direct.office.com,2,0.00%,3,1,66.67%
outlook.tm1-a.office.com,2,0.00%,3,1,66.67%
onedriveclucprodbn20016.blob.core.windows.net,2,0.00%,2,0,100.00%
www.6.cn,2,0.00%,2,0,100.00%
c.open.163.com,2,0.00%,2,0,100.00%
allcdn.china.qiniu.qnydns.com,2,0.00%,5,3,40.00%
api.mgr.xiangtatech.com,2,0.00%,2,0,100.00%
download.parallels.com.cdn.cloudflare.net,2,0.00%,2,0,100.00%
userblink.csdnimg.cn,2,0.00%,2,0,100.00%
gov.sohu.com,2,0.00%,2,0,100.00%
go.sohu.com,2,0.00%,2,0,100.00%
hqm.stock.sohu.com,2,0.00%,2,0,100.00%
pla-prod-ea-app-ingest-01.azurewebsites.net,2,0.00%,2,0,100.00%
home.mi.com,2,0.00%,2,0,100.00%
e2c3.gcp.gvt2.com,2,0.00%,2,0,100.00%
y2eziy020513cf52.aliyunddos1026.com,2,0.00%,2,0,100.00%
api-gd.dutils.com,2,0.00%,2,0,100.00%
zj1cfweh.cloud.tds1.tapapis.cn,2,0.00%,2,0,100.00%
shuc-android.ksord.com,2,0.00%,2,0,100.00%
sdp.58.com,2,0.00%,2,0,100.00%
umengacs.m.taobao.com,2,0.00%,2,0,100.00%
verifycode.58.com,2,0.00%,2,0,100.00%
flash.xiaohongshu.com,2,0.00%,2,0,100.00%
abtest-client.skyengine.com.cn,2,0.00%,2,0,100.00%
ffapi.n.shifen.com,2,0.00%,2,0,100.00%
shopc.e.shifen.com,2,0.00%,8,6,25.00%
rtlog3-applog-hl.ixigua.com,2,0.00%,2,0,100.00%
log3-misc-hl.ixigua.com,2,0.00%,2,0,100.00%
v3-novelapp.fqnovelvod.com,2,0.00%,2,0,100.00%
adapter.prod.logitech.io,2,0.00%,2,0,100.00%
i-chi01p-cor001.api.p001.1drv.com,2,0.00%,2,0,100.00%
local-updatepro.wps.cn,2,0.00%,2,0,100.00%
twgame07.graniterapids.com,2,0.00%,2,0,100.00%
apisgame.iqiyi.com,2,0.00%,2,0,100.00%
grs.hicloud.com,2,0.00%,2,0,100.00%
cdn.carbonads.com,2,0.00%,2,0,100.00%
www.qlspx.com,2,0.00%,2,0,100.00%
v.qisaoba.com.w.kunlunaq.com,2,0.00%,2,0,100.00%
t891.ts2.1633mu.com.w.kunlunaq.com,2,0.00%,2,0,100.00%
statistics.yozsc.com,2,0.00%,2,0,100.00%
yk.rongxingvr.cc,2,0.00%,2,0,100.00%
myfavor2.eastmoney.com,2,0.00%,2,0,100.00%
v5-h.douyinvod.com,2,0.00%,4,2,50.00%
v5-coldy.douyinvod.com.zjgslb.com,2,0.00%,4,2,50.00%
dy-vod-coldy.bytegslb.com,2,0.00%,4,2,50.00%
hcdnv.bilizj.c.cdnhwc2.com,2,0.00%,4,2,50.00%
mobile.da.mgtv.com,2,0.00%,2,0,100.00%
v1.play.log.hunantv.com,2,0.00%,2,0,100.00%
ys.da.mgtv.com,2,0.00%,2,0,100.00%
mail.ranisdieher.tk,2,0.00%,2,0,100.00%
s2.ssl.qhres2.com.qh-cdn.com,2,0.00%,4,2,50.00%
s.ssl.qhimg.com.qh-cdn.com,2,0.00%,4,2,50.00%
so.qss-lb.com,2,0.00%,2,0,100.00%
s2.ssl.qhres2.com.webcdn.360qhcdn.com,2,0.00%,6,4,33.33%
s5.ssl.qhimg.com.qh-cdn.com,2,0.00%,4,2,50.00%
p.ssl.qhimg.com.webcdn.360qhcdn.com,2,0.00%,4,2,50.00%
s5.ssl.qhimg.com.webcdn.360qhcdn.com,2,0.00%,6,4,33.33%
p5.ssl.qhimg.com.webcdn.360qhcdn.com,2,0.00%,4,2,50.00%
p419.ssl.qhimgs4.com.qh-cdn.com,2,0.00%,4,2,50.00%
p418.ssl.qhimgs4.com.qh-cdn.com,2,0.00%,4,2,50.00%
p420.ssl.qhimgs4.com.qh-cdn.com,2,0.00%,4,2,50.00%
p419.ssl.qhimgs4.com.webcdn.360qhcdn.com,2,0.00%,4,2,50.00%
p418.ssl.qhimgs4.com.webcdn.360qhcdn.com,2,0.00%,4,2,50.00%
p420.ssl.qhimgs4.com.webcdn.360qhcdn.com,2,0.00%,4,2,50.00%
api.ssl.so.qss-lb.com,2,0.00%,2,0,100.00%
fanyi.so.com,2,0.00%,2,0,100.00%
agdist-api.cloud.huawei.com,2,0.00%,2,0,100.00%
v26.douyinvod.com.c.cdnhwc1.com,2,0.00%,2,0,100.00%
sandbox.itunes.apple.com,2,0.00%,2,0,100.00%
icon4count.com,2,0.00%,2,0,100.00%
www.cnitpm.com,2,0.00%,2,0,100.00%
pic.cnitpm.com,2,0.00%,2,0,100.00%
www.likecs.com,2,0.00%,2,0,100.00%
imgser.wangyeyixia.com,2,0.00%,2,0,100.00%
user1.likecs.com,2,0.00%,2,0,100.00%
mask.apple-dns.net,2,0.00%,4,2,50.00%
mask-t.apple-dns.net,2,0.00%,6,4,33.33%
f.clarity.ms,2,0.00%,2,0,100.00%
ec-prd-east-1-1688064408.us-east-1.elb.amazonaws.com,2,0.00%,2,0,100.00%
fexhtml5static.jomodns.com,2,0.00%,2,0,100.00%
crl-lb.apple.com.akadns.net,2,0.00%,3,1,66.67%
crl-cn-lb.apple.com.akadns.net,2,0.00%,3,1,66.67%
account.console.aliyun.com,2,0.00%,2,0,100.00%
notifications.console.aliyun.com,2,0.00%,2,0,100.00%
workorder.console.aliyun.com,2,0.00%,2,0,100.00%
me.xdrig.com,2,0.00%,2,0,100.00%
gecko-pangle-lf.snssdk.com.w.cdngslb.com,2,0.00%,2,0,100.00%
yunpanzhushou.com,2,0.00%,2,0,100.00%
oauth.hpbp.io,2,0.00%,2,0,100.00%
setting1.hicloud.com,2,0.00%,2,0,100.00%
sync.matetranslate.com,2,0.00%,2,0,100.00%
vivomaa.chinanetcenter.com,2,0.00%,2,0,100.00%
imgsa.jomodns.com,2,0.00%,5,3,40.00%
tb5.bdstatic.com.a.bdydns.com,2,0.00%,2,0,100.00%
tb3.bdstatic.com.a.bdydns.com,2,0.00%,2,0,100.00%
s3m4.fenxi.com.qh-cdn.com,2,0.00%,2,0,100.00%
mediago-static.cdn.bcebos.com.a.bdydns.com,2,0.00%,2,0,100.00%
live-s3m.mediav.com.live.360vcloud.com,2,0.00%,2,0,100.00%
3e09ace1a43f40ec8f8ccac3cd57802e.fp.measure.office.com,2,0.00%,2,0,100.00%
1610340727.D4EE073396E8.device.hiwifi.com,2,0.00%,2,0,100.00%
94.push2.eastmoney.com,2,0.00%,4,2,50.00%
microsoftedgetips.microsoft.com,2,0.00%,2,0,100.00%
coupons.console.aliyun.com,2,0.00%,2,0,100.00%
ots.console.aliyun.com,2,0.00%,2,0,100.00%
eci.console.aliyun.com,2,0.00%,2,0,100.00%
essnew.console.aliyun.com,2,0.00%,2,0,100.00%
iduxlmv.qiniudns.com,2,0.00%,5,3,40.00%
news.hbtv.com.cn,2,0.00%,4,2,50.00%
csdnimg.cn.trpcdn.net,2,0.00%,2,0,100.00%
pushtrs1.push.hicloud.com,2,0.00%,2,0,100.00%
gw.alicdn.com.danuoyi.tbcache.com,2,0.00%,4,2,50.00%
intercms.damai.cn,2,0.00%,2,0,100.00%
gtms04.alicdn.com,2,0.00%,2,0,100.00%
aaai.org,2,0.00%,2,0,100.00%
img10.360buyimg.com.gslb.qianxun.com,2,0.00%,3,1,66.67%
pages.jd.com,2,0.00%,2,0,100.00%
lzkj-isv.isvjcloud.com,2,0.00%,2,0,100.00%
lzcdn.dianpusoft.cn,2,0.00%,2,0,100.00%
badjs.m.jd.com,2,0.00%,2,0,100.00%
1610369521.D4EE073396E8.device.hiwifi.com,2,0.00%,2,0,100.00%
xsweb.gdt.qq.com,2,0.00%,3,1,66.67%
api.tencentmusic.com,2,0.00%,2,0,100.00%
stuff.cdn.biddingx.com,2,0.00%,2,0,100.00%
agentchannel.api.duapp.com,2,0.00%,2,0,100.00%
tj.kongfz.com,2,0.00%,2,0,100.00%
www.kfzimg.com,2,0.00%,2,0,100.00%
feed-image.baidu.com,2,0.00%,2,0,100.00%
mini.douyu.com,2,0.00%,2,0,100.00%
static.javashuo.com,2,0.00%,2,0,100.00%
www.3h3.com,2,0.00%,2,0,100.00%
gamebox.3h3.com,2,0.00%,2,0,100.00%
pt.3h3.com,2,0.00%,2,0,100.00%
pic.3h3.com,2,0.00%,2,0,100.00%
m.3h3.com,2,0.00%,2,0,100.00%
mhw.huijiwiki.com,2,0.00%,2,0,100.00%
huiji-fs.huijistatic.com,2,0.00%,2,0,100.00%
fs.huijiwiki.com,2,0.00%,2,0,100.00%
huiji-public.huijistatic.com,2,0.00%,2,0,100.00%
jiugjq7p.sched.sma.tdnsstic1.cn,2,0.00%,2,0,100.00%
2e3vw0eo.sched.sma.tdnsstic1.cn,2,0.00%,2,0,100.00%
www.huijiwiki.com,2,0.00%,2,0,100.00%
asoiaf.huijiwiki.com,2,0.00%,2,0,100.00%
nms.huijiwiki.com,2,0.00%,2,0,100.00%
warframe.huijiwiki.com,2,0.00%,2,0,100.00%
cdn.huijiwiki.com,2,0.00%,2,0,100.00%
hearthstone.huijiwiki.com,2,0.00%,2,0,100.00%
cod.huijiwiki.com,2,0.00%,2,0,100.00%
witcher.huijiwiki.com,2,0.00%,2,0,100.00%
dontstarve.huijiwiki.com,2,0.00%,2,0,100.00%
hitman.huijiwiki.com,2,0.00%,2,0,100.00%
sat.huijiwiki.com,2,0.00%,2,0,100.00%
club.huijiwiki.com,2,0.00%,2,0,100.00%
jiuzhou.huijiwiki.com,2,0.00%,2,0,100.00%
libraryofruina.huijiwiki.com,2,0.00%,2,0,100.00%
xyy.huijiwiki.com,2,0.00%,2,0,100.00%
mlp.huijiwiki.com,2,0.00%,2,0,100.00%
xinglugu.huijiwiki.com,2,0.00%,2,0,100.00%
warriors.huijiwiki.com,2,0.00%,2,0,100.00%
r6s.huijiwiki.com,2,0.00%,2,0,100.00%
hkss.huijiwiki.com,2,0.00%,2,0,100.00%
coppermind.huijiwiki.com,2,0.00%,2,0,100.00%
fnd.huijiwiki.com,2,0.00%,2,0,100.00%
lotr.huijiwiki.com,2,0.00%,2,0,100.00%
ff14.huijiwiki.com,2,0.00%,2,0,100.00%
isaac.huijiwiki.com,2,0.00%,2,0,100.00%
dnfcn.huijiwiki.com,2,0.00%,2,0,100.00%
qunxing.huijiwiki.com,2,0.00%,2,0,100.00%
tagatame.huijiwiki.com,2,0.00%,2,0,100.00%
warcraft.huijiwiki.com,2,0.00%,2,0,100.00%
hots.huijiwiki.com,2,0.00%,2,0,100.00%
tarsylia.huijiwiki.com,2,0.00%,2,0,100.00%
cultist.huijiwiki.com,2,0.00%,2,0,100.00%
toaru.huijiwiki.com,2,0.00%,2,0,100.00%
gw2.huijiwiki.com,2,0.00%,2,0,100.00%
dota.huijiwiki.com,2,0.00%,2,0,100.00%
totalwar.huijiwiki.com,2,0.00%,2,0,100.00%
iknow-pic.cdn.bcebos.com.a.bdydns.com,2,0.00%,2,0,100.00%
blog.farmso.tk,2,0.00%,2,0,100.00%
ca02.graniterapids.com,2,0.00%,2,0,100.00%
uf-bigsearch.ksord.com,2,0.00%,2,0,100.00%
probe.me.apple-dns.net,2,0.00%,4,2,50.00%
services.prod.sdfe.sciencedirect.com,2,0.00%,2,0,100.00%
catchdata.xiaojukeji.com,2,0.00%,2,0,100.00%
boot.jitucdn.com,2,0.00%,4,2,50.00%
cdn.bootcss.com.5e72370b.c.cdnhwc1.com,2,0.00%,4,2,50.00%
hcdnw102.gslb.v6.c.cdnhwc2.com,2,0.00%,4,2,50.00%
www.news.cn.lxdns.com,2,0.00%,4,2,50.00%
emimpcpf2.eastmoney.com,2,0.00%,2,0,100.00%
al.p2p.huya.com.w.alikunlun.net,2,0.00%,5,3,40.00%
service.kongfz.com,2,0.00%,2,0,100.00%
www.dpfile.com,2,0.00%,5,3,40.00%
analytics.meituan.net,2,0.00%,4,2,50.00%
report.meituan.net,2,0.00%,2,0,100.00%
wreport.meituan.net,2,0.00%,2,0,100.00%
wreport1.meituan.net,2,0.00%,2,0,100.00%
s3.meituan.net,2,0.00%,5,3,40.00%
lx1.meituan.net,2,0.00%,2,0,100.00%
fsmvpc.tx.kugou.com,2,0.00%,6,4,33.33%
p210-fmip.icloud.com.cn,2,0.00%,2,0,100.00%
api.777ppt.com,2,0.00%,2,0,100.00%
wapepaper.stcn.com,2,0.00%,2,0,100.00%
rs.stcn.com,2,0.00%,2,0,100.00%
xinpi.stcn.com,2,0.00%,2,0,100.00%
www.battlenet.com.cn,2,0.00%,2,0,100.00%
c.4dex.io,2,0.00%,2,0,100.00%
pc.52pk.com,2,0.00%,2,0,100.00%
www.52pk.com,2,0.00%,2,0,100.00%
image.diyiyou.com,2,0.00%,2,0,100.00%
pass.52pk.com,2,0.00%,2,0,100.00%
5y9nfpes.52pk.com,2,0.00%,2,0,100.00%
www.9k9k.com,2,0.00%,2,0,100.00%
pic2.52pk.com,2,0.00%,2,0,100.00%
content.52pk.com,2,0.00%,2,0,100.00%
f.xuchuang.com,2,0.00%,2,0,100.00%
pic1.52pk.com,2,0.00%,2,0,100.00%
p214-keyvalueservice.icloud.com.cn,2,0.00%,2,0,100.00%
support.strava.com,2,0.00%,2,0,100.00%
static.zdassets.com,2,0.00%,2,0,100.00%
p13.zdassets.com,2,0.00%,2,0,100.00%
ekr.zdassets.com,2,0.00%,2,0,100.00%
prodcmscdn.azureedge.net,2,0.00%,2,0,100.00%
blog.strava.com,2,0.00%,2,0,100.00%
1n4rcn88bk4ziht713dla5ub-wpengine.netdna-ssl.com,2,0.00%,2,0,100.00%
app-center.cdn.bcebos.com,2,0.00%,2,0,100.00%
floor.jd.com,2,0.00%,4,2,50.00%
img1.360buyimg.com,2,0.00%,4,2,50.00%
minisite.zhhainiao.com,2,0.00%,2,0,100.00%
s.jiathis.com,2,0.00%,2,0,100.00%
onedriveclubproddm20037.blob.core.windows.net,2,0.00%,2,0,100.00%
onedriveclucproddm20041.blob.core.windows.net,2,0.00%,2,0,100.00%
wWW.Vod.LxdNs.Com,2,0.00%,4,2,50.00%
wlssl.jd.com,2,0.00%,2,0,100.00%
ping.wubi.sogou.com,2,0.00%,2,0,100.00%
consentcdn.cookiebot.com,2,0.00%,4,2,50.00%
monitor.liepin.com,2,0.00%,2,0,100.00%
statistic.liepin.com,2,0.00%,2,0,100.00%
www.liepin.com,2,0.00%,2,0,100.00%
api-cbp-im.liepin.com,2,0.00%,2,0,100.00%
socket-long.liepin.com,2,0.00%,2,0,100.00%
wow.liepin.com,2,0.00%,2,0,100.00%
concat.lietou-static.com,2,0.00%,2,0,100.00%
image0.lietou-static.com,2,0.00%,2,0,100.00%
www.lebanban.com,2,0.00%,2,0,100.00%
account.liepin.com,2,0.00%,2,0,100.00%
api-cbp-baizhong.liepin.com,2,0.00%,2,0,100.00%
h.liepin.com,2,0.00%,2,0,100.00%
api-cbp-open.liepin.com,2,0.00%,2,0,100.00%
debian.neo4j.org,2,0.00%,4,2,50.00%
1610071487.D4EE073C2A20.device.hiwifi.com,2,0.00%,2,0,100.00%
b.gtld-servers.net,2,0.00%,6,4,33.33%
arxivcu.containers.piwik.pro,2,0.00%,2,0,100.00%
www.xyaz.cn,2,0.00%,2,0,100.00%
www.it1352.com,2,0.00%,2,0,100.00%
img01.yuandaxia.cn,2,0.00%,2,0,100.00%
crt.trust-provider.cn,2,0.00%,2,0,100.00%
file-oss.aikucun.com,2,0.00%,2,0,100.00%
bizhi.360.cn,2,0.00%,2,0,100.00%
www.birdpaper.cn,2,0.00%,2,0,100.00%
teacher.ucas.ac.cn,2,0.00%,2,0,100.00%
www.timeanddate.com,2,0.00%,2,0,100.00%
www.airchina.com,2,0.00%,2,0,100.00%
www.airchina.com.cn,2,0.00%,2,0,100.00%
pop3.vip.sina.com,2,0.00%,2,0,100.00%
static.wondercv.com,2,0.00%,2,0,100.00%
logo.wondercv.com,2,0.00%,2,0,100.00%
assets-cli.udesk.cn,2,0.00%,2,0,100.00%
wondercv.udesk.cn,2,0.00%,2,0,100.00%
static-ud.udesk.cn,2,0.00%,2,0,100.00%
m.you.163.com,2,0.00%,2,0,100.00%
1610333521.D4EE073396E8.device.hiwifi.com,2,0.00%,2,0,100.00%
1610333547.D4EE073396E8.device.hiwifi.com,2,0.00%,2,0,100.00%
t7rf6iqxafqiwyyfecoq-pucbgu-879ca287b-clientnsv4-s.akamaihd.net,2,0.00%,2,0,100.00%
au05.graniterapids.com,2,0.00%,2,0,100.00%
semafor.catalogueformpro.com,2,0.00%,2,0,100.00%
mail.riamacti.tk,2,0.00%,2,0,100.00%
d.agkn.com,2,0.00%,4,2,50.00%
ver.bandi.so,2,0.00%,2,0,100.00%
www.bandisoft.com,2,0.00%,2,0,100.00%
message.finance.qq.com,2,0.00%,2,0,100.00%
ask.csdn.net,2,0.00%,2,0,100.00%
player.alicdn.com,2,0.00%,2,0,100.00%
mv.aura-el.com,2,0.00%,2,0,100.00%
ime.files2.sogou.com,2,0.00%,2,0,100.00%
file.foxitreader.cn,2,0.00%,2,0,100.00%
apps.bittorrent.com,2,0.00%,4,2,50.00%
tw09.graniterapids.com,2,0.00%,2,0,100.00%
tw08.graniterapids.com,2,0.00%,2,0,100.00%
1608241785.D4EE071FA772.device.hiwifi.com,2,0.00%,2,0,100.00%
direwolf-03e75e3cbb.herokuapp.com,2,0.00%,2,0,100.00%
1608234676.D4EE071FA772.device.hiwifi.com,2,0.00%,2,0,100.00%
1608234697.D4EE071FA772.device.hiwifi.com,2,0.00%,2,0,100.00%
adx.halomobi.com,2,0.00%,2,0,100.00%
adhub.ly.com,2,0.00%,2,0,100.00%
pageservice-calendar-drcn.weather.dbankcloud.cn,2,0.00%,2,0,100.00%
ps.ssl.qhimg.com,2,0.00%,2,0,100.00%
wenku.so.com,2,0.00%,2,0,100.00%
api.so.lianmeng.360.cn,2,0.00%,2,0,100.00%
bl5ll840h87qcm242mg3v6ejud66j78lu3m76ggrm55sptevolcfv5ka.qc.x.bsgslb.cn,2,0.00%,2,0,100.00%
1610071548.D4EE073C2A20.device.hiwifi.com,2,0.00%,2,0,100.00%
r2---sn-ni5eln7s.gvt1.com,2,0.00%,2,0,100.00%
hikingbackpack.steinwood.de,2,0.00%,2,0,100.00%
sdrs.splashtop.com,2,0.00%,5,3,40.00%
downloads.dell.com,2,0.00%,4,2,50.00%
p3plvcpnl455723.prod.phx3.secureserver.net,2,0.00%,2,0,100.00%
90.push2.eastmoney.com,2,0.00%,4,2,50.00%
pinpoint.us-west-2.amazonaws.com,2,0.00%,2,0,100.00%
duihui.duoduocdn.com,2,0.00%,4,2,50.00%
v12.cnzz.com,2,0.00%,2,0,100.00%
sensorstrace.hexun.com,2,0.00%,2,0,100.00%
www.editorialmanager.com,2,0.00%,2,0,100.00%
www.makeapie.cn,2,0.00%,2,0,100.00%
itunes.com,2,0.00%,2,0,100.00%
xxl-log.rantu.com,2,0.00%,2,0,100.00%
cdn.rantu.com,2,0.00%,2,0,100.00%
cdn-test.rantu.com,2,0.00%,2,0,100.00%
cdn-test.rantu.com.w.alikunlun.com,2,0.00%,2,0,100.00%
tRAnsit1.WSLog.CHInANeTcENter.com,2,0.00%,2,0,100.00%
cnc-powerpoint.partner.officewebapps.cn,2,0.00%,2,0,100.00%
cn4-arr.partner.officewebapps.cn,2,0.00%,2,0,100.00%
hlws.huanle.qq.com,2,0.00%,2,0,100.00%
ksn-url-geo.kaspersky-labs.com,2,0.00%,2,0,100.00%
msg.mail.163.com,2,0.00%,2,0,100.00%
ipads.se.sjtu.edu.cn,2,0.00%,2,0,100.00%
pubnew.paperol.cn,2,0.00%,2,0,100.00%
ws-na.amazon-adsystem.com,2,0.00%,2,0,100.00%
g-images.amazon.com,2,0.00%,2,0,100.00%
fma-1.get-ser7.xyz,2,0.00%,2,0,100.00%
mp-blog.csdn.net,2,0.00%,2,0,100.00%
mp-download.csdn.net,2,0.00%,2,0,100.00%
mp-others.csdn.net,2,0.00%,2,0,100.00%
h10hxsame.hexun.com,2,0.00%,2,0,100.00%
h06hxsame.hexun.com,2,0.00%,2,0,100.00%
i.csdn.net,2,0.00%,2,0,100.00%
castatic.fengkongcloud.com,2,0.00%,2,0,100.00%
www.licaike.com,2,0.00%,4,2,50.00%
nsp-hicloud-cloudphotoeast3-p01-drcn.obs.cn-east-3.myhuaweicloud.cn,2,0.00%,2,0,100.00%
fastapp-drcn.dbankcdn.cn,2,0.00%,2,0,100.00%
1.ymx002.cf,2,0.00%,2,0,100.00%
flashentertainment-com.mail.protection.outlook.com,2,0.00%,2,0,100.00%
roofsbybryan.jemcdev.com,2,0.00%,2,0,100.00%
experiences.the20ninth.com,2,0.00%,2,0,100.00%
img4.xs.cdnyes.com,2,0.00%,2,0,100.00%
hw.118114.net,2,0.00%,2,0,100.00%
apac04.azure-devices.net,2,0.00%,2,0,100.00%
2236dd202e3dfa73c919b7f1b7461ce4.dlied1.cdntips.net,2,0.00%,2,0,100.00%
prod.ups-ats.ap-southeast-1.aolp-ds-prd.aws.oath.cloud,2,0.00%,2,0,100.00%
clIeNtlOGvOdP2p.haPlAt.net,2,0.00%,2,0,100.00%
MAMBaP2pvoDh5.8686C.CoM,2,0.00%,2,0,100.00%
www.ecb.europa.eu,2,0.00%,2,0,100.00%
det.cipsup.cn,2,0.00%,2,0,100.00%
hexun.com,2,0.00%,2,0,100.00%
k1-bz-lln.gslb.ksyuncdn.com,2,0.00%,2,0,100.00%
data.10jqka.com.cn,2,0.00%,2,0,100.00%
config.ios.wps.cn,2,0.00%,2,0,100.00%
p56-buy.itunes.apple.com,2,0.00%,2,0,100.00%
liveupdate7.drivergenius.com,2,0.00%,2,0,100.00%
apt.v2raya.mzz.pub,2,0.00%,4,2,50.00%
apt.v2raya.org,2,0.00%,4,2,50.00%
g37.gph.netease.com,2,0.00%,5,3,40.00%
1610064241.D4EE073C2A20.device.hiwifi.com,2,0.00%,2,0,100.00%
p207-keyvalueservice.icloud.com.cn,2,0.00%,2,0,100.00%
searchplugin.csdn.net,2,0.00%,2,0,100.00%
alt7-mtalk.google.com,2,0.00%,5,3,40.00%
alt7.mobile-gtalk.l.google.com,2,0.00%,4,2,50.00%
baike.bdimg.com,2,0.00%,2,0,100.00%
p59-escrowproxy.icloud.com.cn,2,0.00%,2,0,100.00%
mirrors.yun-idc.com,2,0.00%,2,0,100.00%
1.hkt1.207.ns5958.com,2,0.00%,2,0,100.00%
dns3.tuna.tsinghua.edu.cn,2,0.00%,2,0,100.00%
kr04.graniterapids.com,2,0.00%,2,0,100.00%
moonburrow.club,2,0.00%,2,0,100.00%
alinw.alicdn.com,2,0.00%,2,0,100.00%
ucc.alicdn.com,2,0.00%,2,0,100.00%
ad.atdmt.com,2,0.00%,4,2,50.00%
recomm.cnblogs.com,2,0.00%,2,0,100.00%
oneconsole.alicdn.com,2,0.00%,2,0,100.00%
ip-92-205-29-168.ip.secureserver.net,2,0.00%,2,0,100.00%
ip1873674376.funshion.com,2,0.00%,2,0,100.00%
tjiwx.smoba.qq.com,2,0.00%,2,0,100.00%
down.dataaps.com,2,0.00%,2,0,100.00%
wad526.se,2,0.00%,2,0,100.00%
btinfo.sandai.net,2,0.00%,2,0,100.00%
mail.lois.cn,2,0.00%,2,0,100.00%
fc-transvideo.baidu.com,2,0.00%,2,0,100.00%
unix.stackexchange.com,2,0.00%,2,0,100.00%
arcane-stream-1752.herokuapp.com,2,0.00%,2,0,100.00%
1610326346.D4EE073396E8.device.hiwifi.com,2,0.00%,2,0,100.00%
1610326367.D4EE073396E8.device.hiwifi.com,2,0.00%,2,0,100.00%
ns1.fednet.gov.ae,2,0.00%,2,0,100.00%
ns2.fednet.gov.ae,2,0.00%,2,0,100.00%
odc-phx02pap002-meta-brs.onedrive.akadns.net,2,0.00%,4,2,50.00%
phx02pcor002-meta.be.1drv.com.l-0003.dc-msedge.net.l-0003.l-msedge.net,2,0.00%,4,2,50.00%
blob.lvl02prdstr14c.store.core.windows.net,2,0.00%,2,0,100.00%
onedriveclubprodbn20005.blob.core.windows.net,2,0.00%,2,0,100.00%
pds-init.ess.apple.com,2,0.00%,2,0,100.00%
upos-sz-mirrorali02.bilivideo.com.w.kunluncan.com,2,0.00%,2,0,100.00%
click.redditmail.com,2,0.00%,2,0,100.00%
gs-loc.ls-apple.com.akadns.net,2,0.00%,2,0,100.00%
ip.tianqijun.com.cdn20.com,2,0.00%,2,0,100.00%
tqjimg.tianqistatic.com.w.cdngslb.com,2,0.00%,2,0,100.00%
wd-prod-cp-as-southeast-3-fe.southeastasia.cloudapp.azure.com,2,0.00%,2,0,100.00%
qq-web-legacy.cdn-go.cn,2,0.00%,5,3,40.00%
csdl-downloads.ieeecomputer.org,2,0.00%,2,0,100.00%
www.clearos.com,2,0.00%,2,0,100.00%
blob.bn9prdstr12a.store.core.windows.net,2,0.00%,2,0,100.00%
ali-bj-pcdn-13.biliapi.net,2,0.00%,2,0,100.00%
i.e.shifen.com,2,0.00%,2,0,100.00%
t.wayfair.com,2,0.00%,2,0,100.00%
www.axure.com,2,0.00%,2,0,100.00%
achievement.hicloud.com,2,0.00%,2,0,100.00%
opencdnbdpassport.jomodns.com,2,0.00%,3,1,66.67%
docs.idqqimg.com,2,0.00%,4,2,50.00%
docs-personalized-fonts-1251316161.file.myqcloud.com,2,0.00%,2,0,100.00%
assets.imedao.com.w.alikunlun.com,2,0.00%,2,0,100.00%
api.getquicker.net,2,0.00%,2,0,100.00%
writing-recommendation.youdao.com,2,0.00%,2,0,100.00%
paulridgway.co.uk,2,0.00%,2,0,100.00%
api-access.pangolin-sdk-toutiao.com.c.dsa.cdnbuild.net,2,0.00%,2,0,100.00%
img.d1xz.net.wsdvs.com,2,0.00%,2,0,100.00%
gtm-cn-6ja202avq0f.gtm-a1b2.com,2,0.00%,2,0,100.00%
pendant-browser.vivo.com.cn,2,0.00%,2,0,100.00%
weatherapi.vivo.com.cn,2,0.00%,2,0,100.00%
api5-normal-quic-hl.ixigua.com,2,0.00%,2,0,100.00%
search5-search-hl.ixigua.com,2,0.00%,2,0,100.00%
is-hl.snssdk.com,2,0.00%,2,0,100.00%
ib-hl.snssdk.com,2,0.00%,2,0,100.00%
i-hl.snssdk.com,2,0.00%,2,0,100.00%
vc-mirror.ndcpp.com,2,0.00%,2,0,100.00%
v5.bdxiguavod.com,2,0.00%,2,0,100.00%
receiver.data.lianjia.com,2,0.00%,2,0,100.00%
smartsms.vivo.com.cn,2,0.00%,2,0,100.00%
app.cjyun.org,2,0.00%,3,1,66.67%
img.cjyun.org,2,0.00%,3,1,66.67%
tj.cjyun.org,2,0.00%,3,1,66.67%
www.hbwhcyw.com,2,0.00%,2,0,100.00%
www.people.com.cn,2,0.00%,7,5,28.57%
videoplus.cjyun.org,2,0.00%,4,2,50.00%
image.ynet.cn,2,0.00%,4,2,50.00%
restios.amap.com,2,0.00%,2,0,100.00%
web-us1-s92ot030.frp.cool,2,0.00%,2,0,100.00%
u.163.com,2,0.00%,2,0,100.00%
mimg.127.net.163jiasu.com,2,0.00%,2,0,100.00%
onegoods.nosdn.127.net.163jiasu.com,2,0.00%,2,0,100.00%
mail-activity.nos-jd.163yun.com,2,0.00%,2,0,100.00%
nos-jd.163yun.com,2,0.00%,2,0,100.00%
stappupgrade.vivo.com.cn,2,0.00%,2,0,100.00%
g.pconline.com.cn.ctdns.cn,2,0.00%,2,0,100.00%
i7.3conline.com.ctadns.cn,2,0.00%,2,0,100.00%
count5.pconline.com.cn,2,0.00%,2,0,100.00%
p00yivkxqvqw.huyacdn.xyz,2,0.00%,4,2,50.00%
whois.pconline.com.cn,2,0.00%,2,0,100.00%
img0w.pconline.com.cn.ctadns.cn,2,0.00%,2,0,100.00%
h5.m.taobao.com,2,0.00%,3,1,66.67%
gw3.alicdn.com,2,0.00%,2,0,100.00%
gw3.alicdn.com.danuoyi.tbcache.com,2,0.00%,2,0,100.00%
dl.fedoraproject.org,2,0.00%,2,0,100.00%
sat02pcor004-com.be.1drv.com,2,0.00%,2,0,100.00%
ns1.siteground.net,2,0.00%,2,0,100.00%
ns2.siteground.net,2,0.00%,2,0,100.00%
dcce53ip56ses.cloudfront.net,2,0.00%,2,0,100.00%
onedriveclubprodbn20050.blob.core.windows.net,2,0.00%,2,0,100.00%
bho.xl7.xunlei.com,2,0.00%,2,0,100.00%
e1.o.lencr.org,2,0.00%,3,1,66.67%
give.thunderbird.net,2,0.00%,2,0,100.00%
ads.ishansong.com,2,0.00%,2,0,100.00%
joogh2uf.nodedata.net,2,0.00%,2,0,100.00%
p205-fmfmobile.icloud.com.cn,2,0.00%,2,0,100.00%
tianquan.gtimg.cn,2,0.00%,2,0,100.00%
grwsyw.gjj.beijing.gov.cn,2,0.00%,2,0,100.00%
aliproxy.video.weibocdn.com,2,0.00%,2,0,100.00%
p216-quota.icloud.com.cn,2,0.00%,2,0,100.00%
cloudsafe.hicloud.com,2,0.00%,2,0,100.00%
v96.douyinvod.com,2,0.00%,2,0,100.00%
services.ao.space,2,0.00%,2,0,100.00%
res.space.eulix.xyz,2,0.00%,2,0,100.00%
jp19.graniterapids.com,2,0.00%,2,0,100.00%
tapi.sooyooj.com,2,0.00%,2,0,100.00%
api.sooyooj.com,2,0.00%,2,0,100.00%
gs.wlb.gosuncdn.com,2,0.00%,2,0,100.00%
m701.music.126.net.163jiasu.com,2,0.00%,2,0,100.00%
h20180.www2.hp.com,2,0.00%,2,0,100.00%
bbs.tianya.cn,2,0.00%,2,0,100.00%
medical-cms.cdn.bcebos.com,2,0.00%,2,0,100.00%
medical-kg.cdn.bcebos.com,2,0.00%,2,0,100.00%
aloc-offline-temp.amap.com,2,0.00%,2,0,100.00%
p3.img.cctvpic.com,2,0.00%,4,2,50.00%
dl-edge.smartscreen.microsoft.com,2,0.00%,2,0,100.00%
amp-api.music.apple.com,2,0.00%,4,2,50.00%
vw.faw-vw.com,2,0.00%,2,0,100.00%
v5-cold.douyinvod.com,2,0.00%,2,0,100.00%
ip-info-gcp.ff.avast.com,2,0.00%,2,0,100.00%
2.anolis.pool.ntp.org,2,0.00%,2,0,100.00%
n3plcpnl0276.prod.ams3.secureserver.net,2,0.00%,2,0,100.00%
zzl-graphics.mybranchbob.com,2,0.00%,2,0,100.00%
forum.open3d.org,2,0.00%,2,0,100.00%
badjs2.qq.com,2,0.00%,2,0,100.00%
ws.stream.qqmusic.qq.com,2,0.00%,4,2,50.00%
TrANSiT1.WSlOG.CHInanETceNTEr.cOM,2,0.00%,2,0,100.00%
MaMbAP2PVODH5.8686C.coM,2,0.00%,2,0,100.00%
ClieNtLOGVoDp2p.HaPlaT.nEt,2,0.00%,2,0,100.00%
cms.tianyaui.com,2,0.00%,2,0,100.00%
book.tianya.cn,2,0.00%,2,0,100.00%
s2-10623.kwimgs.com,2,0.00%,4,2,50.00%
img3.tianyaui.com,2,0.00%,2,0,100.00%
img3.laibafile.cn,2,0.00%,2,0,100.00%
biz.tianya.cn,2,0.00%,2,0,100.00%
bei.tianya.cn,2,0.00%,2,0,100.00%
sx.tianya.cn,2,0.00%,2,0,100.00%
help.tianya.cn,2,0.00%,2,0,100.00%
join.tianya.cn,2,0.00%,2,0,100.00%
sz.tianya.cn,2,0.00%,2,0,100.00%
travel.tianya.cn,2,0.00%,2,0,100.00%
click.tianyaui.com,2,0.00%,2,0,100.00%
yuqing.tianya.cn,2,0.00%,2,0,100.00%
zc.tianya.cn,2,0.00%,2,0,100.00%
cq.tianya.cn,2,0.00%,2,0,100.00%
cul.tianya.cn,2,0.00%,2,0,100.00%
emo.tianya.cn,2,0.00%,2,0,100.00%
ent.tianya.cn,2,0.00%,2,0,100.00%
fashion.tianya.cn,2,0.00%,2,0,100.00%
fj.tianya.cn,2,0.00%,2,0,100.00%
music.stackexchange.com,2,0.00%,2,0,100.00%
www.kaggle.com,2,0.00%,2,0,100.00%
mumu-store-api.webapp.163.com,2,0.00%,2,0,100.00%
transition.yonghuivip.com,2,0.00%,2,0,100.00%
p12-buy.itunes.apple.com,2,0.00%,2,0,100.00%
yunpan.360.cn,2,0.00%,2,0,100.00%
muchongimg.xmcimg.com,2,0.00%,2,0,100.00%
activity.qz100.com,2,0.00%,2,0,100.00%
mob.muchong.com,2,0.00%,2,0,100.00%
src.100tal.com,2,0.00%,2,0,100.00%
s3-us-west-1.amazonaws.com,2,0.00%,2,0,100.00%
buy.springer.com,2,0.00%,2,0,100.00%
rawtkd.classic.kicksite.net,2,0.00%,2,0,100.00%
msitepp-fm.jd.com.gslb.qianxun.com,2,0.00%,2,0,100.00%
jp27.graniterapids.com,2,0.00%,2,0,100.00%
www.iconfont.cn,2,0.00%,2,0,100.00%
c1.microsoft.com,2,0.00%,2,0,100.00%
gd.tianya.cn,2,0.00%,2,0,100.00%
guizhou.tianya.cn,2,0.00%,2,0,100.00%
gx.tianya.cn,2,0.00%,2,0,100.00%
hunan.tianya.cn,2,0.00%,2,0,100.00%
news.tianya.cn,2,0.00%,2,0,100.00%
nong.tianya.cn,2,0.00%,2,0,100.00%
sanya.tianya.cn,2,0.00%,2,0,100.00%
pinpai.tianya.cn,2,0.00%,2,0,100.00%
sd.tianya.cn,2,0.00%,2,0,100.00%
sc.tianya.cn,2,0.00%,2,0,100.00%
s3m2.nzwgs.com,2,0.00%,2,0,100.00%
api.paradox-interactive.com,2,0.00%,2,0,100.00%
dorangesource.alicdn.com,2,0.00%,5,3,40.00%
office-imm-tmp-cn-beijing.oss-cn-beijing.aliyuncs.com,2,0.00%,2,0,100.00%
pjp1-collabhubrtc.officeapps.live.com,2,0.00%,2,0,100.00%
p4.qhimg.com,2,0.00%,2,0,100.00%
www.diyifanwen.com,2,0.00%,2,0,100.00%
xt.tiantianbannixue.com,2,0.00%,2,0,100.00%
ad-pay.sunlands.com,2,0.00%,2,0,100.00%
ggtf.sunland.org.cn,2,0.00%,2,0,100.00%
mail.nferribyallots.tk,2,0.00%,2,0,100.00%
acquire.privy-staging-pr-3135.privy-staging.com,2,0.00%,2,0,100.00%
hr11.graniterapids.com,2,0.00%,2,0,100.00%
gbc8.sg1.as.criteo.com,2,0.00%,2,0,100.00%
gem.gbc.criteo.com,2,0.00%,2,0,100.00%
content.mtime.com,2,0.00%,2,0,100.00%
dev.g.alicdn.com,2,0.00%,2,0,100.00%
ccp-bj29-video-preview.oss-enet.aliyuncs.com,2,0.00%,2,0,100.00%
bj29-enet.cn-beijing.data.alicloudccp.com,2,0.00%,2,0,100.00%
twgame02.graniterapids.com,2,0.00%,2,0,100.00%
ishigaki.stands.coffee,2,0.00%,2,0,100.00%
imgets.58.com,2,0.00%,2,0,100.00%
ucs.query.yahoo.com,2,0.00%,2,0,100.00%
exo.nel.measure.office.net,2,0.00%,5,3,40.00%
dict.org,2,0.00%,2,0,100.00%
se2.360simg.com,2,0.00%,4,2,50.00%
se3.360simg.com,2,0.00%,2,0,100.00%
forum.qt.io,2,0.00%,2,0,100.00%
97b54cb9ee3d4489b0efbd0431bf8fa9.fp.measure.office.com,2,0.00%,2,0,100.00%
deb.opera.com,2,0.00%,2,0,100.00%
mail.uaqgov.ae,2,0.00%,2,0,100.00%
gw.kylinos.cn,2,0.00%,2,0,100.00%
ysdk.qq.com,2,0.00%,2,0,100.00%
p203-keyvalueservice.icloud.com.cn,2,0.00%,2,0,100.00%
datetime360.com,2,0.00%,2,0,100.00%
pubads.g.doubleclick.net,2,0.00%,4,2,50.00%
ads.vidoomy.com,2,0.00%,2,0,100.00%
ca8cf3910ad737842a582a60384cf7db.safeframe.googlesyndication.com,2,0.00%,2,0,100.00%
38.push2.eastmoney.com,2,0.00%,4,2,50.00%
3.push2.eastmoney.com,2,0.00%,4,2,50.00%
javis486.blog.csdn.net,2,0.00%,2,0,100.00%
res-1.cdn.office.net,2,0.00%,5,3,40.00%
e.feiq18.com,2,0.00%,2,0,100.00%
s3m7.nzwgs.com,2,0.00%,2,0,100.00%
sns-img-bd.xhscdn.com,2,0.00%,2,0,100.00%
static.zhihu.com.cdn.dnsv1.com,2,0.00%,6,4,33.33%
www.pcw365.com,2,0.00%,2,0,100.00%
www.52cad.com,2,0.00%,2,0,100.00%
82.ucp-ntfy.kaspersky-labs.com,2,0.00%,2,0,100.00%
e.hina.com,2,0.00%,2,0,100.00%
oss.hina.com,2,0.00%,2,0,100.00%
coder.hinapower.cn,2,0.00%,2,0,100.00%
cl2.apple.com,2,0.00%,4,2,50.00%
maMbaP2pvODh5.8686C.Com,2,0.00%,2,0,100.00%
CLIENtLoGvodP2p.HAPlaT.NEt,2,0.00%,2,0,100.00%
tRanSIT1.wsLoG.CHinANEtCeNtEr.cOM,2,0.00%,2,0,100.00%
ipm.corel.com,2,0.00%,4,2,50.00%
mAMbAP2PvoDH5.8686C.cOM,2,0.00%,2,0,100.00%
transIT1.WSlOG.cHinanETcenTer.COm,2,0.00%,2,0,100.00%
cLIenTLOGvODP2p.haplaT.NEt,2,0.00%,2,0,100.00%
bullet-ws.hitv.com,2,0.00%,2,0,100.00%
slp2p-east-std41.oray.net,2,0.00%,2,0,100.00%
dy-vod-f.bytegslb.com,2,0.00%,2,0,100.00%
CliENTloGvOdp2p.HaPlat.nET,2,0.00%,2,0,100.00%
trAnsIT1.WsLoG.CHINANeTCenteR.CoM,2,0.00%,2,0,100.00%
mAMbap2pvoDH5.8686C.Com,2,0.00%,2,0,100.00%
bioinfo.ict.ac.cn,2,0.00%,2,0,100.00%
gateway.hinapower.cn,2,0.00%,2,0,100.00%
slp2p-east-std20.oray.net,2,0.00%,2,0,100.00%
a.xywy.com,2,0.00%,2,0,100.00%
pub1.wkimg.com,2,0.00%,2,0,100.00%
stat.xywy.com,2,0.00%,2,0,100.00%
js.static.xywy.com,2,0.00%,2,0,100.00%
css.static.xywy.com,2,0.00%,2,0,100.00%
scs.static.xywy.com,2,0.00%,2,0,100.00%
xs3.op.xywy.com,2,0.00%,2,0,100.00%
static.wkimg.com,2,0.00%,2,0,100.00%
i1.wkimg.com,2,0.00%,2,0,100.00%
i0.wkimg.com,2,0.00%,2,0,100.00%
bdmm.xywy.com,2,0.00%,2,0,100.00%
zy.static.xywy.com,2,0.00%,2,0,100.00%
wrskynet-oregon.s3-us-west-2.amazonaws.com,2,0.00%,2,0,100.00%
adsense.feiq18.com,2,0.00%,2,0,100.00%
www.jsr9.com,2,0.00%,2,0,100.00%
pan.ios.ac.cn,2,0.00%,2,0,100.00%
m.chunyuyisheng.com,2,0.00%,2,0,100.00%
v83-016.douyinvod.com.w.cdngslb.com,2,0.00%,4,2,50.00%
v27-a.douyinvod.com,2,0.00%,2,0,100.00%
a.chunyuyisheng.com,2,0.00%,2,0,100.00%
CLIenTlOGvOdP2P.HaPlAt.nEt,2,0.00%,2,0,100.00%
asia3.akam.net,2,0.00%,2,0,100.00%
apkgf5hg.sched.v1hw-dk.tdnsvod1.cn.cvod.vwnti.yrzhcloud.cn,2,0.00%,6,4,33.33%
tsbrowser.xiangtatech.com.w.kunlungr.com,2,0.00%,2,0,100.00%
mfn-sched.jcloud-cdn.com,2,0.00%,2,0,100.00%
cdnfile2.msstatic.com.w.kunlunhuf.com,2,0.00%,2,0,100.00%
data-leopard1.vip.meituan.com,2,0.00%,2,0,100.00%
public-ws-ubiservices.ubi.com,2,0.00%,2,0,100.00%
i2.itc.cn,2,0.00%,3,1,66.67%
is.snssdk.com.xi.zwtianshangm.com,2,0.00%,2,0,100.00%
ts4.cn.mm.bing.net.lxcvc.com,2,0.00%,2,0,100.00%
d1tarwsje7tj10.cloudfront.net,2,0.00%,2,0,100.00%
jlw00x9vk3e5020j.aliyunddos1026.com,2,0.00%,2,0,100.00%
connectivity-check.ubuntu.com.HOST,2,0.00%,2,0,100.00%
smt.admaster.com.cn,2,0.00%,2,0,100.00%
lf.esf.fang.com,2,0.00%,2,0,100.00%
clzzzxbf.cilizhizhu.club,2,0.00%,2,0,100.00%
clzzfzlj.cilizhizhu.club,2,0.00%,2,0,100.00%
uploads.gamecoast.net,2,0.00%,2,0,100.00%
h30155.www3.hp.com,2,0.00%,2,0,100.00%
accounts.logi.com,2,0.00%,2,0,100.00%
www.weain.mil.cn,2,0.00%,2,0,100.00%
mail.weain.mil.cn,2,0.00%,2,0,100.00%
inst-fs-yul-prod.inscloudgate.net,2,0.00%,2,0,100.00%
relay-yul.sentry.insops.net,2,0.00%,2,0,100.00%
stat.myzaker.com.w.kunlungr.com,2,0.00%,2,0,100.00%
a11224-20946131.cluster222.canvas-user-content.com,2,0.00%,2,0,100.00%
prod-ca-central-1.ally.ac,2,0.00%,2,0,100.00%
sf3-cn.feishucdn.com.w.cdngslb.com,2,0.00%,2,0,100.00%
unpkg.byted-static.com.w.alikunlun.com,2,0.00%,2,0,100.00%
46kwytew.sched.skalego-dk.tdnsstic1.cn,2,0.00%,4,2,50.00%
audio.ali.xmcdn.com.w.alikunlun.com,2,0.00%,4,2,50.00%
dynapix.jp,2,0.00%,2,0,100.00%
appdl-3-drcn.dbankcdn.com.a.bdydns.com,2,0.00%,2,0,100.00%
appdl-12-drcn.dbankcdn.com.akamaized.net,2,0.00%,2,0,100.00%
a1939.d.akamai.net,2,0.00%,2,0,100.00%
opencdnhwapp.jomodns.com,2,0.00%,2,0,100.00%
midas.gtimg.cn.sched.legopic1.tdnsv6.com,2,0.00%,2,0,100.00%
mg.uu.163.com,2,0.00%,2,0,100.00%
trackermore.dler.org,2,0.00%,2,0,100.00%
t02img.yangkeduo.com,2,0.00%,3,1,66.67%
apps.itunes.apple.com.edgekey.net,2,0.00%,5,3,40.00%
pd-cdn.itunes-apple.com.akadns.net,2,0.00%,5,3,40.00%
n.cg.163.com,2,0.00%,2,0,100.00%
so0ujcb41lj79j3aguf20s3o7st09ih4i8c6nqlps4nqsql36p0fue10.tt.x.bsgslb.cn,2,0.00%,2,0,100.00%
imeres.baidu.com,2,0.00%,2,0,100.00%
imeres.baidu.com.a.bdydns.com,2,0.00%,2,0,100.00%
mstatic.cdn.bcebos.com,2,0.00%,4,2,50.00%
selfpage-gips.cdn.bcebos.com.a.bdydns.com,2,0.00%,2,0,100.00%
f2video.gslb.sinaedge.com,2,0.00%,4,2,50.00%
iosapps-cn-lb.dl-apple.com.akadns.net,2,0.00%,2,0,100.00%
notifications.liquipedia.net,2,0.00%,2,0,100.00%
p212-fmf.icloud.com.cn,2,0.00%,2,0,100.00%
home-packages.chinauos.com,2,0.00%,2,0,100.00%
adutp-corner.oss-cn-beijing.aliyuncs.com,2,0.00%,2,0,100.00%
opencdnspyv6.jomodns.com,2,0.00%,4,2,50.00%
kuaishou.httpdns.pro,2,0.00%,2,0,100.00%
mon11-misc-lf.fqnovel.com,2,0.00%,4,2,50.00%
d2f1dr3088xot5.cloudfront.net,2,0.00%,3,1,66.67%
ns2.sap-ag.de,2,0.00%,2,0,100.00%
ns4.sap-ag.de,2,0.00%,2,0,100.00%
ns.sap-ag.de,2,0.00%,2,0,100.00%
ns3.sap-ag.de,2,0.00%,2,0,100.00%
ccleaner.tools.avcdn.net,2,0.00%,6,4,33.33%
update.equinox.io.herokudns.com,2,0.00%,2,0,100.00%
p216-fmipmobile.icloud.com.cn,2,0.00%,2,0,100.00%
p14-fmip.icloud.com.cn,2,0.00%,2,0,100.00%
p216-escrowproxy.icloud.com.cn,2,0.00%,2,0,100.00%
b5006751.iavs9x.avg.u.avcdn.net,2,0.00%,3,1,66.67%
b0017156.iavs9x.avg.u.avcdn.net,2,0.00%,4,2,50.00%
s1299785.iavs9x.avg.u.avcdn.net,2,0.00%,4,2,50.00%
TRANSit1.wsloG.CHiNanEtcenteR.COM,2,0.00%,2,0,100.00%
MAMBaP2PvodH5.8686c.COM,2,0.00%,2,0,100.00%
CLIENTlOGVODP2P.HapLat.nET,2,0.00%,2,0,100.00%
transiT2.wsLog.CHInaNETCentEr.CoM,2,0.00%,2,0,100.00%
v26.ToutiaOvOD.COm,2,0.00%,2,0,100.00%
cLIEnTlOGvoDP2P.HAPLAt.NET,2,0.00%,2,0,100.00%
TrAnSIT1.WSlog.CHINANeTCEntEr.com,2,0.00%,2,0,100.00%
mambAP2PVODH5.8686C.COM,2,0.00%,2,0,100.00%
p2.music.126.net,2,0.00%,5,3,40.00%
s1.music.126.net,2,0.00%,2,0,100.00%
2005517.sched.dma.tdnsdl1.cn,2,0.00%,2,0,100.00%
ldc.mbgcdn.lenovo.com.cn,2,0.00%,2,0,100.00%
hivoice-drcn-emui-dbankcloud-com-drcn.appacc.dbankedge.net,2,0.00%,2,0,100.00%
et.softidc.gaofangm.com,2,0.00%,2,0,100.00%
imlp-static.cdn.bcebos.com,2,0.00%,2,0,100.00%
leads.baidu.com,2,0.00%,2,0,100.00%
imlong-sa-p05-drcn.platform.dbankcloud.cn,2,0.00%,2,0,100.00%
im-drcn-platform-dbankcloud-cn-drcn.appacc.dbankedge.net,2,0.00%,2,0,100.00%
imgs.easyliao.com,2,0.00%,2,0,100.00%
www.ccf.org.cn,2,0.00%,2,0,100.00%
bidder.am5.vip.prod.criteo.com,2,0.00%,2,0,100.00%
js-sec.indexww.com,2,0.00%,2,0,100.00%
eus.rubiconproject.com,2,0.00%,2,0,100.00%
js-sec.casalemedia.com.edgekey.net,2,0.00%,2,0,100.00%
secure-adnxs.edgekey.net,2,0.00%,2,0,100.00%
eus.rubiconproject.com.edgekey.net,2,0.00%,2,0,100.00%
e8037.g.akamaiedge.net,2,0.00%,2,0,100.00%
sjc-bh.contextweb.com,2,0.00%,2,0,100.00%
e6115.g.akamaiedge.net,2,0.00%,2,0,100.00%
e8960.b.akamaiedge.net,2,0.00%,2,0,100.00%
htlb.casalemedia.com.cdn.cloudflare.net,2,0.00%,2,0,100.00%
btlr-ecs-ap-southeast-1.sharethrough.com,2,0.00%,2,0,100.00%
hbopenbid-sg.pubmatic.com,2,0.00%,2,0,100.00%
bid.contextweb.com,2,0.00%,2,0,100.00%
apex.go.sonobi.com,2,0.00%,2,0,100.00%
sjc-bid.contextweb.com,2,0.00%,2,0,100.00%
vap.lijit.com,2,0.00%,2,0,100.00%
hbopenbid-sgc.pubmatic.com,2,0.00%,2,0,100.00%
e.relay.bid,2,0.00%,2,0,100.00%
prod.ups-ats.ap-northeast-1.aolp-ds-prd.aws.oath.cloud,2,0.00%,2,0,100.00%
microsoft.geo.appnexusgslb.net,2,0.00%,2,0,100.00%
e607.d.akamaiedge.net,2,0.00%,2,0,100.00%
prod-pdx-beacon-1406086907.us-west-2.elb.amazonaws.com,2,0.00%,2,0,100.00%
rogs.japanwest.cloudapp.azure.com,2,0.00%,2,0,100.00%
cmfilehelper.weixin.qq.com,2,0.00%,2,0,100.00%
m804.music.126.net.w.kunluncan.com,2,0.00%,2,0,100.00%
tcioutsunfb6ue7ldc12u7sahthbh6vmohlb45vl9tjh6mqqbtdvv4ig.qc.x.bsgslb.cn,2,0.00%,2,0,100.00%
1608227385.D4EE071FA772.device.hiwifi.com,2,0.00%,2,0,100.00%
1608227436.D4EE071FA772.device.hiwifi.com,2,0.00%,2,0,100.00%
j9121315.avi18.u.avcdn.net,2,0.00%,4,2,50.00%
m6211579.avi18.u.avcdn.net,2,0.00%,4,2,50.00%
x8960797.avi18.u.avcdn.net,2,0.00%,4,2,50.00%
95.push2.eastmoney.com,2,0.00%,4,2,50.00%
xpis.alicdn.com,2,0.00%,2,0,100.00%
antibot.qq.com,2,0.00%,2,0,100.00%
img1.gtimg.com,2,0.00%,4,2,50.00%
tj.video.qq.com,2,0.00%,2,0,100.00%
vd.l.qq.com,2,0.00%,2,0,100.00%
docs.microsoft.com-c.edgekey.net,2,0.00%,2,0,100.00%
docs.microsoft.com-c.edgekey.net.globalredir.akadns.net,2,0.00%,2,0,100.00%
boss.hdslb.com.download.ks-cdn.com,2,0.00%,4,2,50.00%
discovery.mbgcdn.lenovo.com.cn,2,0.00%,2,0,100.00%
sstats.adobe.com,2,0.00%,2,0,100.00%
sslsharev6.jomodns.com,2,0.00%,4,2,50.00%
dgss1.bdstatic.com,2,0.00%,4,2,50.00%
7.perf.msedge.net,2,0.00%,2,0,100.00%
c-ring.c-9999.c-msedge.net,2,0.00%,2,0,100.00%
weiboimgwx.gslb.sinaedge.com,2,0.00%,11,9,18.18%
pinduoduoimg.yangkeduo.com,2,0.00%,4,2,50.00%
pinduoduoimg.pddcdn.com,2,0.00%,4,2,50.00%
pinduoduoimg.yangkeduo.com.bsgslb.cn,2,0.00%,4,2,50.00%
zpinddipv6-1.v.bsgslb.cn,2,0.00%,4,2,50.00%
picx.zhimg.com.bytexns.com,2,0.00%,4,2,50.00%
acstatic-dun.126.net.163jiasu.com,2,0.00%,2,0,100.00%
www.chinadiplomacy.org.cn,2,0.00%,2,0,100.00%
intercom.io,2,0.00%,2,0,100.00%
i11.hoopchina.com.cn.cdn.dnsv1.com,2,0.00%,4,2,50.00%
officecdnmac.microsoft.com.edgesuite.net,2,0.00%,4,2,50.00%
l7-online-self-max-v6.s.dsa.cdnbuild.net,2,0.00%,2,0,100.00%
pcc-v1.log.mgtv.com,2,0.00%,2,0,100.00%
avatar-service-prod.trafficmanager.net,2,0.00%,2,0,100.00%
gr.china-embassy.gov.cn,2,0.00%,2,0,100.00%
cs.mfa.gov.cn,2,0.00%,2,0,100.00%
gr.china-embassy.org,2,0.00%,2,0,100.00%
www.chinadiplomacy.org.cn.bsgslb.cn,2,0.00%,2,0,100.00%
zgovweb1.v.bsgslb.cn,2,0.00%,2,0,100.00%
www.xinhuanet.com.w.cdngslb.com,2,0.00%,4,2,50.00%
www.yidaiyilu.gov.cn,2,0.00%,2,0,100.00%
a.slack-edge.com,2,0.00%,2,0,100.00%
pcvideoaliyun.titan.mgtv.com.w.kunlunea.com,2,0.00%,2,0,100.00%
aa704926751218a7.cdn.jiashule.com,2,0.00%,2,0,100.00%
ks3-cn-beijing.ksyun.com,2,0.00%,2,0,100.00%
p29-caldav.icloud.com,2,0.00%,4,2,50.00%
page.coral.qq.com,2,0.00%,2,0,100.00%
ncgi.video.qq.com,2,0.00%,2,0,100.00%
www.dingdx.com,2,0.00%,2,0,100.00%
ws.shimo.im,2,0.00%,2,0,100.00%
api.ppchart.com,2,0.00%,2,0,100.00%
amp.shinnytech.com,2,0.00%,2,0,100.00%
a1779.dscd.akamai.net.0.1.cn.akamaitech.net,2,0.00%,3,1,66.67%
tide-api.moreless.io,2,0.00%,2,0,100.00%
p26-buy-lb.itunes-apple.com.akadns.net,2,0.00%,2,0,100.00%
imap.liafa.univ-paris-diderot.fr,2,0.00%,2,0,100.00%
push-rest.mbgcdn.lenovo.com.cn,2,0.00%,2,0,100.00%
qzonestyle.gtimg.cn.cloud.tc.qq.com,2,0.00%,2,0,100.00%
qzonestyle.mid.tdnsv6.com,2,0.00%,2,0,100.00%
sr.ksria.cn,2,0.00%,4,2,50.00%
world.relay.skype.com,2,0.00%,2,0,100.00%
worldaz.relay.teams.microsoft.com,2,0.00%,2,0,100.00%
worldaz.relay.skype.trafficmanager.net,2,0.00%,2,0,100.00%
worldaz.relay.teams.trafficmanager.net,2,0.00%,2,0,100.00%
b-flightproxy-asse-01-skype.cloudapp.net,2,0.00%,2,0,100.00%
ea1-api-skype.cloudapp.net,2,0.00%,2,0,100.00%
l-ring.l-9999.l-msedge.net,2,0.00%,2,0,100.00%
l-9999.l-msedge.net,2,0.00%,2,0,100.00%
meeting-75420.pictestsz.qpic.cn,2,0.00%,2,0,100.00%
imap.tsinghua.org.cn,2,0.00%,5,3,40.00%
rpic.douyucdn.cn.w.kunlunar.com,2,0.00%,2,0,100.00%
huyaimg.msstatic.com.w.kunlunpi.com,2,0.00%,4,2,50.00%
osxapps.itunes.apple.com.w.alikunlun.com,2,0.00%,2,0,100.00%
ali.pull.yximgs.com,2,0.00%,4,2,50.00%
v4.kwaicdn.com,2,0.00%,4,2,50.00%
d2-reco.a.kwimgs.com,2,0.00%,2,0,100.00%
d4-magic.a.kwimgs.com,2,0.00%,4,2,50.00%
d4-ks.a.kwimgs.com,2,0.00%,4,2,50.00%
dsm01pap008.storage.live.com,2,0.00%,4,2,50.00%
tx-proxy.pull.yximgs.com,2,0.00%,2,0,100.00%
tx-game.pull.yximgs.com,2,0.00%,2,0,100.00%
dlcontrol.chub.sandai.net,2,0.00%,2,0,100.00%
ocws.officeapps.partner.office365.cn,2,0.00%,2,0,100.00%
www.tm.mc.ags.akadns.net,2,0.00%,2,0,100.00%
ehall.ucas.ac.cn,2,0.00%,2,0,100.00%
oss-chart.ppchart.com,2,0.00%,2,0,100.00%
www.cooboys.com,2,0.00%,2,0,100.00%
packages.jetbrains.team,2,0.00%,2,0,100.00%
sdkoptedge.chinanetcenter.com,2,0.00%,2,0,100.00%
ks-proxy.pull.yximgs.com,2,0.00%,2,0,100.00%
bd-proxy.pull.yximgs.com,2,0.00%,2,0,100.00%
httpdns.bcelive.com,2,0.00%,2,0,100.00%
ali2.a.kwimgs.com,2,0.00%,2,0,100.00%
ali-ad.a.yximgs.com,2,0.00%,2,0,100.00%
p2.adkwai.com,2,0.00%,2,0,100.00%
ali.push.yximgs.com,2,0.00%,2,0,100.00%
d2-ec.a.kwimgs.com,2,0.00%,2,0,100.00%
d2-kkd.a.kspkg.com,2,0.00%,2,0,100.00%
d2-push.static.yximgs.com,2,0.00%,2,0,100.00%
hw-p2p.pull.yximgs.com,2,0.00%,2,0,100.00%
d5-ks.a.kwimgs.com,2,0.00%,2,0,100.00%
d4-ec.a.kwimgs.com,2,0.00%,2,0,100.00%
ks.push.yximgs.com,2,0.00%,2,0,100.00%
bd.push.yximgs.com,2,0.00%,2,0,100.00%
v2-cty02.kwaicdn.com,2,0.00%,2,0,100.00%
v2-cty04.kwaicdn.com,2,0.00%,2,0,100.00%
v2-cty06.kwaicdn.com,2,0.00%,2,0,100.00%
v6-gdvod.kwaicdn.com,2,0.00%,2,0,100.00%
ws.push.yximgs.com,2,0.00%,2,0,100.00%
yximgs-webrtc.liveplay.myqcloud.com,2,0.00%,2,0,100.00%
live.kwd.inkuai.com,2,0.00%,2,0,100.00%
tx.push.yximgs.com,2,0.00%,2,0,100.00%
tRanSit1.WsLOG.CHinANetcentEr.COm,2,0.00%,2,0,100.00%
mAmbap2PvOdh5.8686c.COm,2,0.00%,2,0,100.00%
CLientlogvOdP2p.HAplAT.nET,2,0.00%,2,0,100.00%
v3.douyinvod.com,2,0.00%,2,0,100.00%
md.openapi.360.cn,2,0.00%,2,0,100.00%
vipzone.c.duba.net,2,0.00%,2,0,100.00%
cdn.vabs.hub.sandai.net,2,0.00%,2,0,100.00%
tracker1.wasabii.com.tw,2,0.00%,2,0,100.00%
ir03.graniterapids.com,2,0.00%,2,0,100.00%
t0.ssl.ak.tiles.virtualearth.net,2,0.00%,6,4,33.33%
matomo.pidoco.com,2,0.00%,2,0,100.00%
s.bdstatic.com,2,0.00%,9,7,22.22%
evening-badlands-6215.herokuapp.com,2,0.00%,2,0,100.00%
tracker.blucd.org,2,0.00%,2,0,100.00%
p3plmcpnl495951.prod.phx3.secureserver.net,2,0.00%,2,0,100.00%
g3.ykimg.com,2,0.00%,4,2,50.00%
nsp-appgallery-cmsimg3az-drcn.obs.cn-north-2.myhuaweicloud.com,2,0.00%,2,0,100.00%
xx.xingui001.com,2,0.00%,2,0,100.00%
dashboard.tymeo.de,2,0.00%,2,0,100.00%
codingpack.doorkeeper.jp,2,0.00%,2,0,100.00%
acquire.privy-staging-pr-3174.privy-staging.com,2,0.00%,2,0,100.00%
inferno.demonoid.ooo,2,0.00%,2,0,100.00%
shell.qemu.org,2,0.00%,2,0,100.00%
content-ui.battlenet.com.cn,2,0.00%,2,0,100.00%
oauth.battlenet.com.cn,2,0.00%,2,0,100.00%
contentstack-images.blzstatic.cn,2,0.00%,2,0,100.00%
cms.blzstatic.cn,2,0.00%,2,0,100.00%
ad.mrtnsvr.com,2,0.00%,2,0,100.00%
oxp.mxptint.net,2,0.00%,2,0,100.00%
comapi.izaodao.com,2,0.00%,2,0,100.00%
mountain.zhidao.baidu.com.cname3466.yjs-cdn.com,2,0.00%,2,0,100.00%
crl.godaddy.com,2,0.00%,2,0,100.00%
clock.cuhk.edu.hk,2,0.00%,2,0,100.00%
clock.redhat.com,2,0.00%,2,0,100.00%
e751.dsca.akamaiedge.net,2,0.00%,4,2,50.00%
securitymgmt.unifiedapis.mcafee.com,2,0.00%,2,0,100.00%
webzj.netstatic.net,2,0.00%,2,0,100.00%
WORKGROUP.HOST,2,0.00%,2,0,100.00%
www.bshare.cn,2,0.00%,2,0,100.00%
www.ithome.com,2,0.00%,4,2,50.00%
cmt.ithome.com,2,0.00%,2,0,100.00%
mq.hp-dataservices.com,2,0.00%,2,0,100.00%
d3-pr-cu-tm-secapi.trafficmanager.net,2,0.00%,2,0,100.00%
d3-pr-cu-app-sapicore.azurewebsites.net,2,0.00%,2,0,100.00%
p9-be-pack-sign.pglstatp-toutiao.com.bsgslb.com,2,0.00%,3,1,66.67%
mirror.premi.st,2,0.00%,2,0,100.00%
3392567.luxuryrealestate.com,2,0.00%,2,0,100.00%
img.kanzhun.com,2,0.00%,4,2,50.00%
h5.ds.163.com,2,0.00%,2,0,100.00%
winegui.melroy.org,2,0.00%,2,0,100.00%
melroyserver.duckdns.org,2,0.00%,2,0,100.00%
img.lapin365.com,2,0.00%,2,0,100.00%
static.hybris.com,2,0.00%,2,0,100.00%
blob.bnz10prdstr19a.store.core.windows.net,2,0.00%,2,0,100.00%
ts3.cn.mm.bing.net.lxcvc.com,2,0.00%,2,0,100.00%
chi01pcor002-com.be.1drv.com,2,0.00%,2,0,100.00%
app2.myzaker.com,2,0.00%,2,0,100.00%
app2.myzaker.com.w.cdngslb.com,2,0.00%,2,0,100.00%
app.myzaker.com,2,0.00%,2,0,100.00%
zkres.myzaker.com,2,0.00%,2,0,100.00%
zkres3.myzaker.com,2,0.00%,2,0,100.00%
zkres.myzaker.com.w.kunlunhuf.com,2,0.00%,2,0,100.00%
ae.bdstatic.com,2,0.00%,2,0,100.00%
ae.bdstatic.com.a.jomodns.com,2,0.00%,2,0,100.00%
zkres1.myzaker.com,2,0.00%,2,0,100.00%
ggs.myzaker.com,2,0.00%,2,0,100.00%
img.linux.net.cn,2,0.00%,2,0,100.00%
sync.dmp.otm-r.com,2,0.00%,2,0,100.00%
n-push-ws.tplinkcloud.com.cn,2,0.00%,2,0,100.00%
n-wap-ipc.tplinkcloud.com.cn,2,0.00%,2,0,100.00%
n-da.tplinkcloud.com.cn,2,0.00%,2,0,100.00%
minipkg.dingtalk.com,2,0.00%,4,2,50.00%
relay-ed2d2b06.net.anydesk.com,2,0.00%,2,0,100.00%
relay-4ab6679f.net.anydesk.com.cn,2,0.00%,2,0,100.00%
img2020.cnblogs.com,2,0.00%,2,0,100.00%
prod-addinsstoreapi.omexexternallfb.office.net.akadns.net,2,0.00%,2,0,100.00%
alldomain.c2r.ts.cdn.office.net.a.bdydns.com,2,0.00%,2,0,100.00%
opencdnmsdl5.jomodns.com,2,0.00%,2,0,100.00%
el2.ssgnode.ga,2,0.00%,2,0,100.00%
teleprogramma.pro,2,0.00%,2,0,100.00%
optout.businesswire.com,2,0.00%,2,0,100.00%
www.businesswire.com,2,0.00%,2,0,100.00%
mms.businesswire.com,2,0.00%,2,0,100.00%
as.sogou.com,2,0.00%,2,0,100.00%
corp.sogou.com,2,0.00%,2,0,100.00%
fankui.help.sogou.com,2,0.00%,2,0,100.00%
gouwu.sogou.com,2,0.00%,2,0,100.00%
hanyu.sogou.com,2,0.00%,2,0,100.00%
v.sogou.com,2,0.00%,2,0,100.00%
wenwen.sogou.com,2,0.00%,2,0,100.00%
zhihu.sogou.com,2,0.00%,2,0,100.00%
www.xiami.com,2,0.00%,2,0,100.00%
www.jumei.com,2,0.00%,2,0,100.00%
whois-upload-srv.zhhainiao.com,2,0.00%,2,0,100.00%
www.chndoi.org,2,0.00%,2,0,100.00%
c61.cnki.net,2,0.00%,2,0,100.00%
api-edge.apps-lb.itunes-apple.com.akadns.net,2,0.00%,3,1,66.67%
api-apps-lb.itunes-apple.com.akadns.net,2,0.00%,3,1,66.67%
silverbullet-external-ats.itunes-apple.com.akadns.net,2,0.00%,2,0,100.00%
api-apps-lb-cn.itunes-apple.com.akadns.net,2,0.00%,3,1,66.67%
sdkclick.uve.weibo.com,2,0.00%,2,0,100.00%
t2.a.market.xiaomi.com,2,0.00%,2,0,100.00%
t.a.market.c.mgslb.com,2,0.00%,2,0,100.00%
r4---sn-ni5een7z.gvt1.com,2,0.00%,2,0,100.00%
push-ws.mercuryclouds.com.cn,2,0.00%,2,0,100.00%
svc-ipc-ali.mercuryclouds.com.cn,2,0.00%,2,0,100.00%
txc-transmit-ipc-nj-01.mercuryclouds.com.cn,2,0.00%,2,0,100.00%
sync.ipredictive.com,2,0.00%,2,0,100.00%
vdn3.vzuu.com.cdn.dnsv1.com,2,0.00%,4,2,50.00%
chat.avatar.ext.hp.com,2,0.00%,2,0,100.00%
webapi.account.mihoyo.com,2,0.00%,2,0,100.00%
sg09.graniterapids.com,2,0.00%,2,0,100.00%
3.tlu.dl.delivery.mp.microsoft.com.c.footprint.net,2,0.00%,4,2,50.00%
devcenterapi.azure-api.net,2,0.00%,2,0,100.00%
member-log.aligames.com,2,0.00%,2,0,100.00%
member-biz.aligames.com,2,0.00%,2,0,100.00%
mtop.jiaoyimao.com,2,0.00%,2,0,100.00%
et2-na61-na62.wagbridge.alibaba.tanx.com,2,0.00%,2,0,100.00%
static-cdn.jiaoyimao.com,2,0.00%,2,0,100.00%
im-dispatcher.aligames.com,2,0.00%,2,0,100.00%
usdpdown.game.uodoo.com,2,0.00%,2,0,100.00%
a.jiaoyimao.com,2,0.00%,2,0,100.00%
upos-sz-static.bilivideo.com.cdn.dnsv1.com,2,0.00%,4,2,50.00%
avu8qy84.sched.dma-dk.tdnsdl1.cn,2,0.00%,4,2,50.00%
ucc-config.aligames.com,2,0.00%,2,0,100.00%
gs21wx.im.aliyuncs.com,2,0.00%,2,0,100.00%
static.jiaoyimao.com,2,0.00%,2,0,100.00%
m.jiaoyimao.com,2,0.00%,2,0,100.00%
im-biz-cs.aligames.com,2,0.00%,2,0,100.00%
cdn.aligames.com,2,0.00%,2,0,100.00%
smarthome-drcn.dbankcdn.com.cdn.dnsv1.com,2,0.00%,2,0,100.00%
zb-center-accscdn.m.taobao.com,2,0.00%,2,0,100.00%
zb-center-accscdn.m.taobao.com.gds.alibabadns.com,2,0.00%,2,0,100.00%
oauth-login.platform.hicloud.com,2,0.00%,2,0,100.00%
dmvideo.gslb.sinaedge.com,2,0.00%,3,1,66.67%
rc10-fc09.oray.com,2,0.00%,2,0,100.00%
gtm-cn-6ja1oiz5802.mafengwo.cn,2,0.00%,2,0,100.00%
baobao.sohu.com.dsa.dnsv1.com,2,0.00%,2,0,100.00%
v4-4.hiaoxui.work,2,0.00%,2,0,100.00%
v3-fq-tts.fqnovelvod.com,2,0.00%,4,2,50.00%
v4-35.hiaoxui.work,2,0.00%,2,0,100.00%
ldc-fast.mbgcdn.lenovo.com.cn,2,0.00%,2,0,100.00%
ldc-fast.lenovo.com.cn.trpcdn.net,2,0.00%,2,0,100.00%
msg-csw-lenovo.com,2,0.00%,2,0,100.00%
cdn.max-c.com,2,0.00%,2,0,100.00%
default.cn.zb.wagbridge.umeng.alibabacorp.com.gds.alibabadns.com,2,0.00%,2,0,100.00%
docs2.gtimg.com.sched.legopic2-dk.tdnsv6.com,2,0.00%,4,2,50.00%
mxb-00165c01.gslb.pphosted.com,2,0.00%,2,0,100.00%
mxa-00165c01.gslb.pphosted.com,2,0.00%,2,0,100.00%
onedriveclucproddm20019.blob.core.windows.net,2,0.00%,2,0,100.00%
vod-settings.volcvod.com,2,0.00%,2,0,100.00%
ip3720517250.funshion.com,2,0.00%,2,0,100.00%
ip2091113743.funshion.com,2,0.00%,2,0,100.00%
ip2091113744.funshion.com,2,0.00%,2,0,100.00%
ip2072148259.funshion.com,2,0.00%,2,0,100.00%
waws-prod-bay-2e554e5e.cloudapp.net,2,0.00%,2,0,100.00%
deploy.mopinion.com,2,0.00%,2,0,100.00%
www.shixingceping.com,2,0.00%,2,0,100.00%
36d64ce2.sched.skalego.tdnsstic1.cn,2,0.00%,2,0,100.00%
a.tiles.mapbox.com,2,0.00%,2,0,100.00%
dldir2.qq.com.legodlied1.sched.dcloudstc.com,2,0.00%,2,0,100.00%
mailn6sh.message.cmbchina.com,2,0.00%,2,0,100.00%
mailn4sk.message.cmbchina.com,2,0.00%,2,0,100.00%
mailn1sh.message.cmbchina.com,2,0.00%,2,0,100.00%
api.zhihu.com.dsa.dnsv1.com,2,0.00%,10,8,20.00%
mail3.message.cmbchina.com,2,0.00%,2,0,100.00%
ns1-03.azure-dns.com,2,0.00%,8,6,25.00%
oimageb7.ydstatic.com,2,0.00%,2,0,100.00%
www.weather.com.cn,2,0.00%,2,0,100.00%
www.atguigu.com,2,0.00%,2,0,100.00%
tb.53kf.com,2,0.00%,2,0,100.00%
www.gulixueyuan.com,2,0.00%,2,0,100.00%
www.itdachang.com,2,0.00%,2,0,100.00%
www.mobiletrain.org,2,0.00%,2,0,100.00%
www13.53kf.com,2,0.00%,2,0,100.00%
accwww13.53kf.com,2,0.00%,2,0,100.00%
cpro.baidu.com,2,0.00%,2,0,100.00%
filesys.53kf.com,2,0.00%,2,0,100.00%
oss.zhixi.com,2,0.00%,2,0,100.00%
img.y.qq.com,2,0.00%,2,0,100.00%
hunantv.m.cn.miaozhen.com,2,0.00%,2,0,100.00%
client.map.baidu.com,2,0.00%,6,4,33.33%
mobile.yangkeduo.com,2,0.00%,2,0,100.00%
promotion.pddpic.com,2,0.00%,2,0,100.00%
tne.pinduoduo.com,2,0.00%,2,0,100.00%
video3.pddpic.com,2,0.00%,5,3,40.00%
titan-ws.pinduoduo.com,2,0.00%,2,0,100.00%
img-1.pddpic.com,2,0.00%,2,0,100.00%
cmtw.pinduoduo.com,2,0.00%,2,0,100.00%
avatar2.pddpic.com,2,0.00%,2,0,100.00%
sign.utcsoft.com,2,0.00%,2,0,100.00%
jgwdb2.gaox.ml,2,0.00%,2,0,100.00%
citicbank.ceping.com,2,0.00%,2,0,100.00%
catchoice.ceping.com,2,0.00%,2,0,100.00%
bl.nbmswl.com,2,0.00%,2,0,100.00%
zhifoukeji.datasink.sensorsdata.cn,2,0.00%,2,0,100.00%
upd2.sangfor.com.cn.localdomain,2,0.00%,2,0,100.00%
mail.triinnboc.com,2,0.00%,2,0,100.00%
u.jia.mn,2,0.00%,2,0,100.00%
license.unity.cn,2,0.00%,2,0,100.00%
tiantang.mogencloud.com,2,0.00%,2,0,100.00%
picgalb.beisen.com,2,0.00%,2,0,100.00%
fgc0.market.xiaomi.com,2,0.00%,2,0,100.00%
cloudres-drcn.dbankcdn.cn,2,0.00%,2,0,100.00%
cloudres-drcn.dbankcdn.globalsign.c.cdnhwc1.cn,2,0.00%,2,0,100.00%
userk-drcn-cloud-dbankcloud-cn-drcn.appacc.dbankedge.cn,2,0.00%,2,0,100.00%
userk-drcn-cloud-dbankcloud-cn-drcn.edge.dbankedge.cn,2,0.00%,2,0,100.00%
pim-drcn-cloud-dbankcloud-cn-drcn.appacc.dbankedge.net,2,0.00%,2,0,100.00%
pim-drcn-cloud-dbankcloud-cn-drcn.edge.dbankedge.cn,2,0.00%,2,0,100.00%
subscribe.rss-node.com,2,0.00%,2,0,100.00%
ins-5fdz0eh7.ias.tencent-cloud.net,2,0.00%,2,0,100.00%
sq.bls.mdt.qq.com,2,0.00%,2,0,100.00%
cdn.xsj.qq.com,2,0.00%,2,0,100.00%
tsms-drcn.platform.dbankcloud.com,2,0.00%,2,0,100.00%
imlong-sa-p04-drcn.platform.dbankcloud.cn,2,0.00%,2,0,100.00%
sns-drcn.platform.dbankcloud.cn,2,0.00%,2,0,100.00%
mobile.cmbchina.com,2,0.00%,2,0,100.00%
cmp.zh.cmbchina.com,2,0.00%,2,0,100.00%
www.mayiwxw.com,2,0.00%,2,0,100.00%
ca-s2.fatvpn.ml,2,0.00%,2,0,100.00%
staging.v2.myteachlink.com,2,0.00%,2,0,100.00%
a2-65.akam.net,2,0.00%,2,0,100.00%
bg6.market.xiaomi.com,2,0.00%,2,0,100.00%
e8960.e2.akamaiedge.net,2,0.00%,2,0,100.00%
getip.wps.cn,2,0.00%,2,0,100.00%
xdzyfw.10jqka.com.cn,2,0.00%,2,0,100.00%
id.google.com.hk,2,0.00%,4,2,50.00%
e6858.dscx.akamaiedge.net,2,0.00%,7,5,28.57%
e2cs17.gcp.gvt2.com,2,0.00%,2,0,100.00%
h5.vedamobi.com,2,0.00%,2,0,100.00%
v.vaptcha.com,2,0.00%,2,0,100.00%
y.qq.com.sched.legopic1.tdnsv6.com,2,0.00%,2,0,100.00%
i-bn2b-cor003.api.p001.1drv.com,2,0.00%,2,0,100.00%
pdns124.ultradns.org,2,0.00%,5,3,40.00%
c1--cn-gotcha208.bilivideo.com,2,0.00%,5,3,40.00%
hk10.virtual-strike.com,2,0.00%,2,0,100.00%
wan.baidu.com,2,0.00%,2,0,100.00%
wvw.4366.com,2,0.00%,2,0,100.00%
p4psearch.1688.com,2,0.00%,2,0,100.00%
download.52pcfree.com,2,0.00%,2,0,100.00%
webdemo.myscript.com,2,0.00%,2,0,100.00%
webdemoapi.myscript.com,2,0.00%,2,0,100.00%
qrcode.mse.sogou.com,2,0.00%,2,0,100.00%
img.baidu.com,2,0.00%,2,0,100.00%
www.wiris.net,2,0.00%,2,0,100.00%
manifest.googlevideo.com,2,0.00%,4,2,50.00%
img-music.heytapimage.com,2,0.00%,2,0,100.00%
appconf-ocs.heytapdownload.com,2,0.00%,2,0,100.00%
www.stcn.com,2,0.00%,2,0,100.00%
epaper.stcn.com,2,0.00%,2,0,100.00%
data.stcn.com,2,0.00%,2,0,100.00%
kuaixun.stcn.com,2,0.00%,2,0,100.00%
zt.stcn.com,2,0.00%,2,0,100.00%
r3.sn-2x3elnez.gvt1.com,2,0.00%,2,0,100.00%
ec.walkme.com,2,0.00%,2,0,100.00%
assets.imedao.com,2,0.00%,2,0,100.00%
dsp.ads.umeng.com,2,0.00%,4,2,50.00%
amsfile.5i5j.com,2,0.00%,2,0,100.00%
hwxypic.5i5j.com,2,0.00%,2,0,100.00%
image.5i5j.com,2,0.00%,2,0,100.00%
xycitys.5i5j.com,2,0.00%,2,0,100.00%
news.duote.com,2,0.00%,2,0,100.00%
img1.runjiapp.com,2,0.00%,2,0,100.00%
img2.runjiapp.com,2,0.00%,2,0,100.00%
img4.runjiapp.com,2,0.00%,2,0,100.00%
img3.runjiapp.com,2,0.00%,2,0,100.00%
img5.runjiapp.com,2,0.00%,2,0,100.00%
oss.kazhifu.com,2,0.00%,2,0,100.00%
www.duote.com,2,0.00%,2,0,100.00%
url.pc120.com,2,0.00%,2,0,100.00%
www.tuidc.com,2,0.00%,2,0,100.00%
www.zx110.org,2,0.00%,2,0,100.00%
bd-js1.2345.com,2,0.00%,2,0,100.00%
realsense-hw-public.s3.amazonaws.com,2,0.00%,2,0,100.00%
CliENTLOgVODp2P.HaPLAt.Net,2,0.00%,2,0,100.00%
transIt1.WsLog.ChiNANEtCeNtEr.com,2,0.00%,2,0,100.00%
MAmbaP2pvoDh5.8686c.COm,2,0.00%,2,0,100.00%
e2cs03.gcp.gvt2.com,2,0.00%,2,0,100.00%
ns11.zonecybersite.com,2,0.00%,2,0,100.00%
ns76.cybersitezone.com,2,0.00%,2,0,100.00%
ns10.zonecybersite.com,2,0.00%,2,0,100.00%
ns77.cybersitezone.com,2,0.00%,2,0,100.00%
m.onegreen.net.cdn30.com,2,0.00%,2,0,100.00%
cdi-pe-app.letras.ulisboa.pt,2,0.00%,2,0,100.00%
contentful.ziroom.com,2,0.00%,2,0,100.00%
p25-sharedstreams.icloud.com.cn,2,0.00%,2,0,100.00%
img-blog.csdn.net.trpcdn.net,2,0.00%,2,0,100.00%
b2b-web-public.cdn.bcebos.com,2,0.00%,4,2,50.00%
js.live.net,2,0.00%,2,0,100.00%
2398.35go.net,2,0.00%,2,0,100.00%
v96.toutiaovod.com,2,0.00%,2,0,100.00%
v26.toutiaovod.com,2,0.00%,2,0,100.00%
office-fg-geo.trafficmanager.net,2,0.00%,2,0,100.00%
kingsoftspark.c2r.ts.cdn.office.net.download.ks-cdn.com,2,0.00%,2,0,100.00%
xbroker-z1-i6.ngxcld.com,2,0.00%,2,0,100.00%
status.plex.tv,2,0.00%,2,0,100.00%
www.cathaypacific.com,2,0.00%,2,0,100.00%
edge-142.hkhkg.icloud-content.com,2,0.00%,3,1,66.67%
idc-hq-ja.sinajs.cn,2,0.00%,2,0,100.00%
pub.idqqimg.com.sched.legopic2-dk.tdnsv6.com,2,0.00%,4,2,50.00%
stmp.fikuu.com,2,0.00%,2,0,100.00%
people-pa.clients6.google.com,2,0.00%,2,0,100.00%
p209-fmfmobile.icloud.com.cn,2,0.00%,2,0,100.00%
skypeecs-prod-eun-2.trafficmanager.net,2,0.00%,2,0,100.00%
www.itpub.net,2,0.00%,2,0,100.00%
57.push2.eastmoney.com,2,0.00%,3,1,66.67%
blob.bnz10prdstr22a.store.core.windows.net,2,0.00%,2,0,100.00%
phx02pcor002-com.be.1drv.com,2,0.00%,2,0,100.00%
onedriveclubprodbn20004.blob.core.windows.net,2,0.00%,2,0,100.00%
36d64ce2.sched.skalego.tdnsstic1.cn.cjt.vwnti.yrzhcloud.cn,2,0.00%,2,0,100.00%
bduserlog.eastmoney.com,2,0.00%,2,0,100.00%
guarantee.cdn.bcebos.com,2,0.00%,2,0,100.00%
guarantee.cdn.bcebos.com.a.bdydns.com,2,0.00%,2,0,100.00%
res4.vmallres.com,2,0.00%,2,0,100.00%
res4.vmallres.com.c.cdnhwc1.com,2,0.00%,2,0,100.00%
res9.vmallres.com,2,0.00%,2,0,100.00%
mixv4-35.194610.xyz,2,0.00%,2,0,100.00%
mixv4-16.194610.xyz,2,0.00%,2,0,100.00%
mixv4-5.194610.xyz,2,0.00%,2,0,100.00%
mixv4-4.194610.xyz,2,0.00%,2,0,100.00%
mixv4-11.194610.xyz,2,0.00%,2,0,100.00%
465fe81be1b5cc4f9a8c4f8553cfa7cd.dlied1.cdntips.net,2,0.00%,2,0,100.00%
sg.tdatamaster.com,2,0.00%,2,0,100.00%
qd.com.wulincdn.com,2,0.00%,2,0,100.00%
twct07.graniterapids.com,2,0.00%,2,0,100.00%
play.samsungcloud.com,2,0.00%,2,0,100.00%
rnstn-api.samsung.com.cn,2,0.00%,2,0,100.00%
r2.cn-auth2.samsungosp.com.cn,2,0.00%,2,0,100.00%
fp274c.wpc.46392.phicdn.net,2,0.00%,2,0,100.00%
ali-bj-pcdn-10.biliapi.net,2,0.00%,2,0,100.00%
mmbiz.mid.tdnsv6.com,2,0.00%,4,2,50.00%
res06.bignox.com,2,0.00%,2,0,100.00%
api.bignox.com,2,0.00%,2,0,100.00%
s22-sync.firefox.com.cn,2,0.00%,2,0,100.00%
tk.7086.in,2,0.00%,2,0,100.00%
opentrackr.org,2,0.00%,2,0,100.00%
page.douding.cn,2,0.00%,2,0,100.00%
tug.org,2,0.00%,2,0,100.00%
page2.douding.cn,2,0.00%,2,0,100.00%
passapi.izaodao.com,2,0.00%,2,0,100.00%
msgapi.izaodao.com,2,0.00%,2,0,100.00%
combizapi.izaodao.com,2,0.00%,2,0,100.00%
cdn.wwads.cn.cdn.dnsv1.com.cn,2,0.00%,2,0,100.00%
usc-2.config.skype.com,2,0.00%,2,0,100.00%
tracker.artixlinux.org,2,0.00%,2,0,100.00%
e2c50.gcp.gvt2.com,2,0.00%,2,0,100.00%
www.tug.org,2,0.00%,2,0,100.00%
imcpf.eastmoney.com,2,0.00%,2,0,100.00%
isecure.vivo.com.cn,2,0.00%,2,0,100.00%
rds.console.aliyun.com,2,0.00%,2,0,100.00%
survey.aliyun.com,2,0.00%,2,0,100.00%
xux-web-config.oss-accelerate.aliyuncs.com,2,0.00%,2,0,100.00%
market.console.aliyun.com,2,0.00%,2,0,100.00%
logo.aliyun.com,2,0.00%,2,0,100.00%
enterprise.aliyun.com,2,0.00%,2,0,100.00%
bi.aliyun.com,2,0.00%,2,0,100.00%
nativesupport.dcloud.net.cn,2,0.00%,2,0,100.00%
img.cdn.aliyun.dcloud.net.cn,2,0.00%,2,0,100.00%
download.overwolf.com,2,0.00%,2,0,100.00%
image0.lietou-static.com.wscdns.com,2,0.00%,2,0,100.00%
wap.tankung.com,2,0.00%,2,0,100.00%
static-res.mid.tdnsv6.com,2,0.00%,2,0,100.00%
static-res.qq.com.legodlied1.sched.dcloudstc.com,2,0.00%,2,0,100.00%
jvod.300hu.com.vod.galileo.jcloud-cdn.com,2,0.00%,4,2,50.00%
jvod.300hu.com.c.cdnhwc1.com,2,0.00%,4,2,50.00%
hcdnv.jd.ipv6.c.cdnhwc1.com,2,0.00%,4,2,50.00%
img10.360buyimg.com.s.galileo.jcloud-cdn.com,2,0.00%,4,2,50.00%
dmpstatic.cdn.bcebos.com.a.bdydns.com,2,0.00%,2,0,100.00%
baikebcs.bdimg.com.a.bdydns.com,2,0.00%,4,2,50.00%
ohtsvd8qehh09805es2efmpr5e6uhldkto01rh98rkln0un9qp1furn9.qc.x.bsgslb.cn,2,0.00%,2,0,100.00%
ip1880707494.funshion.com,2,0.00%,2,0,100.00%
ip462737477.funshion.com,2,0.00%,2,0,100.00%
ocsp.starfieldtech.com,2,0.00%,2,0,100.00%
qingque.cn,2,0.00%,2,0,100.00%
passport.qingque.cn,2,0.00%,2,0,100.00%
sixinpic.kuaishou.com,2,0.00%,2,0,100.00%
p3.itc.cn,2,0.00%,5,3,40.00%
assp.sohu.com,2,0.00%,2,0,100.00%
www.ctex.org,2,0.00%,2,0,100.00%
images2017.cnblogs.com,2,0.00%,2,0,100.00%
www.52yfjc.com,2,0.00%,2,0,100.00%
v6-fq-tts.fqnovelvod.com-1.download.ks-cdn.com,2,0.00%,2,0,100.00%
upp.itunes.apple.com,2,0.00%,4,2,50.00%
a1818.dscg2.akamai.net,2,0.00%,6,4,33.33%
app.launchdarkly.com,2,0.00%,2,0,100.00%
www.g2795hhl.com,2,0.00%,2,0,100.00%
gsp10-ssl-cn.ls.apple.com,2,0.00%,2,0,100.00%
v6-fq-tts.fqnovelvod.com,2,0.00%,2,0,100.00%
freeus.gslb.sinaedge.com,2,0.00%,2,0,100.00%
blocklist.addons.mozilla.org,2,0.00%,2,0,100.00%
mail.thoughliperpai.tk,2,0.00%,2,0,100.00%
20.push2.eastmoney.com,2,0.00%,3,1,66.67%
e96763.dscb.akamaiedge.net,2,0.00%,4,2,50.00%
www.tom.com,2,0.00%,2,0,100.00%
freeedgeali.grid.sinaedge.com,2,0.00%,2,0,100.00%
www.jd.com.gslb.qianxun.com,2,0.00%,2,0,100.00%
docs.feishu.cn.bytedns1.com,2,0.00%,2,0,100.00%
docs.feishu.cn.1046296236066394.w.cdngslb.com,2,0.00%,2,0,100.00%
3845mc9p.yunhucdn.com,2,0.00%,2,0,100.00%
30.n.yunhucdn.com,2,0.00%,2,0,100.00%
nv00.cdn.bcebos.com.a.bdydns.com,2,0.00%,3,1,66.67%
aidc.apple.com,2,0.00%,2,0,100.00%
event.4wps.net,2,0.00%,2,0,100.00%
obs.lz09-br-dy.cn-north-4.myhuaweicloud.com,2,0.00%,2,0,100.00%
bifrost-v4.getpostman.com,2,0.00%,4,2,50.00%
global.reg.ntes53.netease.com,2,0.00%,2,0,100.00%
s2.music.126.net.w.kunluncan.com,2,0.00%,2,0,100.00%
s5.music.126.net.w.alikunlun.com,2,0.00%,4,2,50.00%
abtest3-misc-lf.zijieapi.com,2,0.00%,4,2,50.00%
weather-map.lb-apple.com.akadns.net,2,0.00%,4,2,50.00%
weblog.cdn-go.cn,2,0.00%,4,2,50.00%
ins-1enqldlj.ias.tencent-cloud.net,2,0.00%,2,0,100.00%
zhh.cdn.yunjiasu360.com,2,0.00%,2,0,100.00%
apd-7b882d5b46ff3cd896caff102246307d.v.smtcdns.com,2,0.00%,2,0,100.00%
package.dingtalk.com,2,0.00%,4,2,50.00%
MAMbaP2pvOdh5.8686c.CoM,2,0.00%,2,0,100.00%
CliENtlOGvoDP2p.hAPlaT.NeT,2,0.00%,2,0,100.00%
sfepodownload.mediatek.com,2,0.00%,2,0,100.00%
r2.sn-2x3elnee.gvt1.com,2,0.00%,2,0,100.00%
tabnine.gallerycdn.azure.cn,2,0.00%,2,0,100.00%
61.push2.eastmoney.com,2,0.00%,4,2,50.00%
ns4.alikunlun.com,2,0.00%,2,0,100.00%
dnnx3exhrd7to.cloudfront.net,2,0.00%,2,0,100.00%
www.sharelatex.com,2,0.00%,2,0,100.00%
csp.escience.cn,2,0.00%,2,0,100.00%
amss.arp.cn,2,0.00%,2,0,100.00%
english.amss.cas.cn,2,0.00%,2,0,100.00%
www.chinamath.cn,2,0.00%,2,0,100.00%
v.hoopchina.com.cn.cdn.dnsv1.com,2,0.00%,4,2,50.00%
a.jd.com,2,0.00%,2,0,100.00%
update.hicloud.com,2,0.00%,4,2,50.00%
sellercentral.amazon.com,2,0.00%,2,0,100.00%
identify.zhhainiao.com,2,0.00%,2,0,100.00%
eclyq.me,2,0.00%,2,0,100.00%
xbox.360game.360.cn,2,0.00%,2,0,100.00%
upd12.sogoucdn.com,2,0.00%,2,0,100.00%
go.browser.qq.com,2,0.00%,2,0,100.00%
game.browser.qq.com,2,0.00%,2,0,100.00%
mdp-appconf-cn.heytapdownload.com,2,0.00%,2,0,100.00%
mdp-appconf-cn.heytapdownload.com.w.alikunlun.com,2,0.00%,2,0,100.00%
puui.qpic.cn.tc.qq.com,2,0.00%,3,1,66.67%
p0ehh1w4.sched.sma-dk.tdnsstic1.cn,2,0.00%,4,2,50.00%
hovv.yilanvaas.com.bsclink.cn,2,0.00%,4,2,50.00%
v1-hax.jikeiot.cloud,2,0.00%,2,0,100.00%
game.eve.mdt.qq.com,2,0.00%,2,0,100.00%
qsb.browser.miui.com,2,0.00%,2,0,100.00%
browsers-pri-c3-c4.alb.xiaomi.com,2,0.00%,2,0,100.00%
rusfs.coloros.com,2,0.00%,2,0,100.00%
multi-az-ad.kuaishou.com,2,0.00%,2,0,100.00%
smart-sms-cn.heytapimage.com,2,0.00%,2,0,100.00%
ins-kn8txc8j.ias.tencent-cloud.net,2,0.00%,2,0,100.00%
p214-contacts.icloud.com.cn,2,0.00%,2,0,100.00%
stats.snipaste.com,2,0.00%,2,0,100.00%
micardapi.micloud.xiaomi.net,2,0.00%,2,0,100.00%
contactapi.micloud.xiaomi.net,2,0.00%,2,0,100.00%
stats.dmp.ghac.cn,2,0.00%,2,0,100.00%
imagev2.xmcdn.com,2,0.00%,6,4,33.33%
s1.xmcdn.com,2,0.00%,4,2,50.00%
mobile.ximalaya.com.dsa.dnsv1.com,2,0.00%,2,0,100.00%
ximalaya.sched.d0.tdnsdp1.cn,2,0.00%,2,0,100.00%
gslbali.ximalaya.com,2,0.00%,2,0,100.00%
pc.ximalaya.com.dsa.dnsv1.com.cn,2,0.00%,2,0,100.00%
rsg461l4.sched.d0.tdnsdp1.cn,2,0.00%,2,0,100.00%
api.feelgood.cn.w.cdngslb.com,2,0.00%,2,0,100.00%
data-drcn.push.dbankcloud.com,2,0.00%,2,0,100.00%
hrec.woqu365.com,2,0.00%,2,0,100.00%
www.zycg.gov.cn,2,0.00%,4,2,50.00%
ggzy.zycg.gov.cn,2,0.00%,2,0,100.00%
staging.wingmateapp.com,2,0.00%,2,0,100.00%
firstpartyapps.oaspapps.com,2,0.00%,2,0,100.00%
msftprod.firstpartyapps.oaspapps.com.akadns.net,2,0.00%,2,0,100.00%
pic2.pedaily.cn,2,0.00%,2,0,100.00%
htp.miwifi.com,2,0.00%,2,0,100.00%
mssdk.snssdk.com,2,0.00%,2,0,100.00%
t2.tiles.ditu.live.com,2,0.00%,2,0,100.00%
huya.com.c.cdnhwc1.com,2,0.00%,6,4,33.33%
dy-vod-g.bytegslb.com,2,0.00%,2,0,100.00%
star-mini.c10r.facebook.com,2,0.00%,4,2,50.00%
referrer.disqus.com,2,0.00%,2,0,100.00%
e8819.g.akamaiedge.net,2,0.00%,2,0,100.00%
apios-alps.51y5.net,2,0.00%,2,0,100.00%
ios-dc.51y5.net,2,0.00%,2,0,100.00%
ios-config.51y5.net,2,0.00%,2,0,100.00%
configwuxi.51y5.net,2,0.00%,2,0,100.00%
v3-web.douyinvod.com,2,0.00%,4,2,50.00%
fe2.hdfimg.com,2,0.00%,2,0,100.00%
fe3.hdfimg.com,2,0.00%,2,0,100.00%
e7caf16f8d004317a865f5a0ab13dc4d.fp.measure.office.com,2,0.00%,2,0,100.00%
staging-codecamp-app.codemao.cn,2,0.00%,2,0,100.00%
p208-escrowproxy.icloud.com.cn,2,0.00%,2,0,100.00%
musicstatus-apac-s.edge-itunes-apple.com.akadns.net,2,0.00%,2,0,100.00%
mel-mvp.trafficmanager.net,2,0.00%,4,2,50.00%
freesound-api.gongyier.com,2,0.00%,2,0,100.00%
freesound-down.audiodown.com,2,0.00%,2,0,100.00%
play-tx-ugcpub.douyucdn2.cn.cdn.dnsv1.com,2,0.00%,2,0,100.00%
ms-comment.douyucdn.cn,2,0.00%,2,0,100.00%
play-tx-ugcpub.douyucdn2.cn.sched.v1.tdnsvod1.cn,2,0.00%,2,0,100.00%
vdot.douyucdn.cn,2,0.00%,2,0,100.00%
wanproxy.127.net,2,0.00%,2,0,100.00%
pc.yiyouliao.com,2,0.00%,2,0,100.00%
yiyouliao.com,2,0.00%,2,0,100.00%
analytics.yiyouliao.com,2,0.00%,2,0,100.00%
mail.seobatch123.tk,2,0.00%,2,0,100.00%
p5.music.126.net.trpcdn.net,2,0.00%,3,1,66.67%
p6.music.126.net,2,0.00%,4,2,50.00%
p6.music.126.net.w.kunluncan.com,2,0.00%,4,2,50.00%
ssjj2-micro.ssjj.cn,2,0.00%,2,0,100.00%
2xogv03u.dayugslb.com,2,0.00%,2,0,100.00%
3312050987-server.va.huya.com,2,0.00%,2,0,100.00%
skynet.bilivideo.com,2,0.00%,2,0,100.00%
d0--cn-gotcha01.bilivideo.com,2,0.00%,2,0,100.00%
8667973.sched.sma.tdnsstic1.cn.cjt.krcdn.idatacube.com,2,0.00%,2,0,100.00%
df.tanx.com,2,0.00%,2,0,100.00%
df.tanx.com.gds.alibabadns.com,2,0.00%,2,0,100.00%
ad-sh-sz-zb.wagbridge.tanx.alimama.com,2,0.00%,2,0,100.00%
xmpp008.hpeprint.com,2,0.00%,2,0,100.00%
dral.irs03.com,2,0.00%,2,0,100.00%
pocket.pcauto.com.cn,2,0.00%,2,0,100.00%
diy.pconline.com.cn,2,0.00%,2,0,100.00%
fawiad-dv.faw.cn,2,0.00%,2,0,100.00%
ks.pconline.com.cn,2,0.00%,2,0,100.00%
www.pcbaby.com.cn.ctdns.cn,2,0.00%,2,0,100.00%
forward.douban.com,2,0.00%,2,0,100.00%
frodo.douban.com,2,0.00%,2,0,100.00%
orbit.jd.com,2,0.00%,2,0,100.00%
kepler.jd.com,2,0.00%,2,0,100.00%
api.douban.com,2,0.00%,2,0,100.00%
img9.doubanio.com.cdn.dnsv1.com,2,0.00%,3,1,66.67%
cacerts.digicert.cn,2,0.00%,2,0,100.00%
artery.douban.com,2,0.00%,2,0,100.00%
configure.rayjump.com,2,0.00%,2,0,100.00%
img3.bitautoimg.com,2,0.00%,4,2,50.00%
img1.bitauto.com,2,0.00%,4,2,50.00%
img2.bitauto.com,2,0.00%,4,2,50.00%
img3.bitauto.com,2,0.00%,4,2,50.00%
img2.bitauto.com.download.ks-cdn.com,2,0.00%,3,1,66.67%
img3.bitauto.com.download.ks-cdn.com,2,0.00%,3,1,66.67%
cdn.permutive.com,2,0.00%,2,0,100.00%
cdn.speedcurve.com,2,0.00%,2,0,100.00%
best.sched.sma-dk.tdnsstic1.cn.cjt.krcdn.idatacube.com,2,0.00%,4,2,50.00%
i.ai.mi.com,2,0.00%,2,0,100.00%
CliENtLOgvOdp2p.HaPlAt.NeT,2,0.00%,2,0,100.00%
traNSIT1.wslOG.cHinANETCenteR.cOm,2,0.00%,2,0,100.00%
MAmbAP2PVOdh5.8686c.com,2,0.00%,2,0,100.00%
TRAnsIT1.WSlOG.ChINanETceNTEr.coM,2,0.00%,2,0,100.00%
CLientLogVOdP2p.hAPlAT.NET,2,0.00%,2,0,100.00%
MaMBaP2PvodH5.8686C.COM,2,0.00%,2,0,100.00%
maxdeutsch.somebody.io,2,0.00%,2,0,100.00%
report.boxsvr.niu.xunlei.com,2,0.00%,2,0,100.00%
blob.dsm10prdstr04a.store.core.windows.net,2,0.00%,2,0,100.00%
t.dynamic.tiles.ditu.live.ccgslb.com.cn,2,0.00%,2,0,100.00%
t0.dynamic.tiles.ditu.live.com.lxcvc.com,2,0.00%,2,0,100.00%
public-data-api.mihoyo.com,2,0.00%,2,0,100.00%
abtest-api-data.mihoyo.com,2,0.00%,2,0,100.00%
a2pssl-drcn.dbankcdn.cn.c.cdnhwc1.com,2,0.00%,2,0,100.00%
game.production.clashofclans.cn,2,0.00%,2,0,100.00%
ugcapi.baidu.com,2,0.00%,6,4,33.33%
telemetry.sonarsource.com,2,0.00%,2,0,100.00%
odc-dsm01pap007-meta-brs.onedrive.akadns.net,2,0.00%,4,2,50.00%
yanran.li,2,0.00%,2,0,100.00%
dl.ee.cuhk.edu.hk,2,0.00%,2,0,100.00%
it.alljournals.cn,2,0.00%,2,0,100.00%
socket.tidio.co,2,0.00%,2,0,100.00%
bytedance.feishu.cn.w.cdngslb.com,2,0.00%,2,0,100.00%
www.hm.com.cn,2,0.00%,2,0,100.00%
static.hm.com.cn,2,0.00%,2,0,100.00%
yx.applesay.cn,2,0.00%,2,0,100.00%
TRAnSIt1.wSlOG.ChiNAnetCeNtEr.CoM,2,0.00%,2,0,100.00%
clIENTlOGvodp2P.hApLaT.Net,2,0.00%,2,0,100.00%
mamBaP2pvodh5.8686C.COm,2,0.00%,2,0,100.00%
checkpoint-api.hashicorp.com,2,0.00%,2,0,100.00%
static-club.crnccdqx.com,2,0.00%,2,0,100.00%
onehk.btavpn.xyz,2,0.00%,2,0,100.00%
onedriveclubprodbn20021.blob.core.windows.net,2,0.00%,2,0,100.00%
pcweb-v1.log.mgtv.com,2,0.00%,2,0,100.00%
shangji.baidu.com,2,0.00%,4,2,50.00%
kyfw.12306.cn,2,0.00%,2,0,100.00%
j.bd.dhsz.cn.cname2801.yjs-cdn.com,2,0.00%,2,0,100.00%
x2.ifengimg.com,2,0.00%,5,3,40.00%
x0.ifengimg.com,2,0.00%,5,3,40.00%
p1.ifengimg.com,2,0.00%,4,2,50.00%
d.ifengimg.com,2,0.00%,5,3,40.00%
p0.ifengimg.com,2,0.00%,4,2,50.00%
fengcx.com,2,0.00%,2,0,100.00%
lc2.ifengcdn.com,2,0.00%,2,0,100.00%
y1.ifengimg.com,2,0.00%,4,2,50.00%
y0.ifengimg.com,2,0.00%,5,3,40.00%
ins-dwgaq849.ias.tencent-cloud.net,2,0.00%,2,0,100.00%
video.upqzfile.com,2,0.00%,2,0,100.00%
s.ss2.us,2,0.00%,2,0,100.00%
master.2018.alumni.ceinpro.es,2,0.00%,2,0,100.00%
one.funnytube.club,2,0.00%,2,0,100.00%
api.mylord.care,2,0.00%,2,0,100.00%
ip2100177553.funshion.com,2,0.00%,2,0,100.00%
m.ddooo.com,2,0.00%,2,0,100.00%
almbd.1125.cc,2,0.00%,2,0,100.00%
count.ddooo.com,2,0.00%,2,0,100.00%
www.hnltff.com.cn,2,0.00%,2,0,100.00%
yukh.jamaica-doctor.net,2,0.00%,2,0,100.00%
mirror1.hs-esslingen.de,2,0.00%,6,4,33.33%
db.auto.sohu.com,2,0.00%,2,0,100.00%
t.focus-res.cn,2,0.00%,2,0,100.00%
v8boisbmeps4frt52o5sdphgp0a2ilo1dc7okj9ji9tku88gufkvvco6.qc.x.bsgslb.cn,2,0.00%,2,0,100.00%
ci92v53587hgaj4kkuprmgfmudnku5adqpoiakkrd9set7pis89vuol6.qc.x.bsgslb.cn,2,0.00%,2,0,100.00%
apprep.smartscreen.microsoft.com,2,0.00%,2,0,100.00%
verify.zijieapi.com.w.cdngslb.com,2,0.00%,2,0,100.00%
r.email1.sketchfab.com,2,0.00%,2,0,100.00%
faye.getstream.io,2,0.00%,2,0,100.00%
3.au.download.windowsupdate.com,2,0.00%,4,2,50.00%
1608230985.D4EE071FA772.device.hiwifi.com,2,0.00%,2,0,100.00%
www.doxygen.org,2,0.00%,2,0,100.00%
zlib.net,2,0.00%,2,0,100.00%
ynote-dynamic-dispatch.cowork.netease.com,2,0.00%,2,0,100.00%
sentry2.lx.netease.com,2,0.00%,2,0,100.00%
id.kuaishou.com,2,0.00%,2,0,100.00%
passport.kuaishou.com,2,0.00%,2,0,100.00%
verification.kuaishouzt.cn,2,0.00%,2,0,100.00%
cs.map.qq.com,2,0.00%,2,0,100.00%
api.verify.mob.com,2,0.00%,2,0,100.00%
im64.jpush.cn,2,0.00%,2,0,100.00%
ties-cdnqn.52tt.com,2,0.00%,2,0,100.00%
elixir.bootlin.com,2,0.00%,2,0,100.00%
api-fc.dutils.com,2,0.00%,2,0,100.00%
dl17.cudown.com,2,0.00%,2,0,100.00%
api-exc.dutils.com,2,0.00%,2,0,100.00%
dfe.mic.mob.com,2,0.00%,2,0,100.00%
devs-data.dutils.com,2,0.00%,2,0,100.00%
ethtx.info,2,0.00%,2,0,100.00%
img.nvidiagrid.net,2,0.00%,3,1,66.67%
ls.dtrace.nvidia.com,2,0.00%,2,0,100.00%
keystore-explorer.org,2,0.00%,2,0,100.00%
vrlab-image4.ljcdn.com,2,0.00%,4,2,50.00%
image1.ljcdn.com,2,0.00%,4,2,50.00%
454.a93.myftpupload.com,2,0.00%,2,0,100.00%
djqnomyzwkbyb.cloudfront.net,2,0.00%,2,0,100.00%
egw-app.herokuapp.com,2,0.00%,2,0,100.00%
pccw09.graniterapids.com,2,0.00%,2,0,100.00%
filos.corsidia.org,2,0.00%,2,0,100.00%
cdn.d.wanfangdata.com.cn,2,0.00%,2,0,100.00%
cdn.wf.pub,2,0.00%,2,0,100.00%
17hs.17win.com,2,0.00%,2,0,100.00%
web.mit.edu,2,0.00%,4,2,50.00%
riskip.cupid.iqiyi.com,2,0.00%,2,0,100.00%
CLIENtLoGvodP2P.HAplaT.NEt,2,0.00%,2,0,100.00%
traNSiT1.wSLOG.cHInaNeTCEnTer.COM,2,0.00%,2,0,100.00%
MaMBap2Pvodh5.8686C.COm,2,0.00%,2,0,100.00%
boot.net.anydesk.com,2,0.00%,2,0,100.00%
biteables.usabilityhub.com,2,0.00%,2,0,100.00%
gov.sohu.com.dsa.dnsv1.com,2,0.00%,2,0,100.00%
mailh4.message.cmbchina.com,2,0.00%,2,0,100.00%
sspapi.zenyou.71360.com,2,0.00%,2,0,100.00%
i.blog.sina.com.cn,2,0.00%,2,0,100.00%
hs.blog.sina.com.cn,2,0.00%,2,0,100.00%
php.weather.sina.com.cn,2,0.00%,2,0,100.00%
iqs03o8ni40fnhbu1d8cs7udbvn29apgvv8rdsj5eos8cdoq6fifu7sp.qc.x.bsgslb.cn,2,0.00%,2,0,100.00%
dig-sc.bdurl.net,2,0.00%,2,0,100.00%
m704.music.126.net.w.kunluncan.com,2,0.00%,2,0,100.00%
im.evaluateai.cn,2,0.00%,2,0,100.00%
fun.xsdzq.cn,2,0.00%,2,0,100.00%
chat.jd.com,2,0.00%,2,0,100.00%
jdcs.jd.com,2,0.00%,2,0,100.00%
vs.jd.com,2,0.00%,2,0,100.00%
www.mafengwo.cn,2,0.00%,2,0,100.00%
static.mafengwo.net,2,0.00%,2,0,100.00%
98.142.141.184.16clouds.com,2,0.00%,2,0,100.00%
da.qiyukf.com,2,0.00%,3,1,66.67%
njiwx.smoba.qq.com,2,0.00%,2,0,100.00%
p203-imap.mail.icloud.com.cn,2,0.00%,2,0,100.00%
logfiles.zoom.us,2,0.00%,2,0,100.00%
us01-logfiles-va.zoom.us,2,0.00%,2,0,100.00%
cl2-cn.ls-apple.com.akadns.net,2,0.00%,2,0,100.00%
cl2-cn.apple.com.download.ks-cdn.com,2,0.00%,2,0,100.00%
res.popo.163.com,2,0.00%,2,0,100.00%
sigma-popominprogram-popo.proxima.nie.easebar.com,2,0.00%,2,0,100.00%
ghproxy.com,2,0.00%,2,0,100.00%
cLiEntLOgVOdP2p.hapLat.nET,2,0.00%,2,0,100.00%
transiT1.WslOG.chINAneTcENTER.cOm,2,0.00%,2,0,100.00%
MAMbAP2PVodh5.8686c.COm,2,0.00%,2,0,100.00%
ans.oobesaas.adobe.com,2,0.00%,2,0,100.00%
www.iciba.com,2,0.00%,2,0,100.00%
animal-10001882.image.myqcloud.com,2,0.00%,2,0,100.00%
82-65-239-16.subs.proxad.net,2,0.00%,2,0,100.00%
discovery.razerapi.com.edgesuite.net.globalredir.akadns.net,2,0.00%,2,0,100.00%
a1944.cn.w.tl88.net,2,0.00%,2,0,100.00%
pgdt.tc.qq.com,2,0.00%,4,2,50.00%
www.pcpop.com,2,0.00%,2,0,100.00%
product.pcpop.com,2,0.00%,2,0,100.00%
icp.aizhan.com,2,0.00%,2,0,100.00%
sports.sohu.com,2,0.00%,4,2,50.00%
change.qq.com,2,0.00%,2,0,100.00%
comic.le.com,2,0.00%,2,0,100.00%
sz5.tencent.com,2,0.00%,2,0,100.00%
sz8.tencent.com,2,0.00%,2,0,100.00%
sz6.tencent.com,2,0.00%,2,0,100.00%
sz3.tencent.com,2,0.00%,2,0,100.00%
sz7.tencent.com,2,0.00%,2,0,100.00%
sz9.tencent.com,2,0.00%,2,0,100.00%
damp-crag-05667.herokuapp.com,2,0.00%,2,0,100.00%
d2mdw063ttlqtq.cloudfront.net,2,0.00%,2,0,100.00%
rc10-g4.oray.com,2,0.00%,2,0,100.00%
pgdt.mid.tdnsv6.com,2,0.00%,4,2,50.00%
pgdt.gtimg.cn.sched.legopic2-dk.tdnsv6.com,2,0.00%,4,2,50.00%
pgdt.gtimg.cn.sched.legopic2-dk.tdnsv6.com.tpic.vwnti.yrzhcloud.cn,2,0.00%,4,2,50.00%
cs02-pps-drcn.dbankcdn.globalsign.c.cdnhwc1.cn,2,0.00%,2,0,100.00%
home.mcafee.com.akadns.net,2,0.00%,2,0,100.00%
img20.360buyimg.com.gslb.qianxun.com,2,0.00%,2,0,100.00%
img20.360buyimg.com.s.galileo.jcloud-cdn.com,2,0.00%,2,0,100.00%
instruaccess-prod-r53.awscommon.mcafee.com,2,0.00%,2,0,100.00%
ax.itunes.apple.com,2,0.00%,2,0,100.00%
mysmth.net,2,0.00%,2,0,100.00%
reagent.bolean.ca,2,0.00%,2,0,100.00%
opencdnnmtest.jomodns.com,2,0.00%,2,0,100.00%
qingnianhudongli.fang.com,2,0.00%,2,0,100.00%
www.escience.cn,2,0.00%,2,0,100.00%
fdsmonline.px.chaoxing.com,2,0.00%,2,0,100.00%
specialpack.chaoxing.com,2,0.00%,2,0,100.00%
app-staging.corpbdc.com,2,0.00%,2,0,100.00%
app.readable.com,2,0.00%,2,0,100.00%
umdc.aliapp.org,2,0.00%,2,0,100.00%
blade17.london-rack424.nodes.gen4.ninja,2,0.00%,2,0,100.00%
2318174577-server.va.huya.com,2,0.00%,2,0,100.00%
gimg2.baidu.com,2,0.00%,4,2,50.00%
note.yd.chaoxing.com,2,0.00%,2,0,100.00%
ap-web-2.agora.io,2,0.00%,2,0,100.00%
a1-vip6.easecdn.com,2,0.00%,2,0,100.00%
passport2.chaoxing.com,2,0.00%,2,0,100.00%
report-edge.agora.io,2,0.00%,2,0,100.00%
ap3.agora.io,2,0.00%,2,0,100.00%
logservice-rtm.agora.io,2,0.00%,2,0,100.00%
ap2.agora.io,2,0.00%,2,0,100.00%
blob.dm2prdstr04a.store.core.windows.net,2,0.00%,2,0,100.00%
internal-api-space.feishu.cn.bytedns1.com,2,0.00%,2,0,100.00%
internal-api-space.feishu.cn.dsa.dnsv1.com,2,0.00%,2,0,100.00%
cran.rstudio.com,2,0.00%,3,1,66.67%
yasisland-ae.mail.protection.outlook.com,2,0.00%,2,0,100.00%
cLIeNTLogvODP2P.HapLAT.net,2,0.00%,2,0,100.00%
tRAnsiT1.wsLOG.ChInaneTCeNTER.Com,2,0.00%,2,0,100.00%
maMBAp2PvODh5.8686c.com,2,0.00%,2,0,100.00%
CLIenTlOgVodP2P.HApLat.nET,2,0.00%,2,0,100.00%
TrAnsiT1.wSlOg.CHinAnETCeNTeR.com,2,0.00%,2,0,100.00%
MaMbAp2PVODh5.8686c.CoM,2,0.00%,2,0,100.00%
sub.520vpn.cc,2,0.00%,4,2,50.00%
paddlepaddle-org-cn.cdn.bcebos.com,2,0.00%,2,0,100.00%
ai-studio-static-online.cdn.bcebos.com,2,0.00%,2,0,100.00%
rogapi.asus.com,2,0.00%,2,0,100.00%
videoimg.nos-jd.163yun.com,2,0.00%,2,0,100.00%
flv.bn.netease.com,2,0.00%,2,0,100.00%
xdc1.szwego.com,2,0.00%,2,0,100.00%
clIenTLogvOdP2p.hapLAt.nET,2,0.00%,2,0,100.00%
Transit1.WsLoG.cHinANeTCENter.coM,2,0.00%,2,0,100.00%
mAmbaP2PvODH5.8686C.cOm,2,0.00%,2,0,100.00%
hk.vpsfortrojan.ml,2,0.00%,2,0,100.00%
www.ear0.com,2,0.00%,2,0,100.00%
aus.loki.delve.office.com,2,0.00%,2,0,100.00%
v5-lite-a.douyinvod.com,2,0.00%,2,0,100.00%
s3m6.fenxi.com.webcdn.360qhcdn.com,2,0.00%,4,2,50.00%
p211-content.icloud.com.cn,2,0.00%,2,0,100.00%
service-4y7r0fta-1251316161.gz.apigw.tencentcs.com,2,0.00%,2,0,100.00%
packages.cloud.google.com,2,0.00%,2,0,100.00%
index.baidu.com,2,0.00%,2,0,100.00%
cpan-rsync.perl.org,2,0.00%,2,0,100.00%
r0965026.iavs9x.u.avast.com,2,0.00%,4,2,50.00%
qpic.y.qq.com,2,0.00%,5,3,40.00%
r1---sn-ni5eln7s.gvt1.com,2,0.00%,2,0,100.00%
data.hexin.cn,2,0.00%,2,0,100.00%
ozone.10jqka.com.cn,2,0.00%,2,0,100.00%
init.wifishenqi.com,2,0.00%,2,0,100.00%
wifi04.wifishenqi.com,2,0.00%,2,0,100.00%
wsba.wifishenqi.com,2,0.00%,2,0,100.00%
config.wifishenqi.com,2,0.00%,2,0,100.00%
app.wifishenqi.com,2,0.00%,2,0,100.00%
pages.xiaohongshu.com,2,0.00%,4,2,50.00%
web-resource-app.xiaohongshu.com,2,0.00%,2,0,100.00%
rn-resource-app.xiaohongshu.com,2,0.00%,2,0,100.00%
baichuan-sdk.alicdn.com.w.cdngslb.com,2,0.00%,2,0,100.00%
2-courier.sandbox.push.apple.com,2,0.00%,2,0,100.00%
p211-fmf.icloud.com.cn,2,0.00%,2,0,100.00%
cmt3.research.microsoft.com,2,0.00%,2,0,100.00%
contentcenter.dbankcdn.com,2,0.00%,2,0,100.00%
seeds.darwin.kuiniuca.com,2,0.00%,2,0,100.00%
fe-static.xhscdn.com,2,0.00%,2,0,100.00%
CliEntlOgVodP2p.HApLAT.nET,2,0.00%,2,0,100.00%
MAmBaP2pvOdH5.8686c.cOm,2,0.00%,2,0,100.00%
614598b441cae.site.ez2q5.cn,2,0.00%,2,0,100.00%
cloudauth-device.aliyuncs.com,2,0.00%,2,0,100.00%
apm.shziyi.com,2,0.00%,2,0,100.00%
slog-trackingio-com-507b4a1ab4945edf.elb.cn-north-1.amazonaws.com.cn,2,0.00%,2,0,100.00%
xonecn-hotupdatecdn.shziyi.com,2,0.00%,2,0,100.00%
cmscdn.shziyi.com,2,0.00%,2,0,100.00%
xonecn-sh-s4-gateway.shziyi.com,2,0.00%,2,0,100.00%
hijack.baidu.com,2,0.00%,4,2,50.00%
clientapibak.hitun.me,2,0.00%,2,0,100.00%
clientapi.hitun.me,2,0.00%,2,0,100.00%
s3.us-west-2.amazonaws.com,2,0.00%,2,0,100.00%
gb.eastmoney.com,2,0.00%,2,0,100.00%
download.sysdig.com,2,0.00%,2,0,100.00%
www.dealctr.com,2,0.00%,2,0,100.00%
blog.teddyaward.tv,2,0.00%,2,0,100.00%
onedriveclucproddm20046.blob.core.windows.net,2,0.00%,2,0,100.00%
i-dsm01p-cor008.api.p001.1drv.com,2,0.00%,2,0,100.00%
onedriveclucprodbn20047.blob.core.windows.net,2,0.00%,2,0,100.00%
smtp.qiye.163.com,2,0.00%,2,0,100.00%
trANsiT1.wSlOG.CHInanetCenteR.Com,2,0.00%,2,0,100.00%
mamBap2pvOdh5.8686c.cOM,2,0.00%,2,0,100.00%
clIENTLogvoDp2P.hapLat.neT,2,0.00%,2,0,100.00%
xyclient.xyz,2,0.00%,2,0,100.00%
mail.cesssezaworltattslop.tk,2,0.00%,2,0,100.00%
cdn2.jianshu.io,2,0.00%,3,1,66.67%
clientnotification-userprodea1-0.servicebus.windows.net,2,0.00%,2,0,100.00%
yktd.m.cn.miaozhen.com,2,0.00%,2,0,100.00%
china.2022richman.ga,2,0.00%,2,0,100.00%
zb-center-openacs.m.taobao.com.gds.alibabadns.com,2,0.00%,2,0,100.00%
image.uc.cn,2,0.00%,2,0,100.00%
s2.zimgs.cn,2,0.00%,2,0,100.00%
s2.zimgs.cn.w.alikunlun.com,2,0.00%,4,2,50.00%
ggkkmuup9wuugp6ep8d.exp.bcevod.com,2,0.00%,2,0,100.00%
gamedelivery.cdn.bcebos.com,2,0.00%,2,0,100.00%
xfr-ss.getui.com,2,0.00%,2,0,100.00%
repo.fdzh.org,2,0.00%,4,2,50.00%
s6-sync.firefox.com.cn,2,0.00%,2,0,100.00%
brush.dev.safi.ai,2,0.00%,2,0,100.00%
umid.xuexi.cn,2,0.00%,2,0,100.00%
fl.reg.163.com,2,0.00%,2,0,100.00%
goerli-faucet.pk910.de,2,0.00%,2,0,100.00%
cryoexpress.com.sg,2,0.00%,2,0,100.00%
cLiENtlOGvoDP2P.haPLAt.nEt,2,0.00%,2,0,100.00%
MambAp2pVOdh5.8686C.COM,2,0.00%,2,0,100.00%
tRANsiT1.wSloG.ChinanetcenTER.COM,2,0.00%,2,0,100.00%
trAnsit1.wslOG.chinanETCeNTEr.CoM,2,0.00%,2,0,100.00%
MAMBaP2pVoDh5.8686c.COM,2,0.00%,2,0,100.00%
clIentLoGvodp2p.hAPlaT.net,2,0.00%,2,0,100.00%
y.gtimg.cn.tc.qq.com,2,0.00%,2,0,100.00%
p3.douyinpic.com,2,0.00%,4,2,50.00%
p9-webcast.douyinpic.com,2,0.00%,4,2,50.00%
infoc1.duba.net,2,0.00%,2,0,100.00%
tw2.link.ac.cn,2,0.00%,2,0,100.00%
d1bb3j3myu8pmw.cloudfront.net,2,0.00%,2,0,100.00%
pytorch.org,2,0.00%,2,0,100.00%
pmo.nj.iscas.ac.cn,2,0.00%,2,0,100.00%
bd.ihealthcoming.com,2,0.00%,2,0,100.00%
guanzhu.zhibo8.cc,2,0.00%,2,0,100.00%
cache.zhibo8.cc,2,0.00%,2,0,100.00%
rq.upgrade.cloud.duba.net,2,0.00%,2,0,100.00%
mssdk.bytedance.com,2,0.00%,2,0,100.00%
1610340721.D4EE073396E8.device.hiwifi.com,2,0.00%,2,0,100.00%
1610340742.D4EE073396E8.device.hiwifi.com,2,0.00%,2,0,100.00%
1610340764.D4EE073396E8.device.hiwifi.com,2,0.00%,2,0,100.00%
cLIentloGVodP2p.HApLat.net,2,0.00%,2,0,100.00%
TrANSIt1.WSlog.CHINaNeTcenTER.cOm,2,0.00%,2,0,100.00%
p9-pc-sign.douyinpic.com,2,0.00%,4,2,50.00%
p215-imap.mail.icloud.com.cn,2,0.00%,2,0,100.00%
xbroker-z1-i4.ngxcld.com,2,0.00%,2,0,100.00%
mail.rja.work,2,0.00%,2,0,100.00%
mx30.mailspamprotection.com,2,0.00%,2,0,100.00%
apt.releases.hashicorp.com,2,0.00%,4,2,50.00%
conoret.com,2,0.00%,2,0,100.00%
scott.app.claystapp.com,2,0.00%,2,0,100.00%
mirrors.v2raya.org,2,0.00%,4,2,50.00%
m.iwin688.com.tw,2,0.00%,4,2,50.00%
www.tm.a.prd.aadg.trafficmanager.NET,2,0.00%,2,0,100.00%
p09.upd.kaspersky.com,2,0.00%,2,0,100.00%
znsv.baidu.com,2,0.00%,2,0,100.00%
namiut.org,2,0.00%,2,0,100.00%
bluescope.com,2,0.00%,2,0,100.00%
crhm.btbizhi.com,2,0.00%,2,0,100.00%
44.push2.eastmoney.com,2,0.00%,4,2,50.00%
2063722872-server.va.huya.com,2,0.00%,2,0,100.00%
clieNtlOgvodP2P.HaPlAt.NEt,2,0.00%,2,0,100.00%
Mambap2pVOdh5.8686C.coM,2,0.00%,2,0,100.00%
trAnsit1.WsLog.ChINANEtcEntER.CoM,2,0.00%,2,0,100.00%
ClIENtlOGVOdP2P.hapLaT.NEt,2,0.00%,2,0,100.00%
TRANsIT1.wSlog.chINANEtcEnter.Com,2,0.00%,2,0,100.00%
MaMBAp2PVOdH5.8686c.cOM,2,0.00%,2,0,100.00%
www.adrianbulat.com,2,0.00%,2,0,100.00%
p.bixinlive.com,2,0.00%,2,0,100.00%
t.quandangdang.net.wswebpic.com,2,0.00%,2,0,100.00%
www.rhinosafe.com,2,0.00%,2,0,100.00%
www.66vod.com,2,0.00%,2,0,100.00%
www.dygang.cc,2,0.00%,2,0,100.00%
www.hao6v.tv,2,0.00%,2,0,100.00%
www.66e.cc,2,0.00%,2,0,100.00%
www.6vhao.net,2,0.00%,2,0,100.00%
www.omanhua.com,2,0.00%,2,0,100.00%
ip2100177557.funshion.com,2,0.00%,2,0,100.00%
s3m3.fenxi.com,2,0.00%,2,0,100.00%
cpe.iam.af,2,0.00%,2,0,100.00%
igslb.fednet.gov.ae,2,0.00%,2,0,100.00%
b217da3058f4c69e705d4b40a968b540.dlied1.cdntips.net,2,0.00%,2,0,100.00%
c7dcd3b51c8f1f3ef3956212b4cec0a0.dlied1.cdntips.net,2,0.00%,2,0,100.00%
ols.nowcoder.com,2,0.00%,2,0,100.00%
repo.us-west-2.amazonaws.com,2,0.00%,2,0,100.00%
packages.us-west-2.amazonaws.com,2,0.00%,2,0,100.00%
arch.ver.input.officeoncloud.cn,2,0.00%,2,0,100.00%
cdn-pri.nlark.com,2,0.00%,2,0,100.00%
cdn.nlark.com,2,0.00%,2,0,100.00%
g.yuque.com,2,0.00%,2,0,100.00%
p217-content.icloud.com.cn,2,0.00%,2,0,100.00%
smetrics.nvidia.com,2,0.00%,2,0,100.00%
17de4c1f.akstat.io,2,0.00%,4,2,50.00%
res-honeycomb.wpscdn.cn,2,0.00%,2,0,100.00%
online.lewelectrical.co.uk,2,0.00%,2,0,100.00%
lia7nosh.nodedata.net,2,0.00%,2,0,100.00%
rmcsdf.ct.glbs.qunar.com,2,0.00%,2,0,100.00%
time1.aliyun.com,2,0.00%,2,0,100.00%
alt6-mtalk.google.com,2,0.00%,2,0,100.00%
reg.homeway.com.cn,2,0.00%,2,0,100.00%
utrack.homeway.com.cn,2,0.00%,2,0,100.00%
regtool.hexun.com,2,0.00%,2,0,100.00%
imgcd.homeway.com.cn,2,0.00%,2,0,100.00%
jeik8oop.nodedata.net,2,0.00%,2,0,100.00%
twct03.graniterapids.com,2,0.00%,2,0,100.00%
93.push2.eastmoney.com,2,0.00%,3,1,66.67%
events-op-hicloud-com-drcn.appacc.dbankedge.net,2,0.00%,2,0,100.00%
efe-h2.cdn.bcebos.com,2,0.00%,4,2,50.00%
app.gmdaily.cn,2,0.00%,2,0,100.00%
content-static.cctvnews.cctv.com,2,0.00%,2,0,100.00%
help.baidu.com,2,0.00%,2,0,100.00%
music.taihe.com,2,0.00%,2,0,100.00%
jg.awaliwa.com,2,0.00%,2,0,100.00%
v.euqq.cn,2,0.00%,2,0,100.00%
photo28.hexun.com,2,0.00%,2,0,100.00%
risk.homeway.com.cn,2,0.00%,2,0,100.00%
order.homeway.com.cn,2,0.00%,2,0,100.00%
buy.homeway.com.cn,2,0.00%,2,0,100.00%
dkapi.geetest.com,2,0.00%,2,0,100.00%
waws-prod-ch1-001.cloudapp.net,2,0.00%,2,0,100.00%
iosqqdata.ab.qq.com,2,0.00%,2,0,100.00%
music-test.cymini.qq.com,2,0.00%,2,0,100.00%
www.795.com.cn,2,0.00%,2,0,100.00%
pixie.porkbun.com,2,0.00%,2,0,100.00%
mailws.fe.apple-dns.cn,2,0.00%,2,0,100.00%
other.upqzfile.com,2,0.00%,2,0,100.00%
mirrors4.bfsu.edu.cn,2,0.00%,2,0,100.00%
appstoreort-stsdk.vivo.com.cn,2,0.00%,2,0,100.00%
filter.appstore.vivo.com.cn,2,0.00%,2,0,100.00%
ort-stsdk.vivo.com.cn,2,0.00%,2,0,100.00%
main.appstore.vivo.com.cn,2,0.00%,2,0,100.00%
u2-204.ecukwai.com,2,0.00%,2,0,100.00%
p217-imap.mail.icloud.com.cn,2,0.00%,2,0,100.00%
bdcore-apr-lb.bda.ndmdhs.com,2,0.00%,2,0,100.00%
fd0f4bb115295e67537a73136852f676.iflysec.com,2,0.00%,2,0,100.00%
111s1.url.cn.cloud.tc.qq.com,2,0.00%,2,0,100.00%
i.360kan.com,2,0.00%,2,0,100.00%
so.360kan.com.w.kunluncan.com,2,0.00%,2,0,100.00%
stat.blibee.com,2,0.00%,2,0,100.00%
api.blibee.com,2,0.00%,2,0,100.00%
s.blibee.net,2,0.00%,2,0,100.00%
zz.blibee.net,2,0.00%,2,0,100.00%
sensors-tc-api.blibee.com,2,0.00%,2,0,100.00%
extcirrusapi.ins.dell.com,2,0.00%,2,0,100.00%
scholarship.ucas.ac.cn,2,0.00%,2,0,100.00%
dbg.pinyin.sogou.com,2,0.00%,2,0,100.00%
st-relay-v3-univ-srs-win-3502-g3.api.splashtop.com,2,0.00%,2,0,100.00%
cn1b.frdic.com,2,0.00%,2,0,100.00%
heapanalytics.com,2,0.00%,2,0,100.00%
ydlunacommon-cdn.nosdn.127.net,2,0.00%,4,2,50.00%
p28-buy-lb.itunes-apple.com.akadns.net,2,0.00%,2,0,100.00%
asia2.ocws1.live.com.akadns.net,2,0.00%,2,0,100.00%
www.360.cn,2,0.00%,2,0,100.00%
417403759-server.va.huya.com,2,0.00%,2,0,100.00%
download.lenovo.com.edgekey.net.globalredir.akadns.net,2,0.00%,2,0,100.00%
down.qq.mid.dcloudstc.com,2,0.00%,2,0,100.00%
dispacth-cdn.dpvs.kwimgs.com,2,0.00%,2,0,100.00%
appdl-drcn.dbankcdn.com.c.cdnhwc1.com,2,0.00%,2,0,100.00%
forum-api-drcn-jos-dbankcloud-cn-drcn.appacc-region.dbankedge.cn,2,0.00%,2,0,100.00%
shop.taobao.com,2,0.00%,2,0,100.00%
ds-s7.addthis.com.edgekey.net,2,0.00%,2,0,100.00%
mttstr.beacon.qq.com,2,0.00%,2,0,100.00%
mtteve.beacon.qq.com,2,0.00%,2,0,100.00%
b-ring.b-9999.b-msedge.net,2,0.00%,2,0,100.00%
ditu.so.com,2,0.00%,2,0,100.00%
api.map.so.com,2,0.00%,2,0,100.00%
map3.ssl.qhimg.com,2,0.00%,2,0,100.00%
fxsjcj.kaipuyun.cn,2,0.00%,2,0,100.00%
beacon.cdn.qq.com,2,0.00%,2,0,100.00%
wpscb.processon.com,2,0.00%,2,0,100.00%
scanner-06.ch1.censys-scanner.com,2,0.00%,2,0,100.00%
bl6pcor001-com.be.1drv.com,2,0.00%,2,0,100.00%
p212-quota.icloud.com.cn,2,0.00%,2,0,100.00%
wifi.vivo.com.cn,2,0.00%,2,0,100.00%
s8.addthis.com,2,0.00%,2,0,100.00%
www2-www2.bing.com.trafficmanager.net,2,0.00%,2,0,100.00%
static.scp.btoo3.com,2,0.00%,2,0,100.00%
app-cdn.2q10.com,2,0.00%,2,0,100.00%
app-cdn.2q10.com.wswebpic.com,2,0.00%,2,0,100.00%
stocks-data-service.apple.com.edgesuite.net,2,0.00%,4,2,50.00%
iniupdate.360qhcdn.com,2,0.00%,2,0,100.00%
vmss-prod-seas.southeastasia.cloudapp.azure.com,2,0.00%,2,0,100.00%
obs.jielong.co,2,0.00%,2,0,100.00%
cLIENTlogVOdP2P.HAPlAT.Net,2,0.00%,2,0,100.00%
tRaNSIT1.wSLOg.ChINanEtCenTer.coM,2,0.00%,2,0,100.00%
mambap2pvOdh5.8686c.cOM,2,0.00%,2,0,100.00%
game.gtimg.cn,2,0.00%,2,0,100.00%
xzfile.aliyuncs.com,2,0.00%,2,0,100.00%
t1024579.iavs9x.u.avast.com,2,0.00%,4,2,50.00%
h4305360.iavs9x.u.avast.com,2,0.00%,4,2,50.00%
y9830512.vps18.u.avcdn.net,2,0.00%,4,2,50.00%
b7210692.vps18.u.avcdn.net,2,0.00%,4,2,50.00%
n2833777.vps18.u.avcdn.net,2,0.00%,4,2,50.00%
apd-d59eb41d265adc96a2616c48aba8c01a.v.smtcdns.com,2,0.00%,2,0,100.00%
abtest-bd.feishu.cn.w.cdngslb.com,2,0.00%,2,0,100.00%
p209-mailws.icloud.com.cn,2,0.00%,2,0,100.00%
books-analytics-events.apple.com,2,0.00%,2,0,100.00%
ur.alipay.com.danuoyi.tbcache.com,2,0.00%,2,0,100.00%
site.cmbchina.com,2,0.00%,2,0,100.00%
mobappconfig.securities.eastmoney.com.w.kunlunle.com,2,0.00%,2,0,100.00%
1608223785.D4EE071FA772.device.hiwifi.com,2,0.00%,2,0,100.00%
topbooks.com.ua,2,0.00%,2,0,100.00%
ohquoo9h.nodedata.net,2,0.00%,2,0,100.00%
cda6f32740dd50c46dd37df1fefeda8f.dlied1.cdntips.net,2,0.00%,2,0,100.00%
ptlogin2.game.qq.com,2,0.00%,2,0,100.00%
postback.applinzi.com,2,0.00%,2,0,100.00%
down.safe.wegamex.com.hk,2,0.00%,2,0,100.00%
s9bglt9mj7fq5ifbhh3cipv3sdpi8hsj9698734ebe69smnps2uvvcve.qc.x.bsgslb.cn,2,0.00%,2,0,100.00%
hlmri2t85dljh4hai0u8mlj267upaklqroctfnpkqn22v2bde30fu8c8.qc.x.bsgslb.cn,2,0.00%,2,0,100.00%
appoptimize-drcn.dbankcdn.80800000.globalsign.c.cdnhwc1.cn,2,0.00%,2,0,100.00%
connect-drcn-hispace-hicloud-com-drcn.appacc.dbankedge.cn,2,0.00%,2,0,100.00%
contentcenter-drcn-dbankcdn-cn-global.staticcdn.dbankedge.cn,2,0.00%,2,0,100.00%
contentcenter-drcn.dbankcdn.globalsign.c.cdnhwc1.cn,2,0.00%,2,0,100.00%
wa.qq.com.cloud.tc.qq.com,2,0.00%,4,2,50.00%
waqq.mid.tdnsv6.com,2,0.00%,4,2,50.00%
mss0.bdstatic.com.a.bdydns.com,2,0.00%,2,0,100.00%
mbdp03.bdstatic.com.a.bdydns.com,2,0.00%,2,0,100.00%
gh.bdstatic.com.a.jomodns.com,2,0.00%,2,0,100.00%
adash.man.aliyuncs.com.gds.alibabadns.com,2,0.00%,2,0,100.00%
adash-new.man.aliyuncs.com,2,0.00%,2,0,100.00%
adash-new.man.aliyuncs.com.gds.alibabadns.com,2,0.00%,2,0,100.00%
forecast.sina.cn,2,0.00%,2,0,100.00%
ar.umeng.com,2,0.00%,2,0,100.00%
default.wagbridge.umeng.alibabacorp.com,2,0.00%,2,0,100.00%
default.wagbridge.umeng.alibabacorp.com.gds.alibabadns.com,2,0.00%,2,0,100.00%
card.weibo.com,2,0.00%,2,0,100.00%
dfp.informance.biz,2,0.00%,2,0,100.00%
i5.hexun.com,2,0.00%,2,0,100.00%
utrack.hexun.com,2,0.00%,2,0,100.00%
i9.hexun.com,2,0.00%,2,0,100.00%
auto.hexun.com,2,0.00%,2,0,100.00%
h05hxsame.hexun.com,2,0.00%,2,0,100.00%
i1.hexun.com,2,0.00%,2,0,100.00%
shzjwxsns.video.qq.com,2,0.00%,4,2,50.00%
biying.com,2,0.00%,2,0,100.00%
ali-ky.static.yximgs.com,2,0.00%,2,0,100.00%
emiratesnbd-com.mail.protection.outlook.com,2,0.00%,2,0,100.00%
CliENTloGVodp2p.HaplaT.NEt,2,0.00%,2,0,100.00%
TRAnSIT1.WsLOg.cHINanETCenTEr.COm,2,0.00%,2,0,100.00%
MAMbAp2pVoDh5.8686C.Com,2,0.00%,2,0,100.00%
tnc3-bjlgy.zijieapi.com,2,0.00%,2,0,100.00%
saveu5-normal-lf.zijieapi.com,2,0.00%,2,0,100.00%
tnc11-bjlgy.zijieapi.com,2,0.00%,2,0,100.00%
rtlog5-applog-lf.fqnovel.com,2,0.00%,2,0,100.00%
pitaya.bytedance.com,2,0.00%,2,0,100.00%
webcast5-open-lf.douyin.com,2,0.00%,2,0,100.00%
insideruser.trafficmanager.net,2,0.00%,2,0,100.00%
cliENTlOGVoDp2P.HapLaT.nET,2,0.00%,2,0,100.00%
TrANSiT1.wSLoG.chiNAnETcEnTEr.cOm,2,0.00%,2,0,100.00%
r4---sn-ibj-i3be6.gvt1.com,2,0.00%,2,0,100.00%
r2---sn-ni57rn7y.gvt1.com,2,0.00%,2,0,100.00%
gallerysearchapi.micloud.xiaomi.net,2,0.00%,2,0,100.00%
ip3720517254.funshion.com,2,0.00%,2,0,100.00%
drops.dagstuhl.de,2,0.00%,2,0,100.00%
www7b.timegrok.com,2,0.00%,2,0,100.00%
wattisgroup.co.uk,2,0.00%,2,0,100.00%
ns2.esmarthosts.com,2,0.00%,2,0,100.00%
ns1.esmarthosts.com,2,0.00%,2,0,100.00%
mc.ags.msidentity.cn,2,0.00%,2,0,100.00%
skypeecs-prod-usc-2.trafficmanager.net,2,0.00%,2,0,100.00%
catalog-public-service-prod06.ol.epicgames.com,2,0.00%,2,0,100.00%
iqc.us.com,2,0.00%,2,0,100.00%
www.synology.com,2,0.00%,2,0,100.00%
course.ucas.ac.cn,2,0.00%,2,0,100.00%
comment5.news.sina.com.cn,2,0.00%,2,0,100.00%
help.desmos.com,2,0.00%,2,0,100.00%
natcm.iggwebcache.com,2,0.00%,4,2,50.00%
pp2033849174.netvigatorscdn.com,2,0.00%,2,0,100.00%
bnz05pap001files.storage.live.com,2,0.00%,4,2,50.00%
t.y.qq.com,2,0.00%,2,0,100.00%
static3.whatthemovie.net,2,0.00%,2,0,100.00%
a.xinyue.qq.com,2,0.00%,2,0,100.00%
m.xinyue.qq.com,2,0.00%,2,0,100.00%
service-glsyjg07-1252323215.bj.apigw.tencentcs.com,2,0.00%,2,0,100.00%
vpic.cms.qq.com,2,0.00%,2,0,100.00%
vmmp.qpic.cn,2,0.00%,2,0,100.00%
tab.video.qq.com,2,0.00%,2,0,100.00%
mall.video.qq.com,2,0.00%,2,0,100.00%
tRAnSIT1.wslOg.ChiNAnETCenter.cOm,2,0.00%,2,0,100.00%
MaMBAp2PvoDh5.8686C.cOm,2,0.00%,2,0,100.00%
CliENtLOGvOdp2p.HApLAt.Net,2,0.00%,2,0,100.00%
alt1.mobile-gtalk.l.google.com,2,0.00%,4,2,50.00%
alt5-mtalk.google.com,2,0.00%,4,2,50.00%
alt5.mobile-gtalk.l.google.com,2,0.00%,4,2,50.00%
onedriveclubproddm20008.blob.core.windows.net,2,0.00%,2,0,100.00%
syndication.twitter.com,2,0.00%,4,2,50.00%
wileypublishing.sc.omtrdc.net,2,0.00%,2,0,100.00%
admission.amss.ac.cn,2,0.00%,2,0,100.00%
amt.amss.cas.cn,2,0.00%,2,0,100.00%
hcms.amss.ac.cn,2,0.00%,2,0,100.00%
www.cc.ac.cn,2,0.00%,2,0,100.00%
vv.play.ott.video.qq.com,2,0.00%,2,0,100.00%
amp.silkthx.com,2,0.00%,2,0,100.00%
segments-s.msedge.net,2,0.00%,2,0,100.00%
1add796ed0d8e84eb9c6513369f19e8a.clo.footprintdns.com,2,0.00%,2,0,100.00%
client1.analytics.desktopcal.com,2,0.00%,2,0,100.00%
cezar.fc.pl,2,0.00%,2,0,100.00%
only-135631-124-16-139-61.nstool.netease.com,2,0.00%,2,0,100.00%
search5-search-lq.ixigua.com,2,0.00%,2,0,100.00%
ib-lq.snssdk.com,2,0.00%,2,0,100.00%
medusa.dianping.com,2,0.00%,2,0,100.00%
data-sdk-uuid-report.dreport.meituan.net,2,0.00%,2,0,100.00%
bh4d9od16a-1.algolianet.com,2,0.00%,2,0,100.00%
click.meituan.com,2,0.00%,2,0,100.00%
ccpce-cn.consumer.huawei.com,2,0.00%,2,0,100.00%
pasta.esfile.duapps.com,2,0.00%,2,0,100.00%
apimgmttmr17ij3jt5dneg64srod9jevcuajxaoube4brtu9cq.trafficmanager.net,2,0.00%,2,0,100.00%
devcenterapi-westus-01.regional.azure-api.net,2,0.00%,2,0,100.00%
dm3cor005-com.be.1drv.com,2,0.00%,2,0,100.00%
aweme.snssdk.com.xi.zwtianshangm.com,2,0.00%,2,0,100.00%
wea.uc.cn,2,0.00%,2,0,100.00%
cn.stratum.slushpool.com,2,0.00%,2,0,100.00%
pool-fr.supportxmr.com,2,0.00%,2,0,100.00%
xmr.crypto-pool.fr,2,0.00%,2,0,100.00%
download-fun.maj-soul.net,2,0.00%,2,0,100.00%
jsync.m.qq.com,2,0.00%,4,2,50.00%
userinfogw-drcn.cloud.dbankcloud.cn,2,0.00%,2,0,100.00%
only-121090-124-16-139-61.nstool.zhuanzfx.com,2,0.00%,2,0,100.00%
jtlutfkpykdw.phone-delivery.com,2,0.00%,2,0,100.00%
577a47befb676471cf5e2c0e7bb070d3.dlied1.cdntips.net,2,0.00%,2,0,100.00%
quality-cdn.shouji.sogou.com,2,0.00%,2,0,100.00%
a1510.w7.akamai.net,2,0.00%,2,0,100.00%
a1279.g2.akamai.net,2,0.00%,2,0,100.00%
us1.sgateway.link,2,0.00%,2,0,100.00%
vrlab-image2.ljcdn.com,2,0.00%,4,2,50.00%
bda.solunes7.site,2,0.00%,2,0,100.00%
repos.citusdata.com,2,0.00%,4,2,50.00%
sina.lovekimo.com,2,0.00%,2,0,100.00%
mail.quichelscipdycomdia.ga,2,0.00%,2,0,100.00%
scorinator.herokuapp.com,2,0.00%,2,0,100.00%
TRAnsIT1.WSLOg.ChInAnetcENtEr.cOm,2,0.00%,2,0,100.00%
CLIENtlOGvODP2p.hAPLAT.NET,2,0.00%,2,0,100.00%
MaMbap2pvodH5.8686c.cOm,2,0.00%,2,0,100.00%
static.360.cn,2,0.00%,4,2,50.00%
only-111858-159-226-95-72.nstool.laiqukankan.com,2,0.00%,2,0,100.00%
only-476672-159-226-95-72.nstool.netease.com,2,0.00%,2,0,100.00%
p1.ssl.img.360kuai.com,2,0.00%,2,0,100.00%
r6.mo.baidu.com,2,0.00%,2,0,100.00%
p50-escrowproxy.icloud.com.cn,2,0.00%,2,0,100.00%
apiv4-iyes.youku.com,2,0.00%,2,0,100.00%
hiboardng-hicloud-com-drcn.appacc.dbankedge.net,2,0.00%,2,0,100.00%
k58.gslb.ksyuncdn.com,2,0.00%,2,0,100.00%
api.edgeoffer.microsoft.com,2,0.00%,2,0,100.00%
cc-api-teamprojects-ue1.adobe.io,2,0.00%,2,0,100.00%
taxcache.51fapiao.cn,2,0.00%,2,0,100.00%
pro-store-packages.uniontech.com,2,0.00%,2,0,100.00%
cdn-professional-security.chinauos.com,2,0.00%,2,0,100.00%
cdn-update-platform-packages.uniontech.com,2,0.00%,2,0,100.00%
home-store-img.uniontech.com,2,0.00%,2,0,100.00%
cdn-professional-packages.chinauos.com,2,0.00%,2,0,100.00%
linux.profile.pinyin.sogou.com,2,0.00%,2,0,100.00%
account.asus.com,2,0.00%,2,0,100.00%
authnz.mathworks.com,2,0.00%,2,0,100.00%
notifications.mathworks.com,2,0.00%,2,0,100.00%
www.hscbec.com,2,0.00%,2,0,100.00%
p00yivkxqvqw.node.onnets1.com,2,0.00%,2,0,100.00%
kzx.360kan.com,2,0.00%,2,0,100.00%
sdk-log-scdn.yfdts.net,2,0.00%,2,0,100.00%
download.skype.com,2,0.00%,4,2,50.00%
download.skype.com.edgekey.net,2,0.00%,4,2,50.00%
e4707.dspg.akamaiedge.net,2,0.00%,4,2,50.00%
ins-j3fgveac.ias.tencent-cloud.net,2,0.00%,2,0,100.00%
update.omnigroup.com,2,0.00%,2,0,100.00%
servicewechat.com,2,0.00%,2,0,100.00%
185.46.142.88.rev.sfr.net,2,0.00%,2,0,100.00%
pif2.norton.com,2,0.00%,2,0,100.00%
st-v3-univ-srs-win-3502-g3.api.splashtop.com,2,0.00%,2,0,100.00%
aliregistry.oss-cn-hangzhou.aliyuncs.com,2,0.00%,2,0,100.00%
im2.xiaoeknow.com,2,0.00%,2,0,100.00%
conn2-im.xiaoeknow.com,2,0.00%,2,0,100.00%
api.look.360.cn,2,0.00%,2,0,100.00%
crl.kaspersky.com,2,0.00%,2,0,100.00%
ocsp.quovadisoffshore.com,2,0.00%,2,0,100.00%
filedownload.lenovo.com.edgekey.net,2,0.00%,2,0,100.00%
adobelogin-origin.prod.ims.adobejanus.com,2,0.00%,2,0,100.00%
ocsp.quovadisglobal.com,2,0.00%,2,0,100.00%
www.rootca.gov.cn,2,0.00%,2,0,100.00%
ldap.rootca.gov.cn,2,0.00%,2,0,100.00%
puui.qpic.cn-v1.edgesuite.net,2,0.00%,2,0,100.00%
vpic.tc.qq.com,2,0.00%,2,0,100.00%
d.safe.360.cn,2,0.00%,2,0,100.00%
sat02pcor005-com.be.1drv.com,2,0.00%,2,0,100.00%
cdn.odc.officeapps.live.com.edgekey.net,2,0.00%,2,0,100.00%
e12370.g.akamaiedge.net,2,0.00%,2,0,100.00%
tianqi.2345.com,2,0.00%,2,0,100.00%
wwjkjj.caai.cn,2,0.00%,2,0,100.00%
login.taobao.com,2,0.00%,2,0,100.00%
pass.tmall.com,2,0.00%,2,0,100.00%
gtms01.alicdn.com,2,0.00%,2,0,100.00%
opbr2.1plus.io,2,0.00%,2,0,100.00%
ocos-office365-s2s.msedge.net,2,0.00%,2,0,100.00%
ocos-office365-s2s-msedge-net.e-0009.e-msedge.net,2,0.00%,2,0,100.00%
p3-open.byteimg.com.w.cdngslb.com,2,0.00%,2,0,100.00%
xs.wxtv.cc,2,0.00%,2,0,100.00%
p9-sign.douyinpic.com.bsgslb.com,2,0.00%,4,2,50.00%
uz91ipv6pic1.v.bsgslb.com,2,0.00%,4,2,50.00%
p1-open.byteimg.com,2,0.00%,4,2,50.00%
p1-open.byteimg.com.wsglb0.com,2,0.00%,4,2,50.00%
o2o.api.xiaomi.com,2,0.00%,2,0,100.00%
syzs.qq.com,2,0.00%,2,0,100.00%
img-x.jd.com,2,0.00%,2,0,100.00%
img-x.jd.com.gslb.qianxun.com,2,0.00%,2,0,100.00%
open-hl.toutiao.com,2,0.00%,2,0,100.00%
open-hl.toutiao.com.bytedns1.com,2,0.00%,2,0,100.00%
open-hl.toutiao.com.w.cdngslb.com,2,0.00%,2,0,100.00%
bbce2345d7772b06.jijifun.com,2,0.00%,2,0,100.00%
edr-project.cn-beijing.log.aliyuncs.com,2,0.00%,2,0,100.00%
244.160.209.35.bc.googleusercontent.com,2,0.00%,2,0,100.00%
copilot-telemetry.githubusercontent.com,2,0.00%,2,0,100.00%
o2.norton.com,2,0.00%,2,0,100.00%
ssh.github.com,2,0.00%,2,0,100.00%
sh.wagbridge.1688.com.gds.alibabadns.com,2,0.00%,2,0,100.00%
bgp.g0.cn.slb.xiaomi.com,2,0.00%,2,0,100.00%
fgb0.market.xiaomi.com.w.cdngslb.com,2,0.00%,2,0,100.00%
nileapi.market.xiaomi.com,2,0.00%,2,0,100.00%
alilang-unify-struct-log.cn-hangzhou.log.aliyuncs.com,2,0.00%,2,0,100.00%
eun-2.config.skype.com,2,0.00%,2,0,100.00%
developer.wordpress.org,2,0.00%,2,0,100.00%
auth-alilang.alibaba-inc.com,2,0.00%,2,0,100.00%
outside.proxy.alibaba-inc.com,2,0.00%,2,0,100.00%
s-api.alibaba-inc.com,2,0.00%,2,0,100.00%
aip-proxy-outside-zb-alibabainc.alibaba-inc.com,2,0.00%,2,0,100.00%
it-sp.alibaba-inc.com,2,0.00%,2,0,100.00%
alilang-intranet.alibaba-inc.com,2,0.00%,2,0,100.00%
aip-proxy-inside-zb.alibaba-inc.com,2,0.00%,2,0,100.00%
retcode.taobao.com.gds.alibabadns.com,2,0.00%,2,0,100.00%
et15-na61-na62.wagbridge.alibaba.taobao.com,2,0.00%,2,0,100.00%
phx02pcor003-com.be.1drv.com,2,0.00%,2,0,100.00%
github-production-user-asset-6210df.s3.amazonaws.com,2,0.00%,2,0,100.00%
p31yuan2.tc.qq.com,2,0.00%,2,0,100.00%
3gimg.qq.com.sched.legopic2.tdnsv6.com,2,0.00%,2,0,100.00%
aa7727d0e20040a1893e3f544e7047ec.fp.measure.office.com,2,0.00%,2,0,100.00%
xml.realtime-bid.com,2,0.00%,2,0,100.00%
pop.163.com,2,0.00%,2,0,100.00%
hcdnv.zjtd02.gslb.c.cdnhwc2.com,2,0.00%,2,0,100.00%
img107718022.file.onnets1.net,2,0.00%,2,0,100.00%
node107718022.api.steamgamepowered.com,2,0.00%,2,0,100.00%
jsU400331093136.edge.huawei-static.com,2,0.00%,2,0,100.00%
jpgithub.edgehelper.com,2,0.00%,2,0,100.00%
tw2.iggfastweb.com,2,0.00%,2,0,100.00%
asia.edgehelper.com,2,0.00%,2,0,100.00%
us.hw-dns.com,2,0.00%,2,0,100.00%
tw3.iggfastweb.com,2,0.00%,2,0,100.00%
sg2.edgehelper.com,2,0.00%,2,0,100.00%
ca1.iggfastweb.com,2,0.00%,2,0,100.00%
au.iggfastweb.com,2,0.00%,2,0,100.00%
www.x-mol.com,2,0.00%,2,0,100.00%
static.x-mol.com,2,0.00%,2,0,100.00%
xpic.x-mol.com,2,0.00%,2,0,100.00%
hlth.io.mi.com,2,0.00%,2,0,100.00%
static.hetaousercontent.com,2,0.00%,2,0,100.00%
report.syzs.qq.com,2,0.00%,2,0,100.00%
jslog.jss.com.cn,2,0.00%,2,0,100.00%
www.echatsoft.com,2,0.00%,2,0,100.00%
www.51miz.com,2,0.00%,2,0,100.00%
3m.mediav.com,2,0.00%,2,0,100.00%
lawyer.110.com,2,0.00%,2,0,100.00%
images.110.com,2,0.00%,2,0,100.00%
v2.jiathis.com,2,0.00%,2,0,100.00%
p.tanx.com,2,0.00%,2,0,100.00%
www-stream.2345cdn.net,2,0.00%,2,0,100.00%
dhrest-static.2345.com,2,0.00%,2,0,100.00%
index-api.2345.com,2,0.00%,2,0,100.00%
imgcdn.toutiaoyule.com,2,0.00%,2,0,100.00%
image1.huabianyl.com,2,0.00%,2,0,100.00%
support.wdc.com,2,0.00%,2,0,100.00%
cdke.youdao.com,2,0.00%,2,0,100.00%
impservice.dictapp.youdao.com,2,0.00%,2,0,100.00%
steambroadcast.akamaized.net,2,0.00%,2,0,100.00%
sctauditing-pa.googleapis.com,2,0.00%,2,0,100.00%
p63-caldav.icloud.com.cn,2,0.00%,2,0,100.00%
TRanSIt1.wslOg.ChinanEtcenTeR.cOM,2,0.00%,2,0,100.00%
ClIeNTLoGVoDp2p.haPLAt.Net,2,0.00%,2,0,100.00%
mAMbAP2PVOdh5.8686c.coM,2,0.00%,2,0,100.00%
ssuresupply.austin.hp.com,2,0.00%,2,0,100.00%
wh3prod.whprod.caaws.services,2,0.00%,2,0,100.00%
ClienTLoGvodP2p.hAPLaT.NeT,2,0.00%,2,0,100.00%
trAnsiT1.WSLoG.ChINaneTCEnTeR.coM,2,0.00%,2,0,100.00%
MaMbAP2pvodH5.8686c.cOM,2,0.00%,2,0,100.00%
v1.browser.360.cn,2,0.00%,2,0,100.00%
ssp.vivo.com.cn,2,0.00%,2,0,100.00%
mkt.zycg.gov.cn,2,0.00%,2,0,100.00%
guocai-prod.s3.cn-north-1.jdcloud-oss.com,2,0.00%,2,0,100.00%
guocai-prod.oss.cn-north-1.jcloudcs.com,2,0.00%,2,0,100.00%
oss.tlwok.com,2,0.00%,2,0,100.00%
imgs.skuyun.com,2,0.00%,2,0,100.00%
img.comix.com.cn,2,0.00%,2,0,100.00%
zhbuy.s3.cn-north-1.jdcloud-oss.com,2,0.00%,2,0,100.00%
resource.donvv.com,2,0.00%,2,0,100.00%
meeting.mof.gov.cn,2,0.00%,2,0,100.00%
s22.cnzz.com,2,0.00%,2,0,100.00%
www.firefox.com.cn,2,0.00%,4,2,50.00%
api.steamapis.com,2,0.00%,2,0,100.00%
api.wolai.com,2,0.00%,2,0,100.00%
cs.emxdgt.com,2,0.00%,2,0,100.00%
providers.gitrak.com,2,0.00%,2,0,100.00%
mbdcdn.bdstatic.com,2,0.00%,2,0,100.00%
qm-h3.baidu.com,2,0.00%,2,0,100.00%
h2mbd.baidu.com,2,0.00%,2,0,100.00%
pimlog.baidu.com,2,0.00%,2,0,100.00%
spcbj.cdn.bcebos.com,2,0.00%,2,0,100.00%
sptest.baidu.com,2,0.00%,2,0,100.00%
pms-cdn.bdstatic.com,2,0.00%,2,0,100.00%
userident.baidu.com,2,0.00%,2,0,100.00%
data.bytedance.com,2,0.00%,2,0,100.00%
zhishubao.1234567.com.cn,2,0.00%,4,2,50.00%
dove.xueqiu.com,2,0.00%,2,0,100.00%
xqsj.gjzq.com.cn,2,0.00%,2,0,100.00%
alt8-mtalk.google.com,2,0.00%,2,0,100.00%
qs.shouji.sogou.com,2,0.00%,2,0,100.00%
jy.xzsec.com,2,0.00%,2,0,100.00%
e2c12.gcp.gvt2.com,2,0.00%,2,0,100.00%
im-linkserver-76.csdn.net,2,0.00%,2,0,100.00%
ns-sc4.proofpoint.us,2,0.00%,4,2,50.00%
dssedc4qxg7o6.cloudfront.net,2,0.00%,2,0,100.00%
checkport.synology.com,2,0.00%,2,0,100.00%
pkgupdate.synology.com,2,0.00%,2,0,100.00%
pkgautoupdate.synology.cn,2,0.00%,2,0,100.00%
c0.ifengimg.com,2,0.00%,2,0,100.00%
dolphin.deliver.ifeng.com,2,0.00%,2,0,100.00%
dol.deliver.ifeng.com,2,0.00%,2,0,100.00%
fund.xueqiu.com,2,0.00%,2,0,100.00%
count.eijs.top,2,0.00%,2,0,100.00%
www.ioffershow.com,2,0.00%,2,0,100.00%
userinfo.user.kugou.com,2,0.00%,2,0,100.00%
media.store.kugou.com,2,0.00%,2,0,100.00%
trackercdnbj.kugou.com,2,0.00%,2,0,100.00%
api.gorouter.info,2,0.00%,2,0,100.00%
s.vconf.f.360.cn,2,0.00%,2,0,100.00%
liveupdate01s.asus.com,2,0.00%,2,0,100.00%
gentle-reef-2837.herokuapp.com,2,0.00%,2,0,100.00%
zgovweb.v.bsclink.cn,2,0.00%,4,2,50.00%
www.moj.gov.cn.w.alikunlun.com,2,0.00%,4,2,50.00%
hhgh9tcf.sched.sma-dk.tdnsstic1.cn,2,0.00%,4,2,50.00%
www.mnr.gov.cn.wswebcdn.com,2,0.00%,4,2,50.00%
zgovweb.v.trpcdn.net,2,0.00%,4,2,50.00%
zgovweb.v.dolfincdnx.com,2,0.00%,4,2,50.00%
uportipv6.v.trpcdn.net,2,0.00%,4,2,50.00%
zmoegovweb.cache.dbappwaf.cn,2,0.00%,4,2,50.00%
upload.wikimedia.ahau.cf,2,0.00%,2,0,100.00%
login.wikimedia.ahau.cf,2,0.00%,2,0,100.00%
meta.wikimedia.ahau.cf,2,0.00%,2,0,100.00%
crsonline.kugou.com,2,0.00%,2,0,100.00%
mAmBaP2PVODh5.8686c.cOm,2,0.00%,2,0,100.00%
CLientLogVodp2p.hapLAT.nET,2,0.00%,2,0,100.00%
TrAnsIT1.WslOg.cHINaNEtCenTER.Com,2,0.00%,2,0,100.00%
m.lmgdkj.com,2,0.00%,2,0,100.00%
tune.shopping.penalty.ml,2,0.00%,2,0,100.00%
gtm-cn-v0h17upzy07.frdic.com,2,0.00%,2,0,100.00%
www.cambridge.org,2,0.00%,2,0,100.00%
static.cambridge.org,2,0.00%,2,0,100.00%
bbs.pku.edu.cn,2,0.00%,2,0,100.00%
assets.cambridge.org,2,0.00%,2,0,100.00%
assets.bop.cupeng.org,2,0.00%,2,0,100.00%
login.www.cambridge.org,2,0.00%,2,0,100.00%
266509774928.gigya-api.com,2,0.00%,2,0,100.00%
c6e3ffd89ebddf1c990b23dede85d91e.dlied1.cdntips.net,2,0.00%,2,0,100.00%
www.meijutt.net,2,0.00%,2,0,100.00%
pengtu.cc,2,0.00%,4,2,50.00%
www.guangsujx.com,2,0.00%,2,0,100.00%
payc.m.jd.com,2,0.00%,4,2,50.00%
jelly-android-bi.cliapi.microfun.cn,2,0.00%,2,0,100.00%
p50-fmip.icloud.com.cn,2,0.00%,2,0,100.00%
p123-fmipmobile.icloud.com.cn,2,0.00%,2,0,100.00%
rtlog5-applog-lq.fqnovel.com,2,0.00%,2,0,100.00%
rtlog5-applog-lq.fqnovel.com.c.dsa.cdnbuild.net,2,0.00%,2,0,100.00%
ad.appier.net,2,0.00%,2,0,100.00%
jp1-bid.adsrvr.org,2,0.00%,2,0,100.00%
eb2.3lift.com,2,0.00%,2,0,100.00%
tlx.3lift.com,2,0.00%,2,0,100.00%
pos2test.oneminorder.com,2,0.00%,2,0,100.00%
img.byzng.xyz,2,0.00%,2,0,100.00%
ea.sangfor.com,2,0.00%,2,0,100.00%
jspassport.ssl.qhimg.com.qh-cdn.com,2,0.00%,2,0,100.00%
mp.music.163.com,2,0.00%,2,0,100.00%
mp.music.163.com.163jiasu.com,2,0.00%,2,0,100.00%
p5.music.126.net,2,0.00%,4,2,50.00%
f77e7fca4e7ad9e2.cname.365cyd.cn,2,0.00%,2,0,100.00%
weiyoh2u.nodedata.net,2,0.00%,2,0,100.00%
waws-prod-hk1-007.sip.azurewebsites.windows.net,2,0.00%,2,0,100.00%
skdisplay.jd.com,2,0.00%,2,0,100.00%
h5hosting-dbankcdn-com-global.staticcdn.dbankedge.net,2,0.00%,2,0,100.00%
h5hosting.dbankcdn.com.a.bdydns.com,2,0.00%,2,0,100.00%
lapi.jd.com.gslb.qianxun.com,2,0.00%,2,0,100.00%
nj.h.bcsp2p.baidu.com,2,0.00%,2,0,100.00%
highlight-video.cdn.bcebos.com,2,0.00%,2,0,100.00%
wu.cmgos.com,2,0.00%,2,0,100.00%
apph54q6wxm2326.h5.xiaoeknow.com,2,0.00%,2,0,100.00%
static-resource.xiaoeknow.com,2,0.00%,2,0,100.00%
sdk.xiaoeknow.com,2,0.00%,2,0,100.00%
commonlib.cdn.xiaoeknow.com,2,0.00%,2,0,100.00%
commonresource-1252524126.cdn.xiaoeknow.com,2,0.00%,2,0,100.00%
static-cdn.xiaoeknow.com,2,0.00%,2,0,100.00%
h5-common-sdk.xiaoeknow.com,2,0.00%,2,0,100.00%
wechatapppro-1252524126.file.myqcloud.com,2,0.00%,2,0,100.00%
xiaoetong-1252524126.file.myqcloud.com,2,0.00%,2,0,100.00%
encrypt-k-vod.xet.tech,2,0.00%,2,0,100.00%
wechatapppro-1252524126.cdn.xiaoeknow.com,2,0.00%,2,0,100.00%
littleclockproduct-1252524126.cdn.xiaoeknow.com,2,0.00%,2,0,100.00%
wechatavator-1252524126.cdn.xiaoeknow.com,2,0.00%,2,0,100.00%
report.h5.xeknow.com,2,0.00%,2,0,100.00%
signal.hitv.com,2,0.00%,2,0,100.00%
ngabbs.com,2,0.00%,2,0,100.00%
ngabbs.com.wswebcdn.com,2,0.00%,2,0,100.00%
3ad01dfa4.sched.d0.tdnsdp1.cn,2,0.00%,2,0,100.00%
us04xmpp1.zoom.us,2,0.00%,2,0,100.00%
us04xmpp1-test.zoom.us,2,0.00%,2,0,100.00%
us04xmpp1-xsr.zoom.us,2,0.00%,2,0,100.00%
dealer.yiche.com,2,0.00%,4,2,50.00%
img4.bitauto.com,2,0.00%,4,2,50.00%
image.bitautoimg.com,2,0.00%,3,1,66.67%
img1.bitautoimg.com,2,0.00%,3,1,66.67%
image.bitauto.com,2,0.00%,4,2,50.00%
img2.bitautoimg.com,2,0.00%,4,2,50.00%
epbf.bitautoimg.com,2,0.00%,3,1,66.67%
log.bitauto.com,2,0.00%,4,2,50.00%
maponline2.bdimg.com.a.bdydns.com,2,0.00%,3,1,66.67%
maponline1.bdimg.com.a.bdydns.com,2,0.00%,3,1,66.67%
maponline3.bdimg.com.a.bdydns.com,2,0.00%,3,1,66.67%
maponline0.bdimg.com.a.bdydns.com,2,0.00%,3,1,66.67%
www.bitauto.com,2,0.00%,4,2,50.00%
www.yiche.com,2,0.00%,4,2,50.00%
www.tablesgenerator.com,2,0.00%,2,0,100.00%
emis.icm.edu.pl,2,0.00%,2,0,100.00%
jdimg.300hu.com,2,0.00%,2,0,100.00%
api.ffnews.cn,2,0.00%,2,0,100.00%
cos.ffnews.cn,2,0.00%,2,0,100.00%
filetranscode-1252524126.file.myqcloud.com,2,0.00%,2,0,100.00%
safeurl6.maxthon.cn,2,0.00%,2,0,100.00%
xet.tech.sched.vp.tdnsv5.com,2,0.00%,2,0,100.00%
widget.us.criteo.com,2,0.00%,2,0,100.00%
sslwidget.criteo.com,2,0.00%,2,0,100.00%
r.casalemedia.com,2,0.00%,2,0,100.00%
sync.outbrain.com,2,0.00%,2,0,100.00%
match.sharethrough.com,2,0.00%,2,0,100.00%
simage2v2.pubmnet.com,2,0.00%,2,0,100.00%
ice.360yield.com,2,0.00%,2,0,100.00%
prod.ups-ats.aolp-ds-prd.aws.oath.cloud,2,0.00%,2,0,100.00%
match-ap-southeast-1-ecs.sharethrough.com,2,0.00%,2,0,100.00%
alldcs.outbrain.org,2,0.00%,2,0,100.00%
dis.criteo.com,2,0.00%,2,0,100.00%
tags.bluekai.com.edgekey.net,2,0.00%,2,0,100.00%
rtb-csync-geo.usersync-prod-sas.akadns.net,2,0.00%,2,0,100.00%
sync-t1.taboola.com,2,0.00%,2,0,100.00%
hk-sync.taboola.com,2,0.00%,2,0,100.00%
criteo-sync.teads.tv,2,0.00%,2,0,100.00%
ad.yieldlab.net,2,0.00%,2,0,100.00%
criteo-sync.teads.tv.edgekey.net,2,0.00%,2,0,100.00%
adgen.socdm.com,2,0.00%,2,0,100.00%
tg.socdm.com,2,0.00%,2,0,100.00%
yieldlab.net.edgekey.net,2,0.00%,2,0,100.00%
e3120.g.akamaiedge.net,2,0.00%,2,0,100.00%
e9957.e4.akamaiedge.net,2,0.00%,2,0,100.00%
adx.dable.io,2,0.00%,2,0,100.00%
ip1.ads.stickyadstv.com.akadns.net,2,0.00%,2,0,100.00%
ip2.ads.stickyadstv.com.akadns.net,2,0.00%,2,0,100.00%
ads.stickyadstv.com.edgesuite.net,2,0.00%,2,0,100.00%
www.google.co.jp,2,0.00%,4,2,50.00%
com-utorrent-prod-bench-bt-vpc-868333863.us-east-1.elb.amazonaws.com,2,0.00%,2,0,100.00%
beta-api.m.jd.com,2,0.00%,2,0,100.00%
rsc.jd.com,2,0.00%,2,0,100.00%
watchtower-logger.jd.com,2,0.00%,2,0,100.00%
wap.sciencenet.cn,2,0.00%,2,0,100.00%
www.chinapostdoctor.org.cn,2,0.00%,2,0,100.00%
apifc.flash.cn,2,0.00%,2,0,100.00%
apifcv2.flash.cn,2,0.00%,2,0,100.00%
www.amwaynet.com.cn,2,0.00%,2,0,100.00%
www.baiduyiyi.com,2,0.00%,2,0,100.00%
mapi.alipay.com,2,0.00%,2,0,100.00%
dl.liebao.cn,2,0.00%,2,0,100.00%
a.alipayobjects.com,2,0.00%,2,0,100.00%
show-f.mediav.com,2,0.00%,2,0,100.00%
soft.flash.cn,2,0.00%,2,0,100.00%
static.ffzww.com,2,0.00%,2,0,100.00%
www.linkedin.cn,2,0.00%,2,0,100.00%
ogs.google.co.jp,2,0.00%,4,2,50.00%
docs.scipy.org,2,0.00%,2,0,100.00%
publift-d.openx.net,2,0.00%,2,0,100.00%
myivc.jd.com,2,0.00%,2,0,100.00%
einvoice.jd.com,2,0.00%,2,0,100.00%
onedriveclubproddm20009.blob.core.windows.net,2,0.00%,2,0,100.00%
downssb.cdn.bcebos.com,2,0.00%,2,0,100.00%
office14client.microsoft.com,2,0.00%,2,0,100.00%
www.acdsee.cn,2,0.00%,2,0,100.00%
pcashier.jd.com,2,0.00%,2,0,100.00%
idt.jd.com,2,0.00%,2,0,100.00%
2008mail.sina.com.cn,2,0.00%,2,0,100.00%
nsp-hicloud-cloudphotoeast3-p02-drcn.obs.cn-east-3.myhuaweicloud.com,2,0.00%,2,0,100.00%
p5.d.meituan.net,2,0.00%,2,0,100.00%
cidzxpc.dfxwdc.com,2,0.00%,2,0,100.00%
unionstatis.dfxwdc.com,2,0.00%,2,0,100.00%
zsrp.admamax.com,2,0.00%,2,0,100.00%
pcunionreportlog.dfxwdc.com,2,0.00%,2,0,100.00%
zsrp02.admamax.com,2,0.00%,2,0,100.00%
zsrp03.admamax.com,2,0.00%,2,0,100.00%
zsrp01.admamax.com,2,0.00%,2,0,100.00%
jprp.admamax.com,2,0.00%,2,0,100.00%
jprp03.admamax.com,2,0.00%,2,0,100.00%
jprp02.admamax.com,2,0.00%,2,0,100.00%
s45.astd.6711.com,2,0.00%,2,0,100.00%
tp.9377s.com,2,0.00%,2,0,100.00%
static.9377ja.com,2,0.00%,2,0,100.00%
hisearch-static-drcn.dbankcdn.com,2,0.00%,2,0,100.00%
events.op.hicloud.com,2,0.00%,2,0,100.00%
slapi-pro.oray.net,2,0.00%,2,0,100.00%
stream.snssdk.com.w.cdngslb.com,2,0.00%,2,0,100.00%
stat.dongqiudi.com,2,0.00%,2,0,100.00%
cn-n1-app-router.leancloud.cn,2,0.00%,2,0,100.00%
s.apkevery.com,2,0.00%,2,0,100.00%
openmobile.qq.com,2,0.00%,2,0,100.00%
pcstatbak.kugou.com,2,0.00%,2,0,100.00%
ll.download3.utorrent.com,2,0.00%,4,2,50.00%
kv801.prod.do.dsp.mp.microsoft.com.edgekey.net,2,0.00%,2,0,100.00%
p13.d.meituan.net,2,0.00%,2,0,100.00%
config.xcast.qq.com,2,0.00%,2,0,100.00%
connectivitycheck-backup.platform.hihonorcloud.com,2,0.00%,2,0,100.00%
xz.tingmall.com,2,0.00%,2,0,100.00%
h5vv.video.qq.com,2,0.00%,2,0,100.00%
mobads-logs.baidu.com,2,0.00%,2,0,100.00%
web.im.weibo.com,2,0.00%,2,0,100.00%
hk4e-api-static.mihoyo.com,2,0.00%,2,0,100.00%
uploadstatic.mihoyo.com,2,0.00%,2,0,100.00%
moblie-ex.log.mgtv.com,2,0.00%,2,0,100.00%
m.bilibili.com,2,0.00%,2,0,100.00%
res2.wx.qq.com,2,0.00%,2,0,100.00%
CLIeNtLoGVODp2P.hAPLat.nEt,2,0.00%,2,0,100.00%
TRAnsit1.wSloG.CHiNANeTCeNTeR.com,2,0.00%,2,0,100.00%
ow1.res.office365.com.edgekey.net,2,0.00%,2,0,100.00%
recv.egovsum.com,2,0.00%,2,0,100.00%
dynamicf.sankuai.com,2,0.00%,2,0,100.00%
datacollection.uve.weibo.com,2,0.00%,2,0,100.00%
a1.alibabausercontent.com,2,0.00%,2,0,100.00%
lemon.baidu.com,2,0.00%,2,0,100.00%
lemonpro.cdn.bcebos.com,2,0.00%,2,0,100.00%
www.csa.iisc.ac.in,2,0.00%,2,0,100.00%
galleryfaceapi.micloud.xiaomi.net,2,0.00%,2,0,100.00%
event.clientgear.com,2,0.00%,2,0,100.00%
cm.ambientdsp.com,2,0.00%,2,0,100.00%
ipac.ctnsnet.com,2,0.00%,2,0,100.00%
ads.playground.xyz,2,0.00%,2,0,100.00%
core.iprom.net,2,0.00%,2,0,100.00%
www.51ste.com,2,0.00%,2,0,100.00%
s.chaojizhu.cn,2,0.00%,2,0,100.00%
js.users.51.la,2,0.00%,2,0,100.00%
tongji.zhibo8.cc,2,0.00%,2,0,100.00%
morette.sheethub.co,2,0.00%,2,0,100.00%
www.weixueyuan.net,2,0.00%,2,0,100.00%
wjz-cdn.baidu.com,2,0.00%,2,0,100.00%
duzhanread.cdn.bcebos.com,2,0.00%,2,0,100.00%
img.zuoyebang.cc,2,0.00%,2,0,100.00%
jwo.vip51quan.com,2,0.00%,2,0,100.00%
kmh5js1.yiyeyu.top,2,0.00%,2,0,100.00%
kmu.kbtseg.xyz,2,0.00%,2,0,100.00%
apt.yjxyjt.com,2,0.00%,2,0,100.00%
m.zjkweiqi.cn,2,0.00%,2,0,100.00%
www.zjkweiqi.cn,2,0.00%,2,0,100.00%
js1.te5.com,2,0.00%,2,0,100.00%
js-1.18183.com,2,0.00%,2,0,100.00%
sdk.dapengyh.com,2,0.00%,2,0,100.00%
phk.nmkstcrt.xyz,2,0.00%,2,0,100.00%
cms.analytics.yahoo.com,2,0.00%,2,0,100.00%
gnt.kjnmwr.xyz,2,0.00%,2,0,100.00%
youpei655ys.xyz,2,0.00%,2,0,100.00%
kbt.hgjxp.cn,2,0.00%,2,0,100.00%
decree.xecloud.cc,2,0.00%,2,0,100.00%
i.liadm.com,2,0.00%,2,0,100.00%
brt.studylabs.cn,2,0.00%,2,0,100.00%
hnr.gscatk.cn,2,0.00%,2,0,100.00%
yasuo.stat.360safe.com,2,0.00%,2,0,100.00%
btf-analytics.s3.dualstack.us-east-1.amazonaws.com,2,0.00%,2,0,100.00%
passport3.wmsh.cf,2,0.00%,2,0,100.00%
www.speedtest.net,2,0.00%,2,0,100.00%
www.tigera.io,2,0.00%,2,0,100.00%
go.tigera.io,2,0.00%,2,0,100.00%
www.easysol.net,2,0.00%,2,0,100.00%
7s9es4t8.emltrk.com,2,0.00%,2,0,100.00%
storage.pardot.com,2,0.00%,4,2,50.00%
create.quest.juntoteam.com,2,0.00%,2,0,100.00%
mermaid.ximalaya.com,2,0.00%,2,0,100.00%
m.data.mob.com,2,0.00%,2,0,100.00%
gslbtx.ximalaya.com,2,0.00%,2,0,100.00%
adse.ximalaya.com,2,0.00%,2,0,100.00%
xdcs-collector.ximalaya.com,2,0.00%,2,0,100.00%
imagev2.tx.xmcdn.com,2,0.00%,2,0,100.00%
xuid-server.ximalaya.com,2,0.00%,2,0,100.00%
irs01.com,2,0.00%,2,0,100.00%
wwcdn.weixin.qq.com.sched.legopic1.tdnsv6.com,2,0.00%,2,0,100.00%
midas.gtimg.cn,2,0.00%,2,0,100.00%
ab.lianjia.com,2,0.00%,2,0,100.00%
ab.ke.com,2,0.00%,2,0,100.00%
i-shadow2.ke.com,2,0.00%,2,0,100.00%
ws-clong-api.ke.com,2,0.00%,2,0,100.00%
dynamic-ui.ke.com,2,0.00%,2,0,100.00%
app-profile.ke.com,2,0.00%,2,0,100.00%
usercenter.api.ke.com,2,0.00%,2,0,100.00%
behavior.ke.com,2,0.00%,2,0,100.00%
pushapi.ke.com,2,0.00%,2,0,100.00%
im.api.ke.com,2,0.00%,2,0,100.00%
nt2.ele.me,2,0.00%,2,0,100.00%
shopping.ele.me,2,0.00%,2,0,100.00%
openacs.m.taobao.com,2,0.00%,2,0,100.00%
nbsdk-baichuan.taobao.com,2,0.00%,2,0,100.00%
mtop.ele.me,2,0.00%,2,0,100.00%
app-gateway-realsee.ke.com,2,0.00%,2,0,100.00%
sgm-static.jd.com,2,0.00%,2,0,100.00%
izw-medienarchiv.baw.de,2,0.00%,2,0,100.00%
asia4.akam.net,2,0.00%,2,0,100.00%
clieNtlogvOdP2P.hAPlat.NeT,2,0.00%,2,0,100.00%
TrAnsit1.WSloG.ChInaNEtcEnTER.Com,2,0.00%,2,0,100.00%
mAMbaP2PVodh5.8686C.Com,2,0.00%,2,0,100.00%
skdg.ke.com,2,0.00%,2,0,100.00%
tongs.ke.com,2,0.00%,2,0,100.00%
auth.10jqka.com.cn,2,0.00%,2,0,100.00%
blog.10jqka.com.cn,2,0.00%,2,0,100.00%
xfer.10jqka.com.cn,2,0.00%,2,0,100.00%
www.10jqka.com.cn,2,0.00%,2,0,100.00%
task.10jqka.com.cn,2,0.00%,2,0,100.00%
zx.10jqka.com.cn,2,0.00%,2,0,100.00%
i.thsi.cn,2,0.00%,2,0,100.00%
tradesafe.10jqka.com.cn,2,0.00%,2,0,100.00%
www.icenit.org,2,0.00%,2,0,100.00%
1p3bhkca.sched.mbq.tdnsstic1.cn,2,0.00%,2,0,100.00%
archives.streamsets.com,2,0.00%,2,0,100.00%
download.2345.com,2,0.00%,2,0,100.00%
TransiT1.WsLOG.cHINAnEtcENtEr.cOm,2,0.00%,2,0,100.00%
MambAp2pVodh5.8686c.cOM,2,0.00%,2,0,100.00%
cLIeNtlOGvoDp2p.haPlAt.NeT,2,0.00%,2,0,100.00%
img.300hu.com,2,0.00%,2,0,100.00%
adm.10jqka.com.cn,2,0.00%,2,0,100.00%
zntg.10jqka.com.cn,2,0.00%,2,0,100.00%
lf26-cdn-tos.bytecdntp.com.51296c5e.c.cdnhwc1.com,2,0.00%,2,0,100.00%
m.10jqka.com.cn,2,0.00%,2,0,100.00%
news.10jqka.com.cn,2,0.00%,2,0,100.00%
m.0033.com,2,0.00%,2,0,100.00%
abtest.5i5j.com,2,0.00%,2,0,100.00%
image.ssports.com,2,0.00%,2,0,100.00%
2121167.sched.sma.tdnsstic1.cn,2,0.00%,2,0,100.00%
hr-file-ext.oppo.com,2,0.00%,2,0,100.00%
store.akamai.steamstatic.com,2,0.00%,2,0,100.00%
wxpay.qpic.cn,2,0.00%,2,0,100.00%
wximg.gtimg.com,2,0.00%,2,0,100.00%
wxpaylogo.qpic.cn,2,0.00%,2,0,100.00%
devs.tplinkcloud.com.cn,2,0.00%,2,0,100.00%
cn-prod-web-new-631384646.cn-north-1.elb.amazonaws.com.cn,2,0.00%,2,0,100.00%
api.zhuanlan.sina.com.cn,2,0.00%,2,0,100.00%
ydcx.360buyimg.com,2,0.00%,2,0,100.00%
conf.international.baidu.com,2,0.00%,2,0,100.00%
counter.people.cn,2,0.00%,2,0,100.00%
collections.md.mp.microsoft.com,2,0.00%,2,0,100.00%
sat02pap005.storage.live.com,2,0.00%,4,2,50.00%
cms.inc.hp.com,2,0.00%,2,0,100.00%
ocsp1.wosign.com,2,0.00%,2,0,100.00%
tip.f.360.cn,2,0.00%,2,0,100.00%
adservice.google.ca,2,0.00%,8,6,25.00%
opentuna.cn,2,0.00%,2,0,100.00%
mail.vcweb.org,2,0.00%,2,0,100.00%
zx.docin.com.cname.yunjiasu-cdn.net,2,0.00%,2,0,100.00%
v5-g.douyinvod.com,2,0.00%,2,0,100.00%
myhpnotification.s3.us-west-2.amazonaws.com,2,0.00%,2,0,100.00%
api.amemv.com.bytedns1.com,2,0.00%,2,0,100.00%
api.amemv.com.c.dsa.cdnbuild.net,2,0.00%,2,0,100.00%
v5-f.douyinvod.com.zjgslb.com,2,0.00%,2,0,100.00%
img.luckincoffeecdn.com,2,0.00%,2,0,100.00%
qimgs.qunarzz.com,2,0.00%,2,0,100.00%
hdreactor.org,2,0.00%,2,0,100.00%
ed2k.vip,2,0.00%,2,0,100.00%
viewdeoscdn.b-cdn.net,2,0.00%,4,2,50.00%
bn3pcor001-com.be.1drv.com,2,0.00%,2,0,100.00%
p69-availability.icloud.com.cn,2,0.00%,2,0,100.00%
api.dior.cn,2,0.00%,2,0,100.00%
kpgnq6fji9-dsn.algolia.net,2,0.00%,2,0,100.00%
media.dior.cn,2,0.00%,2,0,100.00%
ntp3.aliyun.com,2,0.00%,2,0,100.00%
max.book118.com,2,0.00%,2,0,100.00%
tracking-protection.cdn.mozilla.net,2,0.00%,2,0,100.00%
sense-of-style.co.uk,2,0.00%,2,0,100.00%
jkotr.winsoft.aili.com,2,0.00%,2,0,100.00%
static.arxiv.org,2,0.00%,2,0,100.00%
zhibo.sina.com.cn,2,0.00%,2,0,100.00%
file-corpus.zhan.com,2,0.00%,2,0,100.00%
TRANSit1.wSloG.chInANETceNTER.cOm,2,0.00%,2,0,100.00%
cLIentLOgvOdP2P.haplat.nET,2,0.00%,2,0,100.00%
MaMBaP2PVodH5.8686C.COm,2,0.00%,2,0,100.00%
direwolf-903618df6d.herokuapp.com,2,0.00%,2,0,100.00%
opentracker.co,2,0.00%,2,0,100.00%
TRAnsiT1.wSLog.ChINAnETcenTER.com,2,0.00%,2,0,100.00%
mAMBAP2pVodH5.8686C.COm,2,0.00%,2,0,100.00%
CLIENTlOGVoDp2P.hAPlaT.nEt,2,0.00%,2,0,100.00%
vkmukytvolrk.phone-delivery.com,2,0.00%,2,0,100.00%
h-microsoft.online-metrix.net,2,0.00%,2,0,100.00%
195685-ipv4.farm.dprodmgd106.aa-rt.sharepoint.com.dual-spo-0004.spo-msedge.net,2,0.00%,2,0,100.00%
sa2-prod-msgsearch-1.cloudapp.net,1,0.00%,1,0,100.00%
e11294.g.akamaiedge.net,1,0.00%,1,0,100.00%
grafana.com,1,0.00%,4527,4526,0.02%
frenchofengland.ace.fordham.edu,1,0.00%,1,0,100.00%
api.aliyundrive.com,1,0.00%,106,105,0.94%
edifice.opencityapps.org,1,0.00%,1,0,100.00%
szdx.txddns.cn,1,0.00%,183,182,0.55%
slscr.update.microsoft.com,1,0.00%,1139,1138,0.09%
silk.lx.netease.com,1,0.00%,1,0,100.00%
api.vstsusers.visualstudio.com,1,0.00%,17,16,5.88%
biociclo.agri.cl,1,0.00%,1,0,100.00%
cainiao-app-logs.cn-zhangjiakou.log.aliyuncs.com,1,0.00%,1,0,100.00%
sns-img-hw.xhscdn.com,1,0.00%,7,6,14.29%
ac-mqgidvz-shard-00-01.nmmxpgl.mongodb.net,1,0.00%,1,0,100.00%
zn_0pxrmhobblncaad-hpsupport.siteintercept.qualtrics.com,1,0.00%,1,0,100.00%
udc-neb.kampyle.com,1,0.00%,1,0,100.00%
siteintercept.qualtrics.com,1,0.00%,1,0,100.00%
store.is.autonavi.com,1,0.00%,4,3,25.00%
tracker.imgoingto.icu,1,0.00%,227,226,0.44%
module-jshop.jd.com,1,0.00%,1,0,100.00%
jscss.jd.com,1,0.00%,1,0,100.00%
search.ecnu.cf,1,0.00%,1,0,100.00%
images.ppa030cjklwmlkkluiiah3nddnc.com,1,0.00%,1,0,100.00%
aeis.alicdn.com,1,0.00%,2,1,50.00%
static.ppa030cjklwmlkkluiiah3nddnc.com,1,0.00%,1,0,100.00%
bk.n.shifen.com,1,0.00%,788,787,0.13%
ms.vipstatic.com,1,0.00%,1,0,100.00%
a.vpimg1.com,1,0.00%,1,0,100.00%
sc.appvipshop.com,1,0.00%,1,0,100.00%
a.vpimg2.com,1,0.00%,1,0,100.00%
acs.vip.com,1,0.00%,1,0,100.00%
blog.vip.com,1,0.00%,1,0,100.00%
detail.vip.com,1,0.00%,1,0,100.00%
h5rsc.vip.com,1,0.00%,1,0,100.00%
help.vip.com,1,0.00%,1,0,100.00%
iclub.vip.com,1,0.00%,1,0,100.00%
ips.corp.vipshop.com,1,0.00%,1,0,100.00%
m.vip.com,1,0.00%,1,0,100.00%
order.vip.com,1,0.00%,1,0,100.00%
b.appsimg.com,1,0.00%,1,0,100.00%
h2.appsimg.com,1,0.00%,1,0,100.00%
pcapi.vip.com,1,0.00%,1,0,100.00%
s2.vipstatic.com,1,0.00%,1,0,100.00%
jr.vip.com,1,0.00%,1,0,100.00%
myvpal.vip.com,1,0.00%,1,0,100.00%
passport.vip.com,1,0.00%,1,0,100.00%
category.vip.com,1,0.00%,1,0,100.00%
job.vip.com,1,0.00%,1,0,100.00%
xyt.xinchacha.com,1,0.00%,1,0,100.00%
lapp.corp.vipshop.com,1,0.00%,1,0,100.00%
weiquan.vip.com,1,0.00%,1,0,100.00%
www.gdjubao.cn,1,0.00%,1,0,100.00%
400.vip.com,1,0.00%,1,0,100.00%
t2.leech.ie,1,0.00%,73,72,1.37%
node.video.qq.com,1,0.00%,337,336,0.30%
log.u.wps.cn,1,0.00%,1,0,100.00%
libs.baidu.com,1,0.00%,9,8,11.11%
img1.wywyx.com.w.kunlunca.com,1,0.00%,1,0,100.00%
c.bing.com,1,0.00%,94,93,1.06%
zoom.us,1,0.00%,1,0,100.00%
api.wallpaper.xzdesktop.cqttech.com,1,0.00%,1,0,100.00%
edge-microsoft-com.dual-a-0036.a-msedge.net,1,0.00%,257,256,0.39%
shop.darickpay.com,1,0.00%,1,0,100.00%
cbs-i.sports.cctv.com,1,0.00%,347,346,0.29%
open.weixin.qq.com,1,0.00%,260,259,0.38%
hub.docker.com,1,0.00%,253,252,0.40%
w3.wild2home.ga,1,0.00%,1,0,100.00%
service.lx.qianxin.com,1,0.00%,1,0,100.00%
wWw.vod.LxdNS.Com,1,0.00%,2,1,50.00%
tva3.sinaimg.cn,1,0.00%,88,87,1.14%
tracker.tamersunion.org,1,0.00%,304,303,0.33%
apd-vlive.apdcdn.tc.qq.com,1,0.00%,2,1,50.00%
supl.bd-caict.com,1,0.00%,1,0,100.00%
xy6hjm0xw4.feishu.cn,1,0.00%,1,0,100.00%
mkt-advertisement.tuhu.cn,1,0.00%,4,3,25.00%
img.4hou.com,1,0.00%,2,1,50.00%
lbs.map.qq.com,1,0.00%,14,13,7.14%
mirrors.ustc.edu.cn,1,0.00%,371,370,0.27%
updatem.360safe.com,1,0.00%,38,37,2.63%
s-0005.s-msedge.net,1,0.00%,127,126,0.79%
publicassets.lb-apple.com.akadns.net,1,0.00%,2,1,50.00%
publicassets-cn.lb-apple.com.akadns.net,1,0.00%,2,1,50.00%
resources.office.net.edgekey.net,1,0.00%,2,1,50.00%
nine.littlenetwork.ml,1,0.00%,1,0,100.00%
mail.14alledufreee.ml,1,0.00%,1,0,100.00%
clientconfig.passport.net,1,0.00%,4,3,25.00%
newonboarding.socialacademy.me,1,0.00%,1,0,100.00%
maps.metager.de,1,0.00%,1,0,100.00%
wassermann.online,1,0.00%,35,34,2.86%
pull-hls-spe-l1.douyincdn.com.wsdvs.com,1,0.00%,19,18,5.26%
crl.comodoca.com,1,0.00%,253,252,0.40%
v5-coldc.douyinvod.com.zjgslb.com,1,0.00%,3,2,33.33%
dy-vod-coldc.bytegslb.com,1,0.00%,3,2,33.33%
bl6pcor003-meta.fe.1drv.com,1,0.00%,2,1,50.00%
rightmentalattitude.classic.kicksite.net,1,0.00%,1,0,100.00%
cookiesyncing-1395500543.us-east-1.elb.amazonaws.com,1,0.00%,1,0,100.00%
mail.on101.co.uk,1,0.00%,1,0,100.00%
1610340737.D4EE073396E8.device.hiwifi.com,1,0.00%,1,0,100.00%
1610340758.D4EE073396E8.device.hiwifi.com,1,0.00%,1,0,100.00%
1610340779.D4EE073396E8.device.hiwifi.com,1,0.00%,1,0,100.00%
hd-084.stpl.net.pl,1,0.00%,1,0,100.00%
tx-nat.videojj.com,1,0.00%,1,0,100.00%
speed.ino.qq.com,1,0.00%,1,0,100.00%
music.cliggo.com,1,0.00%,1,0,100.00%
p63-caldav.icloud.com,1,0.00%,2,1,50.00%
bfdmirrors.s.tuna.tsinghua.edu.cn,1,0.00%,77,76,1.30%
bclearning.top,1,0.00%,1,0,100.00%
softwareupdate.vmware.com,1,0.00%,2,1,50.00%
sodefaultwordapi.paas.cmbchina.com,1,0.00%,1,0,100.00%
ebank.sz1.cmbchina.com,1,0.00%,1,0,100.00%
retracker.hotplug.ru,1,0.00%,7,6,14.29%
klone-mobile-12.vapp-servers.com,1,0.00%,1,0,100.00%
ipv6check-udp.steamcontent.com,1,0.00%,278,277,0.36%
E.ROOT-SERVERS.NET,1,0.00%,129,128,0.78%
G.ROOT-SERVERS.NET,1,0.00%,117,116,0.85%
map.n.shifen.com,1,0.00%,413,412,0.24%
download.jetbrains.com,1,0.00%,130,129,0.77%
maskells.luxuryrealestate.com,1,0.00%,1,0,100.00%
dev.sissai.com,1,0.00%,1,0,100.00%
stats.use-snip.com,1,0.00%,1,0,100.00%
fortimail.flashentertainment.com,1,0.00%,1,0,100.00%
wcdn.servyou.com.cn,1,0.00%,3,2,33.33%
hub5btmain.v6.shub.sandai.net,1,0.00%,135,134,0.74%
baileywood.co.uk,1,0.00%,1,0,100.00%
test.schoene-karten.com,1,0.00%,1,0,100.00%
v3-cold1.douyinvod.com,1,0.00%,2,1,50.00%
v3-cold1.douyinvod.com.w.kunluncan.com,1,0.00%,2,1,50.00%
v6-cold2.douyinvod.com,1,0.00%,2,1,50.00%
v6-cold2.douyinvod.com.download.ks-cdn.com,1,0.00%,2,1,50.00%
tracker-campus.tjupt.org,1,0.00%,33,32,3.03%
tracker.tongyifan.me,1,0.00%,19,18,5.26%
link-yqsx01.netease.im,1,0.00%,1,0,100.00%
xmrj002.xmrth-node.xyz,1,0.00%,1,0,100.00%
v11-cold1.sched.v4lego-dk.tdnsvod1.cn,1,0.00%,2,1,50.00%
v27.douyinvod.com,1,0.00%,4,3,25.00%
v27.douyinvod.com.vod.galileo.jcloud-cdn.com,1,0.00%,3,2,33.33%
ca.gmdns.net,1,0.00%,1,0,100.00%
us1.gmdns.net,1,0.00%,1,0,100.00%
au.gmdns.net,1,0.00%,1,0,100.00%
de.gmdns.net,1,0.00%,1,0,100.00%
us2.gmdns.net,1,0.00%,1,0,100.00%
dual-a-0001.a-msedge.net,1,0.00%,38,37,2.63%
bing.cn,1,0.00%,1,0,100.00%
001.jiang2020.ga,1,0.00%,1,0,100.00%
v6.douyinvod.com,1,0.00%,2,1,50.00%
weather-edge.news.apple-dns.net,1,0.00%,1,0,100.00%
easyscholar.cc,1,0.00%,1,0,100.00%
www-wide.l.google.com,1,0.00%,3,2,33.33%
p2pstuntest.haplat.net,1,0.00%,224,223,0.45%
update.client.163.com,1,0.00%,535,534,0.19%
naz.com.sa,1,0.00%,1,0,100.00%
15.expertcoach.ml,1,0.00%,1,0,100.00%
safebrowsing.clients.google.com,1,0.00%,2,1,50.00%
docs.axisrooms.com,1,0.00%,1,0,100.00%
ham-staging-oracle.redant.cloud,1,0.00%,1,0,100.00%
ns3-35.azure-dns.org,1,0.00%,40,39,2.50%
jksb.v.zzu.edu.cn,1,0.00%,1,0,100.00%
blob.dz5prdstr06a.store.core.windows.net,1,0.00%,1,0,100.00%
sconf.f.qh-lb.com,1,0.00%,1,0,100.00%
up-q.qh-lb.com,1,0.00%,1,0,100.00%
weather-analytics-events.news.apple-dns.net,1,0.00%,1,0,100.00%
v3-cold2.douyinvod.com.w.kunluncan.com,1,0.00%,2,1,50.00%
111-20-12-242.volcsiriusbd.com,1,0.00%,1,0,100.00%
v3-cold2.douyinvod.com,1,0.00%,2,1,50.00%
demo17.tool-box.io,1,0.00%,1,0,100.00%
heraeus.safi.ai,1,0.00%,1,0,100.00%
youjia.baidu.com,1,0.00%,4,3,25.00%
rentals.lofteystaging.info,1,0.00%,1,0,100.00%
bilibili.com,1,0.00%,1,0,100.00%
captcha.gtimg.com.sched.legopic1-dk.tdnsv6.com,1,0.00%,6,5,16.67%
static.geetest.com.w.cdngslb.com,1,0.00%,4,3,25.00%
i.sso.sina.com.cn,1,0.00%,30,29,3.33%
yupao-prod.54xiaoshuo.com,1,0.00%,1,0,100.00%
madx.flyme.cn,1,0.00%,1,0,100.00%
api-dandelion.flyme.cn,1,0.00%,1,0,100.00%
app.compendium.com,1,0.00%,1,0,100.00%
polo.feathr.co,1,0.00%,1,0,100.00%
2022.ieeeicassp.org,1,0.00%,1,0,100.00%
yjfk.gjbmj.gov.cn,1,0.00%,1,0,100.00%
pc.589s.cn,1,0.00%,1,0,100.00%
cnac.account.xiaomi.com,1,0.00%,1,0,100.00%
e16991.b.akamaiedge.net,1,0.00%,1,0,100.00%
www.thefreedictionary.com,1,0.00%,1,0,100.00%
newdefault2.go2https.com,1,0.00%,1,0,100.00%
7fi.ukzcyp.ga,1,0.00%,1,0,100.00%
jira.qero.io,1,0.00%,1,0,100.00%
ad-maven.xml.ak-is2.net,1,0.00%,1,0,100.00%
static.realtime-bid.com,1,0.00%,2,1,50.00%
realtime-bid.xs.ak-is2.net,1,0.00%,2,1,50.00%
r2z5g8w6.stackpathcdn.com,1,0.00%,2,1,50.00%
guce.yahoo.com,1,0.00%,1,0,100.00%
files.fireinthehole.cf,1,0.00%,1,0,100.00%
selectcarpetcleaninginc.rk3t.com,1,0.00%,1,0,100.00%
webmail.up4net.net,1,0.00%,1,0,100.00%
cf45.herokuapp.com,1,0.00%,1,0,100.00%
appstore.ldmnq.com,1,0.00%,1,0,100.00%
direwolf-cdbae92306.herokuapp.com,1,0.00%,1,0,100.00%
proxy-detection.eset.com,1,0.00%,1,0,100.00%
v11-x.douyinvod.com.cdn.dnsv1.com,1,0.00%,3,2,33.33%
pull-fcdn-douyin-base7.s.bytefcdn.com,1,0.00%,1,0,100.00%
pull-fcdn-douyin-base6.s.bytefcdn.com,1,0.00%,1,0,100.00%
hw-sh-live-comet-05.chat.bilibili.com,1,0.00%,1,0,100.00%
j.mrpdata.net,1,0.00%,1,0,100.00%
securepubads46.g.doubleclick.net,1,0.00%,10,9,10.00%
rc10-fc01.oray.com,1,0.00%,1,0,100.00%
mamasearchad.cloudvideocdn.taobao.com,1,0.00%,2,1,50.00%
signal-prod-signal-prod-rel-asse-signalr-primary-3.service.signalr.net,1,0.00%,1,0,100.00%
hub5u.sandai.net,1,0.00%,1,0,100.00%
static.xbase.cloud,1,0.00%,1,0,100.00%
api.fantuants.com,1,0.00%,1,0,100.00%
www.shichuan.org,1,0.00%,1,0,100.00%
conference.cipsc.org.cn,1,0.00%,1,0,100.00%
www.cil.pku.edu.cn,1,0.00%,1,0,100.00%
www.springerprofessional.de,1,0.00%,1,0,100.00%
china-img.soulapp.cn,1,0.00%,2,1,50.00%
1608223790.D4EE071FA772.device.hiwifi.com,1,0.00%,1,0,100.00%
nat-office-christian-gasparini-architetto.divisare.pro,1,0.00%,1,0,100.00%
proxy-sub.vulgraph.org,1,0.00%,1,0,100.00%
cheng.vpn.rndto.com,1,0.00%,1,0,100.00%
o.arkcn.tk,1,0.00%,1,0,100.00%
ppa.launchpad.net,1,0.00%,606,605,0.17%
you.csueastbay.edu,1,0.00%,1,0,100.00%
staging-crackerjacks.herokuapp.com,1,0.00%,1,0,100.00%
cx.soft.360.cn,1,0.00%,1,0,100.00%
e2c47.gcp.gvt2.com,1,0.00%,1,0,100.00%
mx.miao.tk,1,0.00%,1,0,100.00%
qlikid.qlik.com,1,0.00%,1,0,100.00%
fiy.ewancle.tk,1,0.00%,1,0,100.00%
WWw.VoD.LXdNS.COm,1,0.00%,2,1,50.00%
www.Vod.LxdnS.COm,1,0.00%,2,1,50.00%
1610326326.D4EE073396E8.device.hiwifi.com,1,0.00%,1,0,100.00%
1610326352.D4EE073396E8.device.hiwifi.com,1,0.00%,1,0,100.00%
1610326372.D4EE073396E8.device.hiwifi.com,1,0.00%,1,0,100.00%
br.vetmatch.org,1,0.00%,1,0,100.00%
fr05.graniterapids.com,1,0.00%,1,0,100.00%
keaxxisbusyjkwod.masiruju.cz,1,0.00%,1,0,100.00%
mail.qq.com,1,0.00%,148,147,0.68%
download.microsoft.com,1,0.00%,2,1,50.00%
hs.browser.360.cn,1,0.00%,1,0,100.00%
vpn.lramirez.tk,1,0.00%,1,0,100.00%
admin-acceptatie.am-i.nl,1,0.00%,1,0,100.00%
cc.f.qh-lb.com,1,0.00%,1,0,100.00%
mail.poigegu.tk,1,0.00%,1,0,100.00%
revivalstrength.truecoach.co,1,0.00%,1,0,100.00%
direwolf-89722a7090.herokuapp.com,1,0.00%,1,0,100.00%
61-241-145-44.volcsiriusbd.com,1,0.00%,1,0,100.00%
mail.countcadimicut.tk,1,0.00%,1,0,100.00%
esd751.vmware.com.ds.edgekey.net,1,0.00%,2,1,50.00%
p6.itc.cn,1,0.00%,9,8,11.11%
wiki.onosproject.org,1,0.00%,1,0,100.00%
m801.music.126.net.w.alikunlun.com,1,0.00%,2,1,50.00%
only-954422-159-226-95-46.nstool.haowu.link,1,0.00%,1,0,100.00%
ip462737478.funshion.com,1,0.00%,1,0,100.00%
ieee.org.ssl.sc.omtrdc.net,1,0.00%,1,0,100.00%
be-nl.jowae.com,1,0.00%,1,0,100.00%
healthdeviceagent-drcn.things.hicloud.com,1,0.00%,1,0,100.00%
healthrecommend.hicloud.com,1,0.00%,1,0,100.00%
healthactivity.hicloud.com,1,0.00%,1,0,100.00%
mail.deht.med.ly,1,0.00%,1,0,100.00%
d9fq3pbkiblkl.cloudfront.net,1,0.00%,1,0,100.00%
d2dohd3bs3jx97.cloudfront.net,1,0.00%,1,0,100.00%
fierce-reaches-21587.herokuapp.com,1,0.00%,1,0,100.00%
ccm.takuma.de,1,0.00%,1,0,100.00%
mail.wektkidetennikvillage.ml,1,0.00%,1,0,100.00%
1610053431.D4EE073C2A20.device.hiwifi.com,1,0.00%,1,0,100.00%
1610053457.D4EE073C2A20.device.hiwifi.com,1,0.00%,1,0,100.00%
1610053498.D4EE073C2A20.device.hiwifi.com,1,0.00%,1,0,100.00%
cdn.cnbj1.fds.api.mi-img.com.mgslb.com,1,0.00%,4,3,25.00%
l7.transfer.sec.miui.com,1,0.00%,1,0,100.00%
keybag.id.mi.com,1,0.00%,1,0,100.00%
sentence.iciba.com,1,0.00%,1,0,100.00%
logupdate.avlyun.sec.miui.com,1,0.00%,1,0,100.00%
lvs-t.avlyun.com,1,0.00%,1,0,100.00%
snhk2.desktopcal.com,1,0.00%,1,0,100.00%
v6-x.douyinvod.com.download.ks-cdn.com,1,0.00%,4,3,25.00%
ecs-office.s-0005.s-msedge.net,1,0.00%,44,43,2.27%
forumctepgmbh.teamtailor.com,1,0.00%,1,0,100.00%
direwolf-eb3c66e408.herokuapp.com,1,0.00%,1,0,100.00%
direwolf-87ffe67b80.herokuapp.com,1,0.00%,1,0,100.00%
kenconrad.realscout.com,1,0.00%,1,0,100.00%
bttracker.debian.org,1,0.00%,132,131,0.76%
appnavi.baidu.com,1,0.00%,4,3,25.00%
p4-axtd7iihdyht2-yeofw2rr4eupbgcw-if-v6exp3-v4.metric.gstatic.com,1,0.00%,1,0,100.00%
nep.advangelists.com,1,0.00%,1,0,100.00%
hd01.easyquant.tk,1,0.00%,1,0,100.00%
static-cdn-test.naturemasterclassesonline.cn,1,0.00%,1,0,100.00%
yuri-intel.app.kdsec.org,1,0.00%,1,0,100.00%
sex9.sexorb.io,1,0.00%,1,0,100.00%
ns6.google-direct.net,1,0.00%,1,0,100.00%
apiservice.playserver.xyz,1,0.00%,1,0,100.00%
tjv1.wn51.com,1,0.00%,1,0,100.00%
jp.wn51.com,1,0.00%,1,0,100.00%
v2.freeyes.xyz,1,0.00%,1,0,100.00%
pltraffic32.com,1,0.00%,1,0,100.00%
bossan.radiohjalpen.se,1,0.00%,1,0,100.00%
blob.lvl02prdstr02a.store.core.windows.net,1,0.00%,1,0,100.00%
content.dellsupportcenter.com.edgekey.net,1,0.00%,1,0,100.00%
s2.statsupdate.microsoft.com.nsatc.net,1,0.00%,1,0,100.00%
www3.onlydisk.cf,1,0.00%,1,0,100.00%
a.mishen.ml,1,0.00%,1,0,100.00%
csharp-moku2.doorkeeper.jp,1,0.00%,1,0,100.00%
h5mj.uopiao.com,1,0.00%,1,0,100.00%
direwolf-d91ef2c1e7.herokuapp.com,1,0.00%,1,0,100.00%
dns1.p03.nsone.net,1,0.00%,4,3,25.00%
dns3.p03.nsone.net,1,0.00%,4,3,25.00%
dns2.p03.nsone.net,1,0.00%,4,3,25.00%
direwolf-c3391a447c.herokuapp.com,1,0.00%,1,0,100.00%
hr06.graniterapids.com,1,0.00%,1,0,100.00%
in07.graniterapids.com,1,0.00%,1,0,100.00%
wkctj.wenku.n.shifen.com,1,0.00%,6,5,16.67%
ssp-ats-prod-ap-southeast-1.one-mobile-prod.aws.oath.cloud,1,0.00%,1,0,100.00%
wx.zltianhen.com,1,0.00%,1,0,100.00%
o11.mypig.cf,1,0.00%,1,0,100.00%
one.bnu.edu.cn,1,0.00%,1,0,100.00%
cas.bnu.edu.cn,1,0.00%,1,0,100.00%
abtest3-misc-hl.zijieapi.com,1,0.00%,2,1,50.00%
bsync3-normal-hl.zijieapi.com,1,0.00%,2,1,50.00%
dataservice.protection.outlook.com,1,0.00%,1,0,100.00%
augloop.office.com,1,0.00%,14,13,7.14%
liveplay.pddpic.com,1,0.00%,2,1,50.00%
live-adapt.pddpic.com,1,0.00%,2,1,50.00%
live12-adapt.pddpic.com,1,0.00%,2,1,50.00%
eh16.foot5176.cf,1,0.00%,1,0,100.00%
res.imtt.tc.qq.com,1,0.00%,2,1,50.00%
res.imtt.qq.com.sched.px-dk.tdnsv6.com,1,0.00%,2,1,50.00%
acs.m.taobao.com.gds.alibabadns.com,1,0.00%,13,12,7.69%
dualstack-na610-na620.acs.m.taobao.com,1,0.00%,10,9,10.00%
api-drcn-music-dbankcloud-cn-drcn.appacc-region.dbankedge.net,1,0.00%,1,0,100.00%
affa2f9462bfbe92-cl2.qcloudcjgj.com,1,0.00%,1,0,100.00%
0.4848.tk,1,0.00%,1,0,100.00%
2osst4024rik63t21ptff1ft3ak6tps5t53k5rlp0tn54b8dfd3vudsc.qc.x.bsgslb.cn,1,0.00%,1,0,100.00%
fmmefpjvhst06kp9esirkm18a1dhm426k6i0lfbedeub2vnfkhbfvna9.qc.x.bsgslb.cn,1,0.00%,1,0,100.00%
1tucesh6ejeak592otl0j4684g1ot40fcgumj0fnn73uandfijsvuckl.qc.x.bsgslb.cn,1,0.00%,1,0,100.00%
update.wn51.com,1,0.00%,1,0,100.00%
enef.edu.py,1,0.00%,1,0,100.00%
119-147-89-77.volcsiriusbd.com,1,0.00%,1,0,100.00%
223-109-173-135.volcsiriusbd.com,1,0.00%,1,0,100.00%
bddtlog.trafficmanager.cn,1,0.00%,1,0,100.00%
dy-vod-i.bytegslb.com,1,0.00%,1,0,100.00%
downloads.dell.com-v2-dd.edgekey.net,1,0.00%,2,1,50.00%
e12616.dscd.akamaiedge.net,1,0.00%,2,1,50.00%
9dzraa.uuh.layo.cf,1,0.00%,1,0,100.00%
opencdnbdpcsvideotmp.jomodns.com,1,0.00%,2,1,50.00%
wiley.met.vgwort.de,1,0.00%,1,0,100.00%
slb-vgwort-de-pool03.vgwort-de.2cnt.net,1,0.00%,1,0,100.00%
wiley.grapeshot.co.uk,1,0.00%,1,0,100.00%
porky.pool.gscontxt.net,1,0.00%,1,0,100.00%
a18cb0e20b3ee3a71f2b1389f919fa95.safeframe.googlesyndication.com,1,0.00%,1,0,100.00%
edge.api.brightcove.com,1,0.00%,1,0,100.00%
brightcove.map.fastly.net,1,0.00%,1,0,100.00%
map.brightcove.com,1,0.00%,1,0,100.00%
audience-public-prod-90639937.us-east-1.elb.amazonaws.com,1,0.00%,1,0,100.00%
abs-0.twimg.com,1,0.00%,1,0,100.00%
abs-zero.twimg.com,1,0.00%,1,0,100.00%
c.riskified.com,1,0.00%,2,1,50.00%
mail.cacrnet.org.cn,1,0.00%,1,0,100.00%
7cfed504f6614da0841265c6af44e91a.fp.measure.office.com,1,0.00%,1,0,100.00%
support.hp.com,1,0.00%,1,0,100.00%
nexus.ensighten.com,1,0.00%,1,0,100.00%
cdn.optimizely.com,1,0.00%,3,2,33.33%
www8.hp.com,1,0.00%,1,0,100.00%
logx.optimizely.com,1,0.00%,1,0,100.00%
nebula-cdn.kampyle.com,1,0.00%,1,0,100.00%
global-navbar-backend.id.hp.com,1,0.00%,1,0,100.00%
t.contentsquare.net,1,0.00%,1,0,100.00%
c.contentsquare.net,1,0.00%,1,0,100.00%
k-aus1.contentsquare.net,1,0.00%,1,0,100.00%
d18dtii85prvml.cloudfront.net,1,0.00%,3,2,33.33%
apd-b70fa555e3b663697632bbfb11873c24.v.smtcdns.com,1,0.00%,1,0,100.00%
china1.elsevier.com,1,0.00%,1,0,100.00%
sciencedirect-id.elsevier-ae.com,1,0.00%,1,0,100.00%
elsevier-id.elsevier-ae.com,1,0.00%,1,0,100.00%
id.elsevier.com,1,0.00%,1,0,100.00%
id.elsevier-ae.com.cdn.cloudflare.net,1,0.00%,1,0,100.00%
chi01pcor001-meta.be.1drv.com.l-0003.dc-msedge.net.l-0003.l-msedge.net,1,0.00%,1,0,100.00%
elsevier.squizedge.net,1,0.00%,1,0,100.00%
a1858.dscd.akamai.net.0.1.cn.akamaitech.net,1,0.00%,2,1,50.00%
k.sni.global.fastly.net,1,0.00%,1,0,100.00%
cm.everesttech.net.akadns.net,1,0.00%,1,0,100.00%
intf-pc.peasrch.com,1,0.00%,1,0,100.00%
fc5tn.baidu.com.a.bdydns.com,1,0.00%,1,0,100.00%
webim.kefu.easemob.com.m.alikunlun.com,1,0.00%,1,0,100.00%
store.cloudflare.steamstatic.com,1,0.00%,3,2,33.33%
cdn.cloudflare.steamstatic.com,1,0.00%,2,1,50.00%
feedvideo.jomodns.com,1,0.00%,4,3,25.00%
vd3.bdstatic.com.w.alikunlun.com,1,0.00%,2,1,50.00%
mini.360.cn.qh-cdn.com,1,0.00%,2,1,50.00%
api.occipital.com,1,0.00%,1,0,100.00%
e90971.dsca.akamaiedge.net,1,0.00%,2,1,50.00%
e118390.a.akamaiedge.net,1,0.00%,1,0,100.00%
cs02-pps-drcn.dbankcdn.com.p8.qcloudcdn.com,1,0.00%,1,0,100.00%
best.sched.skalego.tdnsstic1.cn.cjt.vwnti.yrzhcloud.cn,1,0.00%,1,0,100.00%
lib.ucas.ac.cn,1,0.00%,1,0,100.00%
google.com.sg,1,0.00%,1,0,100.00%
newclient.map.n.shifen.com,1,0.00%,8,7,12.50%
api.watch.okii.com,1,0.00%,1,0,100.00%
watchda.eebbk.net,1,0.00%,1,0,100.00%
newvector.map.baidu.com,1,0.00%,4,3,25.00%
vectormap0.bdimg.com.a.bdydns.com,1,0.00%,2,1,50.00%
smartwatch.qiniucdn.com,1,0.00%,1,0,100.00%
edu-wenku.bdimg.com.a.bdydns.com,1,0.00%,2,1,50.00%
wappass.n.shifen.com,1,0.00%,222,221,0.45%
wkbjcloudbos.bdimg.com.a.bdydns.com,1,0.00%,2,1,50.00%
wa.qq.com.sched.legopic2-dk.tdnsv6.com.tpic.vwnti.yrzhcloud.cn,1,0.00%,2,1,50.00%
p43-availability.icloud.com,1,0.00%,2,1,50.00%
availability.fe.apple-dns.net,1,0.00%,2,1,50.00%
553490.com,1,0.00%,1,0,100.00%
image.superqqshow.qq.com,1,0.00%,2,1,50.00%
g.whatsapp.net,1,0.00%,2,1,50.00%
awareness-api-drcn.ai.dbankcloud.com,1,0.00%,1,0,100.00%
pubapi3.bizport.cn,1,0.00%,1,0,100.00%
pubapi1.bizport.cn,1,0.00%,1,0,100.00%
dmd-ilp-hd.youku.com,1,0.00%,4,3,25.00%
identity.ess-apple.com.akadns.net,1,0.00%,1,0,100.00%
apigateway.iqiyi.com,1,0.00%,1,0,100.00%
apigw.iqiyi.com,1,0.00%,1,0,100.00%
e5956.f.akamaiedge.net,1,0.00%,1,0,100.00%
saservices.dell.com.edgekey.net,1,0.00%,2,1,50.00%
kms.cic.tsinghua.edu.cn,1,0.00%,1,0,100.00%
e28.dscx.akamaiedge.net,1,0.00%,2,1,50.00%
ins-e4aq5nj0.ias.tencent-cloud.net,1,0.00%,1,0,100.00%
sf6-cdn-tos.douyinstatic.com.download.ks-cdn.com,1,0.00%,3,2,33.33%
product-setting-uat.haituncun.com,1,0.00%,1,0,100.00%
event-store-api-clarity-mainnet.make.services,1,0.00%,1,0,100.00%
autofrey100611.tjekvik.com,1,0.00%,1,0,100.00%
i-dsm01p-cor002.api.p001.1drv.com,1,0.00%,1,0,100.00%
blob.bn9prdstr14a.store.core.windows.net,1,0.00%,1,0,100.00%
cm-10-35.getui.com,1,0.00%,1,0,100.00%
dl1023.tcdn.qq.com,1,0.00%,1,0,100.00%
www.aibtba.com,1,0.00%,1,0,100.00%
img.baidu.com.btba.xiaoeryi.com,1,0.00%,1,0,100.00%
10.mi.com,1,0.00%,1,0,100.00%
c.aibtba.com,1,0.00%,1,0,100.00%
torrent.baidu.com.btba.xiaoeryi.com,1,0.00%,1,0,100.00%
www.xinfushe.com,1,0.00%,1,0,100.00%
webchat.7moor.com,1,0.00%,1,0,100.00%
xinfushe-1254330234.cos.ap-beijing.myqcloud.com,1,0.00%,1,0,100.00%
4o1.ptr5668.nolt.io,1,0.00%,1,0,100.00%
service.jjxiangya.xyz,1,0.00%,2,1,50.00%
america.west-world.link,1,0.00%,1,0,100.00%
mcleodproshop.com.au,1,0.00%,1,0,100.00%
reader001.pdfslide.net,1,0.00%,1,0,100.00%
www.Vod.LxDnS.COm,1,0.00%,2,1,50.00%
direwolf-05834760cb.herokuapp.com,1,0.00%,1,0,100.00%
gig-mvp.trafficmanager.net,1,0.00%,2,1,50.00%
1610326336.D4EE073396E8.device.hiwifi.com,1,0.00%,1,0,100.00%
1610326357.D4EE073396E8.device.hiwifi.com,1,0.00%,1,0,100.00%
only-557170-124-16-137-194.nstool.netease.com,1,0.00%,1,0,100.00%
only-917676-124-16-137-194.nstool.netease.com,1,0.00%,1,0,100.00%
only-432407-124-16-137-194.nstool.laiqukankan.com,1,0.00%,1,0,100.00%
only-27285-124-16-137-194.nstool.yqkk.link,1,0.00%,1,0,100.00%
only-633161-124-16-137-194.nstool.netease.com,1,0.00%,1,0,100.00%
only-371639-124-16-137-194.nstool.321fenx.com,1,0.00%,1,0,100.00%
only-733545-124-16-137-194.nstool.zhuanzfx.com,1,0.00%,1,0,100.00%
only-994423-124-16-137-194.nstool.laiqukankan.com,1,0.00%,1,0,100.00%
only-931325-124-16-137-194.nstool.321fenx.com,1,0.00%,1,0,100.00%
only-127656-124-16-137-194.nstool.yqkk.link,1,0.00%,1,0,100.00%
only-223150-124-16-137-194.nstool.laiqukankan.com,1,0.00%,1,0,100.00%
only-260543-124-16-137-194.nstool.laiqukankan.com,1,0.00%,1,0,100.00%
only-339858-124-16-137-194.nstool.laiqukankan.com,1,0.00%,1,0,100.00%
only-790701-124-16-137-194.nstool.laiqukankan.com,1,0.00%,1,0,100.00%
only-222612-124-16-137-194.nstool.netease.com,1,0.00%,1,0,100.00%
only-643349-124-16-137-194.nstool.netease.com,1,0.00%,1,0,100.00%
only-18588-124-16-137-194.nstool.zhuanzfx.com,1,0.00%,1,0,100.00%
only-120253-124-16-137-194.nstool.zhuanzfx.com,1,0.00%,1,0,100.00%
only-448317-124-16-137-194.nstool.zhuanzfx.com,1,0.00%,1,0,100.00%
only-913289-124-16-137-194.nstool.zhuanzfx.com,1,0.00%,1,0,100.00%
only-819523-124-16-137-194.nstool.laiqukankan.com,1,0.00%,1,0,100.00%
only-256288-124-16-137-194.nstool.zhuanzfx.com,1,0.00%,1,0,100.00%
only-152607-124-16-137-194.nstool.zhuanzfx.com,1,0.00%,1,0,100.00%
only-633734-124-16-137-194.nstool.zhuanzfx.com,1,0.00%,1,0,100.00%
only-67065-124-16-137-194.nstool.haowu.link,1,0.00%,1,0,100.00%
only-515280-124-16-137-194.nstool.laiqukankan.com,1,0.00%,1,0,100.00%
only-884872-124-16-137-194.nstool.laiqukankan.com,1,0.00%,1,0,100.00%
only-962575-124-16-137-194.nstool.yqkk.link,1,0.00%,1,0,100.00%
only-567080-124-16-137-194.nstool.haowu.link,1,0.00%,1,0,100.00%
only-189822-124-16-137-194.nstool.laiqukankan.com,1,0.00%,1,0,100.00%
only-769105-124-16-137-194.nstool.laiqukankan.com,1,0.00%,1,0,100.00%
only-423474-124-16-137-194.nstool.laiqukankan.com,1,0.00%,1,0,100.00%
only-57499-124-16-137-194.nstool.laiqukankan.com,1,0.00%,1,0,100.00%
only-653590-124-16-137-194.nstool.laiqukankan.com,1,0.00%,1,0,100.00%
only-157908-124-16-137-194.nstool.zhuanzfx.com,1,0.00%,1,0,100.00%
only-248442-124-16-137-194.nstool.zhuanzfx.com,1,0.00%,1,0,100.00%
only-454284-124-16-137-194.nstool.zhuanzfx.com,1,0.00%,1,0,100.00%
only-57292-124-16-137-194.nstool.haowu.link,1,0.00%,1,0,100.00%
d1b4sl9g7ism1h.cloudfront.net,1,0.00%,1,0,100.00%
only-632421-124-16-137-194.nstool.haowu.link,1,0.00%,1,0,100.00%
only-490466-124-16-137-194.nstool.321fenx.com,1,0.00%,1,0,100.00%
r3.sn-ni5eln7e.gvt1.com,1,0.00%,1,0,100.00%
changdunovel.com.w.cdngslb.com,1,0.00%,1,0,100.00%
mcs.snssdk.com.bytedns1.com,1,0.00%,3,2,33.33%
mcs.snssdk.com.51296c5e.c.cdnhwc1.com,1,0.00%,3,2,33.33%
p3-novel.byteimg.com.w.alikunlun.com,1,0.00%,2,1,50.00%
direct.toutiao-misc-lb-v3.hl.bytelb.net,1,0.00%,1,0,100.00%
fc6tn.baidu.com.a.bdydns.com,1,0.00%,1,0,100.00%
kefuhttps.z.easemob.com,1,0.00%,1,0,100.00%
kefuhttps.z.easemob.com.x.easeslb.com,1,0.00%,1,0,100.00%
cn-hb.kefuhttps.z.easemob.com.x.easeslb.com,1,0.00%,1,0,100.00%
www.statcounter.com,1,0.00%,1,0,100.00%
dcdn-query.n.shifen.com,1,0.00%,1,0,100.00%
alt4.mobile-gtalk4.l.google.com,1,0.00%,1,0,100.00%
skilled.alinea-engage.com,1,0.00%,1,0,100.00%
android-context-data.googleapis.com,1,0.00%,2,1,50.00%
get.daocloud.io,1,0.00%,1,0,100.00%
mail.seorankerpro9.ml,1,0.00%,1,0,100.00%
tw-8.zoommeeting.work,1,0.00%,1,0,100.00%
api2.checkout.bugbarfly.com,1,0.00%,1,0,100.00%
rilehd.5exlfzr10.gq,1,0.00%,1,0,100.00%
upgrade.nowifi.cn,1,0.00%,1,0,100.00%
ns4-35.azure-dns.info,1,0.00%,46,45,2.17%
account.cloud.huawei.com,1,0.00%,1,0,100.00%
libvpn.ucas.ac.cn,1,0.00%,1,0,100.00%
file.scholarin.cn,1,0.00%,1,0,100.00%
v.map.n.shifen.com,1,0.00%,2,1,50.00%
1610103826.D4EE073C2A20.device.hiwifi.com,1,0.00%,1,0,100.00%
th-tw01.ddnsth.top,1,0.00%,1,0,100.00%
e6.whatsapp.net,1,0.00%,2,1,50.00%
rq.optimize.cloud.duba.net,1,0.00%,1,0,100.00%
app.exploradogs.com,1,0.00%,1,0,100.00%
www2.asian-sirens.com,1,0.00%,1,0,100.00%
swcdn.g.aaplimg.com,1,0.00%,2,1,50.00%
uu.gdl.netease.com,1,0.00%,1,0,100.00%
ems-app.herokuapp.com,1,0.00%,1,0,100.00%
m.o4gqmq.ga,1,0.00%,1,0,100.00%
wpsfile-beijing.ksyunjiasu.cn,1,0.00%,1,0,100.00%
1qmbvze.aud.dscew.ga,1,0.00%,1,0,100.00%
adamsreese.admin.onenorth.com,1,0.00%,1,0,100.00%
www.vps234.com,1,0.00%,1,0,100.00%
timg.jomodns.com,1,0.00%,5,4,20.00%
lf3-atsx-tob.feishucdn.com,1,0.00%,2,1,50.00%
mail.inceltejectnes.tk,1,0.00%,1,0,100.00%
ink-gia.mluoc.tk,1,0.00%,1,0,100.00%
grind.iscouttest.com,1,0.00%,1,0,100.00%
jordan-rati.invitesco.com,1,0.00%,1,0,100.00%
qzvkimvrirop.exitlist.co,1,0.00%,1,0,100.00%
spximagem.com.br,1,0.00%,1,0,100.00%
faith-baptist-church1.bridgeelementcms.com,1,0.00%,1,0,100.00%
millennium.getambassador.com,1,0.00%,1,0,100.00%
ff0618c13ceb605cac6c.erneststewart.private-api.com,1,0.00%,1,0,100.00%
mail.blcksmm.tk,1,0.00%,1,0,100.00%
s.cpro.e.shifen.com,1,0.00%,1,0,100.00%
api-prd-drcn.hiboard.hihonorcloud.com,1,0.00%,1,0,100.00%
dk84ue410hpf2.cloudfront.net,1,0.00%,1,0,100.00%
mail.saas-lighting.com,1,0.00%,1,0,100.00%
qi-mobile-notifications.enjaz-mobile.dev,1,0.00%,1,0,100.00%
link-2joi520r.gaapqcloud.com,1,0.00%,1,0,100.00%
ee.df-emergency.com,1,0.00%,1,0,100.00%
assets.privy-staging-pr-5285.privy-staging.com,1,0.00%,1,0,100.00%
phia.org.in,1,0.00%,1,0,100.00%
fridacastelli.scontrinoshop.com,1,0.00%,1,0,100.00%
k53k6ler.sched.sma.tdnsstic1.cn.cjt.krcdn.idatacube.com,1,0.00%,1,0,100.00%
letstestbranch17.rsvy-staging.io,1,0.00%,1,0,100.00%
mail.tipsdertesonrobang.ga,1,0.00%,1,0,100.00%
dev.totalhus.se,1,0.00%,1,0,100.00%
mail.manyser.com,1,0.00%,1,0,100.00%
restaurants.table4u.at,1,0.00%,1,0,100.00%
mail.chase-dashboard.ml,1,0.00%,1,0,100.00%
aquadental.demo.platform24.se,1,0.00%,1,0,100.00%
api.hylo.com,1,0.00%,1,0,100.00%
www.eol.cn,1,0.00%,1,0,100.00%
l2983942.iavs9x.u.avast.com,1,0.00%,4,3,25.00%
r0965026.vps18.u.avcdn.net,1,0.00%,4,3,25.00%
pi.pardot.com,1,0.00%,1,0,100.00%
www2.internet2.edu,1,0.00%,1,0,100.00%
bj.pcs.n.shifen.com,1,0.00%,2,1,50.00%
bikingsardinia.booqable.shop,1,0.00%,1,0,100.00%
hylsj2.dingyue.ml,1,0.00%,1,0,100.00%
yt-adp.ws.126.net,1,0.00%,6,5,16.67%
www.iikx.com,1,0.00%,1,0,100.00%
stun.ideasip.com,1,0.00%,59,58,1.69%
wWW.vOD.lxDNs.CoM,1,0.00%,2,1,50.00%
ca4f8260638d1dadfa89aa879432a6dc.safeframe.googlesyndication.com,1,0.00%,1,0,100.00%
norma-external-collect.meizu.com,1,0.00%,1,0,100.00%
1610057031.D4EE073C2A20.device.hiwifi.com,1,0.00%,1,0,100.00%
1610057062.D4EE073C2A20.device.hiwifi.com,1,0.00%,1,0,100.00%
1610057088.D4EE073C2A20.device.hiwifi.com,1,0.00%,1,0,100.00%
mmocgame.qpic.cn,1,0.00%,2,1,50.00%
mmocgame.qpic.cn.tc.qq.com,1,0.00%,2,1,50.00%
mmocgame.qpic.cn.sched.px-dk.tdnsv6.com,1,0.00%,2,1,50.00%
ulink.qq.com.x2.sched.dcloudstc.com,1,0.00%,1,0,100.00%
hw-gz-live-p2p-07.chat.bilibili.com,1,0.00%,1,0,100.00%
tx-bj-live-comet-04.chat.bilibili.com,1,0.00%,1,0,100.00%
tasks.google.com,1,0.00%,2,1,50.00%
tx-bj-live-p2p-01.chat.bilibili.com,1,0.00%,1,0,100.00%
tx-gz-live-comet-01.chat.bilibili.com,1,0.00%,1,0,100.00%
ossweb-img.qq.com.sched.dlied1.tdnsv5.com,1,0.00%,1,0,100.00%
ulink.game.qq.com,1,0.00%,1,0,100.00%
hw-sh-live-p2p-backup-0002.chat.bilibili.com,1,0.00%,1,0,100.00%
tx-gz-live-stun-2.chat.bilibili.com,1,0.00%,1,0,100.00%
tx-bj-live-comet-03.chat.bilibili.com,1,0.00%,1,0,100.00%
v11-cold.douyinvod.com,1,0.00%,2,1,50.00%
v11-cold.douyinvod.com.cdn.dnsv1.com,1,0.00%,2,1,50.00%
v11-cold.sched.v4lego-dk.tdnsvod1.cn,1,0.00%,2,1,50.00%
registry.docker-cn.com,1,0.00%,1,0,100.00%
ooe7wn09.mirror.aliyuncs.com,1,0.00%,1,0,100.00%
kay-javtube.herokuapp.com,1,0.00%,1,0,100.00%
anontelemetry.phusionpassenger.com,1,0.00%,1,0,100.00%
c.gtld-servers.net,1,0.00%,12,11,8.33%
h1785399.iavs9x.avg.u.avcdn.net,1,0.00%,3,2,33.33%
download.bitdefender.com,1,0.00%,1,0,100.00%
www.avast.com,1,0.00%,3,2,33.33%
51.renrenjiji.com,1,0.00%,1,0,100.00%
trace-ssl.ad7.com,1,0.00%,1,0,100.00%
www.33ip.com,1,0.00%,1,0,100.00%
www.hncloud.com,1,0.00%,1,0,100.00%
extension.maxthon.cn,1,0.00%,1,0,100.00%
tool.oschina.net,1,0.00%,1,0,100.00%
liquer.herokuapp.com,1,0.00%,1,0,100.00%
bloom-callback-sit.zaintl.com,1,0.00%,1,0,100.00%
service.dcloud.net.cn,1,0.00%,1,0,100.00%
item.jd.com.gslb.qianxun.com,1,0.00%,3,2,33.33%
h5static.jcloud-cdn.com,1,0.00%,1,0,100.00%
static.leetcode-cn.com.w.kunlungr.com,1,0.00%,1,0,100.00%
res1.wpsacdm.cache.wpscdn.cn,1,0.00%,2,1,50.00%
myhuiban.com,1,0.00%,1,0,100.00%
image11.m1905.cn,1,0.00%,1,0,100.00%
diygod.me,1,0.00%,4,3,25.00%
only-49794-124-16-140-20.nstool.laiqukankan.com,1,0.00%,1,0,100.00%
only-929372-124-16-140-20.nstool.laiqukankan.com,1,0.00%,1,0,100.00%
only-803221-124-16-140-20.nstool.321fenx.com,1,0.00%,1,0,100.00%
only-735425-124-16-140-20.nstool.haowu.link,1,0.00%,1,0,100.00%
only-590775-124-16-140-20.nstool.zhuanzfx.com,1,0.00%,1,0,100.00%
only-631892-124-16-140-20.nstool.haowu.link,1,0.00%,1,0,100.00%
only-472622-124-16-140-20.nstool.zhuanzfx.com,1,0.00%,1,0,100.00%
only-54648-124-16-140-20.nstool.yqkk.link,1,0.00%,1,0,100.00%
only-683370-124-16-140-20.nstool.yqkk.link,1,0.00%,1,0,100.00%
ip3720517262.funshion.com,1,0.00%,1,0,100.00%
only-317090-124-16-140-20.nstool.yqkk.link,1,0.00%,1,0,100.00%
only-945826-124-16-140-20.nstool.yqkk.link,1,0.00%,1,0,100.00%
only-621234-124-16-140-20.nstool.321fenx.com,1,0.00%,1,0,100.00%
only-236875-124-16-140-20.nstool.haowu.link,1,0.00%,1,0,100.00%
only-892953-124-16-140-20.nstool.haowu.link,1,0.00%,1,0,100.00%
maven.tmatesoft.com,1,0.00%,1,0,100.00%
mail.wolasoasa.ml,1,0.00%,1,0,100.00%
cloud.upmb.co.ug,1,0.00%,1,0,100.00%
news.winno.app,1,0.00%,1,0,100.00%
mail.humt.ga,1,0.00%,1,0,100.00%
blog.ofionline.com,1,0.00%,1,0,100.00%
boer.konsertina.com,1,0.00%,1,0,100.00%
e15203.dscb.akamaiedge.net.0.1.cn.akamaiedge.net,1,0.00%,2,1,50.00%
mail.empowerarts.net,1,0.00%,1,0,100.00%
1608223851.D4EE071FA772.device.hiwifi.com,1,0.00%,1,0,100.00%
slp2p-east-std35.oray.net,1,0.00%,1,0,100.00%
let.mefly.cf,1,0.00%,1,0,100.00%
slp2p-east-std101.oray.net,1,0.00%,1,0,100.00%
store.getupg.com,1,0.00%,1,0,100.00%
crash.browser.360.cn,1,0.00%,1,0,100.00%
cdn2.1xxx.pro,1,0.00%,1,0,100.00%
voipfinderliveplay.wxqcloud.qq.com.l4vip-dk.sched.dcloudlive.com.clive.jsq.ho-wan.cn,1,0.00%,2,1,50.00%
shivachen8.direct.quickconnect.to,1,0.00%,1,0,100.00%
blackhole-m.m.jd.com.gslb.qianxun.com,1,0.00%,3,2,33.33%
uc.ireader.com,1,0.00%,7,6,14.29%
fts.jd.com.gslb.qianxun.com,1,0.00%,1,0,100.00%
h5speed.m.jd.com.gslb.qianxun.com,1,0.00%,1,0,100.00%
www.guancha.cn,1,0.00%,2,1,50.00%
v.admaster.com.cn,1,0.00%,1,0,100.00%
sc.guancha.cn,1,0.00%,1,0,100.00%
user.guancha.cn,1,0.00%,2,1,50.00%
ps-w-s.applk.cn,1,0.00%,1,0,100.00%
maux.alu-web.de,1,0.00%,1,0,100.00%
ec3-core-lf.ecombdapi.com,1,0.00%,1,0,100.00%
api5-core-c-lf.amemv.com,1,0.00%,1,0,100.00%
polaris3-normal-lf.zijieapi.com,1,0.00%,3,2,33.33%
webcast5-normal-c-lf.amemv.com,1,0.00%,1,0,100.00%
lf26-dy-cdn-tos.bytegecko.com,1,0.00%,1,0,100.00%
optimus-ads.amap.com.w.alikunlun.com,1,0.00%,3,2,33.33%
mapdownload.autonavi.com.danuoyi.tbcache.com,1,0.00%,4,3,25.00%
h5.m.youzan.com,1,0.00%,1,0,100.00%
tj1.youzanyun.com,1,0.00%,1,0,100.00%
ranta.m.youzan.com,1,0.00%,1,0,100.00%
tj.youzan.com,1,0.00%,1,0,100.00%
shop18071305.m.youzan.com,1,0.00%,1,0,100.00%
img.yzcdn.cn,1,0.00%,1,0,100.00%
rpc-global.znly.co,1,0.00%,1,0,100.00%
feedback.ramict.dev,1,0.00%,1,0,100.00%
dev.launchnow.org,1,0.00%,1,0,100.00%
edge-http.microsoft.com,1,0.00%,2,1,50.00%
only-52097-124-16-140-20.nstool.321fenx.com,1,0.00%,1,0,100.00%
1610078712.D4EE073C2A20.device.hiwifi.com,1,0.00%,1,0,100.00%
a.listary.com,1,0.00%,1,0,100.00%
device.auth.xboxlive.com,1,0.00%,34,33,2.94%
hn2.maikrappss.xyz,1,0.00%,1,0,100.00%
WwW.VoD.LXdNS.COm,1,0.00%,2,1,50.00%
affiliates.hz.sr971.esys.live,1,0.00%,1,0,100.00%
iscas1-my.sharepoint.cn,1,0.00%,201,200,0.50%
track.cnki.net,1,0.00%,1,0,100.00%
blacklist.tampermonkey.net,1,0.00%,2,1,50.00%
1608223911.D4EE071FA772.device.hiwifi.com,1,0.00%,1,0,100.00%
offers.replacementwindowserie.com,1,0.00%,1,0,100.00%
staging.mycadillacprotection.com,1,0.00%,1,0,100.00%
acquire.privy-staging-pr-2691.privy-staging.com,1,0.00%,1,0,100.00%
t.csrg.ga,1,0.00%,1,0,100.00%
hk.woshixp2020.tk,1,0.00%,1,0,100.00%
api.changba.com,1,0.00%,1,0,100.00%
res.cdn.changbaimg.com,1,0.00%,2,1,50.00%
res.cdn.changbaimg.com.w.cdngslb.com,1,0.00%,2,1,50.00%
www.qchannel01.cn,1,0.00%,1,0,100.00%
changba.com,1,0.00%,1,0,100.00%
z5j3pihy.dayugslb.com,1,0.00%,1,0,100.00%
papi.changba.com,1,0.00%,1,0,100.00%
api-bj-ha.changba.com,1,0.00%,1,0,100.00%
lc.zt.changba.com,1,0.00%,1,0,100.00%
edge.wshttpdns.com.wswebpic.com,1,0.00%,1,0,100.00%
aliimg.changbalive.com.w.kunlunar.com,1,0.00%,1,0,100.00%
direct.frontier-lark-lb-v3.hl.bytelb.net,1,0.00%,1,0,100.00%
direct.frontier-lark-lb-v3.lf.bytelb.net,1,0.00%,1,0,100.00%
www.scio.gov.cn,1,0.00%,121,120,0.83%
mail.nbq.ae,1,0.00%,1,0,100.00%
garytyler.gallerycdn.azure.cn,1,0.00%,1,0,100.00%
kevinrose.gallerycdn.azure.cn,1,0.00%,1,0,100.00%
ionutvmi.gallerycdn.azure.cn,1,0.00%,1,0,100.00%
magicstack.gallerycdn.azure.cn,1,0.00%,1,0,100.00%
mail.firstfidelityfs.com,1,0.00%,1,0,100.00%
sentry.deepl.com,1,0.00%,1,0,100.00%
src1.leju.com,1,0.00%,1,0,100.00%
ess6.leju.com,1,0.00%,1,0,100.00%
ess3.leju.com,1,0.00%,1,0,100.00%
bj.leju.com,1,0.00%,1,0,100.00%
img.mix.sina.com.cn,1,0.00%,1,0,100.00%
adm.leju.com,1,0.00%,1,0,100.00%
top.finance.sina.com.cn,1,0.00%,1,0,100.00%
top.edu.sina.com.cn,1,0.00%,1,0,100.00%
hemptown-baptist-church.websrvcs.com,1,0.00%,1,0,100.00%
wWW.voD.lXdnS.CoM,1,0.00%,2,1,50.00%
apph.wpsmail.net,1,0.00%,1,0,100.00%
app.hnzycfc.com,1,0.00%,1,0,100.00%
lf9-mgsdk-sign.dailygn.com,1,0.00%,2,1,50.00%
lf6-mgsdk-sign.dailygn.com,1,0.00%,2,1,50.00%
lf3-mgsdk-sign.dailygn.com,1,0.00%,2,1,50.00%
e13678.dscg.akamaiedge.net,1,0.00%,2,1,50.00%
ckie.researchchina.cn,1,0.00%,1,0,100.00%
wi-consortium.org,1,0.00%,1,0,100.00%
5b0988e595225.cdn.sohucs.com,1,0.00%,3,2,33.33%
p2.itc.cn,1,0.00%,3,2,33.33%
img.mp.sohu.com,1,0.00%,3,2,33.33%
linux-updatecollect.wps.cn,1,0.00%,1,0,100.00%
ipv6check-http.steamcontent.com,1,0.00%,60,59,1.67%
decotv.com.tw,1,0.00%,1,0,100.00%
allamericanmovers.movebooker.app,1,0.00%,1,0,100.00%
cdn77-vid-mp4.xvideos-cdn.com,1,0.00%,1,0,100.00%
conn-service-cn-03.allawntech.com,1,0.00%,1,0,100.00%
cloudkit-api-cn.heytapmobi.com,1,0.00%,1,0,100.00%
e2cs09.gcp.gvt2.com,1,0.00%,1,0,100.00%
e2c29.gcp.gvt2.com,1,0.00%,1,0,100.00%
fshrv-cmpzourl.maillist-manage.com,1,0.00%,1,0,100.00%
s1764.t.eloqua.com,1,0.00%,1,0,100.00%
freescale.d2.sc.omtrdc.net,1,0.00%,1,0,100.00%
www.nxp.com.cn,1,0.00%,1,0,100.00%
p55-imap.mail.me.com.akadns.net,1,0.00%,1,0,100.00%
3a3be1cb7867f62a93c8a09d6784c1a8.dlied1.cdntips.net,1,0.00%,1,0,100.00%
534dbbbf246b702affa2145d24beee00.dlied1.cdntips.net,1,0.00%,1,0,100.00%
apphq.longhuvip.com,1,0.00%,1,0,100.00%
sd.cname3.getui.com,1,0.00%,2,1,50.00%
cm-10-33.getui.com,1,0.00%,1,0,100.00%
hmma.e.shifen.com,1,0.00%,8,7,12.50%
apppage.longhuvip.com,1,0.00%,1,0,100.00%
roxy.azurefd.net,1,0.00%,1,0,100.00%
api.taoguba.com.cn,1,0.00%,1,0,100.00%
image.taoguba.com.cn,1,0.00%,1,0,100.00%
connect.facebook.net,1,0.00%,5,4,20.00%
nuxt.cdn.readpaper.com,1,0.00%,2,1,50.00%
openapi.bangdao-tech.com,1,0.00%,1,0,100.00%
test-publicservice.bangdao-tech.com,1,0.00%,1,0,100.00%
sdr-admin-siteease.bangdao-tech.com,1,0.00%,1,0,100.00%
a0.app.xiaomi.com,1,0.00%,1,0,100.00%
console-base.log-global.aliyuncs.com.w.cdngslb.com,1,0.00%,1,0,100.00%
s.aliyun.com,1,0.00%,1,0,100.00%
contract-console.aliyun.com,1,0.00%,1,0,100.00%
expense-invoice.aliyun.com,1,0.00%,1,0,100.00%
pn.baidu.com,1,0.00%,3,2,33.33%
dns.jd.com,1,0.00%,2,1,50.00%
dvod.300hu.com,1,0.00%,2,1,50.00%
pecas.las.ac.cn,1,0.00%,1,0,100.00%
apac-taiwan-courier-4.push-apple.com.akadns.net,1,0.00%,1,0,100.00%
images.sohu.com,1,0.00%,3,2,33.33%
643108e7617ef.cdn.sohucs.com,1,0.00%,4,3,25.00%
js.softdl.360tpcdn.com,1,0.00%,2,1,50.00%
us.creativecdn.com,1,0.00%,1,0,100.00%
r2.sn-2x3elnel.gvt1.com,1,0.00%,1,0,100.00%
oimagea7.ydstatic.com,1,0.00%,1,0,100.00%
oimageb6.ydstatic.com,1,0.00%,1,0,100.00%
log.study.163.com,1,0.00%,1,0,100.00%
c.youdao.com,1,0.00%,2,1,50.00%
www.icourse163.org,1,0.00%,1,0,100.00%
s6.cnzz.com,1,0.00%,1,0,100.00%
s2.stu.126.net,1,0.00%,1,0,100.00%
chat.study.163.com,1,0.00%,1,0,100.00%
crumb.soboten.com,1,0.00%,1,0,100.00%
errorlog.sobot.com,1,0.00%,1,0,100.00%
manage.onceprojects.ga,1,0.00%,1,0,100.00%
app.getexos.com,1,0.00%,1,0,100.00%
api.herewesell.online,1,0.00%,1,0,100.00%
srn.wikipedia.ahau.cf,1,0.00%,1,0,100.00%
www.angelesmex.com,1,0.00%,1,0,100.00%
ys.epicbrowser.com,1,0.00%,1,0,100.00%
api.xuechebu.com,1,0.00%,1,0,100.00%
xcbapi.xuechebu.com,1,0.00%,1,0,100.00%
cndl.synology.cn,1,0.00%,1,0,100.00%
www.taoguba.com.cn,1,0.00%,1,0,100.00%
rc10-g3.oray.com,1,0.00%,1,0,100.00%
bbs.csdn.net,1,0.00%,1,0,100.00%
mp-action.csdn.net,1,0.00%,1,0,100.00%
mdap.alipaylog.com,1,0.00%,1,0,100.00%
p26.toutiaoimg.com,1,0.00%,2,1,50.00%
ttwid.bytedance.com,1,0.00%,1,0,100.00%
v2.chromehelper.net,1,0.00%,1,0,100.00%
dynamodb.us-east-1.amazonaws.com,1,0.00%,1,0,100.00%
dynamodb.us-west-1.amazonaws.com,1,0.00%,1,0,100.00%
dynamodb.eu-west-3.amazonaws.com,1,0.00%,1,0,100.00%
a2pvideo-drcn.dbankcdn.cn,1,0.00%,1,0,100.00%
nl-ams.veryamt.com,1,0.00%,1,0,100.00%
perf.m.jd.com,1,0.00%,2,1,50.00%
h5.m.jd.com,1,0.00%,2,1,50.00%
plogin.m.jd.com,1,0.00%,2,1,50.00%
edas.info,1,0.00%,2,1,50.00%
cdn.tiny.cloud,1,0.00%,2,1,50.00%
trustcom-2022.edas.info,1,0.00%,2,1,50.00%
sp.tinymce.com,1,0.00%,1,0,100.00%
rc10biz.oray.com,1,0.00%,1,0,100.00%
sah3neey.nodedata.net,1,0.00%,1,0,100.00%
files.dongao.com,1,0.00%,1,0,100.00%
v.trustutn.org,1,0.00%,1,0,100.00%
icon.cecdc.com,1,0.00%,1,0,100.00%
help.dongao.com,1,0.00%,1,0,100.00%
credit.szfw.org,1,0.00%,1,0,100.00%
www.dongao.com,1,0.00%,1,0,100.00%
jxjycwsc.dongao.com,1,0.00%,1,0,100.00%
icauh.youdao.com,1,0.00%,1,0,100.00%
tx-sh-live-p2p-01.chat.bilibili.com,1,0.00%,1,0,100.00%
snapshots-tezos.giganode.io,1,0.00%,1,0,100.00%
res21.traffer.net,1,0.00%,1,0,100.00%
gloria.com.gr,1,0.00%,1,0,100.00%
partners-api.torchlite.com,1,0.00%,1,0,100.00%
nutrislice-error-pages.s3.amazonaws.com,1,0.00%,1,0,100.00%
blog.eliteflyers.com,1,0.00%,1,0,100.00%
singlepass-375864791403-client-data.s3.amazonaws.com,1,0.00%,1,0,100.00%
bitwarden.nand.io,1,0.00%,1,0,100.00%
mail.tileclape.tk,1,0.00%,1,0,100.00%
pgysle-client-adv01.oray.net,1,0.00%,1,0,100.00%
openapp.wpscdn.cn.qiniudns.com,1,0.00%,3,2,33.33%
slp2p-east-std71.oray.net,1,0.00%,1,0,100.00%
castoffs.herokuapp.com,1,0.00%,1,0,100.00%
slp2p-east-std37.oray.net,1,0.00%,1,0,100.00%
v2.speedstunnel.com,1,0.00%,1,0,100.00%
581b9a34bc2953ce00f1212d0d7285c5.safeframe.googlesyndication.com,1,0.00%,1,0,100.00%
appstore.foxitsoftware.cn,1,0.00%,1,0,100.00%
www-cn.connectedpdf.com,1,0.00%,1,0,100.00%
platform-cn.foxitcloud.com,1,0.00%,1,0,100.00%
config-cn.connectedpdf.com,1,0.00%,1,0,100.00%
cws-cn.connectedpdf.com,1,0.00%,1,0,100.00%
wemeet.ctrl.qq.com,1,0.00%,1,0,100.00%
onedriveclucproddm20015.blob.core.windows.net,1,0.00%,1,0,100.00%
g.us.sinaimg.cn,1,0.00%,12,11,8.33%
media.davebaar.com,1,0.00%,1,0,100.00%
hit.uptrendsdata.com,1,0.00%,1,0,100.00%
blog.tianjinkun.com,1,0.00%,1,0,100.00%
www.ccleaner.com,1,0.00%,2,1,50.00%
keyvalueservice.fe.apple-dns.net,1,0.00%,2,1,50.00%
cxd.herokuapp.com,1,0.00%,1,0,100.00%
sxqkxvqgnrbdi.masiruju.cz,1,0.00%,1,0,100.00%
devteste.com.br,1,0.00%,1,0,100.00%
mail.mtd-tg.de,1,0.00%,1,0,100.00%
s3.fx.kgimg.com,1,0.00%,1,0,100.00%
p1.fx.kgimg.com,1,0.00%,1,0,100.00%
cozycountryredirectiv.addons.business,1,0.00%,1,0,100.00%
activity.pdf365.cn,1,0.00%,1,0,100.00%
tmfmazu4.m.qq.com,1,0.00%,1,0,100.00%
ins-hbkhjmd8.ias.tencent-cloud.net,1,0.00%,1,0,100.00%
www.lianmenhu.com,1,0.00%,1,0,100.00%
g.dtv.cn.miaozhen.com,1,0.00%,1,0,100.00%
sdk.alibaba.com.ailbaba.me,1,0.00%,1,0,100.00%
slp2p-east-std09.oray.net,1,0.00%,1,0,100.00%
b5b0ab47-fc00-46fa-82af-f8b038c91862.booqable.shop,1,0.00%,1,0,100.00%
smart-train.co.nz,1,0.00%,1,0,100.00%
poly.marais.co,1,0.00%,1,0,100.00%
oddular-core.s3.amazonaws.com,1,0.00%,1,0,100.00%
ce7602.softether.net,1,0.00%,1,0,100.00%
atlas.hypernet.ch,1,0.00%,1,0,100.00%
data6.video.iqiyi.com,1,0.00%,64,63,1.56%
tocaitlinlchandler.clippings.me,1,0.00%,1,0,100.00%
old.metalinjection.net,1,0.00%,1,0,100.00%
us1809.tomnode.com,1,0.00%,1,0,100.00%
mail.ukknowlegefree88.tk,1,0.00%,1,0,100.00%
dash.pixelmachinery.com,1,0.00%,1,0,100.00%
ns-365.awsdns-45.com,1,0.00%,2,1,50.00%
auth.techniknews.net,1,0.00%,1,0,100.00%
token-drcn.push.dbankcloud.com,1,0.00%,1,0,100.00%
conf.psvr.wps.cn,1,0.00%,1,0,100.00%
api.data.mgtv.com,1,0.00%,1,0,100.00%
xnet.da.mgtv.com,1,0.00%,1,0,100.00%
union.api.mgtv.com,1,0.00%,1,0,100.00%
hunantv-mipdx.cn.miaozhen.com,1,0.00%,1,0,100.00%
dsun.log.mgtv.com,1,0.00%,1,0,100.00%
d7.wzip.ru,1,0.00%,1,0,100.00%
jingyan.n.shifen.com,1,0.00%,3,2,33.33%
webmail.banbanli.net,1,0.00%,1,0,100.00%
default.tdatamaster.com,1,0.00%,10,9,10.00%
crashreport.smartisan.com,1,0.00%,1,0,100.00%
m-cdn-lv.topsports.com.cn,1,0.00%,1,0,100.00%
shzzzhk.eucdurl.me,1,0.00%,1,0,100.00%
firebaselogging-pa.mihoyo.com,1,0.00%,1,0,100.00%
ns1.xolos.com.mx,1,0.00%,1,0,100.00%
manaka.1berdu.my.id,1,0.00%,1,0,100.00%
i-dm2p-cor090.api.p001.1drv.com,1,0.00%,1,0,100.00%
embed.uphex.com,1,0.00%,1,0,100.00%
40.getambassador.com,1,0.00%,1,0,100.00%
pdp.gomultitaskr.com,1,0.00%,1,0,100.00%
a.anlu.cf,1,0.00%,1,0,100.00%
cvss2022.gakkai.online,1,0.00%,1,0,100.00%
sf1-cdn-tos.huoshanstatic.com,1,0.00%,2,1,50.00%
secureapi.samqaicongen.com,1,0.00%,1,0,100.00%
cpu-openapi.baidu.com,1,0.00%,2,1,50.00%
contentsblock.samqaicongen.com,1,0.00%,1,0,100.00%
adx.ad-survey.com,1,0.00%,1,0,100.00%
input.theta.sogou.com,1,0.00%,1,0,100.00%
sf3-ttcdn-tos.pstatp.com,1,0.00%,2,1,50.00%
sdk.verification.jiguang.cn,1,0.00%,1,0,100.00%
galaxystore.ad-survey.com,1,0.00%,1,0,100.00%
dl.min.io,1,0.00%,1,0,100.00%
handbook.thatweblook.co.uk,1,0.00%,1,0,100.00%
siira.wanhala.net,1,0.00%,1,0,100.00%
search.extfans.com,1,0.00%,3,2,33.33%
pull-flv-f6-xg.bytecdn.cn,1,0.00%,1,0,100.00%
pull-rtmp-hs-l6-xg.ixigua.com,1,0.00%,1,0,100.00%
pull-f3-xg.bytecdn.cn,1,0.00%,1,0,100.00%
pull-rtmp-l6-xg.ixigua.com,1,0.00%,1,0,100.00%
pull-hs-f5-xg.flive.ixigua.com,1,0.00%,1,0,100.00%
pull-rtmp-l1-xg.bytecdn.cn,1,0.00%,1,0,100.00%
pull-hs-l3-xg.ixigua.com,1,0.00%,1,0,100.00%
pull-flv-l11.ixigua.com,1,0.00%,1,0,100.00%
pull-rtmp-hs-l1-xg.ixigua.com,1,0.00%,1,0,100.00%
pull-rtmp-l1-xg.ixigua.com,1,0.00%,1,0,100.00%
pull-flv-l6-xg.ixigua.com,1,0.00%,1,0,100.00%
pull-rtmp-l11.ixigua.com,1,0.00%,1,0,100.00%
pull-flv-l1-xg.bytecdn.cn,1,0.00%,1,0,100.00%
pull-l3-xg.ixigua.com,1,0.00%,1,0,100.00%
pull-flv-hs-l6-xg.ixigua.com,1,0.00%,1,0,100.00%
pull-rtmp-f6-xg.bytecdn.cn,1,0.00%,1,0,100.00%
pull-flv-l1-xg.ixigua.com,1,0.00%,1,0,100.00%
pull-f5-xg.bytecdn.cn,1,0.00%,1,0,100.00%
pull-flv-hs-l1-xg.ixigua.com,1,0.00%,1,0,100.00%
ta.pinduoduo.com,1,0.00%,1,0,100.00%
ccdn.pddpic.com,1,0.00%,1,0,100.00%
citeseerx.ist.psu.edu,1,0.00%,1,0,100.00%
only-417228-124-16-139-61.nstool.321fenx.com,1,0.00%,1,0,100.00%
cc.cdn.civiccomputing.com,1,0.00%,1,0,100.00%
forge.speedtest.cn,1,0.00%,1,0,100.00%
cntwlayer1.standurl.xyz,1,0.00%,1,0,100.00%
colleen-m-olson.luxuryrealestate.com,1,0.00%,1,0,100.00%
data.jsdelivr.com,1,0.00%,3,2,33.33%
laskuri.storeys.fi,1,0.00%,1,0,100.00%
shouji.sogou.com,1,0.00%,1,0,100.00%
www.qwant.com,1,0.00%,1,0,100.00%
srchstatic.imtt.qq.com,1,0.00%,2,1,50.00%
gp.bizool.com,1,0.00%,1,0,100.00%
gbres.dfcfw.com,1,0.00%,50,49,2.00%
n7,1,0.00%,1,0,100.00%
n5,1,0.00%,1,0,100.00%
n4,1,0.00%,1,0,100.00%
n2,1,0.00%,1,0,100.00%
n6,1,0.00%,1,0,100.00%
nthwrestling.teamsitesnow.com,1,0.00%,1,0,100.00%
gxh2.kuwo.cn,1,0.00%,1,0,100.00%
www.kuwo.cn,1,0.00%,1,0,100.00%
ipdomainserver.kuwo.cn,1,0.00%,1,0,100.00%
mobilead.kuwo.cn,1,0.00%,1,0,100.00%
logwebs.kugou.com,1,0.00%,1,0,100.00%
sf0.market.xiaomi.com,1,0.00%,2,1,50.00%
t13img.yangkeduo.com,1,0.00%,2,1,50.00%
commfile.pddpic.com,1,0.00%,2,1,50.00%
push-resources.sched.dma.tdnsdl1.cn,1,0.00%,1,0,100.00%
www.iefans.net,1,0.00%,1,0,100.00%
p.mybib.com,1,0.00%,1,0,100.00%
static.youku.com.w.kunlunar.com,1,0.00%,2,1,50.00%
static.youku.com,1,0.00%,3,2,33.33%
rtb.com.ru,1,0.00%,1,0,100.00%
direwolf-307c10087a.herokuapp.com,1,0.00%,1,0,100.00%
api.officeaid.com,1,0.00%,1,0,100.00%
apsides-smoot-apne1c.v.aaplimg.com,1,0.00%,1,0,100.00%
1610369527.D4EE073396E8.device.hiwifi.com,1,0.00%,1,0,100.00%
fx-it.66rpg.com,1,0.00%,1,0,100.00%
cc88ce5d544329a8624468fcf48235d9.clo.footprintdns.com,1,0.00%,1,0,100.00%
adsfs-sdkconfig.heytapimage.com,1,0.00%,1,0,100.00%
admin.ifinca.co,1,0.00%,1,0,100.00%
iterable-connector.herokuapp.com,1,0.00%,1,0,100.00%
gitlab.ititour.com,1,0.00%,1,0,100.00%
iocaffcdn.phphub.org,1,0.00%,1,0,100.00%
angsviksgarden.collective.tools,1,0.00%,1,0,100.00%
pdns196.ultradns.co.uk,1,0.00%,2,1,50.00%
1610333526.D4EE073396E8.device.hiwifi.com,1,0.00%,1,0,100.00%
1610333552.D4EE073396E8.device.hiwifi.com,1,0.00%,1,0,100.00%
1610333578.D4EE073396E8.device.hiwifi.com,1,0.00%,1,0,100.00%
internal.faceunity.com,1,0.00%,1,0,100.00%
mmres-cdn-sslauth.jiefeixinxij.top,1,0.00%,1,0,100.00%
cm.ctnsnet.com,1,0.00%,1,0,100.00%
forum.askmiddlewareexpert.com,1,0.00%,1,0,100.00%
cfg-1.pddpic.com,1,0.00%,3,2,33.33%
wWW.Vod.lxDNs.coM,1,0.00%,2,1,50.00%
bds.snssdk.com,1,0.00%,1,0,100.00%
zgsdk.zhugeio.com,1,0.00%,1,0,100.00%
assets.processon.com,1,0.00%,1,0,100.00%
img.processon.com,1,0.00%,1,0,100.00%
web.docer.wpscdn.cn,1,0.00%,2,1,50.00%
app.skp-beijing.com,1,0.00%,1,0,100.00%
m7.lefile.cn,1,0.00%,1,0,100.00%
wp.qiye.qq.com,1,0.00%,1,0,100.00%
img.bosszhipin.com,1,0.00%,2,1,50.00%
www.coder.work,1,0.00%,1,0,100.00%
job.ucas.ac.cn,1,0.00%,1,0,100.00%
server.cadaverexquisito.online,1,0.00%,1,0,100.00%
green.alvinxu.ga,1,0.00%,1,0,100.00%
hb.jixie.io,1,0.00%,1,0,100.00%
vip.jsjinfu.com,1,0.00%,1,0,100.00%
img.lionshome.it,1,0.00%,1,0,100.00%
d1br91wyosz8a9.cloudfront.net,1,0.00%,1,0,100.00%
chatlink-yqsx08.netease.im,1,0.00%,1,0,100.00%
direwolf-06a7fa36ef.herokuapp.com,1,0.00%,1,0,100.00%
1610060630.D4EE073C2A20.device.hiwifi.com,1,0.00%,1,0,100.00%
cdn.doubleverify.com,1,0.00%,2,1,50.00%
dm-sg.hybrid.ai,1,0.00%,1,0,100.00%
blog.edufinet.com,1,0.00%,1,0,100.00%
cLIENtlOgVODp2p.haplaT.Net,1,0.00%,1,0,100.00%
TrANSit1.WsLoG.CHiNANEtCENter.cOM,1,0.00%,1,0,100.00%
catdot.dianping.com,1,0.00%,15,14,6.67%
dpmtpush.dianping.com,1,0.00%,4,3,25.00%
api.neixin.cn,1,0.00%,10,9,10.00%
d16ehd6wpytnwf.cloudfront.net,1,0.00%,1,0,100.00%
only-302157-124-16-137-194.nstool.netease.com,1,0.00%,1,0,100.00%
comment4.news.sina.com.cn,1,0.00%,1,0,100.00%
cn-jssz-cm-02-13.bilivideo.com,1,0.00%,1,0,100.00%
hzwwx.hangzhou.com.cn,1,0.00%,1,0,100.00%
go.mocomarketplace.com,1,0.00%,1,0,100.00%
stg.bluebird.ac,1,0.00%,1,0,100.00%
mx20.mailspamprotection.com,1,0.00%,1,0,100.00%
mx10.mailspamprotection.com,1,0.00%,1,0,100.00%
school.usefedorastage-pr-9679.devenv.website,1,0.00%,1,0,100.00%
slp2p-east-std1057.oray.net,1,0.00%,1,0,100.00%
hel-mvp.trafficmanager.net,1,0.00%,2,1,50.00%
ngo.minigame.qq.com,1,0.00%,1,0,100.00%
granadero.sperant.com,1,0.00%,1,0,100.00%
tlt-umoja.sparkmeter.cloud,1,0.00%,1,0,100.00%
mipt-mirror.adnote.cn.jikedata.com,1,0.00%,1,0,100.00%
ad.mipt.cn,1,0.00%,1,0,100.00%
87b54aa6.hyperbeam.com,1,0.00%,1,0,100.00%
form.so-estates.be,1,0.00%,1,0,100.00%
ucmp-static.sf-express.com,1,0.00%,1,0,100.00%
ucmp.sf-express.com,1,0.00%,1,0,100.00%
ext.immomo.com,1,0.00%,1,0,100.00%
ubs.sf-express.com,1,0.00%,1,0,100.00%
sfpay.sf-express.com,1,0.00%,1,0,100.00%
west.smtp.mx.exch091.serverdata.net,1,0.00%,1,0,100.00%
fw.dnsforwardingservice.com,1,0.00%,1,0,100.00%
east.smtp.mx.exch091.serverdata.net,1,0.00%,1,0,100.00%
e2cs38.gcp.gvt2.com,1,0.00%,1,0,100.00%
leplayer.vgs.lenovo.com.cn,1,0.00%,1,0,100.00%
28886554.s21i.faiusr.com,1,0.00%,1,0,100.00%
hw.p2p.huya.com,1,0.00%,3,2,33.33%
aecdbrjtfr3f77wh.node.ppio.cloud,1,0.00%,1,0,100.00%
aecopg6t5otqsggf.node.ppio.cloud,1,0.00%,1,0,100.00%
aecj43wkshhciaya.node.ppio.cloud,1,0.00%,1,0,100.00%
aecbysyam7wp7so4.node.ppio.cloud,1,0.00%,1,0,100.00%
aecpxebgr3vxs7ju.node.ppio.cloud,1,0.00%,1,0,100.00%
aeckbwdwshbtbjhi.node.ppio.cloud,1,0.00%,1,0,100.00%
fld.funshion.com,1,0.00%,1,0,100.00%
aecebpgesg6n7rw2.node.ppio.cloud,1,0.00%,1,0,100.00%
aecbgsx4fkesbldr.node.ppio.cloud,1,0.00%,1,0,100.00%
d11ir4eijp84g9.cloudfront.net,1,0.00%,2,1,50.00%
aecjsr4r4ykjexm4.node.ppio.cloud,1,0.00%,1,0,100.00%
aeckgmdxy3diim67.node.ppio.cloud,1,0.00%,1,0,100.00%
aech26yn55jggqh5.node.ppio.cloud,1,0.00%,1,0,100.00%
aecccixwu34tc3qc.node.ppio.cloud,1,0.00%,1,0,100.00%
ts.khd.2345.cc,1,0.00%,1,0,100.00%
zh.wikipedia.org,1,0.00%,2,1,50.00%
admin.stg.pointc.com,1,0.00%,1,0,100.00%
www.z.cn,1,0.00%,1,0,100.00%
ali-bj-pcdn-31.biliapi.net,1,0.00%,1,0,100.00%
mail.blush-bar.com,1,0.00%,1,0,100.00%
mail.santatoyshop.ga,1,0.00%,1,0,100.00%
direwolf-62c279c13c.herokuapp.com,1,0.00%,1,0,100.00%
direwolf-57d953dba8.herokuapp.com,1,0.00%,1,0,100.00%
infrastructure-command-api.newrelic.com,1,0.00%,1,0,100.00%
pushimg.com,1,0.00%,1,0,100.00%
ghostyapi.herokuapp.com,1,0.00%,1,0,100.00%
young.getambassador.com,1,0.00%,1,0,100.00%
cpanel.polk.tk,1,0.00%,1,0,100.00%
mail.cierenvo.tk,1,0.00%,1,0,100.00%
grupostandex.com.mx,1,0.00%,1,0,100.00%
ns12.gdnsdef.com,1,0.00%,1,0,100.00%
dham.ybdbruk.cn,1,0.00%,1,0,100.00%
obs.lz04-br-inet.cn-south-1.myhuaweicloud.cn,1,0.00%,1,0,100.00%
obs.lz04-br-inet.cn-east-3.myhuaweicloud.cn,1,0.00%,1,0,100.00%
ip-fo-ovh.infra.leadplace.fr,1,0.00%,1,0,100.00%
pixel-eu.rubiconproject.net.akadns.net,1,0.00%,1,0,100.00%
ssbsync-apac1.smartadserver.com,1,0.00%,1,0,100.00%
onboarding.dewi.org,1,0.00%,1,0,100.00%
cdnizy.updrv.com,1,0.00%,1,0,100.00%
m1kgshow.kugou.com,1,0.00%,2,1,50.00%
p3-pc-sign.douyinpic.com,1,0.00%,4,3,25.00%
cn.winmate.com.tw,1,0.00%,1,0,100.00%
gtm-sg-6wr2tkcds0k.gtm-i1d2.com,1,0.00%,1,0,100.00%
gtm-sg-4hr2tj27j0t.gtm-i1d2.com,1,0.00%,1,0,100.00%
music.desperadoj.com,1,0.00%,1,0,100.00%
e2cs30.gcp.gvt2.com,1,0.00%,1,0,100.00%
e2c9.gcp.gvt2.com,1,0.00%,1,0,100.00%
v1.addthisedge.com,1,0.00%,1,0,100.00%
uit.univercity.io,1,0.00%,1,0,100.00%
produkte.pallmann.eu,1,0.00%,1,0,100.00%
1376117605-server.va.huya.com,1,0.00%,1,0,100.00%
www.hoyyon.com,1,0.00%,1,0,100.00%
www.ehschina.org,1,0.00%,1,0,100.00%
www.epa.gov,1,0.00%,2,1,50.00%
afd.baidu.com,1,0.00%,1,0,100.00%
rpe.xdplt.com,1,0.00%,1,0,100.00%
img3.appinn.net,1,0.00%,3,2,33.33%
eclick.360doc.com,1,0.00%,1,0,100.00%
imageplus.baidu.com,1,0.00%,1,0,100.00%
api.360doc.com,1,0.00%,1,0,100.00%
blockart.360doc.com,1,0.00%,1,0,100.00%
pay.360doc.com,1,0.00%,1,0,100.00%
account.360doc.com,1,0.00%,1,0,100.00%
ip0467472085.livehwc3.cn,1,0.00%,1,0,100.00%
wwW.VOd.Lxdns.COM,1,0.00%,2,1,50.00%
maMBAp2PVOdmObILE.8686c.Com,1,0.00%,2,1,50.00%
pear.horde.org,1,0.00%,1,0,100.00%
direwolf-65b5c9822f.herokuapp.com,1,0.00%,1,0,100.00%
juridico.sengerj.org.br,1,0.00%,1,0,100.00%
dns3.easydns.org,1,0.00%,6,5,16.67%
jp2.oneword.ml,1,0.00%,1,0,100.00%
webmail.ibmns-ahead.cf,1,0.00%,1,0,100.00%
d.zmdgjprj.com,1,0.00%,1,0,100.00%
northwestflorida.uso.org,1,0.00%,1,0,100.00%
pic.vcp.tw,1,0.00%,1,0,100.00%
plus.tourispo.com,1,0.00%,1,0,100.00%
xznh.pilot-supports.net,1,0.00%,1,0,100.00%
txqfch.dtimeflies.org,1,0.00%,1,0,100.00%
topeka.roofingproservices.com,1,0.00%,1,0,100.00%
anywhere.iqpro.com,1,0.00%,1,0,100.00%
1608223800.D4EE071FA772.device.hiwifi.com,1,0.00%,1,0,100.00%
1608223861.D4EE071FA772.device.hiwifi.com,1,0.00%,1,0,100.00%
e-jp.cmcd1.com,1,0.00%,1,0,100.00%
csync.smartadserver.com,1,0.00%,2,1,50.00%
a577.dscb.akamai.net,1,0.00%,2,1,50.00%
ced-ns.sascdn.com,1,0.00%,2,1,50.00%
a1845.dscb.akamai.net,1,0.00%,2,1,50.00%
prod.appnexus.map.fastly.net,1,0.00%,1,0,100.00%
betweendigital.cdnvideo.ru,1,0.00%,1,0,100.00%
static.smilewanted.com,1,0.00%,1,0,100.00%
widget.am5.vip.prod.criteo.com,1,0.00%,1,0,100.00%
acm-stoc.org,1,0.00%,1,0,100.00%
blob.bnz10prdstr09a.store.core.windows.net,1,0.00%,1,0,100.00%
huan.folaifa.tk,1,0.00%,1,0,100.00%
api.rpmtwchat.ga,1,0.00%,1,0,100.00%
au04.graniterapids.com,1,0.00%,1,0,100.00%
yoga.staging.triptribe.com,1,0.00%,1,0,100.00%
shihuo.hupucdn.com,1,0.00%,1,0,100.00%
w3.hoopchina.com.cn,1,0.00%,2,1,50.00%
w2.hoopchina.com.cn,1,0.00%,2,1,50.00%
aecaqx4mgoijvs45.node.ppio.cloud,1,0.00%,1,0,100.00%
static2.51cto.com,1,0.00%,1,0,100.00%
s2.51cto.com,1,0.00%,1,0,100.00%
s1.51cto.com,1,0.00%,1,0,100.00%
jwh.daxigua.xyz,1,0.00%,1,0,100.00%
support.huawei.com,1,0.00%,2,1,50.00%
conda.io,1,0.00%,14,13,7.14%
img.cdnpitbull.pl,1,0.00%,1,0,100.00%
www.nvidia.eu,1,0.00%,1,0,100.00%
www.influ2.com,1,0.00%,1,0,100.00%
app.mydrivers.com,1,0.00%,1,0,100.00%
www.newasp.net,1,0.00%,1,0,100.00%
weblearn.kaikeba.com,1,0.00%,1,0,100.00%
xiaoke.kaikeba.com,1,0.00%,1,0,100.00%
bbs.mydrivers.com,1,0.00%,1,0,100.00%
www.webmasterhome.cn,1,0.00%,1,0,100.00%
sentry.kaikeba.com,1,0.00%,1,0,100.00%
driver.zol.com.cn,1,0.00%,1,0,100.00%
file.antutu.com,1,0.00%,1,0,100.00%
www.51testing.com,1,0.00%,1,0,100.00%
www.9553.com,1,0.00%,2,1,50.00%
status.spectrio-staging.com,1,0.00%,1,0,100.00%
sn.sunridots.gq,1,0.00%,1,0,100.00%
bangkok-thai-food-2-co.hipierce.com,1,0.00%,1,0,100.00%
1608223927.D4EE071FA772.device.hiwifi.com,1,0.00%,1,0,100.00%
bunkyo.9nal.xyz,1,0.00%,1,0,100.00%
dsp.adfarm1.adition.com,1,0.00%,1,0,100.00%
lb.mediarithmics.com,1,0.00%,1,0,100.00%
bl1-ap.dyntrk.com,1,0.00%,1,0,100.00%
store.amatimodel.com,1,0.00%,1,0,100.00%
mail.0535767223624.tk,1,0.00%,1,0,100.00%
ask.qcloudimg.com,1,0.00%,1,0,100.00%
ali.android.speed.auth.vip.xunlei.com,1,0.00%,1,0,100.00%
jonbarron.info,1,0.00%,1,0,100.00%
empathyrecruitment.co.uk,1,0.00%,1,0,100.00%
iyyo.herokuapp.com,1,0.00%,1,0,100.00%
shapemaster.co.uk,1,0.00%,1,0,100.00%
update-dbankcdn-com-global.staticcdn.dbankedge.net,1,0.00%,2,1,50.00%
update.dbankcdn.com.c.cdnhwc1.com,1,0.00%,2,1,50.00%
hcdnd.hota.gslb.c.cdnhwc6.com,1,0.00%,2,1,50.00%
sale.jing-shop.in.th,1,0.00%,1,0,100.00%
socket.store.dissfk.top,1,0.00%,1,0,100.00%
rc10-fc02.oray.com,1,0.00%,1,0,100.00%
aa.tiziki3.tk,1,0.00%,1,0,100.00%
global-us.link.ac.cn,1,0.00%,1,0,100.00%
p437.ssl.qhimgs4.com,1,0.00%,2,1,50.00%
api-prod.i.mediav.com,1,0.00%,1,0,100.00%
s3.vip.wpscdn.cn,1,0.00%,2,1,50.00%
psuite.vivo.com.cn,1,0.00%,1,0,100.00%
tb.sogou.com,1,0.00%,1,0,100.00%
self.bkchina.cn,1,0.00%,1,0,100.00%
east-order.oss-cn-hangzhou.aliyuncs.com,1,0.00%,1,0,100.00%
cnallaz2.eucdurl.me,1,0.00%,1,0,100.00%
imgoss.douyucdn.cn,1,0.00%,2,1,50.00%
hydra.qzone.qq.com,1,0.00%,1,0,100.00%
farm.qzone.qq.com,1,0.00%,1,0,100.00%
j2.getrom.ml,1,0.00%,1,0,100.00%
relaunch.adcologne.de,1,0.00%,1,0,100.00%
y2.musicology.tk,1,0.00%,1,0,100.00%
webmail.auctionforanya.com,1,0.00%,1,0,100.00%
xtz.hicket.pro,1,0.00%,1,0,100.00%
api.codedefender.proserve.aws.dev,1,0.00%,1,0,100.00%
montijo.alegromais.pt,1,0.00%,1,0,100.00%
admin.yieh.com,1,0.00%,1,0,100.00%
vps.yinas.cf,1,0.00%,1,0,100.00%
llynholidays.co.uk,1,0.00%,1,0,100.00%
1608227430.D4EE071FA772.device.hiwifi.com,1,0.00%,1,0,100.00%
ns2.cuhk.edu.hk,1,0.00%,4,3,25.00%
mail.fy98.tk,1,0.00%,1,0,100.00%
login.empfehlungsbund.de,1,0.00%,1,0,100.00%
swheritage.org.uk,1,0.00%,1,0,100.00%
l.molimoli.tech,1,0.00%,1,0,100.00%
gspe19-cn-ssl.ls-apple.com.akadns.net,1,0.00%,1,0,100.00%
gspe19-cn-ssl.ls.apple.com.download.ks-cdn.com,1,0.00%,1,0,100.00%
impression.aflink.com,1,0.00%,1,0,100.00%
aflink.edgekey.net,1,0.00%,1,0,100.00%
aflink.edgekey.net.globalredir.akadns.net,1,0.00%,1,0,100.00%
e16624.ca2.s.tl88.net,1,0.00%,1,0,100.00%
1fnl5t7a.sched.vip-dk.tdnsvod1.cn,1,0.00%,2,1,50.00%
rec.z.qingting.fm,1,0.00%,1,0,100.00%
06efe7c3.z.qingting.fm.06efe7c3.c.cdnhwc1.com,1,0.00%,1,0,100.00%
hcdnw.qtfm.c.cdnhwc1.com,1,0.00%,1,0,100.00%
a4b97c982ba8dbb12.awsglobalaccelerator.com,1,0.00%,1,0,100.00%
a1916.dscg2.akamai.net,1,0.00%,2,1,50.00%
udblgn.huya.com,1,0.00%,1,0,100.00%
l1.xfinfr.com,1,0.00%,1,0,100.00%
dx-test-1463927589.us-east-1.elb.amazonaws.com,1,0.00%,1,0,100.00%
opencdnhwv6.jomodns.com,1,0.00%,22,21,4.55%
cnszui.lenovomm.com,1,0.00%,1,0,100.00%
cns.zui.lenovomm.com,1,0.00%,1,0,100.00%
cmake.org,1,0.00%,1,0,100.00%
ws-origin.pull.yximgs.com,1,0.00%,3,2,33.33%
ws.pull.yximgs.com,1,0.00%,3,2,33.33%
sdkoptedge.chinanetcenter.com.wscdns.com,1,0.00%,1,0,100.00%
ks.pull.yximgs.com,1,0.00%,3,2,33.33%
dsm04pcor002-meta.fe.1drv.com,1,0.00%,1,0,100.00%
odc-dsm04pap002-meta-geo.onedrive.akadns.net,1,0.00%,1,0,100.00%
odc-dsm04pap002-meta-brs.onedrive.akadns.net,1,0.00%,1,0,100.00%
bd.pull.yximgs.com,1,0.00%,2,1,50.00%
http.gslb.ksyuncdn.com,1,0.00%,1,0,100.00%
s6210.gslb.ksyuncdn.com,1,0.00%,1,0,100.00%
v2.kwaicdn.com,1,0.00%,1,0,100.00%
p5.a.yximgs.com.a.bdydns.com,1,0.00%,1,0,100.00%
d3.a.kwimgs.com.download.ks-cdn.com,1,0.00%,1,0,100.00%
k35-migu.gslb.h.ngaacdn.cn,1,0.00%,1,0,100.00%
txdwk.a.yximgs.com,1,0.00%,3,2,33.33%
txmov6.a.yximgs.com,1,0.00%,3,2,33.33%
p5-live.a.yximgs.com.a.bdydns.com,1,0.00%,1,0,100.00%
txdwkvod.a.etoote.com,1,0.00%,3,2,33.33%
tx-ad.a.yximgs.com,1,0.00%,3,2,33.33%
tx.pull.yximgs.com,1,0.00%,3,2,33.33%
k117-cp.gslb.ksyuncdn.com,1,0.00%,1,0,100.00%
tx-incu.gifshow.com,1,0.00%,1,0,100.00%
multi-az-eshop.kwaixiaodian.com,1,0.00%,1,0,100.00%
d3-kkd.a.kspkg.com,1,0.00%,3,2,33.33%
d3-ks.a.kwimgs.com,1,0.00%,3,2,33.33%
d3-reco.a.kwimgs.com,1,0.00%,3,2,33.33%
d3-yoda.a.kwimgs.com,1,0.00%,3,2,33.33%
d5-ks.a.kwimgs.com.a.bdydns.com,1,0.00%,1,0,100.00%
hw-p2p.pull.yximgs.com.c.cdnhwc3.com,1,0.00%,1,0,100.00%
hcdnl.pullksp2p.gslb.c.cdnhwc2.com,1,0.00%,1,0,100.00%
s03-p2p.gslb.ksyuncdn.com,1,0.00%,1,0,100.00%
u104.gslb.ksyuncdn.com,1,0.00%,1,0,100.00%
v2-cty01.kwaicdn.com.ctdns.cn,1,0.00%,1,0,100.00%
v2-cty03.kwaicdn.com.ctdns.cn,1,0.00%,1,0,100.00%
v11.kwaicdn.com,1,0.00%,3,2,33.33%
v5-skvod.kwaicdn.com.a.bdydns.com,1,0.00%,1,0,100.00%
ws-p2p.pull.yximgs.com.gccdn.net,1,0.00%,1,0,100.00%
ws.push.yximgs.com.wscdns.com,1,0.00%,1,0,100.00%
yximgs-webrtc.liveplay.myqcloud.com.sched.webrtc.tdnsv5.com,1,0.00%,1,0,100.00%
hw2.a.kwimgs.com,1,0.00%,3,2,33.33%
www.rocq.inria.fr,1,0.00%,1,0,100.00%
www.paris.inria.fr,1,0.00%,1,0,100.00%
odc-sat02pap001-meta-geo.onedrive.akadns.net,1,0.00%,1,0,100.00%
fxsong.kugou.com,1,0.00%,2,1,50.00%
acscdn.lavasoft.com,1,0.00%,1,0,100.00%
portal.djebots.ch,1,0.00%,1,0,100.00%
hcdnw103.c.cdnhwc2.com,1,0.00%,1,0,100.00%
rlsbj.cq.gov.cn,1,0.00%,5,4,20.00%
mike-holder.luxuryrealestate.com,1,0.00%,1,0,100.00%
phoenix2011.kicksite.net,1,0.00%,1,0,100.00%
1610067882.D4EE073C2A20.device.hiwifi.com,1,0.00%,1,0,100.00%
webmail.dionsdrapery.com,1,0.00%,1,0,100.00%
bpm2021.bpm.vps303.tadam.co.il,1,0.00%,1,0,100.00%
canberrasleeplab.com.au,1,0.00%,1,0,100.00%
blog.urania.com.tw,1,0.00%,1,0,100.00%
rss.srss.xyz,1,0.00%,1,0,100.00%
1394032.sedoparking.com,1,0.00%,1,0,100.00%
1608227457.D4EE071FA772.device.hiwifi.com,1,0.00%,1,0,100.00%
1608227483.D4EE071FA772.device.hiwifi.com,1,0.00%,1,0,100.00%
cdn.savoy.click,1,0.00%,1,0,100.00%
ambassadedelarepblq-niger.staging.driven.ca,1,0.00%,1,0,100.00%
bl6pap004.settings.live.net,1,0.00%,2,1,50.00%
mail.lilitrasasise.tk,1,0.00%,1,0,100.00%
kr.bigrep.com,1,0.00%,1,0,100.00%
cqiwx.smoba.qq.com,1,0.00%,1,0,100.00%
accollect.1234567.com.cn,1,0.00%,1,0,100.00%
slp2p-east-biz03.oray.net,1,0.00%,1,0,100.00%
uni-fundts.1234567.com.cn,1,0.00%,1,0,100.00%
appcollect.1234567.com.cn,1,0.00%,1,0,100.00%
fundabapi.1234567.com.cn,1,0.00%,1,0,100.00%
j3.dfcfw.com.cdn.dnsv1.com,1,0.00%,2,1,50.00%
appconfig2.1234567.com.cn,1,0.00%,1,0,100.00%
appcache.95021.com,1,0.00%,2,1,50.00%
appcollect2.1234567.com.cn,1,0.00%,1,0,100.00%
s0y6agn1.sched.sma-dk.tdnsstic1.cn,1,0.00%,2,1,50.00%
tradeapilvs15.1234567.com.cn,1,0.00%,1,0,100.00%
appactive.1234567.com.cn,1,0.00%,1,0,100.00%
j5.dfcfw.com.cdn.dnsv1.com,1,0.00%,2,1,50.00%
ohv6wbyw.sched.skalego-dk.tdnsstic1.cn,1,0.00%,2,1,50.00%
fundimpcpf.eastmoney.com,1,0.00%,1,0,100.00%
appsuggest.1234567.com.cn,1,0.00%,1,0,100.00%
bdstatics.eastmoney.com.w.cdngslb.com,1,0.00%,1,0,100.00%
bd-fireworks.eastmoney.com,1,0.00%,1,0,100.00%
mp.1234567.com.cn,1,0.00%,1,0,100.00%
appcollect3.1234567.com.cn,1,0.00%,1,0,100.00%
ibgapi15.1234567.com.cn,1,0.00%,1,0,100.00%
fydvoks2.sched.sma-dk.tdnsstic1.cn,1,0.00%,2,1,50.00%
fundmobapi.trafficmanager.cn,1,0.00%,1,0,100.00%
fundcomapi.trafficmanager.cn,1,0.00%,1,0,100.00%
pg1.kuwo.cn,1,0.00%,1,0,100.00%
www.vmall.com,1,0.00%,1,0,100.00%
hcdnw.nbkh.gslb.c.cdnhwc2.com,1,0.00%,1,0,100.00%
openapi.vmall.com,1,0.00%,1,0,100.00%
community.narniaweb.com,1,0.00%,1,0,100.00%
v4-16.hiaoxui.work,1,0.00%,1,0,100.00%
dap.vmall.com,1,0.00%,1,0,100.00%
zt.cn.ksapisrv.com,1,0.00%,1,0,100.00%
api.kwaizt.com,1,0.00%,1,0,100.00%
ulogjs.gifshow.com,1,0.00%,1,0,100.00%
509346c69186a43d8177224ebd043e87.safeframe.googlesyndication.com,1,0.00%,1,0,100.00%
matomo.privacy.apache.org,1,0.00%,1,0,100.00%
us01-logfiles-va-20.zoom.us,1,0.00%,1,0,100.00%
a1544.dscd.akamai.net,1,0.00%,3,2,33.33%
a1163.dscd.akamai.net,1,0.00%,2,1,50.00%
mid.hao123.com,1,0.00%,4,3,25.00%
events.baidu.com,1,0.00%,2,1,50.00%
sf1-scmcdn-tos.pstatp.com,1,0.00%,2,1,50.00%
waws-prod-sg1-065-e697.southeastasia.cloudapp.azure.com,1,0.00%,1,0,100.00%
r3.sn-ni5een7z.gvt1.com,1,0.00%,1,0,100.00%
cs.chocolateplatform.com,1,0.00%,1,0,100.00%
utility-f95afef1b1735de6.elb.us-west-2.amazonaws.com,1,0.00%,1,0,100.00%
htx.ht.zepdev.com,1,0.00%,1,0,100.00%
mail.ahmadmughrabi.com,1,0.00%,1,0,100.00%
adstats.tencentmusic.com,1,0.00%,15,14,6.67%
saga.yogamen.net,1,0.00%,1,0,100.00%
only-116612-124-16-139-61.nstool.netease.com,1,0.00%,1,0,100.00%
only-286413-124-16-139-61.nstool.netease.com,1,0.00%,1,0,100.00%
p3-buy-lb.itunes-apple.com.akadns.net,1,0.00%,1,0,100.00%
only-182440-124-16-139-61.nstool.321fenx.com,1,0.00%,1,0,100.00%
j1hqc7ee.e0.sched.ovscdns.com,1,0.00%,3,2,33.33%
only-507441-159-226-95-71.nstool.haowu.link,1,0.00%,1,0,100.00%
7b9df997f31b3b4d11d466d3e99e8b02.safeframe.googlesyndication.com,1,0.00%,1,0,100.00%
git.vulgraph.org,1,0.00%,1,0,100.00%
my.gyre.pro,1,0.00%,1,0,100.00%
web18171.getambassador.com,1,0.00%,1,0,100.00%
voipa04c.getambassador.com,1,0.00%,1,0,100.00%
ucenter.qqpy.sogou.com,1,0.00%,1,0,100.00%
img01.sogoucdn.com.cdn.dnsv1.com,1,0.00%,1,0,100.00%
blob.bz7prdstr10a.store.core.windows.net,1,0.00%,1,0,100.00%
phys2.harvard.edu,1,0.00%,1,0,100.00%
secure-savannah-16785.herokuapp.com,1,0.00%,1,0,100.00%
v4-12.hiaoxui.work,1,0.00%,1,0,100.00%
v4-37.hiaoxui.work,1,0.00%,1,0,100.00%
v4-38.hiaoxui.work,1,0.00%,1,0,100.00%
v4-34.hiaoxui.work,1,0.00%,1,0,100.00%
v4-28.hiaoxui.work,1,0.00%,1,0,100.00%
v4-31.hiaoxui.work,1,0.00%,1,0,100.00%
realprotect1.realprotectcloud.com,1,0.00%,1,0,100.00%
blob.dm2prdstr03a.store.core.windows.net,1,0.00%,1,0,100.00%
spa.spicegems.com,1,0.00%,1,0,100.00%
tomcat-app-new-49437122.cn-north-1.elb.amazonaws.com.cn,1,0.00%,1,0,100.00%
zttapk-s.v.bsgslb.com,1,0.00%,2,1,50.00%
tp.pinduoduo.com,1,0.00%,1,0,100.00%
nd0.baidupcs.com,1,0.00%,2,1,50.00%
nd0.baidupcs.com.a.bdydns.com,1,0.00%,2,1,50.00%
opencdnbdpcs.jomodns.com,1,0.00%,2,1,50.00%
rs499n.jomodns.com,1,0.00%,1,0,100.00%
rc656n.jomodns.com,1,0.00%,1,0,100.00%
rs16n.jomodns.com,1,0.00%,1,0,100.00%
rx709n.jomodns.com,1,0.00%,1,0,100.00%
rq909n.jomodns.com,1,0.00%,1,0,100.00%
rl425n.jomodns.com,1,0.00%,1,0,100.00%
rt867n.jomodns.com,1,0.00%,1,0,100.00%
rq772n.jomodns.com,1,0.00%,1,0,100.00%
rg551n.jomodns.com,1,0.00%,1,0,100.00%
ra490n.jomodns.com,1,0.00%,1,0,100.00%
rx263n.jomodns.com,1,0.00%,1,0,100.00%
rl819n.jomodns.com,1,0.00%,1,0,100.00%
d3cvl83wk0xajt.cloudfront.net,1,0.00%,2,1,50.00%
www.gcores.com,1,0.00%,1,0,100.00%
aecckz3db6ux6pkh.node.ppio.cloud,1,0.00%,1,0,100.00%
bj.pcsdownload.n.shifen.com,1,0.00%,2,1,50.00%
only-919742-124-16-139-61.nstool.yqkk.link,1,0.00%,1,0,100.00%
gsp57-ssl-background.ls-apple.com.akadns.net,1,0.00%,1,0,100.00%
m.youtube.com,1,0.00%,2,1,50.00%
sso.biancheng.net,1,0.00%,1,0,100.00%
findershort.weixin.qq.com,1,0.00%,1,0,100.00%
only-859773-124-16-139-61.nstool.haowu.link,1,0.00%,1,0,100.00%
cdnlive.radiou.com,1,0.00%,1,0,100.00%
analytics.srvnw.com,1,0.00%,1,0,100.00%
oss.aliyuncs.com,1,0.00%,1,0,100.00%
s10-sync.firefox.com.cn,1,0.00%,1,0,100.00%
download2.rapid7.com.edgekey.net,1,0.00%,1,0,100.00%
porta.herokuapp.com,1,0.00%,1,0,100.00%
i-bl6p-cor003.api.p001.1drv.com,1,0.00%,1,0,100.00%
server.hells-angels.com,1,0.00%,1,0,100.00%
mail.francoisandco.com,1,0.00%,1,0,100.00%
ikran.tian.download,1,0.00%,1,0,100.00%
fresh.attensa.net,1,0.00%,1,0,100.00%
td-balancer-ae1-190-141.wixdns.net,1,0.00%,1,0,100.00%
mail.fashionconaultancy.ml,1,0.00%,1,0,100.00%
aeckmmsjqyrqhuuf.node.ppio.cloud,1,0.00%,1,0,100.00%
aecpqakdd5js4k42.node.ppio.cloud,1,0.00%,1,0,100.00%
aeca6ytzxvhjmqtv.node.ppio.cloud,1,0.00%,1,0,100.00%
aeclcfvipkr7zryh.node.ppio.cloud,1,0.00%,1,0,100.00%
yx-template.svc.app.yinxiang.com,1,0.00%,1,0,100.00%
api.md.wpscdn.cn,1,0.00%,3,2,33.33%
68906qf0.sched.dma.tdnsdl1.cn.cdl.cdncloud.idc400.com,1,0.00%,1,0,100.00%
mail.warsawinstitute.org,1,0.00%,1,0,100.00%
az725175.vo.msecnd.net,1,0.00%,1,0,100.00%
fpt2.microsoft.com,1,0.00%,1,0,100.00%
josetr.gallerycdn.azure.cn,1,0.00%,1,0,100.00%
go2sh.gallerycdn.azure.cn,1,0.00%,1,0,100.00%
cheshirekow.gallerycdn.azure.cn,1,0.00%,1,0,100.00%
numaru.gallerycdn.azure.cn,1,0.00%,1,0,100.00%
derivitec-ltd.gallerycdn.azure.cn,1,0.00%,1,0,100.00%
zchrissirhcz.gallerycdn.azure.cn,1,0.00%,1,0,100.00%
nordic-semiconductor.gallerycdn.azure.cn,1,0.00%,1,0,100.00%
darkembers.gallerycdn.azure.cn,1,0.00%,1,0,100.00%
ucl-ixn.gallerycdn.azure.cn,1,0.00%,1,0,100.00%
ydew.gallerycdn.azure.cn,1,0.00%,1,0,100.00%
aperlman.gallerycdn.azure.cn,1,0.00%,1,0,100.00%
auto.tancdn.com,1,0.00%,1,0,100.00%
badges.gitter.im,1,0.00%,1,0,100.00%
txpcdn.liveplay.egame.qq.com,1,0.00%,1,0,100.00%
xnet-flv265.liveplay.egame.qq.com,1,0.00%,1,0,100.00%
appservice.qq.com,1,0.00%,1,0,100.00%
test.ark.qq.com,1,0.00%,1,0,100.00%
only-693655-159-226-95-46.nstool.zhuanzfx.com,1,0.00%,1,0,100.00%
ms-ceintl.gallery.vsassets.io,1,0.00%,1,0,100.00%
github.gallery.vsassets.io,1,0.00%,1,0,100.00%
eamodio.gallery.vsassets.io,1,0.00%,1,0,100.00%
eamodio.gallerycdn.azure.cn,1,0.00%,1,0,100.00%
app.dmall.com,1,0.00%,1,0,100.00%
p3plvcpnl463996.prod.phx3.secureserver.net,1,0.00%,1,0,100.00%
mail.tehila.gov.il,1,0.00%,1,0,100.00%
ordina.gnamferrara.it,1,0.00%,1,0,100.00%
products.stitcherpre.com,1,0.00%,1,0,100.00%
oakwood-sarasota-8.myzeki.com,1,0.00%,1,0,100.00%
webmail.vbc.cloud,1,0.00%,1,0,100.00%
a26-67.akam.net,1,0.00%,1,0,100.00%
docer-waf.wpsdns.com,1,0.00%,1,0,100.00%
ja-jp.proxioshowcase.com,1,0.00%,1,0,100.00%
utqbt.hcmsite.com,1,0.00%,1,0,100.00%
haveaniceday.gitee.com,1,0.00%,1,0,100.00%
o3.tyhu.ga,1,0.00%,1,0,100.00%
e11474.b.akamaiedge.net,1,0.00%,1,0,100.00%
storage.360buyimg.com.s.galileo.jcloud-cdn.com,1,0.00%,2,1,50.00%
nlb-appmcacom-56b9b583d670f997.elb.us-west-2.amazonaws.com,1,0.00%,1,0,100.00%
img12.360buyimg.com.gslb.qianxun.com,1,0.00%,2,1,50.00%
img12.360buyimg.com.s.galileo.jcloud-cdn.com,1,0.00%,2,1,50.00%
img12.360buyimg.com.volcgslb.com,1,0.00%,2,1,50.00%
campaign-music.hicloud.com,1,0.00%,1,0,100.00%
api-drcn-theme-dbankcloud-cn-drcn.appacc-region.dbankedge.net,1,0.00%,1,0,100.00%
nlb-platformmca-a9c25d0778721dd8.elb.us-west-2.amazonaws.com,1,0.00%,1,0,100.00%
dsm01pcor003-meta.fe.1drv.com,1,0.00%,2,1,50.00%
odc-dsm01pap003-meta-geo.onedrive.akadns.net,1,0.00%,2,1,50.00%
odc-dsm01pap003-meta-brs.onedrive.akadns.net,1,0.00%,2,1,50.00%
dsm01pcor003-meta.be.1drv.com.l-0003.dc-msedge.net.l-0003.l-msedge.net,1,0.00%,2,1,50.00%
context-enroll.awsmcafeeccs.mcafee.com,1,0.00%,1,0,100.00%
policyorchestration.awsmcafeeccs.mcafee.com,1,0.00%,1,0,100.00%
weathernew.pae.baidu.com,1,0.00%,2,1,50.00%
hcdnv.contentcenter.v6.c.cdnhwc2.com,1,0.00%,2,1,50.00%
appcloud.zhihu.com,1,0.00%,2,1,50.00%
www.hupu.com,1,0.00%,2,1,50.00%
gdc.hupucdn.com,1,0.00%,2,1,50.00%
sports.cctv.com,1,0.00%,2,1,50.00%
collect.hoopchina.com,1,0.00%,1,0,100.00%
nn38emda66kq5bmermufuszxwpaxpnwg.yundunwaf3.com,1,0.00%,1,0,100.00%
js.data.cctv.com,1,0.00%,2,1,50.00%
hermes.hoopchina.com,1,0.00%,1,0,100.00%
qosp.iqiyi.com,1,0.00%,1,0,100.00%
ipv6-img.dns.iqiyi.com,1,0.00%,2,1,50.00%
home.if.iqiyi.com,1,0.00%,1,0,100.00%
homeai.iqiyi.com,1,0.00%,1,0,100.00%
m.iqiyi.com,1,0.00%,2,1,50.00%
img5.iqiyipic.com,1,0.00%,2,1,50.00%
n0kngygwx1mbjoojeyy55rrctnqoqrm7.yundunwaf4.com,1,0.00%,1,0,100.00%
only-618631-159-226-95-34.nstool.zhuanzfx.com,1,0.00%,1,0,100.00%
hub5idx.v6.shub.sandai.net,1,0.00%,7,6,14.29%
cloud.typography.com,1,0.00%,1,0,100.00%
mail.fuckjoebiden.tk,1,0.00%,1,0,100.00%
a2plvcpnl424686.prod.iad2.secureserver.net,1,0.00%,1,0,100.00%
p3plmcpnl495967.prod.phx3.secureserver.net,1,0.00%,1,0,100.00%
d2na0fb6srbte6.cloudfront.net,1,0.00%,1,0,100.00%
en.martinbitman.cz,1,0.00%,1,0,100.00%
one-coffee.herokuapp.com,1,0.00%,1,0,100.00%
dev.activewin.co.uk,1,0.00%,1,0,100.00%
t2x-edge-ass-do-sgp-06.out-x.nanocosmos.de,1,0.00%,1,0,100.00%
download.copr.fedorainfracloud.org,1,0.00%,2,1,50.00%
d1nld9ovj32u75.cloudfront.net,1,0.00%,2,1,50.00%
linuxdownload.wip4.adobe.com,1,0.00%,1,0,100.00%
F4,1,0.00%,1,0,100.00%
d2ra6nuwn69ktl.cloudfront.net,1,0.00%,1,0,100.00%
mail.beijing.gov.cn,1,0.00%,1,0,100.00%
ihsu-southeastasia-2.southeastasia.cloudapp.azure.com,1,0.00%,1,0,100.00%
pcgec-img-1258344701.image.myqcloud.com,1,0.00%,1,0,100.00%
cat.sh.vip.dianping.com,1,0.00%,1,0,100.00%
d1ey6b4lsxjlpc.cloudfront.net,1,0.00%,2,1,50.00%
a1333.q.akamai.net,1,0.00%,1,0,100.00%
alt3.mobile-gtalk.l.google.com,1,0.00%,1,0,100.00%
websocket.pod4.avatar.ext.hp.com,1,0.00%,1,0,100.00%
apm-s3.ejoy.com,1,0.00%,1,0,100.00%
static.tsbrowser.xiangtatech.com.w.kunlunca.com,1,0.00%,1,0,100.00%
sdkh5.9game.cn,1,0.00%,1,0,100.00%
paycenter-log.9game.cn,1,0.00%,1,0,100.00%
p10445-game-adapter.ejoy.com,1,0.00%,1,0,100.00%
prod-pod4-dvc-avatarws-podlb-alb-227246374.us-east-1.elb.amazonaws.com,1,0.00%,1,0,100.00%
w.kancloud.cn,1,0.00%,1,0,100.00%
i-38.b-46304.ut.bench.utorrent.com,1,0.00%,5,4,20.00%
sns-avatar-qc.xhscdn.com.cdn.dnsv1.com,1,0.00%,2,1,50.00%
audio-ak-spotify-com.akamaized.net,1,0.00%,2,1,50.00%
a297.dscc.akamai.net.0.1.cn.akamaitech.net,1,0.00%,2,1,50.00%
staticlive.douyucdn.cn,1,0.00%,2,1,50.00%
res.douyucdn.cn,1,0.00%,2,1,50.00%
static.galaxyclouds.cn,1,0.00%,1,0,100.00%
c399e1eba3cafdcf71c1b49fbbabaf96.v.smtcdns.net,1,0.00%,1,0,100.00%
ip0467469273.livehwc3.cn,1,0.00%,1,0,100.00%
87b85e0bd14b9416c1439fcac8b8a929.v.smtcdns.net,1,0.00%,1,0,100.00%
d3afeddfd2d6b691141031ef6d8ecc1f.dlied1.cdntips.net,1,0.00%,1,0,100.00%
appsec-mobile.meituan.com,1,0.00%,6,5,16.67%
t2-xhs-new-vpc-ipv6-2022140793.cn-north-1.elb.amazonaws.com.cn,1,0.00%,2,1,50.00%
update.powerword.wps.cn,1,0.00%,1,0,100.00%
tm1.dns-tm.com,1,0.00%,1,0,100.00%
tm2.dns-tm.com,1,0.00%,1,0,100.00%
sso.shoprunback.com,1,0.00%,1,0,100.00%
vetadomicilio-it.socialacademy.me,1,0.00%,1,0,100.00%
rads.rollingbonesoutfitters.com,1,0.00%,1,0,100.00%
tracker.nice-prod.pro,1,0.00%,1,0,100.00%
apache.jfrog.io,1,0.00%,1,0,100.00%
eccanova.herokuapp.com,1,0.00%,1,0,100.00%
direwolf-15a1e1e3bd-renamed.herokuapp.com,1,0.00%,1,0,100.00%
direwolf-939b4e3031.herokuapp.com,1,0.00%,1,0,100.00%
sl-platform-production.herokuapp.com,1,0.00%,1,0,100.00%
hw-gz-live-p2p-06.chat.bilibili.com,1,0.00%,1,0,100.00%
tx-bj-live-comet-01.chat.bilibili.com,1,0.00%,1,0,100.00%
p10445-ob-pk12game-zone001.ejoy.com,1,0.00%,1,0,100.00%
jssz-boss.hdslb.com.w.cdngslb.com,1,0.00%,1,0,100.00%
www.6.cn.6resource.cn,1,0.00%,1,0,100.00%
www.6.cn.wscdns.com,1,0.00%,1,0,100.00%
c.open.163.com.163jiasu.com,1,0.00%,1,0,100.00%
c.open.163.com.w.cdngslb.com,1,0.00%,1,0,100.00%
p10445-safebox.ejoy.com,1,0.00%,1,0,100.00%
p10445-badge.ejoy.com,1,0.00%,1,0,100.00%
update.ludashi.com,1,0.00%,1,0,100.00%
ssl-hw-monidashi.ludashi.com,1,0.00%,1,0,100.00%
ssl-hw-monidashi.ludashi.com.c.cdnhwc1.com,1,0.00%,1,0,100.00%
live-file.csdnimg.cn,1,0.00%,1,0,100.00%
live-file.csdnimg.cn.w.alikunlun.com,1,0.00%,1,0,100.00%
i.go.sohu.com,1,0.00%,1,0,100.00%
imp.ad-plus.cn,1,0.00%,1,0,100.00%
t1.focus-img.cn,1,0.00%,1,0,100.00%
t2.focus-img.cn,1,0.00%,1,0,100.00%
t2.focus-img.cn.cdn.dnsv1.com,1,0.00%,1,0,100.00%
t1.focus-img.cn.cdn.dnsv1.com,1,0.00%,1,0,100.00%
images.sohu.com.w.kunlunar.com,1,0.00%,2,1,50.00%
t3.focus-img.cn,1,0.00%,1,0,100.00%
t3.focus-img.cn.cdn.dnsv1.com,1,0.00%,1,0,100.00%
505854.sched.skalego.tdnsstic1.cn,1,0.00%,1,0,100.00%
qcloudcdn.sched.skalego.tdnsstic1.cn,1,0.00%,1,0,100.00%
best.sched.d0-dk.tdnsdp1.cn,1,0.00%,2,1,50.00%
t.focus-img.cn,1,0.00%,1,0,100.00%
t4.focus-img.cn,1,0.00%,1,0,100.00%
t.focus-img.cn.cdn.dnsv1.com,1,0.00%,1,0,100.00%
m4.auto.itc.cn.w.cdngslb.com,1,0.00%,2,1,50.00%
t4.focus-img.cn.cdn.dnsv1.com,1,0.00%,1,0,100.00%
29e5534ea20a8.cdn.sohucs.com,1,0.00%,3,2,33.33%
userblink.csdnimg.cn.w.cdngslb.com,1,0.00%,1,0,100.00%
statics.itc.cn.w.cdngslb.com,1,0.00%,2,1,50.00%
best.sched.skalego-dk.tdnsstic1.cn.cjt.vwnti.yrzhcloud.cn,1,0.00%,6,5,16.67%
img.mp.sohu.com.w.cdngslb.com,1,0.00%,2,1,50.00%
img-bss.csdn.net,1,0.00%,1,0,100.00%
stock.gd.a.sohu.com,1,0.00%,1,0,100.00%
f7yd.a.sohu.com,1,0.00%,1,0,100.00%
forward.weixin.qq.com,1,0.00%,9,8,11.11%
p1.adkwai.com,1,0.00%,3,2,33.33%
click.notification.elsevier.com,1,0.00%,1,0,100.00%
hcdnwsad.gslb.c.cdnhwc2.com,1,0.00%,1,0,100.00%
fc.xiaozujian.com,1,0.00%,1,0,100.00%
openwith.mathworks.com,1,0.00%,1,0,100.00%
starget.mathworks.com,1,0.00%,1,0,100.00%
smetrics.mathworks.com,1,0.00%,1,0,100.00%
cl.qualaroo.com,1,0.00%,1,0,100.00%
pagestates-tracking.crazyegg.com,1,0.00%,1,0,100.00%
assets-tracking.crazyegg.com,1,0.00%,1,0,100.00%
tracking.crazyegg.com,1,0.00%,1,0,100.00%
lasteventf-tm.everesttech.net,1,0.00%,1,0,100.00%
snap.licdn.com,1,0.00%,4,3,25.00%
geo.qualaroo.com,1,0.00%,1,0,100.00%
www186.tk0010.top,1,0.00%,1,0,100.00%
api.taptapdada.com,1,0.00%,1,0,100.00%
b-gi.getui.com,1,0.00%,2,1,50.00%
lobdock.randompoolboy.com,1,0.00%,1,0,100.00%
amdcopen.m.taobao.com,1,0.00%,1,0,100.00%
sdk.push.mob.com,1,0.00%,1,0,100.00%
api3-normal-c-hl.ixigua.com,1,0.00%,2,1,50.00%
mail.quepufac.tk,1,0.00%,1,0,100.00%
webmail.sortscape.com,1,0.00%,1,0,100.00%
new2.piapromos.com,1,0.00%,1,0,100.00%
voxmarkets.co.uk,1,0.00%,1,0,100.00%
r1.sn-ni5een7l.gvt1.com,1,0.00%,1,0,100.00%
fanyi.so.qss-lb.com,1,0.00%,1,0,100.00%
merchantsportal.srewardscentre.com.my,1,0.00%,1,0,100.00%
mail.inibeprocaps.tk,1,0.00%,1,0,100.00%
vdposter.bdstatic.com,1,0.00%,6,5,16.67%
pcw-data.video.iqiyi.com,1,0.00%,2,1,50.00%
static.g.iqiyi.com,1,0.00%,2,1,50.00%
u0.iqiyipic.com,1,0.00%,2,1,50.00%
u4.iqiyipic.com,1,0.00%,2,1,50.00%
u9.iqiyipic.com,1,0.00%,2,1,50.00%
www.webofscience.com,1,0.00%,2,1,50.00%
m.ikesic.ga,1,0.00%,1,0,100.00%
qey2c3tr.n.sudun-cname.com,1,0.00%,1,0,100.00%
matsapi.blackshark.com,1,0.00%,1,0,100.00%
www.clewxc.com,1,0.00%,1,0,100.00%
truststatic.jomodns.com,1,0.00%,1,0,100.00%
v5-h.douyinvod.com.zjgslb.com,1,0.00%,2,1,50.00%
dy-vod-h.bytegslb.com,1,0.00%,2,1,50.00%
lf-dy-sourcecdn-tos.bytegecko.com,1,0.00%,2,1,50.00%
zjtd02.yunv6.c.cdnhwc2.com,1,0.00%,2,1,50.00%
lf-dy-sourcecdn-tos.bytegecko.com.bytedns1.com,1,0.00%,2,1,50.00%
lf3-mg-developer.dailygn.com.w.alikunlun.com,1,0.00%,2,1,50.00%
xiyou.world,1,0.00%,3,2,33.33%
monitor.bdstatic.com.baidu-itm.com,1,0.00%,1,0,100.00%
oo00.biz,1,0.00%,1,0,100.00%
pad.da.mgtv.com,1,0.00%,1,0,100.00%
img.da.mgtv.com.w.kunlunca.com,1,0.00%,1,0,100.00%
mail.efuinsurance.com,1,0.00%,1,0,100.00%
evo.xiebruce.cf,1,0.00%,1,0,100.00%
_dmarc.wgv-portal.de,1,0.00%,1,0,100.00%
r1.sn-ni5eln7l.gvt1.com,1,0.00%,1,0,100.00%
hcdnv.zjtd02.v6.c.cdnhwc2.com,1,0.00%,2,1,50.00%
only-921777-159-226-95-33.nstool.netease.com,1,0.00%,1,0,100.00%
sandbox.itunes-apple.com.akadns.net,1,0.00%,1,0,100.00%
presence.api.drift.com,1,0.00%,1,0,100.00%
1531062-12.chat.api.drift.com,1,0.00%,1,0,100.00%
gameplus-platform.cdn.bcebos.com,1,0.00%,1,0,100.00%
c2.p.tabnine.com,1,0.00%,1,0,100.00%
zt.map.n.shifen.com,1,0.00%,1,0,100.00%
map-mobile-opnimg.cdn.bcebos.com.a.bdydns.com,1,0.00%,1,0,100.00%
forest-china.upwardsware.com,1,0.00%,1,0,100.00%
forest-china-1415829784.cn-northwest-1.elb.amazonaws.com.cn,1,0.00%,1,0,100.00%
device-messaging-na.amazon.com,1,0.00%,1,0,100.00%
content.map.n.shifen.com,1,0.00%,1,0,100.00%
cloudmonitor.console.aliyun.com,1,0.00%,3,2,33.33%
sh.wagbridge.aliyun.com,1,0.00%,1,0,100.00%
sh.wagbridge.aliyun.com.gds.alibabadns.com,1,0.00%,1,0,100.00%
www-jp-de-intl-adns.aliyun.com.gds.alibabadns.com,1,0.00%,1,0,100.00%
ali-bj-pcdn-06.biliapi.net,1,0.00%,1,0,100.00%
rochestermt.classic.kicksite.net,1,0.00%,1,0,100.00%
cm-10-140.getui.com,1,0.00%,1,0,100.00%
checkstand.oss-cn-hangzhou.aliyuncs.com,1,0.00%,1,0,100.00%
videoeditor-drcn.hms.dbankcloud.com,1,0.00%,1,0,100.00%
setting.hicloud.com,1,0.00%,1,0,100.00%
gavinhughhu.cnblogs.com,1,0.00%,1,0,100.00%
img39.dangdang.com,1,0.00%,1,0,100.00%
c4.yapatube.com,1,0.00%,1,0,100.00%
my.streamnotes.app,1,0.00%,1,0,100.00%
skylab.gxmnetworks.com,1,0.00%,1,0,100.00%
kcdtw.goshare.monster,1,0.00%,1,0,100.00%
1610340748.D4EE073396E8.device.hiwifi.com,1,0.00%,1,0,100.00%
1610340769.D4EE073396E8.device.hiwifi.com,1,0.00%,1,0,100.00%
smtp2.doh.gov.ae,1,0.00%,1,0,100.00%
smtp1.doh.gov.ae,1,0.00%,1,0,100.00%
static-global-s-msn-com.akamaized.net,1,0.00%,2,1,50.00%
wus-streaming-video-rt-microsoft-com.akamaized.net,1,0.00%,2,1,50.00%
wildcard.moatads.com.edgekey.net,1,0.00%,1,0,100.00%
e13136.g.akamaiedge.net,1,0.00%,1,0,100.00%
ssl.uptrendsrumappasia.azurewebsites.net,1,0.00%,1,0,100.00%
music.bilibili.com,1,0.00%,1,0,100.00%
dxedge-prod-lb-389334914.ap-southeast-1.elb.amazonaws.com,1,0.00%,1,0,100.00%
ins-14wmvi7w.ias.tencent-cloud.net,1,0.00%,1,0,100.00%
rr.knet.cn,1,0.00%,2,1,50.00%
upichqipv6.v.trpcdn.net,1,0.00%,2,1,50.00%
dingyue.ws.126.net,1,0.00%,2,1,50.00%
intercms.damai.cn.w.alikunlun.com,1,0.00%,1,0,100.00%
sf-api-token-service-lb-cn.itunes-apple.com.akadns.net,1,0.00%,3,2,33.33%
storage23.360buyimg.com,1,0.00%,2,1,50.00%
uranus.jd.com.gslb.qianxun.com,1,0.00%,1,0,100.00%
lzkj-isv.isvjcloud.com-2f9a65efd7e3.jdcloudwaf.com,1,0.00%,1,0,100.00%
cjwxqz.dianpusoft.cn.w.kunluncan.com,1,0.00%,1,0,100.00%
lzcdn.dianpusoft.cn.w.kunlunpi.com,1,0.00%,1,0,100.00%
ym.gslb.qianxun.com,1,0.00%,1,0,100.00%
img11.360buyimg.com.gslb.qianxun.com,1,0.00%,2,1,50.00%
img14.360buyimg.com.gslb.qianxun.com,1,0.00%,2,1,50.00%
bdimg2.qunliao.info,1,0.00%,2,1,50.00%
om.lmtovs.sched.apdcdn.com,1,0.00%,1,0,100.00%
bdimg4.qunliao.info,1,0.00%,2,1,50.00%
sd.qunliao.info,1,0.00%,1,0,100.00%
stuff.cdn.biddingx.com.w.kunlunso.com,1,0.00%,1,0,100.00%
o965865.ingest.sentry.io,1,0.00%,1,0,100.00%
cart.kongfz.com,1,0.00%,1,0,100.00%
user.kongfz.com,1,0.00%,1,0,100.00%
live-api.dongqiudi.com,1,0.00%,1,0,100.00%
www.noobyard.com,1,0.00%,1,0,100.00%
www.3h3.com.wswebpic.com,1,0.00%,1,0,100.00%
3h3.fhyx.com,1,0.00%,1,0,100.00%
pt.3h3.com.wswebpic.com,1,0.00%,1,0,100.00%
gamebox.3h3.com.wswebpic.com,1,0.00%,1,0,100.00%
pic.3h3.com.wswebpic.com,1,0.00%,1,0,100.00%
m.3h3.com.wswebpic.com,1,0.00%,1,0,100.00%
elmhovdu.sched.sma.tdnsstic1.cn.cjt.krcdn.idatacube.com,1,0.00%,1,0,100.00%
av.huijiwiki.com,1,0.00%,1,0,100.00%
2e3vw0eo.sched.sma.tdnsstic1.cn.cjt.krcdn.idatacube.com,1,0.00%,1,0,100.00%
2gwthcez.sched.sma.tdnsstic1.cn,1,0.00%,1,0,100.00%
qfla166u.sched.sma.tdnsstic1.cn,1,0.00%,1,0,100.00%
huijidata.com,1,0.00%,1,0,100.00%
iknow.baidu.com,1,0.00%,2,1,50.00%
www.manongjc.com,1,0.00%,1,0,100.00%
cpcontacts.ankesoryapim.com,1,0.00%,1,0,100.00%
peancgm.herokuapp.com,1,0.00%,1,0,100.00%
s1.ssasuka.ml,1,0.00%,1,0,100.00%
mail.poft.cf,1,0.00%,1,0,100.00%
li.m.wiktionary.hfut.cf,1,0.00%,1,0,100.00%
download-stls.adobe.com.edgesuite.net,1,0.00%,2,1,50.00%
a1860.dscd.akamai.net,1,0.00%,2,1,50.00%
live.xhscdn.com.livecdn.liveplay.myqcloud.com,1,0.00%,2,1,50.00%
live.xhscdn.com.l5-dk.sched.dcloudlive.com,1,0.00%,2,1,50.00%
live-ali.xhscdn.com,1,0.00%,2,1,50.00%
live-ali.xhscdn.com.w.alikunlun.net,1,0.00%,2,1,50.00%
gz01.router.omg.xiaojukeji.com,1,0.00%,1,0,100.00%
www.jjckb.cn.lxdns.com,1,0.00%,2,1,50.00%
img.riskified.com,1,0.00%,1,0,100.00%
message.kongfz.com,1,0.00%,1,0,100.00%
search.kongfz.com,1,0.00%,1,0,100.00%
user.kfzimg.com,1,0.00%,1,0,100.00%
wwc.alicdn.com,1,0.00%,2,1,50.00%
twzzbak.jjyun.ml,1,0.00%,1,0,100.00%
tracker.thinelephant.org,1,0.00%,1,0,100.00%
image.9xsecndns.cn,1,0.00%,2,1,50.00%
p206-fmf.icloud.com.cn,1,0.00%,1,0,100.00%
rt-p.kugou.com,1,0.00%,1,0,100.00%
elb-status-us.statuspage.io,1,0.00%,1,0,100.00%
eum-orange-saas.instana.io,1,0.00%,1,0,100.00%
pc.52pk.com.wswebcdn.com,1,0.00%,1,0,100.00%
www.52pk.com.wswebcdn.com,1,0.00%,1,0,100.00%
5y9nfpes.52pk.com.wswebcdn.com,1,0.00%,1,0,100.00%
pass.52pk.com.wswebcdn.com,1,0.00%,1,0,100.00%
image.diyiyou.com.wscdns.com,1,0.00%,1,0,100.00%
www.9k9k.com.wswebpic.com,1,0.00%,1,0,100.00%
wsall.52pk.com.wswebpic.com,1,0.00%,1,0,100.00%
pic2.52pk.com.wswebcdn.com,1,0.00%,1,0,100.00%
t.xuchuang.com,1,0.00%,1,0,100.00%
onimg.leshu.com,1,0.00%,1,0,100.00%
down.52pk.com,1,0.00%,2,1,50.00%
onimg.leshu.com.wswebcdn.com,1,0.00%,1,0,100.00%
f.xuchuang.com.wsglb0.com,1,0.00%,1,0,100.00%
pic1.52pk.com.wswebcdn.com,1,0.00%,1,0,100.00%
edger-edger-4e3vcwvnek77-1367313377.us-east-2.elb.amazonaws.com,1,0.00%,1,0,100.00%
h5.vdo.ai,1,0.00%,1,0,100.00%
www.javashuo.com,1,0.00%,1,0,100.00%
strava.zendesk.com,1,0.00%,1,0,100.00%
theme.zdassets.com,1,0.00%,1,0,100.00%
cdn.solvvy.com,1,0.00%,1,0,100.00%
api.solvvy.com,1,0.00%,1,0,100.00%
dy9z4910shqac.cloudfront.net,1,0.00%,2,1,50.00%
redemptions.privy-staging-pr-2755.privy-staging.com,1,0.00%,1,0,100.00%
webdisk.tempftp.cf,1,0.00%,1,0,100.00%
mapsnap0.bdimg.com,1,0.00%,2,1,50.00%
en.mmcs.org.cn,1,0.00%,1,0,100.00%
tennis.start4all.com,1,0.00%,1,0,100.00%
mail.masslatemps.ml,1,0.00%,1,0,100.00%
dl.gi.de,1,0.00%,1,0,100.00%
mail.rlfazone.cf,1,0.00%,1,0,100.00%
d3jq4x7ht7rl2f.cloudfront.net,1,0.00%,1,0,100.00%
onewhat.herokuapp.com,1,0.00%,1,0,100.00%
pr.33663368.xyz,1,0.00%,1,0,100.00%
stage.attensa.net,1,0.00%,1,0,100.00%
outlook.euler.gq,1,0.00%,1,0,100.00%
aebdeu.teamworkonline.com,1,0.00%,1,0,100.00%
p45-caldav.icloud.com,1,0.00%,2,1,50.00%
chrome-devtools-frontend.appspot.com,1,0.00%,2,1,50.00%
dev-sentry.mokahr.com,1,0.00%,1,0,100.00%
pages.launchpayload.com,1,0.00%,1,0,100.00%
pugq.herokuapp.com,1,0.00%,1,0,100.00%
actua.fundacionbobath.org,1,0.00%,1,0,100.00%
srv107.mexa.sh,1,0.00%,1,0,100.00%
mail.praisesytems.ml,1,0.00%,1,0,100.00%
staging-cc-sync-service.api.miairline.com,1,0.00%,1,0,100.00%
start.firefoxchina.cn.wscdns.com,1,0.00%,1,0,100.00%
rd-service-gobfe.e.shifen.com,1,0.00%,1,0,100.00%
www.ei.org.cn,1,0.00%,1,0,100.00%
cscn.tupu360.com,1,0.00%,1,0,100.00%
jwba.ucas.ac.cn,1,0.00%,1,0,100.00%
review.tsinghua.edu.cn,1,0.00%,1,0,100.00%
www.icics.cn,1,0.00%,1,0,100.00%
geonode.geeknixta.com,1,0.00%,1,0,100.00%
www.wondercv.com,1,0.00%,1,0,100.00%
files.wondercv.com,1,0.00%,2,1,50.00%
wondercv-public-resource.oss-cn-beijing.aliyuncs.com,1,0.00%,1,0,100.00%
photo.wondercv.com,1,0.00%,2,1,50.00%
io.wondercv.cn,1,0.00%,1,0,100.00%
dn-udeskpub.qbox.me,1,0.00%,2,1,50.00%
prod-file-uploaded.oss-cn-beijing.aliyuncs.com,1,0.00%,1,0,100.00%
e2c20.gcp.gvt2.com,1,0.00%,1,0,100.00%
glb.sls.prod.dcat.dsp.trafficmanager.NET,1,0.00%,5,4,20.00%
trek.aotter.net,1,0.00%,1,0,100.00%
684d0d46.akstat.io,1,0.00%,2,1,50.00%
ns3.alikunlun.com,1,0.00%,1,0,100.00%
gtjar.herokuapp.com,1,0.00%,1,0,100.00%
ventennipaperoni.altervista.org,1,0.00%,1,0,100.00%
packaging.start4all.com,1,0.00%,1,0,100.00%
fedebeis.com.pa,1,0.00%,1,0,100.00%
admin.bj.bonzapuzzles.com,1,0.00%,1,0,100.00%
vscode.cdn.azure.cn,1,0.00%,1,0,100.00%
ana.bandi.so,1,0.00%,1,0,100.00%
l-0003.l-dc-msedge.net,1,0.00%,1,0,100.00%
evcs-crl.ws.symantec.com,1,0.00%,2,1,50.00%
www.iacr.org,1,0.00%,1,0,100.00%
yun.aura.cn,1,0.00%,1,0,100.00%
uploader.feimayun.com,1,0.00%,1,0,100.00%
ping-yiliao.pinyin.sogou.com,1,0.00%,1,0,100.00%
pp.interactivesystems.info,1,0.00%,1,0,100.00%
unclejohns-a.citroorder.com,1,0.00%,1,0,100.00%
podcasts.advancingbitcoin.com,1,0.00%,1,0,100.00%
popoc2.www.iciba.com,1,0.00%,1,0,100.00%
bbc.wydn.tk,1,0.00%,1,0,100.00%
us2.freeme.ml,1,0.00%,1,0,100.00%
mail.quecongwana.tk,1,0.00%,1,0,100.00%
mcube-ota.oss-cn-beijing.aliyuncs.com,1,0.00%,1,0,100.00%
one.maomaotou.tk,1,0.00%,1,0,100.00%
1608241795.D4EE071FA772.device.hiwifi.com,1,0.00%,1,0,100.00%
1608241851.D4EE071FA772.device.hiwifi.com,1,0.00%,1,0,100.00%
1608241917.D4EE071FA772.device.hiwifi.com,1,0.00%,1,0,100.00%
k5.nilmo.info,1,0.00%,1,0,100.00%
wd-node-08.silvermob.com,1,0.00%,1,0,100.00%
acquire.privy-staging-pr-5228.privy-staging.com,1,0.00%,1,0,100.00%
the-maker-knife.backerkit.com,1,0.00%,1,0,100.00%
skill-lab.socialacademy.com,1,0.00%,1,0,100.00%
stephanie-blog.hupahup.com,1,0.00%,1,0,100.00%
applecsb.crm.189.cn,1,0.00%,1,0,100.00%
frtravel.co.za,1,0.00%,1,0,100.00%
m.t5nvt1.ga,1,0.00%,1,0,100.00%
zfhdwjgljvokcpe.masiruju.cz,1,0.00%,1,0,100.00%
ag.innovid.com,1,0.00%,2,1,50.00%
log.8bcd9.com,1,0.00%,1,0,100.00%
people.ucas.ac.cn,1,0.00%,1,0,100.00%
open.iciba.com,1,0.00%,1,0,100.00%
direwolf-d5e369ce22.herokuapp.com,1,0.00%,1,0,100.00%
msn.airfocus.com,1,0.00%,1,0,100.00%
weather-community-drcn.weather.dbankcloud.cn,1,0.00%,1,0,100.00%
cloudrom-global.emui.dbankcloud.com,1,0.00%,1,0,100.00%
metrics.dt.hicloud.com,1,0.00%,1,0,100.00%
app.playstream.media,1,0.00%,1,0,100.00%
iacvpn.iacwork.com,1,0.00%,1,0,100.00%
ksafe.union.ijinshan.com,1,0.00%,1,0,100.00%
reflect.labs.kaptivo.com,1,0.00%,1,0,100.00%
hyperion.minecraft.gr,1,0.00%,1,0,100.00%
x1op88ea.666.layo.ml,1,0.00%,1,0,100.00%
evankleinfilms.fluidgalleries.co,1,0.00%,1,0,100.00%
noland588-2021-09-22-05.herokuapp.com,1,0.00%,1,0,100.00%
frigg.carnegiefonder.se,1,0.00%,1,0,100.00%
slp2p-east-std78.oray.net,1,0.00%,1,0,100.00%
antevenio.planning.tools,1,0.00%,1,0,100.00%
live.chatalyze.com,1,0.00%,1,0,100.00%
video.detector.media,1,0.00%,1,0,100.00%
zhibo8.com,1,0.00%,1,0,100.00%
pg-ad-b1.ws.126.net,1,0.00%,2,1,50.00%
pca.zhibo8.cc,1,0.00%,1,0,100.00%
bifen4pc.qiumibao.com,1,0.00%,1,0,100.00%
cors.cdn.bcebos.com,1,0.00%,2,1,50.00%
masterconn.qq.com,1,0.00%,1,0,100.00%
abtest-tx-beijing-01.saas.sensorsdata.cn,1,0.00%,1,0,100.00%
tRaNSit1.wsloG.CHinAnetCeNTEr.CoM,1,0.00%,1,0,100.00%
cLIenTLogVoDP2P.haPlat.NeT,1,0.00%,1,0,100.00%
maMbaP2PVODH5.8686C.CoM,1,0.00%,1,0,100.00%
passport.voicecloud.cn,1,0.00%,1,0,100.00%
clIeNtLogVodp2P.haplaT.nEt,1,0.00%,1,0,100.00%
mAMbaP2PVoDh5.8686C.cOM,1,0.00%,1,0,100.00%
rights-manager.staging.orfium.com,1,0.00%,1,0,100.00%
mznr.herokuapp.com,1,0.00%,1,0,100.00%
mail.ekeap.ga,1,0.00%,1,0,100.00%
cn4-pods-eap.partner.officewebapps.cn,1,0.00%,1,0,100.00%
tizi.chunaiqun.cf,1,0.00%,1,0,100.00%
my.opalstack.com,1,0.00%,1,0,100.00%
z86b6g.deeqrr.dscew.ml,1,0.00%,1,0,100.00%
mobile.163.com,1,0.00%,1,0,100.00%
img3.126.net,1,0.00%,1,0,100.00%
webstat.ws.126.net,1,0.00%,1,0,100.00%
talent-fe.cdn.bcebos.com,1,0.00%,1,0,100.00%
img3.xs.cdnyes.com,1,0.00%,1,0,100.00%
cdn1.gosur.com,1,0.00%,1,0,100.00%
tile2.gosurmaps.com,1,0.00%,1,0,100.00%
www.datadoghq-browser-agent.com,1,0.00%,1,0,100.00%
rum-http-intake.logs.datadoghq.com,1,0.00%,2,1,50.00%
aax-us-east.amazon-adsystem.com,1,0.00%,1,0,100.00%
qn1-next.xuetangonline.com,1,0.00%,2,1,50.00%
qn-sc0.yuketang.cn,1,0.00%,2,1,50.00%
public-prod-dspcookiematching.dmxleo.com,1,0.00%,1,0,100.00%
1610107587.D4EE073C2A20.device.hiwifi.com,1,0.00%,1,0,100.00%
e2c28.gcp.gvt2.com,1,0.00%,1,0,100.00%
log.snssdk.com,1,0.00%,1,0,100.00%
log.snssdk.com.w.kunlunhuf.com,1,0.00%,1,0,100.00%
mp.csdn.net,1,0.00%,1,0,100.00%
a.cnzz.com,1,0.00%,1,0,100.00%
www.myhack58.com,1,0.00%,1,0,100.00%
student.csdn.net,1,0.00%,1,0,100.00%
editor.csdn.net,1,0.00%,1,0,100.00%
matukhloting.scontrinoshop.com,1,0.00%,1,0,100.00%
notify.privy-staging-pr-8267.privy-staging.com,1,0.00%,1,0,100.00%
sso.drk-kv-en.de,1,0.00%,1,0,100.00%
techtroopers.teamtailor.com,1,0.00%,1,0,100.00%
d2tmthzm7jp200.cloudfront.net,1,0.00%,1,0,100.00%
direwolf-16189327dd.herokuapp.com,1,0.00%,1,0,100.00%
leaderboards.matchpick.co,1,0.00%,1,0,100.00%
getcare.southcountyhealth.org,1,0.00%,1,0,100.00%
mupuixdncztlhae.masiruju.cz,1,0.00%,1,0,100.00%
45-76-11-227.brd-cdn.com,1,0.00%,1,0,100.00%
p3plmcpnl496013.prod.phx3.secureserver.net,1,0.00%,1,0,100.00%
a221.static-file.com,1,0.00%,1,0,100.00%
fto.tor2peng.ml,1,0.00%,1,0,100.00%
cdn3.gosur.com,1,0.00%,1,0,100.00%
img5.xs.cdnyes.com,1,0.00%,1,0,100.00%
jcenter.bintray.com,1,0.00%,1,0,100.00%
WwW.Vod.LXDNs.COm,1,0.00%,2,1,50.00%
TRansIt1.WslOG.chINanetCENtEr.COm,1,0.00%,1,0,100.00%
www.imf.org,1,0.00%,2,1,50.00%
e-0014.e-dc-msedge.net,1,0.00%,1,0,100.00%
beginning.disease.ml,1,0.00%,1,0,100.00%
imagex-web-settings.volcimagex.net,1,0.00%,1,0,100.00%
cms-api.csdn.net,1,0.00%,1,0,100.00%
info.iciba.com,1,0.00%,1,0,100.00%
archive.biliimg.com,1,0.00%,2,1,50.00%
all.biliimg.com.w.cdngslb.com,1,0.00%,1,0,100.00%
www.hxkba.com,1,0.00%,1,0,100.00%
47fcc754.ipip.net.cname.yunduns.com,1,0.00%,1,0,100.00%
p56-buy-lb.itunes-apple.com.akadns.net,1,0.00%,1,0,100.00%
apiv3.douyucdn.cn,1,0.00%,1,0,100.00%
1610067820.D4EE073C2A20.device.hiwifi.com,1,0.00%,1,0,100.00%
0316ee7454c7881007111cca5a.doorkeeper.jp,1,0.00%,1,0,100.00%
admin.excelinstore.com,1,0.00%,1,0,100.00%
d140lhg9ete0od.cloudfront.net,1,0.00%,1,0,100.00%
bilder.lunardon-fotografie.de,1,0.00%,1,0,100.00%
cloud.samoxa.ml,1,0.00%,1,0,100.00%
only-886494-124-16-140-20.nstool.zhuanzfx.com,1,0.00%,1,0,100.00%
only-473988-124-16-140-20.nstool.zhuanzfx.com,1,0.00%,1,0,100.00%
only-55986-124-16-140-20.nstool.zhuanzfx.com,1,0.00%,1,0,100.00%
only-648546-124-16-140-20.nstool.zhuanzfx.com,1,0.00%,1,0,100.00%
only-331998-124-16-140-20.nstool.laiqukankan.com,1,0.00%,1,0,100.00%
only-962174-124-16-140-20.nstool.laiqukankan.com,1,0.00%,1,0,100.00%
only-576754-124-16-140-20.nstool.yqkk.link,1,0.00%,1,0,100.00%
only-73307-124-16-140-20.nstool.laiqukankan.com,1,0.00%,1,0,100.00%
only-689512-124-16-140-20.nstool.laiqukankan.com,1,0.00%,1,0,100.00%
only-325858-124-16-140-20.nstool.zhuanzfx.com,1,0.00%,1,0,100.00%
only-947385-124-16-140-20.nstool.zhuanzfx.com,1,0.00%,1,0,100.00%
only-568993-124-16-140-20.nstool.yqkk.link,1,0.00%,1,0,100.00%
only-305171-124-16-140-20.nstool.yqkk.link,1,0.00%,1,0,100.00%
only-42757-124-16-140-20.nstool.netease.com,1,0.00%,1,0,100.00%
1610064231.D4EE073C2A20.device.hiwifi.com,1,0.00%,1,0,100.00%
d335luupugsy2.cloudfront.net,1,0.00%,1,0,100.00%
apics.start4all.com,1,0.00%,1,0,100.00%
uslaur.herokuapp.com,1,0.00%,1,0,100.00%
vulture.mse.sogou.com,1,0.00%,1,0,100.00%
only-620755-159-226-95-34.nstool.netease.com,1,0.00%,1,0,100.00%
umijs.org,1,0.00%,1,0,100.00%
sublimetext.com,1,0.00%,1,0,100.00%
update.virtualbox.org,1,0.00%,1,0,100.00%
1610067841.D4EE073C2A20.device.hiwifi.com,1,0.00%,1,0,100.00%
pull.ke.qq.com,1,0.00%,1,0,100.00%
analytics.woutz.com,1,0.00%,1,0,100.00%
parkble.therealstart.com,1,0.00%,1,0,100.00%
www.amitree.com,1,0.00%,1,0,100.00%
slp2p-east-std39.oray.net,1,0.00%,1,0,100.00%
ql06.zbcsvip.com,1,0.00%,1,0,100.00%
ondemand.chriscollinsinc.com,1,0.00%,1,0,100.00%
234bb104c4dafd99141e8d56f073218a.safeframe.googlesyndication.com,1,0.00%,1,0,100.00%
img.cnpython.com,1,0.00%,2,1,50.00%
i-dsm01p-cor006.api.p001.1drv.com,1,0.00%,1,0,100.00%
opencdnbaiduvdposter.jomodns.com,1,0.00%,2,1,50.00%
springer.met.vgwort.de,1,0.00%,1,0,100.00%
ma.dpool.weibo.com,1,0.00%,1,0,100.00%
m.sohu.com,1,0.00%,3,2,33.33%
otexts.com,1,0.00%,1,0,100.00%
icourse.club,1,0.00%,1,0,100.00%
bing,1,0.00%,1,0,100.00%
staging.lalali.app,1,0.00%,1,0,100.00%
ssl.googlevideo.gq,1,0.00%,1,0,100.00%
zetatielle.isopro.it,1,0.00%,1,0,100.00%
blob.dsz04prdstr06a.store.core.windows.net,1,0.00%,1,0,100.00%
blob.bn7prdstr01a.store.core.windows.net,1,0.00%,1,0,100.00%
blob.dsz04prdstr08a.store.core.windows.net,1,0.00%,1,0,100.00%
p3plcpnl0446.prod.phx3.secureserver.net,1,0.00%,1,0,100.00%
se.m.wikipedia.ahut.cf,1,0.00%,1,0,100.00%
2.mbvnclick5.com,1,0.00%,1,0,100.00%
webmail.fullsight.io,1,0.00%,1,0,100.00%
p211-keyvalueservice.icloud.com.cn,1,0.00%,1,0,100.00%
upos-sz-mirrorali02.bilivideo.com,1,0.00%,1,0,100.00%
azhk.ddrk.cf,1,0.00%,1,0,100.00%
tracker.tcp.exchange,1,0.00%,1,0,100.00%
mathjax.rstudio.com,1,0.00%,2,1,50.00%
only-450652-159-226-95-71.nstool.haowu.link,1,0.00%,1,0,100.00%
p33-caldav.icloud.com.cn,1,0.00%,1,0,100.00%
tanz-moble.01download.xyz,1,0.00%,1,0,100.00%
feedfreev6.jomodns.com,1,0.00%,2,1,50.00%
daehan.kicksite.net,1,0.00%,1,0,100.00%
i-bl6p-cor004.api.p001.1drv.com,1,0.00%,1,0,100.00%
b197.s372.meetrics.net,1,0.00%,1,0,100.00%
grassmats.co.uk,1,0.00%,1,0,100.00%
qq-video.cdn-go.cn,1,0.00%,2,1,50.00%
cast.innity.com,1,0.00%,1,0,100.00%
cpcalendars.intrepidusa-doc.tk,1,0.00%,1,0,100.00%
portal.domesticandgeneral.org.au,1,0.00%,1,0,100.00%
jp16.graniterapids.com,1,0.00%,1,0,100.00%
qq-web-other.cdn-go.cn,1,0.00%,3,2,33.33%
localhost.sec.qq.com,1,0.00%,1,0,100.00%
direwolf-bc76a57635.herokuapp.com,1,0.00%,1,0,100.00%
e592.dscg.akamaiedge.net,1,0.00%,2,1,50.00%
wm.xiajunhuagong.cn.w.cdngslb.com,1,0.00%,1,0,100.00%
aecm6lskxygidkb6.node.ppio.cloud,1,0.00%,1,0,100.00%
aecmynwftjjraz35.node.ppio.cloud,1,0.00%,1,0,100.00%
e2490.dscf.akamaiedge.net,1,0.00%,2,1,50.00%
hw-sh-live-p2p-2.chat.bilibili.com,1,0.00%,1,0,100.00%
www.evita-project.org,1,0.00%,1,0,100.00%
beauty.meituyun.com,1,0.00%,1,0,100.00%
foxitsoftware-com.mail.protection.outlook.com,1,0.00%,1,0,100.00%
weicolog.api.weibo.cn,1,0.00%,4,3,25.00%
sofire.n.shifen.com,1,0.00%,5,4,20.00%
36d7fbc3.ovslegodl.sched.ovscdns.com,1,0.00%,1,0,100.00%
hk.thewss.tk,1,0.00%,1,0,100.00%
ssd-staging.sycamoreinformatics.com,1,0.00%,1,0,100.00%
mail.kagul.cyou,1,0.00%,1,0,100.00%
preimage0.iqiyipic.com,1,0.00%,2,1,50.00%
docimg9.docs.qq.com,1,0.00%,2,1,50.00%
www.91boshuo.com,1,0.00%,1,0,100.00%
www.yisu.com,1,0.00%,1,0,100.00%
juejin.cn.w.cdngslb.com,1,0.00%,1,0,100.00%
p3-juejin.byteimg.com,1,0.00%,2,1,50.00%
p3-juejin.byteimg.com.w.cdngslb.com,1,0.00%,2,1,50.00%
api.juejin.cn.w.cdngslb.com,1,0.00%,1,0,100.00%
abtestvm.bytedance.com,1,0.00%,1,0,100.00%
abtestvm.bytedance.com.w.cdngslb.com,1,0.00%,1,0,100.00%
cryptonomicon.mit.edu,1,0.00%,1,0,100.00%
ca-en.jowae.com,1,0.00%,1,0,100.00%
ws.lanhuapp.com,1,0.00%,1,0,100.00%
lanhu-logger.cn-beijing.log.aliyuncs.com,1,0.00%,1,0,100.00%
disruptnetwork.podigee.io,1,0.00%,1,0,100.00%
office3.dawei.tk,1,0.00%,1,0,100.00%
csng.ok.getambassador.com,1,0.00%,1,0,100.00%
direwolf-de2f830349.herokuapp.com,1,0.00%,1,0,100.00%
mail.presfawdobu.tk,1,0.00%,1,0,100.00%
mail.ushsdabababsa.ga,1,0.00%,1,0,100.00%
1610060676.D4EE073C2A20.device.hiwifi.com,1,0.00%,1,0,100.00%
1610060697.D4EE073C2A20.device.hiwifi.com,1,0.00%,1,0,100.00%
mail.pipimorederhau.ml,1,0.00%,1,0,100.00%
ioversea.mobileapi.ucnewtest.wanyol.com,1,0.00%,1,0,100.00%
dr.netease.im,1,0.00%,1,0,100.00%
mail.fopmy.cyou,1,0.00%,1,0,100.00%
blob.dsm07prdstr09c.store.core.windows.net,1,0.00%,1,0,100.00%
domus-edesia-chef-a-domicilio.socialacademy.me,1,0.00%,1,0,100.00%
ye.dun.163yun.com,1,0.00%,1,0,100.00%
testing.1degree.org,1,0.00%,1,0,100.00%
form.dap.be,1,0.00%,1,0,100.00%
1610333531.D4EE073396E8.device.hiwifi.com,1,0.00%,1,0,100.00%
1610333562.D4EE073396E8.device.hiwifi.com,1,0.00%,1,0,100.00%
e2cs33.gcp.gvt2.com,1,0.00%,1,0,100.00%
dl.teamviewer.cn,1,0.00%,2,1,50.00%
secure.wescom.org,1,0.00%,1,0,100.00%
mipcache.jomodns.com,1,0.00%,2,1,50.00%
vc-brain.ndcpp.com,1,0.00%,1,0,100.00%
stsdk.vivo.com.cn,1,0.00%,2,1,50.00%
control.verysync.cn,1,0.00%,2,1,50.00%
wsxf.hbzw.gov.cn,1,0.00%,1,0,100.00%
www.hbgbdst.com,1,0.00%,2,1,50.00%
trace.ynet.com,1,0.00%,1,0,100.00%
unilog.wostore.cn,1,0.00%,1,0,100.00%
web.m.taobao.com,1,0.00%,2,1,50.00%
site-42697893545.helphub.io,1,0.00%,1,0,100.00%
taverne-dev.mfd-net.de,1,0.00%,1,0,100.00%
course.jessratcliffe.com,1,0.00%,1,0,100.00%
direwolf-88288f45c0-renamed.herokuapp.com,1,0.00%,1,0,100.00%
direwolf-8001bd71ce.herokuapp.com,1,0.00%,1,0,100.00%
mariacristina-agnello-madesign.divisare.pro,1,0.00%,1,0,100.00%
hinet2.xiaolongyun.xyz,1,0.00%,1,0,100.00%
rapidfire.amsnetwork.app,1,0.00%,1,0,100.00%
drydocks-gov-ae.mail.protection.outlook.com,1,0.00%,1,0,100.00%
da.dun.163.com,1,0.00%,1,0,100.00%
log-api.pangolin-sdk-toutiao-b.com.51296c5e.c.cdnhwc1.com,1,0.00%,3,2,33.33%
itunes.apple.com.edgekey.net,1,0.00%,2,1,50.00%
kk.visionpunk.xyz,1,0.00%,1,0,100.00%
1610333583.D4EE073396E8.device.hiwifi.com,1,0.00%,1,0,100.00%
youtubezero.herokuapp.com,1,0.00%,1,0,100.00%
m.oyec4e.ga,1,0.00%,1,0,100.00%
eppelin.tntszb.icujsoquybrsmwk.enw.systems,1,0.00%,1,0,100.00%
ptsouweb.vivo.com.cn,1,0.00%,1,0,100.00%
oneconsole.alicdn.com.w.cdngslb.com,1,0.00%,1,0,100.00%
alinw.alicdn.com.danuoyi.tbcache.com,1,0.00%,1,0,100.00%
ucc.alicdn.com.danuoyi.tbcache.com,1,0.00%,1,0,100.00%
retcode.alicdn.com.danuoyi.tbcache.com,1,0.00%,6,5,16.67%
heic.alicdn.com,1,0.00%,2,1,50.00%
zres.alicdn.com,1,0.00%,2,1,50.00%
mdike.alicdn.com,1,0.00%,2,1,50.00%
yixiu-abtest.alicdn.com,1,0.00%,2,1,50.00%
ossgw.alicdn.com,1,0.00%,5,4,20.00%
mail.quattthepermyka.tk,1,0.00%,1,0,100.00%
makoshan.logdown.com,1,0.00%,1,0,100.00%
ornac.scholasticahq.com,1,0.00%,1,0,100.00%
mail.ranmare.ga,1,0.00%,1,0,100.00%
i-dsm04p-cor001.api.p001.1drv.com,1,0.00%,1,0,100.00%
wdpr-juliehodgemd.westd.info,1,0.00%,1,0,100.00%
mail.joaoporto.ml,1,0.00%,1,0,100.00%
ww2.mediaclub.tv,1,0.00%,1,0,100.00%
d6.rethink-education.com,1,0.00%,1,0,100.00%
j4jddc99.e0.sched.ovscdns.com,1,0.00%,1,0,100.00%
wdzy.ucas.ac.cn,1,0.00%,1,0,100.00%
getpocket.com,1,0.00%,1,0,100.00%
development.allcrux.com,1,0.00%,1,0,100.00%
miniprogram.ishansong.com,1,0.00%,1,0,100.00%
beidou.ishansong.com,1,0.00%,1,0,100.00%
online.slb.api.ishansong.com,1,0.00%,1,0,100.00%
file.ishansong.com,1,0.00%,1,0,100.00%
cdn.ishansong.com,1,0.00%,2,1,50.00%
cdn.ishansong.com.m.alikunlun.com,1,0.00%,1,0,100.00%
rechner.nachfolge.de,1,0.00%,1,0,100.00%
tensorflow.google.cn,1,0.00%,1,0,100.00%
developers.google.com,1,0.00%,2,1,50.00%
tip.org.tr,1,0.00%,1,0,100.00%
1610103887.D4EE073C2A20.device.hiwifi.com,1,0.00%,1,0,100.00%
ClIENtlOGVOdP2P.haPLaT.Net,1,0.00%,1,0,100.00%
tRaNSIT1.wsloG.cHiNAnEtcEnTer.CoM,1,0.00%,1,0,100.00%
mAmbAP2Pvodh5.8686c.cOm,1,0.00%,1,0,100.00%
img5.cache.netease.com,1,0.00%,1,0,100.00%
proxyweibovideo.gslb.sinaedge.com,1,0.00%,1,0,100.00%
blog.advicenode.com,1,0.00%,1,0,100.00%
gdp.alicdn.com,1,0.00%,2,1,50.00%
sock71-ap1.pusher.com,1,0.00%,1,0,100.00%
60.wowfan.net,1,0.00%,1,0,100.00%
shopping.inlooma.com,1,0.00%,1,0,100.00%
xa84.tiktopple.com,1,0.00%,1,0,100.00%
d30c3ninvwucte.cloudfront.net,1,0.00%,1,0,100.00%
esxi.r0gu3ptm.tk,1,0.00%,1,0,100.00%
taste.unitedwayhaysco.org,1,0.00%,1,0,100.00%
newapi.taplause.com,1,0.00%,1,0,100.00%
ppa.launchpad.net.itechs.cn,1,0.00%,1,0,100.00%
www5b.pfuniverse.com,1,0.00%,1,0,100.00%
v.euqq.cn.w.kunlunaq.com,1,0.00%,1,0,100.00%
panda.moyix.net,1,0.00%,1,0,100.00%
j9bqptcvqodk86o447q5maoeitf7lorrsvrh4043uepp2vbp8j8vu97u.qc.x.bsgslb.cn,1,0.00%,1,0,100.00%
c8714eqv8s4impjj99ilbf875pct5fakdq0duvrjt2mnfiirlkrvvhr4.qc.x.bsgslb.cn,1,0.00%,1,0,100.00%
linkdood.httc.com.cn,1,0.00%,1,0,100.00%
1610078701.D4EE073C2A20.device.hiwifi.com,1,0.00%,1,0,100.00%
1610078728.D4EE073C2A20.device.hiwifi.com,1,0.00%,1,0,100.00%
9s8ftc99ftsns4520bp7j3u74f48pj6r2jk77bs828lr3mdambbfv2hd.tt.x.bsgslb.cn,1,0.00%,1,0,100.00%
flph633gg28c1e1o46b3n7p1m97176sfpte0ui81qu9uqkm1kv2vuda2.tt.x.bsgslb.cn,1,0.00%,1,0,100.00%
oldwp.247hometesting.com,1,0.00%,1,0,100.00%
r1.sn-j5o7dn76.gvt1.com,1,0.00%,1,0,100.00%
livecb.alicdn.com,1,0.00%,1,0,100.00%
52.push2.eastmoney.com,1,0.00%,1,0,100.00%
13.push2.eastmoney.com,1,0.00%,1,0,100.00%
direwolf-ff717ed8f1.herokuapp.com,1,0.00%,1,0,100.00%
atomolsonfitness.gymmasteronline.com,1,0.00%,1,0,100.00%
staging.gatewayresourcelibrary.com,1,0.00%,1,0,100.00%
mail.tiobeschcow.tk,1,0.00%,1,0,100.00%
p45-contacts.icloud.com,1,0.00%,2,1,50.00%
b2badmin.lenovo.com.cn,1,0.00%,1,0,100.00%
www.ibp.cas.cn,1,0.00%,1,0,100.00%
wWw.VOd.lXDnS.cOm,1,0.00%,2,1,50.00%
passport.tianya.cn,1,0.00%,1,0,100.00%
dol.tianya.cn,1,0.00%,1,0,100.00%
stat.tianya.cn,1,0.00%,1,0,100.00%
collect.tianya.cn,1,0.00%,1,0,100.00%
static.tianya.cn,1,0.00%,1,0,100.00%
www.tianya.cn,1,0.00%,1,0,100.00%
service.tianya.cn,1,0.00%,1,0,100.00%
userlogo.tianya.cn,1,0.00%,1,0,100.00%
search.tianya.cn,1,0.00%,1,0,100.00%
www.hainan.net,1,0.00%,1,0,100.00%
a56e8fb77c67c7c201fcb2c689e45093e.profile.fra2-c2.cloudfront.net,1,0.00%,1,0,100.00%
game.tianya.cn,1,0.00%,1,0,100.00%
cas-pra.sugon.com,1,0.00%,1,0,100.00%
developer.hpccube.com,1,0.00%,1,0,100.00%
stable.pay.st.sankuai.com,1,0.00%,1,0,100.00%
offlinebeijing-bj.st.vip.sankuai.com,1,0.00%,1,0,100.00%
p12-buy-lb.itunes-apple.com.akadns.net,1,0.00%,1,0,100.00%
www.dbank.com,1,0.00%,1,0,100.00%
muchong.com,1,0.00%,1,0,100.00%
xbroker-z1-i3.ngxcld.com,1,0.00%,1,0,100.00%
blog.es2000.de,1,0.00%,1,0,100.00%
126mx02.mxmail.netease.com,1,0.00%,1,0,100.00%
126mx03.mxmail.netease.com,1,0.00%,1,0,100.00%
126mx01.mxmail.netease.com,1,0.00%,1,0,100.00%
126mx00.mxmail.netease.com,1,0.00%,1,0,100.00%
bbb-0241.laeng.info.qa.carlosfairdns.com,1,0.00%,1,0,100.00%
blog.easynda.com,1,0.00%,1,0,100.00%
goerlitz.staging.zootickets.app,1,0.00%,1,0,100.00%
sorasushisteak.uorder.io,1,0.00%,1,0,100.00%
webdisk.web67.srv11.host-os.com,1,0.00%,1,0,100.00%
mail.troscapla.cf,1,0.00%,1,0,100.00%
mail.jamesfrancizkenefick.ml,1,0.00%,1,0,100.00%
groups.tianya.cn,1,0.00%,1,0,100.00%
licai.tianya.cn,1,0.00%,1,0,100.00%
shang.tianya.cn,1,0.00%,1,0,100.00%
market.m.taobao.com.danuoyi.tbcache.com,1,0.00%,1,0,100.00%
cn-beijing.office-static.aliyunpds.com,1,0.00%,2,1,50.00%
office-imm-static.imm.aliyuncs.com,1,0.00%,2,1,50.00%
pjp1-vipcollabrtc.officeapps.live.com,1,0.00%,1,0,100.00%
cdn.soft.360.cn,1,0.00%,2,1,50.00%
arthas.safe.360.cn,1,0.00%,1,0,100.00%
activity.soft.360.cn,1,0.00%,1,0,100.00%
ggtf.shangdejigou.cn,1,0.00%,1,0,100.00%
saltuc.sunlands.com,1,0.00%,1,0,100.00%
galshan.co.il,1,0.00%,1,0,100.00%
jobs.leehealth.org,1,0.00%,1,0,100.00%
synagoga.ockostrow.pl,1,0.00%,1,0,100.00%
putty.org.ru,1,0.00%,1,0,100.00%
fiscale.evolove.it,1,0.00%,1,0,100.00%
mail.knhh.ml,1,0.00%,1,0,100.00%
team.pagurospaces.com,1,0.00%,1,0,100.00%
staging.propelx.com,1,0.00%,1,0,100.00%
dsgn.ocmic.org.uk,1,0.00%,1,0,100.00%
learn.sipwm.com,1,0.00%,1,0,100.00%
cdn-lfs.huggingface.co,1,0.00%,5,4,20.00%
m.rr5ptd.ga,1,0.00%,1,0,100.00%
mug.criteo.com,1,0.00%,1,0,100.00%
mug.sg1.vip.prod.criteo.com,1,0.00%,1,0,100.00%
qqq.gtimg.cn,1,0.00%,2,1,50.00%
fragment.tmall.com,1,0.00%,2,1,50.00%
shop.zuk.at,1,0.00%,1,0,100.00%
blog.officefurnitureonline.co.uk,1,0.00%,1,0,100.00%
staging.goyesler.com,1,0.00%,1,0,100.00%
shift-api.sensei.com,1,0.00%,1,0,100.00%
mail.rindodelilbeite.tk,1,0.00%,1,0,100.00%
ourspace.thesanjosegroup.com,1,0.00%,1,0,100.00%
res.qhcdn.com,1,0.00%,1,0,100.00%
hp.mercadolibre.pulpou.com,1,0.00%,1,0,100.00%
m.rrddnf.ga,1,0.00%,1,0,100.00%
optionsbackup.logitech.com,1,0.00%,1,0,100.00%
imgwcszq.soufunimg.com.wswebcdn.com,1,0.00%,1,0,100.00%
se1.360simg.com,1,0.00%,2,1,50.00%
p8.qhimg.com,1,0.00%,3,2,33.33%
p499.ssl.qhimgs4.com,1,0.00%,4,3,25.00%
im-linkserver-77.csdn.net,1,0.00%,1,0,100.00%
blog.humanminds.eu,1,0.00%,1,0,100.00%
vancomrade.co.uk,1,0.00%,1,0,100.00%
crossword.dailyprincetonian.com,1,0.00%,1,0,100.00%
mail.toffaisketquibes.cf,1,0.00%,1,0,100.00%
sg10.graniterapids.com,1,0.00%,1,0,100.00%
paradox-productions.checkcherry.com,1,0.00%,1,0,100.00%
direwolf-3e371970ca.herokuapp.com,1,0.00%,1,0,100.00%
ios-sentry.mm.taou.com,1,0.00%,1,0,100.00%
rc09-g1.oray.com,1,0.00%,1,0,100.00%
navua.adventist.org.fj,1,0.00%,1,0,100.00%
x16.litiliti.com,1,0.00%,1,0,100.00%
ereg.som.yale.edu,1,0.00%,1,0,100.00%
disk.month.ml,1,0.00%,1,0,100.00%
training.izonesoftware.co.uk,1,0.00%,1,0,100.00%
www.tm.prd.ags.trafficmanager.NET,1,0.00%,9,8,11.11%
share.tiktokcloud.tk,1,0.00%,1,0,100.00%
strong4-server.herokuapp.com,1,0.00%,1,0,100.00%
gateway-remote.homedns.org,1,0.00%,1,0,100.00%
xue.zerobo.ml,1,0.00%,1,0,100.00%
v2hk3-ws-tls.ytv2line.top,1,0.00%,1,0,100.00%
widget-api.heweather.net,1,0.00%,1,0,100.00%
abacus.ideocambridge.com,1,0.00%,1,0,100.00%
s02.solidfilesusercontent.com,1,0.00%,1,0,100.00%
e.FeiQ18.com,1,0.00%,1,0,100.00%
1610078681.D4EE073C2A20.device.hiwifi.com,1,0.00%,1,0,100.00%
guangguang.cloudvideocdn.taobao.com,1,0.00%,2,1,50.00%
mirrors.njupt.edu.cn,1,0.00%,10,9,10.00%
p3plvcpnl468347.prod.phx3.secureserver.net,1,0.00%,1,0,100.00%
fpl.uxpin-rails-staging-upd-ld4bvd.uxpinstage.com,1,0.00%,1,0,100.00%
o2.yixiangke.ga,1,0.00%,1,0,100.00%
woodbridgetkd.classic.kicksite.net,1,0.00%,1,0,100.00%
acquire.privy-staging-pr-5351.privy-staging.com,1,0.00%,1,0,100.00%
zfda.ggj.gov.cn,1,0.00%,1,0,100.00%
c.live.com,1,0.00%,1,0,100.00%
www.0vzu.org,1,0.00%,1,0,100.00%
jpn.loki.delve.office.com,1,0.00%,1,0,100.00%
notion-emojis.s3-us-west-2.amazonaws.com,1,0.00%,1,0,100.00%
opengraph.githubassets.com,1,0.00%,1,0,100.00%
bcc2021.edigital-testing.tk,1,0.00%,1,0,100.00%
WWW.VOD.LxdNS.coM,1,0.00%,2,1,50.00%
ifzq.gtimg.cn,1,0.00%,1,0,100.00%
m.aqemka.ga,1,0.00%,1,0,100.00%
hub.sandbox.zaikio.com,1,0.00%,1,0,100.00%
WWw.VOD.lXDNs.com,1,0.00%,2,1,50.00%
www.kingsfw.com,1,0.00%,1,0,100.00%
app.bigwinepot.com,1,0.00%,1,0,100.00%
pwittmann.fluidgalleries.co,1,0.00%,1,0,100.00%
mail.preshanssophopavor.tk,1,0.00%,1,0,100.00%
cpcontacts.maksonsgroup-com.ga,1,0.00%,1,0,100.00%
1610078723.D4EE073C2A20.device.hiwifi.com,1,0.00%,1,0,100.00%
111-20-12-245.volcsiriusbd.com,1,0.00%,1,0,100.00%
tg24c.tkcdns.com,1,0.00%,1,0,100.00%
coolkidsclub.42pag.es,1,0.00%,1,0,100.00%
wWw.VOd.lxDNs.Com,1,0.00%,2,1,50.00%
us05.greenhubtx.ga,1,0.00%,1,0,100.00%
mail.codapillar.com,1,0.00%,1,0,100.00%
ns1.toptam.ir,1,0.00%,1,0,100.00%
new.o2in.ru,1,0.00%,1,0,100.00%
corsi.fadpsy.it,1,0.00%,1,0,100.00%
mail.cinefast.tk,1,0.00%,1,0,100.00%
itc.eventi.fi,1,0.00%,1,0,100.00%
www92.zippyshare.com,1,0.00%,1,0,100.00%
www97.zippyshare.com,1,0.00%,1,0,100.00%
mjj3004.hjdn.tk,1,0.00%,1,0,100.00%
pc-86-114-0-13.herokuapp.com,1,0.00%,1,0,100.00%
mjceo2.herokuapp.com,1,0.00%,1,0,100.00%
only-852158-124-16-139-61.nstool.haowu.link,1,0.00%,1,0,100.00%
ccmdls.adobe.com,1,0.00%,2,1,50.00%
only-704821-124-16-139-61.nstool.321fenx.com,1,0.00%,1,0,100.00%
login.66law.cn,1,0.00%,2,1,50.00%
club.xywy.com,1,0.00%,2,1,50.00%
lib.wkimg.com,1,0.00%,1,0,100.00%
c1.wkimg.com,1,0.00%,1,0,100.00%
bdmjs.xywy.com,1,0.00%,1,0,100.00%
img.static.xywy.com,1,0.00%,1,0,100.00%
doctor.club.xywy.com,1,0.00%,1,0,100.00%
stat-y.xywy.com,1,0.00%,1,0,100.00%
display.xywy.com,1,0.00%,1,0,100.00%
sydy.api.xywy.com,1,0.00%,1,0,100.00%
static.img.xywy.com,1,0.00%,1,0,100.00%
stat-z.xywy.com,1,0.00%,1,0,100.00%
tramayne.co.za,1,0.00%,1,0,100.00%
woc.repotmeat.cf,1,0.00%,1,0,100.00%
only-551262-159-226-95-34.nstool.zhuanzfx.com,1,0.00%,1,0,100.00%
us-01.licom.ml,1,0.00%,1,0,100.00%
mms2ui.k3ov53eft.gq,1,0.00%,1,0,100.00%
ogtzahprvmb.masiruju.cz,1,0.00%,1,0,100.00%
m.nnd7xl.ga,1,0.00%,1,0,100.00%
www.latexlive.com,1,0.00%,1,0,100.00%
www.latexstudio.net,1,0.00%,1,0,100.00%
static.chunyuyisheng.com,1,0.00%,2,1,50.00%
qiyukf.nosdn.127.net,1,0.00%,3,2,33.33%
resourced.chunyu.mobi,1,0.00%,1,0,100.00%
xtrapath4.xboxprod.izatcloud.net,1,0.00%,1,0,100.00%
rc10-fc05.oray.com,1,0.00%,1,0,100.00%
tRansIt1.wSLOG.CHInAnetCentER.coM,1,0.00%,1,0,100.00%
longandfoster.luxuryrealestate.com,1,0.00%,1,0,100.00%
mail.connacililevs.tk,1,0.00%,1,0,100.00%
mail.conmiwersixfcos.tk,1,0.00%,1,0,100.00%
midvalegarage.co.uk,1,0.00%,1,0,100.00%
45-76-253-6.luminatinet.com,1,0.00%,1,0,100.00%
appcashier256.95516.com.wscdns.com,1,0.00%,2,1,50.00%
config.me.apple-dns.net,1,0.00%,2,1,50.00%
weibointl.api.weibo.cn,1,0.00%,5,4,20.00%
e13551.dscg.akamaiedge.net,1,0.00%,2,1,50.00%
passport.shanghaihuanli.com.w.kunluncan.com,1,0.00%,1,0,100.00%
passport.bilibili.cn.w.kunluncan.com,1,0.00%,1,0,100.00%
5kex7xoa.sched.d0.tdnsdp1.cn,1,0.00%,1,0,100.00%
8zye0awu.sched.d0.tdnsdp1.cn,1,0.00%,1,0,100.00%
24m0q0m3.sched.sma.tdnsstic1.cn.cjt.krcdn.idatacube.com,1,0.00%,1,0,100.00%
v.ifeng.com.cdn.dnsv1.com,1,0.00%,1,0,100.00%
vanguard.aligames.com,1,0.00%,1,0,100.00%
zb.wagbridge.alibaba-clould.taobao.com,1,0.00%,1,0,100.00%
zb.wagbridge.alibaba-clould.taobao.com.gds.alibabadns.com,1,0.00%,1,0,100.00%
sdklog.9game.cn,1,0.00%,1,0,100.00%
hz.wagbridge.alibaba-clould.taobao.com,1,0.00%,1,0,100.00%
hz.wagbridge.alibaba-clould.taobao.com.gds.alibabadns.com,1,0.00%,1,0,100.00%
p10445-gangplank.ejoy.com,1,0.00%,1,0,100.00%
carbon-api.lingxigames.com,1,0.00%,1,0,100.00%
kun-sz-prod.lingxigames.com,1,0.00%,1,0,100.00%
p10445-launcher.ejoy.com,1,0.00%,1,0,100.00%
p10445-log-collector.ejoy.com,1,0.00%,1,0,100.00%
p10445-ob-platform.ejoy.com,1,0.00%,1,0,100.00%
p10445-nginx-slb.ejoy.com,1,0.00%,1,0,100.00%
res.flysdk.cn,1,0.00%,1,0,100.00%
account.9game.cn,1,0.00%,1,0,100.00%
static.tsbrowser.xiangtatech.com,1,0.00%,1,0,100.00%
v.ifeng.com,1,0.00%,1,0,100.00%
oany97vz.sched.sma.tdnsstic1.cn,1,0.00%,1,0,100.00%
oany97vz.sched.sma.tdnsstic1.cn.cjt.krcdn.idatacube.com,1,0.00%,1,0,100.00%
www.baofeng.com,1,0.00%,1,0,100.00%
www.kankan.com,1,0.00%,1,0,100.00%
www.baofeng.com.bsclink.cn,1,0.00%,1,0,100.00%
www.kankan.com.w.alikunlun.com,1,0.00%,1,0,100.00%
www.le.com,1,0.00%,1,0,100.00%
www.le.com.s.galileo.jcloud-cdn.com,1,0.00%,1,0,100.00%
p10445-friend.ejoy.com,1,0.00%,1,0,100.00%
p10445-chat-wsclient.ejoy.com,1,0.00%,1,0,100.00%
p10445-qabot.ejoy.com,1,0.00%,1,0,100.00%
p10445-chat-tcpclient.ejoy.com,1,0.00%,1,0,100.00%
o0.d.meituan.net,1,0.00%,1,0,100.00%
scontent.whatsapp.net,1,0.00%,3,2,33.33%
public.dm.files.1drv.com,1,0.00%,1,0,100.00%
old-vc-mirror.snssdk.com,1,0.00%,1,0,100.00%
bcscschools.helpjuice.com,1,0.00%,1,0,100.00%
emoji.qpic.cn.sched.legopic1-dk.tdnsv6.com,1,0.00%,3,2,33.33%
miaowu.baidu.com,1,0.00%,2,1,50.00%
p39-buy-lb.itunes-apple.com.akadns.net,1,0.00%,1,0,100.00%
1703698.sched.dma.tdnsdl1.cn.cdl.cdncloud.idc400.com,1,0.00%,1,0,100.00%
midas.gtimg.cn.sched.legopic1-dk.tdnsv6.com,1,0.00%,2,1,50.00%
d2gt2ux04o03l1.cloudfront.net,1,0.00%,2,1,50.00%
mobilemad.zlongame.com,1,0.00%,1,0,100.00%
countpvn.3g.fang.com,1,0.00%,1,0,100.00%
iterable.scribd.com,1,0.00%,1,0,100.00%
imgv2-2-f.scribdassets.com,1,0.00%,1,0,100.00%
imgv2-1-f.scribdassets.com,1,0.00%,1,0,100.00%
blog.scribd.com,1,0.00%,1,0,100.00%
email.hello.scribd.com,1,0.00%,1,0,100.00%
mailgun.org,1,0.00%,1,0,100.00%
scribd.map.fastly.net,1,0.00%,3,2,33.33%
mail.secretosdemadrid.es,1,0.00%,1,0,100.00%
ordoelecra-blog.logdown.com,1,0.00%,1,0,100.00%
1610078778.D4EE073C2A20.device.hiwifi.com,1,0.00%,1,0,100.00%
gfzscq.weain.mil.cn,1,0.00%,1,0,100.00%
ztb.weain.mil.cn,1,0.00%,1,0,100.00%
www.mod.gov.cn,1,0.00%,2,1,50.00%
inst-fs-yul-prod-sfyv6gptlf-286754664.ca-central-1.elb.amazonaws.com,1,0.00%,1,0,100.00%
canvas-yul-prod-c222-1474529541.ca-central-1.elb.amazonaws.com,1,0.00%,1,0,100.00%
daycount-1450237091.cn-north-1.elb.amazonaws.com.cn,1,0.00%,1,0,100.00%
restpublicalbloadbalancer-165328169.ca-central-1.elb.amazonaws.com,1,0.00%,1,0,100.00%
www.feishu.cn.w.cdngslb.com,1,0.00%,1,0,100.00%
sf1-scmcdn-cn.feishucdn.com.wsglb0.com,1,0.00%,2,1,50.00%
picwebws.pstatp.com.wsglb0.com,1,0.00%,2,1,50.00%
p3-hera.byteimg.com.w.cdngslb.com,1,0.00%,2,1,50.00%
blob.bn9prdstr08a.store.core.windows.net,1,0.00%,1,0,100.00%
crates.io,1,0.00%,2,1,50.00%
static.crates.io,1,0.00%,2,1,50.00%
d19xqa3lc3clo8.cloudfront.net,1,0.00%,2,1,50.00%
img.meituan.net,1,0.00%,10,9,10.00%
p1.meituan.net.cdn.dnsv1.com,1,0.00%,2,1,50.00%
p0.meituan.net.cdn.dnsv1.com,1,0.00%,2,1,50.00%
img.meituan.net.download.ks-cdn.com,1,0.00%,2,1,50.00%
meituan.sched.skalego-dk.tdnsstic1.cn,1,0.00%,2,1,50.00%
web.archive.org,1,0.00%,2,1,50.00%
orcid.zendesk.com,1,0.00%,1,0,100.00%
only-748571-124-16-137-11.nstool.laiqukankan.com,1,0.00%,1,0,100.00%
cambrian-images.cdn.bcebos.com.a.bdydns.com,1,0.00%,2,1,50.00%
lb.apr-1180c.edgecastdns.net,1,0.00%,13,12,7.69%
d3azwz0fcakc5.cloudfront.net,1,0.00%,1,0,100.00%
vpn.nju.edu.cn,1,0.00%,1,0,100.00%
mg.uu.163.com.w.kunluncan.com,1,0.00%,1,0,100.00%
v83-017.douyinvod.com.w.cdngslb.com,1,0.00%,1,0,100.00%
v9-cold1.douyinvod.com,1,0.00%,2,1,50.00%
v9-cold1.douyinvod.com.bsgslb.com,1,0.00%,2,1,50.00%
zttvc2.v.bsgslb.com,1,0.00%,2,1,50.00%
mstatic.cdn.bcebos.com.a.bdydns.com,1,0.00%,2,1,50.00%
se-edge.itunes-apple.com.akadns.net,1,0.00%,2,1,50.00%
iosapps-tp.g.aaplimg.com,1,0.00%,1,0,100.00%
media-shxiya-yijia10.sn3oss.ctyunxs.cn,1,0.00%,1,0,100.00%
math.jianshu.com,1,0.00%,1,0,100.00%
home-store-packages.uniontech.com,1,0.00%,1,0,100.00%
1610071603.D4EE073C2A20.device.hiwifi.com,1,0.00%,1,0,100.00%
paascu.org.ph,1,0.00%,1,0,100.00%
ns1.manandvanelephantandcastle.com,1,0.00%,1,0,100.00%
bond.backerkit.com,1,0.00%,1,0,100.00%
1610060665.D4EE073C2A20.device.hiwifi.com,1,0.00%,1,0,100.00%
as202l.princeton.edu,1,0.00%,1,0,100.00%
wWW.VOD.lXDNs.cOM,1,0.00%,2,1,50.00%
mAMBaP2PVOdmoBILe.8686c.coM,1,0.00%,2,1,50.00%
wwW.VOd.LXDnS.CoM,1,0.00%,2,1,50.00%
api.ifuncun.cn,1,0.00%,1,0,100.00%
iad.g.163.com,1,0.00%,1,0,100.00%
newoa.arp.cn,1,0.00%,1,0,100.00%
ali-bj-pcdn-29.biliapi.net,1,0.00%,1,0,100.00%
collab.yuque.com.alipaydns.com,1,0.00%,1,0,100.00%
selfpage-voice.cdn.bcebos.com,1,0.00%,2,1,50.00%
selfpage-voice.cdn.bcebos.com.a.bdydns.com,1,0.00%,2,1,50.00%
edge-chat.facebook.com,1,0.00%,2,1,50.00%
f.m.suning.com,1,0.00%,2,1,50.00%
pmmtk.pinduoduo.com,1,0.00%,1,0,100.00%
avatar2-2.pddpic.com.a.bdydns.com,1,0.00%,2,1,50.00%
opencdnpddpic2.jomodns.com,1,0.00%,2,1,50.00%
hivoice-drcn-emui-dbankcloud-com-drcn.appacc-region.dbankedge.net,1,0.00%,1,0,100.00%
imagelib.cdn.bcebos.com,1,0.00%,2,1,50.00%
imagelib.cdn.bcebos.com.a.bdydns.com,1,0.00%,2,1,50.00%
baozhang.baidu.com,1,0.00%,2,1,50.00%
baozhang.e.shifen.com,1,0.00%,2,1,50.00%
messagecenter.hicloud.com,1,0.00%,1,0,100.00%
healthcommon.hicloud.com,1,0.00%,1,0,100.00%
kidwatch.hicloud.com,1,0.00%,1,0,100.00%
imlong-sa-p05-drcn-platform-dbankcloud-cn-drcn.appacc-region.dbankedge.net,1,0.00%,1,0,100.00%
imgs.easyliao.com.w.kunlungr.com,1,0.00%,1,0,100.00%
mxg.cdn.yunjiasu360.com,1,0.00%,1,0,100.00%
dl.ccf.org.cn,1,0.00%,1,0,100.00%
www.e-tiller.com,1,0.00%,1,0,100.00%
contextual.media.net,1,0.00%,1,0,100.00%
api.btloader.com,1,0.00%,1,0,100.00%
ggsoftware-d.openx.net,1,0.00%,1,0,100.00%
lax-1-apex.go.sonobi.com,1,0.00%,1,0,100.00%
lax-1-sync.go.sonobi.com,1,0.00%,1,0,100.00%
a0xcd-a0xal-10phi1xlgy0q-1371607250.us-east-1.elb.amazonaws.com,1,0.00%,1,0,100.00%
ActivationEdge-activation-886544353.ap-northeast-1.elb.amazonaws.com,1,0.00%,1,0,100.00%
elb-aws-fr-dorpat-283474803.eu-central-1.elb.amazonaws.com,1,0.00%,1,0,100.00%
wx8.qq.com,1,0.00%,1,0,100.00%
lh4.googleusercontent.com,1,0.00%,2,1,50.00%
1029304.sched.sma-dk.tdnsstic1.cn.cjt.krcdn.idatacube.com,1,0.00%,2,1,50.00%
ocsp.rootca1.amazontrust.com,1,0.00%,2,1,50.00%
bd2.a.kwimgs.com,1,0.00%,2,1,50.00%
4554.jiedian.info,1,0.00%,1,0,100.00%
weather.api.moji.com,1,0.00%,2,1,50.00%
bwgjp.goodday.gq,1,0.00%,1,0,100.00%
eft-test.compass-canada.com,1,0.00%,1,0,100.00%
download.01.org,1,0.00%,1,0,100.00%
smartmail1.fednet.gov.ae,1,0.00%,1,0,100.00%
smartmail2.fednet.gov.ae,1,0.00%,1,0,100.00%
mail.nirvanatr.ga,1,0.00%,1,0,100.00%
mail.nodeid.tk,1,0.00%,1,0,100.00%
1608227395.D4EE071FA772.device.hiwifi.com,1,0.00%,1,0,100.00%
d1fd687oe6a92y.cloudfront.net,1,0.00%,1,0,100.00%
1608227452.D4EE071FA772.device.hiwifi.com,1,0.00%,1,0,100.00%
1608227478.D4EE071FA772.device.hiwifi.com,1,0.00%,1,0,100.00%
mail.gadebesearwordtrod.tk,1,0.00%,1,0,100.00%
1610060686.D4EE073C2A20.device.hiwifi.com,1,0.00%,1,0,100.00%
ns12.gdnsec.com,1,0.00%,1,0,100.00%
etrack01.com,1,0.00%,1,0,100.00%
f.seals.qq.com,1,0.00%,1,0,100.00%
jsqmt.qq.com,1,0.00%,1,0,100.00%
m.sports.qq.com,1,0.00%,1,0,100.00%
apd-82cb731adc411313ffef07c4a1729a0f.v.smtcdns.com,1,0.00%,1,0,100.00%
apd-381897c22866d013926473c0e6dff128.v.smtcdns.com,1,0.00%,1,0,100.00%
apd-db8bba9f5b9358ab203f98cab882d921.v.smtcdns.com,1,0.00%,1,0,100.00%
apd-85e836647a234f005d8c6879f5b9214d.v.smtcdns.com,1,0.00%,1,0,100.00%
apd-43dea06d7fac3f2dcce6b3f73f430ff5.v.smtcdns.com,1,0.00%,1,0,100.00%
geomobileservices-pa.googleapis.com,1,0.00%,6,5,16.67%
qlbm.troops-forget.org,1,0.00%,1,0,100.00%
adobe.com.ssl.d1.sc.omtrdc.net,1,0.00%,1,0,100.00%
sc0.hao123img.com.a.bdydns.com,1,0.00%,2,1,50.00%
hao123-static.cdn.bcebos.com.a.bdydns.com,1,0.00%,2,1,50.00%
3c3c7edaea1788452cdfdb63eebd5d45.clo.footprintdns.com,1,0.00%,1,0,100.00%
l-0001.l-msedge.net,1,0.00%,1,0,100.00%
fenwan.cdn.bcebos.com.a.bdydns.com,1,0.00%,2,1,50.00%
workerz1.com,1,0.00%,1,0,100.00%
as1.m.hao123.com.cname210.yjs-cdn.com,1,0.00%,1,0,100.00%
cdn.rollserver.xyz,1,0.00%,2,1,50.00%
icns.zui.lenovomm.com,1,0.00%,1,0,100.00%
dot.net,1,0.00%,1,0,100.00%
solarflare03.zhihu.com,1,0.00%,2,1,50.00%
t.fenyucn.com.cdn.dnsv1.com,1,0.00%,2,1,50.00%
static.v2ex.com,1,0.00%,2,1,50.00%
qin5jgmy.sched.sma-dk.tdnsstic1.cn,1,0.00%,2,1,50.00%
qpfbyli6.sched.vplego-dk.tdnsvod4.cn,1,0.00%,2,1,50.00%
v2ex.com,1,0.00%,2,1,50.00%
sr.ksria.cn.qiniudns.com,1,0.00%,2,1,50.00%
slackb.com,1,0.00%,1,0,100.00%
crsignv1.qq.com,1,0.00%,1,0,100.00%
k96ml9cz.sched.sma-dk.tdnsstic1.cn,1,0.00%,2,1,50.00%
service1.most.gov.cn,1,0.00%,1,0,100.00%
galaxy.bz.mgtv.com,1,0.00%,1,0,100.00%
gr.china-embassy.gov.cn.wswebcdn.com,1,0.00%,1,0,100.00%
i2.hoopchina.com.cn.cdn.dnsv1.com,1,0.00%,2,1,50.00%
hfoa4etd.sched.sma-dk.tdnsstic1.cn,1,0.00%,2,1,50.00%
w1.hoopchina.com.cn.cdn.dnsv1.com,1,0.00%,2,1,50.00%
1869pa4r.sched.sma-dk.tdnsstic1.cn,1,0.00%,2,1,50.00%
fairy.mobileapi.hupu.com,1,0.00%,2,1,50.00%
1img.hitv.com,1,0.00%,2,1,50.00%
1img.hitv.com.c.cdnhwc1.com,1,0.00%,2,1,50.00%
hcdnw.mgtv.gslb.c.cdnhwc2.com,1,0.00%,2,1,50.00%
www.cctv.com,1,0.00%,3,2,33.33%
g1.cctvcdn.net,1,0.00%,2,1,50.00%
cs.mfa.gov.cn.wswebpic.com,1,0.00%,1,0,100.00%
gr.china-embassy.org.whecloud.com,1,0.00%,1,0,100.00%
www.gov.cn.bsgslb.cn,1,0.00%,2,1,50.00%
www.people.com.cn.wswebpic.com,1,0.00%,4,3,25.00%
www.tibet.cn,1,0.00%,2,1,50.00%
www.tibet.cn.dolfincdnx.com,1,0.00%,2,1,50.00%
www.visaforchina.org,1,0.00%,1,0,100.00%
dfzj888.v.trpcdn.net,1,0.00%,2,1,50.00%
slb-03-xy5-rb5.ctripgslb.com,1,0.00%,1,0,100.00%
sf1.helloking.win,1,0.00%,1,0,100.00%
t.fenyucn.com,1,0.00%,2,1,50.00%
cdn.v2ex.com,1,0.00%,2,1,50.00%
v2.res.log.hunantv.com,1,0.00%,1,0,100.00%
www.ctrip.com.ctripgslb.com,1,0.00%,1,0,100.00%
p1-q.mafengwo.net.cdn.dnsv1.com,1,0.00%,2,1,50.00%
chawzksu.sched.sma-dk.tdnsstic1.cn,1,0.00%,2,1,50.00%
weng.mafengwo.net.cdn.dnsv1.com,1,0.00%,2,1,50.00%
ns-734.awsdns-27.net,1,0.00%,4,3,25.00%
lorenaulloamayorga.offeringtree.com,1,0.00%,1,0,100.00%
mail.imhilnemousubneu.gq,1,0.00%,1,0,100.00%
admin.hopsbottoms.com,1,0.00%,1,0,100.00%
mail.stattequaraper.tk,1,0.00%,1,0,100.00%
nettest.processon.com,1,0.00%,1,0,100.00%
nowphas.mlit.go.jp,1,0.00%,1,0,100.00%
mail.networkingpros.tk,1,0.00%,1,0,100.00%
api.impetus.no,1,0.00%,1,0,100.00%
img.wykw.com,1,0.00%,2,1,50.00%
tongji.51kaowang.com,1,0.00%,1,0,100.00%
open.u-tools.cn,1,0.00%,1,0,100.00%
realip.e.lanxin.cn,1,0.00%,1,0,100.00%
7511304a3e1af5fa73f2d0ebbb89e9e9.safeframe.googlesyndication.com,1,0.00%,1,0,100.00%
e2c23.gcp.gvt2.com,1,0.00%,1,0,100.00%
api.isqqw.com,1,0.00%,1,0,100.00%
avatar-service-prod-euwe-arm-a.westeurope.cloudapp.azure.com,1,0.00%,1,0,100.00%
mailhost.liafa.univ-paris-diderot.fr,1,0.00%,1,0,100.00%
a1992.dscd.akamai.net.0.1.cn.akamaitech.net,1,0.00%,2,1,50.00%
app.slack.com,1,0.00%,1,0,100.00%
d29id7n8587nnz.cloudfront.net,1,0.00%,1,0,100.00%
i-sat02p-cor002.api.p001.1drv.com,1,0.00%,1,0,100.00%
blockchain.info,1,0.00%,1,0,100.00%
s-ybd.youku.com,1,0.00%,1,0,100.00%
ijcai.org,1,0.00%,1,0,100.00%
s3-w.us-east-1.amazonaws.com,1,0.00%,1,0,100.00%
sa2-prod-msgsearch-2.cloudapp.net,1,0.00%,1,0,100.00%
options.skype.com,1,0.00%,1,0,100.00%
skype-options-prod.trafficmanager.net,1,0.00%,1,0,100.00%
a-tr-teamsc-asse-02.southeastasia.cloudapp.azure.com,1,0.00%,1,0,100.00%
cc-asse-08-skype.cloudapp.net,1,0.00%,1,0,100.00%
res.vps234.com.w.kunlungr.com,1,0.00%,1,0,100.00%
hotel.mafengwo.net,1,0.00%,2,1,50.00%
pz0wpx83.sched.sma-dk.tdnsstic1.cn,1,0.00%,2,1,50.00%
api3-normal-lq.fqnovel.com.w.cdngslb.com,1,0.00%,1,0,100.00%
e26769.b.akamaiedge.net,1,0.00%,1,0,100.00%
static.nvidiagrid.net.edgekey.net,1,0.00%,2,1,50.00%
e28142.dscg.akamaiedge.net,1,0.00%,2,1,50.00%
v6-be-pack.pglstatp-toutiao.com.download.ks-cdn.com,1,0.00%,2,1,50.00%
k2-dy-ipv6.gslb.ksyuncdn.com,1,0.00%,2,1,50.00%
ifanyi.iciba.com,1,0.00%,1,0,100.00%
cmshow.gtimg.cn.sched.px.tdnsv6.com,1,0.00%,1,0,100.00%
anchorpost.msstatic.com,1,0.00%,2,1,50.00%
anchorpost.msstatic.com.w.cdngslb.com,1,0.00%,2,1,50.00%
osxapps.itunes.apple.com,1,0.00%,3,2,33.33%
only-415619-124-16-139-126.nstool.321fenx.com,1,0.00%,1,0,100.00%
txmov6.a.kwimgs.com,1,0.00%,2,1,50.00%
txdwkmov.a.kwimgs.com,1,0.00%,2,1,50.00%
txmov2.a.yximgs.com,1,0.00%,2,1,50.00%
txdwkmov.a.yximgs.com,1,0.00%,2,1,50.00%
alimov2.a.yximgs.com,1,0.00%,2,1,50.00%
tx-origin.pull.yximgs.com,1,0.00%,2,1,50.00%
tx-adaptive.pull.yximgs.com,1,0.00%,2,1,50.00%
v3.oskwai.com,1,0.00%,2,1,50.00%
mail.sattdemonscu.ml,1,0.00%,1,0,100.00%
new.ebig.biz,1,0.00%,1,0,100.00%
www.tm.mc.prd.aadg.trafficmanager.net,1,0.00%,1,0,100.00%
osi-prod-bjb01-ocws.chinacloudapp.cn,1,0.00%,1,0,100.00%
cn4-powerpoint-collab.partner.officewebapps.cn,1,0.00%,1,0,100.00%
45-32-225-6.luminatinet.com,1,0.00%,1,0,100.00%
or1.myi101s001.tk,1,0.00%,1,0,100.00%
1610057072.D4EE073C2A20.device.hiwifi.com,1,0.00%,1,0,100.00%
oraclesga.norway22.ml,1,0.00%,1,0,100.00%
vout.fltikl.tk,1,0.00%,1,0,100.00%
as.atlassian.com,1,0.00%,1,0,100.00%
history.google.com,1,0.00%,2,1,50.00%
orders.demo.wherefour.com,1,0.00%,1,0,100.00%
app.ucas.ac.cn,1,0.00%,1,0,100.00%
ussus3eastprod.blob.core.windows.net,1,0.00%,1,0,100.00%
www.isqqw.com,1,0.00%,1,0,100.00%
echarts.isqqw.com,1,0.00%,1,0,100.00%
ws-adaptive.pull.yximgs.com,1,0.00%,2,1,50.00%
v3-ot01.kwaicdn.com,1,0.00%,2,1,50.00%
v3-ot02.kwaicdn.com,1,0.00%,2,1,50.00%
v3.kwaicdn.com,1,0.00%,2,1,50.00%
ks-origin.pull.yximgs.com,1,0.00%,2,1,50.00%
ks-adaptive.pull.yximgs.com,1,0.00%,2,1,50.00%
bd-origin.pull.yximgs.com,1,0.00%,2,1,50.00%
bd-adaptive.pull.yximgs.com,1,0.00%,2,1,50.00%
d1.a.kwimgs.com,1,0.00%,2,1,50.00%
d3.a.kwimgs.com,1,0.00%,2,1,50.00%
tx6.a.kwimgs.com,1,0.00%,2,1,50.00%
tx2.a.kwimgs.com,1,0.00%,2,1,50.00%
txqcmmov.a.etoote.com,1,0.00%,2,1,50.00%
p1-live.a.yximgs.com,1,0.00%,2,1,50.00%
p1.a.yximgs.com,1,0.00%,2,1,50.00%
hw-adaptive.pull.yximgs.com,1,0.00%,2,1,50.00%
p3-live.a.yximgs.com,1,0.00%,2,1,50.00%
p5-live.a.yximgs.com,1,0.00%,2,1,50.00%
p4-live.a.yximgs.com,1,0.00%,2,1,50.00%
alicmmov.a.etoote.com,1,0.00%,2,1,50.00%
aliqcmmov.a.etoote.com,1,0.00%,2,1,50.00%
txcmmov.a.etoote.com,1,0.00%,2,1,50.00%
js2.a.kwimgs.com,1,0.00%,2,1,50.00%
txcmvod.a.etoote.com,1,0.00%,2,1,50.00%
tx.static.yximgs.com,1,0.00%,2,1,50.00%
d1-magic.static.yximgs.com,1,0.00%,2,1,50.00%
p3.eckwai.com,1,0.00%,2,1,50.00%
s2-10958.kwimgs.com,1,0.00%,2,1,50.00%
p1.eckwai.com,1,0.00%,2,1,50.00%
v2-mg07.kwaicdn.com,1,0.00%,2,1,50.00%
ali-p2p.pull.yximgs.com,1,0.00%,2,1,50.00%
bs-adaptive.pull.yximgs.com,1,0.00%,2,1,50.00%
p3.adkwai.com,1,0.00%,2,1,50.00%
bs-origin.pull.yximgs.com,1,0.00%,2,1,50.00%
bd-p2p.pull.yximgs.com,1,0.00%,2,1,50.00%
d1-ec.a.kwimgs.com,1,0.00%,2,1,50.00%
d1-ks.a.kwimgs.com,1,0.00%,2,1,50.00%
d1-push.static.yximgs.com,1,0.00%,2,1,50.00%
d1-kkd.a.kspkg.com,1,0.00%,2,1,50.00%
d3-magic.static.yximgs.com,1,0.00%,2,1,50.00%
d1-reco.a.kwimgs.com,1,0.00%,2,1,50.00%
d1-yoda.a.kwimgs.com,1,0.00%,2,1,50.00%
d3-ec.a.kwimgs.com,1,0.00%,2,1,50.00%
d3-push.static.yximgs.com,1,0.00%,2,1,50.00%
js.a.kspkg.com,1,0.00%,2,1,50.00%
static.inkuai.com,1,0.00%,2,1,50.00%
v1-dwkvod.kwaicdn.com,1,0.00%,2,1,50.00%
v1-vod.kwaicdn.com,1,0.00%,2,1,50.00%
v2-cty01.kwaicdn.com,1,0.00%,2,1,50.00%
v2-cty03.kwaicdn.com,1,0.00%,2,1,50.00%
v2-cty05.kwaicdn.com,1,0.00%,2,1,50.00%
v2-vod.kwaicdn.com,1,0.00%,2,1,50.00%
v3-vod.kwaicdn.com,1,0.00%,2,1,50.00%
v5-skvod.kwaicdn.com,1,0.00%,2,1,50.00%
v6.kwaicdn.com,1,0.00%,2,1,50.00%
ws-p2p.pull.yximgs.com,1,0.00%,2,1,50.00%
wwW.VOd.lxdNs.Com,1,0.00%,2,1,50.00%
112-50-95-241.volcsiriusbd.com,1,0.00%,1,0,100.00%
api-skytone-4-drcn.cloud.dbankcloud.cn,1,0.00%,1,0,100.00%
pro.lawnbuddy.com,1,0.00%,1,0,100.00%
sec-nas.vulgraph.net,1,0.00%,1,0,100.00%
dcdnhub.dcdn.sandai.net,1,0.00%,1,0,100.00%
retracker.bashtel.ru,1,0.00%,1,0,100.00%
rp.m.v6.shub.sandai.net,1,0.00%,1,0,100.00%
torrentsmd.eu,1,0.00%,1,0,100.00%
tracker.city9x.com,1,0.00%,1,0,100.00%
retracker.omsk.ru,1,0.00%,1,0,100.00%
tracker.tfile.me,1,0.00%,1,0,100.00%
tj-ctfs.ftn.qq.com,1,0.00%,1,0,100.00%
d.sfsdx.com,1,0.00%,1,0,100.00%
user.haimianbaobao.tk,1,0.00%,1,0,100.00%
jiagu.treechoi.ml,1,0.00%,1,0,100.00%
pbmtc-aspho-2019.busyconf.com,1,0.00%,1,0,100.00%
philippe-meyer-architecte.divisare.pro,1,0.00%,1,0,100.00%
rije.herokuapp.com,1,0.00%,1,0,100.00%
mynikonworld2.nikonlenswear.co.uk,1,0.00%,1,0,100.00%
am-0.moevideo.biz,1,0.00%,1,0,100.00%
dcc.shuzilm.cn,1,0.00%,1,0,100.00%
daa.shuzilm.cn,1,0.00%,1,0,100.00%
darmstadt.heimatschatz.de,1,0.00%,1,0,100.00%
mail.igrpanel.tk,1,0.00%,1,0,100.00%
mail.inewphowinlafur.tk,1,0.00%,1,0,100.00%
ie01.ingress.herokuapp.com,1,0.00%,1,0,100.00%
519d06b954abbf4331b854c76c54a450.safeframe.googlesyndication.com,1,0.00%,1,0,100.00%
tx.lnk0.com,1,0.00%,1,0,100.00%
nvkfkpsp2pyh1bj9bwcv79lsm66x0l1t.aliyundunwaf.com,1,0.00%,1,0,100.00%
bkzhj.ucas.ac.cn,1,0.00%,1,0,100.00%
jwjz.ucas.ac.cn,1,0.00%,1,0,100.00%
cLiEntlOGVodp2P.HAplaT.nEt,1,0.00%,1,0,100.00%
mAMbAP2pvODH5.8686C.coM,1,0.00%,1,0,100.00%
TrAnsit1.wsLOG.ChInAneTCeNteR.COM,1,0.00%,1,0,100.00%
q92jhm5q0dgjn597mcsab12d6c8r1lropc04rbjbqk06d7bb03nvvfdq.qc.x.bsgslb.cn,1,0.00%,1,0,100.00%
private.codecogs.com,1,0.00%,1,0,100.00%
v.kdsvp.qq.com,1,0.00%,1,0,100.00%
cota-global.magicui.hihonorcloud.com,1,0.00%,1,0,100.00%
first4solar.co.uk,1,0.00%,1,0,100.00%
mail.seobatch139.cf,1,0.00%,1,0,100.00%
pgy-std02.oray.net,1,0.00%,1,0,100.00%
pgysle-client02.oray.net,1,0.00%,1,0,100.00%
packages.crunchbangplusplus.org,1,0.00%,1,0,100.00%
bbsld2iu-my.sharepoint.com,1,0.00%,1,0,100.00%
www.tgbak.com,1,0.00%,1,0,100.00%
tracker.christianbro.pw,1,0.00%,1,0,100.00%
tracker.edoardocolombo.eu,1,0.00%,1,0,100.00%
tracker.doko.moe,1,0.00%,1,0,100.00%
tracker.safe.moe,1,0.00%,1,0,100.00%
cfdc.91p52.com,1,0.00%,1,0,100.00%
media.aiailah.com,1,0.00%,1,0,100.00%
media.aalah.me,1,0.00%,1,0,100.00%
ulfbrueggemann.no-ip.org,1,0.00%,1,0,100.00%
tracker2.christianbro.pw,1,0.00%,1,0,100.00%
1608234671.D4EE071FA772.device.hiwifi.com,1,0.00%,1,0,100.00%
1608234692.D4EE071FA772.device.hiwifi.com,1,0.00%,1,0,100.00%
cn-legal.battlenet.com.cn,1,0.00%,1,0,100.00%
smtpdm.aliyun.com.gds.alibabadns.com,1,0.00%,1,0,100.00%
salesforce1andriod.herokuapp.com,1,0.00%,1,0,100.00%
sportradarserving.com,1,0.00%,1,0,100.00%
u.ipw.metadsp.co.uk,1,0.00%,1,0,100.00%
www.thirdparty.com,1,0.00%,1,0,100.00%
fuckwenku8.herokuapp.com,1,0.00%,1,0,100.00%
d422.upstore.net,1,0.00%,1,0,100.00%
ebrualoglu.co.uk,1,0.00%,1,0,100.00%
mail.cryptosweethearts.com,1,0.00%,1,0,100.00%
jp30.graniterapids.com,1,0.00%,1,0,100.00%
ckjelite.classic.kicksite.net,1,0.00%,1,0,100.00%
mail.cisitaronseagy.cf,1,0.00%,1,0,100.00%
decotv.rockpie.com,1,0.00%,1,0,100.00%
hw.pull.yximgs.com,1,0.00%,2,1,50.00%
developer.n.shifen.com,1,0.00%,4,3,25.00%
info.logiworldllc.com,1,0.00%,1,0,100.00%
hyapi01.ino.qq.com,1,0.00%,1,0,100.00%
ipv4.lookup.test-ipv6.com,1,0.00%,1,0,100.00%
www.alibabacloud.com,1,0.00%,1,0,100.00%
app.huawei.com,1,0.00%,1,0,100.00%
probably.xz246.com,1,0.00%,1,0,100.00%
you.rivandworld.com,1,0.00%,1,0,100.00%
carefully.ab0u.com,1,0.00%,1,0,100.00%
mscrl.microsoft.com,1,0.00%,1,0,100.00%
ntp7.aliyun.com,1,0.00%,1,0,100.00%
webzj-v6.netstatic.net,1,0.00%,2,1,50.00%
box.jomodns.com,1,0.00%,6,5,16.67%
dyn.ithome.com,1,0.00%,2,1,50.00%
pdsprod-deploy-mq-prod.us-west-2.elasticbeanstalk.com,1,0.00%,1,0,100.00%
api.infinitynewtab.com,1,0.00%,1,0,100.00%
ws.infinitynewtab.com,1,0.00%,1,0,100.00%
waws-prod-dm1-055.cloudapp.net,1,0.00%,1,0,100.00%
asstefil.com.br,1,0.00%,1,0,100.00%
uz91nooversea.v.bsgslb.com,1,0.00%,2,1,50.00%
1608227390.D4EE071FA772.device.hiwifi.com,1,0.00%,1,0,100.00%
hk.dd100.ga,1,0.00%,1,0,100.00%
be917e9f-736e-4f7a-94f4-3c69621330a4.booqable.shop,1,0.00%,1,0,100.00%
linuxmirrors.ir,1,0.00%,1,0,100.00%
mirror.earthlink.iq,1,0.00%,1,0,100.00%
repo.ugm.ac.id,1,0.00%,1,0,100.00%
epel.scopesky.iq,1,0.00%,1,0,100.00%
epel.mirror.angkasa.id,1,0.00%,1,0,100.00%
mirror01.idc.hinet.net,1,0.00%,2,1,50.00%
mirror.vinahost.vn,1,0.00%,1,0,100.00%
harridayskarate.kicksite.net,1,0.00%,1,0,100.00%
a3nafy.vfra.dscew.ml,1,0.00%,1,0,100.00%
servicediscovery.awsmcafeeccs.mcafee.com,1,0.00%,2,1,50.00%
dealers.backofficeapps.com,1,0.00%,1,0,100.00%
blob.dz5prdstr15a.store.core.windows.net,1,0.00%,1,0,100.00%
you.conncoll.edu,1,0.00%,1,0,100.00%
covid-19.mitpress.mit.edu,1,0.00%,1,0,100.00%
vghubb.herokuapp.com,1,0.00%,1,0,100.00%
avatar.ithome.com,1,0.00%,2,1,50.00%
hc6.app.lmpm.com,1,0.00%,1,0,100.00%
sns-img-qc.xhscdn.com,1,0.00%,2,1,50.00%
k8s-sentryk8-sentryre-65b18f85a4-1587643516.ca-central-1.elb.amazonaws.com,1,0.00%,1,0,100.00%
i-chi01p-cor002.api.p001.1drv.com,1,0.00%,1,0,100.00%
msite.baidu.com,1,0.00%,1,0,100.00%
egakat.linuxpl.info,1,0.00%,1,0,100.00%
1608227446.D4EE071FA772.device.hiwifi.com,1,0.00%,1,0,100.00%
sync.bumlam.com,1,0.00%,1,0,100.00%
app1.urano4web.com,1,0.00%,1,0,100.00%
blob.bn6prdstr20a.store.core.windows.net,1,0.00%,1,0,100.00%
a2plvcpnl280622.prod.iad2.secureserver.net,1,0.00%,1,0,100.00%
direwolf-c7c0a789ca.herokuapp.com,1,0.00%,1,0,100.00%
liq3.herokuapp.com,1,0.00%,1,0,100.00%
n-dalogup.tplinkcloud.com.cn,1,0.00%,1,0,100.00%
o143679.ingest.sentry.io,1,0.00%,1,0,100.00%
fintigo.creditar.io,1,0.00%,1,0,100.00%
dc-api.adobe.io,1,0.00%,1,0,100.00%
csdkapi-policy.adobe.com,1,0.00%,2,1,50.00%
osiprod-eus2-coffee-000.eastus2.cloudapp.azure.com,1,0.00%,1,0,100.00%
imgcache.gtimg.cn.sched.legopic1.tdnsv6.com,1,0.00%,1,0,100.00%
e2c44.gcp.gvt2.com,1,0.00%,1,0,100.00%
i.pr-1445.quiltt.dev,1,0.00%,1,0,100.00%
wlimg10.360buyimg.com,1,0.00%,1,0,100.00%
dzgc.xsyu.edu.cn,1,0.00%,1,0,100.00%
contacts-eu.globenewswire.com,1,0.00%,1,0,100.00%
b.sogou.com,1,0.00%,1,0,100.00%
baike.sogou.com,1,0.00%,1,0,100.00%
mingyi.sogou.com,1,0.00%,1,0,100.00%
zhishi.sogou.com,1,0.00%,1,0,100.00%
s.account.sogoucdn.com,1,0.00%,1,0,100.00%
douban.fm,1,0.00%,1,0,100.00%
www.yhd.com,1,0.00%,1,0,100.00%
www.yinyuetai.com,1,0.00%,1,0,100.00%
www.fang.com,1,0.00%,1,0,100.00%
www.lvmama.com,1,0.00%,1,0,100.00%
www.tmall.com,1,0.00%,2,1,50.00%
www.tuniu.com,1,0.00%,1,0,100.00%
xs.sogou.com,1,0.00%,1,0,100.00%
ai.taobao.com,1,0.00%,1,0,100.00%
service.cnki.net,1,0.00%,1,0,100.00%
help.cnki.net,1,0.00%,1,0,100.00%
api.devopsclub.cn,1,0.00%,1,0,100.00%
apps.itunes-nocookie.com,1,0.00%,1,0,100.00%
1l7usz58.sched.pddlego-dk.tdnsstic1.cn,1,0.00%,2,1,50.00%
wxa.wxs.qq.com.sched.legopic1-dk.tdnsv6.com,1,0.00%,2,1,50.00%
e7248.dsce9.akamaiedge.net,1,0.00%,3,2,33.33%
weico.api.weibo.cn,1,0.00%,4,3,25.00%
book.pared.com,1,0.00%,1,0,100.00%
im-drcn-platform-dbankcloud-cn-drcn.appacc-region.dbankedge.net,1,0.00%,1,0,100.00%
r4.sn-ni5een7z.gvt1.com,1,0.00%,1,0,100.00%
ogs.google.com.hk,1,0.00%,2,1,50.00%
nr.cg.163.com,1,0.00%,1,0,100.00%
viewreport-ipc.mercuryclouds.com.cn,1,0.00%,1,0,100.00%
almdown-ipc.mercuryclouds.com.cn,1,0.00%,1,0,100.00%
1608227472.D4EE071FA772.device.hiwifi.com,1,0.00%,1,0,100.00%
webmail.travelminds.site,1,0.00%,1,0,100.00%
v3.duo1.promey.art,1,0.00%,1,0,100.00%
prod.ols.live.com.akadns.net,1,0.00%,1,0,100.00%
d2g15hp0vtnk4i.cloudfront.net,1,0.00%,1,0,100.00%
galerie.wildwoodhearts.de,1,0.00%,1,0,100.00%
singlepass-374792989049-client-data.s3.amazonaws.com,1,0.00%,1,0,100.00%
jp28.graniterapids.com,1,0.00%,1,0,100.00%
et2-na61-na62.wagbridge.alibaba.tanx.com.gds.alibabadns.com,1,0.00%,1,0,100.00%
static-cdn.jiaoyimao.com.w.alikunlun.com,1,0.00%,1,0,100.00%
ude-yxhn.aligames.com,1,0.00%,1,0,100.00%
usdpdown.game.uodoo.com.w.alikunlun.com,1,0.00%,1,0,100.00%
tls-cloud-cname.dingtalk.com,1,0.00%,1,0,100.00%
crl.akamai.certum.pl,1,0.00%,2,1,50.00%
static.jiaoyimao.com.w.alikunlun.net,1,0.00%,1,0,100.00%
cdn.aligames.com.w.alikunlun.com,1,0.00%,1,0,100.00%
china.cdp.internal.unity3d.com,1,0.00%,1,0,100.00%
hwa.douyucdn2.cn,1,0.00%,2,1,50.00%
w1uzyjxn.dayugslb.com,1,0.00%,1,0,100.00%
gv1.xdrig.com.td.fusion.iaas.jdcloud.com.jcloudlb.com,1,0.00%,1,0,100.00%
p42-caldav.icloud.com,1,0.00%,2,1,50.00%
p66-caldav.icloud.com,1,0.00%,2,1,50.00%
rs9.qq.com,1,0.00%,1,0,100.00%
p3.music.126.net.bsclink.cn,1,0.00%,2,1,50.00%
rs8.qq.com,1,0.00%,1,0,100.00%
e9959.dsce9.akamaiedge.net,1,0.00%,2,1,50.00%
17.ultralab.club,1,0.00%,1,0,100.00%
plugin.sowise.cn,1,0.00%,1,0,100.00%
dbeaver.io,1,0.00%,1,0,100.00%
alb-jdsnebi3mkopuq5bxf.cn-hangzhou.alb.aliyuncs.com,1,0.00%,1,0,100.00%
a2ga48yn.sched.d0.tdnsdp1.cn,1,0.00%,1,0,100.00%
api.xiaoheihe.cn,1,0.00%,1,0,100.00%
vdn5.vzuu.com.cdn.dnsv1.com,1,0.00%,3,2,33.33%
vdn6.vzuu.com.v1.ksydns.com,1,0.00%,2,1,50.00%
vdn6.vzuu.com.cdn.dnsv1.com.cn,1,0.00%,3,2,33.33%
messaging.zhihu.com,1,0.00%,1,0,100.00%
www.microsoftstore.com.cn,1,0.00%,1,0,100.00%
front-gw.aunapi.com,1,0.00%,1,0,100.00%
optionsservice-prod-southeastasia-a.cloudapp.net,1,0.00%,1,0,100.00%
a-tr-skysc-jpwe-01.japanwest.cloudapp.azure.com,1,0.00%,1,0,100.00%
b-flightproxy-jpea-01-skype.cloudapp.net,1,0.00%,1,0,100.00%
q.maxjia.com,1,0.00%,1,0,100.00%
ocx.umeng.com,1,0.00%,1,0,100.00%
3lp4h0gt.sched.sma.tdnsstic1.cn,1,0.00%,1,0,100.00%
3lp4h0gt.sched.sma.tdnsstic1.cn.cjt.krcdn.idatacube.com,1,0.00%,1,0,100.00%
djzphop2.sched.sma.tdnsstic1.cn.cjt.krcdn.idatacube.com,1,0.00%,1,0,100.00%
wp-test.baileyshorsefeeds.co.uk,1,0.00%,1,0,100.00%
mail.jobstuffs.tk,1,0.00%,1,0,100.00%
jenpaulson.realscout.me,1,0.00%,1,0,100.00%
bajastore.com.mx,1,0.00%,1,0,100.00%
api.spheric.gg,1,0.00%,1,0,100.00%
eapps.easternhops.com,1,0.00%,1,0,100.00%
mail22.pension.gov.ae,1,0.00%,1,0,100.00%
mail11.pension.gov.ae,1,0.00%,1,0,100.00%
maildr.pension.gov.ae,1,0.00%,1,0,100.00%
web.stg.viasanabolivia.com,1,0.00%,1,0,100.00%
blade4.singapore-rack405.nodes.gen4.ninja,1,0.00%,1,0,100.00%
mail.toplines72.cf,1,0.00%,1,0,100.00%
1610401921.D4EE073396E8.device.hiwifi.com,1,0.00%,1,0,100.00%
1610401958.D4EE073396E8.device.hiwifi.com,1,0.00%,1,0,100.00%
s.cpro.baidu.com,1,0.00%,1,0,100.00%
k128-mzstatic-fclouddns.gslb.new.fclouddns.net,1,0.00%,1,0,100.00%
d231vab146qzfb.cloudfront.net,1,0.00%,2,1,50.00%
in-live.live.eks.hotjar.com,1,0.00%,1,0,100.00%
prod.disqus.map.fastlylb.net,1,0.00%,1,0,100.00%
translate.google.fr,1,0.00%,4,3,25.00%
idp.zju.edu.cn,1,0.00%,1,0,100.00%
e2cs40.gcp.gvt2.com,1,0.00%,1,0,100.00%
m.ddznpt.ga,1,0.00%,1,0,100.00%
cdn.ynuf.aliapp.org.w.alikunlun.com,1,0.00%,4,3,25.00%
fullscreen-detail.alicdn.com.danuoyi.tbcache.com,1,0.00%,4,3,25.00%
e2cs32.gcp.gvt2.com,1,0.00%,1,0,100.00%
warehouse-camo.ingress.cmh1.psfhosted.org,1,0.00%,1,0,100.00%
funimg.pddpic.com.cdn.dnsv1.com,1,0.00%,2,1,50.00%
funimg.pddpic.com.sched.pddlego-dk.tdnsstic1.cn.cjt.krcdn.idatacube.com,1,0.00%,2,1,50.00%
secure.zwift.com,1,0.00%,1,0,100.00%
mailh3.message.cmbchina.com,1,0.00%,1,0,100.00%
mailn2sz.message.cmbchina.com,1,0.00%,1,0,100.00%
presscache.ccs.neu.edu,1,0.00%,1,0,100.00%
direwolf-09ddf6900a.herokuapp.com,1,0.00%,1,0,100.00%
cpanel.szichikenindex.cf,1,0.00%,1,0,100.00%
icloud.la.tenbyte.tk,1,0.00%,1,0,100.00%
api2.pushdeer.com,1,0.00%,1,0,100.00%
welcome.variety.lesson.ml,1,0.00%,1,0,100.00%
writersradio.amsnetwork.ca,1,0.00%,1,0,100.00%
ochre.wearecast.org.uk,1,0.00%,1,0,100.00%
q4radrt439.tsfh.ga,1,0.00%,1,0,100.00%
nodestore.logitech.io,1,0.00%,1,0,100.00%
e2c39.gcp.gvt2.com,1,0.00%,1,0,100.00%
i.guancha.cn,1,0.00%,2,1,50.00%
i.tq121.com.cn,1,0.00%,1,0,100.00%
pic.weather.com.cn,1,0.00%,1,0,100.00%
i.weather.com.cn,1,0.00%,1,0,100.00%
wgeo.weather.com.cn,1,0.00%,1,0,100.00%
client.uu.me,1,0.00%,1,0,100.00%
logbak.hicloud.com,1,0.00%,1,0,100.00%
web-seminare.beton-webakademie.36chambers.de,1,0.00%,1,0,100.00%
app.myzaker.com.w.kunlungr.com,1,0.00%,1,0,100.00%
syz.phic.org.cn,1,0.00%,1,0,100.00%
static.pddpic.com,1,0.00%,2,1,50.00%
img.pddpic.com,1,0.00%,2,1,50.00%
th.yangkeduo.com,1,0.00%,1,0,100.00%
avatar2-1.pddpic.com,1,0.00%,2,1,50.00%
video-snapshot.pddpic.com,1,0.00%,2,1,50.00%
transfer.ceping.com,1,0.00%,1,0,100.00%
stcms.beisen.com,1,0.00%,1,0,100.00%
image.dayi.org.cn,1,0.00%,1,0,100.00%
eo.dbpedia.org,1,0.00%,1,0,100.00%
bleisure.ba.com,1,0.00%,1,0,100.00%
rgmb.classic.kicksite.net,1,0.00%,1,0,100.00%
cbwh5s4.i3zmbs.com,1,0.00%,1,0,100.00%
activation.unity.cn,1,0.00%,1,0,100.00%
23-92-30-53.3f5ffcbecff340969874c9eb90a37eeb.plex.direct,1,0.00%,1,0,100.00%
1610057041.D4EE073C2A20.device.hiwifi.com,1,0.00%,1,0,100.00%
1610057067.D4EE073C2A20.device.hiwifi.com,1,0.00%,1,0,100.00%
mail.foodbeauty.ga,1,0.00%,1,0,100.00%
architectsnearme.co.uk,1,0.00%,1,0,100.00%
1610057093.D4EE073C2A20.device.hiwifi.com,1,0.00%,1,0,100.00%
saludloprado.xpyri-staging.com,1,0.00%,1,0,100.00%
ilofeudo.com.ar,1,0.00%,1,0,100.00%
pgysle-client-adv02.oray.net,1,0.00%,1,0,100.00%
cryptoworld.co.uk,1,0.00%,1,0,100.00%
swcdn.apple.com.w.alikunlun.com,1,0.00%,1,0,100.00%
thetravelvine.picfair.com,1,0.00%,1,0,100.00%
stinmmtn.vivo.com.cn,1,0.00%,1,0,100.00%
picasso-static.xiaohongshu.com,1,0.00%,2,1,50.00%
jw.ucas.ac.cn,1,0.00%,1,0,100.00%
assistant.ceping.com,1,0.00%,1,0,100.00%
transfer-hw.ceping.com,1,0.00%,1,0,100.00%
task.ac.cn,1,0.00%,1,0,100.00%
app-support.blackmagicdesign.com,1,0.00%,1,0,100.00%
de4.videofile.me,1,0.00%,1,0,100.00%
dev.livebeaches.com,1,0.00%,1,0,100.00%
ingest.perchsecurity.com,1,0.00%,1,0,100.00%
staging.app.bloomfarming.com,1,0.00%,1,0,100.00%
mx25.xmvmess.com,1,0.00%,1,0,100.00%
ns3.dfn.de,1,0.00%,1,0,100.00%
deneb.dfn.de,1,0.00%,1,0,100.00%
tamasi.pizzakaravan.hu,1,0.00%,1,0,100.00%
mail.checkthewarehouze.ml,1,0.00%,1,0,100.00%
iceoiw.ni56es2qy.gq,1,0.00%,1,0,100.00%
new.em-acplumbing.com,1,0.00%,1,0,100.00%
staging.app.trackgo.com,1,0.00%,1,0,100.00%
yr.easyfly.tk,1,0.00%,1,0,100.00%
sla-bac.nutrislice.com,1,0.00%,1,0,100.00%
gracieunitedhancock.classic.kicksite.net,1,0.00%,1,0,100.00%
obs.lz02-br-inet.cn-east-3.myhuaweicloud.cn,1,0.00%,1,0,100.00%
explorer.sharemyworks.com,1,0.00%,1,0,100.00%
learn.derose.app,1,0.00%,1,0,100.00%
staging.globusjourneys.in,1,0.00%,1,0,100.00%
m.o4aac.ga,1,0.00%,1,0,100.00%
ddns.oray.com,1,0.00%,1,0,100.00%
slp2p-east-std1054.oray.net,1,0.00%,1,0,100.00%
data.uniontech.com,1,0.00%,1,0,100.00%
juhacqev.sched.sma.tdnsstic1.cn,1,0.00%,1,0,100.00%
tianshu.gtimg.cn.legodlied1-dk.sched.dcloudstc.com,1,0.00%,2,1,50.00%
im1.hicloud.com,1,0.00%,1,0,100.00%
dps-drcn.jos.dbankcloud.cn,1,0.00%,1,0,100.00%
t.91tianlu.pw,1,0.00%,1,0,100.00%
acp.zh.cmbchina.com,1,0.00%,1,0,100.00%
pub-api-gateway.paas.cmbchina.com,1,0.00%,1,0,100.00%
img.biquge-app.com,1,0.00%,1,0,100.00%
1099ddb.vfra.dscew.ml,1,0.00%,1,0,100.00%
reflections.repeatmd.com,1,0.00%,1,0,100.00%
a24-66.akam.net,1,0.00%,1,0,100.00%
eyktkpzypweq.exitlist.co,1,0.00%,1,0,100.00%
cpanel.magnasoftbim.com,1,0.00%,1,0,100.00%
paris.trial.paladinsoftware.com,1,0.00%,1,0,100.00%
rttf.citrix.com,1,0.00%,1,0,100.00%
test.quantcast.mgr.consensu.org,1,0.00%,2,1,50.00%
httplogserver-lb.global.unified-prod.sharethis.net,1,0.00%,1,0,100.00%
px-eu.adhigh.net,1,0.00%,1,0,100.00%
creativecdn.com,1,0.00%,1,0,100.00%
elb-aws-jp-adizio-1511153879.ap-northeast-1.elb.amazonaws.com,1,0.00%,1,0,100.00%
spug-sgc.pubmnet.com,1,0.00%,1,0,100.00%
x01.aidata.io,1,0.00%,1,0,100.00%
d1jm6n7utzqv3r.cloudfront.cn,1,0.00%,1,0,100.00%
1.cpm.ak-is2.net,1,0.00%,1,0,100.00%
jddriving.theorytestpro.co.uk,1,0.00%,1,0,100.00%
m.npdfr1.ga,1,0.00%,1,0,100.00%
meeting.kdocs.cn,1,0.00%,1,0,100.00%
wenk.ios.wpscdn.cn,1,0.00%,2,1,50.00%
8uof.herokuapp.com,1,0.00%,1,0,100.00%
perfops-3-v4.stackpath.com,1,0.00%,1,0,100.00%
vodstreaming.video.globo.com,1,0.00%,1,0,100.00%
2022.acmmm.org,1,0.00%,1,0,100.00%
tw14.virtual-strike.com,1,0.00%,1,0,100.00%
event.xiaohongshu.com,1,0.00%,1,0,100.00%
m.igame.163.com,1,0.00%,1,0,100.00%
s3gw.cmbchina.com,1,0.00%,1,0,100.00%
www.bohuitalent.com,1,0.00%,1,0,100.00%
api.g.micloud.xiaomi.net,1,0.00%,1,0,100.00%
tz.sec.xiaomi.com,1,0.00%,1,0,100.00%
stats.credly.com,1,0.00%,1,0,100.00%
vl.dt-autoopt.ru,1,0.00%,1,0,100.00%
hoots.co.uk,1,0.00%,1,0,100.00%
annemills.foxbyte.uk,1,0.00%,1,0,100.00%
jp-ntt-2.nodeok.icu,1,0.00%,1,0,100.00%
2018.hackthefuture.be,1,0.00%,1,0,100.00%
mail.inpuracithu.ga,1,0.00%,1,0,100.00%
eecs-haproxy-vip.eecs.berkeley.edu,1,0.00%,1,0,100.00%
valisimofashions.com,1,0.00%,1,0,100.00%
16fpjqhi.sched.d0.tdnsdp1.cn,1,0.00%,1,0,100.00%
32x7bcvl.sched.d0.tdnsdp1.cn,1,0.00%,1,0,100.00%
nd4gdvse.sched.d0.tdnsdp1.cn,1,0.00%,1,0,100.00%
p0.itc.cn,1,0.00%,5,4,20.00%
ali-bj-pcdn-14.biliapi.net,1,0.00%,1,0,100.00%
hw-sh-live-p2p-3.chat.bilibili.com,1,0.00%,1,0,100.00%
hl2rcv.adobe.com,1,0.00%,1,0,100.00%
p.qiao.baidu.com,1,0.00%,1,0,100.00%
pannss.bdstatic.com,1,0.00%,1,0,100.00%
static.cingta.com,1,0.00%,1,0,100.00%
www.ict.cas.cn,1,0.00%,1,0,100.00%
sc1.hao123img.com,1,0.00%,2,1,50.00%
image.baidu.com,1,0.00%,5,4,20.00%
img1.hao123.com,1,0.00%,2,1,50.00%
img2.hao123.com,1,0.00%,2,1,50.00%
gad.netease.com,1,0.00%,1,0,100.00%
v.6.cn,1,0.00%,1,0,100.00%
www.gmw.cn,1,0.00%,2,1,50.00%
caldav.icloud.com,1,0.00%,2,1,50.00%
helpinfockeniu1.ksmobile.com,1,0.00%,1,0,100.00%
dragate.dc.oppomobile.com,1,0.00%,1,0,100.00%
info.stcn.com,1,0.00%,1,0,100.00%
wap.stcn.com,1,0.00%,1,0,100.00%
aidatatest.zhihu.com,1,0.00%,2,1,50.00%
open.xueqiu.com,1,0.00%,1,0,100.00%
api.steambig.com,1,0.00%,1,0,100.00%
mbook.duote.com,1,0.00%,1,0,100.00%
police.cnool.net,1,0.00%,1,0,100.00%
submit.duote.com,1,0.00%,1,0,100.00%
union.rising.com.cn,1,0.00%,1,0,100.00%
www.avira.com,1,0.00%,2,1,50.00%
www.jiangmin.com,1,0.00%,1,0,100.00%
front.steambig.com,1,0.00%,1,0,100.00%
media.vuess.net,1,0.00%,1,0,100.00%
1610067831.D4EE073C2A20.device.hiwifi.com,1,0.00%,1,0,100.00%
1610067893.D4EE073C2A20.device.hiwifi.com,1,0.00%,1,0,100.00%
efjxmwi.amo.dseoe.ga,1,0.00%,1,0,100.00%
abc.rudywoo.ml,1,0.00%,1,0,100.00%
vkk49ekoc3luxt0d.b.requestbin.net,1,0.00%,1,0,100.00%
videoepg.hicloud.com,1,0.00%,2,1,50.00%
test.friends.getambassador.com,1,0.00%,1,0,100.00%
www.voD.lxdns.CoM,1,0.00%,2,1,50.00%
login.qfarm.qq.com,1,0.00%,1,0,100.00%
bit.jjyy.ml,1,0.00%,1,0,100.00%
parrot-pc-1251479438.cos.ap-beijing.myqcloud.com,1,0.00%,1,0,100.00%
georeferencer.outerspatial.com,1,0.00%,1,0,100.00%
57afda59-ed10-407a-a920-26b0b1695d40.assets.booqable.com,1,0.00%,1,0,100.00%
megaone.acrothemes.com,1,0.00%,1,0,100.00%
vol3rd.herokuapp.com,1,0.00%,1,0,100.00%
oracle-gia-fhc-free.wisdomfree.tk,1,0.00%,1,0,100.00%
jp.567568.ml,1,0.00%,1,0,100.00%
jp-01.woshi.gq,1,0.00%,1,0,100.00%
checkout.tablelistpro.com,1,0.00%,1,0,100.00%
www.bjnotary.org,1,0.00%,1,0,100.00%
tdomkim.berkutschi.com,1,0.00%,1,0,100.00%
m.ieiuyg.ga,1,0.00%,1,0,100.00%
direwolf-baa54fbdc1.herokuapp.com,1,0.00%,1,0,100.00%
e12919.dscd.akamaiedge.net.0.1.cn.akamaiedge.net,1,0.00%,1,0,100.00%
blob.dsm07prdstr03a.store.core.windows.net,1,0.00%,1,0,100.00%
img.ziroom.com,1,0.00%,2,1,50.00%
bizsec-auth.alicdn.com,1,0.00%,2,1,50.00%
bizsec-auth.alicdn.com.danuoyi.tbcache.com,1,0.00%,2,1,50.00%
slp2p-east-std27.oray.net,1,0.00%,1,0,100.00%
d1nc0sgtxu7wmg.cloudfront.net,1,0.00%,2,1,50.00%
v3.toutiaovod.com,1,0.00%,2,1,50.00%
test.puzat.ru,1,0.00%,1,0,100.00%
d1dmgcawtbm6l9.cloudfront.net,1,0.00%,1,0,100.00%
joel.solofolio.net,1,0.00%,1,0,100.00%
pl.smartep.pro,1,0.00%,1,0,100.00%
spa.catttt.ml,1,0.00%,1,0,100.00%
app.auxpad.com,1,0.00%,1,0,100.00%
vvebo.vip,1,0.00%,1,0,100.00%
svc.webspellchecker.net,1,0.00%,1,0,100.00%
webmail.novasulfm.tk,1,0.00%,1,0,100.00%
www.toutiao.com.bytedns1.com,1,0.00%,2,1,50.00%
r2.sn-ni5eln7e.gvt1.com,1,0.00%,1,0,100.00%
k8s-pbs-prodingr-4207bf599b-1216599560.us-east-1.elb.amazonaws.com,1,0.00%,1,0,100.00%
static-cdn-test.google-cdn.public.springernature.app,1,0.00%,1,0,100.00%
down.znshuru.com,1,0.00%,1,0,100.00%
down.znshuru.com.wsglb0.com,1,0.00%,1,0,100.00%
e1315.dsca.akamaiedge.net,1,0.00%,2,1,50.00%
hbrt-or1-ext-vip.adobe.com,1,0.00%,1,0,100.00%
idc-hq-ja6.sinajs.cn,1,0.00%,1,0,100.00%
pub.idqqimg.com.mid.tdnsv6.com,1,0.00%,2,1,50.00%
radarr.secondwife.ga,1,0.00%,1,0,100.00%
wk-video-img.cdn.bcebos.com,1,0.00%,2,1,50.00%
skypeecs-prod-eun-2.cloudapp.net,1,0.00%,1,0,100.00%
1610355308.D4EE073396E8.device.hiwifi.com,1,0.00%,1,0,100.00%
lekarzfinansow.instalbud.pro,1,0.00%,1,0,100.00%
ru.moretecgroup.com,1,0.00%,1,0,100.00%
interactive.com.gr,1,0.00%,1,0,100.00%
i-phx02p-cor002.api.p001.1drv.com,1,0.00%,1,0,100.00%
blob.bn1prdstr15a.store.core.windows.net,1,0.00%,1,0,100.00%
apim2.bige.dev,1,0.00%,1,0,100.00%
bend.g1outdoors.life,1,0.00%,1,0,100.00%
rb.liuyelove.cf,1,0.00%,1,0,100.00%
bmsc.caves.org.au,1,0.00%,1,0,100.00%
jp08.graniterapids.com,1,0.00%,1,0,100.00%
tjaqq.smoba.qq.com,1,0.00%,1,0,100.00%
gnginx.kuwo.cn,1,0.00%,1,0,100.00%
fundts.eastmoney.com,1,0.00%,1,0,100.00%
j7.dfcfw.com,1,0.00%,2,1,50.00%
j7.dfcfw.com.cdn.dnsv1.com,1,0.00%,2,1,50.00%
r2.sn-ni5een7l.gvt1.com,1,0.00%,1,0,100.00%
v4-5.hiaoxui.work,1,0.00%,1,0,100.00%
v4-11.hiaoxui.work,1,0.00%,1,0,100.00%
baa9c3ed9f92fdc069247645b6f2b483.dlied1.cdntips.net.tztc.jsq.ho-wan.cn,1,0.00%,1,0,100.00%
z163picipv6.v.bsgslb.cn,1,0.00%,2,1,50.00%
0915.bell.cf,1,0.00%,1,0,100.00%
cdn-cmcn360.wggames.cn,1,0.00%,1,0,100.00%
lc11.lvchi.tk,1,0.00%,1,0,100.00%
cachetv.tc.qq.com,1,0.00%,2,1,50.00%
cache.tv.qq.com.sched.px-dk.tdnsv6.com,1,0.00%,2,1,50.00%
www.12377.cn.cdn.dnsv1.com.cn,1,0.00%,2,1,50.00%
vm.gtimg.cn.sched.legopic1-dk.tdnsv6.com,1,0.00%,2,1,50.00%
r.mailin.fr,1,0.00%,1,0,100.00%
app.notes.mustang.cloud,1,0.00%,1,0,100.00%
capi.samsungcloud.com,1,0.00%,1,0,100.00%
fe-pcn1-ext-galaxyappstore-lb-1188523672.cn-north-1.elb.amazonaws.com.cn,1,0.00%,1,0,100.00%
alb-rubin-nginx-5071359.cn-north-1.elb.amazonaws.com.cn,1,0.00%,1,0,100.00%
apigateway-sacnnorth1-ext-2014765339.cn-north-1.elb.amazonaws.com.cn,1,0.00%,1,0,100.00%
fp274c.wpc.phicdn.net,1,0.00%,1,0,100.00%
b9ml3jr.myraidbox.de,1,0.00%,1,0,100.00%
d3qlttb2odh0ir.cloudfront.net,1,0.00%,1,0,100.00%
hr13.graniterapids.com,1,0.00%,1,0,100.00%
appcenter-api.yeshen.com,1,0.00%,1,0,100.00%
shizzle.hammetjus.nl,1,0.00%,1,0,100.00%
mserver.link,1,0.00%,1,0,100.00%
www.codenong.com,1,0.00%,1,0,100.00%
i2.wp.com,1,0.00%,1,0,100.00%
img3.douding.cn,1,0.00%,1,0,100.00%
img.docin.com,1,0.00%,1,0,100.00%
ric.agama.dev,1,0.00%,1,0,100.00%
eau02-breeziest-in.cloudapp.net,1,0.00%,1,0,100.00%
aspmx.l.google.com,1,0.00%,2,1,50.00%
alt1.aspmx.l.google.com,1,0.00%,2,1,50.00%
alt2.aspmx.l.google.com,1,0.00%,2,1,50.00%
alt4.aspmx.l.google.com,1,0.00%,2,1,50.00%
alt3.aspmx.l.google.com,1,0.00%,1,0,100.00%
udpolimenew.n.shifen.com,1,0.00%,1,0,100.00%
work.arun.be,1,0.00%,1,0,100.00%
mail.frionik.com,1,0.00%,1,0,100.00%
arenanetwlrk.teamworkonline.com,1,0.00%,1,0,100.00%
ldvp-3a3319.diltwo.com,1,0.00%,1,0,100.00%
quincycsd.systemcatalog.net,1,0.00%,1,0,100.00%
skypeecs-prod-usc-2.cloudapp.net,1,0.00%,1,0,100.00%
crane1.151114.tk,1,0.00%,1,0,100.00%
demo.bagipeti.hu,1,0.00%,1,0,100.00%
krislightman.realscout.com,1,0.00%,1,0,100.00%
www1.dell-cidr.akadns.net,1,0.00%,1,0,100.00%
wangtai.herokuapp.com,1,0.00%,1,0,100.00%
poly.luros.de,1,0.00%,1,0,100.00%
only-930097-124-16-140-20.nstool.321fenx.com,1,0.00%,1,0,100.00%
e15489.b.akamaiedge.net,1,0.00%,1,0,100.00%
tex.stackexchange.com,1,0.00%,1,0,100.00%
cloud-assets.alicdn.com,1,0.00%,1,0,100.00%
d.alicdn.com,1,0.00%,6,5,16.67%
ecs.console.aliyun.com,1,0.00%,1,0,100.00%
s1-imfile.feishucdn.com,1,0.00%,2,1,50.00%
cdn.amplitude.com,1,0.00%,1,0,100.00%
adt-cpatrk-net-848013041.cn-north-1.elb.amazonaws.com.cn,1,0.00%,1,0,100.00%
h7qbwl8g.sched.d2.tdnsdp1.cn.cjt.vwnti.yrzhcloud.cn,1,0.00%,1,0,100.00%
s1-imfile.feishucdn.com.wsglb0.com,1,0.00%,2,1,50.00%
poster.fqtodo.cn,1,0.00%,2,1,50.00%
poster-fqtodo-cn-idvfvdm.qiniudns.com,1,0.00%,2,1,50.00%
t.chaojizhu.cn,1,0.00%,1,0,100.00%
blackhole.m.jd.com.gslb.qianxun.com,1,0.00%,1,0,100.00%
calendar.google.com,1,0.00%,6,5,16.67%
e.gtld-servers.net,1,0.00%,2,1,50.00%
av3.nstld.com,1,0.00%,4,3,25.00%
d.gtld-servers.net,1,0.00%,2,1,50.00%
kopalniawiedzy.pl,1,0.00%,1,0,100.00%
webdisk.davedoes.com,1,0.00%,1,0,100.00%
direwolf-7b98c550ca.herokuapp.com,1,0.00%,1,0,100.00%
ip3026294286.funshion.com,1,0.00%,1,0,100.00%
s2-10955.kwimgs.com,1,0.00%,2,1,50.00%
klink-newproduct-ws1.kuaishouzt.com,1,0.00%,1,0,100.00%
only-815730-124-16-140-20.nstool.yqkk.link,1,0.00%,1,0,100.00%
vthumb.ykimg.com,1,0.00%,2,1,50.00%
v2ray.papio.cf,1,0.00%,1,0,100.00%
staging.curbjam.com,1,0.00%,1,0,100.00%
eloraartigosmisticos.com.br,1,0.00%,1,0,100.00%
prometheus.findmykids.app,1,0.00%,1,0,100.00%
glw-old.kg-mtl.com,1,0.00%,1,0,100.00%
1608223856.D4EE071FA772.device.hiwifi.com,1,0.00%,1,0,100.00%
1608223922.D4EE071FA772.device.hiwifi.com,1,0.00%,1,0,100.00%
business.wedesignitall.com,1,0.00%,1,0,100.00%
qos.gcloud.qq.com,1,0.00%,2,1,50.00%
capi.voice.gcloud.qq.com,1,0.00%,1,0,100.00%
sv.wikipedia.ahmu.cf,1,0.00%,1,0,100.00%
mathcode.herokuapp.com,1,0.00%,1,0,100.00%
www.thinbug.com,1,0.00%,1,0,100.00%
file.inktok.com,1,0.00%,1,0,100.00%
only-535037-124-16-137-11.nstool.laiqukankan.com,1,0.00%,1,0,100.00%
modou.wpsdns.com,1,0.00%,1,0,100.00%
c3.shared.global.fastly.net,1,0.00%,1,0,100.00%
oracle1.crim.ist,1,0.00%,1,0,100.00%
only-220613-124-16-137-11.nstool.laiqukankan.com,1,0.00%,1,0,100.00%
upos-sz-mirrorcosb.bilivideo.com.cdn.dnsv1.com,1,0.00%,2,1,50.00%
upos-sz-mirrorcosb.bilivideo.com.sched.v1lego-dk.tdnsvod1.cn,1,0.00%,2,1,50.00%
ali-bj-pcdn-33.biliapi.net,1,0.00%,1,0,100.00%
blocklists.settings.services.mozilla.com,1,0.00%,1,0,100.00%
bt.yncn.xyz,1,0.00%,1,0,100.00%
pool-96-241-40-16.washdc.fios.verizon.net,1,0.00%,1,0,100.00%
millfordmilly.mymealplan.me,1,0.00%,1,0,100.00%
familyguard-api-cn-02.wanyol.com,1,0.00%,1,0,100.00%
mail.camplife.tk,1,0.00%,1,0,100.00%
rdo.med.br,1,0.00%,1,0,100.00%
1608227462.D4EE071FA772.device.hiwifi.com,1,0.00%,1,0,100.00%
leetcode-cn.com,1,0.00%,1,0,100.00%
client.px-cloud.net,1,0.00%,2,1,50.00%
collector-pxgqnulzzy.px-cloud.net,1,0.00%,1,0,100.00%
b.px-cdn.net,1,0.00%,1,0,100.00%
tongji.tom.com,1,0.00%,1,0,100.00%
a122.dscd.akamai.net,1,0.00%,2,1,50.00%
p1.music.126.net.bsclink.cn,1,0.00%,2,1,50.00%
only-835224-124-16-137-11.nstool.haowu.link,1,0.00%,1,0,100.00%
netagetfit.mymealplan.me,1,0.00%,1,0,100.00%
gs.getui.net,1,0.00%,1,0,100.00%
h-adashx.ut.dingtalk.com,1,0.00%,1,0,100.00%
i-bnz05p-cor002.api.p001.1drv.com,1,0.00%,1,0,100.00%
mail.justinakosi.cf,1,0.00%,1,0,100.00%
maestec.com.br,1,0.00%,1,0,100.00%
tw6.ssgnode.ga,1,0.00%,1,0,100.00%
cpanel.1inijiter.tk,1,0.00%,1,0,100.00%
events.launchdarkly.com,1,0.00%,1,0,100.00%
hwa.his.huawei.com,1,0.00%,1,0,100.00%
ins-k0hthigw.ias.tencent-cloud.net,1,0.00%,1,0,100.00%
mbsug.ssl.so.qss-lb.com,1,0.00%,1,0,100.00%
browser5.qhimg.com.qh-cdn.com,1,0.00%,2,1,50.00%
browser5.qhimg.com.webcdn.360qhcdn.com,1,0.00%,2,1,50.00%
pop3s.aruba.it,1,0.00%,1,0,100.00%
s3m5.fenxi.com.qh-cdn.com,1,0.00%,2,1,50.00%
s3m5.fenxi.com.webcdn.360qhcdn.com,1,0.00%,2,1,50.00%
api.shoptoit.net,1,0.00%,1,0,100.00%
cuiapi.lenovo.com.cn,1,0.00%,1,0,100.00%
TrANsIT1.wSlOg.CHInanetcEntER.CoM,1,0.00%,1,0,100.00%
mqtt-broker-review.feature-2429.cowboy.bike,1,0.00%,1,0,100.00%
neliveto.refox.fi,1,0.00%,1,0,100.00%
ticketing-service.boilerjuice-dev.com,1,0.00%,1,0,100.00%
mail.1mlkkk.cf,1,0.00%,1,0,100.00%
webrtc-streamer.herokuapp.com,1,0.00%,1,0,100.00%
1610060620.D4EE073C2A20.device.hiwifi.com,1,0.00%,1,0,100.00%
sg10.anyco.vip,1,0.00%,1,0,100.00%
mail.fircrestpres.org,1,0.00%,1,0,100.00%
shapenet.cs.stanford.edu,1,0.00%,1,0,100.00%
gz2vip.91tunnel.com,1,0.00%,1,0,100.00%
68-183-88-124.brd-cdn.com,1,0.00%,1,0,100.00%
yukh.hostel-worship.org,1,0.00%,1,0,100.00%
ali-bj-pcdn-25.biliapi.net,1,0.00%,1,0,100.00%
ns-eh2-prod-dm2-518.cloudapp.net,1,0.00%,1,0,100.00%
ns-eh2-prod-dm2-543.cloudapp.net,1,0.00%,1,0,100.00%
obus-dc20123-cn.heytapmobi.com,1,0.00%,1,0,100.00%
microsoft-com.mail.protection.outlook.com,1,0.00%,1,0,100.00%
i10.hoopchina.com.cn.cdn.dnsv1.com,1,0.00%,2,1,50.00%
gv9c9act.sched.sma-dk.tdnsstic1.cn,1,0.00%,2,1,50.00%
arm1.liaoliqing.ml,1,0.00%,1,0,100.00%
1610326321.D4EE073396E8.device.hiwifi.com,1,0.00%,1,0,100.00%
ja.betenemy.com,1,0.00%,1,0,100.00%
u1.starkbobo.ml,1,0.00%,1,0,100.00%
schellshockbjj.kicksite.net,1,0.00%,1,0,100.00%
staging.tms2.ideawrights.com,1,0.00%,1,0,100.00%
dashboard.whiteshark.ca,1,0.00%,1,0,100.00%
6amsci.b30zhnong.gq,1,0.00%,1,0,100.00%
hk.lihang2022.cf,1,0.00%,1,0,100.00%
2vbb.herokuapp.com,1,0.00%,1,0,100.00%
1610078676.D4EE073C2A20.device.hiwifi.com,1,0.00%,1,0,100.00%
1610078717.D4EE073C2A20.device.hiwifi.com,1,0.00%,1,0,100.00%
upd13.sogoucdn.com,1,0.00%,1,0,100.00%
upd14.sogoucdn.com,1,0.00%,1,0,100.00%
now8.gtimg.com,1,0.00%,2,1,50.00%
jr1se25g.sched.sma-dk.tdnsstic1.cn,1,0.00%,2,1,50.00%
i4.hoopchina.com.cn.cdn.dnsv1.com,1,0.00%,2,1,50.00%
v1-hax.ct.jikeiot.cloud,1,0.00%,1,0,100.00%
prod-zspnslog.kurogame.com,1,0.00%,1,0,100.00%
valipl10.cp31.ott.cibntv.net,1,0.00%,2,1,50.00%
valipl10.cp31.ott.cibntv.net.w.alikunlun.com,1,0.00%,2,1,50.00%
irus.coloros.com,1,0.00%,1,0,100.00%
rusfs.coloros.com.w.kunluncan.com,1,0.00%,1,0,100.00%
sms.ads.heytapmobi.com,1,0.00%,1,0,100.00%
smart-sms-cn.heytapimage.com.w.alikunlun.com,1,0.00%,1,0,100.00%
110-dot.teddymobile.cn,1,0.00%,1,0,100.00%
smtp.chemical-block.com,1,0.00%,1,0,100.00%
dldir1v6.qq.com.mid.dcloudstc.com,1,0.00%,2,1,50.00%
dmp-log-534275707.cn-northwest-1.elb.amazonaws.com.cn,1,0.00%,1,0,100.00%
bigdata-lbs-pri-c3.alb.xiaomi.com,1,0.00%,1,0,100.00%
s1.xmcdn.com.w.cdngslb.com,1,0.00%,2,1,50.00%
imagev2.xmcdn.com.w.cdngslb.com,1,0.00%,2,1,50.00%
waf.ctc.ximalaya.com,1,0.00%,1,0,100.00%
m.ctcbs.ximalaya.com,1,0.00%,1,0,100.00%
dsm01pcor005-meta.fe.1drv.com,1,0.00%,2,1,50.00%
media-shxiya-yijia09.sn3oss.ctyunxs.cn,1,0.00%,1,0,100.00%
1610071481.D4EE073C2A20.device.hiwifi.com,1,0.00%,1,0,100.00%
1610071542.D4EE073C2A20.device.hiwifi.com,1,0.00%,1,0,100.00%
st.19pkd.com,1,0.00%,1,0,100.00%
kr.jiangyu.tk,1,0.00%,1,0,100.00%
best-holiday-inn-shillong.namastenortheast.com,1,0.00%,1,0,100.00%
brooklynstore.com.ua,1,0.00%,1,0,100.00%
app.nearmint.io,1,0.00%,1,0,100.00%
elderalex.brimhallfamily.org,1,0.00%,1,0,100.00%
webmail.micolegio.cl,1,0.00%,1,0,100.00%
webmail.sjbnrexcellent.ga,1,0.00%,1,0,100.00%
1.uk.pool.ntp.org,1,0.00%,1,0,100.00%
techcrunch.com.anum.clonezone.link,1,0.00%,1,0,100.00%
prod-addinsinstallation.omexexternallfb.office.net.akadns.net,1,0.00%,1,0,100.00%
learn.wisely.academy,1,0.00%,1,0,100.00%
voipfinderliveplay.wxqcloud.qq.com.l4vip-dk.sched.dcloudlive.com.clive.cdnjn01.cenvandns.com,1,0.00%,2,1,50.00%
secure.globalsign.com,1,0.00%,2,1,50.00%
9i61iidn1kfvp3fscs3p6k2prqrjri086di17hu4lv85hlb60afvuna1.qc.x.bsgslb.cn,1,0.00%,1,0,100.00%
suisunrcd.systemcatalog.net,1,0.00%,1,0,100.00%
blog.innovationti.mx,1,0.00%,1,0,100.00%
ssl.netwood.net,1,0.00%,1,0,100.00%
mail.masesanthumbmona.ga,1,0.00%,1,0,100.00%
mail.regina.ga,1,0.00%,1,0,100.00%
relay2.mod.gov.ae,1,0.00%,1,0,100.00%
relay1.mod.gov.ae,1,0.00%,1,0,100.00%
tw.ifancl-address.net,1,0.00%,1,0,100.00%
web-opt.fuerst.one,1,0.00%,1,0,100.00%
dh.yunliunet.com,1,0.00%,1,0,100.00%
m.t35frb.ga,1,0.00%,1,0,100.00%
puntoviti-s-r-l.scontrinoshop.com,1,0.00%,1,0,100.00%
apd-f8146276e351bde53365bdbd09afbba4.v.smtcdns.com,1,0.00%,1,0,100.00%
dev-c.microsofttranslator.search.prod.ms.akadns.net,1,0.00%,1,0,100.00%
d1--cn-gotcha208.bilivideo.com.c.cdnhwc1.com,1,0.00%,2,1,50.00%
dy-vod-e.bytegslb.com,1,0.00%,1,0,100.00%
cloudsearch.googleapis.com,1,0.00%,1,0,100.00%
ali-video-privilege-vip.xunlei.com,1,0.00%,1,0,100.00%
flume-xldw-ssl.xunlei.cn,1,0.00%,1,0,100.00%
public-cdn.cloud.unitychina.cn.m.alikunlun.com,1,0.00%,1,0,100.00%
p212-content.icloud.com.cn,1,0.00%,1,0,100.00%
ip3720517264.funshion.com,1,0.00%,1,0,100.00%
se.360.cn.webcdn.360qhcdn.com,1,0.00%,2,1,50.00%
web-img.oss.aliyuncs.com,1,0.00%,1,0,100.00%
roas.afunapp.com,1,0.00%,1,0,100.00%
apwx.51y5.net,1,0.00%,1,0,100.00%
snake-compose-api.tcsdzz.com,1,0.00%,1,0,100.00%
pagead2.googleadservices.com,1,0.00%,1,0,100.00%
slike.knez.tk,1,0.00%,1,0,100.00%
139-59-145-121.cprapid.com,1,0.00%,1,0,100.00%
xb001.kifk.cf,1,0.00%,1,0,100.00%
mail.seobacklinks73.ml,1,0.00%,1,0,100.00%
web.boxhero-app.com,1,0.00%,1,0,100.00%
sg2plmcpnl485225.prod.sin2.secureserver.net,1,0.00%,1,0,100.00%
uqntbn.a85shuai.gq,1,0.00%,1,0,100.00%
xbroker-z1-i1.ngxcld.com,1,0.00%,1,0,100.00%
tu.video.weibocdn.com,1,0.00%,2,1,50.00%
tuvideo.gslb.sinaedge.com,1,0.00%,2,1,50.00%
www.freesound.cn,1,0.00%,1,0,100.00%
us05www3.zoom.us,1,0.00%,1,0,100.00%
audiodown.mylog.tech,1,0.00%,1,0,100.00%
dotab.douyucdn.cn.w.cdngslb.com,1,0.00%,1,0,100.00%
a1851.dscg2.akamai.net.0.1.cn.akamaitech.net,1,0.00%,2,1,50.00%
vdanmu.douyu.com,1,0.00%,1,0,100.00%
ms-comment.douyucdn.cn.w.cdngslb.com,1,0.00%,1,0,100.00%
a.msstatic.com.w.kunlunle.com,1,0.00%,2,1,50.00%
only-783555-124-16-137-11.nstool.laiqukankan.com,1,0.00%,1,0,100.00%
api.k.ntes53.netease.com,1,0.00%,2,1,50.00%
d4.music.126.net,1,0.00%,2,1,50.00%
only-157917-124-16-137-11.nstool.netease.com,1,0.00%,1,0,100.00%
d4.music.126.net.163jiasu.com,1,0.00%,2,1,50.00%
d4.music.126.net.bsclink.cn,1,0.00%,2,1,50.00%
zmx163ad.v.bsclink.cn,1,0.00%,2,1,50.00%
d1.music.126.net.ctot.baishangeek.cn,1,0.00%,2,1,50.00%
www.virtualbox.org,1,0.00%,1,0,100.00%
topicimg.1234567.com.cn,1,0.00%,2,1,50.00%
f1.dfcfw.com,1,0.00%,2,1,50.00%
z1.dfcfw.com,1,0.00%,2,1,50.00%
img.1234567.com.cn,1,0.00%,2,1,50.00%
counter1.1234567.com.cn,1,0.00%,1,0,100.00%
update.hicloud.com.c.cdnhwc1.com,1,0.00%,2,1,50.00%
p6-pc-sign.douyinpic.com,1,0.00%,3,2,33.33%
aae-sgweb001-1.asuscomm.com,1,0.00%,1,0,100.00%
mail.yunjushi.com,1,0.00%,1,0,100.00%
mail.drugulf.ae,1,0.00%,1,0,100.00%
promotions.privy-staging-pr-6934.privy-staging.com,1,0.00%,1,0,100.00%
andjoy-site-staging.andjoy.life,1,0.00%,1,0,100.00%
metab.rick.ai,1,0.00%,1,0,100.00%
shop.audi-zentrum-goettingen.de,1,0.00%,1,0,100.00%
lic1.embedded-wizard.de,1,0.00%,1,0,100.00%
besticon-demo.herokuapp.com,1,0.00%,1,0,100.00%
cn.cada.cf,1,0.00%,1,0,100.00%
p6.music.126.net.163jiasu.com,1,0.00%,2,1,50.00%
upp-cdn.itunes-apple.com.akadns.net,1,0.00%,2,1,50.00%
elk.ssjj2.com,1,0.00%,1,0,100.00%
ali-bj-pcdn-32.biliapi.net,1,0.00%,1,0,100.00%
bottom-line-live-relay-01108-ct.bvc-line.bilivideo.com,1,0.00%,1,0,100.00%
1r9t940v9m79t0zn.aliyunddos1006.com,1,0.00%,1,0,100.00%
j.map.n.shifen.com,1,0.00%,4,3,25.00%
map-mobile-resource.cdn.bcebos.com.a.bdydns.com,1,0.00%,2,1,50.00%
youjia-image.cdn.bcebos.com.a.bdydns.com,1,0.00%,2,1,50.00%
vmss-clarity-ingest-eus2-e.eastus2.cloudapp.azure.com,1,0.00%,1,0,100.00%
d1dknu9lq1pttw.cloudfront.net,1,0.00%,1,0,100.00%
price.pcauto.com.cn.ctadns.cn,1,0.00%,1,0,100.00%
search.sogoucdn.com,1,0.00%,2,1,50.00%
help.sogou.com,1,0.00%,1,0,100.00%
d1p4fa0g2cgyhv.cloudfront.net,1,0.00%,1,0,100.00%
driver.deliberr.io,1,0.00%,1,0,100.00%
hr19.graniterapids.com,1,0.00%,1,0,100.00%
culturelle.biomarker.io,1,0.00%,1,0,100.00%
blog.finestjourneys.com,1,0.00%,1,0,100.00%
p3plmcpnl495750.prod.phx3.secureserver.net,1,0.00%,1,0,100.00%
dierendonckblancke-architects.divisare.pro,1,0.00%,1,0,100.00%
c.nightnumen203.ml,1,0.00%,1,0,100.00%
p27-caldav.icloud.com,1,0.00%,2,1,50.00%
arquivos.getambassador.com,1,0.00%,1,0,100.00%
medialibrary.nrc.govt.nz,1,0.00%,1,0,100.00%
s725ipmi.herokuapp.com,1,0.00%,1,0,100.00%
server.dnspark.in,1,0.00%,1,0,100.00%
img.pcauto.com.cn.ctadns.cn,1,0.00%,1,0,100.00%
pgdt.ugdtimg.com.tcdn.qq.com,1,0.00%,2,1,50.00%
pgdt.ugdtimg.com.sched.legopic2-dk.tdnsv6.com,1,0.00%,2,1,50.00%
bbs.pcauto.com.cn.ctadns.cn,1,0.00%,1,0,100.00%
imgad0.pcauto.com.cn.ctadns.cn,1,0.00%,1,0,100.00%
v.topqh.net,1,0.00%,1,0,100.00%
imgad0.pconline.com.cn.ctadns.cn,1,0.00%,1,0,100.00%
b.lnk0.com.td.fusion.iaas.jdcloud.com,1,0.00%,1,0,100.00%
ks.pconline.com.cn.ctadns.cn,1,0.00%,1,0,100.00%
tx-sh-live-stun-2.chat.bilibili.com,1,0.00%,1,0,100.00%
blob.bnz10prdstr21a.store.core.windows.net,1,0.00%,1,0,100.00%
amonsul.douban.com,1,0.00%,1,0,100.00%
0yqwj67l.sched.dma-dk.tdnsdl1.cn,1,0.00%,2,1,50.00%
img3.doubanio.com.w.alikunlun.com,1,0.00%,2,1,50.00%
orbit.jd.com.gslb.qianxun.com,1,0.00%,1,0,100.00%
kepler.jd.com.gslb.qianxun.com,1,0.00%,1,0,100.00%
wqs11.jd.com,1,0.00%,2,1,50.00%
wqs11.jd.com.gslb.qianxun.com,1,0.00%,2,1,50.00%
wqs11.jd.com.s.galileo.jcloud-cdn.com,1,0.00%,2,1,50.00%
wqs11.jd.com.wscdns.com,1,0.00%,2,1,50.00%
adsmind.ugdtimg.com.tcdn.qq.com,1,0.00%,2,1,50.00%
adsmind.ugdtimg.com.svideolego-dk.sched.dcloudstc.com,1,0.00%,2,1,50.00%
cacerts.digicert.cn.w.cdngslb.com,1,0.00%,1,0,100.00%
cdn.17qiche.com.w.kunlunpi.com,1,0.00%,1,0,100.00%
js.17qiche.com.w.kunlunpi.com,1,0.00%,1,0,100.00%
newimg.17qiche.com.w.kunlunpi.com,1,0.00%,1,0,100.00%
images2.17qiche.com.w.kunlunaq.com,1,0.00%,1,0,100.00%
www.17qiche.com.w.kunluncan.com,1,0.00%,1,0,100.00%
zpns-byoip-va.zoom.us,1,0.00%,1,0,100.00%
net.rayjump.com,1,0.00%,1,0,100.00%
cn-setting.rayjump.com,1,0.00%,1,0,100.00%
img1.bitauto.com.download.ks-cdn.com,1,0.00%,2,1,50.00%
blob.dsm07prdstr13a.store.core.windows.net,1,0.00%,1,0,100.00%
mt.cv3sarato.ga,1,0.00%,1,0,100.00%
ocsp.cfca.com.cn,1,0.00%,1,0,100.00%
www.dwin1.com,1,0.00%,2,1,50.00%
a3.shared.global.fastly.net,1,0.00%,1,0,100.00%
2e4b93d1-a8ae-4a89-8885-6109135ac0de.prmutv.co,1,0.00%,1,0,100.00%
api.permutive.com,1,0.00%,1,0,100.00%
ins-kb6bwez1.ias.tencent-cloud.net,1,0.00%,1,0,100.00%
ins-m6sfg1rv.ias.tencent-cloud.net,1,0.00%,1,0,100.00%
cmshow.gtimg.cn.sched.legopic2-dk.tdnsv6.com,1,0.00%,2,1,50.00%
cmshow.gtimg.cn.sched.legopic2-dk.tdnsv6.com.tpic.vwnti.yrzhcloud.cn,1,0.00%,2,1,50.00%
circlevideo2.photo.qq.com.tcdn.qq.com,1,0.00%,2,1,50.00%
1193002.svideolego-dk.sched.dcloudstc.com,1,0.00%,2,1,50.00%
1193002.svideolego-dk.sched.dcloudstc.com.tdl.cdn.uyun-cdn.com,1,0.00%,2,1,50.00%
dnacdn.net,1,0.00%,1,0,100.00%
gbc4.sg1.as.criteo.com,1,0.00%,1,0,100.00%
imgcache.qq.com.sched.legopic1-dk.tdnsv6.com,1,0.00%,2,1,50.00%
d2jafhvbn4akdi.cloudfront.net,1,0.00%,1,0,100.00%
e12627.g.akamaiedge.net,1,0.00%,1,0,100.00%
www.scholat.com,1,0.00%,1,0,100.00%
res.scholat.com,1,0.00%,1,0,100.00%
upos-tf-all-hw.bilivideo.com,1,0.00%,2,1,50.00%
s15-sync.firefox.com.cn,1,0.00%,1,0,100.00%
tienda.uramused.com,1,0.00%,1,0,100.00%
mail.clubx.ml,1,0.00%,1,0,100.00%
a0wsw.hm04j.ga,1,0.00%,1,0,100.00%
WWW.VOd.LxdnS.COm,1,0.00%,2,1,50.00%
wWw.vod.lXdNs.coM,1,0.00%,2,1,50.00%
wiki.igeolise.com,1,0.00%,1,0,100.00%
sam.xnet.tk,1,0.00%,1,0,100.00%
staging.allvest-test.de,1,0.00%,1,0,100.00%
www.originlab.com,1,0.00%,1,0,100.00%
azwancan.trafficmanager.net,1,0.00%,1,0,100.00%
q9d61a80760279w5.aliyunddos1006.com,1,0.00%,1,0,100.00%
3czmc20a2u816ocl.aliyunddos1006.com,1,0.00%,1,0,100.00%
bbs-api-static.mihoyo.com,1,0.00%,2,1,50.00%
sysdk.cl2009.com,1,0.00%,1,0,100.00%
cmpassport.com,1,0.00%,1,0,100.00%
auth.wosms.cn,1,0.00%,1,0,100.00%
daily.m.zzx9.cn,1,0.00%,1,0,100.00%
login.vivaldi.net,1,0.00%,1,0,100.00%
downloads.vivaldi.com,1,0.00%,2,1,50.00%
academy-di-vincenzo.socialacademy.me,1,0.00%,1,0,100.00%
mail.hostcurrchlorov.tk,1,0.00%,1,0,100.00%
Telemetry-alb-Prod-1043652844.eu-central-1.elb.amazonaws.com,1,0.00%,1,0,100.00%
slp2p-east-std1017.oray.net,1,0.00%,1,0,100.00%
www.zhihu.com.ipv6.dsa.dnsv1.com,1,0.00%,2,1,50.00%
1610401952.D4EE073396E8.device.hiwifi.com,1,0.00%,1,0,100.00%
mqtt-internal-public.zhihu.com.dsa.dnsv1.com,1,0.00%,6,5,16.67%
magnet.arthivap.tk,1,0.00%,1,0,100.00%
msgapi.teams.live.com,1,0.00%,1,0,100.00%
plus.google.com,1,0.00%,2,1,50.00%
www.amazon.cn,1,0.00%,1,0,100.00%
mademistakes.com,1,0.00%,2,1,50.00%
www4.comp.polyu.edu.hk,1,0.00%,1,0,100.00%
www.jsmastery.pro,1,0.00%,1,0,100.00%
widget.trustpilot.com,1,0.00%,1,0,100.00%
code.tidio.co,1,0.00%,1,0,100.00%
x22npxvj.apicdn.sanity.io,1,0.00%,1,0,100.00%
cl2-cdn.origin-apple.com.akadns.net,1,0.00%,2,1,50.00%
datasink.hm.com.cn,1,0.00%,1,0,100.00%
wWW.vod.LXdNs.COM,1,0.00%,2,1,50.00%
v2tw.51717277.tk,1,0.00%,1,0,100.00%
directory.hivelearningnetworks.org,1,0.00%,1,0,100.00%
direwolf-0d6727d123.herokuapp.com,1,0.00%,1,0,100.00%
ceement.rssx.hp.com,1,0.00%,1,0,100.00%
1608234773.D4EE071FA772.device.hiwifi.com,1,0.00%,1,0,100.00%
www27.pdf2go.com,1,0.00%,1,0,100.00%
mail.theinternetmarketingshoppe.com,1,0.00%,1,0,100.00%
staging.enaena.gr,1,0.00%,1,0,100.00%
api-dev.kontroluje.me,1,0.00%,1,0,100.00%
p.landing22.tk,1,0.00%,1,0,100.00%
notify.privy-staging-pr-7017.privy-staging.com,1,0.00%,1,0,100.00%
mail.pichagumy.cf,1,0.00%,1,0,100.00%
wordpress-820293-2818038.cloudwaysapps.com,1,0.00%,1,0,100.00%
instantlearning.newhorizons.de,1,0.00%,1,0,100.00%
blob.bn7prdstr03a.store.core.windows.net,1,0.00%,1,0,100.00%
connectivity-check.ubuntu.com.itechs.cn,1,0.00%,1,0,100.00%
pcconf.api.mgtv.com,1,0.00%,1,0,100.00%
vidframe.imtt.qq.com,1,0.00%,1,0,100.00%
a.msstatic.com,1,0.00%,2,1,50.00%
kyfw.12306.cn.lxdns.com,1,0.00%,1,0,100.00%
149366088.v2.pressablecdn.com,1,0.00%,1,0,100.00%
_dmarc.mx.mx.mantaray.hoistup.com,1,0.00%,1,0,100.00%
billing.scoop.io,1,0.00%,1,0,100.00%
stremio-kickass.herokuapp.com,1,0.00%,1,0,100.00%
records.shoppu.space,1,0.00%,1,0,100.00%
px.jianpu.ga,1,0.00%,1,0,100.00%
p41-keyvalueservice.icloud.com.cn,1,0.00%,1,0,100.00%
1610060625.D4EE073C2A20.device.hiwifi.com,1,0.00%,1,0,100.00%
tqwr.herokuapp.com,1,0.00%,1,0,100.00%
beta.julianiot.tk,1,0.00%,1,0,100.00%
1610060671.D4EE073C2A20.device.hiwifi.com,1,0.00%,1,0,100.00%
1610060692.D4EE073C2A20.device.hiwifi.com,1,0.00%,1,0,100.00%
slp2p-east-std21.oray.net,1,0.00%,1,0,100.00%
forum.carclub.mk,1,0.00%,1,0,100.00%
mao.mcjparker.xyz,1,0.00%,1,0,100.00%
mail.icabpenco.tk,1,0.00%,1,0,100.00%
agents.pickplus.com,1,0.00%,1,0,100.00%
kltbzd6pxu.3r3.layo.ga,1,0.00%,1,0,100.00%
hk-aws.sssv9.gq,1,0.00%,1,0,100.00%
api.staging.exploremypurpose.com,1,0.00%,1,0,100.00%
pingma.qq.com,1,0.00%,1,0,100.00%
twc01.nwncd.com,1,0.00%,1,0,100.00%
www.zhanqi.tv,1,0.00%,1,0,100.00%
kan.2345.com,1,0.00%,1,0,100.00%
www.showself.com,1,0.00%,1,0,100.00%
www.leiphone.com,1,0.00%,1,0,100.00%
www.voa365.com,1,0.00%,1,0,100.00%
www.cgdream.com.cn,1,0.00%,1,0,100.00%
www.ailab.cn,1,0.00%,1,0,100.00%
www.51cto.com,1,0.00%,1,0,100.00%
c.csdnimg.cn,1,0.00%,1,0,100.00%
www.iteye.com,1,0.00%,1,0,100.00%
news.cctv.com,1,0.00%,3,2,33.33%
www.newyx.net,1,0.00%,1,0,100.00%
www.17yy.com,1,0.00%,1,0,100.00%
www.99danji.com,1,0.00%,1,0,100.00%
www.7k7k.com,1,0.00%,1,0,100.00%
www.ali213.net,1,0.00%,1,0,100.00%
www.doyo.cn,1,0.00%,1,0,100.00%
img4.18183.duoku.com,1,0.00%,1,0,100.00%
www.gamersky.com,1,0.00%,1,0,100.00%
youclever.org,1,0.00%,1,0,100.00%
www.ddooo.com,1,0.00%,1,0,100.00%
zj.ddooo.com,1,0.00%,1,0,100.00%
metrics.hearthsim.net,1,0.00%,1,0,100.00%
pixel.dealtale.com,1,0.00%,1,0,100.00%
972-gdu-533.mktoresp.com,1,0.00%,1,0,100.00%
app.dealtale.com,1,0.00%,1,0,100.00%
man.amsnetwork.app,1,0.00%,1,0,100.00%
mail.seobacklinks211.ga,1,0.00%,1,0,100.00%
1608241790.D4EE071FA772.device.hiwifi.com,1,0.00%,1,0,100.00%
speeddate.choice.no,1,0.00%,1,0,100.00%
gtm-update-khd.2345.cc,1,0.00%,1,0,100.00%
kahoni.satellit.online,1,0.00%,1,0,100.00%
angelicacalderon.realscout.me,1,0.00%,1,0,100.00%
whynow.lsnto.me,1,0.00%,1,0,100.00%
store.thirtybees.com,1,0.00%,1,0,100.00%
downloads.roadmaptozero.com,1,0.00%,1,0,100.00%
login.reviewguards.com,1,0.00%,1,0,100.00%
affinitymartialartsnj.kicksite.net,1,0.00%,1,0,100.00%
00t8h8.kongza.website,1,0.00%,1,0,100.00%
39d0825d09f05.cdn.sohucs.com,1,0.00%,3,2,33.33%
v4.passport.sohu.com,1,0.00%,1,0,100.00%
adv-sv-show.focus.cn,1,0.00%,1,0,100.00%
jincai.sohu.com,1,0.00%,1,0,100.00%
k.sohu.com,1,0.00%,1,0,100.00%
auto.sohu.com,1,0.00%,1,0,100.00%
astro.sohu.com,1,0.00%,1,0,100.00%
acg.sohu.com,1,0.00%,1,0,100.00%
blog.sohu.com,1,0.00%,1,0,100.00%
business.sohu.com,1,0.00%,1,0,100.00%
caipiao.sohu.com,1,0.00%,1,0,100.00%
chihe.sohu.com,1,0.00%,1,0,100.00%
cul.sohu.com,1,0.00%,1,0,100.00%
fashion.sohu.com,1,0.00%,1,0,100.00%
film.sohu.com,1,0.00%,1,0,100.00%
game.sohu.com,1,0.00%,1,0,100.00%
health.sohu.com,1,0.00%,1,0,100.00%
history.sohu.com,1,0.00%,1,0,100.00%
home.focus.cn,1,0.00%,1,0,100.00%
clk.optaim.com,1,0.00%,1,0,100.00%
sem.17zhuangxiu.cn,1,0.00%,1,0,100.00%
sohu.com,1,0.00%,1,0,100.00%
house.focus.cn,1,0.00%,1,0,100.00%
q.stock.sohu.com,1,0.00%,1,0,100.00%
beijing.auto.sohu.com,1,0.00%,1,0,100.00%
jlnhadqt00d8rdsmdgil4g4b9fvuuhorknieboi7pu5db3vp8infuq73.qc.x.bsgslb.cn,1,0.00%,1,0,100.00%
cdn.pcsoftconfig.eastmoney.com,1,0.00%,1,0,100.00%
tireguruwebsites.com,1,0.00%,1,0,100.00%
www.stlracingphotos.com,1,0.00%,1,0,100.00%
media.sketchfab.com,1,0.00%,1,0,100.00%
a58f10cc0fbd913de63cbad92597572e.safeframe.googlesyndication.com,1,0.00%,1,0,100.00%
http://t.yangkeduo.com,1,0.00%,1,0,100.00%
cpanel.sxle.gq,1,0.00%,1,0,100.00%
1608241846.D4EE071FA772.device.hiwifi.com,1,0.00%,1,0,100.00%
static.vesti.rs,1,0.00%,1,0,100.00%
pccoin.pconline.com.cn,1,0.00%,1,0,100.00%
sxb1plmcpnl491464.prod.sxb1.secureserver.net,1,0.00%,1,0,100.00%
intofsale-7a.blocovid.amitree.com,1,0.00%,1,0,100.00%
xlabdiamonds.co.il,1,0.00%,1,0,100.00%
staging.kaniti.online,1,0.00%,1,0,100.00%
new-hope-church.websrvcs.com,1,0.00%,1,0,100.00%
v2rayddd.herokuapp.com,1,0.00%,1,0,100.00%
mail.kneelnovssi.ml,1,0.00%,1,0,100.00%
cm-10-60.getui.com,1,0.00%,1,0,100.00%
stun.rapidnet.de,1,0.00%,1,0,100.00%
stun.voxgratia.org,1,0.00%,1,0,100.00%
stun.voipwise.com,1,0.00%,1,0,100.00%
stun.voipzoom.com,1,0.00%,1,0,100.00%
api.51dzt.com,1,0.00%,1,0,100.00%
ttcmdstatistics.52tt.com,1,0.00%,1,0,100.00%
cm-10-20.getui.com,1,0.00%,1,0,100.00%
sojump.cn-hangzhou.log.aliyuncs.com,1,0.00%,1,0,100.00%
cdn.usefathom.com,1,0.00%,4,3,25.00%
use.fortawesome.com,1,0.00%,1,0,100.00%
ex.ke.com,1,0.00%,1,0,100.00%
28.push2.eastmoney.com,1,0.00%,2,1,50.00%
v2cms.bx483.com,1,0.00%,1,0,100.00%
radar.dev.oneup.company,1,0.00%,1,0,100.00%
elcndugwujop.phone-delivery.com,1,0.00%,1,0,100.00%
direwolf-42b8896210.herokuapp.com,1,0.00%,1,0,100.00%
mail.ontrotravelgroup.ml,1,0.00%,1,0,100.00%
k.klei.ga,1,0.00%,1,0,100.00%
ticker.coinomi.net,1,0.00%,1,0,100.00%
mail.mymtbiotech.com,1,0.00%,1,0,100.00%
1610401947.D4EE073396E8.device.hiwifi.com,1,0.00%,1,0,100.00%
xiyouapp.net,1,0.00%,1,0,100.00%
xiyou.club,1,0.00%,1,0,100.00%
sxfspj.sf.gov.cn,1,0.00%,1,0,100.00%
wWw.VOd.lxdNS.COM,1,0.00%,2,1,50.00%
partnerschule.corona-school.de,1,0.00%,1,0,100.00%
chatwootwong.herokuapp.com,1,0.00%,1,0,100.00%
dl.cloudsmith.io,1,0.00%,2,1,50.00%
mail.proranker150.cf,1,0.00%,1,0,100.00%
dgiddat5.sched.d0.tdnsdp1.cn,1,0.00%,1,0,100.00%
tx-web-player-tracker.biliapi.com,1,0.00%,1,0,100.00%
p0.meituan.net.download.ks-cdn.com,1,0.00%,2,1,50.00%
46kwytew.sched.skalego-dk.tdnsstic1.cn.cjt.vwnti.yrzhcloud.cn,1,0.00%,2,1,50.00%
do.asdfu.xyz,1,0.00%,1,0,100.00%
k7fm0ia9qn1ls473ujou7vsc0jm98ald9bpo15hcvutvfp8e6c5fu597.qc.x.bsgslb.cn,1,0.00%,1,0,100.00%
analyticspixel-microsoft-com.a-0005.a-msedge.net,1,0.00%,1,0,100.00%
a-0005.dc-msedge.net,1,0.00%,1,0,100.00%
v27-a.douyinvod.com.vod.galileo.jcloud-cdn.com,1,0.00%,1,0,100.00%
bbs.ngacn.cc,1,0.00%,1,0,100.00%
sat02pcor001-meta.fe.1drv.com,1,0.00%,1,0,100.00%
api5-normal-dsa.amemv.com.c.dsa.cdnbuild.net,1,0.00%,1,0,100.00%
seedsoft.feishu.cn,1,0.00%,1,0,100.00%
win.eskimi.com,1,0.00%,1,0,100.00%
dsp.nrich.ai,1,0.00%,1,0,100.00%
sync.intentiq.com,1,0.00%,1,0,100.00%
tag.yieldoptimizer.com,1,0.00%,1,0,100.00%
dsp-trk.eskimi.com,1,0.00%,1,0,100.00%
dsp-ap.eskimi.com,1,0.00%,1,0,100.00%
a4p.adpartner.pro,1,0.00%,1,0,100.00%
rcp.c.appier.net,1,0.00%,1,0,100.00%
s-cs.rmp.rakuten.com,1,0.00%,1,0,100.00%
modao.cc,1,0.00%,1,0,100.00%
imio.jd.com,1,0.00%,1,0,100.00%
www.zhuanzhi.ai,1,0.00%,1,0,100.00%
platform-cdn.sharethis.com,1,0.00%,2,1,50.00%
air.kitora.ga,1,0.00%,1,0,100.00%
pr-17474.dev.autoenrolment.co.uk,1,0.00%,1,0,100.00%
us33.thunetwork.ml,1,0.00%,1,0,100.00%
boundless.ayan.org.au,1,0.00%,1,0,100.00%
mail.coolgadgetsforhome.com,1,0.00%,1,0,100.00%
js.mafengwo.net,1,0.00%,3,2,33.33%
184-092-112-149.res.spectrum.com,1,0.00%,1,0,100.00%
www.youxiake.com,1,0.00%,1,0,100.00%
ikoubei.baidu.com,1,0.00%,1,0,100.00%
cn.patch.battlenet.com.cn,1,0.00%,1,0,100.00%
ncc.popo.netease.com,1,0.00%,1,0,100.00%
us01-logfiles-va-9.zoom.us,1,0.00%,1,0,100.00%
plausible.io,1,0.00%,2,1,50.00%
enchantworldle.com,1,0.00%,1,0,100.00%
jp2.ops.ci,1,0.00%,1,0,100.00%
api-global-staging.sponsorpulseimi.com,1,0.00%,1,0,100.00%
pb.epro.sogou.com,1,0.00%,1,0,100.00%
kjimg10.360buyimg.com,1,0.00%,1,0,100.00%
zh.wikisource.ahut.cf,1,0.00%,1,0,100.00%
s3gw.cmbimg.com.w.alikunlun.com,1,0.00%,1,0,100.00%
wwW.VOd.lxdns.COm,1,0.00%,2,1,50.00%
b8erd43r.tsfh.ga,1,0.00%,1,0,100.00%
svapetto.scontrinoshop.com,1,0.00%,1,0,100.00%
aaaj.brio.club,1,0.00%,1,0,100.00%
qcheck.chapelville.com,1,0.00%,1,0,100.00%
info.iscas.ac.cn,1,0.00%,1,0,100.00%
ham-qa-pavilions.redant.cloud,1,0.00%,1,0,100.00%
6019923465.ifncdn.com,1,0.00%,1,0,100.00%
a1692.b.akamai.net,1,0.00%,2,1,50.00%
aecljialudhchlo3.node.ppio.cloud,1,0.00%,1,0,100.00%
aecozmyxxdz5hw5j.node.ppio.cloud,1,0.00%,1,0,100.00%
aecdubvwikkk26dr.node.ppio.cloud,1,0.00%,1,0,100.00%
a1831.cn.w.tl88.net,1,0.00%,1,0,100.00%
h12o01dt.sched.sma.tdnsstic1.cn.cjt.krcdn.idatacube.com,1,0.00%,1,0,100.00%
manifest.razerapi.com.edgesuite.net.globalredir.akadns.net,1,0.00%,1,0,100.00%
dxra5xll.sched.sma.tdnsstic1.cn.cjt.krcdn.idatacube.com,1,0.00%,1,0,100.00%
blob.lvl02prdstr03c.store.core.windows.net,1,0.00%,1,0,100.00%
anti-sdk-report.m.jd.com.gslb.qianxun.com,1,0.00%,1,0,100.00%
lbsgw.m.jd.com,1,0.00%,2,1,50.00%
lbsgw.m.jd.com.gslb.qianxun.com,1,0.00%,2,1,50.00%
sugg.sogou.com,1,0.00%,1,0,100.00%
web.casadi.org,1,0.00%,2,1,50.00%
cpfd.cnki.com.cn,1,0.00%,1,0,100.00%
comic.qq.com,1,0.00%,2,1,50.00%
company.ch.gongchang.com,1,0.00%,1,0,100.00%
www.coolpad.com,1,0.00%,1,0,100.00%
taipei-a1.gp.schneider-electric.com,1,0.00%,1,0,100.00%
comic.letv.com,1,0.00%,1,0,100.00%
www.datafountain.cn,1,0.00%,1,0,100.00%
www.mtruning.club,1,0.00%,1,0,100.00%
mail.alliancestartups.com,1,0.00%,1,0,100.00%
brandmo-back.herokuapp.com,1,0.00%,1,0,100.00%
clouddoc.tzoa.com,1,0.00%,1,0,100.00%
netdata.thkserver.tk,1,0.00%,1,0,100.00%
greco.com.tw,1,0.00%,1,0,100.00%
card.qzone.qq.com,1,0.00%,1,0,100.00%
m.jjwxc.net,1,0.00%,1,0,100.00%
flintapp.runahr.com,1,0.00%,1,0,100.00%
adsmind.gdtimg.com.tcdn.qq.com,1,0.00%,2,1,50.00%
adsmind.gdtimg.com.svideolego-dk.sched.dcloudstc.com,1,0.00%,2,1,50.00%
cngfdispatch.yuanshen.com,1,0.00%,1,0,100.00%
bnz05pcor002-meta.fe.1drv.com,1,0.00%,2,1,50.00%
uci.edog.cdn.office.net.edgekey.net,1,0.00%,2,1,50.00%
word-edit.wac.trafficmanager.net,1,0.00%,1,0,100.00%
instruaccess.awswsscommon.mcafee.com,1,0.00%,1,0,100.00%
ihsu-southeastasia-1.southeastasia.cloudapp.azure.com,1,0.00%,1,0,100.00%
a1108.gi3.akamai.net.0.1.cn.akamaitech.net,1,0.00%,1,0,100.00%
bifrost-https-v4.gw.postman.com,1,0.00%,2,1,50.00%
ali-bj-pcdn-28.biliapi.net,1,0.00%,1,0,100.00%
r.dianping.com,1,0.00%,1,0,100.00%
r1.dianping.com,1,0.00%,1,0,100.00%
register.danzo.ca,1,0.00%,1,0,100.00%
mainwww.newsmth.net,1,0.00%,1,0,100.00%
avemoreandringawalkno221.southafricahotels.website,1,0.00%,1,0,100.00%
jztr.herokuapp.com,1,0.00%,1,0,100.00%
mail.saydenermantbat.gq,1,0.00%,1,0,100.00%
bwttest.vsternchen.de,1,0.00%,1,0,100.00%
discuss.gravit.io,1,0.00%,1,0,100.00%
2010799.luxuryrealestate.com,1,0.00%,1,0,100.00%
cc14.adlion.tk,1,0.00%,1,0,100.00%
ce.ow7.com.br,1,0.00%,1,0,100.00%
youjia.a.shifen.com,1,0.00%,1,0,100.00%
youjia-pc.bdstatic.com,1,0.00%,2,1,50.00%
form.lomnium.be,1,0.00%,1,0,100.00%
patricianoivasefestas.com.br,1,0.00%,1,0,100.00%
p.ananas.chaoxing.com,1,0.00%,2,1,50.00%
7d6cd41defd1458abc5d54d72d5e1178.fp.measure.office.com,1,0.00%,1,0,100.00%
druid-townhomes-21.myzeki.com,1,0.00%,1,0,100.00%
1608230990.D4EE071FA772.device.hiwifi.com,1,0.00%,1,0,100.00%
enfortrowills.co.uk,1,0.00%,1,0,100.00%
lt9bvd.22i7dr1fg.ml,1,0.00%,1,0,100.00%
dentist-template.medicalcare.com,1,0.00%,1,0,100.00%
rust.codemood.ga,1,0.00%,1,0,100.00%
securechef.test.financialforce.com,1,0.00%,1,0,100.00%
saylani-pk.herokuapp.com,1,0.00%,1,0,100.00%
api.malty.ml,1,0.00%,1,0,100.00%
redmine.millepondo.biz,1,0.00%,1,0,100.00%
da30.quinvaidtop2.com,1,0.00%,1,0,100.00%
nationalchurchresidences-mentorship-admin.uremc.com,1,0.00%,1,0,100.00%
imap.web.de,1,0.00%,1,0,100.00%
exercism.org,1,0.00%,1,0,100.00%
im.ecourse.ucas.ac.cn,1,0.00%,1,0,100.00%
note.yd.ecourse.ucas.ac.cn,1,0.00%,1,0,100.00%
noteyd.ecourse.ucas.ac.cn,1,0.00%,1,0,100.00%
webcollector-rtm.agora.io,1,0.00%,1,0,100.00%
web-1.ap.sd-rtn.com,1,0.00%,1,0,100.00%
120-92-123-82.edge.agora.io,1,0.00%,1,0,100.00%
43-255-84-236.edge.sd-rtn.com,1,0.00%,1,0,100.00%
43-255-212-141.edge.agora.io,1,0.00%,1,0,100.00%
43-255-84-251.edge.agora.io,1,0.00%,1,0,100.00%
120-92-45-215.edge.sd-rtn.com,1,0.00%,1,0,100.00%
status.kimai.cloud,1,0.00%,1,0,100.00%
git.qemu.org,1,0.00%,1,0,100.00%
1610333573.D4EE073396E8.device.hiwifi.com,1,0.00%,1,0,100.00%
catalog.bcepi.com,1,0.00%,1,0,100.00%
529901.h18.tw,1,0.00%,1,0,100.00%
dhfs.heytapimage.com,1,0.00%,1,0,100.00%
generos.offeringtree.com,1,0.00%,1,0,100.00%
lol-this-is-dumb.42pag.es,1,0.00%,1,0,100.00%
sync.vmgfactory.com,1,0.00%,1,0,100.00%
sp-mountainburg.myzeki.com,1,0.00%,1,0,100.00%
www.googleoptimize.com,1,0.00%,1,0,100.00%
api.natfrp.com.cdn.cloudflare.net,1,0.00%,2,1,50.00%
vdrd.75262.cn,1,0.00%,1,0,100.00%
osiprod-krs-blush-002.koreasouth.cloudapp.azure.com,1,0.00%,1,0,100.00%
wc.clbk.app,1,0.00%,1,0,100.00%
panel.tabbibia.tk,1,0.00%,1,0,100.00%
mail.wingperkiro.tk,1,0.00%,1,0,100.00%
ns-1189.awsdns-20.org,1,0.00%,4,3,25.00%
band1.aaronchin.ml,1,0.00%,1,0,100.00%
account.venmo.com,1,0.00%,1,0,100.00%
pro.gift.mu,1,0.00%,1,0,100.00%
2i2j.unmsapp.com,1,0.00%,1,0,100.00%
www.vOd.LxdNs.COM,1,0.00%,2,1,50.00%
wWW.VoD.lXDnS.cOM,1,0.00%,2,1,50.00%
welcome.newgeneration.agency,1,0.00%,1,0,100.00%
moneroseeds.ae.org,1,0.00%,1,0,100.00%
mail.kbbnc.ac.in,1,0.00%,1,0,100.00%
a2plvcpnl275310.prod.iad2.secureserver.net,1,0.00%,1,0,100.00%
vodafone-dev.leoworx.com,1,0.00%,1,0,100.00%
cdn.tw-01.planb.cat,1,0.00%,1,0,100.00%
bbs.simonhe.ml,1,0.00%,1,0,100.00%
api-cs.intsig.net,1,0.00%,1,0,100.00%
timg01.bdimg.com,1,0.00%,2,1,50.00%
bzib.nelreports.net,1,0.00%,2,1,50.00%
identity.nel.measure.office.net,1,0.00%,2,1,50.00%
test.areaseb.agency,1,0.00%,1,0,100.00%
admin.amplify-2.gaggleampstaging.us,1,0.00%,1,0,100.00%
miami.binfer.com,1,0.00%,1,0,100.00%
www.voD.lXdns.COM,1,0.00%,2,1,50.00%
linkhelp.clients.google.com,1,0.00%,1,0,100.00%
p3plmcpnl495853.prod.phx3.secureserver.net,1,0.00%,1,0,100.00%
hub-login.stagecliengo.com,1,0.00%,1,0,100.00%
vps.weldonhu.tk,1,0.00%,1,0,100.00%
us_88.antchatxj.com,1,0.00%,1,0,100.00%
tech.datascienceblog.net,1,0.00%,1,0,100.00%
rrln.herokuapp.com,1,0.00%,1,0,100.00%
esg.noexis-lab.cloud,1,0.00%,1,0,100.00%
docs.dgl.ai,1,0.00%,1,0,100.00%
1608256231.D4EE071FA772.device.hiwifi.com,1,0.00%,1,0,100.00%
activist-protection.umdpl.info,1,0.00%,1,0,100.00%
factotum.11marketing.net,1,0.00%,1,0,100.00%
chat.yes98.net,1,0.00%,1,0,100.00%
exed.in.ua,1,0.00%,1,0,100.00%
api.ecommjobs.io,1,0.00%,1,0,100.00%
niederlahnstein-evangelisch.ekhn.de,1,0.00%,1,0,100.00%
v6-litea.douyinvod.com,1,0.00%,2,1,50.00%
welcome.amity.copiri.com,1,0.00%,1,0,100.00%
app.naplessingles.com,1,0.00%,1,0,100.00%
api-blue-2136.blueboard-testing.com,1,0.00%,1,0,100.00%
cn.convert.world,1,0.00%,1,0,100.00%
hiveportsmouth.org.uk,1,0.00%,1,0,100.00%
realestatefinehomes.luxuryrealestate.com,1,0.00%,1,0,100.00%
www.search616.com,1,0.00%,1,0,100.00%
web.hrbc.org.uk,1,0.00%,1,0,100.00%
sc.victorwu.ga,1,0.00%,1,0,100.00%
digitalartguide.segelnblogs.de,1,0.00%,1,0,100.00%
direwolf-d25549ee82.herokuapp.com,1,0.00%,1,0,100.00%
picgalb.beisen.com.w.cdngslb.com,1,0.00%,1,0,100.00%
docrp.weixin.qq.com,1,0.00%,1,0,100.00%
a1.hl1225.tk,1,0.00%,1,0,100.00%
medea-one.herokuapp.com,1,0.00%,1,0,100.00%
dph.fluff.org,1,0.00%,1,0,100.00%
shop.bunsble.com,1,0.00%,1,0,100.00%
cpcontacts.okechamp.ml,1,0.00%,1,0,100.00%
adx.dlads.cn,1,0.00%,1,0,100.00%
d39l2hkdp2esp1.cloudfront.net,1,0.00%,1,0,100.00%
api.candlescience.com,1,0.00%,1,0,100.00%
l4691727.vps18.u.avcdn.net,1,0.00%,2,1,50.00%
y8002308.iavs9x.u.avast.com,1,0.00%,2,1,50.00%
z4055813.vps18.u.avcdn.net,1,0.00%,2,1,50.00%
d3176133.vps18.u.avcdn.net,1,0.00%,2,1,50.00%
w5805295.vps18.u.avcdn.net,1,0.00%,2,1,50.00%
shop.craigwoodwildlifephotography.com,1,0.00%,1,0,100.00%
itvl.herokuapp.com,1,0.00%,1,0,100.00%
pdgxpvmgpu024-b.nam.corp.gm.com,1,0.00%,1,0,100.00%
portal.healthcareglobal.online,1,0.00%,1,0,100.00%
app.stayfi.com,1,0.00%,1,0,100.00%
popuppower.co.uk,1,0.00%,1,0,100.00%
direwolf-60efcff69c.herokuapp.com,1,0.00%,1,0,100.00%
ip-208-109-11-74.ip.secureserver.net,1,0.00%,1,0,100.00%
vod0129.aliyun05.vip.lixian.xunlei.com,1,0.00%,1,0,100.00%
cm-10-19.getui.com,1,0.00%,1,0,100.00%
metrics-dra.dt.hicloud.com,1,0.00%,1,0,100.00%
cds.51y5.net,1,0.00%,1,0,100.00%
opencdnxhsvod1.jomodns.com,1,0.00%,2,1,50.00%
crash.xiaohongshu.com,1,0.00%,1,0,100.00%
cdn-api-verify.mob.com.w.kunluncan.com,1,0.00%,1,0,100.00%
f9e9542dq6tz0v6p.aliyunddos1026.com,1,0.00%,1,0,100.00%
oj3y7wx427mfa02u.aliyunddos1026.com,1,0.00%,1,0,100.00%
slp2px-east-std76.oray.net,1,0.00%,1,0,100.00%
virmach.moemo.ga,1,0.00%,1,0,100.00%
lightbrokers.com.au,1,0.00%,1,0,100.00%
seeds-darwin.xycdn.com,1,0.00%,1,0,100.00%
6-courier.sandbox.push.apple.com,1,0.00%,1,0,100.00%
wp.thecreativehub.in,1,0.00%,1,0,100.00%
noiseclient5.co.uk,1,0.00%,1,0,100.00%
mail.gker.cf,1,0.00%,3,2,33.33%
wiki.oktopos.net,1,0.00%,1,0,100.00%
sni.upyun.online,1,0.00%,1,0,100.00%
WwW.VOd.LXDnS.cOM,1,0.00%,2,1,50.00%
tranSIT1.WSloG.chiNAnetcEnTER.CoM,1,0.00%,1,0,100.00%
ifu.nobelpearl.zeramex.com,1,0.00%,1,0,100.00%
mail.harndislelira.tk,1,0.00%,1,0,100.00%
e13363.dsca.akamaiedge.net,1,0.00%,2,1,50.00%
a1091.dscb.akamai.net.0.1.cn.akamaitech.net,1,0.00%,2,1,50.00%
dev.approveme.me,1,0.00%,1,0,100.00%
metrika.1site.eu,1,0.00%,1,0,100.00%
ne-vt.herokuapp.com,1,0.00%,1,0,100.00%
check.unity.cn,1,0.00%,1,0,100.00%
api.shziyi.com,1,0.00%,1,0,100.00%
popunify-large.cn-shanghai.aliyuncs.com.gds.alibabadns.com,1,0.00%,1,0,100.00%
alb-9ofbnufsm4p6a9axub.cn-hangzhou.alb.aliyuncs.com,1,0.00%,1,0,100.00%
xonecn-hotupdatecdn.shziyi.com.w.kunlunaq.com,1,0.00%,1,0,100.00%
cmscdn.shziyi.com.w.cdngslb.com,1,0.00%,1,0,100.00%
kfjesee2.herokuapp.com,1,0.00%,1,0,100.00%
824095e68a108e0d1eefe0c124c30e99.safeframe.googlesyndication.com,1,0.00%,1,0,100.00%
cloud.goblu.net,1,0.00%,1,0,100.00%
direwolf-94745fd495.herokuapp.com,1,0.00%,1,0,100.00%
manual-related-products-app.herokuapp.com,1,0.00%,1,0,100.00%
download.fileflow.nl,1,0.00%,1,0,100.00%
issuer.zadanetwork.com,1,0.00%,1,0,100.00%
nasa.level.press,1,0.00%,1,0,100.00%
mhra-vaccine-qa-1.redant.cloud,1,0.00%,1,0,100.00%
blog.bogahost.com,1,0.00%,1,0,100.00%
www.lowes.com,1,0.00%,1,0,100.00%
icebook-2021-cms-test.yazo.com.br,1,0.00%,1,0,100.00%
1610326341.D4EE073396E8.device.hiwifi.com,1,0.00%,1,0,100.00%
1610326362.D4EE073396E8.device.hiwifi.com,1,0.00%,1,0,100.00%
ebs.org.cn.v5dun.net,1,0.00%,1,0,100.00%
resolver.msg.global.xiaomi.net,1,0.00%,1,0,100.00%
service.weather.microsoft.com,1,0.00%,1,0,100.00%
qqpublic.qpic.cn,1,0.00%,1,0,100.00%
webdisk.sablehost.offnetwork.info,1,0.00%,1,0,100.00%
galerie.laurakaroline.de,1,0.00%,1,0,100.00%
t4.mshca.co,1,0.00%,1,0,100.00%
bpe17snzq2.aeer.layo.ml,1,0.00%,1,0,100.00%
cvpr2019.thecvf.com,1,0.00%,1,0,100.00%
iclr.cc,1,0.00%,1,0,100.00%
nips.cc,1,0.00%,1,0,100.00%
eu.messenger-notify.xyz,1,0.00%,1,0,100.00%
cable-prod.spaceti.co,1,0.00%,1,0,100.00%
gdjp008.desktop2244.tk,1,0.00%,1,0,100.00%
conf.huyun.cf,1,0.00%,1,0,100.00%
communityevents.td.com,1,0.00%,1,0,100.00%
hk-0020.tmseq.cf,1,0.00%,1,0,100.00%
audiomachine.cadenzabox.com,1,0.00%,1,0,100.00%
kaccessvegas.project22.cf,1,0.00%,1,0,100.00%
traveler.stcl.com.tw,1,0.00%,1,0,100.00%
mail.regular666se-blog.ga,1,0.00%,1,0,100.00%
hnizami.staging.driven.ca,1,0.00%,1,0,100.00%
sock66-ap1.pusher.com,1,0.00%,1,0,100.00%
1610326423.D4EE073396E8.device.hiwifi.com,1,0.00%,1,0,100.00%
sh.10088.ga,1,0.00%,1,0,100.00%
rtbc-ae1.doubleverify.com,1,0.00%,1,0,100.00%
ds.uncn.jp,1,0.00%,1,0,100.00%
jp-u.openx.net,1,0.00%,1,0,100.00%
sgcp-tpsc-hlb.dvgtm.akadns.net,1,0.00%,1,0,100.00%
jp03.getss.top,1,0.00%,1,0,100.00%
only-2621-159-226-95-46.nstool.321fenx.com,1,0.00%,1,0,100.00%
dfxkx81cg4hsz.cloudfront.net,1,0.00%,1,0,100.00%
tm1.edgedns-tm.info,1,0.00%,1,0,100.00%
tm2.edgedns-tm.info,1,0.00%,1,0,100.00%
resolver-nginx-redirect-lb-1267960602.us-east-1.elb.amazonaws.com,1,0.00%,1,0,100.00%
a7ca4b9223b274582916f3cfa5a7f4a2-1318326470.us-west-2.elb.amazonaws.com,1,0.00%,1,0,100.00%
status.ventraip.com.au,1,0.00%,1,0,100.00%
prclub.reportablenews.com,1,0.00%,1,0,100.00%
form.finteract.be,1,0.00%,1,0,100.00%
wWw.VOD.lxDnS.cOM,1,0.00%,2,1,50.00%
xyclient.net,1,0.00%,1,0,100.00%
r2.sn-2x3elnes.gvt1.com,1,0.00%,1,0,100.00%
mail.wisdombots.ml,1,0.00%,1,0,100.00%
d6tcollect.databolt.tech,1,0.00%,1,0,100.00%
nigelholmesmenswear.co.uk,1,0.00%,1,0,100.00%
pool-jp.zagreb.iponweb.net,1,0.00%,1,0,100.00%
bs-geo.dvgtm.akadns.net,1,0.00%,1,0,100.00%
dsum.casalemedia.com.cdn.cloudflare.net,1,0.00%,1,0,100.00%
cm-exchange.toast.com,1,0.00%,1,0,100.00%
a1363.dscg.akamai.net,1,0.00%,2,1,50.00%
huichuan-mc.sm.cn,1,0.00%,4,3,25.00%
pic.huiqudsp.com,1,0.00%,1,0,100.00%
pic.huiqudsp.com.w.kunlunca.com,1,0.00%,1,0,100.00%
adtrack.ucweb.com,1,0.00%,1,0,100.00%
na61-na62.wagbridge.advertisement.tanx.com.gds.alibabadns.com,1,0.00%,1,0,100.00%
upload.jianshu.io,1,0.00%,3,2,33.33%
s2.yylady.cn,1,0.00%,1,0,100.00%
s3m.nzwgs.com,1,0.00%,2,1,50.00%
pgdt.ugdtimg.com.sched.legopic2.tdnsv6.com,1,0.00%,1,0,100.00%
win.gdt.qq.com,1,0.00%,1,0,100.00%
cm.cn.miaozhen.com,1,0.00%,1,0,100.00%
webdav.aliwap.cf,1,0.00%,1,0,100.00%
1610071461.D4EE073C2A20.device.hiwifi.com,1,0.00%,1,0,100.00%
taobao.yzjorc.ml,1,0.00%,1,0,100.00%
anydo-analytics.herokuapp.com,1,0.00%,1,0,100.00%
pizzaboutique.co.uk,1,0.00%,1,0,100.00%
api.tools.unlayer.com,1,0.00%,1,0,100.00%
mail.brandmasters.law,1,0.00%,1,0,100.00%
holmeshelp.uc.cn,1,0.00%,1,0,100.00%
uc.ucweb.com,1,0.00%,1,0,100.00%
openacs4uc.m.taobao.com,1,0.00%,1,0,100.00%
navigis.uc.cn,1,0.00%,1,0,100.00%
ucus.ucweb.com,1,0.00%,1,0,100.00%
uae-2.foxy.bjyz.uc.cn,1,0.00%,1,0,100.00%
ff.dayu.com,1,0.00%,1,0,100.00%
pis.alicdn.com,1,0.00%,1,0,100.00%
pis.alicdn.com.gds.alibabadns.com,1,0.00%,1,0,100.00%
pdds-pn-cdn.uc.cn,1,0.00%,1,0,100.00%
inside-gateway.alipay.com,1,0.00%,1,0,100.00%
vs16.bj2ct.u3.ucweb.com,1,0.00%,1,0,100.00%
s-adashx4yt.ut.hzshudian.com,1,0.00%,1,0,100.00%
als.e.shifen.com,1,0.00%,1,0,100.00%
supermobilev1.jomodns.com,1,0.00%,1,0,100.00%
m.ykimg.com.w.cdngslb.com,1,0.00%,4,3,25.00%
track.uc.cn,1,0.00%,1,0,100.00%
vali.cp31.ott.cibntv.net,1,0.00%,1,0,100.00%
safe.ucdns.uc.cn,1,0.00%,1,0,100.00%
vali.cp31.ott.cibntv.net.w.kunlunar.com,1,0.00%,1,0,100.00%
image.uc.cn.w.alikunlun.com,1,0.00%,2,1,50.00%
orange-ack.alibaba.com,1,0.00%,1,0,100.00%
cdn.sm.cn,1,0.00%,2,1,50.00%
image-ad.sm.cn,1,0.00%,2,1,50.00%
so-h3-v1.sm.cn,1,0.00%,1,0,100.00%
sv.bdstatic.com,1,0.00%,1,0,100.00%
redaksi.duta.co,1,0.00%,1,0,100.00%
tryout.sonicgarden.world,1,0.00%,1,0,100.00%
intf1.zsall.mobilem.360.cn,1,0.00%,1,0,100.00%
kiendl.dev.creattic.de,1,0.00%,1,0,100.00%
mail.wavecomputing.xyz,1,0.00%,1,0,100.00%
i-dsm04p-cor002.api.p001.1drv.com,1,0.00%,1,0,100.00%
note.thereandhere.tk,1,0.00%,1,0,100.00%
tw17.twmyhome.com,1,0.00%,1,0,100.00%
i-sat02p-cor004.api.p001.1drv.com,1,0.00%,1,0,100.00%
bahamasrealty.luxuryrealestate.com,1,0.00%,1,0,100.00%
go.gunicom.ml,1,0.00%,1,0,100.00%
prediovilla-sw001.website.smartoo.pandevstudio.com,1,0.00%,1,0,100.00%
p43-caldav.icloud.com,1,0.00%,2,1,50.00%
x.spac.me,1,0.00%,1,0,100.00%
tripod.westfly.ml,1,0.00%,1,0,100.00%
d8fajseshwsed.cloudfront.net,1,0.00%,1,0,100.00%
log.ireader.com,1,0.00%,2,1,50.00%
cdn-mum.alibabachengdun.com,1,0.00%,2,1,50.00%
b158.s372.meetrics.net,1,0.00%,1,0,100.00%
smtp.geves.fr,1,0.00%,1,0,100.00%
desktop-bnp-pf-img.app.captaindash.com,1,0.00%,1,0,100.00%
ssc.sicat.com,1,0.00%,1,0,100.00%
qqsoimgcache.gtimg.cn,1,0.00%,2,1,50.00%
f-up.vivo.com.cn,1,0.00%,1,0,100.00%
aivr.ariua.tk,1,0.00%,1,0,100.00%
801ivc6o9h5ywdk9.aliyunddos1009.com,1,0.00%,1,0,100.00%
tin.gdnsec.com,1,0.00%,1,0,100.00%
ns4.gdnsec.com,1,0.00%,1,0,100.00%
api.evazf.tk,1,0.00%,2,1,50.00%
a5.centaur.network,1,0.00%,1,0,100.00%
atosbjjbrisbane.kicksite.net,1,0.00%,1,0,100.00%
Www.voD.lxDNs.coM,1,0.00%,2,1,50.00%
wWw.Vod.lxdns.COM,1,0.00%,2,1,50.00%
51.ltlsxkdar8c.tk,1,0.00%,1,0,100.00%
site-34975534882.helphub.io,1,0.00%,1,0,100.00%
st-dashboard.byslam.com,1,0.00%,1,0,100.00%
staging.admin.pi.club,1,0.00%,1,0,100.00%
mpaas-loggw4zwy.aliyuncs.com,1,0.00%,1,0,100.00%
adalliance.zmeng123.com,1,0.00%,1,0,100.00%
e3396.ca2.s.tl88.net,1,0.00%,1,0,100.00%
redhat.sc.omtrdc.net,1,0.00%,1,0,100.00%
trs.teamrampage.net,1,0.00%,1,0,100.00%
kintone-cafe-gifu.doorkeeper.jp,1,0.00%,1,0,100.00%
mln.com.ua,1,0.00%,1,0,100.00%
austinweather.start4all.com,1,0.00%,1,0,100.00%
dynamic.adcrowd.com,1,0.00%,1,0,100.00%
a.videoreach.com,1,0.00%,1,0,100.00%
api.linktexting.com,1,0.00%,1,0,100.00%
p6-webcast.douyinpic.com,1,0.00%,2,1,50.00%
mail.rankerweb103.cf,1,0.00%,1,0,100.00%
blog.dilady.com.br,1,0.00%,1,0,100.00%
r2.sn-2x3elnez.gvt1.com,1,0.00%,1,0,100.00%
online-md.co.uk,1,0.00%,1,0,100.00%
tutul.logdown.com,1,0.00%,1,0,100.00%
webdisk.corsifad.org,1,0.00%,1,0,100.00%
hr12.graniterapids.com,1,0.00%,1,0,100.00%
file.ihealthcoming.com,1,0.00%,2,1,50.00%
data.zhibo8.cc,1,0.00%,1,0,100.00%
static.duoduocdn.com,1,0.00%,1,0,100.00%
dingshi4pc.qiumibao.com,1,0.00%,1,0,100.00%
bifen4pc2.qiumibao.com,1,0.00%,1,0,100.00%
dan.zhibo8.cc,1,0.00%,1,0,100.00%
dc4pc.qiumibao.com,1,0.00%,1,0,100.00%
status.nws.netways.de,1,0.00%,1,0,100.00%
fdttrh.b43shuang.ga,1,0.00%,1,0,100.00%
youkneadamassage.offeringtree.com,1,0.00%,1,0,100.00%
download.cdn.proxmox.com,1,0.00%,4,3,25.00%
enterprise.cdn.proxmox.com,1,0.00%,3,2,33.33%
test.nuwarobotics.com,1,0.00%,1,0,100.00%
morning-haze-52.versacommerce.de,1,0.00%,1,0,100.00%
oracle.renxh.ml,1,0.00%,1,0,100.00%
live.douyin.com,1,0.00%,1,0,100.00%
dowr580i1gdmf.cloudfront.net,1,0.00%,1,0,100.00%
wwW.vOd.LXDnS.COM,1,0.00%,2,1,50.00%
intranet.primacura.nl,1,0.00%,1,0,100.00%
mail.healanitonisu.ml,1,0.00%,1,0,100.00%
analysis.51family.com.cn,1,0.00%,1,0,100.00%
mail.seobatch120.gq,1,0.00%,1,0,100.00%
gruppomade.skillsincloud.com,1,0.00%,1,0,100.00%
community1.badabusiness.com,1,0.00%,1,0,100.00%
wtw2.avpn.cc,1,0.00%,1,0,100.00%
dmm-game-got33.gdsrx888.com,1,0.00%,1,0,100.00%
mail.tiponvabude.tk,1,0.00%,1,0,100.00%
mail.top-levelsite4.cf,1,0.00%,1,0,100.00%
39.push2.eastmoney.com,1,0.00%,1,0,100.00%
track-abler-com-br.prospectrck.com,1,0.00%,1,0,100.00%
cogesaf.qc.ca,1,0.00%,1,0,100.00%
tyjr-common-cn-hangzhou.aliyun.com,1,0.00%,1,0,100.00%
pubminishare-30161.picsz.qpic.cn,1,0.00%,1,0,100.00%
efile101.hpccube.com,1,0.00%,1,0,100.00%
cdn1.1800flowers.com,1,0.00%,1,0,100.00%
mail.fundacaofamiliacristadeuseconosco.tk,1,0.00%,1,0,100.00%
stanford-jblp.pubpub.org,1,0.00%,1,0,100.00%
vezk.decades-courts.org,1,0.00%,1,0,100.00%
bs9sscg0.myraidbox.de,1,0.00%,1,0,100.00%
tpl.mmcdn.de,1,0.00%,1,0,100.00%
1608241907.D4EE071FA772.device.hiwifi.com,1,0.00%,1,0,100.00%
pauldebevec.herokuapp.com,1,0.00%,1,0,100.00%
plfz.herokuapp.com,1,0.00%,1,0,100.00%
webmail.padikkattugal.org,1,0.00%,1,0,100.00%
online.equipe.com,1,0.00%,1,0,100.00%
slp2p-east-std08.oray.net,1,0.00%,1,0,100.00%
staging.steamer10theatre.org,1,0.00%,1,0,100.00%
mail.ersitaronseagy.ml,1,0.00%,1,0,100.00%
api.elisiapp.com,1,0.00%,1,0,100.00%
iberdrola.optimization.energy,1,0.00%,1,0,100.00%
mail.4mcollision.net,1,0.00%,1,0,100.00%
apd-ea13c8ce204dc33c62ff24dfdf98e98a.v.smtcdns.com,1,0.00%,1,0,100.00%
44.ucp-ntfy.kaspersky-labs.com,1,0.00%,1,0,100.00%
slp2p-east-std1021.oray.net,1,0.00%,1,0,100.00%
fortifiedsafe.com,1,0.00%,1,0,100.00%
www.bluescope.com,1,0.00%,1,0,100.00%
d3mzlbmn9ukddk.cloudfront.net,1,0.00%,1,0,100.00%
pop.wo.cn,1,0.00%,2,1,50.00%
s0-static.jjwxc.net,1,0.00%,2,1,50.00%
twct06.graniterapids.com,1,0.00%,1,0,100.00%
merckgroup.buyitfast.co,1,0.00%,1,0,100.00%
mail.mickiespub.com,1,0.00%,1,0,100.00%
cs.arek-home.de,1,0.00%,1,0,100.00%
a2plvcpnl160945.prod.iad2.secureserver.net,1,0.00%,1,0,100.00%
app.birb.app,1,0.00%,1,0,100.00%
anaxqdeughyp.enw.systems,1,0.00%,1,0,100.00%
kprfnsk.ruv.su,1,0.00%,1,0,100.00%
bonmercato.makaira.cloud,1,0.00%,1,0,100.00%
smtp1.dubailand.gov.ae,1,0.00%,1,0,100.00%
zhaoanqi.herokuapp.com,1,0.00%,1,0,100.00%
api.scinan.com,1,0.00%,1,0,100.00%
aoesqkmryznx.falconiers.com,1,0.00%,1,0,100.00%
ss.autolycos.cf,1,0.00%,1,0,100.00%
qpbv1oqr6kquv45lffdskk7cj6ka9srnm22vssc4aqcm404can8fvnt9.qc.x.bsgslb.cn,1,0.00%,1,0,100.00%
60.push2.eastmoney.com,1,0.00%,1,0,100.00%
wwW.vod.LXDnS.Com,1,0.00%,2,1,50.00%
WwW.Vod.lxDNS.COm,1,0.00%,2,1,50.00%
adrianbulat.com,1,0.00%,1,0,100.00%
p.bixinlive.com.wswebpic.com,1,0.00%,1,0,100.00%
firearmsuniversity.com,1,0.00%,1,0,100.00%
global.cdn-b.996dns.com,1,0.00%,1,0,100.00%
www.dushe.net,1,0.00%,1,0,100.00%
omanhua.com,1,0.00%,1,0,100.00%
gtm-cn-6ja22i7nm0h.gtm-a4b8.com,1,0.00%,1,0,100.00%
mail.kaviaztech.com,1,0.00%,1,0,100.00%
fhvgaujz.masiruju.cz,1,0.00%,1,0,100.00%
cosmos.marfeel.com,1,0.00%,1,0,100.00%
eu1-ds-iam.3dexperience.3ds.com,1,0.00%,1,0,100.00%
dragonlam39.direct.quickconnect.to,1,0.00%,1,0,100.00%
adana.nebula.to,1,0.00%,1,0,100.00%
shuttletx.ridebitsapp.com,1,0.00%,1,0,100.00%
1608234687.D4EE071FA772.device.hiwifi.com,1,0.00%,1,0,100.00%
k-explorer.herokuapp.com,1,0.00%,1,0,100.00%
wwW.SlAShdoT.Org,1,0.00%,1,0,100.00%
wwW.mIt.eDu,1,0.00%,1,0,100.00%
direwolf-242f8be4a7.herokuapp.com,1,0.00%,1,0,100.00%
earlyaccess.routined.life,1,0.00%,1,0,100.00%
www.rengshu.com,1,0.00%,1,0,100.00%
chaxin.las.ac.cn,1,0.00%,1,0,100.00%
www.oscca.gov.cn,1,0.00%,1,0,100.00%
TrACkeR.leeCheRS-PARADIse.oRG,1,0.00%,1,0,100.00%
c21d2dd891bfc6be1b8368629b6648b2.dlied1.cdntips.net,1,0.00%,1,0,100.00%
www.jiaoyangsiwo.cn,1,0.00%,1,0,100.00%
alb-aq3hqwp9xd7wbzmjp4.cn-hangzhou.alb.aliyuncs.com,1,0.00%,1,0,100.00%
jitae-sefrehkwc.vakd.tk,1,0.00%,1,0,100.00%
staging.illust.space,1,0.00%,1,0,100.00%
linux.oracle.com,1,0.00%,2,1,50.00%
cdn.amazonlinux.com,1,0.00%,2,1,50.00%
git.launchpad.net,1,0.00%,1,0,100.00%
hk-tr-1.cats22.net,1,0.00%,1,0,100.00%
signal.twilio.com,1,0.00%,1,0,100.00%
shop.gutrad.com,1,0.00%,1,0,100.00%
sbox.rmegold.com,1,0.00%,1,0,100.00%
apd-94e1d2579b3fc50ffef999289b8b839c.v.smtcdns.com,1,0.00%,1,0,100.00%
slp2p-east-std01.oray.net,1,0.00%,1,0,100.00%
reg.wnevc.com,1,0.00%,1,0,100.00%
ur.alipay.com,1,0.00%,2,1,50.00%
www.nbd.com.cn,1,0.00%,2,1,50.00%
zh-v2.d2l.ai,1,0.00%,1,0,100.00%
j.6sc.co,1,0.00%,1,0,100.00%
dev.visualwebsiteoptimizer.com,1,0.00%,1,0,100.00%
c.6sc.co,1,0.00%,1,0,100.00%
156-ofn-742.mktoresp.com,1,0.00%,1,0,100.00%
d2l.ai,1,0.00%,1,0,100.00%
courses.d2l.ai,1,0.00%,1,0,100.00%
discuss.d2l.ai,1,0.00%,1,0,100.00%
apps.azhelp.ru,1,0.00%,1,0,100.00%
mail.workfar.cf,1,0.00%,1,0,100.00%
napaluxury.luxuryrealestate.com,1,0.00%,1,0,100.00%
rc-onedrive-e5.herokuapp.com,1,0.00%,1,0,100.00%
1610064225.D4EE073C2A20.device.hiwifi.com,1,0.00%,1,0,100.00%
1610064246.D4EE073C2A20.device.hiwifi.com,1,0.00%,1,0,100.00%
1610064312.D4EE073C2A20.device.hiwifi.com,1,0.00%,1,0,100.00%
mail.julekalender.com,1,0.00%,1,0,100.00%
dell,1,0.00%,1,0,100.00%
blog.colibricafe.space,1,0.00%,1,0,100.00%
ha-ae.mail.protection.outlook.com,1,0.00%,1,0,100.00%
apd-8b033c710e254b42bdc16e7a111f83d1.v.smtcdns.com,1,0.00%,1,0,100.00%
apd-ed2b4e61e9f495f144309ba14c88dc43.v.smtcdns.com,1,0.00%,1,0,100.00%
pwapp.ct.glbs.qunar.com,1,0.00%,1,0,100.00%
caproxy.video.weibocdn.com,1,0.00%,1,0,100.00%
www.hpccube.com,1,0.00%,1,0,100.00%
regtool.homeway.com.cn,1,0.00%,1,0,100.00%
m.mohotel.tk,1,0.00%,1,0,100.00%
produtos.cm-santiagocacem.pt,1,0.00%,1,0,100.00%
superfree8.dev8.lmscheckoutdev.com,1,0.00%,1,0,100.00%
ph.hessischer-jobanzeiger.de,1,0.00%,1,0,100.00%
atbrangus.a3de.info,1,0.00%,1,0,100.00%
dev.signstream.net,1,0.00%,1,0,100.00%
zf.fcyyyds.cf,1,0.00%,1,0,100.00%
home.hacamer.ml,1,0.00%,1,0,100.00%
app.codemonkey.com,1,0.00%,1,0,100.00%
quark-h3-v1.upaas.uc.cn,1,0.00%,1,0,100.00%
vt.quark.cn,1,0.00%,1,0,100.00%
cq.news.cn,1,0.00%,1,0,100.00%
h.xinhuaxmt.com,1,0.00%,2,1,50.00%
wap.peopleapp.com,1,0.00%,2,1,50.00%
tj.sosomp.com,1,0.00%,1,0,100.00%
gateway.webofknowledge.com,1,0.00%,1,0,100.00%
ins-b5e690jq.ias.tencent-cloud.net,1,0.00%,1,0,100.00%
ins-q3j233s1.ias.tencent-cloud.net,1,0.00%,1,0,100.00%
ec2-174-129-43-152.compute-1.amazonaws.com,1,0.00%,1,0,100.00%
pic.upqzfile.com,1,0.00%,1,0,100.00%
mobilelog.upqzfile.com,1,0.00%,1,0,100.00%
only-403822-159-226-95-33.nstool.laiqukankan.com,1,0.00%,1,0,100.00%
iadmusicmat.music.126.net,1,0.00%,2,1,50.00%
iadmusicmat.music.126.net.w.alikunlun.com,1,0.00%,2,1,50.00%
mon3-misc-lf.fqnovel.com,1,0.00%,2,1,50.00%
v2oracle.catv2.cf,1,0.00%,1,0,100.00%
random.osu.bet,1,0.00%,1,0,100.00%
w3.lopon.org.tw,1,0.00%,1,0,100.00%
rc10.oray.com,1,0.00%,1,0,100.00%
only-887312-159-226-95-47.nstool.zhuanzfx.com,1,0.00%,1,0,100.00%
5e5ccc262d4ba94a5579e843c0f7ef33.safeframe.googlesyndication.com,1,0.00%,1,0,100.00%
test-ic.ks3-cn-beijing.ksyun.com,1,0.00%,1,0,100.00%
CLIENTLOGVoDP2p.HaPlAT.NET,1,0.00%,1,0,100.00%
tRANSIT1.wslog.CHINANetcenTEr.COm,1,0.00%,1,0,100.00%
mamBaP2pvOdh5.8686c.cOM,1,0.00%,1,0,100.00%
dev.trumptaxsecrets.com,1,0.00%,1,0,100.00%
scan-13.shadowserver.org,1,0.00%,1,0,100.00%
kddi.iggfastweb.com,1,0.00%,1,0,100.00%
newyork.edgehelper.com,1,0.00%,1,0,100.00%
analytics.mpay.netease.com,1,0.00%,1,0,100.00%
cdn-go.cn.cloud.tc.qq.com,1,0.00%,1,0,100.00%
top.n.shifen.com,1,0.00%,1,0,100.00%
js.aq.tc.qq.com,1,0.00%,1,0,100.00%
js.aq.tcdn.qq.com,1,0.00%,1,0,100.00%
x2.tc.qq.com,1,0.00%,1,0,100.00%
ac.mmstat.com,1,0.00%,1,0,100.00%
cn.gravatar.com,1,0.00%,4,3,25.00%
api-edge.apps.apple.com,1,0.00%,1,0,100.00%
safebrowsing.g.aaplimg.com,1,0.00%,1,0,100.00%
init.gc.apple.com,1,0.00%,1,0,100.00%
init.gc-lb.apple.com.akadns.net,1,0.00%,1,0,100.00%
p217-contacts.icloud.com.cn,1,0.00%,1,0,100.00%
app-api.smzdm.com,1,0.00%,1,0,100.00%
shence-import.smzdm.com,1,0.00%,1,0,100.00%
df8c27174cb94c43.vip.jiasule.org,1,0.00%,1,0,100.00%
analytics-api.smzdm.com,1,0.00%,1,0,100.00%
1e180234072b3376.vip.jiasule.org,1,0.00%,1,0,100.00%
wework.qpic.cn.sched.legopic1-dk.tdnsv6.com,1,0.00%,4,3,25.00%
ad-static-xg.tagtic.cn.a.bdydns.com,1,0.00%,1,0,100.00%
app-site-association.cdn-apple.com.akadns.net,1,0.00%,1,0,100.00%
i1.yomuzu.com.w.kunlunpi.com,1,0.00%,1,0,100.00%
sal.topgslb.com,1,0.00%,1,0,100.00%
www.360kan.com.wsglb0.com,1,0.00%,1,0,100.00%
p6.qhimg.com.webcdn.360qhcdn.com,1,0.00%,2,1,50.00%
p0.ssl.qhimg.com.webcdn.360qhcdn.com,1,0.00%,2,1,50.00%
p.s.360kan.com,1,0.00%,1,0,100.00%
img.email1.sketchfab.com,1,0.00%,1,0,100.00%
dg5bepmjyhz9h.cloudfront.net,1,0.00%,1,0,100.00%
d1jlf623bx36qa.cloudfront.net,1,0.00%,1,0,100.00%
ms.blibee.com,1,0.00%,1,0,100.00%
web.vip.bianlifeng.com,1,0.00%,1,0,100.00%
s.blibee.net.trpcdn.net,1,0.00%,1,0,100.00%
core-web.vip.bianlifeng.com,1,0.00%,1,0,100.00%
zz.blibee.com,1,0.00%,1,0,100.00%
collect-vgs.mbgcdn.lenovo.com.cn,1,0.00%,1,0,100.00%
xcx.cnii.com.cn,1,0.00%,1,0,100.00%
e6987.dsce9.akamaiedge.net,1,0.00%,2,1,50.00%
everbrightplus1.direct.quickconnect.to,1,0.00%,1,0,100.00%
media.dantty.com,1,0.00%,1,0,100.00%
identity.actionstation.org.nz,1,0.00%,1,0,100.00%
custom-domain-1.pubpub.org.herokudns.com,1,0.00%,1,0,100.00%
a1988.dscg1.akamai.net,1,0.00%,2,1,50.00%
a1874.dscg1.akamai.net,1,0.00%,2,1,50.00%
d38au5kn48shwv.cloudfront.net,1,0.00%,1,0,100.00%
ydlunacommon-cdn.nosdn.127.net.163jiasu.com,1,0.00%,2,1,50.00%
ydlunacommon-cdn.nosdn.127.net.w.cdngslb.com,1,0.00%,2,1,50.00%
blob.bnz14prdstr09a.store.core.windows.net,1,0.00%,1,0,100.00%
www.mozorg.moz.works,1,0.00%,1,0,100.00%
login.tim.qq.com,1,0.00%,1,0,100.00%
os-config.appstore.vivo.com.cn,1,0.00%,1,0,100.00%
kernelapi.vivo.com.cn,1,0.00%,1,0,100.00%
m.iekegu.ga,1,0.00%,1,0,100.00%
fuss10.elemecdn.com,1,0.00%,1,0,100.00%
sunyisalina.classic.kicksite.net,1,0.00%,1,0,100.00%
ad35c47783db42cc56324f520747e157.safeframe.googlesyndication.com,1,0.00%,1,0,100.00%
project.painting.ml,1,0.00%,1,0,100.00%
download.lenovo.com,1,0.00%,1,0,100.00%
pc-store-lb.mbgstore.lenovo.com.cn,1,0.00%,1,0,100.00%
down.qq.com.tcdn.qq.com,1,0.00%,1,0,100.00%
sketchfab.discoursehosting.net,1,0.00%,1,0,100.00%
apd-dab9ae12dbdc8420779f283f9f3d368b.v.smtcdns.com,1,0.00%,1,0,100.00%
faye-public-elb-us-east-4054519.us-east-1.elb.amazonaws.com,1,0.00%,1,0,100.00%
ak-gs-gf.hypergryph.com,1,0.00%,1,0,100.00%
cloud.tim.qq.com,1,0.00%,1,0,100.00%
miniapp-package-zcache.taobao.com.w.cdngslb.com,1,0.00%,2,1,50.00%
open.taou.com,1,0.00%,1,0,100.00%
au.download.windowsupdate.com.c.footprint.net,1,0.00%,2,1,50.00%
pds-prod.v.aaplimg.com,1,0.00%,1,0,100.00%
ins-xloy0tw9.ias.tencent-cloud.net,1,0.00%,1,0,100.00%
ins-hqt8xhm4.ias.tencent-cloud.net,1,0.00%,1,0,100.00%
b-9999.b-msedge.net,1,0.00%,1,0,100.00%
cacm.acm.org,1,0.00%,1,0,100.00%
www.theregister.com,1,0.00%,1,0,100.00%
nir.theregister.co.uk,1,0.00%,1,0,100.00%
map0.ssl.qhimg.com,1,0.00%,2,1,50.00%
wenda.so.com,1,0.00%,1,0,100.00%
map4.ssl.qhimg.com,1,0.00%,2,1,50.00%
map1.ssl.qhimg.com,1,0.00%,2,1,50.00%
map2.ssl.qhimg.com,1,0.00%,1,0,100.00%
www.wuxia.net.cn,1,0.00%,1,0,100.00%
c.gtld.biz,1,0.00%,1,0,100.00%
block-chain.herokuapp.com,1,0.00%,1,0,100.00%
form.mortelmans.be,1,0.00%,1,0,100.00%
finlays.safi.ai,1,0.00%,1,0,100.00%
mail.chantuhijulis.tk,1,0.00%,1,0,100.00%
inigo-bujedo-aguirre.divisare.pro,1,0.00%,1,0,100.00%
adservice.google.com.tw,1,0.00%,2,1,50.00%
hudong.alicdn.com,1,0.00%,2,1,50.00%
hiring.talntcast.io,1,0.00%,1,0,100.00%
me.qlihub.tk,1,0.00%,1,0,100.00%
pipzyrikeopr.phone-delivery.com,1,0.00%,1,0,100.00%
host.effect-marketing.de,1,0.00%,1,0,100.00%
dash-1.indexer.coinomi.net,1,0.00%,1,0,100.00%
ip-23-229-189-134.ip.secureserver.net,1,0.00%,1,0,100.00%
open.ryc106.com,1,0.00%,1,0,100.00%
idata.game.qq.com,1,0.00%,1,0,100.00%
a75d7d6fb9c038e9315b3faf38dcb655.dlied1.cdntips.net,1,0.00%,1,0,100.00%
trace.tgp.qq.com,1,0.00%,1,0,100.00%
a4590d019f463cfef6a69d74d8f22e74.dlied1.cdntips.net,1,0.00%,1,0,100.00%
ts9.qq.com,1,0.00%,1,0,100.00%
eau04-breeziest-in.cloudapp.net,1,0.00%,1,0,100.00%
opencdnbaidumap.jomodns.com,1,0.00%,2,1,50.00%
www.zgcbank.com,1,0.00%,2,1,50.00%
ip-107-180-102-65.ip.secureserver.net,1,0.00%,1,0,100.00%
goagpczbfonuynkw.masiruju.cz,1,0.00%,1,0,100.00%
go.theregister.com,1,0.00%,1,0,100.00%
8.dl.delivery.microsoft.com.mwcname.com,1,0.00%,2,1,50.00%
opencdnnavideo.jomodns.com,1,0.00%,2,1,50.00%
ec2-13-244-76-168.af-south-1.compute.amazonaws.com,1,0.00%,1,0,100.00%
machine.cmp-gaming.com,1,0.00%,1,0,100.00%
ks1.kerbertools.xyz,1,0.00%,1,0,100.00%
gimg1.baidu.com,1,0.00%,2,1,50.00%
gimg1.baidu.com.a.bdydns.com,1,0.00%,2,1,50.00%
mbdcdn.bdstatic.com.a.bdydns.com,1,0.00%,2,1,50.00%
www.taobao.com.danuoyi.tbcache.com,1,0.00%,2,1,50.00%
locini.gslb.360safe.com,1,0.00%,1,0,100.00%
apd-a3397887814a21b35222c124a12e4449.v.smtcdns.com,1,0.00%,1,0,100.00%
weather-map.apple.com,1,0.00%,2,1,50.00%
h-api.jielong.co,1,0.00%,1,0,100.00%
i.jielong.co,1,0.00%,1,0,100.00%
1610067836.D4EE073C2A20.device.hiwifi.com,1,0.00%,1,0,100.00%
wWw.vOD.LxdNS.COm,1,0.00%,2,1,50.00%
code.devinterface.com,1,0.00%,1,0,100.00%
1610067877.D4EE073C2A20.device.hiwifi.com,1,0.00%,1,0,100.00%
1610067898.D4EE073C2A20.device.hiwifi.com,1,0.00%,1,0,100.00%
mandibhav.ekisan.net,1,0.00%,1,0,100.00%
dealer-acceptatie.am-i.nl,1,0.00%,1,0,100.00%
tw1v.acrossgw.info,1,0.00%,1,0,100.00%
km.s1seven.ovh,1,0.00%,1,0,100.00%
integrationspreprod.tulka.com,1,0.00%,1,0,100.00%
mail21.dot.gov.ae,1,0.00%,1,0,100.00%
mail22.dot.gov.ae,1,0.00%,1,0,100.00%
2129796.luxuryrealestate.com,1,0.00%,1,0,100.00%
1610057026.D4EE073C2A20.device.hiwifi.com,1,0.00%,1,0,100.00%
1610057052.D4EE073C2A20.device.hiwifi.com,1,0.00%,1,0,100.00%
1610057078.D4EE073C2A20.device.hiwifi.com,1,0.00%,1,0,100.00%
pendo-static-5721633846329344.storage.googleapis.com,1,0.00%,2,1,50.00%
velti.com.br,1,0.00%,1,0,100.00%
wangziyulechenghuiyuanzhuce.herokuapp.com,1,0.00%,1,0,100.00%
direwolf-fd29b31361.herokuapp.com,1,0.00%,1,0,100.00%
plat.tgp.qq.com,1,0.00%,1,0,100.00%
beaconcdn.qq.com,1,0.00%,1,0,100.00%
tgp.ied-tqos-s.qq.com,1,0.00%,1,0,100.00%
ied-tqosweb.qq.com,1,0.00%,1,0,100.00%
match.game.qq.com,1,0.00%,1,0,100.00%
apps7.game.qq.com,1,0.00%,1,0,100.00%
welive.qq.com,1,0.00%,1,0,100.00%
322fbb17aa371817ba7415b59f5ecea9.dlied1.cdntips.net,1,0.00%,1,0,100.00%
c899c7833ab4ad6b535833a9bca6858d.dlied1.cdntips.net,1,0.00%,1,0,100.00%
live-cover.msstatic.com,1,0.00%,2,1,50.00%
cgi.datamore.qq.com,1,0.00%,1,0,100.00%
hardware.tgp.qq.com,1,0.00%,1,0,100.00%
login.game.qq.com,1,0.00%,2,1,50.00%
ts8.qq.com,1,0.00%,1,0,100.00%
9jxvmf8y7ujfl8hppt35mhqud9gbndab.yundunwaf1.com,1,0.00%,1,0,100.00%
api.fqtodo.cn,1,0.00%,1,0,100.00%
f5ie8y7l.dayugslb.com,1,0.00%,1,0,100.00%
certs.apple.com.download.ks-cdn.com,1,0.00%,2,1,50.00%
gspe79-ssl.ls.apple.com.edgesuite.net,1,0.00%,2,1,50.00%
bookkeeper.itunes.apple.com,1,0.00%,2,1,50.00%
bookkeeper-cdn.itunes-apple.com.akadns.net,1,0.00%,2,1,50.00%
books-analytics-events.news.apple-dns.net,1,0.00%,1,0,100.00%
cdn.yuque.com,1,0.00%,1,0,100.00%
cdn.nlark.com.w.alikunlun.com,1,0.00%,1,0,100.00%
cdn-pri.nlark.com.w.alikunlun.com,1,0.00%,1,0,100.00%
mdap.yuque.com,1,0.00%,1,0,100.00%
crystalapp.miguvideo.com,1,0.00%,2,1,50.00%
iduwdjf.qiniudns.com,1,0.00%,2,1,50.00%
chinaweb172.china.line.qiniudns.com,1,0.00%,2,1,50.00%
mms-static.cdn.bcebos.com,1,0.00%,3,2,33.33%
d500.userdrive.me,1,0.00%,1,0,100.00%
secure.123sheets.com,1,0.00%,1,0,100.00%
analytics.vmn.net,1,0.00%,1,0,100.00%
hwdsb.staging.boreal321.com,1,0.00%,1,0,100.00%
1608223795.D4EE071FA772.device.hiwifi.com,1,0.00%,1,0,100.00%
kingmarcel.stores-mobilosoft.be,1,0.00%,1,0,100.00%
rptdata.wb.qq.com,1,0.00%,1,0,100.00%
xgc.luoyingzhi.ga,1,0.00%,1,0,100.00%
jpushsc.m.jd.com.gslb.qianxun.com,1,0.00%,1,0,100.00%
connectivitycheck.platform.dbankcloud.com,1,0.00%,2,1,50.00%
connectivitycheck.platform.dbankcloud.com.80800000.c.cdnhwc1.com,1,0.00%,2,1,50.00%
connect-drcn-hispace-hicloud-com-drcn.appacc-region.dbankedge.cn,1,0.00%,1,0,100.00%
browserr-drcn.dbankcdn.cn.cdn.dnsv1.com,1,0.00%,2,1,50.00%
os5emd6b.sched.sma-dk.tdnsstic1.cn,1,0.00%,2,1,50.00%
psstatic.cdn.bcebos.com.a.bdydns.com,1,0.00%,2,1,50.00%
mms-static.cdn.bcebos.com.a.bdydns.com,1,0.00%,2,1,50.00%
in.hes.trendmicro.eu,1,0.00%,1,0,100.00%
jdpull.jd.com,1,0.00%,2,1,50.00%
jdpull.jd.com.gslb.qianxun.com,1,0.00%,2,1,50.00%
jdpull.jd.com.live-play.galileo.jcloud-cdn.com,1,0.00%,2,1,50.00%
jdpull.jd.com.wscdns.com,1,0.00%,2,1,50.00%
img10.360buyimg.com.volcgslb.com,1,0.00%,2,1,50.00%
img30.360buyimg.com.gslb.qianxun.com,1,0.00%,2,1,50.00%
img30.360buyimg.com.s.galileo.jcloud-cdn.com,1,0.00%,2,1,50.00%
logu.hpplay.cn,1,0.00%,1,0,100.00%
conf.hpplay.cn,1,0.00%,1,0,100.00%
rp.hpplay.cn,1,0.00%,1,0,100.00%
card-all.dpool.sina.com.cn,1,0.00%,1,0,100.00%
codingdict.com,1,0.00%,1,0,100.00%
ams-mvp.trafficmanager.net,1,0.00%,2,1,50.00%
bigsoul.biz,1,0.00%,1,0,100.00%
assets.privacytollfree.com,1,0.00%,1,0,100.00%
api.canary.mydomastudio.com,1,0.00%,1,0,100.00%
1610333542.D4EE073396E8.device.hiwifi.com,1,0.00%,1,0,100.00%
1610333567.D4EE073396E8.device.hiwifi.com,1,0.00%,1,0,100.00%
1610333588.D4EE073396E8.device.hiwifi.com,1,0.00%,1,0,100.00%
e2cs54.gcp.gvt2.com,1,0.00%,1,0,100.00%
xjpd.wytf.fun,1,0.00%,1,0,100.00%
aecebpny5shcpj4v.node.ppio.cloud,1,0.00%,1,0,100.00%
only-346168-159-226-95-71.nstool.321fenx.com,1,0.00%,1,0,100.00%
mail.seobacklinks14.ga,1,0.00%,1,0,100.00%
dkk.esschertdesign.com,1,0.00%,1,0,100.00%
jp.p2006315.tk,1,0.00%,1,0,100.00%
sparkcloud-husk-sariswa.sparkmeter.cloud,1,0.00%,1,0,100.00%
wWW.VOD.LXDnS.COm,1,0.00%,2,1,50.00%
e2c37.gcp.gvt2.com,1,0.00%,1,0,100.00%
portal.lindseyforwarders.com,1,0.00%,1,0,100.00%
mention.fly.criticism.ml,1,0.00%,1,0,100.00%
api5.zhipin.com,1,0.00%,1,0,100.00%
vc-brain.snssdk.com,1,0.00%,1,0,100.00%
lf9-cj-cdn-tos.bytegecko.com,1,0.00%,2,1,50.00%
lf9-webcast-cdn-tos.bytegecko.com,1,0.00%,2,1,50.00%
nigv7f7o3k2a36jltmvi42eukeutuu6c8f2u5poaoit0n9rhsquvvgv3.tt.x.bsgslb.cn,1,0.00%,1,0,100.00%
g2k4na4javheuri9ij1bjamqpfunk6adkf1lonov0adueiio2q1fv1om.tt.x.bsgslb.cn,1,0.00%,1,0,100.00%
kr6kjsabjebi2ldfucn799pg1s3cq35o26p511dn8bu2v991hk8vuiu8.tt.x.bsgslb.cn,1,0.00%,1,0,100.00%
myveganmealplan.mymealplan.me,1,0.00%,1,0,100.00%
mail.uapafpe.tk,1,0.00%,1,0,100.00%
moneydog.herokuapp.com,1,0.00%,1,0,100.00%
sla-hll.nutrislice.com,1,0.00%,1,0,100.00%
dagafitness.mymealplan.me,1,0.00%,1,0,100.00%
lora.bigosaur.com,1,0.00%,1,0,100.00%
dell.archive.canonical.com,1,0.00%,1,0,100.00%
cloud4.yixiu.ga,1,0.00%,1,0,100.00%
crash.glodon.com,1,0.00%,1,0,100.00%
s5.vip.wpscdn.cn,1,0.00%,2,1,50.00%
apps.ptc.com,1,0.00%,1,0,100.00%
bbsimg.zhibo8.cc,1,0.00%,2,1,50.00%
lecturesonline.co.il,1,0.00%,1,0,100.00%
a4.centaur.network,1,0.00%,1,0,100.00%
hindi.crpfindia.com,1,0.00%,1,0,100.00%
quote-api.priceforbesonline.com,1,0.00%,1,0,100.00%
WWw.VOD.LXdns.COM,1,0.00%,2,1,50.00%
mail.proranker57.cf,1,0.00%,1,0,100.00%
music.madeincoimbra.org,1,0.00%,1,0,100.00%
wsv.cdp.qq.com,1,0.00%,2,1,50.00%
direwolf-8389d7233d.herokuapp.com,1,0.00%,1,0,100.00%
stage-leadaki-frontend-pr-698.stagecliengo.com,1,0.00%,1,0,100.00%
mosaico-app.herokuapp.com,1,0.00%,1,0,100.00%
form.deboever.be,1,0.00%,1,0,100.00%
r3---sn-ni57rn7y.gvt1.com,1,0.00%,1,0,100.00%
production-loadbalancer-1975618156.eu-central-1.elb.amazonaws.com,1,0.00%,1,0,100.00%
cm-10-40.getui.com,1,0.00%,1,0,100.00%
volley-new.herokuapp.com,1,0.00%,1,0,100.00%
baseserver.damai.cn,1,0.00%,1,0,100.00%
groups.dakotamccarty.com,1,0.00%,1,0,100.00%
aram-yedigaryan.luxuryrealestate.com,1,0.00%,1,0,100.00%
elladc.ellasa.com,1,0.00%,1,0,100.00%
1610064236.D4EE073C2A20.device.hiwifi.com,1,0.00%,1,0,100.00%
1610064302.D4EE073C2A20.device.hiwifi.com,1,0.00%,1,0,100.00%
leyendoapalerm.alterum.info,1,0.00%,1,0,100.00%
speedyelettrico.scontrinoshop.com,1,0.00%,1,0,100.00%
dashboard.lttm.pl,1,0.00%,1,0,100.00%
mbz.s4p-iapps.com,1,0.00%,1,0,100.00%
tz.erduo.ga,1,0.00%,1,0,100.00%
direwolf-32413e6773.herokuapp.com,1,0.00%,1,0,100.00%
front-gate-api-from-cn-449940069.ap-northeast-2.elb.amazonaws.com,1,0.00%,1,0,100.00%
duikwereld.ridders.dev,1,0.00%,1,0,100.00%
d1lggihq2bt4jo.cloudfront.net,1,0.00%,1,0,100.00%
polar-thicket-70644.herokuapp.com,1,0.00%,1,0,100.00%
app.tour-innsbruck.at,1,0.00%,1,0,100.00%
newtimed-liveng.alibabausercontent.com,1,0.00%,2,1,50.00%
redir.snipaste.com,1,0.00%,1,0,100.00%
vcardmgt-drcn.wallet.hicloud.com,1,0.00%,1,0,100.00%
restsdk.amap.com,1,0.00%,1,0,100.00%
site-70709661247.helphub.io,1,0.00%,1,0,100.00%
hk.rmih.co.za,1,0.00%,1,0,100.00%
daniel.greetpve.tk,1,0.00%,1,0,100.00%
cloud.chdbits.ml,1,0.00%,1,0,100.00%
universaltailors.co.uk,1,0.00%,1,0,100.00%
sup-almina.booqable.shop,1,0.00%,1,0,100.00%
1610064367.D4EE073C2A20.device.hiwifi.com,1,0.00%,1,0,100.00%
bancore.php7.postbox.kiev.ua,1,0.00%,1,0,100.00%
nanlotansper-blog.logdown.com,1,0.00%,1,0,100.00%
mysql.aaplumbing.co.uk,1,0.00%,1,0,100.00%
erthworks.co.uk,1,0.00%,1,0,100.00%
cdn-static.breeze24.know-domainwork.tk,1,0.00%,1,0,100.00%
8-134-75-168-yfd2ac63.free-lbv6.idouyinvod.com,1,0.00%,1,0,100.00%
portal.factoringorsan.cl,1,0.00%,1,0,100.00%
bi.uhomes.com,1,0.00%,1,0,100.00%
ip3070414037.funshion.com,1,0.00%,1,0,100.00%
oxfordcity.membermeister.com,1,0.00%,1,0,100.00%
trans-drcn.wallet.hicloud.com,1,0.00%,1,0,100.00%
to.snipaste.com,1,0.00%,1,0,100.00%
ex-updater.sayori.moe,1,0.00%,1,0,100.00%
3d.g4p.cn,1,0.00%,1,0,100.00%
www.tianqijun.com.cdn20.com,1,0.00%,1,0,100.00%
dhrest-static.2345.com.w.kunluncan.com,1,0.00%,1,0,100.00%
ocsp.trust-provider.cn.w.cdngslb.com,1,0.00%,1,0,100.00%
mail.azad.io,1,0.00%,1,0,100.00%
transfer.pointclouds.com,1,0.00%,1,0,100.00%
aidn.herokuapp.com,1,0.00%,1,0,100.00%
mail.rak.ae,1,0.00%,1,0,100.00%
enchant-ecom-cors-server.herokuapp.com,1,0.00%,1,0,100.00%
d4dda2e5-b4f1-4976-8bf4-41858a00ead8.assets.booqable.com,1,0.00%,1,0,100.00%
rc10-fc03.oray.com,1,0.00%,1,0,100.00%
api.glassfy.io,1,0.00%,1,0,100.00%
ddks.123143.com,1,0.00%,1,0,100.00%
edm.eet-china.com,1,0.00%,1,0,100.00%
sina-static.oss-cn-beijing.aliyuncs.com,1,0.00%,1,0,100.00%
ceur-ws.org,1,0.00%,1,0,100.00%
p002yjjexjkk.node.onnets1.com,1,0.00%,6,5,16.67%
img2033849174.file.onnets1.net,1,0.00%,1,0,100.00%
p02033849174.huyacdn.xyz,1,0.00%,2,1,50.00%
u2033849174.static.onnets1.xyz,1,0.00%,1,0,100.00%
file2033849174.netvigatorscdn.net,1,0.00%,2,1,50.00%
p02033849174.node.onnets1.com,1,0.00%,1,0,100.00%
file2033849174.harmonycloudcache.com,1,0.00%,2,1,50.00%
s7-sync.firefox.com.cn,1,0.00%,1,0,100.00%
conf.voice.qcloud.com,1,0.00%,1,0,100.00%
www.jb51.net.cdn20.com,1,0.00%,1,0,100.00%
icws.jb51.net.wswebpic.com,1,0.00%,1,0,100.00%
mm.jbzj.com.cname3097.yjs-cdn.com,1,0.00%,1,0,100.00%
mail.seorankerpro101.ml,1,0.00%,1,0,100.00%
mail.seobacklinks151.cf,1,0.00%,1,0,100.00%
retreats.selina.com,1,0.00%,1,0,100.00%
imsp.cas.uplb.edu.ph,1,0.00%,1,0,100.00%
mail.oihghhj.ga,1,0.00%,1,0,100.00%
m.huohua.cn,1,0.00%,1,0,100.00%
huozi.huohuacdn.com,1,0.00%,2,1,50.00%
ts.huohua.cn,1,0.00%,1,0,100.00%
active-appmedia.video.qq.com,1,0.00%,1,0,100.00%
av.video.qq.com,1,0.00%,1,0,100.00%
config.ab.qq.com,1,0.00%,1,0,100.00%
disp-qryapi.3g.qq.com,1,0.00%,1,0,100.00%
tv.ott.video.qq.com,1,0.00%,1,0,100.00%
compliance.tdos.qq.com,1,0.00%,1,0,100.00%
vfiles-raw.gtimg.cn,1,0.00%,1,0,100.00%
m.v.qq.com,1,0.00%,1,0,100.00%
unad.oss-accelerate.aliyuncs.com,1,0.00%,1,0,100.00%
metformina2017.logdown.com,1,0.00%,1,0,100.00%
connect.strategiccoach.com,1,0.00%,1,0,100.00%
WWw.Vod.lxdns.cOm,1,0.00%,2,1,50.00%
api.insface.tech,1,0.00%,1,0,100.00%
m.zxmh.net,1,0.00%,1,0,100.00%
flame-scarlet.logdown.com,1,0.00%,1,0,100.00%
validate.onecount.net,1,0.00%,1,0,100.00%
pbs.twimg.com,1,0.00%,2,1,50.00%
platform.twitter.map.fastly.net,1,0.00%,1,0,100.00%
0.centos.pool.ntp.org,1,0.00%,1,0,100.00%
1.centos.pool.ntp.org,1,0.00%,1,0,100.00%
3.centos.pool.ntp.org,1,0.00%,1,0,100.00%
www.freebuf.com,1,0.00%,1,0,100.00%
gateway.sogou.com,1,0.00%,1,0,100.00%
iss.amss.cas.cn,1,0.00%,1,0,100.00%
www.ncmis.cas.cn,1,0.00%,1,0,100.00%
math.amss.cas.cn,1,0.00%,1,0,100.00%
commdata.v.qq.com,1,0.00%,1,0,100.00%
idcconfig.gcloudsdk.com,1,0.00%,1,0,100.00%
weaknetprobe.3g.qq.com,1,0.00%,1,0,100.00%
masdk.3g.qq.com,1,0.00%,1,0,100.00%
dzedcomics.co.uk,1,0.00%,1,0,100.00%
visit.flossdentalmagnolia.com,1,0.00%,1,0,100.00%
telemetry-prod-1054754349.us-east-1.elb.amazonaws.com,1,0.00%,1,0,100.00%
_.com.teamsitesnow.com,1,0.00%,1,0,100.00%
premialab.coachingassembly.com,1,0.00%,1,0,100.00%
gcams049.exitgames.com,1,0.00%,1,0,100.00%
av1.nstld.com,1,0.00%,2,1,50.00%
av4.nstld.com,1,0.00%,4,3,25.00%
http.kali.org,1,0.00%,1,0,100.00%
1610053420.D4EE073C2A20.device.hiwifi.com,1,0.00%,1,0,100.00%
jackett.tanatos.tk,1,0.00%,1,0,100.00%
allegria-glasschmuck.versacommerce.de,1,0.00%,1,0,100.00%
union.zibbet.com,1,0.00%,1,0,100.00%
tyrepartner.co.uk,1,0.00%,1,0,100.00%
spam.jacvandenberg.com,1,0.00%,1,0,100.00%
login.sendpulse.com,1,0.00%,1,0,100.00%
is-lq.snssdk.com,1,0.00%,2,1,50.00%
mrn.meituan.net,1,0.00%,2,1,50.00%
data00.adlooxtracking.com,1,0.00%,1,0,100.00%
c.easongogo.tk,1,0.00%,1,0,100.00%
res.servicewechat.com.sched.legopic1-dk.tdnsv6.com,1,0.00%,4,3,25.00%
metrics-picture.dreport.meituan.net,1,0.00%,1,0,100.00%
catfront.dianping.com,1,0.00%,2,1,50.00%
a.bj.vip.dianping.com,1,0.00%,1,0,100.00%
a.sh.vip.dianping.com,1,0.00%,1,0,100.00%
dpurl.cn,1,0.00%,2,1,50.00%
tsp-web.vip.meituan.com,1,0.00%,1,0,100.00%
46kwytew.sched.skalego.tdnsstic1.cn,1,0.00%,1,0,100.00%
46kwytew.sched.skalego.tdnsstic1.cn.cjt.vwnti.yrzhcloud.cn,1,0.00%,1,0,100.00%
promotion.waimai.meituan.com,1,0.00%,1,0,100.00%
waimai.vip.meituan.com,1,0.00%,1,0,100.00%
marketing.waimai.meituan.com,1,0.00%,2,1,50.00%
puffer.4.891218518.gcloudlgame.qq.com,1,0.00%,1,0,100.00%
gspe85-cn-ssl.ls.apple.com,1,0.00%,2,1,50.00%
gspe85-cn-ssl.ls.apple.com.w.alikunlun.com,1,0.00%,1,0,100.00%
cbhsathletics.teamsitesnow.com,1,0.00%,1,0,100.00%
wp.pinnacle.in,1,0.00%,1,0,100.00%
direwolf-5fb42694af.herokuapp.com,1,0.00%,1,0,100.00%
mx-capricab.easydns.com,1,0.00%,1,0,100.00%
smtp.ddll.ga,1,0.00%,1,0,100.00%
trinsly.jeffreylamp.com,1,0.00%,1,0,100.00%
probe-edge.v.aaplimg.com,1,0.00%,2,1,50.00%
cloud.mooncloud.ml,1,0.00%,1,0,100.00%
1610053441.D4EE073C2A20.device.hiwifi.com,1,0.00%,1,0,100.00%
clone-windhamsd.nutrislice.com,1,0.00%,1,0,100.00%
1610064220.D4EE073C2A20.device.hiwifi.com,1,0.00%,1,0,100.00%
production-nautilus-1585718034.us-west-2.elb.amazonaws.com,1,0.00%,1,0,100.00%
mail.rues2.tk,1,0.00%,1,0,100.00%
apimgmths8k8srwuo5d9jfc6q658hofn97z0hejguw9hpvcwd4.cloudapp.net,1,0.00%,1,0,100.00%
na61-na62.wagbridge.advertisement.taobao.com.gds.alibabadns.com,1,0.00%,1,0,100.00%
zb-center-openjmacs.m.taobao.com.gds.alibabadns.com,1,0.00%,1,0,100.00%
jrs.com.cn,1,0.00%,1,0,100.00%
voice-service.uc.cn,1,0.00%,1,0,100.00%
cloud.yumixiu768.com,1,0.00%,1,0,100.00%
css-js-j.oss-accelerate.aliyuncs.com,1,0.00%,1,0,100.00%
cn-beijing-ds-2010.oss-acc.aliyuncs.com,1,0.00%,1,0,100.00%
1453639.sched.sma.tdnsstic1.cn.cjt.krcdn.idatacube.com,1,0.00%,1,0,100.00%
szbalbg.uae2grp.uc.cn,1,0.00%,1,0,100.00%
www.jrs.com.cn,1,0.00%,1,0,100.00%
pssn.alicdn.com,1,0.00%,1,0,100.00%
pssn.alicdn.com.gds.alibabadns.com,1,0.00%,1,0,100.00%
stratum-ltc.antpool.com,1,0.00%,1,0,100.00%
stratum-zec.antpool.com,1,0.00%,2,1,50.00%
stratum.antpool.com,1,0.00%,2,1,50.00%
mmgr.gtimg.com,1,0.00%,2,1,50.00%
ins-u9egduso.ias.tencent-cloud.net,1,0.00%,2,1,50.00%
p216-ckdatabase.icloud.com.cn,1,0.00%,1,0,100.00%
cm-10-16.getui.com,1,0.00%,1,0,100.00%
staging.tktrips.com,1,0.00%,1,0,100.00%
forum.metagame.wtf,1,0.00%,1,0,100.00%
www.cs.ox.ac.uk,1,0.00%,1,0,100.00%
icode-best.webpkgcache.com,1,0.00%,1,0,100.00%
ns-1119.awsdns-11.org,1,0.00%,2,1,50.00%
cors.redoc.ly,1,0.00%,1,0,100.00%
mail.nforsejid.tk,1,0.00%,1,0,100.00%
adr-web-radr-uat.redant.cloud,1,0.00%,1,0,100.00%
p3plvcpnl447742.prod.phx3.secureserver.net,1,0.00%,1,0,100.00%
mail.pertasaco.ml,1,0.00%,1,0,100.00%
philfordmachinery.co.uk,1,0.00%,1,0,100.00%
nm.thehealthority.com,1,0.00%,1,0,100.00%
mail.pokeronlineqqmega368.ml,1,0.00%,1,0,100.00%
imap.opkeservices.net,1,0.00%,1,0,100.00%
rock-e-mountain-bike-llc.booqable.shop,1,0.00%,1,0,100.00%
tnzmipnkptwy.loomings.net,1,0.00%,1,0,100.00%
direwolf-2a10c85dbe-renamed-2.herokuapp.com,1,0.00%,1,0,100.00%
bedford.swimtopia.com,1,0.00%,1,0,100.00%
fmmnbyobxipl.tembow.com,1,0.00%,1,0,100.00%
stiker.com.ua,1,0.00%,1,0,100.00%
downloads.hpdaas.com,1,0.00%,2,1,50.00%
atafargo.classic.kicksite.net,1,0.00%,1,0,100.00%
u7.iqiyipic.com,1,0.00%,2,1,50.00%
ip2091219986.funshion.com,1,0.00%,1,0,100.00%
09fa0d097a5970215252d408f0a84ca5.dlied1.cdntips.net,1,0.00%,1,0,100.00%
ln.vless2.xservs.xyz,1,0.00%,1,0,100.00%
8wy7jsbc.sched.sma.tdnsstic1.cn,1,0.00%,1,0,100.00%
8wy7jsbc.sched.sma.tdnsstic1.cn.cjt.krcdn.idatacube.com,1,0.00%,1,0,100.00%
openevent-anttalk.oss-cn-hangzhou.aliyuncs.com,1,0.00%,1,0,100.00%
gmail.com,1,0.00%,2,1,50.00%
vrlab-image1.ljcdn.com,1,0.00%,2,1,50.00%
newlaunch.propertygiant.com,1,0.00%,1,0,100.00%
punch.p2p.qq.com,1,0.00%,1,0,100.00%
cloud.maileducn.cf,1,0.00%,1,0,100.00%
dart.tapridemobile.com,1,0.00%,1,0,100.00%
hjrzpp.b30huang.gq,1,0.00%,1,0,100.00%
rogrundk.appraise.cf,1,0.00%,1,0,100.00%
_.3ll9k8.onlineladytorosbasketball.teamsitesnow.com,1,0.00%,1,0,100.00%
wWw.VoD.LxDnS.coM,1,0.00%,2,1,50.00%
discpath.haxor.fi,1,0.00%,1,0,100.00%
direwolf-ded87292e1.herokuapp.com,1,0.00%,1,0,100.00%
radiar.co.za,1,0.00%,1,0,100.00%
synresins.dev.safi.ai,1,0.00%,1,0,100.00%
p38-buy-lb.itunes-apple.com.akadns.net,1,0.00%,1,0,100.00%
dl-preview.csdnimg.cn,1,0.00%,1,0,100.00%
avatar.csdn.net,1,0.00%,1,0,100.00%
app.nlark.com.w.cdngslb.com,1,0.00%,1,0,100.00%
s.u7u9.com.w.kunlunle.com,1,0.00%,1,0,100.00%
zxgghn.25ku.com.cname3868.yjs-cdn.com,1,0.00%,1,0,100.00%
v.agicogroup.com,1,0.00%,1,0,100.00%
mmsns.qpic.cn,1,0.00%,4,3,25.00%
only-794326-159-226-95-72.nstool.laiqukankan.com,1,0.00%,1,0,100.00%
p3.ssl.img.360kuai.com,1,0.00%,1,0,100.00%
p2.ssl.img.360kuai.com,1,0.00%,1,0,100.00%
p5.ssl.img.360kuai.com,1,0.00%,1,0,100.00%
p4.ssl.img.360kuai.com,1,0.00%,1,0,100.00%
kzx1.360kan.com,1,0.00%,1,0,100.00%
only-487282-159-226-95-72.nstool.zhuanzfx.com,1,0.00%,1,0,100.00%
only-733594-159-226-95-72.nstool.haowu.link,1,0.00%,1,0,100.00%
jmy-pic.wejianzhan.com,1,0.00%,1,0,100.00%
r6.mo.n.shifen.com,1,0.00%,1,0,100.00%
hiboardng-hicloud-com-drcn.appacc-region.dbankedge.net,1,0.00%,1,0,100.00%
amp-api.media-lb.apple.com.akadns.net,1,0.00%,2,1,50.00%
magpie.xhscdn.com.cdn.dnsv1.com,1,0.00%,2,1,50.00%
www.rhhz.net,1,0.00%,1,0,100.00%
iat-api.xfyun.cn,1,0.00%,1,0,100.00%
professional-packages.chinauos.com,1,0.00%,1,0,100.00%
professional-security.chinauos.com,1,0.00%,1,0,100.00%
query.v-secure.cn,1,0.00%,1,0,100.00%
daop.xfyun.cn,1,0.00%,1,0,100.00%
linux.ime.sogou.com,1,0.00%,1,0,100.00%
plvuwomuvgur.oneworldbuttons.com,1,0.00%,1,0,100.00%
sg.usxx.ml,1,0.00%,1,0,100.00%
direwolf-a5502254d7.herokuapp.com,1,0.00%,1,0,100.00%
cms.rankedhoops.gg,1,0.00%,1,0,100.00%
woozacandy.socialacademy.me,1,0.00%,1,0,100.00%
polarismartialarts.classic.kicksite.net,1,0.00%,1,0,100.00%
ns01.rabble.com,1,0.00%,1,0,100.00%
1610053425.D4EE073C2A20.device.hiwifi.com,1,0.00%,1,0,100.00%
1610053446.D4EE073C2A20.device.hiwifi.com,1,0.00%,1,0,100.00%
downloads.dell-cidr.akadns.net,1,0.00%,2,1,50.00%
downloads-regions.dell-cidr.akadns.net,1,0.00%,2,1,50.00%
updateleak.qihucdn.com.dl.360qhcdn.com,1,0.00%,2,1,50.00%
vcheck.f.qh-lb.com,1,0.00%,1,0,100.00%
af3a4dec35f8263f9b.ignaciodoyle.private-api.com,1,0.00%,1,0,100.00%
cowork-storage-public-cdn.lx.netease.com,1,0.00%,1,0,100.00%
vs.funshion.com,1,0.00%,1,0,100.00%
hash6.server.kugou.net,1,0.00%,1,0,100.00%
cloudcfg.yfp2p.net,1,0.00%,2,1,50.00%
api.yfscdn.net,1,0.00%,2,1,50.00%
bsb.baidu.com,1,0.00%,1,0,100.00%
ejp-prod-msgsearch-1.cloudapp.net,1,0.00%,1,0,100.00%
update-bsd.omnigroup.com,1,0.00%,1,0,100.00%
d9eae637ff9c1b4c235d3b706e66678c.dlied1.cdntips.net,1,0.00%,1,0,100.00%
89-97-218-142.ip19.fastwebnet.it,1,0.00%,1,0,100.00%
zglynk.com,1,0.00%,1,0,100.00%
fpxx.es366.cn,1,0.00%,1,0,100.00%
qat05.virtual-strike.com,1,0.00%,1,0,100.00%
yourcomplete.co.uk,1,0.00%,1,0,100.00%
plastmed.almond-qms.com,1,0.00%,1,0,100.00%
school.droneacademy.co.il,1,0.00%,1,0,100.00%
association.confidencesdabeilles.fr,1,0.00%,1,0,100.00%
1610053493.D4EE073C2A20.device.hiwifi.com,1,0.00%,1,0,100.00%
wimo.kligao.cf,1,0.00%,1,0,100.00%
wWw.slashDOT.oRg,1,0.00%,1,0,100.00%
wWw.miT.eDu,1,0.00%,1,0,100.00%
adminstaging.swaptions.net,1,0.00%,1,0,100.00%
fleet.drive-eld.com,1,0.00%,1,0,100.00%
tianhan.herokuapp.com,1,0.00%,1,0,100.00%
m.look.360.cn,1,0.00%,2,1,50.00%
u.api.look.360.cn,1,0.00%,1,0,100.00%
comment.360kuai.com,1,0.00%,1,0,100.00%
relate.look.360.cn,1,0.00%,1,0,100.00%
81-227-30-35-no2989.tbcn.telia.com,1,0.00%,1,0,100.00%
blog.brimstedt.se,1,0.00%,1,0,100.00%
update.tabnine.com,1,0.00%,2,1,50.00%
www.ai1718.com,1,0.00%,1,0,100.00%
kjjs.360.cn,1,0.00%,2,1,50.00%
kjjs.360.cn.qh-cdn.com,1,0.00%,2,1,50.00%
kjjs.360.cn.webcdn.360qhcdn.com,1,0.00%,2,1,50.00%
filedownload-csw-lenovo.com,1,0.00%,1,0,100.00%
quoteqx.trafficmanager.cn,1,0.00%,1,0,100.00%
c.s.360.cn.qh-cdn.com,1,0.00%,2,1,50.00%
c.s.360.cn.webcdn.360qhcdn.com,1,0.00%,2,1,50.00%
a1971.b.akamai.net,1,0.00%,1,0,100.00%
vpic.video.qq.com.sched.legopic1.tdnsv6.com,1,0.00%,1,0,100.00%
easychair.org,1,0.00%,1,0,100.00%
ads.servenobid.com,1,0.00%,1,0,100.00%
nmm-use1-prod-alb-pbs-server-1662300823.us-east-1.elb.amazonaws.com,1,0.00%,1,0,100.00%
snz04pcor002-meta.fe.1drv.com,1,0.00%,2,1,50.00%
odc-snz04pap002-meta-geo.onedrive.akadns.net,1,0.00%,2,1,50.00%
odc-snz04pap002-meta-brs.onedrive.akadns.net,1,0.00%,2,1,50.00%
snz04pcor002-meta.be.1drv.com.l-0003.dc-msedge.net.l-0003.l-msedge.net,1,0.00%,2,1,50.00%
Reporting-API-PRO-686221983.us-west-2.elb.amazonaws.com,1,0.00%,1,0,100.00%
www.caai.cn,1,0.00%,1,0,100.00%
caai.cn,1,0.00%,1,0,100.00%
ir.iscas.ac.cn,1,0.00%,1,0,100.00%
2021aichina.caai.cn,1,0.00%,1,0,100.00%
detail.tmall.com,1,0.00%,2,1,50.00%
x.alicdn.com,1,0.00%,2,1,50.00%
assets.alicdn.com,1,0.00%,2,1,50.00%
clients.crestcreations.com,1,0.00%,1,0,100.00%
5e954fba-9b47-4d84-b2a9-62eda92e791a.reportablenews.com,1,0.00%,1,0,100.00%
p3plmcpnl495901.prod.phx3.secureserver.net,1,0.00%,1,0,100.00%
web3797.getambassador.com,1,0.00%,1,0,100.00%
angel-groups-wp.rfstaging.co.uk,1,0.00%,1,0,100.00%
anchiale.nuist.cf,1,0.00%,1,0,100.00%
hpdemo-apj.cds-limes.com,1,0.00%,1,0,100.00%
sg-aws.sssv9.gq,1,0.00%,1,0,100.00%
ospf.zw.hector.ntes53.netease.com,1,0.00%,1,0,100.00%
oimageb4.ydstatic.com.w.cdngslb.com,1,0.00%,1,0,100.00%
sr.mail.163.com,1,0.00%,1,0,100.00%
miic.gouv.ml,1,0.00%,1,0,100.00%
upgrade.down.sandai.net,1,0.00%,2,1,50.00%
upgrade.down.sandai.net.w.kunlunca.com,1,0.00%,2,1,50.00%
cdn-qwb-hz.wxb.com.w.kunluncan.com,1,0.00%,1,0,100.00%
static.hp-dataservices.com,1,0.00%,2,1,50.00%
ins-zthl41dz.ias.tencent-cloud.net,1,0.00%,1,0,100.00%
v9-mllqv.onewsvod.com,1,0.00%,2,1,50.00%
v9-mllqv.onewsvod.com.bsgslb.com,1,0.00%,2,1,50.00%
zttvadipv6.v.bsgslb.com,1,0.00%,2,1,50.00%
zkqyxx.bjhdedu.cn,1,0.00%,1,0,100.00%
wzqjypt.bjhdedu.cn,1,0.00%,1,0,100.00%
www.bjhdedu.cn,1,0.00%,2,1,50.00%
p3-ad.bytecdn.cn,1,0.00%,2,1,50.00%
p6-ad.bytecdn.cn,1,0.00%,2,1,50.00%
p1-ad.bytecdn.cn,1,0.00%,2,1,50.00%
p9-ad.bytecdn.cn,1,0.00%,2,1,50.00%
content.volccdn.com,1,0.00%,2,1,50.00%
p1-ad.bytecdn.cn.wsglb0.com,1,0.00%,2,1,50.00%
p9-ad.bytecdn.cn.bsgslb.com,1,0.00%,2,1,50.00%
p6-ad.bytecdn.cn.download.ks-cdn.com,1,0.00%,2,1,50.00%
p3-ad.bytecdn.cn.w.cdngslb.com,1,0.00%,2,1,50.00%
content.volccdn.com.yangyi19.com,1,0.00%,2,1,50.00%
l2-toutiao-ipv6-ml.gslb.ksyuncdn.com,1,0.00%,2,1,50.00%
common-img.bytegslb.com,1,0.00%,2,1,50.00%
p6-open-sign.byteimg.com,1,0.00%,2,1,50.00%
p6-open-sign.byteimg.com-1.download.ks-cdn.com,1,0.00%,2,1,50.00%
blog.nhautopiezas.com.ar,1,0.00%,1,0,100.00%
m.podkluch.rewedo.ru,1,0.00%,1,0,100.00%
domains.eventcreate.com,1,0.00%,1,0,100.00%
api.assertcom.de,1,0.00%,1,0,100.00%
d396xlxpwbqk4a.cloudfront.net,1,0.00%,1,0,100.00%
yc-k-userapi.q0mzo-j49ec-ibg0u-5flcx.com,1,0.00%,1,0,100.00%
only-936482-124-16-139-126.nstool.321fenx.com,1,0.00%,1,0,100.00%
only-421125-124-16-139-126.nstool.321fenx.com,1,0.00%,1,0,100.00%
only-559462-124-16-139-126.nstool.321fenx.com,1,0.00%,1,0,100.00%
only-450138-124-16-139-126.nstool.haowu.link,1,0.00%,1,0,100.00%
only-386851-124-16-139-126.nstool.haowu.link,1,0.00%,1,0,100.00%
only-992932-124-16-139-126.nstool.zhuanzfx.com,1,0.00%,1,0,100.00%
only-22968-124-16-139-126.nstool.laiqukankan.com,1,0.00%,1,0,100.00%
only-882719-124-16-139-126.nstool.laiqukankan.com,1,0.00%,1,0,100.00%
only-590177-124-16-139-126.nstool.haowu.link,1,0.00%,1,0,100.00%
only-427437-124-16-139-126.nstool.zhuanzfx.com,1,0.00%,1,0,100.00%
only-202683-124-16-139-126.nstool.laiqukankan.com,1,0.00%,1,0,100.00%
only-150069-124-16-139-126.nstool.haowu.link,1,0.00%,1,0,100.00%
only-17931-124-16-139-126.nstool.yqkk.link,1,0.00%,1,0,100.00%
only-917051-124-16-139-126.nstool.yqkk.link,1,0.00%,1,0,100.00%
only-738519-124-16-139-126.nstool.haowu.link,1,0.00%,1,0,100.00%
idealworkflow.alignpatientexperience.at,1,0.00%,1,0,100.00%
wiki.dimisjim.com,1,0.00%,1,0,100.00%
apac-docloc.invisalign.com,1,0.00%,1,0,100.00%
vc.hotjar.io,1,0.00%,1,0,100.00%
vc-live-cf.hotjar.io,1,0.00%,1,0,100.00%
susy.mdpi.com,1,0.00%,1,0,100.00%
www.preprints.org,1,0.00%,1,0,100.00%
www.mdpi.com,1,0.00%,1,0,100.00%
m.ikimkg.ga,1,0.00%,1,0,100.00%
adash-emas.cn-hangzhou.aliyuncs.com,1,0.00%,2,1,50.00%
imagesinajs.gslb.sinaedge.com,1,0.00%,2,1,50.00%
fgb0.market.xiaomi.com,1,0.00%,2,1,50.00%
fgb0.market.c.mgslb.com,1,0.00%,2,1,50.00%
api.tw06.xlmc.sandai.net,1,0.00%,1,0,100.00%
alilang-unify-struct-log.cn-hangzhou-b.log.aliyuncs.com,1,0.00%,1,0,100.00%
ocs-oneagent-server.alibaba.com,1,0.00%,2,1,50.00%
ali-info-terminal-client.cn-hangzhou.log.aliyuncs.com,1,0.00%,1,0,100.00%
tcp-alilang.alibaba-inc.com.gds.alibabadns.com,1,0.00%,1,0,100.00%
outside.proxy.alibaba-inc.com.gds.alibabadns.com,1,0.00%,1,0,100.00%
alimeeting.cn-hangzhou.log.aliyuncs.com,1,0.00%,1,0,100.00%
aip-proxy-outside-zb.alibaba-inc.com.gds.alibabadns.com,1,0.00%,1,0,100.00%
aip-proxy-outside-zb-alibabainc.alibaba-inc.com.gds.alibabadns.com,1,0.00%,1,0,100.00%
it-sp.alibaba-inc.com.gds.alibabadns.com,1,0.00%,1,0,100.00%
aip-proxy-inside-zb.alibaba-inc.com.gds.alibabadns.com,1,0.00%,1,0,100.00%
et15-na61-na62.wagbridge.alibaba.taobao.com.gds.alibabadns.com,1,0.00%,1,0,100.00%
i-phx02p-cor003.api.p001.1drv.com,1,0.00%,1,0,100.00%
aci.alipay.com,1,0.00%,1,0,100.00%
gz-rr2.office.spanner.alipaydns.com,1,0.00%,1,0,100.00%
3c32a2da-rh2sg0-0-6ny5.us.pyboard.vip,1,0.00%,1,0,100.00%
mail.limscare.cf,1,0.00%,1,0,100.00%
blackpink.lnk.to,1,0.00%,1,0,100.00%
sodium.gdnsdef.com,1,0.00%,1,0,100.00%
ns4.gdnsdef.com,1,0.00%,1,0,100.00%
alpezzi.com.mx,1,0.00%,1,0,100.00%
hubdz.ubon.io,1,0.00%,1,0,100.00%
selected.hicloud.com,1,0.00%,1,0,100.00%
gps-drcn.game.dbankcloud.cn,1,0.00%,1,0,100.00%
jxs1.jos.hicloud.com,1,0.00%,1,0,100.00%
gs-drcn.game.dbankcloud.com,1,0.00%,1,0,100.00%
1610401927.D4EE073396E8.device.hiwifi.com,1,0.00%,1,0,100.00%
cdn.huggingface.co,1,0.00%,2,1,50.00%
mail.bucatarie.tv,1,0.00%,1,0,100.00%
staging.app.metacognitiv.com,1,0.00%,1,0,100.00%
hcdndyn.zjtd.v4.c.cdnhwc2.com,1,0.00%,2,1,50.00%
ssp.ibluefrog.com,1,0.00%,1,0,100.00%
wifistat.ggsafe.com,1,0.00%,1,0,100.00%
p0107718022.node.onnets1.com,1,0.00%,1,0,100.00%
p0107718022.huyacdn.xyz,1,0.00%,3,2,33.33%
u107718022.static.onnets1.xyz,1,0.00%,1,0,100.00%
file107718022.harmonycloudcache.com,1,0.00%,2,1,50.00%
file107718022.netvigatorscdn.net,1,0.00%,2,1,50.00%
sg1.edgehelper.com,1,0.00%,1,0,100.00%
th.iggfastweb.com,1,0.00%,1,0,100.00%
de.edgehelper.com,1,0.00%,1,0,100.00%
ru1.iggfastweb.com,1,0.00%,1,0,100.00%
uk2.iggfastweb.com,1,0.00%,1,0,100.00%
in2.iggfastweb.com,1,0.00%,1,0,100.00%
india.edgehelper.com,1,0.00%,1,0,100.00%
kr.iggfastweb.com,1,0.00%,1,0,100.00%
fsofso.com,1,0.00%,2,1,50.00%
dualstack.fsou-prod-610526454.cn-northwest-1.elb.amazonaws.com.cn,1,0.00%,2,1,50.00%
bugs.hetaointernal.com,1,0.00%,1,0,100.00%
f.hetaousercontent.com,1,0.00%,1,0,100.00%
exp.hetaousercontent.com,1,0.00%,1,0,100.00%
mtm.hetaousercontent.com,1,0.00%,1,0,100.00%
lh1.hetaousercontent.com,1,0.00%,1,0,100.00%
xpic.oss-cn-hangzhou.aliyuncs.com,1,0.00%,1,0,100.00%
gateway-china.icloud.com,1,0.00%,2,1,50.00%
collectorupdate7.synology.com,1,0.00%,1,0,100.00%
d1b7bw0f38jscn.cloudfront.cn,1,0.00%,1,0,100.00%
lf9-sf-be-pack-sign.pglstatp-toutiao.com,1,0.00%,2,1,50.00%
lf9-sf-be-pack-sign.pglstatp-toutiao.com.bsgslb.com,1,0.00%,2,1,50.00%
collectorautoupdate7.synology.com,1,0.00%,1,0,100.00%
mb.adres.wpscdn.cn,1,0.00%,2,1,50.00%
mb-adres-wpscdn-cn-idvb5xm.qiniudns.com,1,0.00%,2,1,50.00%
chinaweb55.china.line.qiniudns.com,1,0.00%,2,1,50.00%
flightaware.com,1,0.00%,1,0,100.00%
8582c4919a16e769.vip.jiasule.org,1,0.00%,1,0,100.00%
s.syzs.qq.com.cdn.dnsv1.com,1,0.00%,1,0,100.00%
0ign8j4l.sched.vplego.tdnsvod4.cn,1,0.00%,1,0,100.00%
733868e706dd40d3a4a0588fc39b3df8.pacloudflare.com,1,0.00%,1,0,100.00%
wisedevice-drcn.things.dbankcloud.cn,1,0.00%,1,0,100.00%
ckcoderouter.fe.apple-dns.cn,1,0.00%,1,0,100.00%
e7741.x.akamaiedge.net,1,0.00%,1,0,100.00%
adl.windows.com.edgesuite.net,1,0.00%,1,0,100.00%
pool-173-48-35-129.bstnma.fios.verizon.net,1,0.00%,1,0,100.00%
e.echatsoft.com,1,0.00%,1,0,100.00%
max.dmp.360.cn,1,0.00%,1,0,100.00%
img.110.com,1,0.00%,1,0,100.00%
www.law-sharing.cn,1,0.00%,1,0,100.00%
start.yynnz.com,1,0.00%,1,0,100.00%
passport-plugin.hao184.com,1,0.00%,1,0,100.00%
guess-web.50bangzh.com,1,0.00%,1,0,100.00%
dhrest.2345.com,1,0.00%,1,0,100.00%
www.zunerguang.com,1,0.00%,1,0,100.00%
s6.vip.wpscdn.cn,1,0.00%,2,1,50.00%
bwg4.klzry.ml,1,0.00%,1,0,100.00%
tlcc.lend-engine-app.com,1,0.00%,1,0,100.00%
pingdom30l.jobs2web.sapsf.cn,1,0.00%,1,0,100.00%
jgwhdlb1.gaox.ml,1,0.00%,1,0,100.00%
solarhouse.tycg.gov.tw,1,0.00%,1,0,100.00%
m.runoob.com,1,0.00%,1,0,100.00%
api.ludashi.com,1,0.00%,1,0,100.00%
www.geoplugin.net,1,0.00%,1,0,100.00%
geo.homenewtab.com,1,0.00%,1,0,100.00%
xbroker-z1-i5.ngxcld.com,1,0.00%,1,0,100.00%
time.pool.aliyun.com,1,0.00%,1,0,100.00%
track.tiara.daum.net,1,0.00%,2,1,50.00%
cdn-3.brodude.ru,1,0.00%,1,0,100.00%
mail.matiff.ga,1,0.00%,1,0,100.00%
Www.voD.lxDnS.com,1,0.00%,2,1,50.00%
preview-api.agentscorner.com,1,0.00%,1,0,100.00%
rwuodnstmlrr.exitlist.co,1,0.00%,1,0,100.00%
p3plmcpnl495849.prod.phx3.secureserver.net,1,0.00%,1,0,100.00%
download.hikops.com,1,0.00%,1,0,100.00%
cas.rsi.com.tw,1,0.00%,1,0,100.00%
z.moatads.com,1,0.00%,1,0,100.00%
dr2.ylyh.ml,1,0.00%,1,0,100.00%
iup.360safe.com,1,0.00%,2,1,50.00%
wWw.voD.LXDNs.coM,1,0.00%,2,1,50.00%
omgid.qq.com,1,0.00%,1,0,100.00%
health.baidu.com,1,0.00%,2,1,50.00%
staging.aliyilmaz.nl,1,0.00%,1,0,100.00%
video4-3.pddpic.com,1,0.00%,2,1,50.00%
funnels.leadhero.de,1,0.00%,1,0,100.00%
tsa.swimtopia.com,1,0.00%,1,0,100.00%
me.7381.tk,1,0.00%,1,0,100.00%
mail.hotelallinone.in,1,0.00%,1,0,100.00%
webmail.myu.com.tw,1,0.00%,1,0,100.00%
mancentos.w64139303.tk,1,0.00%,1,0,100.00%
newtajmahal.groceryport.com,1,0.00%,1,0,100.00%
1610053436.D4EE073C2A20.device.hiwifi.com,1,0.00%,1,0,100.00%
1610053462.D4EE073C2A20.device.hiwifi.com,1,0.00%,1,0,100.00%
1610053503.D4EE073C2A20.device.hiwifi.com,1,0.00%,1,0,100.00%
app.sendwarmup.com,1,0.00%,1,0,100.00%
the-implementation-of-the-triple-helix-model.confetti.events,1,0.00%,1,0,100.00%
safe.task.uc.360.cn,1,0.00%,1,0,100.00%
aesohch8.nodedata.net,1,0.00%,1,0,100.00%
polywork.fabian-niesen.de,1,0.00%,1,0,100.00%
ucpop3.uc-tek.com,1,0.00%,1,0,100.00%
adreq.vivo.com.cn,1,0.00%,1,0,100.00%
sys.zhangyue.com,1,0.00%,1,0,100.00%
adlog.vivo.com.cn,1,0.00%,1,0,100.00%
code.createjs.com,1,0.00%,2,1,50.00%
tycloud.hpccube.com,1,0.00%,1,0,100.00%
ezanvakti.herokuapp.com,1,0.00%,1,0,100.00%
www.ydc360.com,1,0.00%,1,0,100.00%
www.szkoa.com,1,0.00%,1,0,100.00%
www.chzybj.com,1,0.00%,1,0,100.00%
shxgoods.oss-cn-beijing.aliyuncs.com,1,0.00%,1,0,100.00%
www.66123123.com,1,0.00%,1,0,100.00%
updown.shenhexin.com,1,0.00%,1,0,100.00%
webdisk.santaanamayamich.gob.mx,1,0.00%,1,0,100.00%
www.zbrjcg.gov.cn,1,0.00%,1,0,100.00%
secure-bigfile.wostatic.cn,1,0.00%,1,0,100.00%
secure2.wostatic.cn,1,0.00%,1,0,100.00%
non-secure.wostatic.cn,1,0.00%,1,0,100.00%
msg.api.wolai.com,1,0.00%,1,0,100.00%
htlb.casalemedia.com,1,0.00%,1,0,100.00%
hb.emxdgt.com,1,0.00%,1,0,100.00%
secure.cdn.fastclick.net,1,0.00%,1,0,100.00%
pixel-eu.rubiconproject.com,1,0.00%,1,0,100.00%
lb.eu-1-id5-sync.com,1,0.00%,1,0,100.00%
erpweb.bcc.com.cn,1,0.00%,1,0,100.00%
divorcetools.herokuapp.com,1,0.00%,1,0,100.00%
system-clx-localtest1.test.financialforce.com,1,0.00%,1,0,100.00%
smtp.dreamfunded.com,1,0.00%,1,0,100.00%
104-248-173-250.luminatinet.com,1,0.00%,1,0,100.00%
lcs.baidu.com,1,0.00%,2,1,50.00%
novelapi.baidu.com,1,0.00%,2,1,50.00%
sjws-tls.baidu.com,1,0.00%,2,1,50.00%
only-312339-159-226-95-72.nstool.haowu.link,1,0.00%,1,0,100.00%
only-213066-159-226-95-72.nstool.netease.com,1,0.00%,1,0,100.00%
public.wolai.com,1,0.00%,1,0,100.00%
secure2-danger.wostatic.cn,1,0.00%,1,0,100.00%
ustcse.wolai.com,1,0.00%,1,0,100.00%
secure-bigfile-danger.wostatic.cn,1,0.00%,1,0,100.00%
p.weather.com.cn,1,0.00%,1,0,100.00%
www.tm.ak.prd.aadg.akadns.NET,1,0.00%,1,0,100.00%
gubacdn.dfcfw.com,1,0.00%,3,2,33.33%
premiumcdn.eastmoney.com,1,0.00%,3,2,33.33%
topic.1234567.com.cn,1,0.00%,4,3,25.00%
swcpinyin.sogoucdn.com,1,0.00%,1,0,100.00%
stream2.cat3movie.org,1,0.00%,1,0,100.00%
spam2.sugon.com,1,0.00%,1,0,100.00%
ali-bj-pcdn-11.biliapi.net,1,0.00%,1,0,100.00%
red-dot.com.tw,1,0.00%,1,0,100.00%
ns-at1.proofpoint.us,1,0.00%,2,1,50.00%
mail.topheadlines31.ga,1,0.00%,1,0,100.00%
1vyzpcx.aoih.dseoe.tk,1,0.00%,1,0,100.00%
mail.toenopvensccer.ml,1,0.00%,1,0,100.00%
1608241805.D4EE071FA772.device.hiwifi.com,1,0.00%,1,0,100.00%
1608241856.D4EE071FA772.device.hiwifi.com,1,0.00%,1,0,100.00%
server.okoo.cc,1,0.00%,1,0,100.00%
mob.mobplus.net,1,0.00%,1,0,100.00%
dataupdate.synology.com,1,0.00%,1,0,100.00%
dataautoupdate.synology.cn,1,0.00%,1,0,100.00%
ds9dsukghgfh6.cloudfront.net,1,0.00%,1,0,100.00%
datascience.virginia.edu,1,0.00%,1,0,100.00%
prod-fix-create--xdb2bk.kajabi-staging.com,1,0.00%,1,0,100.00%
comment.ifeng.com,1,0.00%,1,0,100.00%
survey.news.ifeng.com,1,0.00%,1,0,100.00%
bdmap1.ifeng.com,1,0.00%,1,0,100.00%
u22694140.ct.sendgrid.net,1,0.00%,1,0,100.00%
hypoterian.com,1,0.00%,1,0,100.00%
m7r3746kyf1yj8ft.aliyunddos1010.com,1,0.00%,1,0,100.00%
live.com,1,0.00%,1,0,100.00%
www.baicaio.com,1,0.00%,1,0,100.00%
iwriseborough.plus.com,1,0.00%,1,0,100.00%
analytics.inzynk.io,1,0.00%,1,0,100.00%
krcs.kugou.com,1,0.00%,1,0,100.00%
meetthemarket.co.za,1,0.00%,1,0,100.00%
janny.ddfba.cf,1,0.00%,1,0,100.00%
thefrenchjewelbox.com.au,1,0.00%,1,0,100.00%
parent.garbage.guarantee.ml,1,0.00%,1,0,100.00%
mail.bien-immo.ml,1,0.00%,1,0,100.00%
ravo.immaginecreativa.it,1,0.00%,1,0,100.00%
d9nzpz.34maoiw77.tk,1,0.00%,1,0,100.00%
6ee92578-223a-49ef-9ef0-a0644f7eae33.pushnotifications.pusher.com,1,0.00%,1,0,100.00%
po15t5h16.2adh.layo.cf,1,0.00%,1,0,100.00%
1608241922.D4EE071FA772.device.hiwifi.com,1,0.00%,1,0,100.00%
mail.ukknowlegefree38.gq,1,0.00%,1,0,100.00%
dev.polysentry.com,1,0.00%,1,0,100.00%
cpcalendars.fggcibusa.com.ng,1,0.00%,1,0,100.00%
equipe.adaptativa.com.br,1,0.00%,1,0,100.00%
hopepilates.pozenstaging.xyz,1,0.00%,1,0,100.00%
api.xplenty.com,1,0.00%,1,0,100.00%
186697.logineonrw-lms.de,1,0.00%,1,0,100.00%
ru.openlist.wiki,1,0.00%,1,0,100.00%
mail.twedatdioprinorar.tk,1,0.00%,1,0,100.00%
p215-escrowproxy.icloud.com.cn,1,0.00%,1,0,100.00%
healthcdn.cqliving.com.w.kunlunaq.com,1,0.00%,1,0,100.00%
job.mohrss.gov.cn,1,0.00%,2,1,50.00%
url.sfndns.cn,1,0.00%,1,0,100.00%
7a838a520ae1fe6b42fd63298369694b.sangfordns.com,1,0.00%,1,0,100.00%
webmail.voss.tk,1,0.00%,1,0,100.00%
softstat.kugou.com,1,0.00%,1,0,100.00%
optimal.seneris.com,1,0.00%,1,0,100.00%
sleeprss.herokuapp.com,1,0.00%,1,0,100.00%
old.nsa.la,1,0.00%,1,0,100.00%
www.VOD.lxDNS.CoM,1,0.00%,2,1,50.00%
app.gainexps.com,1,0.00%,1,0,100.00%
useless.underscore.co.jp,1,0.00%,1,0,100.00%
webtv.italianfishingtv.it,1,0.00%,1,0,100.00%
order.chezgaby.ae,1,0.00%,1,0,100.00%
web-img.oss-cn-hangzhou.aliyuncs.com,1,0.00%,1,0,100.00%
map-img.oss.aliyuncs.com,1,0.00%,1,0,100.00%
fileserver.cdn.huya.com.w.kunluncan.com,1,0.00%,1,0,100.00%
tt-vod-cold1-sched.jcloudimg.com,1,0.00%,2,1,50.00%
e16126.dscg.akamaiedge.net,1,0.00%,2,1,50.00%
bdwm.net,1,0.00%,1,0,100.00%
e8333.g.akamaiedge.net,1,0.00%,1,0,100.00%
assets-ext01-684130249.eu-west-1.elb.amazonaws.com,1,0.00%,1,0,100.00%
d2hifmcrdlhbcy.cloudfront.net,1,0.00%,1,0,100.00%
e316d1f5c13a425fe9a8b30bb24c072b.dlied1.cdntips.net,1,0.00%,1,0,100.00%
e4578.dscf.akamaiedge.net,1,0.00%,2,1,50.00%
analytics-union.xunlei.com,1,0.00%,1,0,100.00%
www.juyouquan.net,1,0.00%,1,0,100.00%
e1.monidai.com,1,0.00%,1,0,100.00%
success.jd.com,1,0.00%,2,1,50.00%
m.au2gam.ga,1,0.00%,1,0,100.00%
fmipmobile.fe.apple-dns.cn,1,0.00%,1,0,100.00%
cdn-china.ampproject.org,1,0.00%,2,1,50.00%
mon3-misc-lq.fqnovel.com,1,0.00%,2,1,50.00%
jx0tc5tw.sched.d2-dk.tdnsdp1.cn,1,0.00%,1,0,100.00%
jx0tc5tw.sched.d2-dk.tdnsdp1.cn.cjt.vwnti.yrzhcloud.cn,1,0.00%,2,1,50.00%
gw-c-sht.pinduoduo.com,1,0.00%,1,0,100.00%
iwan-s.video.qq.com,1,0.00%,1,0,100.00%
apd-5bc3bfadf20fc138169092cf798dcd04.v.smtcdns.com,1,0.00%,1,0,100.00%
iota211.rtb.appier.net,1,0.00%,1,0,100.00%
vst.c.appier.net,1,0.00%,1,0,100.00%
userlocation.googleapis.com,1,0.00%,2,1,50.00%
ox-delivery-prod-asia-northeast1.openx.net,1,0.00%,1,0,100.00%
choices.truste.com,1,0.00%,1,0,100.00%
ib.3lift.com,1,0.00%,1,0,100.00%
choices.trustarc.com,1,0.00%,1,0,100.00%
www.bejson.com,1,0.00%,1,0,100.00%
3valw9gt.sched.d2.tdnsdp1.cn.cjt.vwnti.yrzhcloud.cn,1,0.00%,1,0,100.00%
1685738.sched.v1lego-dk.tdnsvod1.cn,1,0.00%,2,1,50.00%
jwcg.ucas.ac.cn,1,0.00%,1,0,100.00%
sub.it-global.ml,1,0.00%,1,0,100.00%
dev1.cpshopmanager.com,1,0.00%,1,0,100.00%
a6153510-4b71-4372-a6e9-ec904247cd8c.adquick.com,1,0.00%,1,0,100.00%
rotkaeppchen-cos-stage.makaira.cloud,1,0.00%,1,0,100.00%
localrealtors.realscout.com,1,0.00%,1,0,100.00%
app.lila.help,1,0.00%,1,0,100.00%
1610340732.D4EE073396E8.device.hiwifi.com,1,0.00%,1,0,100.00%
1610340753.D4EE073396E8.device.hiwifi.com,1,0.00%,1,0,100.00%
1610340774.D4EE073396E8.device.hiwifi.com,1,0.00%,1,0,100.00%
vdot.douyucdn.cn.w.kunluncan.com,1,0.00%,1,0,100.00%
www.douyu.com.w.kunluncan.com,1,0.00%,2,1,50.00%
s.ssl.qhres2.com.qh-cdn.com,1,0.00%,2,1,50.00%
d22oj5itccz3aw.cloudfront.net,1,0.00%,2,1,50.00%
api2.music.163.com,1,0.00%,2,1,50.00%
api2.music.163.com.w.cdngslb.com,1,0.00%,2,1,50.00%
s6.music.126.net.163jiasu.com,1,0.00%,2,1,50.00%
mp.music.163.com.w.cdngslb.com,1,0.00%,1,0,100.00%
s7.music.126.net,1,0.00%,2,1,50.00%
only-917453-124-16-137-194.nstool.yqkk.link,1,0.00%,1,0,100.00%
dns.east.comss.one,1,0.00%,1,0,100.00%
vec.m.wikipedia.shisu.cf,1,0.00%,1,0,100.00%
comments.people.com.cn,1,0.00%,1,0,100.00%
na.glbtls.t.co,1,0.00%,1,0,100.00%
scan-44a.shadowserver.org,1,0.00%,1,0,100.00%
mobril.herokuapp.com,1,0.00%,1,0,100.00%
speckleparksales.com.au,1,0.00%,1,0,100.00%
allthingshome.mydomastudio.com,1,0.00%,1,0,100.00%
hostdare.router2.ml,1,0.00%,1,0,100.00%
581277016.slp2p-east-std31.oray.net,1,0.00%,1,0,100.00%
hr03.graniterapids.com,1,0.00%,1,0,100.00%
api.zenmindnewtab.com,1,0.00%,1,0,100.00%
ts5.xiaoxw.xyz,1,0.00%,1,0,100.00%
skdisplay.jd.com.gslb.qianxun.com,1,0.00%,1,0,100.00%
e11954.a.akamaiedge.net,1,0.00%,1,0,100.00%
creator.hupu.com,1,0.00%,2,1,50.00%
activity-static.hoopchina.com.cn.cdn.dnsv1.com,1,0.00%,2,1,50.00%
pldm6odk.sched.sma-dk.tdnsstic1.cn,1,0.00%,2,1,50.00%
54.push2.eastmoney.com,1,0.00%,2,1,50.00%
staging.tonyrobbins.com,1,0.00%,1,0,100.00%
up.bxsb.cf,1,0.00%,1,0,100.00%
update-check.realvnc.com,1,0.00%,1,0,100.00%
game.wywyx.com,1,0.00%,1,0,100.00%
www.wuxingzhenjiuxuehui.cn,1,0.00%,1,0,100.00%
bbs1.hope.org.cn,1,0.00%,1,0,100.00%
https://im.dingtalk.com,1,0.00%,1,0,100.00%
alivereport.xiaoeknow.com,1,0.00%,1,0,100.00%
dp.xiaoeknow.com,1,0.00%,1,0,100.00%
im.xiaoeknow.com,1,0.00%,1,0,100.00%
logreport.xiaoeknow.com,1,0.00%,1,0,100.00%
app.xiaoe-tech.com,1,0.00%,1,0,100.00%
mail.viwevisbave.ml,1,0.00%,1,0,100.00%
mail.rankerweb70.ml,1,0.00%,1,0,100.00%
butcherandvine.stagingsite.work,1,0.00%,1,0,100.00%
efca-contacts.journeydns.com,1,0.00%,1,0,100.00%
public.map.n.shifen.com,1,0.00%,2,1,50.00%
ns-eh2-prod-sg3-518.cloudapp.net,1,0.00%,1,0,100.00%
log3.tagtic.cn,1,0.00%,1,0,100.00%
adlog.tagtic.cn,1,0.00%,1,0,100.00%
hw-bj-live-p2p-2.chat.bilibili.com,1,0.00%,1,0,100.00%
download1.vzuu.com,1,0.00%,2,1,50.00%
analytics-ios.rayjump.com,1,0.00%,1,0,100.00%
us04xmpp-xsrsrv8.zoom.us,1,0.00%,1,0,100.00%
dealer.yiche.com.cdn.dnsv1.com.cn,1,0.00%,2,1,50.00%
h1cyui00.sched.sma-dk.tdnsstic1.cn,1,0.00%,2,1,50.00%
image.bitautoimg.com.download.ks-cdn.com,1,0.00%,2,1,50.00%
newsapi.yiche.com.download.ks-cdn.com,1,0.00%,2,1,50.00%
img4.bitauto.com.download.ks-cdn.com,1,0.00%,2,1,50.00%
img1.bitautoimg.com.download.ks-cdn.com,1,0.00%,2,1,50.00%
l11-ipv6.gslb.ksyuncdn.com,1,0.00%,2,1,50.00%
us04as-va.zoom.us,1,0.00%,1,0,100.00%
us04xmppapi-ngxsvr6.zoom.us,1,0.00%,1,0,100.00%
image.bitauto.com.download.ks-cdn.com,1,0.00%,2,1,50.00%
img2.bitautoimg.com.download.ks-cdn.com,1,0.00%,2,1,50.00%
pbs1.ycgslb.com,1,0.00%,1,0,100.00%
epbf.bitautoimg.com.cdn.dnsv1.com,1,0.00%,2,1,50.00%
sz-special-overseas.volcgtm.com,1,0.00%,1,0,100.00%
2zy7rpcf.sched.sma-dk.tdnsstic1.cn,1,0.00%,2,1,50.00%
pbs3.ycgslb.com,1,0.00%,1,0,100.00%
frontapi.easypass.cn.wsglb0.com,1,0.00%,1,0,100.00%
tx3.ycgslb.com,1,0.00%,1,0,100.00%
log.bitauto.com.cdn.dnsv1.com.cn,1,0.00%,2,1,50.00%
0zpz7d6f.sched.sma-dk.tdnsstic1.cn,1,0.00%,2,1,50.00%
www.bitauto.com.cdn.dnsv1.com.cn,1,0.00%,2,1,50.00%
n9cujqk1.sched.sma-dk.tdnsstic1.cn,1,0.00%,2,1,50.00%
www.yiche.com.cdn.dnsv1.com,1,0.00%,2,1,50.00%
huuvzxtu.sched.sma-dk.tdnsstic1.cn,1,0.00%,2,1,50.00%
941321.xyz,1,0.00%,1,0,100.00%
data.datagrand.com,1,0.00%,1,0,100.00%
www.datagrand.com,1,0.00%,1,0,100.00%
cloudconvert.com,1,0.00%,2,1,50.00%
jdvod.300hu.com,1,0.00%,2,1,50.00%
ttfm2018-oss-cdn.tingtingfm.com,1,0.00%,2,1,50.00%
store-images.s-microsoft.com,1,0.00%,2,1,50.00%
www.cnmzppw.com,1,0.00%,1,0,100.00%
p1-tt.byteimg.com,1,0.00%,2,1,50.00%
safeurl-api.maxthon.cn,1,0.00%,1,0,100.00%
centerhk.nvjun.m-co.cn,1,0.00%,1,0,100.00%
m.momoshop.com.tw,1,0.00%,3,2,33.33%
maps.google.com,1,0.00%,1,0,100.00%
cdn.iframe.ly,1,0.00%,1,0,100.00%
app.playhub.cc,1,0.00%,1,0,100.00%
mcsin-k12.nutrislice.com,1,0.00%,1,0,100.00%
trackerslist.com,1,0.00%,2,1,50.00%
verwaltung.mitteldeutsche-steeldartliga.de,1,0.00%,1,0,100.00%
books.spirittracks.ca,1,0.00%,1,0,100.00%
upload-bbs.mihoyo.com.m.alikunlun.com,1,0.00%,2,1,50.00%
shenghong1126.com.tw,1,0.00%,1,0,100.00%
widget.va1.vip.prod.criteo.com,1,0.00%,1,0,100.00%
ih.adscale.de,1,0.00%,1,0,100.00%
exchange.mediavine.com,1,0.00%,1,0,100.00%
r.casalemedia.com.cdn.cloudflare.net,1,0.00%,1,0,100.00%
ap-ice.360yield.com,1,0.00%,1,0,100.00%
sadc1.outbrain.org,1,0.00%,1,0,100.00%
bid.dr.socdm.com,1,0.00%,1,0,100.00%
tg.dr.socdm.com,1,0.00%,1,0,100.00%
cookie-matcher-prod.fs6yf3fqvt.ap-northeast-2.elasticbeanstalk.com,1,0.00%,1,0,100.00%
cs.adingo.jp,1,0.00%,1,0,100.00%
s.ad.smaato.net,1,0.00%,2,1,50.00%
ade.clmbtech.com,1,0.00%,2,1,50.00%
cotads.adscale.de,1,0.00%,2,1,50.00%
ade.clmbtech.com-v2.edgekey.net,1,0.00%,2,1,50.00%
d285sbdaklqe28.cloudfront.net,1,0.00%,2,1,50.00%
e63851.dscj.akamaiedge.net,1,0.00%,2,1,50.00%
downv6.qq.com.sched.dlied1.tdnsv5.com,1,0.00%,1,0,100.00%
epsilon.6sense.com,1,0.00%,1,0,100.00%
i-4103.b-4522.utw.bench.utorrent.com,1,0.00%,3,2,33.33%
sdk.privacy-center.org,1,0.00%,2,1,50.00%
assets.trontv.com,1,0.00%,1,0,100.00%
www.bittorrent.com,1,0.00%,3,2,33.33%
recp.jd.com,1,0.00%,1,0,100.00%
en.saudishopper.com.sa,1,0.00%,1,0,100.00%
autospecial.com.ar,1,0.00%,1,0,100.00%
choice.eastmoney.com,1,0.00%,1,0,100.00%
iguba.eastmoney.com,1,0.00%,1,0,100.00%
acttg.eastmoney.com,1,0.00%,1,0,100.00%
emhd2.eastmoney.com,1,0.00%,1,0,100.00%
js1.eastmoney.com,1,0.00%,1,0,100.00%
js5.eastmoney.com,1,0.00%,1,0,100.00%
jywg.18.cn,1,0.00%,1,0,100.00%
qs.dfcfw.com,1,0.00%,1,0,100.00%
trade.1234567.com.cn,1,0.00%,1,0,100.00%
trade6.1234567.com.cn,1,0.00%,1,0,100.00%
www.langke.com,1,0.00%,1,0,100.00%
www.shjbzx.cn,1,0.00%,1,0,100.00%
emdesk.eastmoney.com,1,0.00%,1,0,100.00%
help.eastmoney.com,1,0.00%,1,0,100.00%
www.amazon.com,1,0.00%,2,1,50.00%
c.si.gov.cn,1,0.00%,1,0,100.00%
poi-pic.cdn.bcebos.com,1,0.00%,2,1,50.00%
zhifu.cnki.net,1,0.00%,1,0,100.00%
oauth.cnki.net,1,0.00%,1,0,100.00%
my.cnki.net,1,0.00%,1,0,100.00%
api.liebao.cn,1,0.00%,1,0,100.00%
url-query.api.pc120.com,1,0.00%,1,0,100.00%
uslos.zspol.tk,1,0.00%,1,0,100.00%
smokair.co.uk,1,0.00%,1,0,100.00%
home.pain-diary.com,1,0.00%,1,0,100.00%
flipbot.uberflip.com,1,0.00%,1,0,100.00%
gitlab.krier-information.de,1,0.00%,1,0,100.00%
netapp.workspot.com,1,0.00%,1,0,100.00%
kefu.brjogo.com,1,0.00%,1,0,100.00%
folawejwebapp.folawej.com,1,0.00%,1,0,100.00%
bestellung.kismet-mangal.de,1,0.00%,1,0,100.00%
usd.opai.io,1,0.00%,1,0,100.00%
azureedge.mdc.akamaized.net,1,0.00%,2,1,50.00%
a1879.dscw14.akamai.net,1,0.00%,2,1,50.00%
hnd-mvp.trafficmanager.net,1,0.00%,2,1,50.00%
w2gc.herokuapp.com,1,0.00%,1,0,100.00%
tracker.slowcheetah.org,1,0.00%,1,0,100.00%
fundlc.eastmoney.com,1,0.00%,1,0,100.00%
faxian.1234567.com.cn,1,0.00%,1,0,100.00%
fundsc.eastmoney.com,1,0.00%,1,0,100.00%
fundzt.eastmoney.com,1,0.00%,1,0,100.00%
login.1234567.com.cn,1,0.00%,1,0,100.00%
register.1234567.com.cn,1,0.00%,1,0,100.00%
blob.dz6prdstr05a.store.core.windows.net,1,0.00%,1,0,100.00%
www.zhhbiqu.com,1,0.00%,2,1,50.00%
jrsecstatic.jdpay.com,1,0.00%,1,0,100.00%
gitlab.kdsec.org,1,0.00%,1,0,100.00%
gitlab2.kdsec.org,1,0.00%,1,0,100.00%
marbleuk.co.uk,1,0.00%,1,0,100.00%
success.jdpay.com,1,0.00%,1,0,100.00%
ms.jr.jd.com,1,0.00%,1,0,100.00%
admin.staging.speedleasing.com,1,0.00%,1,0,100.00%
imgehall.ucas.ac.cn,1,0.00%,1,0,100.00%
dimg04.c-ctrip.com,1,0.00%,2,1,50.00%
roundrobin.sinakfim.erp.sina.com.cn,1,0.00%,1,0,100.00%
information.casip.ac.cn,1,0.00%,1,0,100.00%
daren.xiaoziwei.tk,1,0.00%,1,0,100.00%
disc801.prod.do.dsp.mp.microsoft.com.edgekey.net,1,0.00%,1,0,100.00%
mail.zhile.ml,1,0.00%,1,0,100.00%
js.cgpnews.cn,1,0.00%,1,0,100.00%
search.ccgp.gov.cn,1,0.00%,1,0,100.00%
www.ccgp-fujian.gov.cn,1,0.00%,1,0,100.00%
www.ccgp-shanxi.gov.cn,1,0.00%,1,0,100.00%
www.ccgp-sichuan.gov.cn,1,0.00%,1,0,100.00%
www.ccgp-xinjiang.gov.cn,1,0.00%,1,0,100.00%
www.ccgp-xizang.gov.cn,1,0.00%,1,0,100.00%
www.ccgp-zhejiang.gov.cn,1,0.00%,1,0,100.00%
www.plap.cn,1,0.00%,1,0,100.00%
www.ccgp-guangdong.gov.cn,1,0.00%,1,0,100.00%
www.ccgp-yunnan.gov.cn,1,0.00%,1,0,100.00%
www.ccgp-guangxi.gov.cn,1,0.00%,1,0,100.00%
www.ccgp-guizhou.gov.cn,1,0.00%,1,0,100.00%
www.ccgp-hainan.gov.cn,1,0.00%,1,0,100.00%
www.ccgp-heilongj.gov.cn,1,0.00%,1,0,100.00%
www.ccgp-henan.gov.cn,1,0.00%,1,0,100.00%
www.ccgp-hubei.gov.cn,1,0.00%,1,0,100.00%
www.ccgp-hunan.gov.cn,1,0.00%,1,0,100.00%
www.ccgp-jiangsu.gov.cn,1,0.00%,1,0,100.00%
www.ccgp-jiangxi.gov.cn,1,0.00%,1,0,100.00%
www.ccgp-liaoning.gov.cn,1,0.00%,1,0,100.00%
www.ccgp-ningxia.gov.cn,1,0.00%,1,0,100.00%
www.ccgp-qinghai.gov.cn,1,0.00%,1,0,100.00%
www.ccgp-shaanxi.gov.cn,1,0.00%,1,0,100.00%
www.ccgp-shandong.gov.cn,1,0.00%,1,0,100.00%
www.ccgp-shanghai.gov.cn,1,0.00%,1,0,100.00%
bd0.d.meituan.net,1,0.00%,1,0,100.00%
s0.d.meituan.net,1,0.00%,1,0,100.00%
videoimg.ws.126.net,1,0.00%,1,0,100.00%
phonecallapi.micloud.xiaomi.net,1,0.00%,1,0,100.00%
ttpcstatic.dftoutiao.com,1,0.00%,1,0,100.00%
dnvp.xsvncxh.cn,1,0.00%,1,0,100.00%
shzzzz.dftoutiao.com,1,0.00%,1,0,100.00%
open.e.kuaishou.cn,1,0.00%,1,0,100.00%
dspadlogger.waimai.meituan.com,1,0.00%,1,0,100.00%
dnkeeper.dbankcloud.com,1,0.00%,1,0,100.00%
hisearch-drcn.dt.dbankcloud.com,1,0.00%,1,0,100.00%
pushservice-drcn.dt.dbankcloud.cn,1,0.00%,1,0,100.00%
i-bn2b-cor002.api.p001.1drv.com,1,0.00%,1,0,100.00%
tbm.snssdk.com,1,0.00%,1,0,100.00%
subca.ocsp-certum.com,1,0.00%,2,1,50.00%
s.pdfxd.com,1,0.00%,1,0,100.00%
t4s.cdn2020.com,1,0.00%,1,0,100.00%
abudhabiculture-ae.mail.protection.outlook.com,1,0.00%,1,0,100.00%
mail.quifonbay.tk,1,0.00%,1,0,100.00%
acl.dns.ripn.net,1,0.00%,2,1,50.00%
tw1.yoyovpn.org,1,0.00%,1,0,100.00%
wiki.absorto.dev,1,0.00%,1,0,100.00%
cctkd.classic.kicksite.net,1,0.00%,1,0,100.00%
start.xdiarys.com,1,0.00%,1,0,100.00%
jdw.jd.hk,1,0.00%,1,0,100.00%
upload-images.jianshu.io,1,0.00%,2,1,50.00%
demo.untangle.com,1,0.00%,1,0,100.00%
metrics-drcn.dt.hihonorcloud.com,1,0.00%,1,0,100.00%
sentry.mihoyo.com,1,0.00%,1,0,100.00%
best.qq.com.legodlied1.sched.dcloudstc.com,1,0.00%,1,0,100.00%
sunderlandhairandbeauty.co.uk,1,0.00%,1,0,100.00%
1610071456.D4EE073C2A20.device.hiwifi.com,1,0.00%,1,0,100.00%
1610071492.D4EE073C2A20.device.hiwifi.com,1,0.00%,1,0,100.00%
1610071553.D4EE073C2A20.device.hiwifi.com,1,0.00%,1,0,100.00%
tk.yycat.tk,1,0.00%,1,0,100.00%
jornada.com.mx,1,0.00%,1,0,100.00%
evo.yuncasa00003.ml,1,0.00%,1,0,100.00%
nfa.futalin.tk,1,0.00%,1,0,100.00%
WWw.Vod.LXdNS.cOM,1,0.00%,2,1,50.00%
larosedev.technucom.com,1,0.00%,1,0,100.00%
static-dev-es.pelckmansportail.be,1,0.00%,1,0,100.00%
v3-litea.douyinvod.com,1,0.00%,1,0,100.00%
mail.carrierservicezinc.ml,1,0.00%,1,0,100.00%
recv-wd.gridsumdissector.com,1,0.00%,1,0,100.00%
httpdns.meituan.com,1,0.00%,1,0,100.00%
appresource-gw-drcn.hispace.hihonorcloud.com,1,0.00%,1,0,100.00%
tt1.moonbase.life,1,0.00%,1,0,100.00%
tracker2.ctix.cn,1,0.00%,1,0,100.00%
smoot-feedback.v.aaplimg.com,1,0.00%,1,0,100.00%
p22-calendars.icloud.com,1,0.00%,2,1,50.00%
jp.wocwoc.ga,1,0.00%,1,0,100.00%
operationposition-drcn.things.dbankcloud.com,1,0.00%,1,0,100.00%
res.njxzwh.com,1,0.00%,2,1,50.00%
c.a.spush.com,1,0.00%,2,1,50.00%
515537a2e128a431079fc5fcfe2e6aa0.safeframe.googlesyndication.com,1,0.00%,1,0,100.00%
www.coonote.com,1,0.00%,1,0,100.00%
static.coonote.com,1,0.00%,2,1,50.00%
eclipse.org,1,0.00%,1,0,100.00%
download.eclipse.org,1,0.00%,1,0,100.00%
ip.kugou.com,1,0.00%,1,0,100.00%
api.io.mi.com,1,0.00%,2,1,50.00%
business.smartcamera.api.io.mi.com,1,0.00%,1,0,100.00%
cdn.experiment.xiaomi.com,1,0.00%,1,0,100.00%
tp.hd.mi.com,1,0.00%,1,0,100.00%
sync-dsp.ad-m.asia,1,0.00%,1,0,100.00%
www.creditxj.gov.cn,1,0.00%,1,0,100.00%
www.jszwfw.gov.cn,1,0.00%,2,1,50.00%
rtb.gumgum.com,1,0.00%,1,0,100.00%
brichi.oss-cn-beijing.aliyuncs.com,1,0.00%,1,0,100.00%
gqux.herokuapp.com,1,0.00%,1,0,100.00%
open-knowledge-institutions.pubpub.org,1,0.00%,1,0,100.00%
cardarelli-massaua.edu.it,1,0.00%,1,0,100.00%
direwolf-a39f441315.herokuapp.com,1,0.00%,1,0,100.00%
mail.ukknowlegefree39.ga,1,0.00%,1,0,100.00%
1608234630.D4EE071FA772.device.hiwifi.com,1,0.00%,1,0,100.00%
demo.socialacademy.me,1,0.00%,1,0,100.00%
ewmiyg.a19qiang.ga,1,0.00%,1,0,100.00%
new.challengemachine.com,1,0.00%,1,0,100.00%
nexus6.cdnrobot.xyz,1,0.00%,1,0,100.00%
web2.take2dev.com,1,0.00%,1,0,100.00%
premium.vnr.de,1,0.00%,1,0,100.00%
v5-lite.douyinvod.com,1,0.00%,1,0,100.00%
v26-litea.douyinvod.com,1,0.00%,1,0,100.00%
9ys.skl9a.ga,1,0.00%,1,0,100.00%
api.officescripts.microsoftusercontent.com,1,0.00%,1,0,100.00%
request.sosabrothers.com,1,0.00%,1,0,100.00%
cdn.officialbrand.store,1,0.00%,1,0,100.00%
p101.music.126.net,1,0.00%,2,1,50.00%
anndo-blog.logdown.com,1,0.00%,1,0,100.00%
93d44acec907399768c03ddc602cb180.safeframe.googlesyndication.com,1,0.00%,1,0,100.00%
res.cdn.openinstall.io,1,0.00%,2,1,50.00%
qq-web.cdn-go.cn,1,0.00%,2,1,50.00%
bbs.freekaoyan.com,1,0.00%,1,0,100.00%
kzyjc.alljournals.cn,1,0.00%,1,0,100.00%
download.bitcomet.com,1,0.00%,1,0,100.00%
www.woniu1888.com,1,0.00%,1,0,100.00%
test.xinxiyidiantong.com,1,0.00%,1,0,100.00%
www.yw104.com,1,0.00%,1,0,100.00%
hihsp.com,1,0.00%,1,0,100.00%
www.hihsp.com,1,0.00%,1,0,100.00%
www.sexmm1.top,1,0.00%,1,0,100.00%
www.ytwwe.top,1,0.00%,1,0,100.00%
www.majiamen.com,1,0.00%,1,0,100.00%
mms-mis.cdn.bcebos.com,1,0.00%,1,0,100.00%
aop47.com,1,0.00%,1,0,100.00%
iknight.icu,1,0.00%,1,0,100.00%
w-t4483589102640134410.id.amgdgt.com,1,0.00%,1,0,100.00%
bcp.crwdcntrl.net,1,0.00%,2,1,50.00%
pixel.onaudience.com,1,0.00%,1,0,100.00%
bt1207fo.xyz,1,0.00%,1,0,100.00%
s4.histats.com,1,0.00%,1,0,100.00%
e.dtscout.com,1,0.00%,1,0,100.00%
t.dtscdn.com,1,0.00%,1,0,100.00%
t.dtscout.com,1,0.00%,1,0,100.00%
connect-metrics-collector.s-onetag.com,1,0.00%,1,0,100.00%
mid.rkdms.com,1,0.00%,1,0,100.00%
mobsec-sec.baidu.com,1,0.00%,2,1,50.00%
8.app.myclapp.de,1,0.00%,1,0,100.00%
mail.xn--42c7apbv2bb5dxb1d.cf,1,0.00%,1,0,100.00%
discourse.axelerant.com,1,0.00%,1,0,100.00%
e110177.f.akamaiedge.net,1,0.00%,1,0,100.00%
1608234681.D4EE071FA772.device.hiwifi.com,1,0.00%,1,0,100.00%
suomenkattocenter.sunenergia.com,1,0.00%,1,0,100.00%
strongnet.nutrislice.com,1,0.00%,1,0,100.00%
singer-slackin.herokuapp.com,1,0.00%,1,0,100.00%
tr.graymiller.ga,1,0.00%,1,0,100.00%
salvacomidas.eitfood.eu,1,0.00%,1,0,100.00%
catalog.gamepass.com.edgesuite.net,1,0.00%,2,1,50.00%
gaming-config.asus.com,1,0.00%,1,0,100.00%
rls-proxy-01.chinaeast2.cloudapp.chinacloudapi.cn,1,0.00%,1,0,100.00%
api-cdn.kylinos.cn.w.kunlunca.com,1,0.00%,1,0,100.00%
kaiji.ts.2345.com,1,0.00%,1,0,100.00%
ip1880707524.funshion.com,1,0.00%,1,0,100.00%
vpn.cmsanmichele.it,1,0.00%,1,0,100.00%
tequila.zolly.ml,1,0.00%,1,0,100.00%
phpmyadmin-schunck.increaseyourskills.com,1,0.00%,1,0,100.00%
tracking.oneminorder.com,1,0.00%,1,0,100.00%
client.bettaway.com,1,0.00%,1,0,100.00%
shopify.privy-staging-pr-3451.privy-staging.com,1,0.00%,1,0,100.00%
direwolf-80ce9f3842.herokuapp.com,1,0.00%,1,0,100.00%
direwolf-88f63ff6ed.herokuapp.com,1,0.00%,1,0,100.00%
aldar-com.mail.protection.outlook.com,1,0.00%,1,0,100.00%
1608234722.D4EE071FA772.device.hiwifi.com,1,0.00%,1,0,100.00%
m.t.linwen.com,1,0.00%,1,0,100.00%
mail.liticonmetourpa.tk,1,0.00%,1,0,100.00%
test.druckterminal.de,1,0.00%,1,0,100.00%
a10-64.akam.net,1,0.00%,1,0,100.00%
jp.fqss.tk,1,0.00%,1,0,100.00%
mail.toplines69.ml,1,0.00%,1,0,100.00%
autotic.com.br,1,0.00%,1,0,100.00%
h21k.fragforce.org,1,0.00%,1,0,100.00%
david666.51vip.biz,1,0.00%,1,0,100.00%
e2c19.gcp.gvt2.com,1,0.00%,1,0,100.00%
voicegenx.niftyquoter.com,1,0.00%,1,0,100.00%
msg-frontier.feishu.cn,1,0.00%,1,0,100.00%
www.bbsmax.com,1,0.00%,1,0,100.00%
a923a2f96e9f95157dadf41e586b814e.safeframe.googlesyndication.com,1,0.00%,1,0,100.00%
www.vipglobal.hk,1,0.00%,1,0,100.00%
smvconf.f.360.cn,1,0.00%,1,0,100.00%
configdownload-drcn.hihonorcdn.com,1,0.00%,1,0,100.00%
ip2091323408.funshion.com,1,0.00%,1,0,100.00%
139-177-195-31.15c9f2e79c4d4beca205766bdb7bc2ea.plex.direct,1,0.00%,1,0,100.00%
i-dm3-cor003.api.p001.1drv.com,1,0.00%,1,0,100.00%
support.aivahthemes.com,1,0.00%,1,0,100.00%
app.sellosatiempo.com,1,0.00%,1,0,100.00%
mail.mycodenet.ml,1,0.00%,1,0,100.00%
syd.eggrice.ml,1,0.00%,1,0,100.00%
guildfordsunset.fc-dev.biz,1,0.00%,1,0,100.00%
mail.dinconsrasarara.tk,1,0.00%,1,0,100.00%
cdn242.cdngig.net,1,0.00%,1,0,100.00%
any-json2html.lkatney.com,1,0.00%,1,0,100.00%
files5.top-androidd.ru,1,0.00%,1,0,100.00%
oauth-login-dra.platform.dbankcloud.com,1,0.00%,1,0,100.00%
mres.ximalaya.com,1,0.00%,1,0,100.00%
mobwsa.ximalaya.com,1,0.00%,1,0,100.00%
teacher.cyc.org.tw,1,0.00%,1,0,100.00%
app.shopmium.com,1,0.00%,1,0,100.00%
mail.tesoreria01.ga,1,0.00%,1,0,100.00%
mail.ionsprohair.ml,1,0.00%,1,0,100.00%
promotions.privy-staging-pr-3286.privy-staging.com,1,0.00%,1,0,100.00%
log.getadblock.com,1,0.00%,1,0,100.00%
muenster.studentenring.de,1,0.00%,1,0,100.00%
ray.fengjing.ml,1,0.00%,1,0,100.00%
e2c54.gcp.gvt2.com,1,0.00%,1,0,100.00%
lkiksdhxpcps.phone-delivery.com,1,0.00%,1,0,100.00%
app.josephprince.com,1,0.00%,1,0,100.00%
arrowmaf.classic.kicksite.net,1,0.00%,1,0,100.00%
blago.km.ua,1,0.00%,1,0,100.00%
lifeskills.nafham.com,1,0.00%,1,0,100.00%
xiaomi.ceping.com,1,0.00%,1,0,100.00%
4.url.cn,1,0.00%,1,0,100.00%
slp2p-east-std25.oray.net,1,0.00%,1,0,100.00%
v1conf.darwin.kuiniuca.com,1,0.00%,1,0,100.00%
qypxstudy.dongao.com,1,0.00%,1,0,100.00%
onepass.geetest.com,1,0.00%,1,0,100.00%
cm-10-32.getui.com,1,0.00%,1,0,100.00%
ke-image.ljcdn.com,1,0.00%,2,1,50.00%
waimai-guide.ele.me,1,0.00%,2,1,50.00%
secgw-na61-na62.wagbridge.alibaba.tanx.com.gds.alibabadns.com,1,0.00%,1,0,100.00%
err.taobao.com,1,0.00%,2,1,50.00%
nr-op.elemecdn.com,1,0.00%,2,1,50.00%
ea119.wagbridge.alsc-prd.tanx.com.gds.alibabadns.com,1,0.00%,2,1,50.00%
error.taobao.com,1,0.00%,2,1,50.00%
ip.360.cn,1,0.00%,1,0,100.00%
swissbiomechanics.qualisys.com,1,0.00%,1,0,100.00%
1610067826.D4EE073C2A20.device.hiwifi.com,1,0.00%,1,0,100.00%
1610067846.D4EE073C2A20.device.hiwifi.com,1,0.00%,1,0,100.00%
1610067887.D4EE073C2A20.device.hiwifi.com,1,0.00%,1,0,100.00%
calendar.theradiantsociety.org,1,0.00%,1,0,100.00%
api.privy-staging-pr-3373.privy-staging.com,1,0.00%,1,0,100.00%
api.projecthope.org.do,1,0.00%,1,0,100.00%
wwW.vOd.lxdns.COM,1,0.00%,2,1,50.00%
automotive.interpon.com,1,0.00%,1,0,100.00%
icpai2020-esunbank.taai.org.tw,1,0.00%,1,0,100.00%
vhelp.herokuapp.com,1,0.00%,1,0,100.00%
mail2.admedia.ae,1,0.00%,1,0,100.00%
mail1.admedia.ae,1,0.00%,1,0,100.00%
pretium.safi.ai,1,0.00%,1,0,100.00%
gzlvicxrkcgk.phone-delivery.com,1,0.00%,1,0,100.00%
host.qqfi.tk,1,0.00%,1,0,100.00%
jp-s1.fatvpn.ml,1,0.00%,1,0,100.00%
alibabacdn.gds.aliyuncdn.space,1,0.00%,1,0,100.00%
nrri1ztyjvaohvsry8czylwggdugtm4t.aligfwaf.com,1,0.00%,1,0,100.00%
www.net.cn,1,0.00%,1,0,100.00%
cars.lrworld.com.gr,1,0.00%,1,0,100.00%
zziei4bmmcmqxvdlckimig7n2mgf1317.yundunwaf.com,1,0.00%,1,0,100.00%
iccsie2022.iaast.net,1,0.00%,1,0,100.00%
zn0ktqraj4o1tkoyarmizmo3xz9bokm9.aligfwaf.com,1,0.00%,1,0,100.00%
cmnrkneprcam.phone-delivery.com,1,0.00%,1,0,100.00%
plt.gymcommerce.co.uk,1,0.00%,1,0,100.00%
h3mnk9.preta.menu,1,0.00%,1,0,100.00%
x.welcomid.tk,1,0.00%,1,0,100.00%
apps.corel.com,1,0.00%,1,0,100.00%
ocspx.digicert.com,1,0.00%,2,1,50.00%
DSANY.SGNIC.SG,1,0.00%,2,1,50.00%
DSANY2.SGNIC.SG,1,0.00%,2,1,50.00%
DSANY3.SGNIC.SG,1,0.00%,2,1,50.00%
wWW.voD.lXdns.COm,1,0.00%,2,1,50.00%
testtest.dynv6.net,1,0.00%,1,0,100.00%
wwww.marinemotion.com,1,0.00%,1,0,100.00%
staging-athome.nurvecloud.com,1,0.00%,1,0,100.00%
pomerelle-estore.entabeni.tech,1,0.00%,1,0,100.00%
mail.fortulizu.cf,1,0.00%,1,0,100.00%
umasocksproxy.mail.qq.com,1,0.00%,1,0,100.00%
fgo.wiki.w.kunlungr.com,1,0.00%,1,0,100.00%
u.thsi.cn,1,0.00%,1,0,100.00%
i-sat02p-cor001.api.p001.1drv.com,1,0.00%,1,0,100.00%
www.google.com.sg,1,0.00%,2,1,50.00%
suggestqueries-clients6.youtube.com,1,0.00%,2,1,50.00%
4v50b4t1.sched.sma-dk.tdnsstic1.cn,1,0.00%,2,1,50.00%
lucloud01.gslb.ugslb.net,1,0.00%,1,0,100.00%
cdn.openfin.co,1,0.00%,1,0,100.00%
mail.miaadvertising.com,1,0.00%,1,0,100.00%
mail.phirevalless.cf,1,0.00%,1,0,100.00%
stage.sailingnations.com,1,0.00%,1,0,100.00%
d2t77mnxyo7adj.cloudfront.net,1,0.00%,1,0,100.00%
proposals.carefox.co,1,0.00%,1,0,100.00%
2fwww.1ktips.com,1,0.00%,1,0,100.00%
rr1.aeej.ga,1,0.00%,1,0,100.00%
1610060660.D4EE073C2A20.device.hiwifi.com,1,0.00%,1,0,100.00%
1610060681.D4EE073C2A20.device.hiwifi.com,1,0.00%,1,0,100.00%
1610060702.D4EE073C2A20.device.hiwifi.com,1,0.00%,1,0,100.00%
r6---sn-u4o-u2x6.gvt1.com,1,0.00%,2,1,50.00%
r2---sn-npoe7n7y.gvt1.com,1,0.00%,2,1,50.00%
crl.root-x1.letsencrypt.org.edgekey.net,1,0.00%,2,1,50.00%
postmaster.app.investnext.com,1,0.00%,1,0,100.00%
log-sdk.clickwifi.net,1,0.00%,1,0,100.00%
alb-4hw1ui3pquipm8zwfn.cn-beijing.alb.aliyuncs.com,1,0.00%,1,0,100.00%
rr4---sn-npoldn7s.googlevideo.com,1,0.00%,3,2,33.33%
prd-elb-conn-cnnw1-0-959062569.cn-northwest-1.elb.amazonaws.com.cn,1,0.00%,1,0,100.00%
ol08.foot5176.cf,1,0.00%,1,0,100.00%
mail.her-web.tk,1,0.00%,1,0,100.00%
vip-eu193.qqupload.com,1,0.00%,1,0,100.00%
ukv.share2vip.com,1,0.00%,1,0,100.00%
s149.convertio.me,1,0.00%,1,0,100.00%
2097221.luxuryrealestate.com,1,0.00%,1,0,100.00%
hubcovid.org.br,1,0.00%,1,0,100.00%
direwolf-6ee3875457.herokuapp.com,1,0.00%,1,0,100.00%
timeline.jamessugrue.ie,1,0.00%,1,0,100.00%
image.mileu.ml,1,0.00%,1,0,100.00%
web.getplano.com,1,0.00%,1,0,100.00%
themusthaves.returnista.nl,1,0.00%,1,0,100.00%
lp-staging.fivestreet.me,1,0.00%,1,0,100.00%
ns2.blrb.tk,1,0.00%,1,0,100.00%
mail.communicat-o.com,1,0.00%,1,0,100.00%
sdk.look.360.cn,1,0.00%,1,0,100.00%
yule.dhrest.com,1,0.00%,1,0,100.00%
bfdh.herokuapp.com,1,0.00%,1,0,100.00%
v6-x.toutiaovod.com,1,0.00%,2,1,50.00%
v26-x.toutiaovod.com,1,0.00%,2,1,50.00%
lf3-orange.byteorge.com,1,0.00%,2,1,50.00%
audit.aaa.mgtv.com,1,0.00%,1,0,100.00%
apperr.log.mgtv.com,1,0.00%,1,0,100.00%
weread-1258476243.file.myqcloud.com,1,0.00%,2,1,50.00%
nibbmibanning-blog.logdown.com,1,0.00%,1,0,100.00%
lfcc.360members.com,1,0.00%,1,0,100.00%
mail.seogesgeragmi.ga,1,0.00%,1,0,100.00%
mirrors.ubuntu.com,1,0.00%,1,0,100.00%
store.working-photographs.com,1,0.00%,1,0,100.00%
campus-im-stift-neuzelle.schul-webportal.de,1,0.00%,1,0,100.00%
av2.nstld.com,1,0.00%,2,1,50.00%
cloudphoto.cn-shanghai.aliyuncs.com,1,0.00%,1,0,100.00%
courier-ab-vs.push.apple.com,1,0.00%,2,1,50.00%
courier-ab-vs.push-apple.com.akadns.net,1,0.00%,2,1,50.00%
keke3.duplus520.ml,1,0.00%,1,0,100.00%
de.wikinews.ahmu.cf,1,0.00%,1,0,100.00%
schola-medica.eduframe.nl,1,0.00%,1,0,100.00%
publicslack.hammerlab.org,1,0.00%,1,0,100.00%
smtp.albioneducation.co.uk,1,0.00%,1,0,100.00%
cs17.clideo.com,1,0.00%,1,0,100.00%
3.1808.cf,1,0.00%,1,0,100.00%
360.dallassuiteshotel.com,1,0.00%,1,0,100.00%
e15275.g.akamaiedge.net.0.1.cn.akamaiedge.net,1,0.00%,1,0,100.00%
mail.tockhundieclaper.cf,1,0.00%,1,0,100.00%
s.safe.360.cn.webcdn.360qhcdn.com,1,0.00%,2,1,50.00%
dns4.easydns.info,1,0.00%,4,3,25.00%
e-cloudstore.com,1,0.00%,1,0,100.00%
bramblemet.co.uk,1,0.00%,1,0,100.00%
gdch001.gd3467.ml,1,0.00%,1,0,100.00%
details.jd.com,1,0.00%,2,1,50.00%
testers.privy-staging-pr-8093.privy-staging.com,1,0.00%,1,0,100.00%
viptb.323391s.xyz,1,0.00%,1,0,100.00%
my-gym-age.socialacademy.me,1,0.00%,1,0,100.00%
rest.mobilerealtyapps.com,1,0.00%,1,0,100.00%
lk.sofit-spb.ru,1,0.00%,1,0,100.00%
map.claimmyrun.com,1,0.00%,1,0,100.00%
dmm-game-got1025.gdsrx888.com,1,0.00%,1,0,100.00%
firmwareupdate.hpbp.io,1,0.00%,1,0,100.00%
ocsp.startssl.com,1,0.00%,1,0,100.00%
s2.vip.wpscdn.cn,1,0.00%,2,1,50.00%
ucpop.browser.360.cn,1,0.00%,1,0,100.00%
p1.ssl.qhimgs4.com,1,0.00%,1,0,100.00%
p0.ssl.qhimgs4.com,1,0.00%,1,0,100.00%
p18.ssl.qhimgs3.com,1,0.00%,1,0,100.00%
guoxue.baike.so.com,1,0.00%,1,0,100.00%
s2.qhimg.com,1,0.00%,1,0,100.00%
s0.qhimg.com,1,0.00%,1,0,100.00%
s5.qhimg.com,1,0.00%,1,0,100.00%
s2.qhres2.com,1,0.00%,1,0,100.00%
p.sug.so.com,1,0.00%,1,0,100.00%
apistore.360.cn,1,0.00%,1,0,100.00%
cm-188-171-3-117.telecable.es,1,0.00%,1,0,100.00%
ml-eu.globenewswire.com,1,0.00%,1,0,100.00%
messe-berlin.universal-messenger.cloud,1,0.00%,1,0,100.00%
v.browser.360.cn,1,0.00%,1,0,100.00%
school.usefedorastage-pr-9847.devenv.website,1,0.00%,1,0,100.00%
ww2.paepsy-erbach.de,1,0.00%,1,0,100.00%
de1.huoxing.me,1,0.00%,1,0,100.00%
twjy-common.jykiwi.com,1,0.00%,1,0,100.00%
libertyfund.e3dev.host,1,0.00%,1,0,100.00%
app.yearly.report,1,0.00%,1,0,100.00%
tendances.expograph.com,1,0.00%,1,0,100.00%
decorsave.co.uk,1,0.00%,1,0,100.00%
acute.large-receipt.cf,1,0.00%,1,0,100.00%
partnerweb.cdnswitch.vmware.com,1,0.00%,2,1,50.00%
elsicon2022.exordo.com,1,0.00%,1,0,100.00%
api.checklyhq.com,1,0.00%,1,0,100.00%
backoffice.lamallefrancaise.com,1,0.00%,1,0,100.00%
ofisu.co.th,1,0.00%,1,0,100.00%
tl9yv667tkw07xdc.aliyunddos1013.com,1,0.00%,1,0,100.00%
pdfwifi.com,1,0.00%,1,0,100.00%
v11.sched.v4lego-dk.tdnsvod1.cn.cvod.cdn.bjys.ysidcz.com,1,0.00%,2,1,50.00%
appconfig-svc.s3.us-west-2.amazonaws.com,1,0.00%,1,0,100.00%
a95-94-19-59.cpe.netcabo.pt,1,0.00%,1,0,100.00%
xfile2.a.88cdn.com,1,0.00%,2,1,50.00%
download-cdn.jetbrains.com,1,0.00%,2,1,50.00%
calskico.pulsefitassistant.com,1,0.00%,1,0,100.00%
cidadedemocratica.org.br,1,0.00%,1,0,100.00%
vv.wells20.ml,1,0.00%,1,0,100.00%
webmail.juhryexcellent.cf,1,0.00%,1,0,100.00%
frp.cheng.tk,1,0.00%,1,0,100.00%
guides.trustyay.com,1,0.00%,1,0,100.00%
threshold.freedynamicdns.org,1,0.00%,1,0,100.00%
conferences.voiceland.gr,1,0.00%,1,0,100.00%
www2.andreas-schroeer.de,1,0.00%,1,0,100.00%
amda.dorishui.ga,1,0.00%,1,0,100.00%
cu5cf0.2adh.layo.cf,1,0.00%,1,0,100.00%
3wabxy9b.sched.sma.tdnsstic1.cn.cjt.krcdn.idatacube.com,1,0.00%,1,0,100.00%
r3.sn-ni5een7e.gvt1.com,1,0.00%,1,0,100.00%
p60-buy-lb.itunes-apple.com.akadns.net,1,0.00%,1,0,100.00%
v11-cold1.sched.v4legocold1-dk.tdnsvod1.cn,1,0.00%,2,1,50.00%
sptest.n.shifen.com,1,0.00%,1,0,100.00%
nmtest.bdstatic.com.a.bdydns.com,1,0.00%,1,0,100.00%
unagi-na.amazon.com,1,0.00%,1,0,100.00%
conn5.coloros.com,1,0.00%,1,0,100.00%
conn5.coloros.com.w.alikunlun.com,1,0.00%,1,0,100.00%
conn4.coloros.com.ctdns.cn,1,0.00%,1,0,100.00%
cde-ta-g7g.amazon.com,1,0.00%,1,0,100.00%
notice.ecourse.ucas.ac.cn,1,0.00%,1,0,100.00%
cde-ta-g7g.amazon.cn,1,0.00%,1,0,100.00%
tangram-config.gdt.qq.com.mid.tdnsv6.com,1,0.00%,1,0,100.00%
c.media-amazon.com,1,0.00%,2,1,50.00%
gaoneng.bilibili.com.w.cdngslb.com,1,0.00%,1,0,100.00%
lbsugc.cdn.bcebos.com.a.bdydns.com,1,0.00%,1,0,100.00%
opencdncloud.jomodns.com,1,0.00%,1,0,100.00%
edge-west.customer.io,1,0.00%,1,0,100.00%
v.icbc.com.cn,1,0.00%,2,1,50.00%
zenodo.org,1,0.00%,1,0,100.00%
openplat.gamesafe.qq.com,1,0.00%,1,0,100.00%
geoname-lookup.ubuntu.com,1,0.00%,1,0,100.00%
mail.salkic.co.ba,1,0.00%,1,0,100.00%
agm-location001.sparkmeter.cloud,1,0.00%,1,0,100.00%
feveridc.computitionhq.ca,1,0.00%,1,0,100.00%
clem.cubicspace3d.com,1,0.00%,1,0,100.00%
ipw.ebizmalta.com,1,0.00%,1,0,100.00%
wallpaperempire.co.uk,1,0.00%,1,0,100.00%
mail.portflimortgages.ml,1,0.00%,1,0,100.00%
gamearena.com.ly,1,0.00%,1,0,100.00%
cpcalendars.apelshoes.com,1,0.00%,1,0,100.00%
mail.congreacomfitilu.ml,1,0.00%,1,0,100.00%
service.giosg.com,1,0.00%,1,0,100.00%
tvnihon.com,1,0.00%,1,0,100.00%
bit-hdtv.com,1,0.00%,1,0,100.00%
tribalmixes.com,1,0.00%,1,0,100.00%
tasvideos.org,1,0.00%,2,1,50.00%
abirxo.cf,1,0.00%,1,0,100.00%
shnflac.net,1,0.00%,1,0,100.00%
va04.ingress.herokuapp.com,1,0.00%,1,0,100.00%
tracker.bittorrent.am,1,0.00%,1,0,100.00%
cws.alicdn.com,1,0.00%,1,0,100.00%
gj.mmstat.com,1,0.00%,1,0,100.00%
cloud-assets.alicdn.com.w.cdngslb.com,1,0.00%,1,0,100.00%
cws.alicdn.com.danuoyi.tbcache.com,1,0.00%,1,0,100.00%
uaction.alicdn.com.danuoyi.tbcache.com,1,0.00%,1,0,100.00%
ynuf.alipaydns.com,1,0.00%,1,0,100.00%
na61-na62.wagbridge.noncert.alibaba.com.gds.alibabadns.com,1,0.00%,1,0,100.00%
hw.zuimeitianqi.com.c.cdnhwc1.com,1,0.00%,1,0,100.00%
hw.zuimeitianqi.com.wsglb0.com,1,0.00%,1,0,100.00%
ecs-console-adns-new.console.aliyun.com,1,0.00%,1,0,100.00%
weather-drcn-music-hicloud-com-drcn.appacc.dbankedge.cn,1,0.00%,1,0,100.00%
rds-adns.console.aliyun.com,1,0.00%,1,0,100.00%
ds-2047.oss-acc-allline.aliyuncs.com,1,0.00%,1,0,100.00%
weather-drcn-music-hicloud-com-drcn.appacc-region.dbankedge.cn,1,0.00%,1,0,100.00%
cn-beijing-ds-2047.oss-acc.aliyuncs.com,1,0.00%,1,0,100.00%
one-console-adns-new.console.aliyun.com.gds.alibabadns.com,1,0.00%,2,1,50.00%
one-second-campaign.cn-hangzhou-b.log.aliyuncs.com,1,0.00%,1,0,100.00%
tyjr-cn-shanghai.aliyun.com,1,0.00%,1,0,100.00%
tagr-gcp-xs2-use1.mookie1.com,1,0.00%,1,0,100.00%
cdn.viewdeos.com,1,0.00%,2,1,50.00%
platform.twitter.com,1,0.00%,2,1,50.00%
i-bn3p-cor001.api.p001.1drv.com,1,0.00%,1,0,100.00%
e1.emxdgt.com,1,0.00%,1,0,100.00%
edge.g.yimg.jp,1,0.00%,1,0,100.00%
partners-alb-1113315349.us-east-1.elb.amazonaws.com,1,0.00%,2,1,50.00%
api.microsofttranslator.search.prod.ms.akadns.net,1,0.00%,1,0,100.00%
gtms04.alicdn.com.danuoyi.alicdn.com,1,0.00%,1,0,100.00%
img2.360buyimg.com.gslb.qianxun.com,1,0.00%,2,1,50.00%
img2.360buyimg.com.s.galileo.jcloud-cdn.com,1,0.00%,2,1,50.00%
img2.360buyimg.com.wscdns.com,1,0.00%,2,1,50.00%
availability.fe.apple-dns.cn,1,0.00%,1,0,100.00%
search.itunes.apple.com,1,0.00%,2,1,50.00%
search-cdn.itunes-apple.com.akadns.net,1,0.00%,2,1,50.00%
search-china.itunes-apple.com.akadns.net,1,0.00%,2,1,50.00%
3.cn,1,0.00%,1,0,100.00%
sub.id9.cc,1,0.00%,1,0,100.00%
livechatcdc.dior.cn,1,0.00%,1,0,100.00%
npm.cdn-go.cn,1,0.00%,2,1,50.00%
248c107c47fb4cdb3b1b5f905ffaf822dc415c56.www.galileo.jomodns.com,1,0.00%,1,0,100.00%
api.talentatlas.ee,1,0.00%,1,0,100.00%
ucv2.yunexpress.cn,1,0.00%,1,0,100.00%
easy.otsepost.com,1,0.00%,1,0,100.00%
api.scrapcatalytics.com,1,0.00%,1,0,100.00%
autotirreno.scontrinoshop.com,1,0.00%,1,0,100.00%
tt.kobeobf.tk,1,0.00%,1,0,100.00%
diary.biserkov.com,1,0.00%,1,0,100.00%
b1w72chl.qec.dseoe.ml,1,0.00%,1,0,100.00%
hinet.yundian666.club,1,0.00%,1,0,100.00%
my-veneto-segreto.socialacademy.me,1,0.00%,1,0,100.00%
vmi979140.contaboserver.net,1,0.00%,1,0,100.00%
e10776.b.akamaiedge.net,1,0.00%,1,0,100.00%
global-v2.clearbit.com,1,0.00%,1,0,100.00%
ns51.solindohost.net,1,0.00%,1,0,100.00%
git.linux-kernel.at,1,0.00%,1,0,100.00%
forum.bradleysmoker.com,1,0.00%,1,0,100.00%
WWW.voD.LXDNS.CoM,1,0.00%,2,1,50.00%
143-198-155-251.brd-cdn.com,1,0.00%,1,0,100.00%
shop.oasiswildlifefuerteventura.com,1,0.00%,1,0,100.00%
direwolf-9dc577bed2-renamed.herokuapp.com,1,0.00%,1,0,100.00%
mail2.tdic.ae,1,0.00%,1,0,100.00%
crasheyerp.testplus.cn,1,0.00%,1,0,100.00%
webcert.cnmstl.net,1,0.00%,1,0,100.00%
8dd0cd95-eb93-48d0-ac73-946b62d799ef.booqable.shop,1,0.00%,1,0,100.00%
www.ilovematlab.cn,1,0.00%,1,0,100.00%
download.ilovematlab.cn,1,0.00%,1,0,100.00%
smetrics.ilovematlab.cn,1,0.00%,1,0,100.00%
portal.gov.mo,1,0.00%,1,0,100.00%
help.github.com,1,0.00%,2,1,50.00%
noblegreenwines.co.uk,1,0.00%,1,0,100.00%
twofour54-com.mail.protection.outlook.com,1,0.00%,1,0,100.00%
app.staging.alva.health,1,0.00%,1,0,100.00%
mail.utarlumo.tk,1,0.00%,1,0,100.00%
d10l9zzdlcl6ti.cloudfront.net,1,0.00%,1,0,100.00%
e-art.top,1,0.00%,1,0,100.00%
lavie-design.reserven.jp,1,0.00%,1,0,100.00%
sensorcentral.dev.heisterberg.dk,1,0.00%,1,0,100.00%
7.push2.eastmoney.com,1,0.00%,1,0,100.00%
cohort2020.global360leader.com,1,0.00%,1,0,100.00%
acg.rip,1,0.00%,2,1,50.00%
tracker01.loveapp.com,1,0.00%,1,0,100.00%
recipes.ps1000program.com,1,0.00%,1,0,100.00%
imap.quchant.com,1,0.00%,1,0,100.00%
wWW.vOD.LxdNs.com,1,0.00%,2,1,50.00%
d344ck2ptlkk0f.cloudfront.net,1,0.00%,1,0,100.00%
eservice.transglobe.com.tw,1,0.00%,1,0,100.00%
rn.tkayn.tk,1,0.00%,1,0,100.00%
es.506.io,1,0.00%,1,0,100.00%
campus.sf-express.com,1,0.00%,1,0,100.00%
api.yesspartners.com,1,0.00%,1,0,100.00%
online.deutschklasse.com,1,0.00%,1,0,100.00%
coffeepeople.merada.dev,1,0.00%,1,0,100.00%
mail.zadersradabvahyd.ga,1,0.00%,1,0,100.00%
told.bssdxx.com,1,0.00%,1,0,100.00%
6dfee1b7-bb2a-45cd-81a9-109194d0f758.assets.booqable.com,1,0.00%,1,0,100.00%
vlscppe.microsoft.com,1,0.00%,1,0,100.00%
tr.mypo5.com,1,0.00%,1,0,100.00%
e2c16.gcp.gvt2.com,1,0.00%,1,0,100.00%
lotse.softfair-server.de,1,0.00%,1,0,100.00%
proposals.geocon-solutions.co.uk,1,0.00%,1,0,100.00%
culinartsrdining.nutrislice.com,1,0.00%,1,0,100.00%
yum.dockerproject.org,1,0.00%,1,0,100.00%
msn.com,1,0.00%,1,0,100.00%
prod.detectportal.prod.cloudops.mozgcp.net,0,0.00%,16201,16201,0.00%
dns.msftncsi.com,0,0.00%,30083,30083,0.00%
ntp.ubuntu.com,0,0.00%,384262,384262,0.00%
glb.cws.prod.dcat.dsp.trafficmanager.net,0,0.00%,370,370,0.00%
api.opensubtitles.com,0,0.00%,55,55,0.00%
imap.qq.com,0,0.00%,625,625,0.00%
dual-a-0036.a-msedge.net,0,0.00%,614,614,0.00%
dav.qq.com,0,0.00%,177,177,0.00%
ins-2n7ixenz.ias.tencent-cloud.net,0,0.00%,29,29,0.00%
example.org,0,0.00%,3800,3800,0.00%
www.cordcloud.one,0,0.00%,17,17,0.00%
localhost,0,0.00%,14363,14363,0.00%
localhost.localdomain,0,0.00%,65,65,0.00%
time.apple.com,0,0.00%,663,663,0.00%
dns.google,0,0.00%,6790,6790,0.00%
potuk.com,0,0.00%,1244,1244,0.00%
siambit.com,0,0.00%,8673,8673,0.00%
szextshort.weixin.qq.com,0,0.00%,783,783,0.00%
h5.qzone.qq.com,0,0.00%,3777,3777,0.00%
peersteers.org,0,0.00%,1329,1329,0.00%
api.blockcypher.com,0,0.00%,652,652,0.00%
db.local.clamav.net,0,0.00%,5593,5593,0.00%
dns.weixin.qq.com.cn,0,0.00%,3219,3219,0.00%
az700632.vo.msecnd.net,0,0.00%,568,568,0.00%
analysis-acc-ssl.xunlei.com,0,0.00%,272,272,0.00%
0d.kebhana.mx,0,0.00%,142,142,0.00%
tracker.nanoha.org,0,0.00%,297,297,0.00%
all4nothin.net,0,0.00%,160,160,0.00%
www.21cn.com,0,0.00%,12,12,0.00%
edgedl.me.gvt1.com,0,0.00%,477,477,0.00%
w.wwwww.wtf,0,0.00%,261,261,0.00%
swh.app,0,0.00%,75,75,0.00%
news.qq.com,0,0.00%,14,14,0.00%
wx.qlogo.cn,0,0.00%,2079,2079,0.00%
dns.weixin.qq.com,0,0.00%,478,478,0.00%
badjs.weixinbridge.com,0,0.00%,373,373,0.00%
mp.weixin.qq.com,0,0.00%,349,349,0.00%
kdocs.cn,0,0.00%,267,267,0.00%
www.kdocs.cn,0,0.00%,385,385,0.00%
u.wwwww.wtf,0,0.00%,271,271,0.00%
api.1e2ea27c13e7d7dff999bc904d79a0a8.pw,0,0.00%,8,8,0.00%
doh.dns.apple.com,0,0.00%,20,20,0.00%
docs.joern.io,0,0.00%,4,4,0.00%
cgi.ark.qq.com,0,0.00%,89,89,0.00%
app.vssps.visualstudio.com,0,0.00%,109,109,0.00%
1337.abcvg.info,0,0.00%,403,403,0.00%
iecvlist.microsoft.com,0,0.00%,80,80,0.00%
ins-r23tsuuf.ias.tencent-cloud.net,0,0.00%,147,147,0.00%
ping.manjaro.org,0,0.00%,692,692,0.00%
szminorshort.weixin.qq.com,0,0.00%,248,248,0.00%
weixin.qq.com,0,0.00%,28,28,0.00%
surl.amap.com,0,0.00%,2,2,0.00%
wb.amap.com,0,0.00%,2,2,0.00%
tracker.ipv6tracker.ru,0,0.00%,249,249,0.00%
tvax1.sinaimg.cn,0,0.00%,222,222,0.00%
webapi.amap.com,0,0.00%,6,6,0.00%
short.weixin.qq.com,0,0.00%,190,190,0.00%
vdata.amap.com,0,0.00%,3,3,0.00%
vdata02.amap.com,0,0.00%,3,3,0.00%
vdata01.amap.com,0,0.00%,3,3,0.00%
fourier.taobao.com,0,0.00%,8,8,0.00%
i5df1.tdum.alibaba.com,0,0.00%,2,2,0.00%
ynuf.aliapp.org,0,0.00%,32,32,0.00%
vdata03.amap.com,0,0.00%,3,3,0.00%
vdata04.amap.com,0,0.00%,3,3,0.00%
img.t.sinajs.cn,0,0.00%,23,23,0.00%
www.notion.so,0,0.00%,373,373,0.00%
www.cas.cn,0,0.00%,29,29,0.00%
otheve.beacon.qq.com,0,0.00%,239,239,0.00%
tracker-cdn.moeking.me,0,0.00%,139,139,0.00%
update.bjca.org.cn,0,0.00%,20,20,0.00%
tagged-by.rubiconproject.net.akadns.net,0,0.00%,8,8,0.00%
tracker.iriseden.eu,0,0.00%,162,162,0.00%
countly.mail.163.com,0,0.00%,92,92,0.00%
gchat.qpic.cn,0,0.00%,299,299,0.00%
cgicol.amap.com,0,0.00%,120,120,0.00%
cgicol.amap.com.gds.alibabadns.com,0,0.00%,14,14,0.00%
www.bt.cn,0,0.00%,199,199,0.00%
apd-ef1d4e4c1ea9898e441fef0017ad517108632f5a868c5ce6.v.smtcdns.com,0,0.00%,1,1,0.00%
minorshort.weixin.qq.com,0,0.00%,511,511,0.00%
shop.vipstatic.com,0,0.00%,1,1,0.00%
d.vpimg1.com,0,0.00%,1,1,0.00%
c.vpimg1.com,0,0.00%,1,1,0.00%
beian.miit.gov.cn,0,0.00%,82,82,0.00%
ir.vip.com,0,0.00%,1,1,0.00%
ss.knet.cn,0,0.00%,1,1,0.00%
wx.mail.qq.com,0,0.00%,100,100,0.00%
graph.qq.com,0,0.00%,493,493,0.00%
www.torrent.eu.org,0,0.00%,24,24,0.00%
tracker.anirena.com,0,0.00%,448,448,0.00%
t.nyaatracker.com,0,0.00%,371,371,0.00%
tracker.0o.is,0,0.00%,41,41,0.00%
tracker.ds.is,0,0.00%,36,36,0.00%
trk.publictracker.xyz,0,0.00%,135,135,0.00%
6rt.tace.ru,0,0.00%,70,70,0.00%
discord.heihachi.pw,0,0.00%,73,73,0.00%
exodus.desync.com,0,0.00%,22,22,0.00%
ipv6.tracker.zerobytes.xyz,0,0.00%,70,70,0.00%
open.demonii.com,0,0.00%,19,19,0.00%
ratings-wrs.norton.com,0,0.00%,2,2,0.00%
shasta-rrs.norton.com,0,0.00%,2,2,0.00%
recruitprod.azurefd.net,0,0.00%,8,8,0.00%
recruit.microsoft.com,0,0.00%,8,8,0.00%
wcpstatic.microsoft.com,0,0.00%,29,29,0.00%
acs-ui.azureedge.net,0,0.00%,8,8,0.00%
consentreceiverfd-prod.azurefd.net,0,0.00%,4,4,0.00%
wwfile.work.weixin.qq.com,0,0.00%,480,480,0.00%
apd-bf858887be56629f5e8387983960b23dd6420ff9a7f7b03b.v.smtcdns.com,0,0.00%,2,2,0.00%
www.dropbox.com,0,0.00%,82,82,0.00%
stat.download.xunlei.com,0,0.00%,10,10,0.00%
excashier.alipay.com,0,0.00%,4,4,0.00%
lab.alipay.com,0,0.00%,4,4,0.00%
kcart.alipay.com,0,0.00%,6,6,0.00%
collect.alipay.com,0,0.00%,12,12,0.00%
apd-6dc2592165268630e5e81885b161ea9094fb91d1cf4b7b4b.v.smtcdns.com,0,0.00%,5,5,0.00%
yangzhangalmo.github.io,0,0.00%,4,4,0.00%
23a72c571eab6919.cdn.jiashule.com,0,0.00%,24,24,0.00%
apd-7a3c059307d194c1953157782742893b1193182453d495c0.v.smtcdns.com,0,0.00%,2,2,0.00%
lookup.nextcloud.com,0,0.00%,6673,6673,0.00%
v6-1.nigirocloud.com,0,0.00%,511,511,0.00%
v6-2.nigirocloud.com,0,0.00%,508,508,0.00%
v6-3.nigirocloud.com,0,0.00%,496,496,0.00%
fedoraproject.org,0,0.00%,623,623,0.00%
wx1.qq.com,0,0.00%,879,879,0.00%
inner-all.toutiao-internal-all-v3.lf.bytelb.net,0,0.00%,329,329,0.00%
aloha.maxhub.vip.wsglb0.com,0,0.00%,866,866,0.00%
ins-diu1q33u.ias.tencent-cloud.net,0,0.00%,75,75,0.00%
crl.sectigo.com,0,0.00%,64,64,0.00%
crl.comodoca.com.cdn.cloudflare.net,0,0.00%,100,100,0.00%
speedtest.snape3058.info,0,0.00%,411,411,0.00%
swdlcdn.eastmoney.com.w.cdngslb.com,0,0.00%,78,78,0.00%
mpv6.weixin.qq.com,0,0.00%,139,139,0.00%
aloha.maxhub.vip,0,0.00%,386,386,0.00%
l-0007.l-msedge.net,0,0.00%,252,252,0.00%
premium.eastmoney.com,0,0.00%,27,27,0.00%
jsdelivr.map.fastly.net,0,0.00%,30,30,0.00%
time.g.aaplimg.com,0,0.00%,365,365,0.00%
time-ios.apple.com,0,0.00%,62,62,0.00%
esm.ubuntu.com,0,0.00%,32,32,0.00%
ntes53v6.mail.yeah.net,0,0.00%,62,62,0.00%
smtp.qq.com,0,0.00%,1618,1618,0.00%
log.tailscale.io,0,0.00%,8176,8176,0.00%
controlplane.tailscale.com,0,0.00%,3455,3455,0.00%
haiwenzhang.github.io,0,0.00%,61,61,0.00%
gitlab.com,0,0.00%,1357,1357,0.00%
tpstelemetry.tencent.com,0,0.00%,599,599,0.00%
pypi.org,0,0.00%,568801,568801,0.00%
pull-hls-vr-l1.douyincdn.com.wsdvs.com,0,0.00%,20,20,0.00%
support.weixin.qq.com,0,0.00%,111,111,0.00%
dstore-metadata.deepin.cn,0,0.00%,1292,1292,0.00%
access.toggle.qq.com,0,0.00%,721,721,0.00%
event.toggle.qq.com,0,0.00%,79,79,0.00%
ping.dgraph.io,0,0.00%,5028,5028,0.00%
web.p.qq.com,0,0.00%,151,151,0.00%
hub5pn.v6.sandai.net,0,0.00%,838,838,0.00%
appconf.mail.163.com,0,0.00%,456,456,0.00%
tracker.m-team.cc,0,0.00%,17,17,0.00%
tracker.lilithraws.org,0,0.00%,167,167,0.00%
torrent.fedoraproject.org,0,0.00%,252,252,0.00%
motd.ubuntu.com,0,0.00%,639,639,0.00%
az667904.vo.msecnd.net,0,0.00%,697,697,0.00%
msgacs.youku.com,0,0.00%,134,134,0.00%
az667904-pme.azureedge.net,0,0.00%,57,57,0.00%
osint.bambenekconsulting.com,0,0.00%,175,175,0.00%
dict.youdao.com,0,0.00%,546,546,0.00%
time.android.com,0,0.00%,10,10,0.00%
mp.4dex.io,0,0.00%,14,14,0.00%
yandex.com,0,0.00%,7,7,0.00%
px.ucweb.com,0,0.00%,18,18,0.00%
P2pSTUnTEST.HAplAT.NEt,0,0.00%,2,2,0.00%
cs9.wpc.v0cdn.net,0,0.00%,67,67,0.00%
tracker.beeimg.com,0,0.00%,54,54,0.00%
natdetection.onethingpcs.com,0,0.00%,144,144,0.00%
ipv6.neubt.com,0,0.00%,81,81,0.00%
edd.e4.nl,0,0.00%,7,7,0.00%
glb.sls.prod.dcat.dsp.trafficmanager.net,0,0.00%,413,413,0.00%
obsetear.github.io,0,0.00%,1,1,0.00%
app.any.run,0,0.00%,5,5,0.00%
cdnjs.cloudflare.com,0,0.00%,134,134,0.00%
i.work.weixin.qq.com,0,0.00%,344,344,0.00%
vscodeexperiments.azureedge.net,0,0.00%,13,13,0.00%
marketplace.visualstudio.com,0,0.00%,151,151,0.00%
apd-bf4bf622660164946c9b3d949a013ccc6751373c355ddeac.v.smtcdns.com,0,0.00%,2,2,0.00%
apd-2ff18d8c533b6c71309e9b084360f9ee2daa5b201ce1a95b.v.smtcdns.com,0,0.00%,2,2,0.00%
apd-55aa056d36dd2a21510c7aba402054b61c3d0af5f3be64c2.v.smtcdns.com,0,0.00%,2,2,0.00%
api-kos.wps.cn,0,0.00%,17,17,0.00%
commentowebd.vps.webdock.io,0,0.00%,1,1,0.00%
apd-8a3283388c9bfd480603732ee18cc09b3d9e120b00d43d9b.v.smtcdns.com,0,0.00%,2,2,0.00%
apd-05ace3e5be3ccfeb4cd6c4b264d896b1b4d7c42810ee4d50.v.smtcdns.com,0,0.00%,2,2,0.00%
apd-f54a02b4deb41d61066bebac717aaa296872e03e66079304.v.smtcdns.com,0,0.00%,2,2,0.00%
stat6.y.qq.com,0,0.00%,28,28,0.00%
ipv6.torrent.centos.org,0,0.00%,10,10,0.00%
rpt.gdt.qq.com,0,0.00%,57,57,0.00%
ii.gdt.qq.com,0,0.00%,24,24,0.00%
apd-126387a827c29b32acbd735ba8c082df93686f8d74a07da2.v.smtcdns.com,0,0.00%,2,2,0.00%
long.weixin.qq.com,0,0.00%,71,71,0.00%
p.guanjia.qq.com,0,0.00%,2,2,0.00%
apd-d8e293bbd0ec700474ea78f11975a93435add3499c7989b7.v.smtcdns.com,0,0.00%,4,4,0.00%
ulogs.umeng.com,0,0.00%,105,105,0.00%
channels.weixin.qq.com,0,0.00%,99,99,0.00%
apis.map.qq.com,0,0.00%,74,74,0.00%
apd-8b1cfd726ba9ef1a0fcbd0cf7f43d30b1e573b1aeeb564ce.v.smtcdns.com,0,0.00%,2,2,0.00%
tracker1.520.jp,0,0.00%,9,9,0.00%
concen.org,0,0.00%,8,8,0.00%
seedbay.net,0,0.00%,7,7,0.00%
tr.greenhat.be,0,0.00%,7,7,0.00%
open.stealth.si,0,0.00%,14,14,0.00%
bank.pingan.com,0,0.00%,2,2,0.00%
tracker.loligirl.cn,0,0.00%,114,114,0.00%
opentracker.cc,0,0.00%,146,146,0.00%
ipv4announce.sktorrent.eu,0,0.00%,50,50,0.00%
ping3.teamviewer.com,0,0.00%,746,746,0.00%
quay.io,0,0.00%,985,985,0.00%
tracker.exorditech.com.tr,0,0.00%,117,117,0.00%
gslb.xcloud.sandai.net,0,0.00%,168,168,0.00%
api.bitbucket.org,0,0.00%,257,257,0.00%
newsinfo.eastmoney.com,0,0.00%,60,60,0.00%
myfavor.eastmoney.com,0,0.00%,77,77,0.00%
searchapi.eastmoney.com,0,0.00%,65,65,0.00%
np-listapi.eastmoney.com,0,0.00%,68,68,0.00%
huaxiang.eastmoney.com,0,0.00%,67,67,0.00%
recommend.eastmoney.com,0,0.00%,63,63,0.00%
vote.eastmoney.com,0,0.00%,73,73,0.00%
reportapi.eastmoney.com,0,0.00%,73,73,0.00%
b32f015b18b6bf83cdb52b1aa3f2d0f3.clo.footprintdns.com,0,0.00%,2,2,0.00%
mailhz.qiye.163.com,0,0.00%,46,46,0.00%
report.url.cn,0,0.00%,692,692,0.00%
speeddials.opera.com,0,0.00%,43,43,0.00%
im.dingtalk.com,0,0.00%,69,69,0.00%
cname.dict.ntes53.netease.com,0,0.00%,145,145,0.00%
dict.ntes53.netease.com,0,0.00%,251,251,0.00%
pancake.g.aaplimg.com,0,0.00%,4,4,0.00%
ace.pgp.wanmei.com,0,0.00%,52,52,0.00%
myfavor1.eastmoney.com,0,0.00%,57,57,0.00%
astat-bugly-tgw4l.mig.tencent-cloud.net,0,0.00%,297,297,0.00%
hdwebv6.mail.split.netease.com,0,0.00%,70,70,0.00%
today.org.ua,0,0.00%,1,1,0.00%
ns-1471.awsdns-55.org,0,0.00%,2,2,0.00%
hj5k.nomade.ga,0,0.00%,1,1,0.00%
public.dns.iij.jp,0,0.00%,322,322,0.00%
v6-4.nigirocloud.com,0,0.00%,524,524,0.00%
tracker.foreverpirates.co,0,0.00%,300,300,0.00%
hub5pr.v6.phub.sandai.net,0,0.00%,620,620,0.00%
hk-proxy.isrc.ac.cn,0,0.00%,909,909,0.00%
cacerts.digicert.com,0,0.00%,30,30,0.00%
aks.jdpay.com,0,0.00%,72,72,0.00%
tracker-public.tjupt.org,0,0.00%,121,121,0.00%
www.weiyun.com,0,0.00%,32,32,0.00%
user.weiyun.com,0,0.00%,7,7,0.00%
ui.ptlogin2.qq.com,0,0.00%,89,89,0.00%
docs.wps.cn,0,0.00%,21,21,0.00%
890a3c996d534bf19f8ed08103f71d66.fp.measure.office.com,0,0.00%,2,2,0.00%
stun-h5.qvb.qcloud.com,0,0.00%,223,223,0.00%
p4-gdmgknw2leoey-43h5anlkzty335p5-146801-i2-bogus-dnssec-bd.gexperiments3.com,0,0.00%,1,1,0.00%
p4-gdmgknw2leoey-43h5anlkzty335p5-146801-i1-bogus-dnssec-vd.gexperiments2.com,0,0.00%,1,1,0.00%
pull-flv-f6.douyincdn.com.hdlvcloud.ks-cdn.com,0,0.00%,14,14,0.00%
s6110-flv-ml.gslb.ksyuncdn.com,0,0.00%,20,20,0.00%
trouter-azsc-asse-0-a.trouter.skype.com,0,0.00%,49,49,0.00%
trouter-azsc-asse-0-a.cloudapp.net,0,0.00%,62,62,0.00%
ocsp.comodoca.com.cdn.cloudflare.net,0,0.00%,79,79,0.00%
hd-v6.mmstat.com.gds.alibabadns.com,0,0.00%,21,21,0.00%
csync.loopme.me,0,0.00%,6,6,0.00%
gbapi.eastmoney.com,0,0.00%,251,251,0.00%
ocsp.comodoca.com,0,0.00%,24,24,0.00%
ocsp.usertrust.com,0,0.00%,63,63,0.00%
ocsp.sectigo.com,0,0.00%,73,73,0.00%
hide.likeafaieog.tk,0,0.00%,1,1,0.00%
crl.usertrust.com,0,0.00%,159,159,0.00%
1d83e3e8e6b57a65f526e888e184d335.clo.footprintdns.com,0,0.00%,1,1,0.00%
teams-ring.msedge.net,0,0.00%,16,16,0.00%
nj.cschannel.anticheatexpert.com,0,0.00%,40,40,0.00%
16827d4fc6e54507858a3f783fc81b82.fp.measure.office.com,0,0.00%,2,2,0.00%
apd-01fe2cea10604cc0d5743de4947f01b13dccda98d5b74beb.v.smtcdns.com,0,0.00%,3,3,0.00%
clientlog.music.163.com,0,0.00%,68,68,0.00%
oss.hpconnected.com,0,0.00%,53,53,0.00%
baoxian.pingan.com,0,0.00%,48,48,0.00%
baoxian.pingan.com.paxdn.com,0,0.00%,45,45,0.00%
ipv6.tracker.harry.lu,0,0.00%,23,23,0.00%
apd-b701c984eb510c61fccb849afda812752d35cb4386286a96.v.smtcdns.com,0,0.00%,2,2,0.00%
vd6.l.qq.com,0,0.00%,46,46,0.00%
mariadb.org,0,0.00%,37,37,0.00%
trouter-azsc-asse-0-b.trouter.skype.com,0,0.00%,24,24,0.00%
apd-d620662384bfa659a4ddcf61b25545de329185f90ef5d08b.v.smtcdns.com,0,0.00%,2,2,0.00%
mirror.aptus.co.tz,0,0.00%,7,7,0.00%
run.publictracker.xyz,0,0.00%,8,8,0.00%
pbaccess.video.qq.com,0,0.00%,28,28,0.00%
tr.bangumi.moe,0,0.00%,149,149,0.00%
tracker.cyberia.is,0,0.00%,50,50,0.00%
tracker.publictracker.xyz,0,0.00%,7,7,0.00%
tracker.nrx.me,0,0.00%,52,52,0.00%
zecircle.xyz,0,0.00%,2,2,0.00%
tracker.theoks.net,0,0.00%,13,13,0.00%
q-client.cn-hongkong.log.aliyuncs.com,0,0.00%,16,16,0.00%
go.ezodn.com,0,0.00%,2,2,0.00%
time1.google.com,0,0.00%,59,59,0.00%
time2.google.com,0,0.00%,53,53,0.00%
time3.google.com,0,0.00%,59,59,0.00%
time4.google.com,0,0.00%,57,57,0.00%
fp-vp.azureedge.net,0,0.00%,9,9,0.00%
static-ecst.licdn.com,0,0.00%,24,24,0.00%
t-ring.msedge.net,0,0.00%,20,20,0.00%
ocsps.ssl.com,0,0.00%,27,27,0.00%
wup.imtt.qq.com,0,0.00%,578,578,0.00%
l-0007.config.skype.com,0,0.00%,28,28,0.00%
udp.ipv6check.akadns.net,0,0.00%,38,38,0.00%
east-asia.udp.ipv6check.akadns.net,0,0.00%,38,38,0.00%
http.ipv6check.akadns.net,0,0.00%,17,17,0.00%
east-asia.http.ipv6check.akadns.net,0,0.00%,18,18,0.00%
az700632-pme.azureedge.net,0,0.00%,75,75,0.00%
az700632-pme.ec.azureedge.net,0,0.00%,37,37,0.00%
api.languagetoolplus.com,0,0.00%,60,60,0.00%
downloads-aws-prod-alb-134617303.eu-west-1.elb.amazonaws.com,0,0.00%,32,32,0.00%
hax.peakgg.ml,0,0.00%,1,1,0.00%
fashionpedia.github.io,0,0.00%,1,1,0.00%
mozilla.cloudflare-dns.com,0,0.00%,288,288,0.00%
mirrorz.org,0,0.00%,234,234,0.00%
macxmp.rcv.sandai.net,0,0.00%,6,6,0.00%
5c705f0af0ed4765a700cdca6800c147.fp.measure.office.com,0,0.00%,2,2,0.00%
ulogs.umeng.com.gds.alibabadns.com,0,0.00%,67,67,0.00%
k2-dy-cold2-ml.gslb.ksyuncdn.com,0,0.00%,2,2,0.00%
v6ncsi.msedge.net,0,0.00%,52,52,0.00%
ncsi.6-c-0003.c-msedge.net,0,0.00%,81,81,0.00%
6-c-0003.c-msedge.net,0,0.00%,291,291,0.00%
lab-a.tongyifan.me,0,0.00%,21,21,0.00%
ios.bugly.qq.com,0,0.00%,43,43,0.00%
alog-default.umeng.com,0,0.00%,74,74,0.00%
think.afunapp.com,0,0.00%,61,61,0.00%
edge-misc-env.dropbox-dns.com,0,0.00%,49,49,0.00%
board.rellek.org,0,0.00%,1,1,0.00%
bing.com,0,0.00%,68,68,0.00%
dualstack-logs.amap.com,0,0.00%,18,18,0.00%
lng.xiaohongshu.com,0,0.00%,10,10,0.00%
acs.m.taobao.com,0,0.00%,49,49,0.00%
thirdwx.qlogo.cn,0,0.00%,44,44,0.00%
ts4.mm.bing.net,0,0.00%,2,2,0.00%
ts1.mm.bing.net,0,0.00%,2,2,0.00%
drive.weixin.qq.com,0,0.00%,120,120,0.00%
python-world.github.io,0,0.00%,1,1,0.00%
interface3.music.163.com.163jiasu.com,0,0.00%,24,24,0.00%
quillbot.com,0,0.00%,66,66,0.00%
doi.org,0,0.00%,25,25,0.00%
szshort.weixin.qq.com,0,0.00%,48,48,0.00%
trpcpb.imtt.qq.com,0,0.00%,8,8,0.00%
searchsuggest.browser.qq.com,0,0.00%,2,2,0.00%
amisfile.bj.bcebos.com,0,0.00%,1,1,0.00%
secclientgw.alipay.com,0,0.00%,142,142,0.00%
apd-af717b152965a30ab140455f8a8f6e67d6420ff9a7f7b03b.v.smtcdns.com,0,0.00%,1,1,0.00%
turingapi-rapiddeploy.microsoft.com,0,0.00%,9,9,0.00%
docker.mirrors.ustc.edu.cn,0,0.00%,8,8,0.00%
registry.npmjs.org,0,0.00%,46,46,0.00%
account.aliyun.com,0,0.00%,7,7,0.00%
sh.wagbridge.acceleration.aliyun.com.gds.alibabadns.com,0,0.00%,5,5,0.00%
debian.map.fastlydns.net,0,0.00%,45,45,0.00%
globalconfig.flashlightproxy.com,0,0.00%,10,10,0.00%
caldavhz.qiye.163.com,0,0.00%,46,46,0.00%
bvvfsx.herlpyo.ga,0,0.00%,1,1,0.00%
lp.open.weixin.qq.com,0,0.00%,318,318,0.00%
cwx.qlogo.cn,0,0.00%,231,231,0.00%
autosoga.ggga.ga,0,0.00%,1,1,0.00%
dns.twnic.tw,0,0.00%,189,189,0.00%
littlecdn.com,0,0.00%,44,44,0.00%
download.se.360.cn,0,0.00%,6,6,0.00%
stage.www.kooliruum.ee,0,0.00%,1,1,0.00%
exp.notion.so,0,0.00%,150,150,0.00%
ns2-35.azure-dns.net,0,0.00%,39,39,0.00%
B.ROOT-SERVERS.NET,0,0.00%,11,11,0.00%
platform.cn.bing.com,0,0.00%,4,4,0.00%
static.deepl.com,0,0.00%,375,375,0.00%
nvidia.github.io,0,0.00%,405,405,0.00%
tracker.byr.pt,0,0.00%,145,145,0.00%
sdk.e.qq.com,0,0.00%,47,47,0.00%
mi.gdt.qq.com,0,0.00%,27,27,0.00%
fe3.delivery.mp.microsoft.com,0,0.00%,121,121,0.00%
wxjnj.readvi.cf,0,0.00%,1,1,0.00%
languagetool.org,0,0.00%,10,10,0.00%
qb-extension.firebaseio.com,0,0.00%,274,274,0.00%
h3o2.me,0,0.00%,133,133,0.00%
v6-zb-alibaba-clould.tengine.alibaba.com,0,0.00%,15,15,0.00%
tr.abir.ga,0,0.00%,166,166,0.00%
release-75570.gzc.vod.tencent-cloud.com,0,0.00%,239,239,0.00%
blackz.ro,0,0.00%,150,150,0.00%
tracker.corpscorp.online,0,0.00%,175,175,0.00%
tracker.torrentleech.org,0,0.00%,134,134,0.00%
laobameishijia.github.io,0,0.00%,2,2,0.00%
cdn.globalsigncdn.com.cdn.cloudflare.net,0,0.00%,12,12,0.00%
wstatic-hb.bj.bcebos.com,0,0.00%,5,5,0.00%
appdownload.deepl.com,0,0.00%,46,46,0.00%
ssl.captcha.qq.com,0,0.00%,68,68,0.00%
clients.config.office.net,0,0.00%,26,26,0.00%
t.captcha.qq.com,0,0.00%,54,54,0.00%
bj.bcebos.com,0,0.00%,31,31,0.00%
www.latex-tables.com,0,0.00%,4,4,0.00%
v-2a384bf7.71edge.com,0,0.00%,9,9,0.00%
pti.store.microsoft.com,0,0.00%,14,14,0.00%
auto.sina.com.cn,0,0.00%,7,7,0.00%
www.sinaimg.cn,0,0.00%,34,34,0.00%
auto4.sinaimg.cn,0,0.00%,2,2,0.00%
auto.sinaimg.cn,0,0.00%,2,2,0.00%
auto3.sinaimg.cn,0,0.00%,2,2,0.00%
n.sinaimg.cn,0,0.00%,23,23,0.00%
auto1.sinaimg.cn,0,0.00%,2,2,0.00%
auto5.sinaimg.cn,0,0.00%,2,2,0.00%
auto2.sinaimg.cn,0,0.00%,2,2,0.00%
i3.sinaimg.cn,0,0.00%,9,9,0.00%
i0.sinaimg.cn,0,0.00%,8,8,0.00%
i1.sinaimg.cn,0,0.00%,7,7,0.00%
www.example.com,0,0.00%,153,153,0.00%
pypi.python.org,0,0.00%,13,13,0.00%
szlong.weixin.qq.com,0,0.00%,57,57,0.00%
mybank.icbc.com.cn,0,0.00%,4,4,0.00%
tools.people.com.cn,0,0.00%,4,4,0.00%
ipv6.ts.qq.com,0,0.00%,17,17,0.00%
hd.mmstat.com,0,0.00%,23,23,0.00%
hd.mmstat.com.gds.alibabadns.com,0,0.00%,19,19,0.00%
hd-v6.mmstat.com,0,0.00%,14,14,0.00%
dashi.163.com,0,0.00%,66,66,0.00%
dashiwebv6.mail.split.netease.com,0,0.00%,26,26,0.00%
tracker.birkenwald.de,0,0.00%,63,63,0.00%
1qw2cd.qqscml.ga,0,0.00%,1,1,0.00%
mirrors.fedoraproject.org,0,0.00%,624,624,0.00%
wildcard.fedoraproject.org,0,0.00%,74,74,0.00%
mirrors.bfsu.edu.cn,0,0.00%,240,240,0.00%
debuginfo.centos.org,0,0.00%,12,12,0.00%
repo.zabbix.com,0,0.00%,40,40,0.00%
conf.wifi.360.cn,0,0.00%,80,80,0.00%
api.free.wifi.360.cn,0,0.00%,26,26,0.00%
ssl.ptlogin2.graph.qq.com,0,0.00%,481,481,0.00%
xui.ptlogin2.qq.com,0,0.00%,496,496,0.00%
sls.update.microsoft.com,0,0.00%,222,222,0.00%
discovery-v6-4.syncthing.net,0,0.00%,40,40,0.00%
polyester-dead-5f6.notion.site,0,0.00%,171,171,0.00%
trackme.theom.nz,0,0.00%,139,139,0.00%
open.nyap2p.com,0,0.00%,153,153,0.00%
tracker.electro-torrent.pl,0,0.00%,171,171,0.00%
tracker.nucozer-tracker.ml,0,0.00%,153,153,0.00%
tracker.xn--vzyr4p.top,0,0.00%,131,131,0.00%
tr.abiir.top,0,0.00%,139,139,0.00%
cdp1.pca.dfn.de,0,0.00%,2,2,0.00%
code.jquery.com,0,0.00%,20,20,0.00%
gpdream.github.io,0,0.00%,1,1,0.00%
qwer1231232020.github.io,0,0.00%,1,1,0.00%
nk5x-jj46gxz.autbxpcje.gq,0,0.00%,1,1,0.00%
kinorun.com,0,0.00%,6,6,0.00%
tr.burnabyhighstar.com,0,0.00%,156,156,0.00%
thekushagra.github.io,0,0.00%,1,1,0.00%
download-ib01.fedoraproject.org,0,0.00%,6,6,0.00%
tva2.sinaimg.cn,0,0.00%,81,81,0.00%
liveng.alicdn.com,0,0.00%,1,1,0.00%
ifs.tanx.com,0,0.00%,7,7,0.00%
hc.tdm.qq.com,0,0.00%,30,30,0.00%
pcapp-push.youku.com,0,0.00%,23,23,0.00%
xmlconf.rcv.sandai.net,0,0.00%,1,1,0.00%
media.info.client.xunlei.com,0,0.00%,1,1,0.00%
download.code.lixian.vip.xunlei.com,0,0.00%,2,2,0.00%
api-shoulei-ssl.xunlei.com,0,0.00%,13,13,0.00%
plugin.xl7.xunlei.com,0,0.00%,1,1,0.00%
etl-xlmc-ssl.xunlei.com,0,0.00%,1,1,0.00%
conf-m-ssl.xunlei.com,0,0.00%,1,1,0.00%
static-xl9-ssl.xunlei.com,0,0.00%,1,1,0.00%
pctest.v6.shub.sandai.net,0,0.00%,1,1,0.00%
hub5u.v6.phub.sandai.net,0,0.00%,2,2,0.00%
detection.v6.shub.sandai.net,0,0.00%,1,1,0.00%
xluser-ssl.xunlei.com,0,0.00%,14,14,0.00%
dlcfg.client.v6.chub.sandai.net,0,0.00%,1,1,0.00%
soa-vip-ssl.xunlei.com,0,0.00%,1,1,0.00%
pcdownsdk.rcv.sandai.net,0,0.00%,1,1,0.00%
advertpay.vip.xunlei.com,0,0.00%,3,3,0.00%
adsp.xunlei.com,0,0.00%,38,38,0.00%
images.client.vip.xunlei.com,0,0.00%,1,1,0.00%
upgrade.xl9.xunlei.com,0,0.00%,7,7,0.00%
c15facffece596ece87eca186c33c3a2.clo.footprintdns.com,0,0.00%,2,2,0.00%
moiafdazure.clo.footprintdns.com,0,0.00%,2,2,0.00%
spo-ring.msedge.net,0,0.00%,37,37,0.00%
fp-afd-nocache-ccp.azureedge.net,0,0.00%,13,13,0.00%
oss.mail.qq.com,0,0.00%,62,62,0.00%
web.hb.ad.cpe.dotomi.com,0,0.00%,4,4,0.00%
q4.qlogo.cn,0,0.00%,21,21,0.00%
web.qun.qq.com,0,0.00%,22,22,0.00%
q3.qlogo.cn,0,0.00%,14,14,0.00%
q1.qlogo.cn,0,0.00%,18,18,0.00%
img2.doubanio.com,0,0.00%,4,4,0.00%
img1.doubanio.com,0,0.00%,6,6,0.00%
dualstack-restapi.amap.com,0,0.00%,4,4,0.00%
o-ring-fallback.msedge.net,0,0.00%,2,2,0.00%
cdn.clustrmaps.com,0,0.00%,5,5,0.00%
clustrmaps.com,0,0.00%,7,7,0.00%
graph-neural-networks.github.io,0,0.00%,2,2,0.00%
www.bupt.edu.cn,0,0.00%,2,2,0.00%
www.jlu.edu.cn,0,0.00%,2,2,0.00%
www.whu.edu.cn,0,0.00%,2,2,0.00%
www.gravatar.com,0,0.00%,50,50,0.00%
acs.youku.com,0,0.00%,28,28,0.00%
explodie.org,0,0.00%,14,14,0.00%
ssl.ptlogin2.qq.com,0,0.00%,26,26,0.00%
tva4.sinaimg.cn,0,0.00%,103,103,0.00%
256f3f107fde425bb220c976fdcadd3f.fp.measure.office.com,0,0.00%,2,2,0.00%
professionalsly.com,0,0.00%,2,2,0.00%
zone1-services-cdn.com,0,0.00%,6,6,0.00%
v6-data.video.dns.iqiyi.com,0,0.00%,74,74,0.00%
ftp.sjtu.edu.cn,0,0.00%,33,33,0.00%
ftp.postgresql.org,0,0.00%,4,4,0.00%
code2chicken.nl,0,0.00%,28,28,0.00%
psytester.github.io,0,0.00%,1,1,0.00%
fp-vs-nocache.azureedge.net,0,0.00%,21,21,0.00%
18ad87839a385ab34d95d0cb4cb02cf0.clo.footprintdns.com,0,0.00%,2,2,0.00%
fp-vs.azureedge.net,0,0.00%,11,11,0.00%
btracker.top,0,0.00%,189,189,0.00%
s2.xoimg.com,0,0.00%,9,9,0.00%
xbtrutor.com,0,0.00%,146,146,0.00%
masters-tb.com,0,0.00%,159,159,0.00%
t.btcland.xyz,0,0.00%,109,109,0.00%
kubernetes-charts.storage.googleapis.com,0,0.00%,235,235,0.00%
ns-166.awsdns-20.com,0,0.00%,4,4,0.00%
p.qlogo.cn,0,0.00%,65,65,0.00%
tr.fuckbitcoin.xyz,0,0.00%,95,95,0.00%
gkaracha.github.io,0,0.00%,122,122,0.00%
theodoric.fr,0,0.00%,114,114,0.00%
docs.qq.com,0,0.00%,475,475,0.00%
60-fps.org,0,0.00%,153,153,0.00%
baibako.tv,0,0.00%,154,154,0.00%
debian.map.fastlydns.NET,0,0.00%,2,2,0.00%
oss.hpconnected.com.cdn.cloudflare.net,0,0.00%,15,15,0.00%
vcsa.vmware.com,0,0.00%,49,49,0.00%
ppa.launchpadcontent.net,0,0.00%,7,7,0.00%
tw3.fnwl.ml,0,0.00%,1,1,0.00%
jackroy1992.github.io,0,0.00%,61,61,0.00%
simsunny22.github.io,0,0.00%,61,61,0.00%
P2PSTUNTEst.HAPlAT.Net,0,0.00%,2,2,0.00%
mirrors.nju.edu.cn,0,0.00%,106,106,0.00%
mirrors.neusoft.edu.cn,0,0.00%,19,19,0.00%
r1---sn-oguesnd7.gvt1.com,0,0.00%,2,2,0.00%
download.installmac.tk,0,0.00%,1,1,0.00%
discovery-v6.verysync.cn,0,0.00%,205,205,0.00%
2xingav.github.io,0,0.00%,61,61,0.00%
l7mrpcfb.fast-github.tk,0,0.00%,1,1,0.00%
devtools.azureedge.net,0,0.00%,4,4,0.00%
dagmar.owncloud.systems,0,0.00%,6,6,0.00%
f.video.weibocdn.com,0,0.00%,82,82,0.00%
rmonitor.qq.com,0,0.00%,51,51,0.00%
cds.s5x3j6q5.hwcdn.net,0,0.00%,9,9,0.00%
replicate.com,0,0.00%,7,7,0.00%
arxiv.paperswithcode.com,0,0.00%,7,7,0.00%
production-media.paperswithcode.com,0,0.00%,3,3,0.00%
rfywxtrk.ggj.gov.cn,0,0.00%,1,1,0.00%
archive.ubuntu.com,0,0.00%,152,152,0.00%
dl.yarnpkg.com,0,0.00%,24,24,0.00%
www.chelseakomlo.com,0,0.00%,1,1,0.00%
tracker.parrotsec.org,0,0.00%,147,147,0.00%
android.bugly.qq.com,0,0.00%,31,31,0.00%
9715f22e280d4abcb7513c2ae012a165.fp.measure.office.com,0,0.00%,1,1,0.00%
alvaroc1.github.io,0,0.00%,1,1,0.00%
discuss.pytorch.org,0,0.00%,24,24,0.00%
features.opera-api.com,0,0.00%,24,24,0.00%
sports.sina.com.cn,0,0.00%,60,60,0.00%
spool.grid.sinaedge.com,0,0.00%,73,73,0.00%
e6c08bbdc0314a9bafefbc6317795186.fp.measure.office.com,0,0.00%,2,2,0.00%
ins-9fciednc.ias.tencent-cloud.net,0,0.00%,21,21,0.00%
discovery-v6.syncthing.net,0,0.00%,19,19,0.00%
stat.wifi.360.cn,0,0.00%,20,20,0.00%
r4---sn-un57sne7.gvt1.com,0,0.00%,2,2,0.00%
v6-zb-alibaba-clould.tengine.alibaba.com.gds.alibabadns.com,0,0.00%,114,114,0.00%
tracker.kamigami.org,0,0.00%,129,129,0.00%
torrent.mp3quran.net,0,0.00%,137,137,0.00%
pypi.tuna.tsinghua.edu.cn,0,0.00%,60,60,0.00%
s2.loli.net.cdn.cloudflare.net,0,0.00%,4,4,0.00%
nm.aicdn.com,0,0.00%,4,4,0.00%
f1.video.weibocdn.com,0,0.00%,14,14,0.00%
doc.owncloud.org,0,0.00%,2,2,0.00%
inferno.demonoid.is,0,0.00%,118,118,0.00%
gz-lb1.internet.v6.spanner.alipaydns.com,0,0.00%,159,159,0.00%
7f995eea339a4e888bd7c6a8c4163a58.fp.measure.office.com,0,0.00%,1,1,0.00%
www.all4nothin.net,0,0.00%,76,76,0.00%
open.trackerlist.xyz,0,0.00%,224,224,0.00%
ins-ck07kq9h.ias.tencent-cloud.net,0,0.00%,3,3,0.00%
ins-13hnm06u.ias.tencent-cloud.net,0,0.00%,2,2,0.00%
user.qzone.qq.com,0,0.00%,6,6,0.00%
sb.adtidy.org,0,0.00%,2,2,0.00%
a06d.expiration.tk,0,0.00%,1,1,0.00%
middle.yun.139.com,0,0.00%,12,12,0.00%
www.incredibuild.com,0,0.00%,5,5,0.00%
aas.caiyun.feixin.10086.cn,0,0.00%,17,17,0.00%
old-ib.incredibuild.com,0,0.00%,12,12,0.00%
mirrors.bupt.edu.cn,0,0.00%,8,8,0.00%
xbai.bestbyte.tk,0,0.00%,1,1,0.00%
owenarden.github.io,0,0.00%,1,1,0.00%
k122.gslb.ksyuncdn.com,0,0.00%,4,4,0.00%
sz.mp.weixin.qq.com,0,0.00%,94,94,0.00%
ecs.office.trafficmanager.net,0,0.00%,51,51,0.00%
gsp-ssl.ls.apple.com,0,0.00%,63,63,0.00%
2v21nxa7.sched.sma-dk.tdnsstic1.cn.cjt.krcdn.idatacube.com,0,0.00%,8,8,0.00%
sh.mp.weixin.qq.com,0,0.00%,69,69,0.00%
files.pfsense.org,0,0.00%,131,131,0.00%
tracker.moeking.me,0,0.00%,222,222,0.00%
torrent.ubuntu.com,0,0.00%,130,130,0.00%
production.cloudflare.docker.com,0,0.00%,68,68,0.00%
te78.github.io,0,0.00%,1,1,0.00%
cms.quantserve.com,0,0.00%,11,11,0.00%
a.tribalfusion.com,0,0.00%,12,12,0.00%
res.cloudinary.com,0,0.00%,2,2,0.00%
fireworks.eu.org,0,0.00%,113,113,0.00%
buny.uk,0,0.00%,43,43,0.00%
data-bg.net,0,0.00%,141,141,0.00%
ocsp.pca.dfn.de,0,0.00%,4,4,0.00%
tracker.kuroy.me,0,0.00%,182,182,0.00%
login2.dingtalk.com,0,0.00%,35,35,0.00%
space.dingtalk.com,0,0.00%,35,35,0.00%
408662a206f24e79bbdf0810d6ce694f.fp.measure.office.com,0,0.00%,3,3,0.00%
nydhdfsgdf.cuddyfyedhhgcuddy735.tk,0,0.00%,61,61,0.00%
san-shui.github.io,0,0.00%,1,1,0.00%
fengxiuwei.github.io,0,0.00%,1,1,0.00%
d31au4hdlg7e7k.cloudfront.net,0,0.00%,1,1,0.00%
login.weixin.qq.com,0,0.00%,81,81,0.00%
mpvideo.qpic.cn.cdn.dcloudstc.com,0,0.00%,3,3,0.00%
mpvideo.qpic.cn.svideolego-dk.sched.dcloudstc.com,0,0.00%,3,3,0.00%
free.wifi.360.cn,0,0.00%,1,1,0.00%
homeassistant.daddylin.ml,0,0.00%,1,1,0.00%
teams.office.com,0,0.00%,5,5,0.00%
teams-mira-afd.trafficmanager.net,0,0.00%,8,8,0.00%
teams-office-com.s-0005.s-msedge.net,0,0.00%,5,5,0.00%
spo-ring.spo-9999.spo-msedge.net,0,0.00%,11,11,0.00%
spo-9999.spo-msedge.net,0,0.00%,12,12,0.00%
r1---sn-cvh7knze.gvt1.com,0,0.00%,1,1,0.00%
ins-vat7e7ap.ias.tencent-cloud.net,0,0.00%,8,8,0.00%
datascene.net,0,0.00%,144,144,0.00%
cidian.youdao.com,0,0.00%,57,57,0.00%
tracker.breizh.pm,0,0.00%,5,5,0.00%
bbs-api.mihoyo.com,0,0.00%,15,15,0.00%
dns.alidns.com,0,0.00%,56,56,0.00%
4.npupt.com,0,0.00%,26,26,0.00%
l-0009.l-msedge.net,0,0.00%,2,2,0.00%
us.archive.ubuntu.com,0,0.00%,324,324,0.00%
t.jaekr.sh,0,0.00%,62,62,0.00%
btx.anifilm.tv,0,0.00%,142,142,0.00%
jump.weiyun.com,0,0.00%,14,14,0.00%
live04-adapt.pddpic.com,0,0.00%,2,2,0.00%
liveplay04.pddpic.com,0,0.00%,2,2,0.00%
dualstack-na610-na620.acs.m.taobao.com.gds.alibabadns.com,0,0.00%,17,17,0.00%
eco.taobao.com,0,0.00%,18,18,0.00%
eco.taobao.com.gds.alibabadns.com,0,0.00%,11,11,0.00%
dualstack-na61-na62.wagbridge.alibaba.taobao.com,0,0.00%,12,12,0.00%
dualstack-na61-na62.wagbridge.alibaba.taobao.com.gds.alibabadns.com,0,0.00%,15,15,0.00%
quilt-lang.richie-bendall.ml,0,0.00%,1,1,0.00%
prod.detectportal.prod.cloudops.mozgcp.NET,0,0.00%,6,6,0.00%
api.adguard.com,0,0.00%,56,56,0.00%
v26-aweme-play-xigua.ixigua.com,0,0.00%,1,1,0.00%
v5-colda.douyinvod.com,0,0.00%,1,1,0.00%
v5-colda.douyinvod.com.yangyi19.com,0,0.00%,1,1,0.00%
dy-vod-colda.bytegslb.com,0,0.00%,2,2,0.00%
my.maxon.net,0,0.00%,28,28,0.00%
yangrubing.github.io,0,0.00%,2,2,0.00%
mirror.xtom.com.hk,0,0.00%,8,8,0.00%
download.opensuse.org,0,0.00%,7,7,0.00%
pinyin.voicecloud.cn,0,0.00%,4,4,0.00%
fp-vp-nocache.azureedge.net,0,0.00%,5,5,0.00%
fp-afd.azureedge.net,0,0.00%,10,10,0.00%
k8s-gateways-gwlh1-a7d3a27fb9-307271065.us-east-1.elb.amazonaws.com,0,0.00%,4,4,0.00%
fastlane.rubiconproject.com,0,0.00%,7,7,0.00%
f7.video.weibocdn.com,0,0.00%,1,1,0.00%
ffa91f29daac478d15861d4bcd8a65bb.clo.footprintdns.com,0,0.00%,1,1,0.00%
a-ring-fallback.msedge.net,0,0.00%,19,19,0.00%
t3.xiaohongshu.com,0,0.00%,5,5,0.00%
cdn.cookielaw.org,0,0.00%,8,8,0.00%
netdna.bootstrapcdn.com,0,0.00%,25,25,0.00%
csxd.contentsquare.net,0,0.00%,1,1,0.00%
ct.contentsquare.net,0,0.00%,1,1,0.00%
www.clinicmed.net,0,0.00%,2,2,0.00%
xhs.l.bdydns.com,0,0.00%,1,1,0.00%
img.clinicmed.net,0,0.00%,2,2,0.00%
report.qqweb.qq.com,0,0.00%,12,12,0.00%
auto-lirpa.readthedocs.io,0,0.00%,2,2,0.00%
static.mendeley.com,0,0.00%,6,6,0.00%
static.mendeley.com.cdn.cloudflare.net,0,0.00%,2,2,0.00%
cn-assets.adobedtm.com.edgekey.net,0,0.00%,1,1,0.00%
assets.readthedocs.org,0,0.00%,2,2,0.00%
ars.els-cdn.com,0,0.00%,9,9,0.00%
ars.els-cdn.com.cdn.cloudflare.net,0,0.00%,3,3,0.00%
ins-pe24hspk.ias.tencent-cloud.net,0,0.00%,17,17,0.00%
brxt-research.mendeley.com,0,0.00%,13,13,0.00%
brxt-research.mendeley.com.cdn.cloudflare.net,0,0.00%,3,3,0.00%
static.cloudflareinsights.com,0,0.00%,23,23,0.00%
media.ethicalads.io,0,0.00%,4,4,0.00%
readthedocs.org,0,0.00%,3,3,0.00%
www.catalyzex.com,0,0.00%,1,1,0.00%
server.ethicalads.io,0,0.00%,5,5,0.00%
weibo.com,0,0.00%,2772,2772,0.00%
s1-aigei-com-idvgmol.qiniudns.com,0,0.00%,1,1,0.00%
s1-chu0-com-idvgnj0.qiniudns.com,0,0.00%,1,1,0.00%
www-cdn.icloud.com.akadns.net,0,0.00%,36,36,0.00%
sa6.tuisong.baidu.com,0,0.00%,2,2,0.00%
agentchannel.sa6.n.shifen.com,0,0.00%,2,2,0.00%
www.icloud.g.aaplimg.com,0,0.00%,43,43,0.00%
l-0006.l-msedge.net,0,0.00%,6,6,0.00%
187jlff4syi785wh.aliyunddos1006.com,0,0.00%,7,7,0.00%
fanyi.youdao.com,0,0.00%,52,52,0.00%
fanyi.ntes53.netease.com,0,0.00%,29,29,0.00%
ins-u4xprfqu.ias.tencent-cloud.net,0,0.00%,14,14,0.00%
terms-drcn.platform.dbankcloud.cn,0,0.00%,18,18,0.00%
default.dualstack.cn.zb.wagbridge.umeng.alibabacorp.com,0,0.00%,4,4,0.00%
aaid.umeng.com,0,0.00%,15,15,0.00%
default.dualstack.cn.zb.wagbridge.umeng.alibabacorp.com.gds.alibabadns.com,0,0.00%,4,4,0.00%
new-aaid.umeng.com,0,0.00%,8,8,0.00%
new-aaid.umeng.com.gds.alibabadns.com,0,0.00%,10,10,0.00%
intake.pbstck.com,0,0.00%,3,3,0.00%
client.map.n.shifen.com,0,0.00%,2,2,0.00%
errlog.umeng.com,0,0.00%,30,30,0.00%
errlog.umeng.com.gds.alibabadns.com,0,0.00%,6,6,0.00%
ossnt-errlog.umeng.com,0,0.00%,8,8,0.00%
newvector.map.n.shifen.com,0,0.00%,2,2,0.00%
wkstatic.bdimg.com.a.bdydns.com,0,0.00%,2,2,0.00%
wenkuretype.jomodns.com,0,0.00%,1,1,0.00%
opencdnbdwenku.jomodns.com,0,0.00%,2,2,0.00%
aps.amap.com.gds.alibabadns.com,0,0.00%,11,11,0.00%
wagbridge.amap.com,0,0.00%,19,19,0.00%
wagbridge.amap.com.gds.alibabadns.com,0,0.00%,19,19,0.00%
ea119-su121-na610.wagbridge.gaode.com,0,0.00%,23,23,0.00%
ea119-su121-na610.wagbridge.gaode.com.gds.alibabadns.com,0,0.00%,14,14,0.00%
default.cn.zb.na610.wagbridge.amap.alibabacorp.com,0,0.00%,16,16,0.00%
default.cn.zb.na610.wagbridge.amap.alibabacorp.com.gds.alibabadns.com,0,0.00%,31,31,0.00%
apd-7b74f36bff6f967e8277dc50543b4c75830430c7f21199af.v.smtcdns.com,0,0.00%,2,2,0.00%
tr.torland.ga,0,0.00%,5,5,0.00%
webv6hz.qiye.ntes53.netease.com,0,0.00%,3,3,0.00%
www.usenix.org,0,0.00%,7,7,0.00%
mum.m.alibaba.com,0,0.00%,3,3,0.00%
mum.m.alibaba.com.gds.alibabadns.com,0,0.00%,3,3,0.00%
secgw-dualstack-na61-na62.wagbridge.alibaba.alibaba.com,0,0.00%,3,3,0.00%
secgw-dualstack-na61-na62.wagbridge.alibaba.alibaba.com.gds.alibabadns.com,0,0.00%,7,7,0.00%
secgw-ipv6-acs-heyi.m.taobao.com,0,0.00%,2,2,0.00%
secgw-ipv6-acs-heyi.m.taobao.com.gds.alibabadns.com,0,0.00%,2,2,0.00%
hostupdate.vmware.com,0,0.00%,18,18,0.00%
shd-download.vmware.com.edgekey.net,0,0.00%,8,8,0.00%
shd-download.vmware.com.splitter-eip.akadns.net,0,0.00%,9,9,0.00%
shd-download.vmware.com.eip.akadns.net,0,0.00%,12,12,0.00%
eip-ntt.shd-download.vmware.com.akahost.net,0,0.00%,12,12,0.00%
tracker.open.cd,0,0.00%,26,26,0.00%
opportunarch.iqiyi.com,0,0.00%,6,6,0.00%
apigateway-v6.iqiyi.com,0,0.00%,2,2,0.00%
ins-z0rk80c6.ias.tencent-cloud.net,0,0.00%,4,4,0.00%
ins-9hkazpwd.ias.tencent-cloud.net,0,0.00%,5,5,0.00%
ins-zfnwnd8h.ias.tencent-cloud.net,0,0.00%,2,2,0.00%
bfp.global.dual.dotomi.weighted.com.akadns.net,0,0.00%,2,2,0.00%
dp3.qq.com,0,0.00%,50,50,0.00%
tdid.m.qq.com,0,0.00%,8,8,0.00%
worldgz.photo.store.qq.com,0,0.00%,15,15,0.00%
yun-hl.3g.qq.com,0,0.00%,49,49,0.00%
v6.mobilelog.upqzfile.com,0,0.00%,15,15,0.00%
tools.3g.qq.com,0,0.00%,27,27,0.00%
r1---sn-4g5lznez.gvt1.com,0,0.00%,2,2,0.00%
download.zerotier.com,0,0.00%,12,12,0.00%
archive.canonical.com,0,0.00%,55,55,0.00%
deb.anydesk.com,0,0.00%,8,8,0.00%
trade-acs.m.taobao.com,0,0.00%,2,2,0.00%
dualstack-a.apilocate.amap.com,0,0.00%,12,12,0.00%
tbshop.m.taobao.com,0,0.00%,3,3,0.00%
api-takumi-record.mihoyo.com,0,0.00%,11,11,0.00%
edgeassetservice.azureedge.net,0,0.00%,26,26,0.00%
kgb-ifs.tanx.com,0,0.00%,10,10,0.00%
pixel.quantserve.com,0,0.00%,4,4,0.00%
r10---sn-2x3eln76.c.2mdn.net,0,0.00%,3,3,0.00%
r18---sn-ni57rn7s.c.2mdn.net,0,0.00%,4,4,0.00%
us.grid.sinaedge.com,0,0.00%,28,28,0.00%
kln.grid.sinaedge.com,0,0.00%,37,37,0.00%
dualstack.r.ssl.global.fastly.net,0,0.00%,8,8,0.00%
i.y.qq.com,0,0.00%,77,77,0.00%
surfacedma.azurefd.net,0,0.00%,2,2,0.00%
promo.lu.com,0,0.00%,4,4,0.00%
httpd.apache.org,0,0.00%,3,3,0.00%
bugs.launchpad.net,0,0.00%,3,3,0.00%
static.debian.org,0,0.00%,3,3,0.00%
conda.anaconda.org,0,0.00%,11,11,0.00%
owncloud.org,0,0.00%,2,2,0.00%
bt2.edwardk.info,0,0.00%,46,46,0.00%
js.monitor.azure.com,0,0.00%,20,20,0.00%
qdreaderpic-1252317822.picsh.myqcloud.com,0,0.00%,8,8,0.00%
login.tailscale.com,0,0.00%,2707,2707,0.00%
prohackingtricks.github.io,0,0.00%,1,1,0.00%
bt.neu6.edu.cn,0,0.00%,8,8,0.00%
projectrooted.github.io,0,0.00%,1,1,0.00%
cn.ntp.org.cn,0,0.00%,64,64,0.00%
ntd-asus-2014b-en.fbs20.trendmicro.com,0,0.00%,95,95,0.00%
gslb6.fbs.trendmicro.com.akadns.net,0,0.00%,61,61,0.00%
aws-prod.fbs25.trendmicro.com,0,0.00%,61,61,0.00%
fbs.prod.spn.a1q7.net,0,0.00%,62,62,0.00%
oapi.dingtalk.com,0,0.00%,20,20,0.00%
worldtj.photo.store.qq.com,0,0.00%,18,18,0.00%
v.gdt.qq.com,0,0.00%,46,46,0.00%
q.qlogo.cn,0,0.00%,36,36,0.00%
torrenttracker.nwc.acsalaska.net,0,0.00%,113,113,0.00%
passport-v6.yeah.net,0,0.00%,10,10,0.00%
06bcad88731a478198cfa8508a71cbef.fp.measure.office.com,0,0.00%,2,2,0.00%
wx2.qq.com,0,0.00%,35,35,0.00%
p3-novel.byteimg.com,0,0.00%,2,2,0.00%
www.huan-zhang.com,0,0.00%,1,1,0.00%
cdn-sqn.aigei.com,0,0.00%,2,2,0.00%
iduzwhf.qiniudns.com,0,0.00%,1,1,0.00%
chinaweb159.china.line.qiniudns.com,0,0.00%,1,1,0.00%
s1.aigei.com,0,0.00%,2,2,0.00%
s1.chu0.com,0,0.00%,2,2,0.00%
chinawebgray12.china.line.qiniudns.com,0,0.00%,1,1,0.00%
maxcdn.bootstrapcdn.com,0,0.00%,9,9,0.00%
rr2---sn-aigl6nsr.googlevideo.com,0,0.00%,3,3,0.00%
rr5---sn-aigl6ns6.googlevideo.com,0,0.00%,956,956,0.00%
img2x-v6-sched.jcloudedge.com,0,0.00%,9,9,0.00%
www.collinsdictionary.com,0,0.00%,3,3,0.00%
h5.gdt.qq.com,0,0.00%,4,4,0.00%
bt.edwardk.info,0,0.00%,42,42,0.00%
d675b9b341264babb89108a84cfaf434.fp.measure.office.com,0,0.00%,2,2,0.00%
resolver.msg.xiaomi.net,0,0.00%,18,18,0.00%
mssdk3-normal-hl.zijieapi.com,0,0.00%,2,2,0.00%
cn-sdjn2-cmcc-live-02.bilivideo.com,0,0.00%,2,2,0.00%
cn-sdjn2-cmcc-v-07.bilivideo.com,0,0.00%,2,2,0.00%
archive.raspberrypi.org,0,0.00%,7,7,0.00%
pushwss.qidian.com,0,0.00%,2,2,0.00%
avatars.githubusercontent.com,0,0.00%,23,23,0.00%
xsaryf.jeancrt.tk,0,0.00%,1,1,0.00%
luka-group.github.io,0,0.00%,1,1,0.00%
pacaio.match.qq.com,0,0.00%,31,31,0.00%
mirror.sjtu.edu.cn,0,0.00%,375,375,0.00%
ilpdkname.github.io,0,0.00%,1,1,0.00%
d35o9b1e0bkfhx.cloudfront.net,0,0.00%,1,1,0.00%
66eb77e134ba42519e3b0d05d14e1ffc.fp.measure.office.com,0,0.00%,2,2,0.00%
waconafd.officeapps.live.com,0,0.00%,110,110,0.00%
d12xoj7p9moygp.cloudfront.net,0,0.00%,1,1,0.00%
kefirjs.github.io,0,0.00%,1,1,0.00%
android.rqd.qq.com,0,0.00%,29,29,0.00%
qqdata.ab.qq.com,0,0.00%,152,152,0.00%
qappcenterv6.3g.qq.com,0,0.00%,26,26,0.00%
www.gnu.org,0,0.00%,2,2,0.00%
2gpzpp82.sched.sma-dk.tdnsstic1.cn,0,0.00%,3,3,0.00%
jdimg1.qunliao.info,0,0.00%,3,3,0.00%
mfn.pk.jcloudimg.com,0,0.00%,5,5,0.00%
v1-ttvideo.qunliao.info.wsdvs.com,0,0.00%,1,1,0.00%
www.thegeeks.bz,0,0.00%,72,72,0.00%
api-41-0-0.twitter.com,0,0.00%,2,2,0.00%
loggw.alipay.com.cn,0,0.00%,22,22,0.00%
sourceware.org,0,0.00%,8,8,0.00%
3q5unp.qqscml.ml,0,0.00%,1,1,0.00%
eljoujat.github.io,0,0.00%,1,1,0.00%
xmduan.github.io,0,0.00%,61,61,0.00%
mpush-api.aliyun.com,0,0.00%,19,19,0.00%
identity.bitwarden.com,0,0.00%,4,4,0.00%
maps.windows.com,0,0.00%,33,33,0.00%
mottaquikarim.github.io,0,0.00%,1,1,0.00%
drayko.github.io,0,0.00%,1,1,0.00%
hardsix.makddegssa.cf,0,0.00%,61,61,0.00%
6.npupt.com,0,0.00%,18,18,0.00%
938d7029545143deb0197bfe12197c88.fp.measure.office.com,0,0.00%,2,2,0.00%
wildma.github.io,0,0.00%,1,1,0.00%
hi.wsale.net,0,0.00%,1,1,0.00%
kvnuke.github.io,0,0.00%,61,61,0.00%
cloud.video.taobao.com,0,0.00%,3,3,0.00%
r20swj13mr.microsoft.com,0,0.00%,6,6,0.00%
tmfsdktcp.m.qq.com,0,0.00%,23,23,0.00%
tmfsdk.m.qq.com,0,0.00%,10,10,0.00%
blog.1point3acres.com,0,0.00%,2,2,0.00%
time-macos.apple.com,0,0.00%,30,30,0.00%
yuyinzhou.github.io,0,0.00%,1,1,0.00%
gsp-ssl.ls-apple.com.akadns.net,0,0.00%,24,24,0.00%
gsp-ssl-geomap.ls-apple.com.akadns.net,0,0.00%,22,22,0.00%
gspx-ssl.ls.apple.com,0,0.00%,16,16,0.00%
get-bx.g.aaplimg.com,0,0.00%,24,24,0.00%
genmcai.github.io,0,0.00%,1,1,0.00%
ifconfig.co,0,0.00%,2,2,0.00%
mix.conssassketsiogesum.ga,0,0.00%,1,1,0.00%
static.123camquiz.com,0,0.00%,1,1,0.00%
uhdtia.qqscml.ga,0,0.00%,1,1,0.00%
cqc-download.weiyun.com,0,0.00%,74,74,0.00%
www.edu.cn,0,0.00%,1,1,0.00%
www.internet2.edu,0,0.00%,3,3,0.00%
internet2.edu,0,0.00%,3,3,0.00%
n8283613.iavs9x.u.avast.com,0,0.00%,2,2,0.00%
p9854759.vps18.u.avcdn.net,0,0.00%,2,2,0.00%
geolocation.onetrust.com,0,0.00%,4,4,0.00%
clarivate.com,0,0.00%,1,1,0.00%
z8.cnzz.com,0,0.00%,2,2,0.00%
api.jiasu.qq.com,0,0.00%,29,29,0.00%
p2pstUNTest.hapLaT.nET,0,0.00%,2,2,0.00%
HK-HKG-IBM-R003.teamviewer.com,0,0.00%,1,1,0.00%
truelim.github.io,0,0.00%,1,1,0.00%
omnipotent-front-end.github.io,0,0.00%,61,61,0.00%
p.qpic.cn,0,0.00%,21,21,0.00%
global.px.quantserve.com,0,0.00%,11,11,0.00%
pingfore.qq.com,0,0.00%,29,29,0.00%
dmplog.qq.com,0,0.00%,2,2,0.00%
cn-jssz-cm-02-40.bilivideo.com,0,0.00%,2,2,0.00%
edu.ntp.org.cn,0,0.00%,50,50,0.00%
aewebproxy.weixin.qq.com,0,0.00%,16,16,0.00%
s1.nsatu.com,0,0.00%,81,81,0.00%
j.gtld-servers.net,0,0.00%,2,2,0.00%
g.gtld-servers.net,0,0.00%,4,4,0.00%
thirdqq.qlogo.cn,0,0.00%,32,32,0.00%
k6951768.iavs9x.avg.u.avcdn.net,0,0.00%,1,1,0.00%
f4973661.iavs9x.avg.u.avcdn.net,0,0.00%,1,1,0.00%
s8784910.iavs9x.avg.u.avcdn.net,0,0.00%,1,1,0.00%
s5445469.iavs9x.avg.u.avcdn.net,0,0.00%,2,2,0.00%
s5445469.avi18.u.avcdn.net,0,0.00%,2,2,0.00%
k6951768.avi18.u.avcdn.net,0,0.00%,2,2,0.00%
k8136955.avi18.u.avcdn.net,0,0.00%,2,2,0.00%
pcapp.youku.com,0,0.00%,10,10,0.00%
6f956519e3f44ba5b388228717d12229.fp.measure.office.com,0,0.00%,2,2,0.00%
log.m.sm.cn,0,0.00%,2,2,0.00%
unpm-upaas.uc.cn,0,0.00%,6,6,0.00%
rating.collaboraonline.com,0,0.00%,2,2,0.00%
dns.adguard.com,0,0.00%,13,13,0.00%
ten.sngapm.qq.com,0,0.00%,27,27,0.00%
jubao.qq.com,0,0.00%,27,27,0.00%
wx.qq.com,0,0.00%,23,23,0.00%
webpush.wx.qq.com,0,0.00%,8,8,0.00%
pcapp-data-collect.youku.com,0,0.00%,14,14,0.00%
labuladong.github.io,0,0.00%,2,2,0.00%
new.qq.com,0,0.00%,7,7,0.00%
hits.kankandy.xyz,0,0.00%,1,1,0.00%
cm.l.qq.com,0,0.00%,24,24,0.00%
c5.rgstatic.net.cdn.cloudflare.net,0,0.00%,4,4,0.00%
www.researchgate.net.cdn.cloudflare.net,0,0.00%,6,6,0.00%
cdn.paddle.com,0,0.00%,2,2,0.00%
i1.rgstatic.net.cdn.cloudflare.net,0,0.00%,8,8,0.00%
l.sinaimg.cn,0,0.00%,6,6,0.00%
newsapi.sina.cn,0,0.00%,2,2,0.00%
fb.video.weibocdn.com,0,0.00%,7,7,0.00%
t1.appmeasurements.com,0,0.00%,9,9,0.00%
wangminrui.github.io,0,0.00%,61,61,0.00%
jsbluecat.github.io,0,0.00%,1,1,0.00%
maps-win-com-cdn.azureedge.net,0,0.00%,2,2,0.00%
maps-win-com-cdn.afd.azureedge.net,0,0.00%,2,2,0.00%
d1u2dq0qgohzjh.cloudfront.net,0,0.00%,1,1,0.00%
g.bing.com,0,0.00%,4,4,0.00%
swcloud.io,0,0.00%,2,2,0.00%
saladict.crimx.com,0,0.00%,2,2,0.00%
mail.davydov.ga,0,0.00%,58,58,0.00%
browser.sentry-cdn.com,0,0.00%,1,1,0.00%
account.live.com,0,0.00%,12,12,0.00%
acctcdn.msauth.net,0,0.00%,11,11,0.00%
lloria.fr,0,0.00%,19,19,0.00%
natescarlet.github.io,0,0.00%,1,1,0.00%
22082c5dc02e4643bb2c4417b346f0fb.fp.measure.office.com,0,0.00%,2,2,0.00%
pay.weixin.qq.com,0,0.00%,19,19,0.00%
wx.tenpay.com,0,0.00%,18,18,0.00%
game.weixin.qq.com,0,0.00%,14,14,0.00%
14aba6b0d1dab7055ca545d78bd220306108d8235d30a0a3.dlied1.cdntips.net,0,0.00%,2,2,0.00%
4bdd44a375037dd184284a65b7c2055a444376bf7ab2f7cb.dlied1.cdntips.net,0,0.00%,2,2,0.00%
wxa.weixin.qq.com,0,0.00%,16,16,0.00%
nssui.comlaude.ch,0,0.00%,4,4,0.00%
h.gtld-servers.net,0,0.00%,1,1,0.00%
f.gtld-servers.net,0,0.00%,4,4,0.00%
comprehends.github.io,0,0.00%,1,1,0.00%
tracker.torrent.eu.org,0,0.00%,27,27,0.00%
api.wakatime.com,0,0.00%,17,17,0.00%
fd.3.cn.gslb.qianxun.com,0,0.00%,3,3,0.00%
gia.jd.com.gslb.qianxun.com,0,0.00%,6,6,0.00%
wq.jd.com.gslb.qianxun.com,0,0.00%,10,10,0.00%
jiu.linyeming.pub,0,0.00%,76,76,0.00%
iwx.mail.qq.com,0,0.00%,15,15,0.00%
adimg.uve.weibo.com,0,0.00%,8,8,0.00%
livephoto.us.sinaimg.cn,0,0.00%,9,9,0.00%
vip.storage.weibo.com,0,0.00%,16,16,0.00%
stockinfo.htsec.com,0,0.00%,1,1,0.00%
api26-core-lf.amemv.com,0,0.00%,1,1,0.00%
ad.us.sinaimg.cn,0,0.00%,13,13,0.00%
iacc.qq.com,0,0.00%,2,2,0.00%
cashier.youzan.com,0,0.00%,1,1,0.00%
shop18071305.youzan.com,0,0.00%,1,1,0.00%
su.yzcdn.cn,0,0.00%,1,1,0.00%
b.yzcdn.cn,0,0.00%,1,1,0.00%
h5.youzan.com,0,0.00%,1,1,0.00%
static-asm.secure.skypeassets.com,0,0.00%,197,197,0.00%
simg.s.weibo.com,0,0.00%,10,10,0.00%
apd-d531521fae6aa995d89e5589bbc7d96c7def19e52513f7eb.v.smtcdns.com,0,0.00%,6,6,0.00%
tracker.imgoingto.icu.cdn.cloudflare.net,0,0.00%,23,23,0.00%
tiaotiaohu98.github.io,0,0.00%,61,61,0.00%
ese3a9b6c5d0ic.prissl.qiqiuyun.net,0,0.00%,1,1,0.00%
p2pstuNTEST.HaPlAt.Net,0,0.00%,2,2,0.00%
53390ab73e8a4e41875fb6a46e02036b.fp.measure.office.com,0,0.00%,1,1,0.00%
tracker.byr.cn,0,0.00%,51,51,0.00%
cdn.adblockcdn.com,0,0.00%,6,6,0.00%
greasyfork.org,0,0.00%,14,14,0.00%
fp-afd.azureedge.us,0,0.00%,10,10,0.00%
git.kernel.org,0,0.00%,4,4,0.00%
grouptalk.c2c.qq.com,0,0.00%,130,130,0.00%
minute.sbisabhesmatira.ga,0,0.00%,1,1,0.00%
iwgasd.nb78.tk,0,0.00%,1,1,0.00%
up-hl.3g.qq.com,0,0.00%,13,13,0.00%
ins-609loygs.ias.tencent-cloud.net,0,0.00%,8,8,0.00%
utoken.umeng.com,0,0.00%,5,5,0.00%
firebase-settings.crashlytics.com,0,0.00%,4,4,0.00%
news.sina.com.cn,0,0.00%,15,15,0.00%
finance.sina.com.cn,0,0.00%,15,15,0.00%
tech.sina.com.cn,0,0.00%,8,8,0.00%
ent.sina.com.cn,0,0.00%,5,5,0.00%
d2.sina.com.cn,0,0.00%,11,11,0.00%
n1.sinaimg.cn,0,0.00%,3,3,0.00%
n3.sinaimg.cn,0,0.00%,17,17,0.00%
d5.sina.com.cn,0,0.00%,9,9,0.00%
d1.sina.com.cn,0,0.00%,10,10,0.00%
d3.sina.com.cn,0,0.00%,8,8,0.00%
p.ivideo.sina.com.cn,0,0.00%,1,1,0.00%
d9.sina.com.cn,0,0.00%,7,7,0.00%
d7.sina.com.cn,0,0.00%,11,11,0.00%
simg.sinajs.cn,0,0.00%,7,7,0.00%
s3.pfp.sina.net,0,0.00%,3,3,0.00%
www.sina.com.cn,0,0.00%,7,7,0.00%
d6.sina.com.cn,0,0.00%,8,8,0.00%
d8.sina.com.cn,0,0.00%,6,6,0.00%
mjs.sinaimg.cn,0,0.00%,16,16,0.00%
static-ssl.mediav.com,0,0.00%,1,1,0.00%
d0.sina.com.cn,0,0.00%,5,5,0.00%
d4.sina.com.cn,0,0.00%,6,6,0.00%
n2.sinaimg.cn,0,0.00%,11,11,0.00%
sjs2.sinajs.cn,0,0.00%,3,3,0.00%
f11.baidu.com,0,0.00%,2,2,0.00%
P2PStuNtEst.hAplat.Net,0,0.00%,2,2,0.00%
mem.gfx.ms,0,0.00%,4,4,0.00%
fp-afd.azurefd.us,0,0.00%,8,8,0.00%
test-perfops.haproxy.com,0,0.00%,2,2,0.00%
q2.qlogo.cn,0,0.00%,22,22,0.00%
coral.qq.com,0,0.00%,10,10,0.00%
dht.anacrolix.link,0,0.00%,6,6,0.00%
8d0eea7876a26f425808d81bbcd4f6a5.clo.footprintdns.com,0,0.00%,1,1,0.00%
se1prdapp01-canary.cloudapp.net,0,0.00%,11,11,0.00%
c2cpicdw.qpic.cn,0,0.00%,14,14,0.00%
v6.htdata.qq.com,0,0.00%,6,6,0.00%
msfwifiv6.3g.qq.com,0,0.00%,6,6,0.00%
docs.gitea.io,0,0.00%,2,2,0.00%
gitea.io,0,0.00%,1,1,0.00%
mail.rubengibson.ml,0,0.00%,1,1,0.00%
channel2rss.bitmachine.org,0,0.00%,99,99,0.00%
C.ROOT-SERVERS.NET,0,0.00%,12,12,0.00%
doh.dns.apple.com.v.aaplimg.com,0,0.00%,11,11,0.00%
msgstore.www.notion.so,0,0.00%,56,56,0.00%
99a400a1ea124b55a39c2d2c34cf3cad.fp.measure.office.com,0,0.00%,1,1,0.00%
msg-video.xhscdn.com,0,0.00%,10,10,0.00%
img03.51jobcdn.com,0,0.00%,1,1,0.00%
c-hzgt2.getui.com,0,0.00%,4,4,0.00%
data.ab.qq.com,0,0.00%,50,50,0.00%
flash.sec.miui.com,0,0.00%,1,1,0.00%
sa4.tuisong.baidu.com,0,0.00%,3,3,0.00%
86rzpg.tdum.alibaba.com,0,0.00%,1,1,0.00%
p38-contacts.icloud.com,0,0.00%,2,2,0.00%
cgi.find.qq.com,0,0.00%,27,27,0.00%
cgi.qqweb.qq.com,0,0.00%,14,14,0.00%
ps-scholar-static.bj.bcebos.com,0,0.00%,4,4,0.00%
view.officeapps.live.com,0,0.00%,4,4,0.00%
q.i.gdt.qq.com,0,0.00%,10,10,0.00%
login.wx2.qq.com,0,0.00%,4,4,0.00%
ipv6.www.so.com,0,0.00%,13,13,0.00%
rlogs.youdao.com,0,0.00%,8,8,0.00%
qiyukf.com,0,0.00%,7,7,0.00%
triplelift-match.dotomi.com,0,0.00%,2,2,0.00%
ju9qjm.qqscml.ml,0,0.00%,1,1,0.00%
api.investing.com,0,0.00%,8,8,0.00%
gengry.github.io,0,0.00%,61,61,0.00%
b.config.skype.com,0,0.00%,16,16,0.00%
2d401d8cc648466eb9176e7be93faefc.fp.measure.office.com,0,0.00%,2,2,0.00%
470bfe1960c44be6a284f43fdce074ea.fp.measure.office.com,0,0.00%,2,2,0.00%
tvaxweibo.grid.sinaedge.com,0,0.00%,9,9,0.00%
mscstorage.eastmoney.com,0,0.00%,20,20,0.00%
c0.info.afilias-nst.info,0,0.00%,2,2,0.00%
ns-418.awsdns-52.com,0,0.00%,1,1,0.00%
extras.ubuntu.com,0,0.00%,18,18,0.00%
bitbucket.org,0,0.00%,148,148,0.00%
mdap.alipay.com,0,0.00%,9,9,0.00%
pytorch-geometric.readthedocs.io,0,0.00%,3,3,0.00%
apphub.qzone.qq.com,0,0.00%,13,13,0.00%
as.com,0,0.00%,49,49,0.00%
ibat.wazong.de,0,0.00%,1,1,0.00%
policy.jd.com,0,0.00%,4,4,0.00%
tbsrecovery.imtt.qq.com,0,0.00%,3,3,0.00%
un.m.jd.com,0,0.00%,4,4,0.00%
cfg.imtt.qq.com,0,0.00%,6,6,0.00%
log.tbs.qq.com,0,0.00%,17,17,0.00%
unpkg.com,0,0.00%,9,9,0.00%
kit.fontawesome.com,0,0.00%,2,2,0.00%
cdn.datatables.net,0,0.00%,2,2,0.00%
polyfill.io,0,0.00%,10,10,0.00%
ka-p.fontawesome.com,0,0.00%,2,2,0.00%
mltrustcom2022.edas.info,0,0.00%,7,7,0.00%
music.91q.com,0,0.00%,6,6,0.00%
logindict.youdao.com,0,0.00%,1,1,0.00%
doctrans-service.youdao.com,0,0.00%,1,1,0.00%
si1.go2yd.com,0,0.00%,1,1,0.00%
foundation.youdao.com,0,0.00%,6,6,0.00%
stun6.chat.bilibili.com,0,0.00%,2,2,0.00%
iugfc.gobackty.ga,0,0.00%,61,61,0.00%
ns-1811.awsdns-34.co.uk,0,0.00%,1,1,0.00%
weboffice.wpsdns.com,0,0.00%,25,25,0.00%
loggw.alipaydns.com,0,0.00%,8,8,0.00%
api.8864029a8b01d50a95d558b5792ce2d6.pw,0,0.00%,4,4,0.00%
cgi.connect.qq.com,0,0.00%,14,14,0.00%
tbsone.imtt.qq.com,0,0.00%,14,14,0.00%
masdkv6.3g.qq.com,0,0.00%,7,7,0.00%
rr5---sn-npoldn7l.c.youtube.com,0,0.00%,3,3,0.00%
alloyreport.cdn-go.cn,0,0.00%,1,1,0.00%
public.us.sinaimg.cn,0,0.00%,9,9,0.00%
connectedpapershpa.azureedge.net,0,0.00%,3,3,0.00%
www.centbrowser.com,0,0.00%,2,2,0.00%
apd-7fc57d805bacbeaaf75ddd1a651f404911f9d2593dd2960c.v.smtcdns.com,0,0.00%,2,2,0.00%
livep.l.qq.com,0,0.00%,12,12,0.00%
etl-xlmc-ssl.sandai.net,0,0.00%,7,7,0.00%
dualstack.q3.shared.global.fastly.net,0,0.00%,9,9,0.00%
bcc42b420c334fa2aee093da10222739.fp.measure.office.com,0,0.00%,1,1,0.00%
data-ai.microsoft.com,0,0.00%,15,15,0.00%
ibank.bankofbeijing.com.cn,0,0.00%,24,24,0.00%
www.clarity.ms,0,0.00%,58,58,0.00%
extension-updates.opera.com,0,0.00%,4,4,0.00%
carapax.net,0,0.00%,30,30,0.00%
jinliangxx.github.io,0,0.00%,1,1,0.00%
zafirshi.github.io,0,0.00%,1,1,0.00%
tmfmazu.m.qq.com,0,0.00%,2,2,0.00%
networkcheck.kde.org,0,0.00%,27,27,0.00%
apiaccess-toutiao-com-1308810737.file.myqcloud.com,0,0.00%,2,2,0.00%
api.prize.qq.com,0,0.00%,2,2,0.00%
use.typekit.net,0,0.00%,3,3,0.00%
mogeko.github.io,0,0.00%,1,1,0.00%
emupdate.bav.avcdn.net,0,0.00%,2,2,0.00%
prd.dls.samsung.com.cn,0,0.00%,2,2,0.00%
plbslog.umeng.com,0,0.00%,7,7,0.00%
alog.umeng.com,0,0.00%,10,10,0.00%
control.aps.amap.com,0,0.00%,6,6,0.00%
rgeo-aloc.amap.com,0,0.00%,2,2,0.00%
api.voso.ml,0,0.00%,1,1,0.00%
d3hitamb7drqut.cloudfront.net,0,0.00%,1,1,0.00%
a1-6.akam.net,0,0.00%,6,6,0.00%
cn-lnsy-cmcc-v-04.bilivideo.com,0,0.00%,22,22,0.00%
ssl.ptlogin2.mail.qq.com,0,0.00%,5,5,0.00%
rl.mail.qq.com,0,0.00%,6,6,0.00%
connect.qq.com,0,0.00%,4,4,0.00%
api.panawyt.xyz,0,0.00%,11,11,0.00%
fq.g502.cf,0,0.00%,1,1,0.00%
apnic.authdns.ripe.net,0,0.00%,3,3,0.00%
apnic1.dnsnode.net,0,0.00%,3,3,0.00%
rirns.arin.net,0,0.00%,3,3,0.00%
ns2.apnic.net,0,0.00%,5,5,0.00%
ns3.lacnic.net,0,0.00%,3,3,0.00%
zhujiahua.html5.qq.com,0,0.00%,4,4,0.00%
teams.live.com,0,0.00%,15,15,0.00%
zsfznb.qqscml.ga,0,0.00%,1,1,0.00%
log1.cmpassport.com,0,0.00%,6,6,0.00%
wap.cmpassport.com,0,0.00%,8,8,0.00%
www.cmpassport.com,0,0.00%,3,3,0.00%
config.cmpassport.com,0,0.00%,6,6,0.00%
onekey1.cmpassport.com,0,0.00%,4,4,0.00%
open.e.189.cn,0,0.00%,6,6,0.00%
httpdns.yunxindns.com,0,0.00%,4,4,0.00%
d2fc7ojl9ttfsq.cloudfront.net,0,0.00%,1,1,0.00%
ie9comview.vo.msecnd.net,0,0.00%,4,4,0.00%
1bdsbjl.faer.gq,0,0.00%,1,1,0.00%
img-3.pddpic.com,0,0.00%,1,1,0.00%
pull-flv-f1-xg.bytecdn.cn,0,0.00%,1,1,0.00%
ftp.stackoverflow.wiki,0,0.00%,3,3,0.00%
factors.sofire.baidu.com,0,0.00%,14,14,0.00%
t1.baidu.com,0,0.00%,1,1,0.00%
t2.baidu.com,0,0.00%,1,1,0.00%
t3.baidu.com,0,0.00%,1,1,0.00%
tz.cccxxx.gq,0,0.00%,1,1,0.00%
apikeys.civiccomputing.com,0,0.00%,2,2,0.00%
devdocs.io,0,0.00%,2,2,0.00%
gravatar.loli.net,0,0.00%,2,2,0.00%
fastly.jsdelivr.net,0,0.00%,3,3,0.00%
video.donglin.org,0,0.00%,2,2,0.00%
updatecenter.qq.com,0,0.00%,20,20,0.00%
file.wx.qq.com,0,0.00%,2,2,0.00%
bed9d7337ba85c5cd84de582185db22b.clo.footprintdns.com,0,0.00%,2,2,0.00%
opensource.org,0,0.00%,2,2,0.00%
stup7.appmeasurements.com,0,0.00%,42,42,0.00%
bae.appmeasurements.com,0,0.00%,51,51,0.00%
t3.appmeasurements.com,0,0.00%,18,18,0.00%
e7b2bed09c1645f4a93c7591bb2e15e0.fp.measure.office.com,0,0.00%,1,1,0.00%
public.popcorn-tracker.org,0,0.00%,13,13,0.00%
wimc.github.io,0,0.00%,2,2,0.00%
search.yahoo.com,0,0.00%,4,4,0.00%
yandex.ru,0,0.00%,2,2,0.00%
www.startpage.com,0,0.00%,4,4,0.00%
search.daum.net,0,0.00%,2,2,0.00%
search.seznam.cz,0,0.00%,2,2,0.00%
passport.yandex.ru,0,0.00%,2,2,0.00%
yastatic.net,0,0.00%,2,2,0.00%
8051038c98cb45bbaf3f032d88546544.fp.measure.office.com,0,0.00%,1,1,0.00%
dfscdn.dfcfw.com,0,0.00%,53,53,0.00%
merchandise.opera-api.com,0,0.00%,8,8,0.00%
h5static.kuwo.cn,0,0.00%,1,1,0.00%
kwimg1.kuwo.cn,0,0.00%,1,1,0.00%
kwimg3.kuwo.cn,0,0.00%,1,1,0.00%
kwimg2.kuwo.cn,0,0.00%,2,2,0.00%
star.kwcdn.kuwo.cn,0,0.00%,2,2,0.00%
img3.kuwo.cn,0,0.00%,2,2,0.00%
img1.kuwo.cn,0,0.00%,1,1,0.00%
img1.kwcdn.kuwo.cn,0,0.00%,1,1,0.00%
img4.kuwo.cn,0,0.00%,2,2,0.00%
img4.sycdn.kuwo.cn,0,0.00%,1,1,0.00%
img3.sycdn.kuwo.cn,0,0.00%,1,1,0.00%
img1.sycdn.kuwo.cn,0,0.00%,1,1,0.00%
api.holalauncher.com,0,0.00%,2,2,0.00%
netapm.music.163.com,0,0.00%,9,9,0.00%
res.weread.qq.com,0,0.00%,5,5,0.00%
a.nel.cloudflare.com,0,0.00%,15,15,0.00%
i.weread.qq.com,0,0.00%,9,9,0.00%
o0palg.qqscml.ml,0,0.00%,1,1,0.00%
z9.cnzz.com,0,0.00%,4,4,0.00%
ccfddl.github.io,0,0.00%,2,2,0.00%
ack.push.n.shifen.com,0,0.00%,2,2,0.00%
z163picipv6.v.trpcdn.net,0,0.00%,4,4,0.00%
vodkgeyttp9.vod.126.net,0,0.00%,4,4,0.00%
vodkgeyttp8.vod.126.net,0,0.00%,2,2,0.00%
v-2a384407.71edge.com,0,0.00%,2,2,0.00%
v-7a8dc83e.71edge.com,0,0.00%,2,2,0.00%
control-i.iqiyi.com,0,0.00%,4,4,0.00%
qrcode.iqiyipic.com,0,0.00%,6,6,0.00%
sns-comment.iqiyi.com,0,0.00%,12,12,0.00%
v-2a38440b.71edge.com,0,0.00%,4,4,0.00%
bestpractices.coreinfrastructure.org,0,0.00%,6,6,0.00%
t4.appmeasurements.com,0,0.00%,4,4,0.00%
azurecomcdn.azureedge.net,0,0.00%,46,46,0.00%
ns-cloud-b2.googledomains.com,0,0.00%,2,2,0.00%
metrics.raptr.com,0,0.00%,37,37,0.00%
d2x5o44lmz1ltu.cloudfront.net,0,0.00%,1,1,0.00%
pornleech.com,0,0.00%,19,19,0.00%
hg.stevelosh.com,0,0.00%,1,1,0.00%
ch-zrh-anx-r006.router.teamviewer.com,0,0.00%,4,4,0.00%
taf.teamviewer.com,0,0.00%,4,4,0.00%
l-0007.l-msedge.NET,0,0.00%,15,15,0.00%
sa.gdt.qq.com,0,0.00%,14,14,0.00%
v2.gdt.qq.com,0,0.00%,12,12,0.00%
onekey.cmpassport.com,0,0.00%,4,4,0.00%
az667904-pme.ec.azureedge.net,0,0.00%,18,18,0.00%
jay1lyg.github.io,0,0.00%,1,1,0.00%
mrkaorou.github.io,0,0.00%,1,1,0.00%
k.us.sinaimg.cn,0,0.00%,7,7,0.00%
api.breezip.com,0,0.00%,2,2,0.00%
P2PStUntesT.hAPLAT.nEt,0,0.00%,2,2,0.00%
v-2a384403.71edge.com,0,0.00%,2,2,0.00%
mlvbdc.live.qcloud.com,0,0.00%,25,25,0.00%
openapi.wps.cn,0,0.00%,2,2,0.00%
comm.weixinbridge.com,0,0.00%,25,25,0.00%
t.gdt.qq.com,0,0.00%,2,2,0.00%
tamaegis.com,0,0.00%,4,4,0.00%
community.steamstatic.com,0,0.00%,4,4,0.00%
d21buns5ku92am.cloudfront.net,0,0.00%,2,2,0.00%
lvraikkonen.github.io,0,0.00%,61,61,0.00%
security.debian.org,0,0.00%,6,6,0.00%
ftp.debian.org,0,0.00%,10,10,0.00%
db.cn.clamav.net,0,0.00%,28,28,0.00%
sns.qzone.qq.com,0,0.00%,12,12,0.00%
ecloud.10086.cn.cdngtm.cn,0,0.00%,8,8,0.00%
wWW.vOd.LxDns.COM,0,0.00%,2,2,0.00%
p2pSTuNtEsT.HAPlaT.NeT,0,0.00%,2,2,0.00%
gaea.meituan.com,0,0.00%,6,6,0.00%
apimobile.meituan.com,0,0.00%,6,6,0.00%
wmapi-mt.meituan.com,0,0.00%,8,8,0.00%
photo.sina.com.cn,0,0.00%,3,3,0.00%
eladies.sina.com.cn,0,0.00%,3,3,0.00%
corp.sina.com.cn,0,0.00%,5,5,0.00%
mil.news.sina.com.cn,0,0.00%,1,1,0.00%
updpct.info,0,0.00%,4,4,0.00%
news.hangzhou.com.cn,0,0.00%,1,1,0.00%
www.hangzhou.com.cn,0,0.00%,1,1,0.00%
t5.appmeasurements.com,0,0.00%,13,13,0.00%
WwW.Google.coM,0,0.00%,3,3,0.00%
wWW.yAhOo.coM,0,0.00%,3,3,0.00%
e7nvur.qqscml.ml,0,0.00%,1,1,0.00%
www.GOOgle.CoM,0,0.00%,3,3,0.00%
WwW.yAHoo.coM,0,0.00%,3,3,0.00%
amyclogan.writerfolio.com,0,0.00%,1,1,0.00%
helm.elastic.co,0,0.00%,30,30,0.00%
kubernetes-charts-incubator.storage.googleapis.com,0,0.00%,24,24,0.00%
b-0016.b-dc-msedge.net,0,0.00%,4,4,0.00%
tiandi0228.github.io,0,0.00%,1,1,0.00%
v6.s.360.cn,0,0.00%,25,25,0.00%
api.ghelper.xyz,0,0.00%,4,4,0.00%
live11-adapt.pddpic.com,0,0.00%,1,1,0.00%
api26-normal-lf.amemv.com,0,0.00%,1,1,0.00%
binary-optiontrade.berramelbeausacont.tk,0,0.00%,61,61,0.00%
view.inews.qq.com,0,0.00%,4,4,0.00%
use.fontawesome.com,0,0.00%,4,4,0.00%
updates.logitech.com,0,0.00%,33,33,0.00%
cn-jsyz-ct-03-28.bilivideo.com,0,0.00%,2,2,0.00%
pngimg.com,0,0.00%,5,5,0.00%
f1876021e5544de999c898ece6fab8fa.fp.measure.office.com,0,0.00%,2,2,0.00%
open.free-tracker.ga,0,0.00%,2,2,0.00%
sta.gtimg.com,0,0.00%,6,6,0.00%
n.extrabux.top,0,0.00%,2,2,0.00%
d.extrabux.top,0,0.00%,2,2,0.00%
wiki-gateway.eudic.net,0,0.00%,3,3,0.00%
wWW.YAhoo.com,0,0.00%,3,3,0.00%
WWw.GoogLe.cOm,0,0.00%,3,3,0.00%
feeds.neosmart.net,0,0.00%,12,12,0.00%
seanchense.github.io,0,0.00%,2,2,0.00%
public-apis.cleanmymac.com,0,0.00%,8,8,0.00%
api.panther.macpaw.com,0,0.00%,8,8,0.00%
spicedcornedegg.github.io,0,0.00%,1,1,0.00%
whois.apnic.net,0,0.00%,37,37,0.00%
zephyrzoom.github.io,0,0.00%,1,1,0.00%
jd.abxin.cf,0,0.00%,1,1,0.00%
40d710a6b9ad4d5a86c225762b470a94.fp.measure.office.com,0,0.00%,2,2,0.00%
5332091c166e449c88d824f58e0e9724.fp.measure.office.com,0,0.00%,2,2,0.00%
www1482.ff-03.com,0,0.00%,1,1,0.00%
e9825c8d74474700b16bfad1146a8215.fp.measure.office.com,0,0.00%,2,2,0.00%
static.sg1.vip.prod.criteo.net,0,0.00%,4,4,0.00%
spl.zeotap.com,0,0.00%,10,10,0.00%
gum.sg1.vip.prod.criteo.com,0,0.00%,8,8,0.00%
ae4a5a896b40498b9467848584181ceb.fp.measure.office.com,0,0.00%,2,2,0.00%
b2584d4b59b64fe7a62776aca89f2cd3.fp.measure.office.com,0,0.00%,1,1,0.00%
p44-calendars.icloud.com,0,0.00%,2,2,0.00%
ublockorigin.github.io,0,0.00%,4,4,0.00%
images.nvidia.com,0,0.00%,6,6,0.00%
sa2.tuisong.baidu.com,0,0.00%,2,2,0.00%
gravatar.appinn.net,0,0.00%,2,2,0.00%
p2perrorlog.douyucdn.cn,0,0.00%,15,15,0.00%
sdkapi.douyucdn.cn,0,0.00%,6,6,0.00%
ping.archlinux.org,0,0.00%,16,16,0.00%
39b43358d311419d932c4c98825df25b.fp.measure.office.com,0,0.00%,1,1,0.00%
0365d2d7ef224fb9ab3b1a8de2695939.fp.measure.office.com,0,0.00%,2,2,0.00%
n.de.net,0,0.00%,4,4,0.00%
l.de.net,0,0.00%,4,4,0.00%
p2pSTUntEst.haPLaT.NEt,0,0.00%,2,2,0.00%
ns2-38.azure-dns.net,0,0.00%,10,10,0.00%
tracker.iriseden.fr,0,0.00%,17,17,0.00%
wWW.YAHoO.cOm,0,0.00%,3,3,0.00%
wwW.GOOgLe.com,0,0.00%,3,3,0.00%
japancartographersassociation.github.io,0,0.00%,61,61,0.00%
hangzhi.github.io,0,0.00%,1,1,0.00%
cclibraries-defaults-cdn.adobe.com,0,0.00%,2,2,0.00%
www.tsx.com,0,0.00%,1,1,0.00%
news.ssp.qq.com,0,0.00%,10,10,0.00%
mini2015.qq.com,0,0.00%,4,4,0.00%
repos.fedorapeople.org,0,0.00%,10,10,0.00%
1877551230.github.io,0,0.00%,1,1,0.00%
edgeassetservice.afd.azureedge.net,0,0.00%,4,4,0.00%
star-azureedge-prod.trafficmanager.net,0,0.00%,7,7,0.00%
dual.part-0021.t-0009.t-msedge.net,0,0.00%,9,9,0.00%
part-0021.t-0009.t-msedge.net,0,0.00%,25,25,0.00%
www-alv.google-analytics.com,0,0.00%,10,10,0.00%
ad.turn.com,0,0.00%,5,5,0.00%
ad.turn.com.akadns.net,0,0.00%,6,6,0.00%
ad4m.at,0,0.00%,2,2,0.00%
mirrors.sjtug.sjtu.edu.cn,0,0.00%,36,36,0.00%
script.leadboxer.com,0,0.00%,1,1,0.00%
incogbyte.github.io,0,0.00%,1,1,0.00%
applitopia.github.io,0,0.00%,1,1,0.00%
kevindgk.github.io,0,0.00%,1,1,0.00%
img2022.cnblogs.com,0,0.00%,1,1,0.00%
www.qcc.com,0,0.00%,2,2,0.00%
z11.cnzz.com,0,0.00%,2,2,0.00%
image.qcc.com,0,0.00%,4,4,0.00%
fw.bjrcgz.gov.cn,0,0.00%,4,4,0.00%
yzt.beijing.gov.cn,0,0.00%,4,4,0.00%
sdl.360safe.com,0,0.00%,2,2,0.00%
www.ccgp.gov.cn,0,0.00%,5,5,0.00%
ipv6-test.com,0,0.00%,6,6,0.00%
i.gdt.qq.com,0,0.00%,8,8,0.00%
l.qq.com,0,0.00%,8,8,0.00%
e0018cfe21b34d24a8ee995887306dca.fp.measure.office.com,0,0.00%,2,2,0.00%
truwoiruotuip.yriuyqloiulouhy.ml,0,0.00%,1,1,0.00%
trendpict.github.io,0,0.00%,1,1,0.00%
gafanssr.github.io,0,0.00%,2,2,0.00%
singerimg.kugou.com,0,0.00%,4,4,0.00%
hao6.qhimg.com,0,0.00%,2,2,0.00%
aloc-control-plus.amap.com,0,0.00%,4,4,0.00%
appimg2.qq.com,0,0.00%,2,2,0.00%
www.haizeix.com,0,0.00%,5,5,0.00%
view.thnf.ml,0,0.00%,1,1,0.00%
d26u1qpb8nca0s.cloudfront.net,0,0.00%,1,1,0.00%
7f408d220f4244adbff238ec142a507b.fp.measure.office.com,0,0.00%,1,1,0.00%
worldnj.photo.store.qq.com,0,0.00%,6,6,0.00%
pdns99.ultradns.net,0,0.00%,5,5,0.00%
albarqouni.github.io,0,0.00%,61,61,0.00%
euleryang.github.io,0,0.00%,1,1,0.00%
uaqg.github.io,0,0.00%,1,1,0.00%
tracker.teambelgium.net,0,0.00%,18,18,0.00%
accounts.nvgs.nvidia.com,0,0.00%,11,11,0.00%
dvfp.ftss.ccb.com,0,0.00%,1,1,0.00%
1637314617.rsc.cdn77.org,0,0.00%,3,3,0.00%
bat-bing-com.a-0001.a-msedge.net,0,0.00%,3,3,0.00%
collect.springer.com,0,0.00%,5,5,0.00%
trouter-azsc-asse-0-b.cloudapp.net,0,0.00%,12,12,0.00%
touch.ccb.com,0,0.00%,1,1,0.00%
tx-adaptive.pull.yximgs.com.l2-dk.sched.dcloudlive.com,0,0.00%,1,1,0.00%
ws-adaptive.pull.yximgs.com.gccdn.net,0,0.00%,1,1,0.00%
ws.pull.yximgs.com.gccdn.net,0,0.00%,1,1,0.00%
s6210-cyw.gslb.ksyuncdn.com,0,0.00%,1,1,0.00%
hw-origin.pull.yximgs.com.c.cdnhwc3.com,0,0.00%,1,1,0.00%
hcdnl.pullks.gslb.c.cdnhwc2.com,0,0.00%,1,1,0.00%
hw-adaptive.pull.yximgs.com.c.cdnhwc3.com,0,0.00%,1,1,0.00%
txmov2.a.yximgs.com.sched.vip-dk.tdnsvod1.cn,0,0.00%,1,1,0.00%
k17-x.gslb.h.ngaacdn.cn,0,0.00%,1,1,0.00%
v3.kwaicdn.com.download.ks-cdn.com,0,0.00%,1,1,0.00%
bceksproxyq2.jomodns.com,0,0.00%,1,1,0.00%
d1.static.yximgs.com.sched.dma-dk.tdnsdl1.cn,0,0.00%,1,1,0.00%
776041.sched.kslego-dk.tdnsstic1.cn,0,0.00%,1,1,0.00%
1036149.sched.kslego-dk.tdnsstic1.cn,0,0.00%,1,1,0.00%
tx2.a.kwimgs.com.cdn.dnsv1.com,0,0.00%,1,1,0.00%
txmov6.a.yximgs.com.sched.vip-dk.tdnsvod1.cn,0,0.00%,1,1,0.00%
dq.sched.vipcm-dk.tdnsv5.com,0,0.00%,2,2,0.00%
p1.a.yximgs.com.cdn.dnsv1.com,0,0.00%,1,1,0.00%
s6220.gslb.ksyuncdn.com,0,0.00%,1,1,0.00%
p1-live.a.yximgs.com.cdn.dnsv1.com,0,0.00%,1,1,0.00%
k164-ipv6.gslb.ksyuncdn.com,0,0.00%,1,1,0.00%
p4-live.a.yximgs.com.3dce113f.c.cdnhwc1.com,0,0.00%,1,1,0.00%
p4.a.yximgs.com.3dce113f.c.cdnhwc1.com,0,0.00%,1,1,0.00%
8hdq5lcg.sched.kslego-dk.tdnsstic1.cn,0,0.00%,1,1,0.00%
dq.sched.vip1-dk.tdnsvod1.cn,0,0.00%,2,2,0.00%
855qlqvu.sched.kslego-dk.tdnsstic1.cn,0,0.00%,1,1,0.00%
txcmvod.sched.vip-dk.tdnsvod1.cn,0,0.00%,1,1,0.00%
txmov6.a.kwimgs.com.sched.vip-dk.tdnsvod1.cn,0,0.00%,1,1,0.00%
txdwkmov.a.yximgs.com.sched.vip-dk.tdnsvod1.cn,0,0.00%,1,1,0.00%
txdwkvod.a.etoote.com.sched.vip-dk.tdnsvod1.cn,0,0.00%,1,1,0.00%
d1-magic.sched.dma-dk.tdnsdl1.cn,0,0.00%,1,1,0.00%
d3-magic.static.yximgs.com.download.ks-cdn.com,0,0.00%,1,1,0.00%
dq1.sched.vip-dk.tdnsvod1.cn,0,0.00%,1,1,0.00%
cdn.feathr.co,0,0.00%,1,1,0.00%
diffuser-cdn.app-us1.com,0,0.00%,1,1,0.00%
tx.pull.yximgs.com.l2-dk.sched.dcloudlive.com,0,0.00%,1,1,0.00%
k17.gslb.ksyuncdn.com,0,0.00%,1,1,0.00%
tx-ec.static.yximgs.com.sched.kslego-dk.tdnsstic1.cn,0,0.00%,1,1,0.00%
p3.eckwai.com.download.ks-cdn.com,0,0.00%,1,1,0.00%
oa9iarv6.sched.kslego-dk.tdnsstic1.cn,0,0.00%,1,1,0.00%
uxks9.v.bsclink.cn,0,0.00%,1,1,0.00%
k17-migu.gslb.h.ngaacdn.cn,0,0.00%,1,1,0.00%
v3-ot02.kwaicdn.com.download.ks-cdn.com,0,0.00%,1,1,0.00%
tx-origin.pull.yximgs.com.l1-dk.sched.dcloudlive.com,0,0.00%,1,1,0.00%
l2e8xre0.sched.kslego-dk.tdnsstic1.cn,0,0.00%,1,1,0.00%
1flpl76p.sched.kslego-dk.tdnsstic1.cn,0,0.00%,1,1,0.00%
7flz8kat.sched.kslego-dk.tdnsstic1.cn,0,0.00%,1,1,0.00%
5ipp6gay.sched.dma-dk.tdnsdl1.cn,0,0.00%,1,1,0.00%
j72extsg.sched.dma-dk.tdnsdl1.cn,0,0.00%,1,1,0.00%
d3-push.static.yximgs.com.download.ks-cdn.com,0,0.00%,1,1,0.00%
k35-migu-ipv6.gslb.h.ngaacdn.cn,0,0.00%,1,1,0.00%
d3-ec.a.kwimgs.com.download.ks-cdn.com,0,0.00%,1,1,0.00%
d4-ec.a.kwimgs.com.3dce113f.c.cdnhwc1.com,0,0.00%,1,1,0.00%
d4-ks.a.kwimgs.com.3dce113f.c.cdnhwc1.com,0,0.00%,1,1,0.00%
k35-pkg-migu.gslb.h.ngaacdn.cn,0,0.00%,1,1,0.00%
q4wy0heg.sched.dma-dk.tdnsdl1.cn,0,0.00%,1,1,0.00%
v22.kwaicdn.com.wsdvs.com,0,0.00%,1,1,0.00%
v3-vod.kwaicdn.com.download.ks-cdn.com,0,0.00%,1,1,0.00%
vodv6100.web.fma.aicdn5.com,0,0.00%,1,1,0.00%
findit.org.tw,0,0.00%,1,1,0.00%
storage100.dcdn.kugou.com,0,0.00%,2,2,0.00%
rt.webcompanion.com,0,0.00%,8,8,0.00%
packages.ros.org,0,0.00%,8,8,0.00%
old-releases.ubuntu.com,0,0.00%,2,2,0.00%
3pcookiecheck.azureedge.net,0,0.00%,8,8,0.00%
outfit-v2-exports-production.s3.ap-southeast-2.amazonaws.com,0,0.00%,4,4,0.00%
2f02f2028160453b1e95a2a2985f0fbb.fp.measure.office.com,0,0.00%,3,3,0.00%
zzhgithub.github.io,0,0.00%,1,1,0.00%
lozanaross.github.io,0,0.00%,1,1,0.00%
0x09al.github.io,0,0.00%,1,1,0.00%
asia.clients.config.office.akadns.net,0,0.00%,8,8,0.00%
j6qup3.github.io,0,0.00%,1,1,0.00%
ota-downloads.nvidia.com,0,0.00%,3,3,0.00%
9j4vj567.sched.sma-dk.tdnsstic1.cn,0,0.00%,2,2,0.00%
appsupport.qq.com,0,0.00%,4,4,0.00%
config.teams.trafficmanager.net,0,0.00%,23,23,0.00%
config-teams.s-0005.s-msedge.net,0,0.00%,11,11,0.00%
xinpub.bj.bcebos.com,0,0.00%,12,12,0.00%
bos.bj.baidubce.n.shifen.com,0,0.00%,19,19,0.00%
v6-4.hiaoxui.work,0,0.00%,5,5,0.00%
mixv6-34.194610.xyz,0,0.00%,2,2,0.00%
v6-34.hiaoxui.work,0,0.00%,2,2,0.00%
v6-35.hiaoxui.work,0,0.00%,2,2,0.00%
mixv6-5.194610.xyz,0,0.00%,2,2,0.00%
mixv6-35.194610.xyz,0,0.00%,5,5,0.00%
v6-5.hiaoxui.work,0,0.00%,2,2,0.00%
nightlies.apache.org,0,0.00%,1,1,0.00%
www.hao123.com,0,0.00%,22,22,0.00%
www.abchina.com,0,0.00%,4,4,0.00%
www.ccb.com,0,0.00%,2,2,0.00%
mail.10086.cn,0,0.00%,4,4,0.00%
tejia.hao123.com,0,0.00%,4,4,0.00%
www.cri.cn,0,0.00%,8,8,0.00%
www.qstheory.cn,0,0.00%,6,6,0.00%
c6fe29a4d31b441d90f25663c5ed5666.fp.measure.office.com,0,0.00%,2,2,0.00%
ins-k5tkxji1.ias.tencent-cloud.net,0,0.00%,13,13,0.00%
u6.y.qq.com,0,0.00%,28,28,0.00%
c6.y.qq.com,0,0.00%,20,20,0.00%
vc.y.qq.com,0,0.00%,20,20,0.00%
ugcup.music.qq.com,0,0.00%,13,13,0.00%
szc6.y.qq.com,0,0.00%,12,12,0.00%
shc6.y.qq.com,0,0.00%,12,12,0.00%
szu6.y.qq.com,0,0.00%,8,8,0.00%
shu6.y.qq.com,0,0.00%,7,7,0.00%
monitor.music.qq.com,0,0.00%,10,10,0.00%
acctcdn.msftauth.net,0,0.00%,8,8,0.00%
acctcdnmsftuswe2.azureedge.net,0,0.00%,7,7,0.00%
acctcdnvzeuno.azureedge.net,0,0.00%,4,4,0.00%
lgincdnmsftuswe2.azureedge.net,0,0.00%,7,7,0.00%
smp-device-content.g.aaplimg.com,0,0.00%,10,10,0.00%
cdn.hoood.info,0,0.00%,4,4,0.00%
user-images.githubusercontent.com,0,0.00%,4,4,0.00%
releases.obsidian.md,0,0.00%,25,25,0.00%
assets.leetcode.com,0,0.00%,4,4,0.00%
forum.hentai.sh,0,0.00%,1,1,0.00%
mirror-hk.koddos.net,0,0.00%,4,4,0.00%
ns-ut7.proofpoint.com,0,0.00%,2,2,0.00%
ynuf.aliapp.org.gds.alibabadns.com,0,0.00%,15,15,0.00%
secgw-dualstack-na61-na62.wagbridge.alibaba.alibabacorp.com.gds.alibabadns.com,0,0.00%,26,26,0.00%
mdw-mvp.trafficmanager.net,0,0.00%,2,2,0.00%
trouter2-azsc-krce-2-b.trouter.teams.microsoft.com,0,0.00%,4,4,0.00%
s1.go2https.com,0,0.00%,4,4,0.00%
mmhead.c2c.wechat.com,0,0.00%,6,6,0.00%
api.cas.cn,0,0.00%,3,3,0.00%
scs.ucas.ac.cn,0,0.00%,5,5,0.00%
v112.v2dns.bar,0,0.00%,2,2,0.00%
yichengchen.github.io,0,0.00%,2,2,0.00%
brownbigdata.github.io,0,0.00%,2,2,0.00%
c.yes.youku.com,0,0.00%,10,10,0.00%
usercenter2.aliyun.com,0,0.00%,4,4,0.00%
fecs.console.aliyun.com,0,0.00%,10,10,0.00%
efc.console.aliyun.com,0,0.00%,4,4,0.00%
1j6fp2.tdum.alibaba.com,0,0.00%,2,2,0.00%
developer.aliyun.com,0,0.00%,10,10,0.00%
e8732d592aeaff69.qaxcloudwaf.com,0,0.00%,6,6,0.00%
ordercenter.console.aliyun.com,0,0.00%,4,4,0.00%
ant.design,0,0.00%,6,6,0.00%
feedback.log-global.aliyuncs.com,0,0.00%,4,4,0.00%
hyperledger.github.io,0,0.00%,3,3,0.00%
tube.conferences-gesticulees.net,0,0.00%,1,1,0.00%
ns-1597.awsdns-07.co.uk,0,0.00%,2,2,0.00%
cdn.digicertcdn.com,0,0.00%,10,10,0.00%
tracker-udp.gbitt.info,0,0.00%,22,22,0.00%
tracker.srv00.com,0,0.00%,19,19,0.00%
fuwu.rsj.beijing.gov.cn,0,0.00%,4,4,0.00%
www.tm.prd.ags.akadns.net,0,0.00%,20,20,0.00%
twxs.gallerycdn.vsassets.io,0,0.00%,1,1,0.00%
gwyydc.cmecloud.cn,0,0.00%,2,2,0.00%
560734b82ce4f952ecc17a611b71f567cc4529c003270686.dlied1.cdntips.net,0,0.00%,2,2,0.00%
2d27ab48901c413b085c7142c4e260931bee44b1efa1fc72.dlied1.cdntips.net,0,0.00%,2,2,0.00%
f3d86ca59d271077adc2881ef47784f092e754f2d908ad73.dlied1.cdntips.net,0,0.00%,1,1,0.00%
6af07ccca1599417fed4de2bd42fdbb76c5b8735e89f2ba2.dlied1.cdntips.net,0,0.00%,1,1,0.00%
d26d80c15743af7d569a51c36736843d1c3d0af5f3be64c2.dlied1.cdntips.net,0,0.00%,2,2,0.00%
dl.url.cn,0,0.00%,1,1,0.00%
stun1.qvb.qcloud.com,0,0.00%,3,3,0.00%
d4bbe256f24ba6fc40a6455d1462778913c221b1d14e504d.dlied1.cdntips.net,0,0.00%,1,1,0.00%
a66e2fded18b01f1be48d41a4e56230a40698ba1e7cd60d5.dlied1.cdntips.net,0,0.00%,1,1,0.00%
eamodio.gallerycdn.vsassets.io,0,0.00%,1,1,0.00%
github.gallerycdn.vsassets.io,0,0.00%,1,1,0.00%
ms-ceintl.gallerycdn.vsassets.io,0,0.00%,1,1,0.00%
ms-python.gallerycdn.vsassets.io,0,0.00%,2,2,0.00%
ms-toolsai.gallerycdn.vsassets.io,0,0.00%,2,2,0.00%
ms-vscode.gallerycdn.vsassets.io,0,0.00%,5,5,0.00%
684d0d42.akstat.io,0,0.00%,2,2,0.00%
v1.hitokoto.cn,0,0.00%,3,3,0.00%
pkg.jenkins.io,0,0.00%,15,15,0.00%
s-img.adskeeper.com,0,0.00%,4,4,0.00%
c.adskeeper.com,0,0.00%,4,4,0.00%
darya-ver.github.io,0,0.00%,1,1,0.00%
dlandroid.rcv.sandai.net,0,0.00%,2,2,0.00%
rum18.perf.linkedin.com,0,0.00%,5,5,0.00%
images.nicknack.tk,0,0.00%,61,61,0.00%
a1-186.akam.net,0,0.00%,6,6,0.00%
a16-67.akam.net,0,0.00%,6,6,0.00%
secgw-dualstack-na61-na62.wagbridge.alibaba.alibabacorp.com,0,0.00%,12,12,0.00%
a1-250.akam.net,0,0.00%,2,2,0.00%
a12-64.akam.net,0,0.00%,4,4,0.00%
a24-65.akam.net,0,0.00%,2,2,0.00%
trackerxyz.tk,0,0.00%,7,7,0.00%
tracker.sandrotracker.biz,0,0.00%,4,4,0.00%
acc.qq.com,0,0.00%,27,27,0.00%
portrait.gitee.com,0,0.00%,6,6,0.00%
cn-assets.gitee.com,0,0.00%,8,8,0.00%
qm.qq.com,0,0.00%,4,4,0.00%
opencollective.com,0,0.00%,4,4,0.00%
v6.video.upqzfile.com,0,0.00%,3,3,0.00%
fx.tj.beijing.gov.cn,0,0.00%,2,2,0.00%
8c2d2ab830978c9c.cdn.jiashule.com,0,0.00%,2,2,0.00%
ipv6.shuzilm.cn,0,0.00%,6,6,0.00%
attack.mitre.org,0,0.00%,2,2,0.00%
aadcdn.msauth.net,0,0.00%,2,2,0.00%
pom.gslb.topgslb.com,0,0.00%,6,6,0.00%
default.cn.nt.wagbridge.amap.alibabacorp.com.gds.alibabadns.com,0,0.00%,5,5,0.00%
js.t.sinajs.cn,0,0.00%,9,9,0.00%
download.owncloud.com,0,0.00%,3,3,0.00%
dns.wdvips.cf,0,0.00%,1,1,0.00%
visionml.github.io,0,0.00%,61,61,0.00%
www.mate.zone,0,0.00%,2,2,0.00%
fedorapeople.org,0,0.00%,2,2,0.00%
a738d66b3e2d4c27831e050ca06f065c.fp.measure.office.com,0,0.00%,1,1,0.00%
blingblingxuanxuan.github.io,0,0.00%,2,2,0.00%
yhxw.tj.beijing.gov.cn,0,0.00%,2,2,0.00%
7075ff241a6174cd.cdn.jiashule.com,0,0.00%,2,2,0.00%
rsj.beijing.gov.cn,0,0.00%,8,8,0.00%
wza.beijing.gov.cn,0,0.00%,2,2,0.00%
play.shipin.beijing.gov.cn,0,0.00%,2,2,0.00%
c4c8ac57389cdbaa.cdn.jiashule.com,0,0.00%,2,2,0.00%
6b516f81c9cbe1a4.cdn.jiashule.com,0,0.00%,2,2,0.00%
www.beijing.gov.cn,0,0.00%,2,2,0.00%
banshi.beijing.gov.cn,0,0.00%,4,4,0.00%
da259f9b03852fbb.cname.365cyd.cn,0,0.00%,2,2,0.00%
feeds-drcn.cloud.huawei.com.cn,0,0.00%,4,4,0.00%
p.meituan.com,0,0.00%,4,4,0.00%
ipv4-ipv6-phase4.web.vip.meituan.com,0,0.00%,14,14,0.00%
cs11.wpc.v0cdn.net,0,0.00%,3,3,0.00%
remote.syslinq.co,0,0.00%,1,1,0.00%
ipv6-aserver-heyi.m.taobao.com,0,0.00%,1,1,0.00%
ipv6-aserver-heyi.m.taobao.com.gds.alibabadns.com,0,0.00%,9,9,0.00%
mirrors.rockylinux.org,0,0.00%,5,5,0.00%
rockylinux.map.fastly.net,0,0.00%,2,2,0.00%
spclient.wg.spotify.com,0,0.00%,2,2,0.00%
i.scdn.co,0,0.00%,2,2,0.00%
www.malwaretech.com,0,0.00%,17,17,0.00%
httpdns-sdk.n.netease.com,0,0.00%,10,10,0.00%
item.m.jd.com,0,0.00%,2,2,0.00%
mapi.m.jd.com,0,0.00%,8,8,0.00%
wq.jd.com,0,0.00%,17,17,0.00%
hermes.jd.com,0,0.00%,4,4,0.00%
fd.3.cn,0,0.00%,8,8,0.00%
sst.taptap.com,0,0.00%,1,1,0.00%
sns-img-hw.xhscdn.com.ctdns.cn,0,0.00%,4,4,0.00%
wmapi.meituan.com,0,0.00%,1,1,0.00%
mars.meituan.com,0,0.00%,2,2,0.00%
lx0.meituan.com,0,0.00%,4,4,0.00%
mapi.dianping.com,0,0.00%,9,9,0.00%
smarthome.extend.ott4china.com,0,0.00%,2,2,0.00%
cache.datamart.windows.com,0,0.00%,4,4,0.00%
jap2.zhuchenlong.tk,0,0.00%,1,1,0.00%
week.enexisimosor.tk,0,0.00%,1,1,0.00%
nickchenyx.github.io,0,0.00%,1,1,0.00%
e36ee80f0ee14aac96281bccf4403b80.fp.measure.office.com,0,0.00%,1,1,0.00%
www.codecademy.com,0,0.00%,1,1,0.00%
cdn.segmentfault.com,0,0.00%,1,1,0.00%
cdn.segmentfault.com.qiniudns.com,0,0.00%,1,1,0.00%
www.sohu.com.dsa.dnsv1.com,0,0.00%,1,1,0.00%
dualstack.apilocate.amap.com,0,0.00%,9,9,0.00%
dualstack.apilocate.amap.com.gds.alibabadns.com,0,0.00%,6,6,0.00%
wpk-hb3c-alb.ude.effirst.com,0,0.00%,5,5,0.00%
m4.auto.itc.cn,0,0.00%,1,1,0.00%
img.mp.itc.cn.w.cdngslb.com,0,0.00%,2,2,0.00%
29e5534ea20a8.cdn.sohucs.com.w.cdngslb.com,0,0.00%,1,1,0.00%
5b0988e595225.cdn.sohucs.com.cdn.dnsv1.com,0,0.00%,1,1,0.00%
g2.ctc.cctvcdn.net.lxdns.com,0,0.00%,3,3,0.00%
forwardtmp.weixin.qq.com,0,0.00%,8,8,0.00%
forwardwx.weixin.qq.com,0,0.00%,9,9,0.00%
script.crazyegg.com,0,0.00%,1,1,0.00%
o-ring.msedge.net,0,0.00%,2,2,0.00%
moapi.wps.cn,0,0.00%,8,8,0.00%
appwos.58.com,0,0.00%,2,2,0.00%
im58log.58.com,0,0.00%,2,2,0.00%
apiwmda.58.com.cn,0,0.00%,2,2,0.00%
app.58.com,0,0.00%,2,2,0.00%
tzgs.58.com,0,0.00%,2,2,0.00%
huangyeapi.58.com,0,0.00%,5,5,0.00%
zpservice.58.com,0,0.00%,4,4,0.00%
bindwpush.58.com,0,0.00%,2,2,0.00%
ulogs.umengcloud.com,0,0.00%,2,2,0.00%
k.sinaimg.cn,0,0.00%,12,12,0.00%
n0.sinaimg.cn,0,0.00%,3,3,0.00%
k2.sinaimg.cn,0,0.00%,2,2,0.00%
k0.sinaimg.cn,0,0.00%,2,2,0.00%
l2.sinaimg.cn,0,0.00%,2,2,0.00%
k1.sinaimg.cn,0,0.00%,2,2,0.00%
l0.sinaimg.cn,0,0.00%,2,2,0.00%
l1.sinaimg.cn,0,0.00%,2,2,0.00%
k3.sinaimg.cn,0,0.00%,2,2,0.00%
l3.sinaimg.cn,0,0.00%,2,2,0.00%
ping46.sina.cn,0,0.00%,2,2,0.00%
webcast3-normal-c-hl.ixigua.com,0,0.00%,2,2,0.00%
icon.eu.mndsrv.com,0,0.00%,16,16,0.00%
image.eu.mndsrv.com,0,0.00%,18,18,0.00%
c21e4aa1d9295c48dea7429d81f5f0b1.clo.footprintdns.com,0,0.00%,1,1,0.00%
download.owncloud.org,0,0.00%,1,1,0.00%
ishtuki.com.ua,0,0.00%,1,1,0.00%
cc.rykagg123.tk,0,0.00%,1,1,0.00%
v2r.ulygoogle.ga,0,0.00%,1,1,0.00%
v-2a384bfa.71edge.com,0,0.00%,2,2,0.00%
mvnrepository.com,0,0.00%,2,2,0.00%
www.hotjob.cn,0,0.00%,5,5,0.00%
darkreader.github.io,0,0.00%,18,18,0.00%
i.loli.net.cdn.cloudflare.net,0,0.00%,6,6,0.00%
i.imgtg.com.cname2477.yjs-cdn.com,0,0.00%,6,6,0.00%
v.baidu.com,0,0.00%,11,11,0.00%
repo.anaconda.com,0,0.00%,45,45,0.00%
rr3---sn-aigl6nsd.googlevideo.com,0,0.00%,18,18,0.00%
connectivitycheck.cbg-app.huawei.com,0,0.00%,41,41,0.00%
du-feige.iqiyi.com,0,0.00%,6,6,0.00%
amdc.m.taobao.com,0,0.00%,13,13,0.00%
ns-206.awsdns-25.com,0,0.00%,6,6,0.00%
baopu-gao.github.io,0,0.00%,1,1,0.00%
p.ssl.qhimg.com.qh-cdn.com,0,0.00%,4,4,0.00%
p5.ssl.qhimg.com.qh-cdn.com,0,0.00%,4,4,0.00%
v-jd.9liuda.com,0,0.00%,4,4,0.00%
v-2a384406.71edge.com,0,0.00%,4,4,0.00%
nl-rcd.iqiyi.com,0,0.00%,2,2,0.00%
console.ecloud.10086.cn.cdngtm.cn,0,0.00%,2,2,0.00%
embed.cloudflarestream.com,0,0.00%,2,2,0.00%
cloudflarestream.com,0,0.00%,2,2,0.00%
videodelivery.net,0,0.00%,2,2,0.00%
embed.videodelivery.net,0,0.00%,4,4,0.00%
eu.doctorpost.net,0,0.00%,4,4,0.00%
sh.wagbridge.acceleration.aliyun.com,0,0.00%,1,1,0.00%
pytorch-cn.readthedocs.io,0,0.00%,1,1,0.00%
cdn.mathjax.org,0,0.00%,7,7,0.00%
forest-s3.seekrtech.com,0,0.00%,1,1,0.00%
videopic.bdstatic.com,0,0.00%,3,3,0.00%
cdn-settings.appsflyersdk.com,0,0.00%,1,1,0.00%
cdn-settings.appsflyersdk.com.cdn.cloudflare.net,0,0.00%,1,1,0.00%
ecsnext.console.aliyun.com,0,0.00%,2,2,0.00%
csrc.nist.gov,0,0.00%,1,1,0.00%
beian.aliyun.com,0,0.00%,2,2,0.00%
cart.aliyun.com,0,0.00%,2,2,0.00%
home.console.aliyun.com,0,0.00%,2,2,0.00%
smartservice.console.aliyun.com,0,0.00%,1,1,0.00%
feedback.log-global.aliyuncs.com.w.cdngslb.com,0,0.00%,2,2,0.00%
area.amdc.m.taobao.com,0,0.00%,1,1,0.00%
area.amdc.m.taobao.com.gds.alibabadns.com,0,0.00%,3,3,0.00%
center.amdc.m.taobao.com.gds.alibabadns.com,0,0.00%,3,3,0.00%
d2af300exsboq5.cloudfront.net,0,0.00%,61,61,0.00%
cdnma.cdnservice.space,0,0.00%,8,8,0.00%
6e87effbd9bd46759008ab90fdd72368.fp.measure.office.com,0,0.00%,2,2,0.00%
c.wybus.ml,0,0.00%,1,1,0.00%
az416426.vo.msecnd.net,0,0.00%,2,2,0.00%
tvaweibo.gslb.sinaedge.com,0,0.00%,9,9,0.00%
tvaweibo.grid.sinaedge.com,0,0.00%,9,9,0.00%
batchcompute.console.aliyun.com,0,0.00%,2,2,0.00%
appstreaming.console.aliyun.com,0,0.00%,2,2,0.00%
pds.console.aliyun.com,0,0.00%,1,1,0.00%
polardb.console.aliyun.com,0,0.00%,1,1,0.00%
rdsnext.console.aliyun.com,0,0.00%,2,2,0.00%
cdn.console.aliyun.com,0,0.00%,2,2,0.00%
cs.console.aliyun.com,0,0.00%,2,2,0.00%
eds.console.aliyun.com,0,0.00%,2,2,0.00%
dbfs.console.aliyun.com,0,0.00%,1,1,0.00%
dfs.console.aliyun.com,0,0.00%,1,1,0.00%
drdsnew.console.aliyun.com,0,0.00%,1,1,0.00%
fcnext.console.aliyun.com,0,0.00%,2,2,0.00%
fnf.console.aliyun.com,0,0.00%,1,1,0.00%
s.tribalfusion.com,0,0.00%,3,3,0.00%
r.turn.com.akadns.net,0,0.00%,2,2,0.00%
an.yandex.ru,0,0.00%,4,4,0.00%
kxlogo.knet.cn,0,0.00%,5,5,0.00%
www.qinai.ml,0,0.00%,1,1,0.00%
mtop.damai.cn,0,0.00%,2,2,0.00%
dualstack-na61-na62.wagbridge.alibaba.alibabacorp.com.gds.alibabadns.com,0,0.00%,2,2,0.00%
perico.damai.cn,0,0.00%,2,2,0.00%
fourier.taobao.com.gds.alibabadns.com,0,0.00%,2,2,0.00%
app.xiaomi.com,0,0.00%,2,2,0.00%
11.au.download.windowsupdate.com,0,0.00%,4,4,0.00%
ad.tencentmusic.com,0,0.00%,4,4,0.00%
tangram.e.qq.com,0,0.00%,4,4,0.00%
default-query.trtc.tencent-cloud.com,0,0.00%,4,4,0.00%
img1.dongqiudi.com,0,0.00%,2,2,0.00%
as.qunliao.info,0,0.00%,2,2,0.00%
img1.qunliao.info,0,0.00%,2,2,0.00%
goldcoin.dongqiudi.com,0,0.00%,2,2,0.00%
topic.dongqiudi.com,0,0.00%,2,2,0.00%
sport-data.dongqiudi.com,0,0.00%,2,2,0.00%
v3-ttvideo.qunliao.info,0,0.00%,2,2,0.00%
jq.qq.com,0,0.00%,2,2,0.00%
mediawiki.org,0,0.00%,1,1,0.00%
atutor.github.io,0,0.00%,2,2,0.00%
packages.clickhouse.com,0,0.00%,2,2,0.00%
mirrors.rpmfusion.org,0,0.00%,4,4,0.00%
ws.figshare.com,0,0.00%,2,2,0.00%
devanlai.github.io,0,0.00%,61,61,0.00%
amdc-v6.alipaydns.com,0,0.00%,5,5,0.00%
dpubstatic.udache.com,0,0.00%,2,2,0.00%
dpubstatic.udache.com.download.ks-cdn.com,0,0.00%,2,2,0.00%
nsinaimg.gslb.sinaedge.com,0,0.00%,6,6,0.00%
adiwlbs.gslb.sinaedge.com,0,0.00%,2,2,0.00%
h5sinaimg.gslb.sinaedge.com,0,0.00%,2,2,0.00%
ksinaimg.gslb.sinaedge.com,0,0.00%,4,4,0.00%
adiwlbs3.gslb.sinaedge.com,0,0.00%,6,6,0.00%
v6.tiamato.com,0,0.00%,2,2,0.00%
report.meituan.com,0,0.00%,4,4,0.00%
box.stefanwienert.de,0,0.00%,1,1,0.00%
apt.kubernetes.io,0,0.00%,11,11,0.00%
pool.v6.bt.n0808.com,0,0.00%,6,6,0.00%
v2raya.org,0,0.00%,2,2,0.00%
tfs.alipayobjects.com,0,0.00%,2,2,0.00%
tfs.alipayobjects.com.danuoyi.tbcache.com,0,0.00%,2,2,0.00%
d1rzvz7k6dfhj6.cloudfront.net,0,0.00%,1,1,0.00%
ca6aa2d1d49d42dea77f8c6fa341a271.fp.measure.office.com,0,0.00%,2,2,0.00%
imge.ali.kugou.com,0,0.00%,2,2,0.00%
trc.taboola.com,0,0.00%,8,8,0.00%
www.pianshen.com,0,0.00%,4,4,0.00%
dev-cms-cdn-hub.azureedge.net,0,0.00%,2,2,0.00%
search.jd.com,0,0.00%,4,4,0.00%
images4.pianshen.com,0,0.00%,5,5,0.00%
thumb4.pianshen.com,0,0.00%,4,4,0.00%
pubads46.g.doubleclick.net,0,0.00%,4,4,0.00%
a.vdo.ai,0,0.00%,6,6,0.00%
images1.pianshen.com,0,0.00%,3,3,0.00%
images2.pianshen.com,0,0.00%,2,2,0.00%
thumb3.pianshen.com,0,0.00%,4,4,0.00%
thumb1.pianshen.com,0,0.00%,4,4,0.00%
thumb2.pianshen.com,0,0.00%,4,4,0.00%
vm.aicdn.com,0,0.00%,4,4,0.00%
images3.pianshen.com,0,0.00%,4,4,0.00%
targeting.vdo.ai,0,0.00%,4,4,0.00%
packages.gitlab.com,0,0.00%,51,51,0.00%
4th.rcv.sandai.net,0,0.00%,6,6,0.00%
xlmacclient.rcv.sandai.net,0,0.00%,18,18,0.00%
9c7014a46c0245869d50f70a4b2b632b.fp.measure.office.com,0,0.00%,2,2,0.00%
messaging.contact-module.ibm.com,0,0.00%,118,118,0.00%
wWW.gooGlE.cOM,0,0.00%,3,3,0.00%
Www.YahoO.cOm,0,0.00%,3,3,0.00%
ssv6.zhengmingz.top,0,0.00%,53,53,0.00%
api.cloud.189.cn,0,0.00%,309,309,0.00%
P2pstUNTeSt.HAPlat.NEt,0,0.00%,4,4,0.00%
yushou.jd.com,0,0.00%,5,5,0.00%
beacon.errorception.com,0,0.00%,4,4,0.00%
activemq.apache.org,0,0.00%,2,2,0.00%
www.apache.org,0,0.00%,2,2,0.00%
fs-gateway.esdict.cn,0,0.00%,2,2,0.00%
dualstack.tls13.taboola.map.fastly.net,0,0.00%,4,4,0.00%
vps-95c2d9fd.vps.ovh.net,0,0.00%,7,7,0.00%
5c659554f14645b6b9f2c53035876940.fp.measure.office.com,0,0.00%,2,2,0.00%
fuck.skystar.ga,0,0.00%,1,1,0.00%
space.thinkrinciveresti.tk,0,0.00%,1,1,0.00%
wallet.schildbach.de,0,0.00%,1,1,0.00%
sentry.tensquaregames.com,0,0.00%,1,1,0.00%
rain.smerensicancho.tk,0,0.00%,1,1,0.00%
download.tenorshare.com,0,0.00%,8,8,0.00%
ns6.gandi.net,0,0.00%,1,1,0.00%
by.uservoice.com,0,0.00%,4,4,0.00%
19706c219aa944b4a55fd4cba04dad71.fp.measure.office.com,0,0.00%,2,2,0.00%
P2pstunTesT.HApLAT.nET,0,0.00%,4,4,0.00%
cdn.kesci.com,0,0.00%,3,3,0.00%
psbckj2022.zhaopin.com,0,0.00%,1,1,0.00%
zhaopin.bjut.edu.cn,0,0.00%,1,1,0.00%
www.psbckj2022.zhaopin.com,0,0.00%,1,1,0.00%
interactive-examples.mdn.mozilla.net,0,0.00%,2,2,0.00%
jwb.ucas.ac.cn,0,0.00%,2,2,0.00%
orcid.org,0,0.00%,4,4,0.00%
service.most.gov.cn,0,0.00%,2,2,0.00%
d.wn51.com,0,0.00%,28,28,0.00%
updateleak.qihucdn.com,0,0.00%,8,8,0.00%
glb.cws.prod.dcat.dsp.trafficmanager.NET,0,0.00%,4,4,0.00%
30d9d8c83f414abd8deecb5be34d07ee.fp.measure.office.com,0,0.00%,1,1,0.00%
shuaitq.github.io,0,0.00%,122,122,0.00%
escoladacognicao.com.br,0,0.00%,2,2,0.00%
brandon-c-tech.github.io,0,0.00%,1,1,0.00%
www.marketsandmarkets.com,0,0.00%,1,1,0.00%
pewpewnotes.github.io,0,0.00%,1,1,0.00%
download.teamviewer.com,0,0.00%,3,3,0.00%
e57eaaf7df7b4d009b0f5994553bc97a.fp.measure.office.com,0,0.00%,2,2,0.00%
mx3.qq.com,0,0.00%,12,12,0.00%
mx2.qq.com,0,0.00%,12,12,0.00%
mx1.qq.com,0,0.00%,12,12,0.00%
srv01.ivity.asia,0,0.00%,1,1,0.00%
wwwh.hettinger.tk,0,0.00%,61,61,0.00%
0648b09e018440c6848cdbc2677bc64b.fp.measure.office.com,0,0.00%,2,2,0.00%
hff2.github.io,0,0.00%,1,1,0.00%
t2.appmeasurements.com,0,0.00%,8,8,0.00%
dht.transmissionbt.com,0,0.00%,10,10,0.00%
router.silotis.us,0,0.00%,6,6,0.00%
4a2b7c481f2c41bca2d74a67a35aa5fc.fp.measure.office.com,0,0.00%,2,2,0.00%
feiji-help.github.io,0,0.00%,1,1,0.00%
told.retitibackbo.gq,0,0.00%,1,1,0.00%
4e65e2f3e1dc4c018e825f0a9971f601.fp.measure.office.com,0,0.00%,3,3,0.00%
fr1.144050.cf,0,0.00%,1,1,0.00%
zhengzerong.github.io,0,0.00%,61,61,0.00%
cognito-identity.us-west-2.amazonaws.com,0,0.00%,5,5,0.00%
ggck.qiumibao.com,0,0.00%,4,4,0.00%
cdn.makeapie.cn,0,0.00%,3,3,0.00%
c11786561f1c4a668947463afae4b741.fp.measure.office.com,0,0.00%,2,2,0.00%
leopardmarine.com.eg,0,0.00%,1,1,0.00%
de.hzyqzx.tk,0,0.00%,61,61,0.00%
dl.comss.org,0,0.00%,1,1,0.00%
www2.vhs-balingen.de,0,0.00%,1,1,0.00%
p2psTunteST.hAplat.nET,0,0.00%,1,1,0.00%
wWw.vOD.LXDNs.CoM,0,0.00%,1,1,0.00%
imeclient.openspeech.cn,0,0.00%,1,1,0.00%
ntd-asus-2014b-en-cfg.fbs20.trendmicro.com,0,0.00%,1,1,0.00%
WWw.vOD.LXDNS.CoM,0,0.00%,2,2,0.00%
p2PSTUNTEsT.HaplAt.Net,0,0.00%,1,1,0.00%
frost-fcbmh02.cnqloqego.ga,0,0.00%,1,1,0.00%
a1-2.sdagsg.ml,0,0.00%,1,1,0.00%
bannedbook.github.io,0,0.00%,1,1,0.00%
d1agt99uerx7mo.cloudfront.net,0,0.00%,1,1,0.00%
6c9df887729a4051a17e7866ea3d6402.fp.measure.office.com,0,0.00%,1,1,0.00%
www.terracotta.org,0,0.00%,1,1,0.00%
files.pythonhosted.org,0,0.00%,18,18,0.00%
cwxlive.qlogo.cn,0,0.00%,5,5,0.00%
commobibank.bankofbeijing.com.cn,0,0.00%,10,10,0.00%
xiuxiu-pro.meitudata.com,0,0.00%,11,11,0.00%
impaas.alicdn.com,0,0.00%,2,2,0.00%
z7.cnzz.com,0,0.00%,4,4,0.00%
w8249s.iosedge.com,0,0.00%,2,2,0.00%
localsaasgap.work.weixin.qq.com,0,0.00%,5,5,0.00%
a.fxltsbl.com,0,0.00%,4,4,0.00%
v1-x.douyinvod.com,0,0.00%,4,4,0.00%
v3-cold.douyinvod.com,0,0.00%,6,6,0.00%
beatree.github.io,0,0.00%,1,1,0.00%
top.trackeroc.ga,0,0.00%,1,1,0.00%
juliaastro.github.io,0,0.00%,1,1,0.00%
maeyon.github.io,0,0.00%,1,1,0.00%
liuxingbaoyu.github.io,0,0.00%,1,1,0.00%
P2PSTUNTest.haPLat.nET,0,0.00%,2,2,0.00%
analytics.query.yahoo.com,0,0.00%,10,10,0.00%
4-courier2.push.apple.com,0,0.00%,5,5,0.00%
netdata.github.io,0,0.00%,1,1,0.00%
d24cbr4vq93gab.cloudfront.net,0,0.00%,1,1,0.00%
a6ac74b1d07e4a6a93b3bbf06585a51a.fp.measure.office.com,0,0.00%,2,2,0.00%
cs486284.wpc.phicdn.NET,0,0.00%,2,2,0.00%
ucc.aliyun.com,0,0.00%,4,4,0.00%
bridge.aliyun.com,0,0.00%,4,4,0.00%
cloudvideo.thepaper.cn,0,0.00%,1,1,0.00%
i-p-v-6.tk,0,0.00%,2,2,0.00%
open-v6.demonoid.ch,0,0.00%,1,1,0.00%
71q3.github.io,0,0.00%,1,1,0.00%
packagecontrol.io,0,0.00%,2,2,0.00%
f901802f9db25acc4770c812a110a837.nrb.footprintdns.com,0,0.00%,2,2,0.00%
bbs1.dianjingy.com,0,0.00%,4,4,0.00%
syt-honey.github.io,0,0.00%,1,1,0.00%
s-0005-office.config.skype.com,0,0.00%,3,3,0.00%
1001.rumc.de,0,0.00%,1,1,0.00%
s-0005-teams.config.skype.com,0,0.00%,5,5,0.00%
freebsdchina.github.io,0,0.00%,1,1,0.00%
redmi.kamiui.ml,0,0.00%,1,1,0.00%
37b0e89e0c52b8413f519b167b7cba8b.nrb.footprintdns.com,0,0.00%,1,1,0.00%
pypi.doubanio.com,0,0.00%,2,2,0.00%
www.job.cqu.edu.cn,0,0.00%,1,1,0.00%
cdn.bootjs.org,0,0.00%,2,2,0.00%
tz.39cl.com,0,0.00%,4,4,0.00%
yacd.haishan.me,0,0.00%,3,3,0.00%
sms-01.mb.fr33tux.org,0,0.00%,1,1,0.00%
cs.blogwithmeilove.ga,0,0.00%,1,1,0.00%
www.tm.prd.ags.trafficmanager.net,0,0.00%,7,7,0.00%
geo.clients.config.office.akadns.net,0,0.00%,6,6,0.00%
tr.ready4.icu,0,0.00%,1,1,0.00%
tracker1.ctix.cn,0,0.00%,3,3,0.00%
black-bird.ynh.fr,0,0.00%,1,1,0.00%
lovewanan.github.io,0,0.00%,1,1,0.00%
jcw87.github.io,0,0.00%,2,2,0.00%
kilsythmedicalcentre.com.au,0,0.00%,1,1,0.00%
weiliang-ms.github.io,0,0.00%,61,61,0.00%
dcb9.github.io,0,0.00%,61,61,0.00%
t.ocmhood.com,0,0.00%,6,6,0.00%
staticview.msn.com.edgekey.net,0,0.00%,1,1,0.00%
testflight.apple.com,0,0.00%,1,1,0.00%
testflight.apple.com.edgekey.net,0,0.00%,1,1,0.00%
nds.qzone.qq.com,0,0.00%,4,4,0.00%
a.config.skype.com,0,0.00%,29,29,0.00%
iccemb.apaset.org,0,0.00%,1,1,0.00%
webmail.ls-mapping-team.de,0,0.00%,61,61,0.00%
plays.tv,0,0.00%,4,4,0.00%
v-2a384bf5.71edge.com,0,0.00%,2,2,0.00%
v-2a384401.71edge.com,0,0.00%,2,2,0.00%
v-7a8dc824.71edge.com,0,0.00%,2,2,0.00%
v-7a8dc829.71edge.com,0,0.00%,1,1,0.00%
write-feedback.youdao.com,0,0.00%,2,2,0.00%
p9-passport.byteacctimg.com,0,0.00%,1,1,0.00%
p1-jj.byteimg.com,0,0.00%,1,1,0.00%
477ddbe756dd4c1475764c89906ebfd0.nrb.footprintdns.com,0,0.00%,2,2,0.00%
3025306375904a22b8abe21a44cf6c34.fp.measure.office.com,0,0.00%,2,2,0.00%
lancache.steamcontent.com,0,0.00%,6,6,0.00%
gd.twy8.tk,0,0.00%,1,1,0.00%
nvd.nist.gov,0,0.00%,4,4,0.00%
5df1b5f826a1418f99964dbe7c50b5ec.fp.measure.office.com,0,0.00%,2,2,0.00%
526686f637824ad4ad73eff3a00efc7d.fp.measure.office.com,0,0.00%,2,2,0.00%
twcdn.gooday.ga,0,0.00%,2,2,0.00%
mirror.webtatic.com,0,0.00%,6,6,0.00%
lonelygo.github.io,0,0.00%,61,61,0.00%
malsup.github.io,0,0.00%,2,2,0.00%
carpentriesoffline.github.io,0,0.00%,1,1,0.00%
dl.teamviewer.com,0,0.00%,6,6,0.00%
crmpiperun.github.io,0,0.00%,1,1,0.00%
gdj.hubei.gov.cn,0,0.00%,3,3,0.00%
www.hubei.gov.cn,0,0.00%,2,2,0.00%
www.nrta.gov.cn,0,0.00%,2,2,0.00%
www.zgjx.cn,0,0.00%,4,4,0.00%
zwfw.hubei.gov.cn,0,0.00%,2,2,0.00%
t.ynet.cn,0,0.00%,2,2,0.00%
v-7a8dc80c.71edge.com,0,0.00%,2,2,0.00%
v-7a8dc826.71edge.com,0,0.00%,2,2,0.00%
abtest.alibaba.com,0,0.00%,6,6,0.00%
aid.m.taobao.com,0,0.00%,3,3,0.00%
ems.youku.com,0,0.00%,4,4,0.00%
dualstack-restios.amap.com,0,0.00%,2,2,0.00%
amdc.alipaydns.com,0,0.00%,4,4,0.00%
1A.au.download.windowsupdate.com,0,0.00%,2,2,0.00%
csu.huahuo-cn.tk,0,0.00%,1,1,0.00%
pdns90.ultradns.net,0,0.00%,2,2,0.00%
rakutentech.github.io,0,0.00%,61,61,0.00%
protocol.mail.163.com,0,0.00%,5,5,0.00%
heekangpark.github.io,0,0.00%,61,61,0.00%
a.root-servers.net,0,0.00%,2,2,0.00%
v13-a.bdxiguavod.com,0,0.00%,2,2,0.00%
sf1-scmcdn-tos.pstatp.com.wsglb0.com,0,0.00%,4,4,0.00%
aliyun-adns.aliyun.com.gds.alibabadns.com,0,0.00%,6,6,0.00%
atoken.m.taobao.com,0,0.00%,8,8,0.00%
rhdc-acs.m.taobao.com,0,0.00%,2,2,0.00%
ditu.amap.com,0,0.00%,3,3,0.00%
loggw-ex.alipay.com,0,0.00%,6,6,0.00%
myluoyu.github.io,0,0.00%,1,1,0.00%
ins-ryzwhfd8.ias.tencent-cloud.net,0,0.00%,7,7,0.00%
f2fd6805323443c7b3d1b54dbf17cb01.fp.measure.office.com,0,0.00%,1,1,0.00%
d2qo6hmxm68chs.cloudfront.net,0,0.00%,1,1,0.00%
lucloud01-ipv6.gslb.ugslb.net,0,0.00%,6,6,0.00%
thunderbird-settings.thunderbird.net,0,0.00%,2,2,0.00%
www.thunderbird.net,0,0.00%,3,3,0.00%
developer.thunderbird.net,0,0.00%,2,2,0.00%
live.thunderbird.net,0,0.00%,2,2,0.00%
autoconfig.thunderbird.net,0,0.00%,2,2,0.00%
tytx.m.cn.miaozhen.com,0,0.00%,7,7,0.00%
odin.re.taobao.com,0,0.00%,2,2,0.00%
default.cn.sz.wagbridge.ad.alibabacorp.com.gds.alibabadns.com,0,0.00%,2,2,0.00%
mpsapi.amap.com,0,0.00%,2,2,0.00%
logs.amap.com,0,0.00%,3,3,0.00%
6beb451d92de4830827c16b50b09fc67.fp.measure.office.com,0,0.00%,2,2,0.00%
fa3b1899b15343e8b5beec029838d717.fp.measure.office.com,0,0.00%,2,2,0.00%
sa2bb9.qqscml.ml,0,0.00%,1,1,0.00%
download5.operacdn.com,0,0.00%,4,4,0.00%
ambroseren.github.io,0,0.00%,1,1,0.00%
troublemaker121.github.io,0,0.00%,1,1,0.00%
uoepsy.github.io,0,0.00%,1,1,0.00%
amdc.alipay.com,0,0.00%,6,6,0.00%
vip.6677.tk,0,0.00%,1,1,0.00%
appcashier256.95516.com,0,0.00%,4,4,0.00%
cdn-zjk-trans.dingtalk.com,0,0.00%,2,2,0.00%
wwW.vOd.LxDnS.cOm,0,0.00%,1,1,0.00%
p2pStUNTesT.HapLaT.neT,0,0.00%,1,1,0.00%
d1bacx80on251l.cloudfront.net,0,0.00%,61,61,0.00%
phototj.photo.store.qq.com,0,0.00%,4,4,0.00%
qlogo4.store.qq.com,0,0.00%,4,4,0.00%
downloads.haskell.org,0,0.00%,2,2,0.00%
static.tieba.baidu.com,0,0.00%,6,6,0.00%
v6-cold.douyinvod.com,0,0.00%,2,2,0.00%
v3-cold3.douyinvod.com,0,0.00%,2,2,0.00%
adm1.801100.tk,0,0.00%,1,1,0.00%
sobanshop1.durapix.de,0,0.00%,1,1,0.00%
mb.shy0.tk,0,0.00%,1,1,0.00%
desktop-release.notion-static.com,0,0.00%,8,8,0.00%
forcedsharetraktor.live,0,0.00%,6,6,0.00%
scss.bupt.edu.cn,0,0.00%,3,3,0.00%
r1---sn-i3belne6.gvt1.com,0,0.00%,2,2,0.00%
element.eleme.io,0,0.00%,9,9,0.00%
r5---sn-i3b7knzl.gvt1.com,0,0.00%,2,2,0.00%
r5---sn-i3b7knzs.gvt1.com,0,0.00%,2,2,0.00%
r4---sn-i3b7knzl.gvt1.com,0,0.00%,2,2,0.00%
r4---sn-i3belnl6.gvt1.com,0,0.00%,2,2,0.00%
r4---sn-i3belnlz.gvt1.com,0,0.00%,4,4,0.00%
r4---sn-i3belney.gvt1.com,0,0.00%,2,2,0.00%
r2---sn-i3b7knlk.gvt1.com,0,0.00%,3,3,0.00%
r3---sn-i3belnl6.gvt1.com,0,0.00%,2,2,0.00%
cheenbee.github.io,0,0.00%,61,61,0.00%
captainjensen.github.io,0,0.00%,1,1,0.00%
d2ygwrecguqg66.cloudfront.net,0,0.00%,1,1,0.00%
forgetall.github.io,0,0.00%,1,1,0.00%
tracker.yarr.pt,0,0.00%,4,4,0.00%
698c4c79707a4a0a9ff2a26d75602f92.fp.measure.office.com,0,0.00%,2,2,0.00%
d57xhc.qqscml.ga,0,0.00%,1,1,0.00%
ins-81eqktfa.ias.tencent-cloud.net,0,0.00%,191,191,0.00%
tedgraham.github.io,0,0.00%,1,1,0.00%
ddaiservices.azurefd.net,0,0.00%,6,6,0.00%
P2PstunTEST.haPlat.NeT,0,0.00%,2,2,0.00%
notifications.mendeley.com,0,0.00%,9,9,0.00%
www.skycn.com,0,0.00%,2,2,0.00%
a.sinaimg.cn,0,0.00%,6,6,0.00%
grs.bupt.edu.cn,0,0.00%,2,2,0.00%
privacy.xboxlive.com,0,0.00%,2,2,0.00%
notify.xboxlive.com,0,0.00%,7,7,0.00%
r1---sn-i3belnl7.gvt1.com,0,0.00%,6,6,0.00%
9ec6416bf994453d8487859ac6261458.fp.measure.office.com,0,0.00%,2,2,0.00%
6d52e36e1a74425c8c155ce12e1a24b5.fp.measure.office.com,0,0.00%,2,2,0.00%
ca84947262854fb1924d93e12764456d.fp.measure.office.com,0,0.00%,1,1,0.00%
edge2us03.ghabc.tk,0,0.00%,1,1,0.00%
WWw.YAHoo.cOm,0,0.00%,3,3,0.00%
Www.gOogle.coM,0,0.00%,3,3,0.00%
security.qunar.com,0,0.00%,4,4,0.00%
security.ct.glbs.qunar.com,0,0.00%,6,6,0.00%
www.aliyundrive.com,0,0.00%,10,10,0.00%
alibaba-group.tengine.alibaba.com.gds.alibabadns.com,0,0.00%,6,6,0.00%
bsy.stream.kg.qq.com,0,0.00%,1,1,0.00%
ws.tsmusic.kg.qq.com,0,0.00%,1,1,0.00%
ws.stream.kg.qq.com,0,0.00%,1,1,0.00%
tx.stream.kg.qq.com,0,0.00%,1,1,0.00%
office-cn-beijing.imm.aliyuncs.com,0,0.00%,2,2,0.00%
leetcode.com,0,0.00%,3,3,0.00%
itsfoss.com,0,0.00%,4,4,0.00%
collabrtc.officeapps.live.com,0,0.00%,3,3,0.00%
mirror.centos.org,0,0.00%,32,32,0.00%
l.balex.tk,0,0.00%,1,1,0.00%
member.aliyundrive.com,0,0.00%,2,2,0.00%
statsd-frontend.leetcode.com,0,0.00%,12,12,0.00%
ahangchen.github.io,0,0.00%,1,1,0.00%
e5.kodamaiko362.tk,0,0.00%,1,1,0.00%
c17a476ea10c4aceb1fd7efa413a7d43.fp.measure.office.com,0,0.00%,1,1,0.00%
dy.wmyun.men,0,0.00%,1,1,0.00%
metrics-config.icloud.com,0,0.00%,1,1,0.00%
zhaopin-c.bj.bcebos.com,0,0.00%,1,1,0.00%
daos-stack.github.io,0,0.00%,1,1,0.00%
qldl.eijia.ml,0,0.00%,1,1,0.00%
ilupi.com.br,0,0.00%,1,1,0.00%
cs3.wpc.v0cdn.net,0,0.00%,6,6,0.00%
r1---sn-i3belnlz.gvt1.com,0,0.00%,2,2,0.00%
r1---sn-i3b7knzl.gvt1.com,0,0.00%,2,2,0.00%
dualstack.l2.shared.us-eu.fastly.net,0,0.00%,4,4,0.00%
packagecloud.io,0,0.00%,26,26,0.00%
s.taou.com,0,0.00%,1,1,0.00%
track.mm.taou.com,0,0.00%,2,2,0.00%
api.bt.cn,0,0.00%,6,6,0.00%
p29-contacts.icloud.com,0,0.00%,6,6,0.00%
ns-666.awsdns-19.net,0,0.00%,3,3,0.00%
jimmiemax.github.io,0,0.00%,1,1,0.00%
gavinsimpson.github.io,0,0.00%,1,1,0.00%
a2.nic.io,0,0.00%,7,7,0.00%
b0.nic.io,0,0.00%,6,6,0.00%
24timezones.com,0,0.00%,4,4,0.00%
jia-shijie.github.io,0,0.00%,4,4,0.00%
api.cdnjs.com,0,0.00%,2,2,0.00%
cdn.somplo.com,0,0.00%,4,4,0.00%
adserve.somplo.com,0,0.00%,4,4,0.00%
video.somplo.com,0,0.00%,4,4,0.00%
pixel.somplo.com,0,0.00%,4,4,0.00%
gerpoly.github.io,0,0.00%,1,1,0.00%
t.hdhome.org,0,0.00%,135,135,0.00%
aec2b66bf6a74432b0e196159b85cf24.fp.measure.office.com,0,0.00%,2,2,0.00%
mail.stu.xidian.edu.cn,0,0.00%,3,3,0.00%
amcdn.msftauth.net,0,0.00%,3,3,0.00%
mirrors.dgut.edu.cn,0,0.00%,6,6,0.00%
mirror.lzu.edu.cn,0,0.00%,13,13,0.00%
gzc-download.weiyun.com,0,0.00%,26,26,0.00%
employers.jobs180.com,0,0.00%,1,1,0.00%
frap.frap.site,0,0.00%,1,1,0.00%
jianbojiao.github.io,0,0.00%,1,1,0.00%
de-fr.b7f9-a8a6e675.info,0,0.00%,1,1,0.00%
stackpath.bootstrapcdn.com,0,0.00%,3,3,0.00%
s609a.github.io,0,0.00%,1,1,0.00%
tracedm.aliyun.com,0,0.00%,1,1,0.00%
notion-enhancer.github.io,0,0.00%,1,1,0.00%
p2PstuNTeST.HapLaT.net,0,0.00%,2,2,0.00%
img.shields.io,0,0.00%,2,2,0.00%
iws.corel.com,0,0.00%,4,4,0.00%
P2PStUNtESt.HAPLAt.NET,0,0.00%,2,2,0.00%
tengzi-will.github.io,0,0.00%,1,1,0.00%
ns-cloud-b4.googledomains.com,0,0.00%,2,2,0.00%
kirisamer.github.io,0,0.00%,2,2,0.00%
community.octoprint.org,0,0.00%,1,1,0.00%
a311e5d4eb164d4db2ea020a83489eed.fp.measure.office.com,0,0.00%,2,2,0.00%
osdkupdatenw.com,0,0.00%,4,4,0.00%
cuke.github.io,0,0.00%,1,1,0.00%
P2pSTuNTEsT.HapLat.nET,0,0.00%,2,2,0.00%
zhengry.github.io,0,0.00%,1,1,0.00%
faded12.github.io,0,0.00%,1,1,0.00%
itstatti.in.ua,0,0.00%,1,1,0.00%
hk-hkg-anx-r004.router.teamviewer.com,0,0.00%,2,2,0.00%
wallaceecomod.github.io,0,0.00%,2,2,0.00%
grupoelefanterosa.com.br,0,0.00%,1,1,0.00%
tableau.github.io,0,0.00%,1,1,0.00%
iptv-pro.github.io,0,0.00%,61,61,0.00%
ccext-cdn.adobecces.com,0,0.00%,2,2,0.00%
d54gi6idwcev6.cloudfront.net,0,0.00%,1,1,0.00%
jlnt8169.czsx1624.tk,0,0.00%,2,2,0.00%
54251ff7681c4bb5bee145d96477016b.fp.measure.office.com,0,0.00%,4,4,0.00%
38905e58a0e94cb4af52a2d448d74351.fp.measure.office.com,0,0.00%,1,1,0.00%
yichangwang.github.io,0,0.00%,61,61,0.00%
dvjp6gtue3lfi.cloudfront.net,0,0.00%,1,1,0.00%
mycolor.space,0,0.00%,10,10,0.00%
staff.chunyu.mobi,0,0.00%,1,1,0.00%
xxchan.github.io,0,0.00%,1,1,0.00%
p2pStUNTesT.HApLaT.nET,0,0.00%,2,2,0.00%
wWw.voD.lXdnS.com,0,0.00%,2,2,0.00%
bom02r3a.msedge.net,0,0.00%,1,1,0.00%
act.weixin.qq.com.cloud.tc.qq.com,0,0.00%,1,1,0.00%
v11-ipv6.sched.v4lego-dk.tdnsvod1.cn,0,0.00%,1,1,0.00%
act.weixin.qq.com,0,0.00%,1,1,0.00%
best.qq.com.legodlied1-dk.sched.dcloudstc.com,0,0.00%,1,1,0.00%
ins-oa2v3toq.ias.tencent-cloud.net,0,0.00%,2,2,0.00%
plbslog.umeng.com.gds.alibabadns.com,0,0.00%,3,3,0.00%
contentcenter-drcn-dbankcdn-com-global.staticcdn.dbankedge.net,0,0.00%,1,1,0.00%
contentcenter-drcn.dbankcdn.com.c.cdnhwc1.com,0,0.00%,1,1,0.00%
hcdnw.cbg-notzjv6.c.cdnhwc2.com,0,0.00%,1,1,0.00%
sh.wagbridge.aliyun.aliyun.com,0,0.00%,4,4,0.00%
aliyun-adns.aliyun.com,0,0.00%,4,4,0.00%
open.e-189.21cn.com,0,0.00%,5,5,0.00%
video.sina.com.cn,0,0.00%,1,1,0.00%
videosina.gslb.sinaedge.com,0,0.00%,1,1,0.00%
www.pptv.com,0,0.00%,1,1,0.00%
www.pptv.com.suninggslb.cn,0,0.00%,1,1,0.00%
sptywebv46.suninggslb.cn,0,0.00%,1,1,0.00%
www.tudou.com,0,0.00%,3,3,0.00%
o58bvl93.sched.sma-dk.tdnsstic1.cn.cjt.krcdn.idatacube.com,0,0.00%,1,1,0.00%
ipv4-ipv6-phase4.a.sh.vip.dianping.com,0,0.00%,3,3,0.00%
ipv4-ipv6-phase4.inf.vip.meituan.com,0,0.00%,5,5,0.00%
bk.baidu.com,0,0.00%,6,6,0.00%
1180c.ec.azureedge.net,0,0.00%,13,13,0.00%
ggkf40.cctv.com,0,0.00%,2,2,0.00%
wsall.itc.cn.wscdns.com,0,0.00%,1,1,0.00%
www.shuyz.com,0,0.00%,1,1,0.00%
ityongzhen.github.io,0,0.00%,2,2,0.00%
bt.oiyo.tk,0,0.00%,10,10,0.00%
6.beyondth.cn,0,0.00%,2,2,0.00%
playerflash.com,0,0.00%,9,9,0.00%
tracker.iro.moe,0,0.00%,2,2,0.00%
tracker.logirl.moe,0,0.00%,4,4,0.00%
clientlog3.music.163.com,0,0.00%,21,21,0.00%
clientlog3.music.ntes53.netease.com,0,0.00%,10,10,0.00%
apm3.music.ntes53.netease.com,0,0.00%,8,8,0.00%
pk-toutiao-ipv6-ml.gslb.ksyuncdn.com,0,0.00%,2,2,0.00%
zb-443-wagbridge.advertisement.alibaba-inc.com,0,0.00%,4,4,0.00%
zb-443-wagbridge.advertisement.alibaba-inc.com.gds.alibabadns.com,0,0.00%,8,8,0.00%
tg35v6.syscdn.zjsxlt.com,0,0.00%,22,22,0.00%
cs10.wpc.v0cdn.net,0,0.00%,16,16,0.00%
qg.lorzl.gq,0,0.00%,12,12,0.00%
tracker.btsync.gq,0,0.00%,8,8,0.00%
liquipedia.net,0,0.00%,2,2,0.00%
fvideo.gslb.sinaedge.com,0,0.00%,4,4,0.00%
mam6.netease.com,0,0.00%,10,10,0.00%
z.gds.cnzz.com,0,0.00%,4,4,0.00%
es5.github.io,0,0.00%,1,1,0.00%
notification.adblockplus.org,0,0.00%,2,2,0.00%
fsandroid.ali.kugou.com,0,0.00%,6,6,0.00%
P2pSTuntESt.hapLAT.NEt,0,0.00%,2,2,0.00%
p2pSTunTEsT.HaPlAt.NeT,0,0.00%,2,2,0.00%
ocsp.msocsp.com,0,0.00%,8,8,0.00%
zhengxin-pub.bj.bcebos.com,0,0.00%,4,4,0.00%
odk-server-pro.bj.bcebos.com,0,0.00%,2,2,0.00%
scontent.fiev13-1.fna.fbcdn.net,0,0.00%,1,1,0.00%
tvaxweibo.gslb.sinaedge.com,0,0.00%,7,7,0.00%
dx.doi.org,0,0.00%,2,2,0.00%
ins-kz1q5rqv.ias.tencent-cloud.net,0,0.00%,10,10,0.00%
www.nsfc.gov.cn,0,0.00%,2,2,0.00%
dualstack-restapi.amap.com.gds.alibabadns.com,0,0.00%,2,2,0.00%
btloader.com,0,0.00%,2,2,0.00%
ad-delivery.net,0,0.00%,2,2,0.00%
static.btloader.com,0,0.00%,2,2,0.00%
script.4dex.io,0,0.00%,2,2,0.00%
ads2ads.net,0,0.00%,2,2,0.00%
jcmellado.github.io,0,0.00%,1,1,0.00%
nginx.org,0,0.00%,14,14,0.00%
ftp.cc.uoc.gr,0,0.00%,6,6,0.00%
ftp.fi.muni.cz,0,0.00%,6,6,0.00%
rtmp-push.tingtingfm.com,0,0.00%,8,8,0.00%
463cab840db04698a2ea5c2f91aac392.fp.measure.office.com,0,0.00%,2,2,0.00%
mettom.vk10.nl,0,0.00%,2,2,0.00%
travisstark.github.io,0,0.00%,1,1,0.00%
sc.drleo.cf,0,0.00%,1,1,0.00%
fuck2.aros.gq,0,0.00%,1,1,0.00%
mobileapi.qipeipu.com,0,0.00%,1,1,0.00%
a20-66.akam.net,0,0.00%,6,6,0.00%
a8-64.akam.net,0,0.00%,3,3,0.00%
a9-65.akam.net,0,0.00%,3,3,0.00%
sports.qq.com,0,0.00%,2,2,0.00%
sessiondirectory.xboxlive.com,0,0.00%,4,4,0.00%
matchweb.sports.qq.com,0,0.00%,2,2,0.00%
data.video.qq.com,0,0.00%,2,2,0.00%
p.l.qq.com,0,0.00%,5,5,0.00%
www.qdu.edu.cn,0,0.00%,2,2,0.00%
www.bjtu.edu.cn,0,0.00%,2,2,0.00%
apd-836e417f989cc7d8893acc8b4661681e6c19bd1ffe3c26f7.v.smtcdns.com,0,0.00%,2,2,0.00%
aq.qq.com,0,0.00%,2,2,0.00%
aijscdn2.azureedge.net,0,0.00%,2,2,0.00%
consentdeliveryfd.azurefd.net,0,0.00%,3,3,0.00%
aijscdn2.afd.azureedge.net,0,0.00%,2,2,0.00%
firstparty-azurefd-prod.trafficmanager.net,0,0.00%,11,11,0.00%
hao123.n.shifen.com,0,0.00%,4,4,0.00%
shield.hao123.com,0,0.00%,8,8,0.00%
gslb-offline-pkx01-v6.zhihu.com,0,0.00%,5,5,0.00%
feed-6009.coderformylife.info,0,0.00%,2,2,0.00%
hostedocsp.globalsign.com,0,0.00%,6,6,0.00%
api.globalsign.cloud,0,0.00%,6,6,0.00%
lb-pkx01-offline-v6.zhihu.com,0,0.00%,9,9,0.00%
i.v2ex.co,0,0.00%,2,2,0.00%
miguvideo.c.cdn.chinamobile.com,0,0.00%,6,6,0.00%
gr.mofcom.gov.cn,0,0.00%,2,2,0.00%
www.cnr.cn,0,0.00%,4,4,0.00%
www.cnr.cn.wswebcdn.com,0,0.00%,2,2,0.00%
www.fmprc.gov.cn,0,0.00%,2,2,0.00%
www.cri.cn.cdn20.com,0,0.00%,2,2,0.00%
www.fmprc.gov.cn.wswebpic.com,0,0.00%,2,2,0.00%
www.ts.cn,0,0.00%,2,2,0.00%
ts-cn.cname.saaswaf.com,0,0.00%,2,2,0.00%
xjca.cache.dbappwaf.cn,0,0.00%,1,1,0.00%
routerpool7.rlb.teamviewer.com,0,0.00%,3,3,0.00%
lf3-reading.fqnovelpic.com.w.kunluncan.com,0,0.00%,4,4,0.00%
weng.mafengwo.net,0,0.00%,2,2,0.00%
vuematerial.github.io,0,0.00%,1,1,0.00%
lingerbhw.github.io,0,0.00%,1,1,0.00%
tfhauj.nb78.tk,0,0.00%,1,1,0.00%
qqweb.qq.com,0,0.00%,6,6,0.00%
qun.qq.com,0,0.00%,2,2,0.00%
m.51test.net,0,0.00%,4,4,0.00%
css.51test.net,0,0.00%,4,4,0.00%
www.51test.net,0,0.00%,2,2,0.00%
js.51test.net,0,0.00%,4,4,0.00%
img.51test.net,0,0.00%,1,1,0.00%
therightsize.net,0,0.00%,8,8,0.00%
i.news.qq.com,0,0.00%,2,2,0.00%
f.10086.cn,0,0.00%,4,4,0.00%
f.10086.cn.c.cdn.chinamobile.com,0,0.00%,3,3,0.00%
qin5jgmy.sched.sma-dk.tdnsstic1.cn.cjt.krcdn.idatacube.com,0,0.00%,1,1,0.00%
oss-v6.mail.qq.com,0,0.00%,12,12,0.00%
cname.fanyi.ntes53.netease.com,0,0.00%,4,4,0.00%
iptest.me,0,0.00%,1,1,0.00%
amdc.m.youku.com,0,0.00%,2,2,0.00%
ipv6-amdc.base.youku.com,0,0.00%,2,2,0.00%
popv6hz.qiye.ntes53.netease.com,0,0.00%,6,6,0.00%
routerpool3.rlb.teamviewer.com,0,0.00%,2,2,0.00%
routerpool12.rlb.teamviewer.com,0,0.00%,2,2,0.00%
1180c.wpc.azureedge.net,0,0.00%,10,10,0.00%
apm3.music.163.com,0,0.00%,7,7,0.00%
f73fb5ace8b8633791aa8dbfb1a13336.clo.footprintdns.com,0,0.00%,1,1,0.00%
ins-0xt2bis9.ias.tencent-cloud.net,0,0.00%,4,4,0.00%
static.ess.apple.com,0,0.00%,4,4,0.00%
v2-mg02.kwaicdn.com,0,0.00%,2,2,0.00%
9ec1a82a92e5480c87377b72aed6f9ef.fp.measure.office.com,0,0.00%,1,1,0.00%
ximysm.github.io,0,0.00%,2,2,0.00%
043c8f6191a541d0bdcb0c593a0e409f.fp.measure.office.com,0,0.00%,1,1,0.00%
glotorrents.pw,0,0.00%,15,15,0.00%
bt.xxxtor.com,0,0.00%,13,13,0.00%
tracker.sbsub.com,0,0.00%,14,14,0.00%
word-view.officeapps.live.com,0,0.00%,1,1,0.00%
cloud-boe.bytedance.net,0,0.00%,1,1,0.00%
cloud.bytedance.net,0,0.00%,1,1,0.00%
jsmov2.a.yximgs.com,0,0.00%,2,2,0.00%
jscmmov.a.etoote.com,0,0.00%,2,2,0.00%
jscm.a.etoote.com,0,0.00%,2,2,0.00%
v10.kwaicdn.com,0,0.00%,2,2,0.00%
v22.kwaicdn.com,0,0.00%,2,2,0.00%
mirror.chpc.utah.edu,0,0.00%,8,8,0.00%
sa5.tuisong.baidu.com,0,0.00%,10,10,0.00%
bvarf.tracker.sh,0,0.00%,2,2,0.00%
asnet.pw,0,0.00%,2,2,0.00%
cqc-download.ftn.qq.com,0,0.00%,2,2,0.00%
sandrotracker.biz,0,0.00%,1,1,0.00%
retracker.spark-rostov.ru,0,0.00%,2,2,0.00%
tracker.videodrugproject.com,0,0.00%,2,2,0.00%
newtrackon.com,0,0.00%,2,2,0.00%
v2.91p48.com,0,0.00%,1,1,0.00%
vps.fengshan.tk,0,0.00%,1,1,0.00%
5a399cb3e83344dc915442809b174e04.fp.measure.office.com,0,0.00%,1,1,0.00%
3d3a9ceed35740b28ccdcf3b5293af1f.fp.measure.office.com,0,0.00%,1,1,0.00%
mail.dev-tools.biz,0,0.00%,59,59,0.00%
au-syd-anx-r008.router.teamviewer.com,0,0.00%,2,2,0.00%
apd-a100d6760ba05bcb6fe68b7ff1d7e7bfa6299cffa286fa4e.v.smtcdns.com,0,0.00%,3,3,0.00%
v2.reachmax.cn,0,0.00%,2,2,0.00%
apd-d8418419d84705b9067c68fa9330c8aa92e754f2d908ad73.v.smtcdns.com,0,0.00%,4,4,0.00%
wwW.Vod.lxdNS.coM,0,0.00%,2,2,0.00%
p2pStuntEst.haPLAT.nEt,0,0.00%,2,2,0.00%
apd-02573fa98f3f2ffb01f9fd524fc749974b44703ef46532b0.v.smtcdns.com,0,0.00%,4,4,0.00%
zdr16avq7.ualoe.gq,0,0.00%,1,1,0.00%
allesanddro.de,0,0.00%,1,1,0.00%
gzc-download.ftn.qq.com,0,0.00%,2,2,0.00%
tracker.trackton.ga,0,0.00%,2,2,0.00%
biol.com.ua,0,0.00%,1,1,0.00%
zijunsoftware.github.io,0,0.00%,1,1,0.00%
tracker.fdn.fr,0,0.00%,6,6,0.00%
d4530f092085467290e7294583c9e271.fp.measure.office.com,0,0.00%,1,1,0.00%
summer.igamantasenta.tk,0,0.00%,1,1,0.00%
kooofly.github.io,0,0.00%,61,61,0.00%
tipsviablogging.github.io,0,0.00%,1,1,0.00%
d3g7ekkjzmadb9.cloudfront.net,0,0.00%,1,1,0.00%
cdn.jiqizhixin.com,0,0.00%,1,1,0.00%
image.jiqizhixin.com,0,0.00%,1,1,0.00%
azure.microsoft.com,0,0.00%,2,2,0.00%
nodeclipse.github.io,0,0.00%,61,61,0.00%
cm.e.qq.com,0,0.00%,16,16,0.00%
gamedevmeowtch.github.io,0,0.00%,1,1,0.00%
dual-a-0036.dc-msedge.net,0,0.00%,5,5,0.00%
3rtfcz.qqscml.ml,0,0.00%,61,61,0.00%
ftp.jaist.ac.jp,0,0.00%,1,1,0.00%
mirror2.totbb.net,0,0.00%,2,2,0.00%
mirror.pregi.net,0,0.00%,2,2,0.00%
ftp.cuhk.edu.hk,0,0.00%,2,2,0.00%
kartolo.sby.datautama.net.id,0,0.00%,6,6,0.00%
johnny.github.io,0,0.00%,1,1,0.00%
download.sangfor.com.cn,0,0.00%,3,3,0.00%
download.sangfor.com.cn.cdn20.com,0,0.00%,7,7,0.00%
wentaoyuan.github.io,0,0.00%,1,1,0.00%
mike.ns.cloudflare.com,0,0.00%,2,2,0.00%
april.ns.cloudflare.com,0,0.00%,2,2,0.00%
trk-183-220-193-55.douyucdn.cn,0,0.00%,2,2,0.00%
www.kanzhun.com,0,0.00%,1,1,0.00%
static.kanzhun.com,0,0.00%,2,2,0.00%
s.kanzhun.com,0,0.00%,4,4,0.00%
t.kanzhun.com,0,0.00%,10,10,0.00%
core.dev.keencs.com,0,0.00%,2,2,0.00%
www1240.ff-03.com,0,0.00%,1,1,0.00%
smc-link.s4hana.ondemand.com,0,0.00%,1,1,0.00%
p.typekit.net,0,0.00%,1,1,0.00%
log.kslogs.ru,0,0.00%,4,4,0.00%
telv6.music.ntes53.netease.com,0,0.00%,11,11,0.00%
social.c-r-t.tk,0,0.00%,1,1,0.00%
ctm-mfm.fastly.ga,0,0.00%,1,1,0.00%
panel.oneprovider.com,0,0.00%,1,1,0.00%
resolver.dingtalk.com,0,0.00%,3,3,0.00%
orange-dc.alibaba.com,0,0.00%,5,5,0.00%
rr1---sn-aigl6nzl.googlevideo.com,0,0.00%,7,7,0.00%
db5716534253222d0bf6b12502546a0b.nrb.footprintdns.com,0,0.00%,2,2,0.00%
csmobiledata.alipay.com,0,0.00%,2,2,0.00%
gz-rr2.internet-g.spanner.alipaydns.com,0,0.00%,2,2,0.00%
gz-rr2.internet.v6.spanner.alipaydns.com,0,0.00%,4,4,0.00%
poloframe.com,0,0.00%,4,4,0.00%
mma.prnewswire.com,0,0.00%,2,2,0.00%
pb6.sogou.com,0,0.00%,3,3,0.00%
www.youku.com,0,0.00%,3,3,0.00%
www.58.com,0,0.00%,1,1,0.00%
www.dianping.com,0,0.00%,1,1,0.00%
www.qunar.com,0,0.00%,1,1,0.00%
www.suning.com,0,0.00%,1,1,0.00%
www.doi.org,0,0.00%,2,2,0.00%
sgm-m.jd.com,0,0.00%,3,3,0.00%
site.ip138.com,0,0.00%,1,1,0.00%
1l7usz58.sched.pddlego-dk.tdnsstic1.cn.cjt.krcdn.idatacube.com,0,0.00%,1,1,0.00%
disp-qqdataabipv6tmp.ias.tencent-cloud.net,0,0.00%,10,10,0.00%
ins-9k5o069p.ias.tencent-cloud.net,0,0.00%,2,2,0.00%
ins-vm1b9zdn.ias.tencent-cloud.net,0,0.00%,7,7,0.00%
qjw.jeffss.tk,0,0.00%,1,1,0.00%
dd16a5f677c14ac98f667e7cb350bdb0.fp.measure.office.com,0,0.00%,2,2,0.00%
3.tlu.dl.delivery.mp.microsoft.com,0,0.00%,2,2,0.00%
4.tlu.dl.delivery.mp.microsoft.com,0,0.00%,10,10,0.00%
msftstorebg.s.llnwi.net,0,0.00%,11,11,0.00%
center.amdc.m.taobao.com,0,0.00%,2,2,0.00%
ipv4-ipv6.inf-epd.vip.meituan.com,0,0.00%,4,4,0.00%
mixv6-4.194610.xyz,0,0.00%,4,4,0.00%
client-api-cdn.itunes-apple.com.akadns.net,0,0.00%,1,1,0.00%
b1-q.mafengwo.net,0,0.00%,5,5,0.00%
zlxxipv6global.v.trpcdn.net,0,0.00%,2,2,0.00%
cococut.net,0,0.00%,1,1,0.00%
sf-helper.com,0,0.00%,2,2,0.00%
geo.trafficmanager.net,0,0.00%,4,4,0.00%
fp-afd.azurefd.net,0,0.00%,5,5,0.00%
hektormisplon.github.io,0,0.00%,61,61,0.00%
catkin.duckdns.org,0,0.00%,2,2,0.00%
zls1996.github.io,0,0.00%,1,1,0.00%
a6f3e37a3d754c8abd6fba98ac814421.fp.measure.office.com,0,0.00%,1,1,0.00%
tlu-dcat.ec.azureedge.net,0,0.00%,2,2,0.00%
v2.zyzh.tk,0,0.00%,2,2,0.00%
e9065da7d734444e8938d09cca0ec6b3.fp.measure.office.com,0,0.00%,1,1,0.00%
d11upr8lrcn9x7.cloudfront.net,0,0.00%,1,1,0.00%
d1pjd8rgyh6n0l.cloudfront.net,0,0.00%,1,1,0.00%
mtpspublic-ejbja5h5btf0cjh8.z01.azurefd.net,0,0.00%,1,1,0.00%
commappxprod-e9bcfbf2cyhzckfb.z01.azurefd.net,0,0.00%,1,1,0.00%
cacheorcheck.mopinion.com,0,0.00%,4,4,0.00%
download.gfe.nvidia.com,0,0.00%,8,8,0.00%
cs486283.wpc.phicdn.net,0,0.00%,1,1,0.00%
lb.apr-2d930.edgecastdns.net,0,0.00%,1,1,0.00%
cs486284.wpc.phicdn.net,0,0.00%,1,1,0.00%
ukibm.ptuu.ga,0,0.00%,104,104,0.00%
git.semisol.dev,0,0.00%,1,1,0.00%
open-smartwatch.github.io,0,0.00%,1,1,0.00%
lucasnathaniel.github.io,0,0.00%,1,1,0.00%
mail.dingtalk.com,0,0.00%,10,10,0.00%
li2237-93.members.linode.com,0,0.00%,2,2,0.00%
alibaba-group.tengine.alibaba.com,0,0.00%,2,2,0.00%
dualstack-logs.amap.com.gds.alibabadns.com,0,0.00%,3,3,0.00%
cstat-lb.apple.com.akadns.net,0,0.00%,1,1,0.00%
r1.sn-i3b7knse.gvt1.com,0,0.00%,2,2,0.00%
ecxgeq.qqscml.ga,0,0.00%,2,2,0.00%
thumbnail9.coupangcdn.com,0,0.00%,1,1,0.00%
rnx.nicefly2099.cf,0,0.00%,1,1,0.00%
oht14ry7nm.fowce.gq,0,0.00%,1,1,0.00%
5e11f9c5f57346e6ba03d9d25561eaec.fp.measure.office.com,0,0.00%,1,1,0.00%
9.tlu.dl.delivery.mp.microsoft.com,0,0.00%,4,4,0.00%
cds.f7y3z2w8.hwcdn.net,0,0.00%,6,6,0.00%
cashapp.github.io,0,0.00%,61,61,0.00%
api.8864029a8b01d50a95d558b5792ce2d6.com,0,0.00%,13,13,0.00%
education-certification.youdao.com,0,0.00%,1,1,0.00%
ydpushserver.youdao.com,0,0.00%,1,1,0.00%
wow.youdao.com,0,0.00%,2,2,0.00%
wow-activity.youdao.com,0,0.00%,2,2,0.00%
v2.shyonghui.xyz,0,0.00%,1,1,0.00%
aqyzmedia.yunaq.com,0,0.00%,2,2,0.00%
v.yunaq.com,0,0.00%,2,2,0.00%
tjs.sjs.sinajs.cn,0,0.00%,2,2,0.00%
set.gosts.gq,0,0.00%,1,1,0.00%
s.c-ctrip.com,0,0.00%,2,2,0.00%
bdbus-turbonet.baidu.com,0,0.00%,4,4,0.00%
s.1688.com,0,0.00%,2,2,0.00%
inversine.elseway.tk,0,0.00%,61,61,0.00%
vcityteam.github.io,0,0.00%,1,1,0.00%
hello-sherlock.github.io,0,0.00%,1,1,0.00%
musa-550-fall-2021.github.io,0,0.00%,1,1,0.00%
jjm2473.github.io,0,0.00%,1,1,0.00%
sa-update-asf.snb.it,0,0.00%,4,4,0.00%
7et2ri.qqscml.ml,0,0.00%,2,2,0.00%
rmm233.github.io,0,0.00%,61,61,0.00%
hztp.hotjob.cn,0,0.00%,2,2,0.00%
d2f1a68rmuokoa.cloudfront.net,0,0.00%,1,1,0.00%
vowel.egsesisurgires.tk,0,0.00%,1,1,0.00%
d15po2y6qe9yxr.cloudfront.net,0,0.00%,1,1,0.00%
www.usps.com,0,0.00%,50,50,0.00%
soft.hitun.io,0,0.00%,4,4,0.00%
disp-dataabqqv6tmp.ias.tencent-cloud.net,0,0.00%,9,9,0.00%
snowflake.qq.com,0,0.00%,4,4,0.00%
ins-y499hqad.ias.tencent-cloud.net,0,0.00%,4,4,0.00%
gatherer.m.qq.com,0,0.00%,2,2,0.00%
mazu.m.qq.com,0,0.00%,6,6,0.00%
ins-isqjvxa9.ias.tencent-cloud.net,0,0.00%,2,2,0.00%
ins-gzw2jbpv.ias.tencent-cloud.net,0,0.00%,4,4,0.00%
tsms-drcn.security.dbankcloud.cn,0,0.00%,2,2,0.00%
rms-drcn.platform.dbankcloud.cn,0,0.00%,2,2,0.00%
connectivitycheck.cbg-app.huawei.com.cn,0,0.00%,2,2,0.00%
e4a8257b91944813a5e1336358c98a20.fp.measure.office.com,0,0.00%,1,1,0.00%
a7-64.akam.net,0,0.00%,2,2,0.00%
a1-127.akam.net,0,0.00%,2,2,0.00%
san3ar.github.io,0,0.00%,1,1,0.00%
huangzhun05.github.io,0,0.00%,1,1,0.00%
steamusercontent-a.akamaihd.net,0,0.00%,1,1,0.00%
aws.vbnm.cf,0,0.00%,1,1,0.00%
cdn.connectad.io,0,0.00%,2,2,0.00%
www.tns-counter.ru,0,0.00%,1,1,0.00%
cfw9ceoxz.uyoo.gq,0,0.00%,1,1,0.00%
c7b8e2a2072947f68801c5f7a2687135.fp.measure.office.com,0,0.00%,1,1,0.00%
vip.video.qq.com,0,0.00%,8,8,0.00%
apd-609c8727e337428bb2edbec922460b5501bdd8f5529987f8.v.smtcdns.com,0,0.00%,2,2,0.00%
coral520.github.io,0,0.00%,1,1,0.00%
meishi.meituan.com,0,0.00%,2,2,0.00%
c.tile.openstreetmap.org,0,0.00%,2,2,0.00%
1e7d137c4429484db195b5d3e5f3fa61.fp.measure.office.com,0,0.00%,2,2,0.00%
maoruimas.github.io,0,0.00%,1,1,0.00%
pdns124.ultradns.net,0,0.00%,2,2,0.00%
barcamp.eusib.de,0,0.00%,61,61,0.00%
03e1181bba1cf.cdn.sohucs.com,0,0.00%,1,1,0.00%
c1494161c414f.cdn.sohucs.com,0,0.00%,1,1,0.00%
www.researchgate.net,0,0.00%,9,9,0.00%
p1.img.cctvpic.com,0,0.00%,2,2,0.00%
z13.cnzz.com,0,0.00%,1,1,0.00%
s0.hao123img.com,0,0.00%,2,2,0.00%
s1.hao123img.com,0,0.00%,2,2,0.00%
tuijian.hao123.com,0,0.00%,2,2,0.00%
game.hao123.com,0,0.00%,2,2,0.00%
www.boc.cn,0,0.00%,1,1,0.00%
jump.luna.58.com,0,0.00%,2,2,0.00%
live.baidu.com,0,0.00%,2,2,0.00%
s.click.taobao.com,0,0.00%,2,2,0.00%
v.hao123.baidu.com,0,0.00%,2,2,0.00%
www.youth.cn,0,0.00%,2,2,0.00%
www.yy.com,0,0.00%,1,1,0.00%
www.myscript.com,0,0.00%,2,2,0.00%
amap-aos-info-nogw.amap.com,0,0.00%,2,2,0.00%
rsync.releases.ubuntu.com,0,0.00%,2,2,0.00%
ports.ubuntu.com,0,0.00%,60,60,0.00%
p2PStUntEST.haPlAT.NET,0,0.00%,2,2,0.00%
www.zone-torrent.net,0,0.00%,5,5,0.00%
6226380651dc4c02a903778c7ae0bc23.fp.measure.office.com,0,0.00%,1,1,0.00%
apd-5d4143548f592cbd7c969842bbae847d61c112a2a99b6bcb.v.smtcdns.com,0,0.00%,2,2,0.00%
ip6.ssl.msdk.qq.com,0,0.00%,4,4,0.00%
css-ui.github.io,0,0.00%,1,1,0.00%
msg.umengcloud.com,0,0.00%,2,2,0.00%
wiki.samat.org,0,0.00%,61,61,0.00%
liwx2000.github.io,0,0.00%,1,1,0.00%
static.hao86.com,0,0.00%,4,4,0.00%
shijieditu.hao86.com,0,0.00%,2,2,0.00%
emweb.securities.eastmoney.com,0,0.00%,2,2,0.00%
7998da2750f4458888cc30c86d7f8a79.fp.measure.office.com,0,0.00%,2,2,0.00%
77cc0354e07c40e594af60b5dc28cfa9.fp.measure.office.com,0,0.00%,2,2,0.00%
caifuhao.eastmoney.com,0,0.00%,6,6,0.00%
guba.eastmoney.com,0,0.00%,8,8,0.00%
i.eastmoney.com,0,0.00%,4,4,0.00%
api-0-5-0.twitter.com,0,0.00%,1,1,0.00%
api-3-0-0.twitter.com,0,0.00%,1,1,0.00%
api-28-0-0.twitter.com,0,0.00%,1,1,0.00%
api-0-4-4.twitter.com,0,0.00%,1,1,0.00%
gstatic.loli.net,0,0.00%,2,2,0.00%
binary-factory.kde.org,0,0.00%,1,1,0.00%
hypothes.is,0,0.00%,2,2,0.00%
dl-portal.iina.io,0,0.00%,3,3,0.00%
edge-142.hkhkg.ce.apple-dns.net,0,0.00%,1,1,0.00%
edge-001.hktko1.icloud-content.com,0,0.00%,1,1,0.00%
edge-001.hktko1.ce.apple-dns.net,0,0.00%,1,1,0.00%
boot.pbstck.com,0,0.00%,2,2,0.00%
cdn.pbstck.com,0,0.00%,2,2,0.00%
assets.a-mo.net.cdn.cloudflare.net,0,0.00%,3,3,0.00%
id.a-mx.com,0,0.00%,4,4,0.00%
crl.identrust.com,0,0.00%,2,2,0.00%
static-cdn-test.sn-cloudflare.com,0,0.00%,2,2,0.00%
eribean.github.io,0,0.00%,1,1,0.00%
download.postgresql.org,0,0.00%,95,95,0.00%
api-env.dropbox-dns.com,0,0.00%,2,2,0.00%
ins-uw43j1pm.ias.tencent-cloud.net,0,0.00%,2,2,0.00%
djl1lrr9.sched.sma-dk.tdnsstic1.cn.cjt.krcdn.idatacube.com,0,0.00%,2,2,0.00%
bkssl.bdimg.com.a.bdydns.com,0,0.00%,8,8,0.00%
mixv6-38.194610.xyz,0,0.00%,1,1,0.00%
mixv6-21.194610.xyz,0,0.00%,2,2,0.00%
mixv6-31.194610.xyz,0,0.00%,2,2,0.00%
v6-21.hiaoxui.work,0,0.00%,2,2,0.00%
v6-31.hiaoxui.work,0,0.00%,2,2,0.00%
v6-38.hiaoxui.work,0,0.00%,2,2,0.00%
martyhimmel.github.io,0,0.00%,1,1,0.00%
js.cyol.com,0,0.00%,3,3,0.00%
companion.untapped.gg,0,0.00%,3,3,0.00%
ns-1627.awsdns-11.co.uk,0,0.00%,2,2,0.00%
ashburnlee.github.io,0,0.00%,1,1,0.00%
nasamars.github.io,0,0.00%,1,1,0.00%
tamas3.ynh.fr,0,0.00%,2,2,0.00%
u6.trakx.crim.ist,0,0.00%,2,2,0.00%
monitor.cxwz.ga,0,0.00%,2,2,0.00%
qunyi-1b3ef.firebaseio.com,0,0.00%,1,1,0.00%
tianshu.qq.com,0,0.00%,5,5,0.00%
ubuntu-cloud.archive.canonical.com,0,0.00%,6,6,0.00%
cftr.amklgbzg.cf,0,0.00%,1,1,0.00%
genggang.github.io,0,0.00%,61,61,0.00%
www.yahoo.com,0,0.00%,4,4,0.00%
code-examples.net,0,0.00%,4,4,0.00%
www.mohrss.gov.cn,0,0.00%,1,1,0.00%
www.piyao.org.cn,0,0.00%,3,3,0.00%
captcha-api.pingan.com,0,0.00%,3,3,0.00%
oss.console.aliyun.com,0,0.00%,2,2,0.00%
dc.console.aliyun.com,0,0.00%,2,2,0.00%
sls.console.aliyun.com,0,0.00%,2,2,0.00%
yundun.console.aliyun.com,0,0.00%,2,2,0.00%
cloudmonitornext.console.aliyun.com,0,0.00%,2,2,0.00%
cloudphone.console.aliyun.com,0,0.00%,2,2,0.00%
nls-portal.console.aliyun.com,0,0.00%,2,2,0.00%
vpc.console.aliyun.com,0,0.00%,2,2,0.00%
api.aliyun.com,0,0.00%,2,2,0.00%
hosting.gitbook.io,0,0.00%,2,2,0.00%
slb.console.aliyun.com,0,0.00%,2,2,0.00%
work.console.aliyun.com,0,0.00%,2,2,0.00%
ros.console.aliyun.com,0,0.00%,2,2,0.00%
sae.console.aliyun.com,0,0.00%,2,2,0.00%
sgwnew.console.aliyun.com,0,0.00%,2,2,0.00%
smc.console.aliyun.com,0,0.00%,2,2,0.00%
ehpc.console.aliyun.com,0,0.00%,1,1,0.00%
www.firestoneapp.com,0,0.00%,1,1,0.00%
static.zerotoheroes.com,0,0.00%,1,1,0.00%
api.roomz.tk,0,0.00%,1,1,0.00%
alogs.umeng.com,0,0.00%,2,2,0.00%
alogs.umeng.com.gds.alibabadns.com,0,0.00%,2,2,0.00%
files01.js.10086.cn,0,0.00%,2,2,0.00%
reports.exodus-privacy.eu.org,0,0.00%,2,2,0.00%
web.facebook.com,0,0.00%,2,2,0.00%
cpro.baidustatic.com.a.bdydns.com,0,0.00%,4,4,0.00%
dns9.hichina.com,0,0.00%,2,2,0.00%
dns10.hichina.com,0,0.00%,1,1,0.00%
alcret.github.io,0,0.00%,1,1,0.00%
d2xagpjpa06rhe.cloudfront.net,0,0.00%,1,1,0.00%
ghedge005.ghabc.tk,0,0.00%,61,61,0.00%
5parishes.org.uk,0,0.00%,61,61,0.00%
trovaagente.replat.com,0,0.00%,1,1,0.00%
apd-8a925afaa7d148a101db7b413fd3db8c5d653b8c3b489e9b.v.smtcdns.com,0,0.00%,3,3,0.00%
weaverluke.github.io,0,0.00%,1,1,0.00%
i-45.b-45966.bench.utorrent.com,0,0.00%,2,2,0.00%
ws.sidequestvr.com,0,0.00%,4,4,0.00%
aruni-01.github.io,0,0.00%,61,61,0.00%
test.chenguaself.tk,0,0.00%,1,1,0.00%
micro-zoe.github.io,0,0.00%,1,1,0.00%
clientreport.gfm.qq.com,0,0.00%,2,2,0.00%
smtp.gmail.com,0,0.00%,2,2,0.00%
publicus.gslb.sinaedge.com,0,0.00%,4,4,0.00%
people-pa.googleapis.com,0,0.00%,2,2,0.00%
client-env.dropbox-dns.com,0,0.00%,2,2,0.00%
ipv4-ipv6-phase4.cat.sh.vip.dianping.com,0,0.00%,10,10,0.00%
ipv4-ipv6-phase4.wpt-portm.vip.meituan.com,0,0.00%,2,2,0.00%
hnb-router-gs-v6.udache.com,0,0.00%,2,2,0.00%
www.pingan.com,0,0.00%,2,2,0.00%
baoxiancdn.pingan.com,0,0.00%,4,4,0.00%
stdv6.pacdn.com,0,0.00%,4,4,0.00%
hcz-static.pingan.com.cn,0,0.00%,4,4,0.00%
appmonjs.pingan.com.cn,0,0.00%,8,8,0.00%
accv6.pacdn.com,0,0.00%,4,4,0.00%
ns-1867.awsdns-41.co.uk,0,0.00%,2,2,0.00%
fgssrs.bzxhds.ml,0,0.00%,1,1,0.00%
jason-live.github.io,0,0.00%,1,1,0.00%
ose.caiyun.feixin.10086.cn,0,0.00%,18,18,0.00%
ose1.caiyun.feixin.10086.cn,0,0.00%,20,20,0.00%
interface3.music.163.com.bsclink.cn,0,0.00%,4,4,0.00%
uz99.v.bsclink.cn,0,0.00%,4,4,0.00%
firebaseremoteconfig.googleapis.com,0,0.00%,2,2,0.00%
voilatile-pa.googleapis.com,0,0.00%,2,2,0.00%
cloud189-shh2-person.oos-sh2.ctyunapi.cn,0,0.00%,2,2,0.00%
fx-xwsjfx-xt.bankofbeijing.com.cn,0,0.00%,2,2,0.00%
dfp-xt.bankofbeijing.com.cn,0,0.00%,2,2,0.00%
commobibank.95526.mobi,0,0.00%,2,2,0.00%
apmreceiver.bankofbeijing.com.cn,0,0.00%,2,2,0.00%
img1.t.sinajs.cn,0,0.00%,4,4,0.00%
cdn-edge.azureedge.net,0,0.00%,2,2,0.00%
qe5ipv.nb78.tk,0,0.00%,1,1,0.00%
static-resource.cktime.tk,0,0.00%,1,1,0.00%
danmarshall.github.io,0,0.00%,1,1,0.00%
oduwsdl.github.io,0,0.00%,2,2,0.00%
moyu-zc.github.io,0,0.00%,61,61,0.00%
www.GoogLe.Com,0,0.00%,3,3,0.00%
wwW.yaHoO.coM,0,0.00%,3,3,0.00%
cdn.cnbj1.fds.api.mi-img.com.download.ks-cdn.com,0,0.00%,2,2,0.00%
device.auth.xboxlive.com.akadns.net,0,0.00%,4,4,0.00%
device-auth-xboxlive-com.l-0006.l-msedge.net,0,0.00%,4,4,0.00%
login.dingtalk.com,0,0.00%,3,3,0.00%
alidocs.dingtalk.com,0,0.00%,3,3,0.00%
P2PSTUnteSt.HaPLat.NEt,0,0.00%,1,1,0.00%
wwW.vOD.lxDNs.cOM,0,0.00%,2,2,0.00%
aunsetre.github.io,0,0.00%,1,1,0.00%
wechatfe.github.io,0,0.00%,1,1,0.00%
0df7812297d04f1cb80f2d57db50266f.fp.measure.office.com,0,0.00%,2,2,0.00%
ns-1306.awsdns-35.org,0,0.00%,1,1,0.00%
48b75f5b1f30409b9caf71cd59aa834a.fp.measure.office.com,0,0.00%,1,1,0.00%
dns.tsinghua.edu.cn,0,0.00%,4,4,0.00%
dns2.tsinghua.edu.cn,0,0.00%,4,4,0.00%
hubinbin91.github.io,0,0.00%,2,2,0.00%
ignite.apache.org,0,0.00%,36,36,0.00%
seongbrave.github.io,0,0.00%,1,1,0.00%
shao3wangdi.github.io,0,0.00%,1,1,0.00%
download.fedoraproject.org,0,0.00%,2,2,0.00%
artifacts.elastic.co,0,0.00%,2,2,0.00%
fast.losadhwselfff2332dasd.xyz,0,0.00%,2,2,0.00%
cz.archive.ubuntu.com,0,0.00%,5,5,0.00%
mholkz.qqscml.ml,0,0.00%,1,1,0.00%
ins-tdjqhtwj.ias.tencent-cloud.net,0,0.00%,11,11,0.00%
s-ring-fallback.msedge.net,0,0.00%,1,1,0.00%
ftp.cn.debian.org,0,0.00%,4,4,0.00%
meeting-75420.picgzc.qpic.cn,0,0.00%,3,3,0.00%
8l0h.github.io,0,0.00%,1,1,0.00%
edgefrecdn.azureedge.net,0,0.00%,2,2,0.00%
now.qq.com,0,0.00%,2,2,0.00%
open.mobile.qq.com,0,0.00%,4,4,0.00%
msgacs-ipv6-v2.youku.com,0,0.00%,6,6,0.00%
policy.jd.com.gslb.qianxun.com,0,0.00%,2,2,0.00%
fussinaimg.gslb.sinaedge.com,0,0.00%,4,4,0.00%
ins-7s8u6xzp.ias.tencent-cloud.net,0,0.00%,2,2,0.00%
packagist.org,0,0.00%,2,2,0.00%
aiui-dispatch.iflyos.cn,0,0.00%,2,2,0.00%
download.cloud.189.cn,0,0.00%,2,2,0.00%
ipv6-datacenter.live.qcloud.com,0,0.00%,12,12,0.00%
mirrors.cqu.edu.cn,0,0.00%,16,16,0.00%
uptime.vsldev.tk,0,0.00%,1,1,0.00%
blakbin.github.io,0,0.00%,61,61,0.00%
de5d11f084394d249db0747f665c9dfe.fp.measure.office.com,0,0.00%,1,1,0.00%
dfea601bc8704805a677c6c6254ab3fb.fp.measure.office.com,0,0.00%,1,1,0.00%
ifrcye.qqscml.ml,0,0.00%,61,61,0.00%
xsf1re.github.io,0,0.00%,1,1,0.00%
m.gtld-servers.net,0,0.00%,2,2,0.00%
dacc1cab04424825bac7fcecb69b083b.fp.measure.office.com,0,0.00%,1,1,0.00%
ffff.lcdj.cf,0,0.00%,61,61,0.00%
f876d60aafb54ee494a506eb17f3dad2.fp.measure.office.com,0,0.00%,2,2,0.00%
faabc392594a4e25b555610ba140b7a2.fp.measure.office.com,0,0.00%,2,2,0.00%
xiaomiyang.github.io,0,0.00%,1,1,0.00%
sbs150.sbsf.tech,0,0.00%,1,1,0.00%
alanli7991.github.io,0,0.00%,1,1,0.00%
d1wnwqwep8qkqc.cloudfront.net,0,0.00%,1,1,0.00%
d3b0gp9nk6xg9a.cloudfront.net,0,0.00%,1,1,0.00%
let.ioswz.cf,0,0.00%,1,1,0.00%
pan.alundra4677.ml,0,0.00%,1,1,0.00%
live.us.sinaimg.cn,0,0.00%,2,2,0.00%
liveus.gslb.sinaedge.com,0,0.00%,2,2,0.00%
lib.baomitu.com.qh-cdn.com,0,0.00%,1,1,0.00%
shark.douyucdn.cn.w.kunlungr.com,0,0.00%,1,1,0.00%
ei.cnzz.com.gds.alibabadns.com,0,0.00%,1,1,0.00%
s3m.mediav.com.webcdn.360qhcdn.com,0,0.00%,3,3,0.00%
bingviz.azurefd.net,0,0.00%,1,1,0.00%
sapphire.api.microsoftapp.net,0,0.00%,1,1,0.00%
star-azurefd-prod.trafficmanager.net,0,0.00%,3,3,0.00%
sapphire.azurefd.net,0,0.00%,3,3,0.00%
lib.baomitu.com.webcdn.360qhcdn.com,0,0.00%,1,1,0.00%
h5hosting-drcn-dbankcdn-cn-global.staticcdn.dbankedge.net,0,0.00%,1,1,0.00%
h5hosting-drcn.dbankcdn.globalsign.c.cdnhwc1.cn,0,0.00%,1,1,0.00%
c.bingapis.com,0,0.00%,1,1,0.00%
c-bingapis-com.a-0001.a-msedge.net,0,0.00%,2,2,0.00%
v9-cold2.douyinvod.com,0,0.00%,1,1,0.00%
v9-cold2.douyinvod.com.bsgslb.com,0,0.00%,1,1,0.00%
zttvc3.v.bsgslb.com,0,0.00%,2,2,0.00%
shark2.douyucdn.cn.w.cdngslb.com,0,0.00%,2,2,0.00%
ios-init.51y5.net,0,0.00%,2,2,0.00%
ios-app.51y5.net,0,0.00%,2,2,0.00%
ns-772.awsdns-32.net,0,0.00%,2,2,0.00%
c332e8a52b80421d98475ee9ac54529c.fp.measure.office.com,0,0.00%,2,2,0.00%
24kcs.github.io,0,0.00%,1,1,0.00%
noon.xindewu.cf,0,0.00%,1,1,0.00%
a0.nic.io,0,0.00%,7,7,0.00%
c0.nic.io,0,0.00%,7,7,0.00%
splashimgbssdl.yun.kugou.com,0,0.00%,2,2,0.00%
cdn.plyr.io,0,0.00%,7,7,0.00%
fbvideo.gslb.sinaedge.com,0,0.00%,2,2,0.00%
vipstorage.gslb.sinaedge.com,0,0.00%,2,2,0.00%
us.sinaimg.cn,0,0.00%,2,2,0.00%
ussinaimg.gslb.sinaedge.com,0,0.00%,3,3,0.00%
livephotous.gslb.sinaedge.com,0,0.00%,2,2,0.00%
mam6.ntes53.netease.com,0,0.00%,2,2,0.00%
api.iplay.ntes53.netease.com,0,0.00%,2,2,0.00%
telv6.iplay.ntes53.netease.com,0,0.00%,2,2,0.00%
apiv6.k.ntes53.netease.com,0,0.00%,5,5,0.00%
www.1234567.com.cn,0,0.00%,4,4,0.00%
j6.dfcfw.com,0,0.00%,2,2,0.00%
stephencurry6666.github.io,0,0.00%,1,1,0.00%
ip.sb,0,0.00%,2,2,0.00%
chicocao.github.io,0,0.00%,1,1,0.00%
dream.checalrafilingha.tk,0,0.00%,1,1,0.00%
v1-x.douyinvod.com.gccdn.net,0,0.00%,2,2,0.00%
s7.music.126.net.w.cdngslb.com,0,0.00%,2,2,0.00%
vodkgeyttp9.vod.126.net.163jiasu.com,0,0.00%,2,2,0.00%
vodkgeyttp9.vod.126.net.a.bdydns.com,0,0.00%,2,2,0.00%
opencdn126music.jomodns.com,0,0.00%,2,2,0.00%
8x65.github.io,0,0.00%,61,61,0.00%
www.youdao.com,0,0.00%,1,1,0.00%
mapi.m.jd.com.gslb.qianxun.com,0,0.00%,2,2,0.00%
img1-doubanio-com.b0.aicdn.com,0,0.00%,3,3,0.00%
fcd2517a.cdn.ucloud.com.cn,0,0.00%,2,2,0.00%
errnewlog.umeng.com,0,0.00%,1,1,0.00%
errnewlog.umeng.com.gds.alibabadns.com,0,0.00%,2,2,0.00%
cdn.remirepo.net,0,0.00%,12,12,0.00%
static.criteo.net,0,0.00%,2,2,0.00%
s.marvellousmachine.net,0,0.00%,4,4,0.00%
gum.criteo.com,0,0.00%,2,2,0.00%
d21is3bk1bus90.cloudfront.net,0,0.00%,1,1,0.00%
P2pSTuNTeST.HaPlAT.NEt,0,0.00%,2,2,0.00%
P2PstUNTEsT.HApLAT.nEt,0,0.00%,2,2,0.00%
new.shengdiyage.cf,0,0.00%,2,2,0.00%
ccla.vultrhawk1.tk,0,0.00%,1,1,0.00%
yanmin-wu.github.io,0,0.00%,1,1,0.00%
git.lmburns.com,0,0.00%,1,1,0.00%
mrqdis.qqscml.ga,0,0.00%,1,1,0.00%
pooh72583.github.io,0,0.00%,1,1,0.00%
t-s1-ring.msedge.net,0,0.00%,4,4,0.00%
t-s1-ring.t-s1-9999.t-s1-msedge.net,0,0.00%,2,2,0.00%
t-s1-9999.t-s1-msedge.net,0,0.00%,2,2,0.00%
ins-o9iydzqn.ias.tencent-cloud.net,0,0.00%,5,5,0.00%
www.ucas.ac.cn,0,0.00%,2,2,0.00%
news.ucas.ac.cn,0,0.00%,2,2,0.00%
sfd-production.azurefd.net,0,0.00%,2,2,0.00%
global-geo-afdthirdparty-unicast.trafficmanager.net,0,0.00%,2,2,0.00%
osa30r3a.msedge.net,0,0.00%,2,2,0.00%
t-ring.t-9999.t-msedge.net,0,0.00%,2,2,0.00%
t-9999.t-msedge.net,0,0.00%,2,2,0.00%
passport-api.mihoyo.com,0,0.00%,2,2,0.00%
5423jos419fr3010.aliyunddos1006.com,0,0.00%,2,2,0.00%
rpm.releases.teleport.dev,0,0.00%,6,6,0.00%
bbs-api-static.mihoyo.com.w.alikunlun.com,0,0.00%,2,2,0.00%
www.zhiyinxx.xyz,0,0.00%,2,2,0.00%
mimir.vivaldi.com,0,0.00%,2,2,0.00%
octemull.github.io,0,0.00%,1,1,0.00%
ekirjasto.kirjastot.fi,0,0.00%,1,1,0.00%
maiog.github.io,0,0.00%,1,1,0.00%
de10774d9ac04277893691c9a05b1ddb.fp.measure.office.com,0,0.00%,1,1,0.00%
s.booster-up.cf,0,0.00%,1,1,0.00%
amd-infra.itunes.g.aaplimg.com,0,0.00%,2,2,0.00%
amd-infra-overflow.itunes-apple.com.akadns.net,0,0.00%,3,3,0.00%
swdlcdn.eastmoney.com,0,0.00%,10,10,0.00%
jekyllrb.com,0,0.00%,2,2,0.00%
widget-v4.tidiochat.com,0,0.00%,2,2,0.00%
bat.bing.com,0,0.00%,4,4,0.00%
apd-2238e910f61afaa3600f4a1a886aec1016e99dc1782446f4.v.smtcdns.com,0,0.00%,4,4,0.00%
cloudflare-dns.com,0,0.00%,4,4,0.00%
apd-fd674f5234f262048297f0b2d59a42809f5c1e825b7db8b3.v.smtcdns.com,0,0.00%,4,4,0.00%
mhjhjt.ncvhvdd.ga,0,0.00%,1,1,0.00%
p2PStuntEST.hAplaT.NeT,0,0.00%,2,2,0.00%
www.ct.glbs.qunar.com,0,0.00%,4,4,0.00%
vata.ct.glbs.qunar.com,0,0.00%,4,4,0.00%
d2h1qfxg5j5pfv.cloudfront.net,0,0.00%,1,1,0.00%
ftp.nluug.nl,0,0.00%,4,4,0.00%
ftp.surfsara.nl,0,0.00%,4,4,0.00%
21-b1cafd52.arue.gq,0,0.00%,1,1,0.00%
x.gtld.biz,0,0.00%,2,2,0.00%
runjing-liu120.github.io,0,0.00%,1,1,0.00%
speed.se.m247.ro,0,0.00%,1,1,0.00%
rum14.perf.linkedin.com,0,0.00%,6,6,0.00%
2089405bb1ba4c54ba625f4348ece528.fp.measure.office.com,0,0.00%,2,2,0.00%
b2b-ods-img-split.bj.bcebos.com,0,0.00%,4,4,0.00%
www.wps.cn,0,0.00%,6,6,0.00%
yonada.postgresql.org,0,0.00%,3,3,0.00%
merlin.fit.vutbr.cz,0,0.00%,4,4,0.00%
mirror.as24220.net,0,0.00%,4,4,0.00%
mail1.sauer-cs.com,0,0.00%,1,1,0.00%
songmin90.github.io,0,0.00%,61,61,0.00%
gitlost-murali.github.io,0,0.00%,1,1,0.00%
nm.poepoe.ml,0,0.00%,1,1,0.00%
liuwqtech.github.io,0,0.00%,1,1,0.00%
ns-1411.awsdns-48.org,0,0.00%,4,4,0.00%
zzckano.github.io,0,0.00%,1,1,0.00%
720e86012e2a40cfa3990ca34272fc91.fp.measure.office.com,0,0.00%,2,2,0.00%
v.xiaodutv.com,0,0.00%,1,1,0.00%
cn.udacity.com,0,0.00%,1,1,0.00%
www.udacity.com,0,0.00%,1,1,0.00%
www.ted.com,0,0.00%,1,1,0.00%
www.thepaper.cn,0,0.00%,1,1,0.00%
www.cankaoxiaoxi.com,0,0.00%,1,1,0.00%
himg2.huanqiu.com,0,0.00%,1,1,0.00%
news.hao123.com,0,0.00%,1,1,0.00%
www.962.net,0,0.00%,1,1,0.00%
xyx.hao123.com,0,0.00%,1,1,0.00%
www.17173.com,0,0.00%,1,1,0.00%
www.37.com,0,0.00%,1,1,0.00%
onecs-live.azureedge.net,0,0.00%,1,1,0.00%
z6.cnzz.com,0,0.00%,5,5,0.00%
docs.influxdata.com,0,0.00%,2,2,0.00%
610-ipv4v6.clump.gallatin.aa-rt.sharepoint.cn,0,0.00%,4,4,0.00%
bhfnjd.daae.ml,0,0.00%,1,1,0.00%
yukikuri.github.io,0,0.00%,61,61,0.00%
mirror.zetup.net,0,0.00%,6,6,0.00%
mirrors.ircam.fr,0,0.00%,6,6,0.00%
mirrors.nav.ro,0,0.00%,4,4,0.00%
mirrors.neterra.net,0,0.00%,6,6,0.00%
mirrors.netix.net,0,0.00%,6,6,0.00%
moerookie.github.io,0,0.00%,1,1,0.00%
sdup.qihucdn.com,0,0.00%,2,2,0.00%
vcxzsd.ewawo.tk,0,0.00%,1,1,0.00%
ba550cc9bfc946999cdbcb766131d074.fp.measure.office.com,0,0.00%,1,1,0.00%
soldierxue.github.io,0,0.00%,1,1,0.00%
e688d56bb50b4fa3a5de75f3175658a3.fp.measure.office.com,0,0.00%,1,1,0.00%
guovv90.github.io,0,0.00%,1,1,0.00%
zmt.itc.cn,0,0.00%,1,1,0.00%
e8aeb8bbdbbd7.cdn.sohucs.com,0,0.00%,1,1,0.00%
m1.auto.itc.cn,0,0.00%,1,1,0.00%
p7.itc.cn,0,0.00%,2,2,0.00%
d1.biz.itc.cn,0,0.00%,1,1,0.00%
m3.auto.itc.cn,0,0.00%,1,1,0.00%
api.snoopi.io,0,0.00%,6,6,0.00%
e9cf7afab28e3bf730ff0d883ae98c23.nrb.footprintdns.com,0,0.00%,2,2,0.00%
d5724fb18d454ecab55e0e8d1dad9826.fp.measure.office.com,0,0.00%,1,1,0.00%
users.rust-lang.org,0,0.00%,4,4,0.00%
epicgames-privacy.my.onetrust.com,0,0.00%,4,4,0.00%
nbnetflow-reply-log.cn-wulanchabu.dualstack.log.aliyuncs.com,0,0.00%,2,2,0.00%
immersiveweb.dev,0,0.00%,4,4,0.00%
cainiao-app-logs.cn-zhangjiakou.dualstack.log.aliyuncs.com,0,0.00%,2,2,0.00%
12f8923107574588a653bf3537a37e6d.fp.measure.office.com,0,0.00%,2,2,0.00%
yaolaigang.github.io,0,0.00%,1,1,0.00%
launchpad.net,0,0.00%,2,2,0.00%
ninja-build.org,0,0.00%,4,4,0.00%
savannah.gnu.org,0,0.00%,4,4,0.00%
gcc.gnu.org,0,0.00%,4,4,0.00%
www.python.org,0,0.00%,2,2,0.00%
accounts.nvgs.nvidia.cn,0,0.00%,3,3,0.00%
smartling.github.io,0,0.00%,61,61,0.00%
jokieleung.github.io,0,0.00%,61,61,0.00%
sdkreport.acc.qq.com,0,0.00%,2,2,0.00%
gdjp009.ghabc0823.tk,0,0.00%,1,1,0.00%
unimixstudio.github.io,0,0.00%,61,61,0.00%
www.yAhoO.COm,0,0.00%,3,3,0.00%
WWw.GoOGLE.COm,0,0.00%,3,3,0.00%
hk.archive.ubuntu.com,0,0.00%,26,26,0.00%
shizhonghai.github.io,0,0.00%,1,1,0.00%
apd-fba25a63f46f54bd0a89c4c836eadf686acd87e865d3f92e.v.smtcdns.com,0,0.00%,2,2,0.00%
apd-62a030c343c6bb01d94617a586a562a4582e1e307166dac7.v.smtcdns.com,0,0.00%,2,2,0.00%
P2pStUnTEST.HApLaT.net,0,0.00%,2,2,0.00%
cgyx.ccgp.gov.cn,0,0.00%,4,4,0.00%
free.open.tracker.4.starka.st,0,0.00%,4,4,0.00%
xtvj.github.io,0,0.00%,61,61,0.00%
ww2.sinaimg.cn,0,0.00%,6,6,0.00%
sjs.sinajs.cn,0,0.00%,4,4,0.00%
p4.sinaimg.cn,0,0.00%,2,2,0.00%
portrait2.sinaimg.cn,0,0.00%,2,2,0.00%
portrait1.sinaimg.cn,0,0.00%,2,2,0.00%
portrait6.sinaimg.cn,0,0.00%,2,2,0.00%
cplusplus.com,0,0.00%,1,1,0.00%
s3.pstatp.com,0,0.00%,1,1,0.00%
s3.pstatp.com.xi.zwtianshangm.com,0,0.00%,2,2,0.00%
v3.vps315.com,0,0.00%,1,1,0.00%
meetlookup.com,0,0.00%,3,3,0.00%
apd-e5a728a6ff408136351b8652bc5b1f659cca5770f7c014b7.v.smtcdns.com,0,0.00%,2,2,0.00%
dsp-media.eskimi.com,0,0.00%,2,2,0.00%
openx2-match.dotomi.com,0,0.00%,1,1,0.00%
cdn-europe.eskimi.com,0,0.00%,1,1,0.00%
p26-sign.douyinpic.com.51296c5e.c.cdnhwc1.com,0,0.00%,1,1,0.00%
ivs.jd.com,0,0.00%,1,1,0.00%
cdn.zhuanzhi.ai,0,0.00%,1,1,0.00%
cormullion.github.io,0,0.00%,1,1,0.00%
6c3018c6bcdd4cc2b4bcb910a8b1ae29.fp.measure.office.com,0,0.00%,2,2,0.00%
app.cctv.com,0,0.00%,1,1,0.00%
front.pandisk.tk,0,0.00%,1,1,0.00%
css.mafengwo.net,0,0.00%,1,1,0.00%
n2-q.mafengwo.net,0,0.00%,1,1,0.00%
note.mafengwo.net,0,0.00%,1,1,0.00%
sales.mafengwo.net,0,0.00%,1,1,0.00%
qimg4.youxiake.com,0,0.00%,1,1,0.00%
gallery.youxiake.com,0,0.00%,1,1,0.00%
ghegus02.ghabc.tk,0,0.00%,1,1,0.00%
images.gitee.com,0,0.00%,4,4,0.00%
p2pSTuNTEst.HaPlaT.Net,0,0.00%,2,2,0.00%
lucabartolomei.github.io,0,0.00%,1,1,0.00%
game.salemthegame.com,0,0.00%,2,2,0.00%
halfsaltedfish.github.io,0,0.00%,1,1,0.00%
wweizhang.github.io,0,0.00%,61,61,0.00%
wp.indarium.com,0,0.00%,1,1,0.00%
i.mail.qq.com,0,0.00%,4,4,0.00%
i-v6.mail.qq.com,0,0.00%,2,2,0.00%
cpc.people.com.cn,0,0.00%,2,2,0.00%
matplotlib-cpp.readthedocs.io,0,0.00%,6,6,0.00%
cpsweek.org,0,0.00%,3,3,0.00%
china.cankaoxiaoxi.com,0,0.00%,2,2,0.00%
collection.sina.com.cn,0,0.00%,2,2,0.00%
ac.qq.com,0,0.00%,2,2,0.00%
alist-org.github.io,0,0.00%,1,1,0.00%
f.us.sinaimg.cn,0,0.00%,1,1,0.00%
bvoava.nb78.tk,0,0.00%,1,1,0.00%
kuiyuanzhang.github.io,0,0.00%,1,1,0.00%
keyou.github.io,0,0.00%,1,1,0.00%
longcloud.weixin.com,0,0.00%,2,2,0.00%
aeproxy.weixin.qq.com,0,0.00%,2,2,0.00%
faf22cb0136a45e3a14fce88197c4e52.fp.measure.office.com,0,0.00%,1,1,0.00%
dxb-mvp.trafficmanager.net,0,0.00%,1,1,0.00%
v6.circlepic.upqzfile.com,0,0.00%,2,2,0.00%
v6.pic.upqzfile.com,0,0.00%,2,2,0.00%
v6.circlevideo.upqzfile.com,0,0.00%,2,2,0.00%
v6.other.upqzfile.com,0,0.00%,1,1,0.00%
www.zhipin.com,0,0.00%,4,4,0.00%
t.zhipin.com,0,0.00%,4,4,0.00%
cn-udacity.github.io,0,0.00%,1,1,0.00%
na-naa77.github.io,0,0.00%,61,61,0.00%
consultoriamcn.com.br,0,0.00%,1,1,0.00%
liaokesen168.github.io,0,0.00%,1,1,0.00%
jiurikun.github.io,0,0.00%,61,61,0.00%
k.fuu3.tk,0,0.00%,2,2,0.00%
ap1-tls.agora.io,0,0.00%,4,4,0.00%
ap4-tls.agora.io,0,0.00%,4,4,0.00%
ap3-tls.agora.io,0,0.00%,6,6,0.00%
ap2-tls.agora.io,0,0.00%,8,8,0.00%
ap5-tls.agora.io,0,0.00%,4,4,0.00%
Www.GOOgLe.COm,0,0.00%,3,3,0.00%
wwW.yahOO.cOM,0,0.00%,3,3,0.00%
valid-apple.g.aaplimg.com,0,0.00%,2,2,0.00%
mirrors.coreix.net,0,0.00%,6,6,0.00%
jetrotal.github.io,0,0.00%,1,1,0.00%
krsdavis.github.io,0,0.00%,1,1,0.00%
ro2.dawei.tk,0,0.00%,2,2,0.00%
asyncial.github.io,0,0.00%,1,1,0.00%
ns-1713.awsdns-22.co.uk,0,0.00%,2,2,0.00%
wykks.github.io,0,0.00%,1,1,0.00%
829c0501386b43329e7398c78f393224.fp.measure.office.com,0,0.00%,2,2,0.00%
ck.itemlist.ml,0,0.00%,61,61,0.00%
rodobarcaaa.github.io,0,0.00%,61,61,0.00%
msantana733.github.io,0,0.00%,1,1,0.00%
openblockcc.github.io,0,0.00%,1,1,0.00%
p2pstunTest.haplaT.neT,0,0.00%,2,2,0.00%
P2pSTUNtesT.hApLAT.Net,0,0.00%,2,2,0.00%
webcompanion.com,0,0.00%,2,2,0.00%
updates.owncloud.com,0,0.00%,4,4,0.00%
ps-scholar-amis-standard.bj.bcebos.com,0,0.00%,3,3,0.00%
webshell.suite.office.com,0,0.00%,2,2,0.00%
mail.massimomendola.tk,0,0.00%,122,122,0.00%
pdus.github.io,0,0.00%,1,1,0.00%
tani.ns.cloudflare.com,0,0.00%,4,4,0.00%
noah.ns.cloudflare.com,0,0.00%,4,4,0.00%
p2psTUNTesT.haplat.Net,0,0.00%,2,2,0.00%
tgp.xn--15t.ml,0,0.00%,61,61,0.00%
website.quimabacar.tk,0,0.00%,1,1,0.00%
page.greenapi.ml,0,0.00%,1,1,0.00%
pay.qq.com,0,0.00%,2,2,0.00%
60238e79d6ef4ef78a349453108e5aaa.fp.measure.office.com,0,0.00%,2,2,0.00%
staging.criptokuz.com,0,0.00%,1,1,0.00%
a2994fe1172e47d2ad5a845140b54b02.fp.measure.office.com,0,0.00%,2,2,0.00%
maegger.github.io,0,0.00%,1,1,0.00%
fdfd.fuawlfnap.cf,0,0.00%,1,1,0.00%
d3rtzn9vw9fr7f.cloudfront.net,0,0.00%,1,1,0.00%
conceptcloset.github.io,0,0.00%,1,1,0.00%
googolplex-c.github.io,0,0.00%,2,2,0.00%
mail.free-thinker.tk,0,0.00%,1,1,0.00%
d2763msf1wgvw2.cloudfront.net,0,0.00%,1,1,0.00%
1km8kx.nb78.tk,0,0.00%,61,61,0.00%
grandbusta.github.io,0,0.00%,1,1,0.00%
download.ceph.com,0,0.00%,14,14,0.00%
aruul.github.io,0,0.00%,1,1,0.00%
xsandrc.utsumiyake.tk,0,0.00%,1,1,0.00%
zhouxingxinig.github.io,0,0.00%,1,1,0.00%
cli.github.com,0,0.00%,2,2,0.00%
ppymys.qqscml.ga,0,0.00%,1,1,0.00%
flutter.github.io,0,0.00%,1,1,0.00%
0wpjl5.nb78.tk,0,0.00%,1,1,0.00%
api.touker.com,0,0.00%,2,2,0.00%
work.weixin.qq.com,0,0.00%,2,2,0.00%
casestudy.html5.qq.com,0,0.00%,2,2,0.00%
img.blr844.com,0,0.00%,1,1,0.00%
ci.xiaohongshu.com,0,0.00%,2,2,0.00%
c0500c791a704e6b88f43a8856a5ca78.fp.measure.office.com,0,0.00%,2,2,0.00%
ssr.ms365vip.ml,0,0.00%,1,1,0.00%
zephyrl.github.io,0,0.00%,1,1,0.00%
P2pSTUnTEST.HAPlAT.Net,0,0.00%,2,2,0.00%
chienlungcheung.github.io,0,0.00%,1,1,0.00%
www263.ff-01.com,0,0.00%,1,1,0.00%
ivanzhangwb.github.io,0,0.00%,1,1,0.00%
xonecn-sh-public-resource.shziyi.com,0,0.00%,2,2,0.00%
xonecn-sh-public-auth.shziyi.com,0,0.00%,6,6,0.00%
xw.qq.com,0,0.00%,2,2,0.00%
favor.fund.eastmoney.com,0,0.00%,2,2,0.00%
wap.eastmoney.com,0,0.00%,4,4,0.00%
group.eastmoney.com,0,0.00%,1,1,0.00%
roadshow.eastmoney.com,0,0.00%,1,1,0.00%
gotox5.nbzdwss87.tk,0,0.00%,1,1,0.00%
yzpkq02.github.io,0,0.00%,1,1,0.00%
we.kandian.qq.com,0,0.00%,2,2,0.00%
quan.qq.com,0,0.00%,1,1,0.00%
mimscmp.icbc.com.cn,0,0.00%,2,2,0.00%
news.html5.qq.com,0,0.00%,2,2,0.00%
guoyl6.github.io,0,0.00%,2,2,0.00%
www.patreon.com,0,0.00%,1,1,0.00%
amd.4150123.gq,0,0.00%,2,2,0.00%
erchoc.github.io,0,0.00%,1,1,0.00%
uzh-rpg.github.io,0,0.00%,1,1,0.00%
appupdate.mail.10086.cn,0,0.00%,5,5,0.00%
f5137bb89ead42f38f1fe7029319fe06.fp.measure.office.com,0,0.00%,2,2,0.00%
de-2.molulu.tk,0,0.00%,1,1,0.00%
ermongroup.github.io,0,0.00%,61,61,0.00%
helm.cilium.io,0,0.00%,2,2,0.00%
68f9780c28b145cd974614d690110202.fp.measure.office.com,0,0.00%,2,2,0.00%
2fcc12998fbb4c2c8ad3a397bb9e8e0c.fp.measure.office.com,0,0.00%,2,2,0.00%
luoyt14.github.io,0,0.00%,1,1,0.00%
p2pStUNtEST.HApLat.net,0,0.00%,2,2,0.00%
huichuan.sm.cn,0,0.00%,1,1,0.00%
huichuan-mc.sm.cn.w.alikunlun.com,0,0.00%,1,1,0.00%
ssp-partner.alibaba.com,0,0.00%,1,1,0.00%
puds.ucweb.com,0,0.00%,1,1,0.00%
broccoli.uc.cn,0,0.00%,1,1,0.00%
order.sm.cn,0,0.00%,4,4,0.00%
puds-down.uc.cn,0,0.00%,1,1,0.00%
pdds-cdn.uc.cn,0,0.00%,1,1,0.00%
pdds-cdn.uc.cn.w.alikunlun.com,0,0.00%,3,3,0.00%
valp.atm.youku.com,0,0.00%,4,4,0.00%
cm.miaozhen.atm.youku.com,0,0.00%,4,4,0.00%
edwardvoon.github.io,0,0.00%,1,1,0.00%
a7610d4860ba4095b83738146dd0fb85.fp.measure.office.com,0,0.00%,2,2,0.00%
t4p-upd.info,0,0.00%,4,4,0.00%
forum.pianmc.tk,0,0.00%,1,1,0.00%
cms.uc.cn,0,0.00%,1,1,0.00%
dualstack-na61-na62.wagbridge.alibaba.alibaba.com.gds.alibabadns.com,0,0.00%,7,7,0.00%
pdds.ucweb.com,0,0.00%,1,1,0.00%
ea119.amdc.m.taobao.com,0,0.00%,1,1,0.00%
editor.sm.cn,0,0.00%,1,1,0.00%
sealine.youku.com,0,0.00%,1,1,0.00%
ff.uc.cn,0,0.00%,2,2,0.00%
sdk-log.partner.sm.cn,0,0.00%,1,1,0.00%
ossgw.alicdn.com.danuoyi.alicdn.com,0,0.00%,9,9,0.00%
dtmall-tel.alicdn.com,0,0.00%,1,1,0.00%
dtmall-tel.alicdn.com.danuoyi.tbcache.com,0,0.00%,2,2,0.00%
quark.sm.cn,0,0.00%,1,1,0.00%
issuecdn.baidupcs.com,0,0.00%,1,1,0.00%
issuepcdn.baidupcs.com,0,0.00%,1,1,0.00%
know.descprofcul.ga,0,0.00%,1,1,0.00%
xiaoqiumc1234.github.io,0,0.00%,1,1,0.00%
fergardi.github.io,0,0.00%,1,1,0.00%
ns-cloud-c4.googledomains.com,0,0.00%,2,2,0.00%
ns-cloud-c1.googledomains.com,0,0.00%,4,4,0.00%
7e8d16d81f094aa4a419f922602d3ff8.fp.measure.office.com,0,0.00%,2,2,0.00%
update.glados-config.com,0,0.00%,7,7,0.00%
dsiw.github.io,0,0.00%,61,61,0.00%
gabrielpict.github.io,0,0.00%,1,1,0.00%
neva-hl.github.io,0,0.00%,2,2,0.00%
h5.vip.qq.com,0,0.00%,4,4,0.00%
juizoarbitral.com.br,0,0.00%,1,1,0.00%
shadow-socks-share.herokuapp.com,0,0.00%,2,2,0.00%
ipcdn.g.aaplimg.com,0,0.00%,2,2,0.00%
ea045821816c4dd8bc7204152fe35956.fp.measure.office.com,0,0.00%,2,2,0.00%
zhuhanqing.github.io,0,0.00%,1,1,0.00%
dl-1.pddpic.com,0,0.00%,1,1,0.00%
dualstack-restsdk.amap.com,0,0.00%,6,6,0.00%
login.wx.qq.com,0,0.00%,2,2,0.00%
www.bidding.csg.cn,0,0.00%,2,2,0.00%
qiye.163.com,0,0.00%,6,6,0.00%
mail.yeah.net,0,0.00%,4,4,0.00%
r3---sn-i3belney.gvt1.com,0,0.00%,2,2,0.00%
p2pSTUnTest.HaPlaT.nET,0,0.00%,2,2,0.00%
P2psTUNTesT.HapLAt.neT,0,0.00%,2,2,0.00%
timebutt.github.io,0,0.00%,1,1,0.00%
a5a42b4014364baeb24d7cb8a78d74d4.fp.measure.office.com,0,0.00%,2,2,0.00%
mirrorlist.repoforge.org,0,0.00%,2,2,0.00%
w.gamecenter.qq.com,0,0.00%,1,1,0.00%
static.redhat.com,0,0.00%,3,3,0.00%
ns-660.awsdns-18.net,0,0.00%,2,2,0.00%
home.dedejoker.tk,0,0.00%,122,122,0.00%
secure-social.axatp.com,0,0.00%,1,1,0.00%
chexian.axa.cn,0,0.00%,2,2,0.00%
shp.qpic.cn,0,0.00%,2,2,0.00%
m.zhibo8.cc,0,0.00%,6,6,0.00%
chat.qiumibao.com,0,0.00%,2,2,0.00%
p2psTunTEsT.haPLAT.NEt,0,0.00%,2,2,0.00%
download.jitsi.org,0,0.00%,2,2,0.00%
packages.prosody.im,0,0.00%,2,2,0.00%
gallery.heapslol.com,0,0.00%,1,1,0.00%
zdss.51ideal.com,0,0.00%,2,2,0.00%
analysis.51job.com,0,0.00%,2,2,0.00%
lhy0609.github.io,0,0.00%,1,1,0.00%
api.iliya.cf,0,0.00%,1,1,0.00%
wotcheats.github.io,0,0.00%,1,1,0.00%
shahrukhatik.github.io,0,0.00%,61,61,0.00%
zhi804.github.io,0,0.00%,1,1,0.00%
binary-option-trade.pranislor.tk,0,0.00%,1,1,0.00%
wheat.fggfcgf.ga,0,0.00%,1,1,0.00%
ea193d47272b4903a646225029b56c4f.fp.measure.office.com,0,0.00%,1,1,0.00%
zhong0316.github.io,0,0.00%,1,1,0.00%
s-avi18.avcdn.net,0,0.00%,1,1,0.00%
apd-7a4ede2fdf478c646dcf6514481f0d779db32f4591c4cf7b.v.smtcdns.com,0,0.00%,2,2,0.00%
a782bc983b286312a0d341c072df76dc.clo.footprintdns.com,0,0.00%,2,2,0.00%
utahsuicideprevention.org,0,0.00%,1,1,0.00%
liveonutah.org,0,0.00%,1,1,0.00%
imap.139.com,0,0.00%,2,2,0.00%
a1-178.akam.net,0,0.00%,2,2,0.00%
upengs.github.io,0,0.00%,1,1,0.00%
83689762b02e4d9ba66153de359da122.fp.measure.office.com,0,0.00%,1,1,0.00%
drive.berfeumumusdeo.ml,0,0.00%,61,61,0.00%
fall.dingmalsversio.cf,0,0.00%,1,1,0.00%
81fd1f7997f74b98b0af0ebed1c3efc1.fp.measure.office.com,0,0.00%,1,1,0.00%
p2pstuNTESt.hAPlat.nEt,0,0.00%,2,2,0.00%
P2PsTuNtEST.hAplAt.NeT,0,0.00%,2,2,0.00%
syn6-fzjtzwlcolrk3wva4py4pd6rn4eqan2aiqb5pymaqrgl775xnetq.firefoxxp-yang.direct.quickconnect.to,0,0.00%,2,2,0.00%
syn6-s6ylnbwtrsvwk2jgmcapute6zi72aaaaaaaaaaaaqrgl775xnetq.firefoxxp-yang.direct.quickconnect.to,0,0.00%,2,2,0.00%
www.kraxel.org,0,0.00%,4,4,0.00%
d2w6u17ngtanmy.cloudfront.net,0,0.00%,1,1,0.00%
gkmw.github.io,0,0.00%,1,1,0.00%
cdn.voso.ml,0,0.00%,2,2,0.00%
tipwheal.github.io,0,0.00%,1,1,0.00%
kawhii.github.io,0,0.00%,1,1,0.00%
Www.GoOgLe.cOm,0,0.00%,1,1,0.00%
WwW.YAHOO.com,0,0.00%,1,1,0.00%
krisyu.github.io,0,0.00%,1,1,0.00%
apd-9deb7310d59ec174d32017e7eee6ee24c617030e7ff08a45.v.smtcdns.com,0,0.00%,2,2,0.00%
apd-0c5bdf9d5b55e0a9a962b8917bbc78801391149f7a108610.v.smtcdns.com,0,0.00%,2,2,0.00%
audiopay.ali.xmcdn.com,0,0.00%,4,4,0.00%
security-tracker.debian.org,0,0.00%,2,2,0.00%
d2yo8j06pbycj9.cloudfront.net,0,0.00%,1,1,0.00%
ca3e86ca1eb042038f92684932905443.fp.measure.office.com,0,0.00%,1,1,0.00%
today-syair.github.io,0,0.00%,2,2,0.00%
privacyportal.onetrust.com,0,0.00%,2,2,0.00%
v2sync.share4nothing.cf,0,0.00%,1,1,0.00%
ns-1295.awsdns-33.org,0,0.00%,1,1,0.00%
jeromecyang.github.io,0,0.00%,61,61,0.00%
work.clouds.archive.ubuntu.com,0,0.00%,4,4,0.00%
cc409f6b13e1465b8e743d1c94b5b909.fp.measure.office.com,0,0.00%,2,2,0.00%
simg1.qunarzz.com,0,0.00%,2,2,0.00%
vata.qunar.com,0,0.00%,2,2,0.00%
fmgw.qunar.com,0,0.00%,6,6,0.00%
fmgw.ct.glbs.qunar.com,0,0.00%,2,2,0.00%
ww1.sinaimg.cn,0,0.00%,3,3,0.00%
z4.cnzz.com,0,0.00%,4,4,0.00%
p54-ckdevice.icloud.com,0,0.00%,2,2,0.00%
mwerbo2.github.io,0,0.00%,1,1,0.00%
6f7f3f00a30d48188e84347b1389880d.fp.measure.office.com,0,0.00%,1,1,0.00%
assets.calendly.com,0,0.00%,1,1,0.00%
so.m.sm.cn,0,0.00%,1,1,0.00%
spread.sm.cn,0,0.00%,1,1,0.00%
image.uczzd.cn,0,0.00%,1,1,0.00%
learning.quark.cn,0,0.00%,2,2,0.00%
china.qianlong.com,0,0.00%,1,1,0.00%
epaper.southcn.com,0,0.00%,2,2,0.00%
xj.news.cn,0,0.00%,1,1,0.00%
www.mendeley.com,0,0.00%,4,4,0.00%
dualstack.python.map.fastly.net,0,0.00%,4,4,0.00%
ds.zhaopin.cn,0,0.00%,2,2,0.00%
tjc-download.ftn.qq.com,0,0.00%,2,2,0.00%
map.qq.com,0,0.00%,2,2,0.00%
ins-mt8gifrl.ias.tencent-cloud.net,0,0.00%,2,2,0.00%
www1613.ff-04.com,0,0.00%,1,1,0.00%
mengzelev.github.io,0,0.00%,1,1,0.00%
ugg.weishi.qq.com,0,0.00%,2,2,0.00%
apm-and.zhipin.com,0,0.00%,4,4,0.00%
2bb3ea7b630d02d73d1b78cc36ab71d8040199cce97f5fc6.dlied1.cdntips.net,0,0.00%,3,3,0.00%
P2pSTUntEst.hAPLat.net,0,0.00%,1,1,0.00%
Www.vOd.lxDns.COM,0,0.00%,1,1,0.00%
ins-jqlgclnv.ias.tencent-cloud.net,0,0.00%,1,1,0.00%
friend.gc.apple.com,0,0.00%,1,1,0.00%
friend.gc-apple.com.akadns.net,0,0.00%,1,1,0.00%
friend.gc.fe.apple-dns.net,0,0.00%,2,2,0.00%
statics-teams-cdn-office-net.s-0005.s-msedge.net,0,0.00%,1,1,0.00%
vthumb.ykimg.com.danuoyi.tbcache.com,0,0.00%,2,2,0.00%
img.thehour.cn.m.alikunlun.com,0,0.00%,4,4,0.00%
s8.qhimg.com.webcdn.360qhcdn.com,0,0.00%,2,2,0.00%
s3.ssl.qhimg.com.webcdn.360qhcdn.com,0,0.00%,2,2,0.00%
s2.qhimg.com.webcdn.360qhcdn.com,0,0.00%,2,2,0.00%
s4.ssl.qhimg.com.webcdn.360qhcdn.com,0,0.00%,2,2,0.00%
p3.ssl.qhimg.com.webcdn.360qhcdn.com,0,0.00%,2,2,0.00%
p25-ckdatabase.icloud.com,0,0.00%,1,1,0.00%
ckdatabase.fe.apple-dns.net,0,0.00%,4,4,0.00%
a-9999.a-dc-msedge.net,0,0.00%,2,2,0.00%
teams-9999.teams-msedge.net,0,0.00%,4,4,0.00%
www.cnii.com.cn,0,0.00%,2,2,0.00%
ws.ksmobile.net,0,0.00%,2,2,0.00%
hcl.baidu.com,0,0.00%,4,4,0.00%
tips.qunar.com,0,0.00%,8,8,0.00%
qreport.qunar.com,0,0.00%,12,12,0.00%
user.qunar.com,0,0.00%,10,10,0.00%
piccolofe.qunar.com,0,0.00%,8,8,0.00%
osa02r3a.msedge.net,0,0.00%,1,1,0.00%
17mdkfq.fowce.gq,0,0.00%,1,1,0.00%
resize-v3.pubpub.org,0,0.00%,1,1,0.00%
assets.pubpub.org,0,0.00%,1,1,0.00%
amd-infra.itunes.apple.com.akamaized.net,0,0.00%,2,2,0.00%
a1911.dscg2.akamai.net,0,0.00%,2,2,0.00%
9to5science.com,0,0.00%,1,1,0.00%
flashpointproject.github.io,0,0.00%,1,1,0.00%
ds6yc8t7pnx74.cloudfront.net,0,0.00%,1,1,0.00%
pba0.apple.com,0,0.00%,2,2,0.00%
pba0.lb-apple.com.akadns.net,0,0.00%,2,2,0.00%
pba0.g.aaplimg.com,0,0.00%,2,2,0.00%
lf3-reading.fqnovelpic.com,0,0.00%,1,1,0.00%
ins-5tsp1vmk.ias.tencent-cloud.net,0,0.00%,8,8,0.00%
eyvgfixh.sched.d0-dk.tdnsdp1.cn,0,0.00%,2,2,0.00%
cdn.meeting.tencent.com.dsa.dnsv1.com,0,0.00%,1,1,0.00%
meeting-75420.gzc.vod.tencent-cloud.com,0,0.00%,2,2,0.00%
miniapp-package-zcache.taobao.com,0,0.00%,1,1,0.00%
poplayer.template.alibaba.com,0,0.00%,2,2,0.00%
poplayer.template.alibaba.com.w.cdngslb.com,0,0.00%,2,2,0.00%
mini-app-packages-cdn.taobao.com,0,0.00%,1,1,0.00%
mini-app-packages-cdn.taobao.com.w.alikunlun.com,0,0.00%,2,2,0.00%
webmails.suports.shop,0,0.00%,1,1,0.00%
cs1404.wpc.epsiloncdn.net,0,0.00%,2,2,0.00%
regmedia.co.uk,0,0.00%,2,2,0.00%
shenzhen.chinatax.gov.cn,0,0.00%,2,2,0.00%
zfwzgl.www.gov.cn,0,0.00%,7,7,0.00%
apd-ea64ef186ac33bb5b088cda9a2ded4c2fbb865d5a4bee9f6.v.smtcdns.com,0,0.00%,1,1,0.00%
stnd-ipsg.crsi.norton.com,0,0.00%,1,1,0.00%
a.gtld.biz,0,0.00%,1,1,0.00%
y.gtld.biz,0,0.00%,2,2,0.00%
w.gtld.biz,0,0.00%,1,1,0.00%
b79229e7861b4fa6abd1d5c840fe9601.fp.measure.office.com,0,0.00%,2,2,0.00%
d26sj91vejbrfr.cloudfront.net,0,0.00%,1,1,0.00%
arm1.zhxiha.tk,0,0.00%,1,1,0.00%
fobohuang.github.io,0,0.00%,1,1,0.00%
zjk-dualstack.trans.dingtalk.com,0,0.00%,2,2,0.00%
lippi-space-zjk.cn-zhangjiakou-dualstack.oss.aliyuncs.com.gds.alibabadns.com,0,0.00%,2,2,0.00%
huiyiftf.dejwhiuuige-uk.ml,0,0.00%,1,1,0.00%
d120zhibhjkfx2.cloudfront.net,0,0.00%,1,1,0.00%
app1.sellslippers55.ml,0,0.00%,1,1,0.00%
58fef318a31a4c668a0642eb2866dc22.fp.measure.office.com,0,0.00%,1,1,0.00%
reign.appmeasurements.com,0,0.00%,2,2,0.00%
2cb24175571578bd69f983f33c01dbf5.safeframe.googlesyndication.com,0,0.00%,1,1,0.00%
v-2a384bf8.71edge.com,0,0.00%,2,2,0.00%
notability.com,0,0.00%,2,2,0.00%
umini.shujupie.com,0,0.00%,2,2,0.00%
e370b0f5cd994d94a4efc2ba14012381.fp.measure.office.com,0,0.00%,2,2,0.00%
wghpic-70080.picnjc.qpic.cn,0,0.00%,2,2,0.00%
retrace.fedoraproject.org,0,0.00%,1,1,0.00%
verify.cmpassport.com,0,0.00%,2,2,0.00%
ins-d94v3bvj.ias.tencent-cloud.net,0,0.00%,2,2,0.00%
0kolf6.qqscml.ml,0,0.00%,1,1,0.00%
ns-1364.awsdns-42.org,0,0.00%,4,4,0.00%
74387d903a5b4f49aa0cdf23aa8c66d6.fp.measure.office.com,0,0.00%,1,1,0.00%
zhehaocao.zhehaocao.github.io,0,0.00%,1,1,0.00%
ptlogin2.qq.com,0,0.00%,2,2,0.00%
r.sg.sec.miui.com,0,0.00%,4,4,0.00%
extranet-alllines-ipv6-pub-c3-c4.alb.xiaomi.com,0,0.00%,2,2,0.00%
dyna.wikimedia.org,0,0.00%,2,2,0.00%
ins-12bpxaxe.ias.tencent-cloud.net,0,0.00%,2,2,0.00%
9d498d1255bf40129831779b9e44aab0.fp.measure.office.com,0,0.00%,2,2,0.00%
fp-vs-nocache.ec.azureedge.net,0,0.00%,2,2,0.00%
fa54b2b6c980f1a318b15b2163aded15.clo.footprintdns.com,0,0.00%,2,2,0.00%
jst.gslb.sinaedge.com,0,0.00%,2,2,0.00%
b2l0j.xyz,0,0.00%,2,2,0.00%
awaken.amap.com,0,0.00%,4,4,0.00%
awaken.amap.com.gds.alibabadns.com,0,0.00%,2,2,0.00%
b4d2544e3b374884b8dea9d4b4e8719a.fp.measure.office.com,0,0.00%,2,2,0.00%
jenkins.bdew.net,0,0.00%,1,1,0.00%
d8acl9.qqscml.ga,0,0.00%,1,1,0.00%
colinjbrown.github.io,0,0.00%,1,1,0.00%
yiazzz.github.io,0,0.00%,1,1,0.00%
p2pStUNtest.hAPLat.neT,0,0.00%,2,2,0.00%
algate.github.io,0,0.00%,1,1,0.00%
api-and.zhipin.com,0,0.00%,2,2,0.00%
logapi-and.zhipin.com,0,0.00%,2,2,0.00%
api-ipv6.zhipin.com,0,0.00%,2,2,0.00%
viyasavpn.github.io,0,0.00%,1,1,0.00%
lf3-cj-cdn-tos.bytegecko.com,0,0.00%,2,2,0.00%
r5---sn-un57enez.gvt1.com,0,0.00%,1,1,0.00%
fvrlvf.nb78.tk,0,0.00%,61,61,0.00%
vodapp.duoduocdn.com,0,0.00%,4,4,0.00%
filters.adtidy.org,0,0.00%,2,2,0.00%
grading-system.flowzstaging.tk,0,0.00%,61,61,0.00%
mhermoso.github.io,0,0.00%,2,2,0.00%
alexandreben.github.io,0,0.00%,61,61,0.00%
P2psTuntEst.haPLaT.NET,0,0.00%,2,2,0.00%
r3---sn-q0cedn7s.gvt1.com,0,0.00%,1,1,0.00%
www.herokucdn.com,0,0.00%,1,1,0.00%
r1---sn-i3belney.gvt1.com,0,0.00%,2,2,0.00%
r5---sn-un57enel.gvt1.com,0,0.00%,4,4,0.00%
r1---sn-oguelney.gvt1.com,0,0.00%,1,1,0.00%
r5---sn-i3belnl7.gvt1.com,0,0.00%,2,2,0.00%
r2---sn-cvhelnll.gvt1.com,0,0.00%,1,1,0.00%
r1---sn-3u-bh2le.gvt1.com,0,0.00%,2,2,0.00%
r5---sn-oguesndl.gvt1.com,0,0.00%,2,2,0.00%
r2---sn-ntqe6n7r.gvt1.com,0,0.00%,2,2,0.00%
r5---sn-aigl6nzs.gvt1.com,0,0.00%,2,2,0.00%
r3---sn-npoe7nsr.gvt1.com,0,0.00%,2,2,0.00%
r6---sn-3pm7snes.gvt1.com,0,0.00%,2,2,0.00%
r1---sn-cvh76ney.gvt1.com,0,0.00%,2,2,0.00%
r2---sn-i3b7knzs.gvt1.com,0,0.00%,1,1,0.00%
r5---sn-t0a7ln7d.gvt1.com,0,0.00%,2,2,0.00%
r4---sn-4g5e6nsy.gvt1.com,0,0.00%,1,1,0.00%
r5---sn-i3bssn7e.gvt1.com,0,0.00%,1,1,0.00%
r3---sn-3pm7dne6.gvt1.com,0,0.00%,2,2,0.00%
r3---sn-oguelnsy.gvt1.com,0,0.00%,2,2,0.00%
ambiesoft.github.io,0,0.00%,1,1,0.00%
v2net.github.io,0,0.00%,1,1,0.00%
d3r2vf296ohq8.cloudfront.net,0,0.00%,1,1,0.00%
vss.g2fly.tk,0,0.00%,1,1,0.00%
xu3352.github.io,0,0.00%,1,1,0.00%
db52300b00f14557bba439f7cbe706b4.fp.measure.office.com,0,0.00%,2,2,0.00%
taryn2016.github.io,0,0.00%,1,1,0.00%
mimalef70.github.io,0,0.00%,1,1,0.00%
payapp.weixin.qq.com,0,0.00%,1,1,0.00%
bootstrapmade.com,0,0.00%,2,2,0.00%
hhh.haxxah.gq,0,0.00%,1,1,0.00%
pomax.github.io,0,0.00%,61,61,0.00%
60ca.ffolpflf.ga,0,0.00%,1,1,0.00%
sbs.kunden.loewenstark.de,0,0.00%,1,1,0.00%
origin-tier2.steampipe.steamcontent.com,0,0.00%,2,2,0.00%
steampipe-origin-tier2.steamcontent.com,0,0.00%,1,1,0.00%
togel-master-minggu.github.io,0,0.00%,1,1,0.00%
unmc.bj.bcebos.com,0,0.00%,2,2,0.00%
doh.opendns.com,0,0.00%,5,5,0.00%
viator42.github.io,0,0.00%,1,1,0.00%
ns1.jjj.domains,0,0.00%,1,1,0.00%
r5---sn-5hne6nz6.gvt1.com,0,0.00%,1,1,0.00%
d3djrgixsbqrbv.cloudfront.net,0,0.00%,1,1,0.00%
z0.sinaimg.cn,0,0.00%,2,2,0.00%
qt.y.qq.com,0,0.00%,2,2,0.00%
repo.steampowered.com,0,0.00%,2,2,0.00%
jp.tiar.app,0,0.00%,1,1,0.00%
r4---sn-un57enez.gvt1.com,0,0.00%,2,2,0.00%
rebraws.github.io,0,0.00%,1,1,0.00%
exchange01.hsa.com.ar,0,0.00%,1,1,0.00%
rdelivery.qq.com,0,0.00%,2,2,0.00%
page-acc.video.qq.com,0,0.00%,2,2,0.00%
v6-accvideo.wns.qq.com,0,0.00%,2,2,0.00%
a.video.qq.com,0,0.00%,1,1,0.00%
ilive.qq.com,0,0.00%,2,2,0.00%
ugd.gtimg.com,0,0.00%,1,1,0.00%
infozb6.video.qq.com,0,0.00%,2,2,0.00%
vv6.video.qq.com,0,0.00%,2,2,0.00%
bkinfozb6.video.qq.com,0,0.00%,1,1,0.00%
fmft.github.io,0,0.00%,1,1,0.00%
quanzhanke.github.io,0,0.00%,1,1,0.00%
cchroot.github.io,0,0.00%,1,1,0.00%
mc.yandex.ru,0,0.00%,1,1,0.00%
p2PSTUNTest.HaPLat.NeT,0,0.00%,2,2,0.00%
bigairport.icu,0,0.00%,1,1,0.00%
r3---sn-oguesndz.gvt1.com,0,0.00%,2,2,0.00%
r3---sn-i3b7knlk.gvt1.com,0,0.00%,2,2,0.00%
dtn44hfc1xtr4.cloudfront.net,0,0.00%,1,1,0.00%
cmp.osano.com,0,0.00%,1,1,0.00%
image.3001.net,0,0.00%,2,2,0.00%
profile.xboxlive.com,0,0.00%,2,2,0.00%
afdxtest.z01.azurefd.net,0,0.00%,4,4,0.00%
timnon.github.io,0,0.00%,1,1,0.00%
a2.org.afilias-nst.info,0,0.00%,1,1,0.00%
desktop-qualityclient-sub.osp.opera.software,0,0.00%,4,4,0.00%
pct-upd.info,0,0.00%,2,2,0.00%
fwupdate.asuswrt-merlin.net,0,0.00%,2,2,0.00%
dcgzvssgtatam.cloudfront.net,0,0.00%,1,1,0.00%
kali.download,0,0.00%,1,1,0.00%
b04431fde9ec4f4d930e6b8af4ce0f97.fp.measure.office.com,0,0.00%,1,1,0.00%
d2cn40jarzxub5.cloudfront.net,0,0.00%,1,1,0.00%
majsoul-hk-client.cn-hongkong.log.aliyuncs.com,0,0.00%,2,2,0.00%
www.v2fly.org,0,0.00%,1,1,0.00%
i.waimai.meituan.com,0,0.00%,2,2,0.00%
api.v2fly.org,0,0.00%,1,1,0.00%
s0.meituan.net,0,0.00%,1,1,0.00%
w.meituan.net,0,0.00%,1,1,0.00%
1865269.sched.skalego-dk.tdnsstic1.cn.cjt.vwnti.yrzhcloud.cn,0,0.00%,2,2,0.00%
plx.meituan.com,0,0.00%,2,2,0.00%
ihotel.meituan.com,0,0.00%,1,1,0.00%
market.waimai.meituan.com,0,0.00%,1,1,0.00%
i.meituan.com,0,0.00%,1,1,0.00%
passport.meituan.com,0,0.00%,1,1,0.00%
maf.meituan.com,0,0.00%,1,1,0.00%
uem.migu.cn,0,0.00%,2,2,0.00%
musoucrow.github.io,0,0.00%,1,1,0.00%
omnipay-omnicash.github.io,0,0.00%,1,1,0.00%
sg1.zzz.cat,0,0.00%,1,1,0.00%
bfe483ae85804cc38dd29cbd7fb20c6f.fp.measure.office.com,0,0.00%,2,2,0.00%
11.tlu.dl.delivery.mp.microsoft.com,0,0.00%,2,2,0.00%
d10lpgp6xz60nq.cloudfront.net,0,0.00%,1,1,0.00%
godbobo.github.io,0,0.00%,1,1,0.00%
security.uc.cn,0,0.00%,1,1,0.00%
play.sportsteam333.com,0,0.00%,2,2,0.00%
static.addtoany.com,0,0.00%,1,1,0.00%
da757f8cc5d94d7da7a10e2f4c29968a.pacloudflare.com,0,0.00%,2,2,0.00%
icanhazip.com,0,0.00%,2,2,0.00%
mcat.lu.com,0,0.00%,13,13,0.00%
ma.lu.com,0,0.00%,12,12,0.00%
maps4html.github.io,0,0.00%,61,61,0.00%
qxlife.github.io,0,0.00%,1,1,0.00%
982aabcb194349e4a38655c4055e7737.fp.measure.office.com,0,0.00%,2,2,0.00%
fi.dot.dns.snopyta.org,0,0.00%,1,1,0.00%
415fc80dabe942118d45c920d1b2d5e5.fp.measure.office.com,0,0.00%,2,2,0.00%
ytianzhao.github.io,0,0.00%,1,1,0.00%
cs21.wpc.v0cdn.net,0,0.00%,6,6,0.00%
v1.socketproep.com,0,0.00%,2,2,0.00%
m.lu.com,0,0.00%,8,8,0.00%
rsb2.pingan.com.cn,0,0.00%,2,2,0.00%
tilomitra.github.io,0,0.00%,1,1,0.00%
1eb46c531e5542dea256d1a11f641c78.fp.measure.office.com,0,0.00%,2,2,0.00%
s.bbluray.ml,0,0.00%,1,1,0.00%
p2PstUNteST.haPLat.neT,0,0.00%,2,2,0.00%
repo1.coderoot.ml,0,0.00%,122,122,0.00%
licheetools.github.io,0,0.00%,61,61,0.00%
img-hxy021.didistatic.com,0,0.00%,1,1,0.00%
img-hxy021.didistatic.com.download.ks-cdn.com,0,0.00%,2,2,0.00%
k112.gslb.ksyuncdn.com,0,0.00%,2,2,0.00%
mjs.gslb.sinaedge.com,0,0.00%,4,4,0.00%
18a61f12f06b43b5960070b536ac8362.fp.measure.office.com,0,0.00%,1,1,0.00%
file.wx2.qq.com,0,0.00%,1,1,0.00%
kzx.yilanvaas.cn,0,0.00%,1,1,0.00%
push.m.youku.com,0,0.00%,4,4,0.00%
secgw-ipv6-aserver-heyi.m.taobao.com,0,0.00%,4,4,0.00%
secgw-ipv6-aserver-heyi.m.taobao.com.gds.alibabadns.com,0,0.00%,6,6,0.00%
abtest.alibaba.com.gds.alibabadns.com,0,0.00%,2,2,0.00%
report.imtt.qq.com,0,0.00%,2,2,0.00%
tax.51fapiao.cn,0,0.00%,2,2,0.00%
sghtt.readvi.cf,0,0.00%,1,1,0.00%
odinvzc.azureedge.net,0,0.00%,2,2,0.00%
isabelladamla.github.io,0,0.00%,1,1,0.00%
updateleak.qihucdn.com.qh-cdn.com,0,0.00%,2,2,0.00%
www.anaconda.com,0,0.00%,6,6,0.00%
15e17f9b1754493b9424f0c2b436ecfc.fp.measure.office.com,0,0.00%,2,2,0.00%
www.cac.gov.cn,0,0.00%,3,3,0.00%
chrstnb.github.io,0,0.00%,1,1,0.00%
ysf.nosdn.127.net,0,0.00%,1,1,0.00%
fsmobile.ali.kugou.com,0,0.00%,3,3,0.00%
pkg-containers.githubusercontent.com,0,0.00%,6,6,0.00%
webpush.wx2.qq.com,0,0.00%,2,2,0.00%
skypeecs-prod-edge-b.trafficmanager.net,0,0.00%,2,2,0.00%
mp.weixinbridge.com,0,0.00%,2,2,0.00%
5c75a.mkmkli.ml,0,0.00%,1,1,0.00%
obito-segu.github.io,0,0.00%,1,1,0.00%
Www.GOOgLe.COM,0,0.00%,1,1,0.00%
WWw.yAHoO.com,0,0.00%,1,1,0.00%
boucker.github.io,0,0.00%,1,1,0.00%
yubangzheng.github.io,0,0.00%,1,1,0.00%
dockerauth.cn-hangzhou.aliyuncs.com,0,0.00%,4,4,0.00%
im.dingtalk.com.gds.alibabadns.com,0,0.00%,2,2,0.00%
v6-cname.dingtalk.com,0,0.00%,2,2,0.00%
v6-cname.dingtalk.com.gds.alibabadns.com,0,0.00%,2,2,0.00%
premiumdataapi.eastmoney.com,0,0.00%,2,2,0.00%
emdcapi.securities.eastmoney.com.w.cdngslb.com,0,0.00%,2,2,0.00%
zzz686970.github.io,0,0.00%,61,61,0.00%
get.pxhere.com,0,0.00%,2,2,0.00%
psg3-word-view.officeapps.live.com,0,0.00%,2,2,0.00%
clients.browser.qq.com,0,0.00%,2,2,0.00%
workroom.fastfamiliar.com,0,0.00%,1,1,0.00%
375956133.github.io,0,0.00%,1,1,0.00%
wikipedia.org,0,0.00%,4,4,0.00%
s3b.pstatp.com,0,0.00%,2,2,0.00%
r.browser.miui.com,0,0.00%,2,2,0.00%
s3b.pstatp.com.w.kunlungr.com,0,0.00%,2,2,0.00%
www.bizographics.com,0,0.00%,4,4,0.00%
sj.admin.cas.cn,0,0.00%,2,2,0.00%
adminsj.cas.cn,0,0.00%,2,2,0.00%
carpentries-incubator.github.io,0,0.00%,61,61,0.00%
hhbbz.github.io,0,0.00%,1,1,0.00%
kr.archive.ubuntu.com,0,0.00%,2,2,0.00%
wangpeng-developer.github.io,0,0.00%,1,1,0.00%
bom-mvp.trafficmanager.net,0,0.00%,2,2,0.00%
WWw.gOoGlE.Com,0,0.00%,3,3,0.00%
WWw.yaHoo.coM,0,0.00%,3,3,0.00%
bangrreview.github.io,0,0.00%,1,1,0.00%
WwW.gOOgLe.com,0,0.00%,3,3,0.00%
Www.yAhoo.COM,0,0.00%,3,3,0.00%
rst.sc.gov.cn,0,0.00%,2,2,0.00%
counter.any.run,0,0.00%,2,2,0.00%
www.scilit.net,0,0.00%,1,1,0.00%
sciprofiles.com,0,0.00%,1,1,0.00%
sciforum.net,0,0.00%,1,1,0.00%
journalsadvisor.com,0,0.00%,1,1,0.00%
analyticalgraphicsinc.github.io,0,0.00%,1,1,0.00%
l.facebook.com,0,0.00%,2,2,0.00%
q6g2v9i6.stackpathcdn.com,0,0.00%,1,1,0.00%
wp.jpg701.ml,0,0.00%,1,1,0.00%
zilianliuxue.github.io,0,0.00%,1,1,0.00%
reguluz.github.io,0,0.00%,1,1,0.00%
ed284dd5e9fb4d77a03321169011b2ee.fp.measure.office.com,0,0.00%,1,1,0.00%
eu.freshpops.net,0,0.00%,1,1,0.00%
ricepurity.github.io,0,0.00%,1,1,0.00%
xiuxin-666.github.io,0,0.00%,1,1,0.00%
torlock.proxyit.ml,0,0.00%,61,61,0.00%
yanxiaoyu.github.io,0,0.00%,1,1,0.00%
akashravichandran.github.io,0,0.00%,1,1,0.00%
iina.io,0,0.00%,2,2,0.00%
scce.ucas.ac.cn,0,0.00%,4,4,0.00%
c-bing-com.a-0001.a-msedge.net,0,0.00%,6,6,0.00%
img.cyol.com.wswebpic.com,0,0.00%,2,2,0.00%
ins-qwjeqs72.ias.tencent-cloud.net,0,0.00%,2,2,0.00%
kaev2.wpsdns.com,0,0.00%,2,2,0.00%
m.cyol.com,0,0.00%,2,2,0.00%
m.cyol.com.wswebpic.com,0,0.00%,2,2,0.00%
img.cyol.com,0,0.00%,2,2,0.00%
js.cyol.com.wswebpic.com,0,0.00%,1,1,0.00%
halo-components.cdn-go.cn,0,0.00%,2,2,0.00%
en.mail.qq.com,0,0.00%,1,1,0.00%
ins-ojz90ij2.ias.tencent-cloud.net,0,0.00%,1,1,0.00%
restest.mail.tc.qq.com,0,0.00%,1,1,0.00%
rescdn.qqmail.com.sched.legopic1-dk.tdnsv6.com,0,0.00%,1,1,0.00%
mauth.chinanetcenter.com,0,0.00%,2,2,0.00%
gma.alicdn.com,0,0.00%,1,1,0.00%
medinet.rocketnine.space,0,0.00%,1,1,0.00%
pe.terjon.es,0,0.00%,61,61,0.00%
bhrutledge.github.io,0,0.00%,1,1,0.00%
xingwenzhang.github.io,0,0.00%,1,1,0.00%
ns2.ena.com,0,0.00%,4,4,0.00%
api-overmind.youdao.com,0,0.00%,2,2,0.00%
6d95a250aa8e42df8704a18790856cac.fp.measure.office.com,0,0.00%,8,8,0.00%
p2PstuNtest.HAPLat.NET,0,0.00%,2,2,0.00%
awaken233.github.io,0,0.00%,1,1,0.00%
fixie.github.io,0,0.00%,1,1,0.00%
vanhiupun.github.io,0,0.00%,1,1,0.00%
collect.mopinion.com,0,0.00%,1,1,0.00%
fp-afd-nocache.azureedge.net,0,0.00%,7,7,0.00%
p2psTUnTEsT.HaPlaT.Net,0,0.00%,2,2,0.00%
magical857.github.io,0,0.00%,1,1,0.00%
888.luzhihao08.ga,0,0.00%,1,1,0.00%
blog.torproject.org,0,0.00%,3,3,0.00%
33f51aa3f4cf4718bc9ad43f6287b428.fp.measure.office.com,0,0.00%,1,1,0.00%
qn-download-v4v6.ctdns.cn,0,0.00%,3,3,0.00%
prebid-stag.setupad.net,0,0.00%,1,1,0.00%
api.14pikpak.cf,0,0.00%,122,122,0.00%
us02.roylzx23.xyz,0,0.00%,1,1,0.00%
click.endnote.com,0,0.00%,2,2,0.00%
s6tu.com,0,0.00%,2,2,0.00%
images.unsplash.com,0,0.00%,1,1,0.00%
cdn3.mndsrv.com,0,0.00%,1,1,0.00%
xqdoc.imedao.com,0,0.00%,1,1,0.00%
r5---sn-30a7ynek.c.youtube.com,0,0.00%,1,1,0.00%
3166d22788b64f00ab392ac675299919.fp.measure.office.com,0,0.00%,2,2,0.00%
binaryoptiontrade.datetio.gq,0,0.00%,2,2,0.00%
7bf635b32a2b4dc4ab90cb55af3d3b1d.fp.measure.office.com,0,0.00%,1,1,0.00%
hct.textwom.cf,0,0.00%,1,1,0.00%
fengzhihao123.github.io,0,0.00%,1,1,0.00%
cdn.bootcdn.net,0,0.00%,1,1,0.00%
casale-match.dotomi.com,0,0.00%,2,2,0.00%
hk.eastmoney.com,0,0.00%,2,2,0.00%
fsvippc.ali.kugou.com,0,0.00%,2,2,0.00%
williamyaps.github.io,0,0.00%,1,1,0.00%
wwW.gOOglE.coM,0,0.00%,3,3,0.00%
WwW.YahOO.COm,0,0.00%,3,3,0.00%
renzhn.github.io,0,0.00%,1,1,0.00%
xishansnow.github.io,0,0.00%,1,1,0.00%
ant.hyysapi.com,0,0.00%,2,2,0.00%
rjnx.github.io,0,0.00%,1,1,0.00%
codingandliving.github.io,0,0.00%,1,1,0.00%
prlz77.github.io,0,0.00%,1,1,0.00%
www.cq.gov.cn,0,0.00%,6,6,0.00%
zwykb.cq.gov.cn,0,0.00%,2,2,0.00%
ggfw.rlsbj.cq.gov.cn,0,0.00%,4,4,0.00%
www.mfa.gov.cn.wswebpic.com,0,0.00%,6,6,0.00%
www.most.gov.cn,0,0.00%,6,6,0.00%
f12692e13eedebb5.cname.365cyd.cn,0,0.00%,4,4,0.00%
d40dac83244cce3f.cname.365cyd.cn,0,0.00%,4,4,0.00%
c04d9a6c18a75906.qaxcloudwaf.com,0,0.00%,4,4,0.00%
www.mwr.gov.cn,0,0.00%,4,4,0.00%
www.mofcom.gov.cn.wswebcdn.com,0,0.00%,4,4,0.00%
8b5acd0b352d6794.icloudwaf.com,0,0.00%,4,4,0.00%
1c7c823fec3c8fe6.vip.jiasule.org,0,0.00%,6,6,0.00%
www.mem.gov.cn.wswebpic.com,0,0.00%,6,6,0.00%
bff48095604a493c.qaxanyuv6.com,0,0.00%,4,4,0.00%
a45ca037923a741f.qaxcloudwaf.com,0,0.00%,6,6,0.00%
www.caea.gov.cn,0,0.00%,2,2,0.00%
b56e8d53ceb0ac5b.cdn.jiashule.com,0,0.00%,4,4,0.00%
23c693c079a30bf1.cdn.jiashule.com,0,0.00%,4,4,0.00%
www.chinatax.gov.cn.wswebcdn.com,0,0.00%,6,6,0.00%
062493db1b0f999e.vip.jiasule.org,0,0.00%,4,4,0.00%
www.nrta.gov.cn.wsssec.com,0,0.00%,4,4,0.00%
www.sport.gov.cn.cdn20.com,0,0.00%,4,4,0.00%
ce5c4cf757a9a3e1.cname.365cyd.cn,0,0.00%,4,4,0.00%
0417861b351234d9.qaxcloudwaf.com,0,0.00%,4,4,0.00%
d0b39c937db1d9e8.qaxcloudwaf.com,0,0.00%,4,4,0.00%
www.shanxi.gov.cn,0,0.00%,2,2,0.00%
www.ln.gov.cn,0,0.00%,4,4,0.00%
3f84049c68b5289d.qaxcloudwaf.com,0,0.00%,4,4,0.00%
451e4e8b7e80208a.qaxcloudwaf.com,0,0.00%,4,4,0.00%
hlj-gov-cn.cname.saaswaf.com,0,0.00%,4,4,0.00%
www.shanghai.gov.cn,0,0.00%,2,2,0.00%
817b85f24b69fdf8.vip.jiasule.org,0,0.00%,6,6,0.00%
www.zj.gov.cn.v6lvs.com,0,0.00%,4,4,0.00%
www.fujian.gov.cn,0,0.00%,4,4,0.00%
www.jiangxi.gov.cn,0,0.00%,2,2,0.00%
sdgov.cache.dbappwaf.cn,0,0.00%,4,4,0.00%
www.henan.gov.cn.cdn30.com,0,0.00%,4,4,0.00%
jyhpt00.llb.chutianyun.gov.cn,0,0.00%,4,4,0.00%
www.hunan.gov.cn,0,0.00%,4,4,0.00%
www.gd.gov.cn,0,0.00%,4,4,0.00%
www.gxzf.gov.cn,0,0.00%,4,4,0.00%
www.hainan.gov.cn,0,0.00%,2,2,0.00%
www.sc.gov.cn,0,0.00%,6,6,0.00%
www.guizhou.gov.cn,0,0.00%,6,6,0.00%
www.yn.gov.cn,0,0.00%,4,4,0.00%
wuxiangwei.github.io,0,0.00%,1,1,0.00%
bucx.github.io,0,0.00%,61,61,0.00%
joxit.github.io,0,0.00%,1,1,0.00%
yhaing.github.io,0,0.00%,1,1,0.00%
P2PStuNteSt.HaplAt.NeT,0,0.00%,2,2,0.00%
591572340a16401399dbae816ce04bd0.fp.measure.office.com,0,0.00%,2,2,0.00%
guomuyun.github.io,0,0.00%,1,1,0.00%
www.rank-tennis.com,0,0.00%,1,1,0.00%
1fw4seq.daae.ml,0,0.00%,1,1,0.00%
upload.wikimedia.org,0,0.00%,2,2,0.00%
v27-cold1.douyinvod.com,0,0.00%,1,1,0.00%
v27-cold1.douyinvod.com.vod.galileo.jcloud-cdn.com,0,0.00%,1,1,0.00%
1688living.alicdn.com,0,0.00%,2,2,0.00%
trade.jd.com,0,0.00%,2,2,0.00%
jdqd.jd.com,0,0.00%,3,3,0.00%
mybank.landbank.com.tw,0,0.00%,1,1,0.00%
xkx1ga8a2k.fowce.gq,0,0.00%,1,1,0.00%
d1flfk77wl2xk4.cloudfront.net,0,0.00%,61,61,0.00%
mon3-misc-lq.fqnovel.com.w.cdngslb.com,0,0.00%,1,1,0.00%
loggw.alipay.com,0,0.00%,2,2,0.00%
video.qq.com,0,0.00%,2,2,0.00%
filespan.kccpdt.ml,0,0.00%,2,2,0.00%
ns-596.awsdns-10.net,0,0.00%,2,2,0.00%
3adf22471f6d43a7bdf59ca2c5481285.fp.measure.office.com,0,0.00%,8,8,0.00%
9fa9949c08694ab09aea34fae3e3e323.fp.measure.office.com,0,0.00%,1,1,0.00%
test.pitom.gq,0,0.00%,1,1,0.00%
s7.music.126.net.163jiasu.com,0,0.00%,2,2,0.00%
imgt.gslb.sinaedge.com,0,0.00%,2,2,0.00%
file.dingtalk.com,0,0.00%,1,1,0.00%
sub.payday2.cf,0,0.00%,1,1,0.00%
cc4.freeid.gq,0,0.00%,1,1,0.00%
vnjvki.nb78.tk,0,0.00%,1,1,0.00%
hcdnd.zjv6.ipv6.c.cdnhwc2.com,0,0.00%,1,1,0.00%
d23oi7qckwqt8o.cloudfront.net,0,0.00%,1,1,0.00%
long.delicacy752.ml,0,0.00%,1,1,0.00%
cacerts.digitalcertvalidation.com,0,0.00%,2,2,0.00%
gimg.bitauto.com,0,0.00%,2,2,0.00%
gimg.bitauto.com.download.ks-cdn.com,0,0.00%,1,1,0.00%
mitadmissions.org,0,0.00%,2,2,0.00%
sci-hubtw.hkvisa.net,0,0.00%,2,2,0.00%
sh.connipv6.qq.com,0,0.00%,2,2,0.00%
sh2.connipv6.qq.com,0,0.00%,2,2,0.00%
tj2.connipv6.qq.com,0,0.00%,2,2,0.00%
sz2.connipv6.qq.com,0,0.00%,2,2,0.00%
sz.connipv6.qq.com,0,0.00%,2,2,0.00%
connipv6.tencent.com,0,0.00%,2,2,0.00%
tj.connipv6.qq.com,0,0.00%,2,2,0.00%
p6-tt.byteimg.com,0,0.00%,2,2,0.00%
aolc.github.io,0,0.00%,61,61,0.00%
daupydqaqerlh.cloudfront.net,0,0.00%,1,1,0.00%
repo.jellyfin.org,0,0.00%,2,2,0.00%
elb1.jellyfin.org,0,0.00%,2,2,0.00%
d1tdp7z6w94jbb.cloudfront.net,0,0.00%,1,1,0.00%
cfgpassport2.eastmoney.com,0,0.00%,2,2,0.00%
gubatopic.eastmoney.com,0,0.00%,2,2,0.00%
passport2.eastmoney.com,0,0.00%,2,2,0.00%
v2.eastmoney.com,0,0.00%,2,2,0.00%
www.eastmoneyfutures.com,0,0.00%,1,1,0.00%
corp.eastmoney.com,0,0.00%,2,2,0.00%
about.eastmoney.com,0,0.00%,2,2,0.00%
www.dfcfw.com,0,0.00%,1,1,0.00%
zhaopin.eastmoney.com,0,0.00%,2,2,0.00%
np-metadata.eastmoney.com,0,0.00%,2,2,0.00%
www.amazon.co.jp,0,0.00%,2,2,0.00%
api.bitwarden.com,0,0.00%,2,2,0.00%
www.alipay.com,0,0.00%,2,2,0.00%
unitradeadapter.alipay.com,0,0.00%,2,2,0.00%
app.alipay.com,0,0.00%,2,2,0.00%
cashier.alipay.com,0,0.00%,2,2,0.00%
financeprod.alipay.com,0,0.00%,2,2,0.00%
my.alipay.com,0,0.00%,2,2,0.00%
shenghuo.alipay.com,0,0.00%,2,2,0.00%
www.bjb.cas.cn,0,0.00%,2,2,0.00%
hqs2.cnzz.com,0,0.00%,2,2,0.00%
sync.tidaltv.com,0,0.00%,2,2,0.00%
discovery.verysync.cn,0,0.00%,1,1,0.00%
2535b3af5a8f87c587fee54c4f369c98.nrb.footprintdns.com,0,0.00%,2,2,0.00%
9258f60d44405386fbd0098ab2bce39d.clo.footprintdns.com,0,0.00%,2,2,0.00%
phx10prdapp02-canary-opaph.netmon.azure.com,0,0.00%,2,2,0.00%
phx10prdapp02-canary-opaph.westus3.cloudapp.azure.com,0,0.00%,2,2,0.00%
imaphm.qiye.163.com,0,0.00%,2,2,0.00%
imaphz.qiye.163.com,0,0.00%,2,2,0.00%
imapc6hz.qiye.ntes53.netease.com,0,0.00%,2,2,0.00%
frameworks.jetbrains.com,0,0.00%,1,1,0.00%
js1.t.sinajs.cn,0,0.00%,2,2,0.00%
js2.t.sinajs.cn,0,0.00%,2,2,0.00%
tp1.sinaimg.cn,0,0.00%,2,2,0.00%
tp2.sinaimg.cn,0,0.00%,2,2,0.00%
tp3.sinaimg.cn,0,0.00%,2,2,0.00%
tp4.sinaimg.cn,0,0.00%,2,2,0.00%
ww3.sinaimg.cn,0,0.00%,2,2,0.00%
ww4.sinaimg.cn,0,0.00%,2,2,0.00%
dmd-fifajs-h5-ikuweb-hb.youku.com,0,0.00%,12,12,0.00%
download.ccgp.gov.cn,0,0.00%,1,1,0.00%
cgjh.ccgp.gov.cn,0,0.00%,1,1,0.00%
pub.ccgp.gov.cn,0,0.00%,1,1,0.00%
www.ccgp-beijing.gov.cn,0,0.00%,1,1,0.00%
www.ccgp-chongqing.gov.cn,0,0.00%,1,1,0.00%
www.ccgp-dalian.gov.cn,0,0.00%,2,2,0.00%
www.ccgp-tianjin.gov.cn,0,0.00%,1,1,0.00%
www.ccgp-anhui.gov.cn,0,0.00%,2,2,0.00%
xygh.ccgp.gov.cn,0,0.00%,1,1,0.00%
www.ccgp-gansu.gov.cn,0,0.00%,1,1,0.00%
www.ccgp-hebei.gov.cn,0,0.00%,1,1,0.00%
www.ccgp-jilin.gov.cn,0,0.00%,1,1,0.00%
www.ccgp-neimenggu.gov.cn,0,0.00%,2,2,0.00%
flv0.bn.netease.com,0,0.00%,1,1,0.00%
as.weixin.qq.com,0,0.00%,1,1,0.00%
pc.us.sinaimg.cn,0,0.00%,1,1,0.00%
mini.eastday.com,0,0.00%,1,1,0.00%
ttpcssp.dftoutiao.com,0,0.00%,1,1,0.00%
jczy.ccgp.gov.cn,0,0.00%,1,1,0.00%
c.l.qq.com,0,0.00%,2,2,0.00%
k-ring-fallback.msedge.net,0,0.00%,2,2,0.00%
17c3525ea373e7dcd755c44614cab498.clo.footprintdns.com,0,0.00%,2,2,0.00%
ap.dongqiudi.com,0,0.00%,3,3,0.00%
voc.dongqiudi.com,0,0.00%,1,1,0.00%
detail.dongqiudi.com,0,0.00%,3,3,0.00%
qv2ray.net,0,0.00%,4,4,0.00%
71af3c49ed2440e0aab9aaa2c992dd6a.fp.measure.office.com,0,0.00%,1,1,0.00%
asanzdiego.github.io,0,0.00%,1,1,0.00%
lana.ns.cloudflare.com,0,0.00%,2,2,0.00%
jim.ns.cloudflare.com,0,0.00%,2,2,0.00%
lara.ns.cloudflare.com,0,0.00%,2,2,0.00%
rudy.ns.cloudflare.com,0,0.00%,2,2,0.00%
ccl.dns.ripn.net,0,0.00%,2,2,0.00%
bcl.dns.ripn.net,0,0.00%,2,2,0.00%
naawyd.qqscml.ga,0,0.00%,1,1,0.00%
d26uz55awpmifc.cloudfront.net,0,0.00%,61,61,0.00%
joece.github.io,0,0.00%,1,1,0.00%
renxingkai.github.io,0,0.00%,1,1,0.00%
r3---sn-oguesnd7.gvt1.com,0,0.00%,2,2,0.00%
r2---sn-ipoxu-umbk.gvt1.com,0,0.00%,2,2,0.00%
dd.meituan.com,0,0.00%,3,3,0.00%
ei.cnzz.com,0,0.00%,2,2,0.00%
m5.amap.com,0,0.00%,2,2,0.00%
h5vv6.video.qq.com,0,0.00%,2,2,0.00%
apd-c0fd26b95ca3f3222f770fbca83c50800a5b70880ef92862.v.smtcdns.com,0,0.00%,2,2,0.00%
apd-8f8bba57dcca71ea8e90a59daa369c7839fac6954d705114.v.smtcdns.com,0,0.00%,2,2,0.00%
apd-6ba5b5c582904da8672b6c73b36c2693fafaee1c9d585abf.v.smtcdns.com,0,0.00%,2,2,0.00%
c-team.gallerycdn.vsassets.io,0,0.00%,1,1,0.00%
ruguodangshi.github.io,0,0.00%,1,1,0.00%
forderud.github.io,0,0.00%,2,2,0.00%
P2psTUNTest.HaPLAt.net,0,0.00%,2,2,0.00%
forum.railwayz.info,0,0.00%,61,61,0.00%
trint-it.github.io,0,0.00%,1,1,0.00%
photovideo.photo.qq.com,0,0.00%,1,1,0.00%
bigballon.github.io,0,0.00%,1,1,0.00%
word-view.officeapps.live.com.b-0016.b-dc-msedge.net,0,0.00%,2,2,0.00%
cgi.kandian.qq.com,0,0.00%,2,2,0.00%
api-pan.xunlei.com,0,0.00%,1,1,0.00%
kadmimage.biz.weibo.com,0,0.00%,2,2,0.00%
p53-calendars.icloud.com,0,0.00%,1,1,0.00%
u1.img.mobile.sina.cn,0,0.00%,1,1,0.00%
263c32d3a46b7cf19d480589887f3614.clo.footprintdns.com,0,0.00%,2,2,0.00%
cmg.ouc.edu.cn,0,0.00%,2,2,0.00%
shopapi.io.mi.com,0,0.00%,2,2,0.00%
api.m.mi.com,0,0.00%,1,1,0.00%
nj.jszwfw.gov.cn,0,0.00%,1,1,0.00%
wuxicredit.wuxi.gov.cn,0,0.00%,2,2,0.00%
www.creditjx.gov.cn,0,0.00%,2,2,0.00%
pubmatic-match.dotomi.com,0,0.00%,4,4,0.00%
par20prdapp01-canary.netmon.azure.com,0,0.00%,2,2,0.00%
a.qiumibao.com,0,0.00%,2,2,0.00%
ping.qiumibao.com,0,0.00%,2,2,0.00%
rouhuasuan.cn,0,0.00%,2,2,0.00%
cn-sxty2-cmcc-bcache-08.bilivideo.com,0,0.00%,1,1,0.00%
chenmaoqing.github.io,0,0.00%,1,1,0.00%
dj.csz666.ml,0,0.00%,1,1,0.00%
meowyih.github.io,0,0.00%,1,1,0.00%
r3---sn-cvh7kn6l.gvt1.com,0,0.00%,1,1,0.00%
mu1.sinaimg.cn,0,0.00%,2,2,0.00%
shitu-query-bj.bj.bcebos.com,0,0.00%,2,2,0.00%
dtsedge.com,0,0.00%,2,2,0.00%
imgg.hxgxfcc.cn,0,0.00%,3,3,0.00%
uuribao.net,0,0.00%,2,2,0.00%
uuribao.uxscdn.com,0,0.00%,2,2,0.00%
tring.clo.footprintdns.com,0,0.00%,2,2,0.00%
b5360e2d825d4a05939e86c6686deaef.fp.measure.office.com,0,0.00%,2,2,0.00%
v29sns.daae.ml,0,0.00%,1,1,0.00%
vvjpt53n0x.yuicc.ga,0,0.00%,1,1,0.00%
qcc107.github.io,0,0.00%,61,61,0.00%
kay21s.github.io,0,0.00%,1,1,0.00%
v-2a384408.71edge.com,0,0.00%,8,8,0.00%
v-7a8dc840.71edge.com,0,0.00%,3,3,0.00%
v-7a8dc830.71edge.com,0,0.00%,6,6,0.00%
imgstat.baidu.com,0,0.00%,3,3,0.00%
incine.ru,0,0.00%,2,2,0.00%
hongbojiang2004.github.io,0,0.00%,1,1,0.00%
api.weather365.net,0,0.00%,1,1,0.00%
a20-64.akam.net,0,0.00%,2,2,0.00%
a1-134.akam.net,0,0.00%,2,2,0.00%
b0b19a1bef274cd69ee3086c3b984587.fp.measure.office.com,0,0.00%,1,1,0.00%
ian.ns.cloudflare.com,0,0.00%,2,2,0.00%
pam.ns.cloudflare.com,0,0.00%,2,2,0.00%
a1-81.akam.net,0,0.00%,2,2,0.00%
a3-66.akam.net,0,0.00%,2,2,0.00%
a9-64.akam.net,0,0.00%,2,2,0.00%
tmapp.qq.com,0,0.00%,2,2,0.00%
imweblog.qq.com,0,0.00%,2,2,0.00%
usc-isi-i2.github.io,0,0.00%,1,1,0.00%
verb.unlonikamesli.tk,0,0.00%,61,61,0.00%
nmh6y7-kiki.mortk.tk,0,0.00%,1,1,0.00%
a.vpimg3.com,0,0.00%,2,2,0.00%
a.vpimg4.com,0,0.00%,2,2,0.00%
wechslertravel.github.io,0,0.00%,1,1,0.00%
45aee149396e491fabc5d2e37b57d332.fp.measure.office.com,0,0.00%,2,2,0.00%
i1.rgstatic.net,0,0.00%,4,4,0.00%
c5.rgstatic.net,0,0.00%,4,4,0.00%
hs-7637559.f.hubspotemail.net,0,0.00%,2,2,0.00%
cwwbh04.na1.hubspotlinks.com,0,0.00%,2,2,0.00%
eventtracking.hubapi.com,0,0.00%,4,4,0.00%
d2jv2tgh0eu86r.cloudfront.net,0,0.00%,1,1,0.00%
porsche.safemail.gq,0,0.00%,1,1,0.00%
twg.elonbot.cf,0,0.00%,1,1,0.00%
kpolsen.github.io,0,0.00%,1,1,0.00%
faxu.github.io,0,0.00%,1,1,0.00%
upd-pct.info,0,0.00%,2,2,0.00%
erodner.github.io,0,0.00%,1,1,0.00%
sumihui.github.io,0,0.00%,61,61,0.00%
hideuvpn.github.io,0,0.00%,3,3,0.00%
derwh.github.io,0,0.00%,1,1,0.00%
oclc-research.github.io,0,0.00%,1,1,0.00%
lemon-412.github.io,0,0.00%,2,2,0.00%
post.picturedata.org,0,0.00%,2,2,0.00%
apps.api.ke.com,0,0.00%,2,2,0.00%
app-monitor.ele.me,0,0.00%,2,2,0.00%
www.iina.io,0,0.00%,2,2,0.00%
dev.fair4host.de,0,0.00%,2,2,0.00%
ns1-69.akam.net,0,0.00%,4,4,0.00%
ns1-111.akam.net,0,0.00%,4,4,0.00%
p2psTunTESt.haplaT.Net,0,0.00%,2,2,0.00%
oorpow.github.io,0,0.00%,2,2,0.00%
center-city.snowmaid.com,0,0.00%,1,1,0.00%
vnmheq.qqscml.ga,0,0.00%,2,2,0.00%
landh.seurl.ml,0,0.00%,1,1,0.00%
22-uhanp491.daae.ga,0,0.00%,1,1,0.00%
alaya2heroku.alaya.tk,0,0.00%,61,61,0.00%
cjinfdu.github.io,0,0.00%,1,1,0.00%
answer518.github.io,0,0.00%,1,1,0.00%
P2PSTunTEsT.hAplAT.net,0,0.00%,2,2,0.00%
woniu201.github.io,0,0.00%,1,1,0.00%
r3---sn-ipoxu-umbr.gvt1.com,0,0.00%,2,2,0.00%
04.sendcdn.com,0,0.00%,122,122,0.00%
apt.postgresql.org,0,0.00%,1,1,0.00%
analytics.tiktok.com,0,0.00%,1,1,0.00%
mini.eastday.com.cdn20.com,0,0.00%,2,2,0.00%
s3m6.nzwgs.com.webcdn.360qhcdn.com,0,0.00%,2,2,0.00%
wangzz.github.io,0,0.00%,1,1,0.00%
jacraig.github.io,0,0.00%,1,1,0.00%
designsku.github.io,0,0.00%,61,61,0.00%
r2---sn-un57sn7y.gvt1.com,0,0.00%,2,2,0.00%
rr4---sn-npoe7n76.googlevideo.com,0,0.00%,10,10,0.00%
binary-option-trade.anintphon.tk,0,0.00%,61,61,0.00%
r1---sn-i3belnl6.gvt1.com,0,0.00%,2,2,0.00%
r1---sn-4jpm0n-nwje.gvt1.com,0,0.00%,2,2,0.00%
r4---sn-n4v7snls.gvt1.com,0,0.00%,2,2,0.00%
p3-tt-video-sprite-sign.byteimg.com,0,0.00%,2,2,0.00%
desktop-download.mendeley.com,0,0.00%,2,2,0.00%
rattlesnakey.github.io,0,0.00%,1,1,0.00%
markjenny.github.io,0,0.00%,1,1,0.00%
4qqgymtv.fast-github.ml,0,0.00%,1,1,0.00%
r5---sn-cvh76nle.gvt1.com,0,0.00%,1,1,0.00%
r3---sn-npoe7nsd.gvt1.com,0,0.00%,2,2,0.00%
s.safe.360.cn.qh-cdn.com,0,0.00%,2,2,0.00%
community.dynv6.com,0,0.00%,1,1,0.00%
coturn1.skred.mobi,0,0.00%,1,1,0.00%
node7.rbcar.ga,0,0.00%,61,61,0.00%
6pv.16818time.cf,0,0.00%,61,61,0.00%
apd-87f04626de85528c63434275d837509a4bab6dd742817d9e.v.smtcdns.com,0,0.00%,1,1,0.00%
apd-35ddcf00738a4c748d911a6519f7c737016e83642a0a1f59.v.smtcdns.com,0,0.00%,1,1,0.00%
apd-93de4b554f24376abba30c64e1c8fe585db7f00a4194fcb9.v.smtcdns.com,0,0.00%,1,1,0.00%
apd-d426c81af6b8d455e529ecfdff27082cb337d15b4be9849e.v.smtcdns.com,0,0.00%,2,2,0.00%
apd-c3a5bd200916c9ce45673f2bce7063ee4c6b6f3d50a9b13c.v.smtcdns.com,0,0.00%,2,2,0.00%
trouter2-azsc-jpea-0-b.trouter.teams.microsoft.com,0,0.00%,2,2,0.00%
dba9ytko5p72r.cloudfront.net,0,0.00%,1,1,0.00%
gzacshow.kugou.com,0,0.00%,2,2,0.00%
d1fl2ex0qrqjwz.cloudfront.net,0,0.00%,1,1,0.00%
apd-7876055b97eeb8cfc0c7341dfe436ff9fa45eb555140ce09.v.smtcdns.com,0,0.00%,2,2,0.00%
apd-a4b2eac8b6cdd3ceea1039d10c011c95c617030e7ff08a45.v.smtcdns.com,0,0.00%,2,2,0.00%
apd-29f09498348d1574328160aad9b15ce7ac58839c35f8314f.v.smtcdns.com,0,0.00%,2,2,0.00%
apd-c93553c4973ec33741b1e744268a455c759d9da5c50ef47e.v.smtcdns.com,0,0.00%,1,1,0.00%
1257092357.github.io,0,0.00%,1,1,0.00%
apd-099aedd713b72aea6babae8d561da31b653b1f8ac2b832dd.v.smtcdns.com,0,0.00%,2,2,0.00%
1fe5e9d1663e49c58bac2007ce1e9876.fp.measure.office.com,0,0.00%,2,2,0.00%
skin.laypeslighterre.tk,0,0.00%,1,1,0.00%
9b2a8c81406f4cb3b7e91756db8be85b.fp.measure.office.com,0,0.00%,1,1,0.00%
rasa.github.io,0,0.00%,1,1,0.00%
ttg.ap-south-1.linodeobjects.com,0,0.00%,1,1,0.00%
anka.if.qidian.com,0,0.00%,4,4,0.00%
blog.drays.tk,0,0.00%,1,1,0.00%
iframe.videodelivery.net,0,0.00%,2,2,0.00%
puui.mid.tdnsv6.com,0,0.00%,1,1,0.00%
puui.qpic.cn.sched.legopic1-dk.tdnsv6.com,0,0.00%,1,1,0.00%
pnewsapp.tc.qq.com,0,0.00%,1,1,0.00%
inews.gtimg.mid.tdnsv6.com,0,0.00%,1,1,0.00%
inews.gtimg.com.sched.legopic2-dk.tdnsv6.com,0,0.00%,1,1,0.00%
downv6.qq.com.mid.dcloudstc.com,0,0.00%,1,1,0.00%
downv6.qq.com.legodlied1-dk.sched.dcloudstc.com,0,0.00%,1,1,0.00%
a1830.dscg2.akamai.net.0.1.cn.akamaitech.net,0,0.00%,1,1,0.00%
map-mobile-static.cdn.bcebos.com.a.bdydns.com,0,0.00%,1,1,0.00%
webmap1.bdimg.com.a.bdydns.com,0,0.00%,1,1,0.00%
webmap0.bdimg.com.a.bdydns.com,0,0.00%,1,1,0.00%
m.media-amazon.com,0,0.00%,1,1,0.00%
poi-pic.cdn.bcebos.com.a.bdydns.com,0,0.00%,1,1,0.00%
epass.icbc.com.cn,0,0.00%,2,2,0.00%
member.icbc.com.cn,0,0.00%,2,2,0.00%
pageviewp.icbc.com.cn,0,0.00%,2,2,0.00%
m.thepaper.cn,0,0.00%,2,2,0.00%
file.thepaper.cn,0,0.00%,2,2,0.00%
imagepphcloud.thepaper.cn,0,0.00%,2,2,0.00%
touch.train.qunar.com,0,0.00%,2,2,0.00%
warm.znbsa.ga,0,0.00%,1,1,0.00%
ns-cloud-c3.googledomains.com,0,0.00%,2,2,0.00%
ns-cloud-c2.googledomains.com,0,0.00%,2,2,0.00%
ns-cloud-b1.googledomains.com,0,0.00%,2,2,0.00%
ns-cloud-b3.googledomains.com,0,0.00%,2,2,0.00%
thebackoffice.github.io,0,0.00%,1,1,0.00%
www.GOOGLe.com,0,0.00%,3,3,0.00%
wWw.yaHoO.cOm,0,0.00%,3,3,0.00%
bt.beatrice-raws.org,0,0.00%,2,2,0.00%
f0edadfb838e4c83b865974c43aa5e56.fp.measure.office.com,0,0.00%,1,1,0.00%
account.aliyun.com.gds.alibabadns.com,0,0.00%,1,1,0.00%
d.alicdn.com.w.cdngslb.com,0,0.00%,1,1,0.00%
one-console-adns-double-center.console.aliyun.com,0,0.00%,1,1,0.00%
one-console-adns-double-center.console.aliyun.com.gds.alibabadns.com,0,0.00%,1,1,0.00%
yundunnext-adns.console.aliyun.com,0,0.00%,1,1,0.00%
nas.console.aliyun.com,0,0.00%,1,1,0.00%
one-console-adns-new.console.aliyun.com,0,0.00%,1,1,0.00%
tyjr-v6-cn-zhangjiakou.aliyun.com,0,0.00%,1,1,0.00%
yundunnext.console.aliyun.com,0,0.00%,1,1,0.00%
ram.console.aliyun.com,0,0.00%,1,1,0.00%
connectedpapershpa.afd.azureedge.net,0,0.00%,1,1,0.00%
developer.apple.com,0,0.00%,1,1,0.00%
acvs.console.aliyun.com,0,0.00%,1,1,0.00%
swas.console.aliyun.com,0,0.00%,1,1,0.00%
computenest.console.aliyun.com,0,0.00%,1,1,0.00%
cr.console.aliyun.com,0,0.00%,1,1,0.00%
eais.console.aliyun.com,0,0.00%,1,1,0.00%
perico.damai.cn.w.kunlunle.com,0,0.00%,1,1,0.00%
ipassport.damai.cn,0,0.00%,2,2,0.00%
agcrc0.qqscml.ml,0,0.00%,1,1,0.00%
cpanel.alarm.wifi-secureaccess.org,0,0.00%,1,1,0.00%
ns-1537.awsdns-00.co.uk,0,0.00%,4,4,0.00%
lightsideapps.github.io,0,0.00%,61,61,0.00%
vsstartpagenewsfeed.azureedge.net,0,0.00%,2,2,0.00%
www.xizang.gov.cn,0,0.00%,4,4,0.00%
api.wordtune.com,0,0.00%,2,2,0.00%
index.docker.io,0,0.00%,1,1,0.00%
d19drxlmdpc1ad.cloudfront.net,0,0.00%,61,61,0.00%
P2PStuNteST.HaPLAt.NET,0,0.00%,2,2,0.00%
mx.cms.tv,0,0.00%,1,1,0.00%
fdfs.xmcdn.com,0,0.00%,2,2,0.00%
www456.ff-01.com,0,0.00%,1,1,0.00%
www.dazu.gov.cn,0,0.00%,2,2,0.00%
www.cqstl.gov.cn,0,0.00%,1,1,0.00%
www.bishan.gov.cn,0,0.00%,1,1,0.00%
www.cqfd.gov.cn,0,0.00%,1,1,0.00%
www.gansu.gov.cn,0,0.00%,2,2,0.00%
www.qinghai.gov.cn,0,0.00%,2,2,0.00%
www.nx.gov.cn.iname.damddos.com,0,0.00%,2,2,0.00%
www.xinjiang.gov.cn,0,0.00%,2,2,0.00%
www.gov.hk,0,0.00%,2,2,0.00%
6170933b4ac2d0d9.qaxcloudwaf.com,0,0.00%,2,2,0.00%
jw.cq.gov.cn,0,0.00%,2,2,0.00%
fzggw.cq.gov.cn,0,0.00%,2,2,0.00%
kjj.cq.gov.cn,0,0.00%,2,2,0.00%
mzzjw.cq.gov.cn,0,0.00%,2,2,0.00%
gaj.cq.gov.cn,0,0.00%,2,2,0.00%
sfj.cq.gov.cn,0,0.00%,2,2,0.00%
mzj.cq.gov.cn,0,0.00%,2,2,0.00%
czj.cq.gov.cn,0,0.00%,2,2,0.00%
ghzrzyj.cq.gov.cn,0,0.00%,2,2,0.00%
zfcxjw.cq.gov.cn,0,0.00%,2,2,0.00%
sthjj.cq.gov.cn,0,0.00%,2,2,0.00%
jtj.cq.gov.cn,0,0.00%,2,2,0.00%
cgj.cq.gov.cn,0,0.00%,2,2,0.00%
slj.cq.gov.cn,0,0.00%,2,2,0.00%
nyncw.cq.gov.cn,0,0.00%,2,2,0.00%
sww.cq.gov.cn,0,0.00%,2,2,0.00%
whlyw.cq.gov.cn,0,0.00%,2,2,0.00%
jkq.cq.gov.cn,0,0.00%,2,2,0.00%
wsjkw.cq.gov.cn,0,0.00%,2,2,0.00%
yjj.cq.gov.cn,0,0.00%,2,2,0.00%
sjj.cq.gov.cn,0,0.00%,2,2,0.00%
zfwb.cq.gov.cn,0,0.00%,2,2,0.00%
scjgj.cq.gov.cn,0,0.00%,2,2,0.00%
gzw.cq.gov.cn,0,0.00%,2,2,0.00%
tjj.cq.gov.cn,0,0.00%,2,2,0.00%
tyj.cq.gov.cn,0,0.00%,2,2,0.00%
jgswj.cq.gov.cn,0,0.00%,2,2,0.00%
jrjgj.cq.gov.cn,0,0.00%,2,2,0.00%
xfb.cq.gov.cn,0,0.00%,2,2,0.00%
ggzyjyjgj.cq.gov.cn,0,0.00%,2,2,0.00%
rmfkb.cq.gov.cn,0,0.00%,2,2,0.00%
lyj.cq.gov.cn,0,0.00%,2,2,0.00%
yaojianju.cq.gov.cn,0,0.00%,2,2,0.00%
zscqj.cq.gov.cn,0,0.00%,2,2,0.00%
ws.cq.gov.cn,0,0.00%,2,2,0.00%
ljxq.cq.gov.cn,0,0.00%,2,2,0.00%
gxq.cq.gov.cn,0,0.00%,2,2,0.00%
gxhzs.cq.gov.cn,0,0.00%,1,1,0.00%
www.qianjiang.gov.cn,0,0.00%,1,1,0.00%
www.cqyz.gov.cn,0,0.00%,2,2,0.00%
www.fl.gov.cn,0,0.00%,1,1,0.00%
www.ddk.gov.cn,0,0.00%,1,1,0.00%
www.cqjb.gov.cn,0,0.00%,1,1,0.00%
www.cqjlp.gov.cn,0,0.00%,1,1,0.00%
cqspb.gov.cn,0,0.00%,2,2,0.00%
nbviewer.jupyter.org,0,0.00%,1,1,0.00%
docs.python.org,0,0.00%,2,2,0.00%
docs.sympy.org,0,0.00%,1,1,0.00%
ipython.org,0,0.00%,1,1,0.00%
matplotlib.org,0,0.00%,2,2,0.00%
pandas.pydata.org,0,0.00%,2,2,0.00%
oracle.ukyo00103.tk,0,0.00%,1,1,0.00%
albert.ns.cloudflare.com,0,0.00%,2,2,0.00%
kara.ns.cloudflare.com,0,0.00%,2,2,0.00%
p2psTuNtEST.HAplAT.NeT,0,0.00%,2,2,0.00%
c.huanbeiloan.com,0,0.00%,1,1,0.00%
ns1.totabuan.tk,0,0.00%,1,1,0.00%
ayameyao.github.io,0,0.00%,1,1,0.00%
tc8aod.nb78.tk,0,0.00%,1,1,0.00%
www.iis.se,0,0.00%,1,1,0.00%
internetstiftelsen.se,0,0.00%,1,1,0.00%
d.stream47741shout.gq,0,0.00%,1,1,0.00%
ranger.github.io,0,0.00%,1,1,0.00%
beta.xyz123.cf,0,0.00%,61,61,0.00%
hanqiu92.github.io,0,0.00%,1,1,0.00%
