domain,num_aaaa_fail,rate_all,num_aaaa_all,num_aaaa_success,rate_aaaa_fail
hub5p.sandai.net,11404,6.33%,11404,0,100.00%
www.baidu.com,7732,4.29%,14708,6976,52.57%
www.chinauos.com,6957,3.86%,6957,0,100.00%
asimov.vortex.data.trafficmanager.net,6027,3.34%,6027,0,100.00%
downloads.yoctoproject.org,4085,2.27%,4085,0,100.00%
note.youdao.com,3999,2.22%,3999,0,100.00%
connectivity-check.ubuntu.com,3882,2.15%,3882,0,100.00%
rq.r9t1.com,2849,1.58%,2849,0,100.00%
optimizationguide-pa.googleapis.com,2763,1.53%,2829,66,97.67%
daisy.ubuntu.com,2649,1.47%,7303,4654,36.27%
qup.b.qianxin.com,2599,1.44%,2599,0,100.00%
api.miwifi.com,2588,1.44%,2588,0,100.00%
xgpolardb.mysql.polardb.rds.aliyuncs.com,2054,1.14%,2054,0,100.00%
yapi.kdsec.org,1791,0.99%,1791,0,100.00%
settings-win.data.microsoft.com,1565,0.87%,1565,0,100.00%
www.msftncsi.com,1490,0.83%,1490,0,100.00%
edragent.sangfor.com.cn,1484,0.82%,1484,0,100.00%
retracker.mgts.by,1478,0.82%,1478,0,100.00%
es.proj217.app.kdsec.org,1375,0.76%,1375,0,100.00%
sources.openembedded.org,1324,0.73%,1324,0,100.00%
2.ubuntu.pool.ntp.org,1257,0.70%,1278,21,98.36%
retracker.lanta-net.ru,1252,0.69%,1252,0,100.00%
v10.events.data.microsoft.com,1231,0.68%,1305,74,94.33%
x.research.qq.com,1168,0.65%,1168,0,100.00%
hsk-embed.oray.com,1122,0.62%,1122,0,100.00%
osfsr.lenovomm.com,1012,0.56%,1012,0,100.00%
ipv4only.arpa,1011,0.56%,1011,0,100.00%
safebrowsing.googleapis.com,993,0.55%,1012,19,98.12%
connectivitycheck.platform.hicloud.com,970,0.54%,1373,403,70.65%
mail.cstnet.cn,898,0.50%,1698,800,52.89%
assets.contentstack.io,786,0.44%,786,0,100.00%
www.expressapisv2.net,747,0.41%,1363,616,54.81%
browser.360.cn,722,0.40%,730,8,98.90%
www.tvnihon.com,698,0.39%,698,0,100.00%
mvgforumtracker.mvgroup.org,696,0.39%,696,0,100.00%
ctldl.windowsupdate.com,689,0.38%,717,28,96.09%
cu1pehnswss01.servicebus.windows.net,681,0.38%,681,0,100.00%
ip.42.pl,665,0.37%,665,0,100.00%
allall01.baidupcs.com,651,0.36%,1264,613,51.50%
www.tribalmixes.com,642,0.36%,642,0,100.00%
mmbiz.qpic.cn,637,0.35%,657,20,96.96%
analytics.yinxiang.com,626,0.35%,626,0,100.00%
www.bit-hdtv.com,616,0.34%,616,0,100.00%
www.yuwabits.net,587,0.33%,587,0,100.00%
h5-api.appstore.vivo.com.cn,582,0.32%,582,0,100.00%
api.vc.bilibili.com,576,0.32%,674,98,85.46%
self.events.data.microsoft.com,548,0.30%,625,77,87.68%
vortex.data.microsoft.com,546,0.30%,546,0,100.00%
t.overflow.biz,523,0.29%,523,0,100.00%
incoming.telemetry.mozilla.org,521,0.29%,521,0,100.00%
us-v20.events.data.microsoft.com,507,0.28%,511,4,99.22%
github.com,506,0.28%,506,0,100.00%
shuc-pc-hunt.ksord.com,498,0.28%,498,0,100.00%
i5.cwip.eset.com,481,0.27%,481,0,100.00%
ping.pinyin.sogou.com,469,0.26%,469,0,100.00%
default.exp-tas.com,452,0.25%,932,480,48.50%
nj.t.bcsp2p.baidu.com,449,0.25%,449,0,100.00%
mirrors.aliyun.com,441,0.24%,472,31,93.43%
get.sogou.com,437,0.24%,437,0,100.00%
duba-defend.zhhainiao.com,427,0.24%,427,0,100.00%
mobile.events.data.microsoft.com,427,0.24%,446,19,95.74%
android.clients.google.com,419,0.23%,419,0,100.00%
stun.douyucdn.cn,417,0.23%,802,385,52.00%
stun1.douyucdn.cn,416,0.23%,416,0,100.00%
contile.services.mozilla.com,408,0.23%,408,0,100.00%
2.centos.pool.ntp.org,393,0.22%,540,147,72.78%
alfred.ixiacom.com,386,0.21%,386,0,100.00%
clientservices.googleapis.com,385,0.21%,407,22,94.59%
www.mvgroup.org,376,0.21%,376,0,100.00%
open.tracker.cl,375,0.21%,375,0,100.00%
slapi.oray.net,369,0.20%,369,0,100.00%
e-0014.e-msedge.net,359,0.20%,359,0,100.00%
update1.sangfor.net,351,0.19%,351,0,100.00%
share.camoe.cn,350,0.19%,350,0,100.00%
router12.teamviewer.com,341,0.19%,360,19,94.72%
pan.baidu.com,335,0.19%,967,632,34.64%
sl-tk.oray.com,322,0.18%,322,0,100.00%
config.pinyin.sogou.com,303,0.17%,576,273,52.60%
tracker.tasvideos.org,296,0.16%,573,277,51.66%
router15.teamviewer.com,293,0.16%,348,55,84.20%
tr.abirxo.cf,292,0.16%,572,280,51.05%
ww62.uatracker.net,289,0.16%,289,0,100.00%
router14.teamviewer.com,285,0.16%,324,39,87.96%
tile-service.weather.microsoft.com,273,0.15%,273,0,100.00%
frp.zwlin.top,271,0.15%,271,0,100.00%
router1.teamviewer.com,267,0.15%,291,24,91.75%
login.live.com,259,0.14%,259,0,100.00%
router3.teamviewer.com,255,0.14%,264,9,96.59%
update.pan.baidu.com,254,0.14%,254,0,100.00%
router11.teamviewer.com,252,0.14%,260,8,96.92%
router2.teamviewer.com,246,0.14%,271,25,90.77%
play.googleapis.com,236,0.13%,246,10,95.93%
update.googleapis.com,235,0.13%,259,24,90.73%
packages.deepin.com,234,0.13%,234,0,100.00%
router13.teamviewer.com,230,0.13%,245,15,93.88%
cn2888.v2free.xyz,229,0.13%,229,0,100.00%
locprod2-elb-us-west-2.prod.mozaws.net,228,0.13%,228,0,100.00%
router7.teamviewer.com,228,0.13%,244,16,93.44%
router9.teamviewer.com,222,0.12%,252,30,88.10%
d27xxe7juh1us6.cloudfront.net,217,0.12%,429,212,50.58%
router6.teamviewer.com,217,0.12%,219,2,99.09%
ntp.sjtu.edu.cn,215,0.12%,215,0,100.00%
client.wns.windows.com,214,0.12%,367,153,58.31%
router10.teamviewer.com,212,0.12%,220,8,96.36%
arc.msn.com,211,0.12%,211,0,100.00%
content-autofill.googleapis.com,210,0.12%,221,11,95.02%
router8.teamviewer.com,210,0.12%,236,26,88.98%
mirrors.163.com,209,0.12%,209,0,100.00%
www.bing.com,205,0.11%,250,45,82.00%
git.rancher.io,204,0.11%,2711,2507,7.52%
bt.okmp3.ru,204,0.11%,204,0,100.00%
femetrics.grammarly.io,203,0.11%,203,0,100.00%
ipv6.google.com,203,0.11%,266,63,76.32%
rscloud.rising.net.cn,199,0.11%,199,0,100.00%
p3p.sogou.com,199,0.11%,199,0,100.00%
pcs-sdk-server.alibaba.com,198,0.11%,362,164,54.70%
clients2.google.com,197,0.11%,203,6,97.04%
router16.teamviewer.com,197,0.11%,229,32,86.03%
nexusrules.officeapps.live.com,196,0.11%,373,177,52.55%
data.bilibili.com,193,0.11%,352,159,54.83%
router5.teamviewer.com,192,0.11%,198,6,96.97%
midinfo.baofeng.com,190,0.11%,190,0,100.00%
router4.teamviewer.com,189,0.10%,193,4,97.93%
www.belkin.com,188,0.10%,188,0,100.00%
o.andfx.cn,187,0.10%,187,0,100.00%
tracker.fixr.pro,184,0.10%,184,0,100.00%
monorepo-production-edge-alb-985829473.us-east-1.elb.amazonaws.com,183,0.10%,183,0,100.00%
ldc.lenovo.com.cn,181,0.10%,181,0,100.00%
mtalk.google.com,181,0.10%,438,257,41.32%
t2.pow7.com,180,0.10%,360,180,50.00%
t1.pow7.com,178,0.10%,350,172,50.86%
d11.baidupcs.com,176,0.10%,176,0,100.00%
atrack.pow7.com,171,0.09%,340,169,50.29%
wup.browser.qq.com,170,0.09%,170,0,100.00%
88dsf5l.003.1.mclqp.link,167,0.09%,167,0,100.00%
huggingface.co,164,0.09%,353,189,46.46%
accounts.google.com,162,0.09%,170,8,95.29%
hk.tcpbbr.net,160,0.09%,306,146,52.29%
tracker.pow7.com,159,0.09%,314,155,50.64%
erickson514-my.sharepoint.com,159,0.09%,159,0,100.00%
treatment.grammarly.com,157,0.09%,157,0,100.00%
gitee.com,156,0.09%,156,0,100.00%
pdcweb.micloud.xiaomi.net,155,0.09%,155,0,100.00%
global.quickconnect.cn,154,0.09%,154,0,100.00%
t.acg.rip,154,0.09%,154,0,100.00%
mon.zijieapi.com,152,0.08%,152,0,100.00%
nzk.woqu365.com,148,0.08%,148,0,100.00%
usa1v2.jsssline.top,148,0.08%,148,0,100.00%
info.pinyin.sogou.com,144,0.08%,275,131,52.36%
ris.api.iris.microsoft.com,144,0.08%,144,0,100.00%
clients1.google.com,144,0.08%,147,3,97.96%
zw-roaming.wps.cn,143,0.08%,143,0,100.00%
mirror.iscas.ac.cn,143,0.08%,143,0,100.00%
secure.pow7.com,143,0.08%,288,145,49.65%
account.wps.cn,141,0.08%,141,0,100.00%
roaming.wps.cn,141,0.08%,141,0,100.00%
dldir1.qq.com,139,0.08%,140,1,99.29%
h-adashx.ut.taobao.com,137,0.08%,137,0,100.00%
cn.bing.com,136,0.08%,163,27,83.44%
hk4.v2u9.top,133,0.07%,133,0,100.00%
assets.msn.cn,132,0.07%,132,0,100.00%
qingcenter.wps.cn,130,0.07%,254,124,51.18%
www.msftconnecttest.com,130,0.07%,134,4,97.01%
v20.events.data.microsoft.com,129,0.07%,138,9,93.48%
switch.pcfg.cache.wpscdn.cn,129,0.07%,277,148,46.57%
prom-monitorproxy1.fastsdwan.com,126,0.07%,126,0,100.00%
watson.telemetry.microsoft.com,125,0.07%,239,114,52.30%
v2.get.sogou.com,125,0.07%,125,0,100.00%
checkappexec.microsoft.com,124,0.07%,124,0,100.00%
x1.c.lencr.org,124,0.07%,253,129,49.01%
array504.prod.do.dsp.mp.microsoft.com,123,0.07%,123,0,100.00%
hpd.baidu.com,123,0.07%,123,0,100.00%
bam.nr-data.net,123,0.07%,123,0,100.00%
ws.666liushen.tk,122,0.07%,122,0,100.00%
mail.digidown.de,122,0.07%,122,0,100.00%
lp-push-server-253.lastpass.com,122,0.07%,122,0,100.00%
repo.huaweicloud.com,121,0.07%,121,0,100.00%
mini.browser.360.cn,119,0.07%,119,0,100.00%
docer.wps.cn,119,0.07%,119,0,100.00%
api.snapcraft.io,118,0.07%,118,0,100.00%
www.taobao.com,118,0.07%,206,88,57.28%
home.wps.cn,117,0.06%,117,0,100.00%
location.services.mozilla.com,117,0.06%,117,0,100.00%
d.docs.live.net,116,0.06%,195,79,59.49%
btrace.qq.com,115,0.06%,208,93,55.29%
winatp-gw-cus3.microsoft.com,115,0.06%,115,0,100.00%
vip.wps.cn,114,0.06%,114,0,100.00%
visualstudio-devdiv-c2s.msedge.net,114,0.06%,114,0,100.00%
shortconn.im.qcloud.com,114,0.06%,114,0,100.00%
vasapi.wps.cn,113,0.06%,113,0,100.00%
caldav.163.com,112,0.06%,112,0,100.00%
vipapi.wps.cn,112,0.06%,112,0,100.00%
diskapi.baidu.com,112,0.06%,208,96,53.85%
push.thanos.ams.eulix.xyz,112,0.06%,112,0,100.00%
api.appstore.deepin.org,112,0.06%,112,0,100.00%
dl.qianxin.com,112,0.06%,112,0,100.00%
update.wps.cn,111,0.06%,111,0,100.00%
allall02.baidupcs.com,111,0.06%,223,112,49.78%
frp.zwlin.store,111,0.06%,111,0,100.00%
dsp.lenovo.com.cn,110,0.06%,110,0,100.00%
qing.wps.cn,109,0.06%,256,147,42.58%
cloud.browser.360.cn,108,0.06%,108,0,100.00%
nexus.officeapps.live.com,107,0.06%,107,0,100.00%
proxy.client.163.com,105,0.06%,105,0,100.00%
www.a.shifen.com,104,0.06%,185,81,56.22%
pc-plugin-plg.wpscdn.cn,104,0.06%,216,112,48.15%
play.google.com,103,0.06%,126,23,81.75%
firefox.settings.services.mozilla.com,102,0.06%,102,0,100.00%
community-store-packages.deepin.com,101,0.06%,101,0,100.00%
www.microsoft.com,99,0.05%,102,3,97.06%
content-signature-2.cdn.mozilla.net,99,0.05%,218,119,45.41%
dw-online.ksosoft.com,99,0.05%,99,0,100.00%
h5.do889.com,99,0.05%,99,0,100.00%
www.googleapis.com,98,0.05%,101,3,97.03%
dd.browser.360.cn,97,0.05%,97,0,100.00%
imap.gmail.com,97,0.05%,112,15,86.61%
notice.wps.cn,97,0.05%,97,0,100.00%
agt.p.qianxin.com,97,0.05%,97,0,100.00%
isrc.iscas.ac.cn,97,0.05%,97,0,100.00%
zj-roaming.wps.cn,96,0.05%,96,0,100.00%
mail.bjtu.edu.cn,95,0.05%,95,0,100.00%
tuna05.mcddns01.com,94,0.05%,94,0,100.00%
www3.l.google.com,94,0.05%,99,5,94.95%
le.wps.cn,93,0.05%,93,0,100.00%
c.pcs.baidu.com,93,0.05%,171,78,54.39%
dcldshlupt.alicdn.com,92,0.05%,92,0,100.00%
tunnel.cfw.trustedsource.org,92,0.05%,92,0,100.00%
download.docker.com,92,0.05%,108,16,85.19%
beacons.gcp.gvt2.com,92,0.05%,97,5,94.85%
apphub.aliyuncs.com,92,0.05%,92,0,100.00%
vscode-sync.trafficmanager.net,91,0.05%,91,0,100.00%
global.asimov.events.data.trafficmanager.net,91,0.05%,92,1,98.91%
1hkclu.pronetworklink.net,91,0.05%,91,0,100.00%
drive.wps.cn,90,0.05%,271,181,33.21%
sms.wps.cn,90,0.05%,90,0,100.00%
hub5pnc.sandai.net,90,0.05%,90,0,100.00%
rs1.qq.com,89,0.05%,89,0,100.00%
docer-api.kdocs.cn,89,0.05%,89,0,100.00%
registry-1.docker.io,89,0.05%,89,0,100.00%
tracker2.itzmx.com,88,0.05%,88,0,100.00%
tracker4.itzmx.com,88,0.05%,152,64,57.89%
ping.avast.com,88,0.05%,190,102,46.32%
2.openwrt.pool.ntp.org,88,0.05%,93,5,94.62%
docer.kdocs.cn,87,0.05%,87,0,100.00%
qr.wps.cn,86,0.05%,86,0,100.00%
dc.services.visualstudio.com,86,0.05%,86,0,100.00%
e6858.e19.s.tl88.net,85,0.05%,85,0,100.00%
translate.google.cn,85,0.05%,167,82,50.90%
api.kylinos.cn,85,0.05%,85,0,100.00%
api.apple-cloudkit.com,84,0.05%,84,0,100.00%
array808.prod.do.dsp.mp.microsoft.com,84,0.05%,84,0,100.00%
opencdnmsdl1.jomodns.com,84,0.05%,84,0,100.00%
geo.wps.cn,84,0.05%,84,0,100.00%
iaas.wps.cn,84,0.05%,84,0,100.00%
zt.wps.cn,84,0.05%,84,0,100.00%
ts2.qq.com,83,0.05%,83,0,100.00%
lucky.wps.cn,82,0.05%,82,0,100.00%
discovery-v4-1.verysync.cn,82,0.05%,82,0,100.00%
h4.trakx.nibba.trade,82,0.05%,82,0,100.00%
iplc-ji.mielink-dns2.com,81,0.04%,81,0,100.00%
avatar.qwps.cn,80,0.04%,80,0,100.00%
update3.sangfor.net,80,0.04%,80,0,100.00%
mobile.pipe.aria.microsoft.com,80,0.04%,86,6,93.02%
az764295.vo.msecnd.net,80,0.04%,80,0,100.00%
www.bitseduce.com,80,0.04%,80,0,100.00%
ts1.qq.com,79,0.04%,79,0,100.00%
www.google.com,79,0.04%,481,402,16.42%
telemetry-in.battle.net,79,0.04%,79,0,100.00%
clients4.google.com,78,0.04%,96,18,81.25%
auth.docker.io,78,0.04%,78,0,100.00%
apac-china-courier-4.push-apple.com.akadns.net,77,0.04%,77,0,100.00%
socm.dmp.360.cn,77,0.04%,77,0,100.00%
deault-exp-tas-com.e-0014.e-msedge.net,77,0.04%,144,67,53.47%
redirector.gvt1.com,77,0.04%,80,3,96.25%
translate.google.com,77,0.04%,78,1,98.72%
api2.firefoxchina.cn.wswebpic.com,75,0.04%,75,0,100.00%
ocsp.digicert.com,75,0.04%,142,67,52.82%
dc1.ksn.kaspersky-labs.com,74,0.04%,74,0,100.00%
cn-hangzhou.axt.aliyun.com,74,0.04%,74,0,100.00%
shdf01-iopq.cgroads.com,74,0.04%,74,0,100.00%
rs2.qq.com,73,0.04%,73,0,100.00%
tsfe.trafficshaping.dsp.mp.microsoft.com,73,0.04%,73,0,100.00%
alive.github.com,72,0.04%,72,0,100.00%
chpm.sangfor.com.cn,72,0.04%,72,0,100.00%
searchrecommend.kugou.com,72,0.04%,72,0,100.00%
ztxdjj-my.sharepoint.com,72,0.04%,72,0,100.00%
mirrors.nwafu.edu.cn,72,0.04%,72,0,100.00%
s.360.cn,71,0.04%,71,0,100.00%
api.zotero.org,70,0.04%,70,0,100.00%
cip.cc,70,0.04%,70,0,100.00%
cdn-cn.nekocloud.cn,70,0.04%,70,0,100.00%
tls-eleme.dingtalk.com,70,0.04%,70,0,100.00%
www.apple.com,69,0.04%,69,0,100.00%
cn-qingdao.axt.aliyun.com,69,0.04%,69,0,100.00%
atm-settingsfe-prod-geo2.trafficmanager.net,69,0.04%,69,0,100.00%
discovery-v4-3.verysync.cn,69,0.04%,69,0,100.00%
load-balancing-system.cmy-dns.com,68,0.04%,68,0,100.00%
prod.ingestion-edge.prod.dataops.mozgcp.net,68,0.04%,68,0,100.00%
update.todesk.com,68,0.04%,68,0,100.00%
www.tg5tj2cu.com,67,0.04%,67,0,100.00%
hk1-7.nigirocloud.com,67,0.04%,67,0,100.00%
us-west-las-5.openssl3.com,67,0.04%,67,0,100.00%
tracker1.itzmx.com,66,0.04%,66,0,100.00%
d2nxq2uap88usk.cloudfront.net,66,0.04%,107,41,61.68%
dev.ditu.live.com,66,0.04%,66,0,100.00%
mcs-bd.feishu.cn.w.cdngslb.com,66,0.04%,66,0,100.00%
download.windowsupdate.com,65,0.04%,66,1,98.48%
hp3.mail.netease.com,65,0.04%,65,0,100.00%
pool.ntp.org,65,0.04%,65,0,100.00%
discovery-v4.verysync.cn,65,0.04%,65,0,100.00%
zhidao.baidu.com,64,0.04%,115,51,55.65%
msedge.b.tlu.dl.delivery.mp.microsoft.com,64,0.04%,64,0,100.00%
safebrowsing.urlsec.qq.com,64,0.04%,64,0,100.00%
odobagg-my.sharepoint.com,64,0.04%,64,0,100.00%
odoooacnz-my.sharepoint.com,64,0.04%,64,0,100.00%
mainnet.infura.io,63,0.03%,106,43,59.43%
ioshost.qtlcdn.com,63,0.03%,126,63,50.00%
1min.pcfg.cache.wpscdn.cn,63,0.03%,63,0,100.00%
honeycomb.wpscdn.cn,63,0.03%,125,62,50.40%
adashx.ut.dingtalk.com,63,0.03%,63,0,100.00%
vamd.cnode.xyz,63,0.03%,63,0,100.00%
i5.c.eset.com,63,0.03%,63,0,100.00%
hotfix.lenovo.com.cn,62,0.03%,62,0,100.00%
puv.tt.browser.360.cn,62,0.03%,62,0,100.00%
time.windows.com,62,0.03%,62,0,100.00%
access.video.qq.com,62,0.03%,62,0,100.00%
api.goco.io,61,0.03%,61,0,100.00%
listen1.myradio24.com,61,0.03%,61,0,100.00%
api.aquamedian.com,61,0.03%,61,0,100.00%
update2.sangfor.net,61,0.03%,61,0,100.00%
todolist.redirect.xzdesktop.cqttech.com,61,0.03%,61,0,100.00%
mail.pnpitalia.it,61,0.03%,61,0,100.00%
w.isoleader.com.tw,61,0.03%,61,0,100.00%
mail.lntaowedgamevn29.tk,61,0.03%,61,0,100.00%
bck65.modsbase.com,61,0.03%,61,0,100.00%
tqovac.b47chang.ml,61,0.03%,61,0,100.00%
signalings.verysync.cn,61,0.03%,61,0,100.00%
orders.pvdonuts.com,61,0.03%,61,0,100.00%
tuna02.mcddns01.com,61,0.03%,61,0,100.00%
smib-app.herokuapp.com,61,0.03%,61,0,100.00%
krynica-zdroj.org.pl,61,0.03%,61,0,100.00%
mosley.staging.fflegacy.club,61,0.03%,61,0,100.00%
mail.ukknowlegefree36.gq,61,0.03%,61,0,100.00%
app.spokehs.com,61,0.03%,61,0,100.00%
api.opal.work,61,0.03%,61,0,100.00%
us2.yesdaddy.win,61,0.03%,61,0,100.00%
mta-sts.mail.franklinleadership.com,61,0.03%,61,0,100.00%
my.jlhosting.net,61,0.03%,61,0,100.00%
s108.api.bsplayer-subtitles.com,61,0.03%,61,0,100.00%
3n.1513ke.ga,61,0.03%,61,0,100.00%
mpb6f6bleezx.qidian.cf,61,0.03%,61,0,100.00%
webmailkhh.tsrc-global.com,61,0.03%,61,0,100.00%
v2ray.emperinter.ga,61,0.03%,61,0,100.00%
motion-studio.danykalmeida.com,61,0.03%,61,0,100.00%
lists.hellasbridge.org,61,0.03%,61,0,100.00%
seednet.tr.zsdcloud.xyz,61,0.03%,61,0,100.00%
gaspumpserver.herokuapp.com,61,0.03%,61,0,100.00%
6954.vrxdy8.com,61,0.03%,61,0,100.00%
mail.ekynox.net,61,0.03%,61,0,100.00%
test.lchecklist.com,61,0.03%,61,0,100.00%
winsel.dynet.com,61,0.03%,61,0,100.00%
pukezuobigaoshou.herokuapp.com,61,0.03%,61,0,100.00%
identatronics.com.mx,61,0.03%,61,0,100.00%
m.234xs.cc,61,0.03%,61,0,100.00%
streamall.alsolnet.com,61,0.03%,61,0,100.00%
apptmech-server-live.herokuapp.com,61,0.03%,61,0,100.00%
catalog.gamepass.com,60,0.03%,126,66,47.62%
ios.ac.cn,60,0.03%,60,0,100.00%
bp.335.wdpdk.link,60,0.03%,60,0,100.00%
go.microsoft.com,59,0.03%,128,69,46.09%
roaming.officeapps.live.com,59,0.03%,59,0,100.00%
www.kanjiantu.com,59,0.03%,59,0,100.00%
rinkeby.infura.io,58,0.03%,58,0,100.00%
cn-beijing.axt.aliyun.com,58,0.03%,58,0,100.00%
v1.go2yd.com,58,0.03%,58,0,100.00%
123.sogou.com,58,0.03%,58,0,100.00%
blog.davideferrero.com,58,0.03%,58,0,100.00%
www.biztorrents.com,58,0.03%,58,0,100.00%
1-courier.push.apple.com,57,0.03%,57,0,100.00%
rq.wh.cmcm.com,57,0.03%,57,0,100.00%
tracker.ccp.ovh,57,0.03%,57,0,100.00%
store-us-uat.motorola.com,57,0.03%,57,0,100.00%
pay.wps.cn,56,0.03%,56,0,100.00%
oth.eve.mdt.qq.com,56,0.03%,56,0,100.00%
discovery-v4-2.verysync.cn,56,0.03%,56,0,100.00%
flbgpi.meiquankongjian.com,56,0.03%,56,0,100.00%
e13678.ca2.s.tl88.net,55,0.03%,55,0,100.00%
licensing.mp.microsoft.com,55,0.03%,55,0,100.00%
tr.cili001.com,55,0.03%,55,0,100.00%
gateway.fe.apple-dns.net,55,0.03%,108,53,50.93%
u.zyinfotech.com,55,0.03%,55,0,100.00%
browser6.qhimg.com,55,0.03%,60,5,91.67%
assets.msn.com,55,0.03%,55,0,100.00%
pagead2.googlesyndication.com,54,0.03%,57,3,94.74%
1-courier.sandbox.push.apple.com,54,0.03%,54,0,100.00%
push.services.mozilla.com,54,0.03%,54,0,100.00%
pss.bdstatic.com,54,0.03%,68,14,79.41%
ntp4.aliyun.com,54,0.03%,54,0,100.00%
www.microvirt.com,54,0.03%,54,0,100.00%
usa.cloudv2a.com,54,0.03%,54,0,100.00%
shcuac.aag436.ccddns.lol,53,0.03%,53,0,100.00%
wdl1.cache.wps.cn,53,0.03%,91,38,58.24%
www.sohu.com,53,0.03%,113,60,46.90%
packages.microsoft.com,53,0.03%,53,0,100.00%
bugly.qq.com,52,0.03%,52,0,100.00%
normandy.cdn.mozilla.net,52,0.03%,52,0,100.00%
dss0.bdstatic.com,52,0.03%,54,2,96.30%
nowpick.nowcoder.com,52,0.03%,52,0,100.00%
tracker.files.fm,51,0.03%,51,0,100.00%
c.go-mpulse.net,51,0.03%,116,65,43.97%
zlxx.v.lxcvc.com,51,0.03%,97,46,52.58%
softcenter-all.os.nfschina.com,51,0.03%,51,0,100.00%
api.ultimaker.com,51,0.03%,51,0,100.00%
nk6.boom.skin,51,0.03%,51,0,100.00%
hectorstatic.baidu.com,50,0.03%,70,20,71.43%
download.visualstudio.microsoft.com,50,0.03%,50,0,100.00%
console.cloud.google.com,50,0.03%,50,0,100.00%
bjbgp01.baidupcs.com,50,0.03%,50,0,100.00%
tm-sdk.platinumai.net,50,0.03%,50,0,100.00%
pr.x.hub.sandai.net,50,0.03%,50,0,100.00%
cstestarea.leagsoft.net,50,0.03%,50,0,100.00%
cdn.packages.deepin.com,49,0.03%,49,0,100.00%
search.apps.ubuntu.com,49,0.03%,49,0,100.00%
api.apple-cloudkit.fe.apple-dns.net,48,0.03%,48,0,100.00%
hm.baidu.com,48,0.03%,115,67,41.74%
l7-online-self-max.s.dsa.cdnbuild.net,48,0.03%,48,0,100.00%
msg.qy.net,48,0.03%,48,0,100.00%
smtp.iscas.ac.cn,48,0.03%,48,0,100.00%
pc.profile.qqpy.sogou.com,48,0.03%,48,0,100.00%
pub.idqqimg.com,47,0.03%,121,74,38.84%
googleads.g.doubleclick.net,47,0.03%,50,3,94.00%
googlecode.l.googleusercontent.com,47,0.03%,97,50,48.45%
auth.sangfor.com.cn,47,0.03%,47,0,100.00%
app.huabao.360.cn,46,0.03%,90,44,51.11%
crl4.digicert.com,46,0.03%,75,29,61.33%
d9caa6e02c990b0a.jijifun.com,46,0.03%,46,0,100.00%
sg02.ipv2.xyz,46,0.03%,46,0,100.00%
rub.myddns.cyou,46,0.03%,46,0,100.00%
mbsug.ssl.so.com,45,0.02%,45,0,100.00%
api.msn.com,45,0.02%,82,37,54.88%
login.microsoftonline.com,45,0.02%,45,0,100.00%
sp1.baidu.com,45,0.02%,80,35,56.25%
nk2.boom.skin,45,0.02%,45,0,100.00%
server-m.pp.cn,45,0.02%,45,0,100.00%
us-sandbox-courier-4.push-apple.com.akadns.net,44,0.02%,44,0,100.00%
poll.exmail.qq.com,44,0.02%,44,0,100.00%
dyn.wps.cn,44,0.02%,44,0,100.00%
api.mathpix.com,44,0.02%,44,0,100.00%
cdn-file.ludashi.com,44,0.02%,44,0,100.00%
update100.sangfor.com.cn,44,0.02%,82,38,53.66%
softbus-device.wps.cn,44,0.02%,44,0,100.00%
dss1.bdstatic.com,44,0.02%,44,0,100.00%
usercount.dockernb.com,44,0.02%,44,0,100.00%
goldengate.grammarly.com,44,0.02%,44,0,100.00%
nk1.boom.skin,44,0.02%,44,0,100.00%
bt2.archive.org,44,0.02%,88,44,50.00%
evalai.cn,44,0.02%,44,0,100.00%
ic.wps.cn,43,0.02%,43,0,100.00%
developer.unity.cn,43,0.02%,43,0,100.00%
mail.google.com,43,0.02%,94,51,45.74%
jtypkz2w.sched.d2.tdnsdp1.cn,43,0.02%,43,0,100.00%
gateway.icloud.com.cn,43,0.02%,43,0,100.00%
wu-bg-shim.trafficmanager.net,42,0.02%,42,0,100.00%
9.rarbg.to,42,0.02%,42,0,100.00%
p0.qhimg.com,42,0.02%,57,15,73.68%
service.account.weibo.com,42,0.02%,42,0,100.00%
msgsrv01.oray.net,41,0.02%,41,0,100.00%
tconf.b.qianxin.com,41,0.02%,41,0,100.00%
push.hicloud.com,41,0.02%,41,0,100.00%
helpdubaclient.ksmobile.com,41,0.02%,41,0,100.00%
rm.api.weibo.com,41,0.02%,68,27,60.29%
notify.tabnine.com,41,0.02%,41,0,100.00%
classify-client.services.mozilla.com,40,0.02%,40,0,100.00%
infoc2.duba.net,40,0.02%,40,0,100.00%
drive.wpsdns.com,40,0.02%,85,45,47.06%
thetracker.org,40,0.02%,40,0,100.00%
interface.music.163.com,40,0.02%,40,0,100.00%
update1.sangfor.net.cdn20.com,40,0.02%,40,0,100.00%
init.push.apple.com,40,0.02%,85,45,47.06%
go.ie.sogou.com,40,0.02%,40,0,100.00%
trakx.herokuapp.com,40,0.02%,40,0,100.00%
v4.tiamato.com,40,0.02%,40,0,100.00%
admin.kdsec.org,40,0.02%,40,0,100.00%
cu005.www.duba.net,40,0.02%,40,0,100.00%
passport.weibo.com,40,0.02%,40,0,100.00%
download.microvirt.com,40,0.02%,40,0,100.00%
opentor.org,39,0.02%,66,27,59.09%
tracker.v6speed.org,39,0.02%,39,0,100.00%
www.jetbrains.com,39,0.02%,93,54,41.94%
fanghu.qianxin.com,39,0.02%,39,0,100.00%
comet.jianguoyun.com,39,0.02%,39,0,100.00%
apple.com,38,0.02%,38,0,100.00%
9.rarbg.me,38,0.02%,38,0,100.00%
tracker.zerobytes.xyz,38,0.02%,38,0,100.00%
high-frequency-gray.zhhainiao.com,38,0.02%,38,0,100.00%
update.cs2c.com.cn,38,0.02%,38,0,100.00%
mubu.com,38,0.02%,38,0,100.00%
geo.prod.do.dsp.mp.microsoft.com,38,0.02%,40,2,95.00%
vm.gtimg.cn,38,0.02%,48,10,79.17%
filedownload.lenovo.com,38,0.02%,38,0,100.00%
www.163.com,38,0.02%,89,51,42.70%
help-tower.2345.cc,38,0.02%,38,0,100.00%
7a37563370ded05f.jijifun.com,38,0.02%,38,0,100.00%
gecko-bd.feishu.cn,38,0.02%,38,0,100.00%
gtm-sg-6wr2n62gk0f.gtm-i1d1.com,37,0.02%,37,0,100.00%
msedge.api.cdp.microsoft.com,37,0.02%,105,68,35.24%
cn-hongkong.axt.aliyun.com,37,0.02%,37,0,100.00%
crl.verisign.com,37,0.02%,71,34,52.11%
update.code.visualstudio.com,37,0.02%,37,0,100.00%
db-safe.2345.cc,37,0.02%,37,0,100.00%
imap.sina.com,37,0.02%,37,0,100.00%
client.teamviewer.com,37,0.02%,37,0,100.00%
mail.iie.ac.cn,37,0.02%,64,27,57.81%
api.geetest.com,37,0.02%,37,0,100.00%
substrate.office.com,36,0.02%,77,41,46.75%
skydrive.wns.windows.com,36,0.02%,70,34,51.43%
pos.baidu.com,36,0.02%,36,0,100.00%
mail.realliferpg.de,36,0.02%,36,0,100.00%
torrentclub.online,36,0.02%,36,0,100.00%
valakas.rollo.dnsabr.com,36,0.02%,36,0,100.00%
vibe.community,36,0.02%,36,0,100.00%
img-xlppc-zhan.xunlei.com,36,0.02%,74,38,48.65%
res.wx.qq.com,36,0.02%,41,5,87.80%
t.helper.2345.cc,36,0.02%,36,0,100.00%
t8.baidu.com,36,0.02%,43,7,83.72%
img.alicdn.com.danuoyi.alicdn.com,36,0.02%,71,35,50.70%
f062936a96d3c8bd.jijifun.com,36,0.02%,36,0,100.00%
accscdn.m.taobao.com,36,0.02%,36,0,100.00%
hubble.netease.com,36,0.02%,36,0,100.00%
br.666.mapow.link,36,0.02%,36,0,100.00%
time1.apple.com,36,0.02%,36,0,100.00%
q.cnblogs.com,36,0.02%,36,0,100.00%
skl.la1.mclqp.link,36,0.02%,36,0,100.00%
tt.browser.360.cn,35,0.02%,35,0,100.00%
filetracker.xyz,35,0.02%,79,44,44.30%
edu.uifr.ru,35,0.02%,35,0,100.00%
ime.sogou.com,35,0.02%,35,0,100.00%
tracker.shkinev.me,35,0.02%,35,0,100.00%
udp-tracker.shittyurl.org,35,0.02%,35,0,100.00%
ug.baidu.com,35,0.02%,54,19,64.81%
s.f.360.cn,35,0.02%,64,29,54.69%
init.push-apple.com.akadns.net,35,0.02%,76,41,46.05%
www.m9ynqi6d.com,35,0.02%,35,0,100.00%
ksn-file-geo.kaspersky-labs.com,35,0.02%,35,0,100.00%
d.pcs.baidu.com,35,0.02%,70,35,50.00%
sadownload.mcafee.com,35,0.02%,35,0,100.00%
honeycomb.wps.cn,35,0.02%,35,0,100.00%
hk1-1.nigirocloud.com,35,0.02%,35,0,100.00%
rum.h5.weibo.cn,35,0.02%,35,0,100.00%
cmrelay-basic-2.nodesub.com,35,0.02%,35,0,100.00%
al04.bb.wdpdk.link,34,0.02%,34,0,100.00%
tracker.bt4g.com,34,0.02%,95,61,35.79%
st.pinyin.sogou.com,34,0.02%,34,0,100.00%
engplus.ru,34,0.02%,34,0,100.00%
zephir.monocul.us,34,0.02%,34,0,100.00%
ts2.cn.mm.bing.net,34,0.02%,34,0,100.00%
torrentsmd.com,34,0.02%,34,0,100.00%
account.jetbrains.com,34,0.02%,34,0,100.00%
functional.events.data.microsoft.com,34,0.02%,37,3,91.89%
prod.nexusrules.live.com.akadns.net,34,0.02%,69,35,49.28%
array513.prod.do.dsp.mp.microsoft.com,34,0.02%,66,32,51.52%
nk7.boom.skin,34,0.02%,34,0,100.00%
adservice.google.com,34,0.02%,37,3,91.89%
g.api.mega.co.nz,34,0.02%,136,102,25.00%
web-drcn.hispace.dbankcloud.cn,34,0.02%,34,0,100.00%
www.sogou.com,34,0.02%,34,0,100.00%
p1.ssl.qhimg.com,34,0.02%,37,3,91.89%
www.deepl.com,34,0.02%,34,0,100.00%
smtp.163.com,34,0.02%,34,0,100.00%
sf.symcb.com,33,0.02%,57,24,57.89%
nleditor.osi.office.net,33,0.02%,33,0,100.00%
mcs-bd.feishu.cn,33,0.02%,33,0,100.00%
safebrowsing.google.com,33,0.02%,33,0,100.00%
free.publictracker.xyz,33,0.02%,33,0,100.00%
tracker0.ufibox.com,33,0.02%,33,0,100.00%
api.tabnine.com,33,0.02%,33,0,100.00%
internal-api-lark-api.feishu.cn,33,0.02%,33,0,100.00%
de2-4.nigirocloud.com,33,0.02%,33,0,100.00%
softcenter.os3.win.nfschina.com,33,0.02%,33,0,100.00%
www.msn.cn,33,0.02%,36,3,91.67%
ssum-sec.casalemedia.com.cdn.cloudflare.net,33,0.02%,33,0,100.00%
tlu.dl.delivery.mp.microsoft.com.w.alikunlun.com,32,0.02%,32,0,100.00%
mathpix.com,32,0.02%,64,32,50.00%
array806.prod.do.dsp.mp.microsoft.com,32,0.02%,32,0,100.00%
newtoncity.org,32,0.02%,32,0,100.00%
ts1.cn.mm.bing.net,32,0.02%,32,0,100.00%
loki.ams.eulix.xyz,32,0.02%,32,0,100.00%
client.dropbox.com,32,0.02%,65,33,49.23%
client-office365-tas.msedge.net,32,0.02%,32,0,100.00%
download.windowsupdate.com.a.bdydns.com,32,0.02%,32,0,100.00%
qbwup.imtt.qq.com,32,0.02%,32,0,100.00%
slardar-bd.feishu.cn.w.cdngslb.com,32,0.02%,32,0,100.00%
developer.atlassian.com,32,0.02%,32,0,100.00%
pki-goog.l.google.com,32,0.02%,37,5,86.49%
ru01.ipv2.xyz,32,0.02%,32,0,100.00%
runc.myddns.cyou,32,0.02%,32,0,100.00%
kv501.prod.do.dsp.mp.microsoft.com,32,0.02%,32,0,100.00%
static.asm.skype.com,32,0.02%,32,0,100.00%
tracker.moeblog.cn,31,0.02%,67,36,46.27%
normandy-cdn.services.mozilla.com,31,0.02%,31,0,100.00%
mobile.events.data.trafficmanager.net,31,0.02%,38,7,81.58%
1595096.sched.d0-dk.tdnsdp1.cn,31,0.02%,68,37,45.59%
tracker.hama3.net,31,0.02%,50,19,62.00%
max-l.mediav.com,31,0.02%,31,0,100.00%
tracker.nitrix.me,31,0.02%,53,22,58.49%
tracker.trackerfix.com,31,0.02%,31,0,100.00%
gimg3.baidu.com,31,0.02%,37,6,83.78%
sp0.baidu.com,31,0.02%,52,21,59.62%
vscode-sync-ase-01.azurewebsites.net,31,0.02%,31,0,100.00%
bugreport.huorong.cn,31,0.02%,83,52,37.35%
evoke-windowsservices-tas.msedge.net,31,0.02%,31,0,100.00%
kv601.prod.do.dsp.mp.microsoft.com,31,0.02%,31,0,100.00%
smartscreen-prod.microsoft.com,31,0.02%,31,0,100.00%
client-api.oray.com,31,0.02%,31,0,100.00%
uz95.v.trpcdn.net,30,0.02%,30,0,100.00%
prod-classifyclient.normandy.prod.cloudops.mozgcp.net,30,0.02%,30,0,100.00%
cloud-rest.lenovomm.com,30,0.02%,30,0,100.00%
tracker.uw0.xyz,30,0.02%,30,0,100.00%
t7.baidu.com,30,0.02%,45,15,66.67%
arc.trafficmanager.net,30,0.02%,30,0,100.00%
www.google.com.hk,30,0.02%,51,21,58.82%
ins-g4ztq7u7.ias.tencent-cloud.net,30,0.02%,30,0,100.00%
tpc.googlesyndication.com,30,0.02%,31,1,96.77%
cm.nwncd.com,30,0.02%,30,0,100.00%
code.osssc.ac.cn,30,0.02%,30,0,100.00%
api.onedrive.com,29,0.02%,46,17,63.04%
wdl1.file.cache.docer.com,29,0.02%,47,18,61.70%
is.iscas.ac.cn,29,0.02%,29,0,100.00%
visualstudio-devdiv-c2s-msedge-net.e-0009.e-msedge.net,29,0.02%,29,0,100.00%
passport.escience.cn,29,0.02%,29,0,100.00%
inews.gtimg.com,29,0.02%,30,1,96.67%
ocsp2-lb.apple.com.akadns.net,29,0.02%,34,5,85.29%
bt.nfshost.com,29,0.02%,29,0,100.00%
ss1.bdstatic.com,29,0.02%,29,0,100.00%
mbd.baidu.com,29,0.02%,29,0,100.00%
www.gsd92gov.com,29,0.02%,29,0,100.00%
ns-eh2-prod-dm2-511.cloudapp.net,29,0.02%,29,0,100.00%
cdn.fwupd.org,29,0.02%,29,0,100.00%
api.bilibili.com,29,0.02%,33,4,87.88%
wp.mail.qq.com,29,0.02%,29,0,100.00%
cs9.wac.phicdn.net,29,0.02%,57,28,50.88%
stock2.finance.sina.com.cn,29,0.02%,29,0,100.00%
webquotepic.eastmoney.com,29,0.02%,29,0,100.00%
changer8.net,29,0.02%,29,0,100.00%
www.google-analytics.com,29,0.02%,51,22,56.86%
1.courier-push-apple.com.akadns.net,29,0.02%,29,0,100.00%
tlu.dl.delivery.mp.microsoft.com,29,0.02%,31,2,93.55%
tracker.pussytorrents.org,29,0.02%,45,16,64.44%
dlied6.qq.com,29,0.02%,29,0,100.00%
fedora.riscv.rocks,29,0.02%,29,0,100.00%
hk-4.upjs.xyz,29,0.02%,29,0,100.00%
hw-web-player-tracker.biliapi.net,28,0.02%,28,0,100.00%
ins-mfa9hirw.ias.tencent-cloud.net,28,0.02%,28,0,100.00%
fm.dl.126.net,28,0.02%,28,0,100.00%
uapi.mp.360.cn,28,0.02%,28,0,100.00%
info.lenovo.com.cn,28,0.02%,28,0,100.00%
e-0009.e-msedge.net,28,0.02%,28,0,100.00%
api.atlassian.com,28,0.02%,28,0,100.00%
autopush.prod.mozaws.net,28,0.02%,28,0,100.00%
gates.grammarly.com,28,0.02%,28,0,100.00%
datarouter.ol.epicgames.com,28,0.02%,28,0,100.00%
shcu1.myddns.cyou,28,0.02%,28,0,100.00%
task.browser.360.cn,28,0.02%,28,0,100.00%
shavar.services.mozilla.com,28,0.02%,28,0,100.00%
targetednotifications-tm.trafficmanager.net,28,0.02%,28,0,100.00%
self-events-data.trafficmanager.net,28,0.02%,34,6,82.35%
imap.cstnet.cn,28,0.02%,28,0,100.00%
seapp.stat.360safe.com,28,0.02%,28,0,100.00%
pc-plugin.wpscdn.cn,28,0.02%,28,0,100.00%
hk1-5.nigirocloud.com,28,0.02%,28,0,100.00%
csdnimg.cn,28,0.02%,28,0,100.00%
cache.tv.qq.com,28,0.02%,38,10,73.68%
orange-pcsafe.2345.cc,28,0.02%,28,0,100.00%
t14.baidu.com,28,0.02%,41,13,68.29%
account.sogou.com,28,0.02%,28,0,100.00%
cloud.streamsets.com,28,0.02%,28,0,100.00%
gateway.bitrenren.com,27,0.01%,55,28,49.09%
tracker.coalition.space,27,0.01%,43,16,62.79%
t9.baidu.com,27,0.01%,35,8,77.14%
mumu.nie.netease.com,27,0.01%,49,22,55.10%
downloads.upd.kaspersky.com,27,0.01%,27,0,100.00%
hk1-8.nigirocloud.com,27,0.01%,27,0,100.00%
imap-mail.outlook.com,27,0.01%,52,25,51.92%
t-safe.2345.cc,27,0.01%,27,0,100.00%
dl.google.com,27,0.01%,28,1,96.43%
upos-sz-mirrorali.bilivideo.com,27,0.01%,27,0,100.00%
fclick.baidu.com,27,0.01%,27,0,100.00%
profile-avatar.csdnimg.cn,27,0.01%,27,0,100.00%
g.csdnimg.cn,27,0.01%,27,0,100.00%
gcr.io,27,0.01%,50,23,54.00%
zykj2019.oss-cn-hangzhou.aliyuncs.com,27,0.01%,27,0,100.00%
detectportal.firefox.com,26,0.01%,2301,2275,1.13%
outlook.office365.com,26,0.01%,56,30,46.43%
tracker1.myporn.club,26,0.01%,40,14,65.00%
dl.vas.wpscdn.cn,26,0.01%,54,28,48.15%
activity.windows.com,26,0.01%,26,0,100.00%
video-hw-drcn.dbankcdn.cn,26,0.01%,61,35,42.62%
waws-prod-sg1-051.sip.azurewebsites.windows.net,26,0.01%,26,0,100.00%
6fe97759aa27a0c9.jijifun.com,26,0.01%,26,0,100.00%
cp601.prod.do.dsp.mp.microsoft.com,26,0.01%,26,0,100.00%
t-safe.2345.com,26,0.01%,26,0,100.00%
t13.baidu.com,26,0.01%,33,7,78.79%
ocsp.entrust.net,26,0.01%,56,30,46.43%
r4.res.office365.com,26,0.01%,53,27,49.06%
array802.prod.do.dsp.mp.microsoft.com,26,0.01%,26,0,100.00%
config.i.duba.net,26,0.01%,26,0,100.00%
bt1.archive.org,26,0.01%,52,26,50.00%
zhanzhang.toutiao.com,26,0.01%,26,0,100.00%
cdn.odc.officeapps.live.com,26,0.01%,26,0,100.00%
shavar.prod.mozaws.net,25,0.01%,25,0,100.00%
ue.lenovomm.cn,25,0.01%,25,0,100.00%
miao.baidu.com,25,0.01%,25,0,100.00%
ocsp2.apple.com,25,0.01%,30,5,83.33%
edge.ivideo.sina.com.cn,25,0.01%,79,54,31.65%
st.todesk.com,25,0.01%,25,0,100.00%
array606.prod.do.dsp.mp.microsoft.com,25,0.01%,25,0,100.00%
zconfig.alibabausercontent.com,25,0.01%,57,32,43.86%
array511.prod.do.dsp.mp.microsoft.com,25,0.01%,25,0,100.00%
us3-5.nigirocloud.com,25,0.01%,25,0,100.00%
dl.delivery.mp.microsoft.com,25,0.01%,29,4,86.21%
papi.funshion.com,25,0.01%,25,0,100.00%
tracker.bitsearch.to,25,0.01%,39,14,64.10%
api.docer.wpscdn.cn,25,0.01%,50,25,50.00%
fc1tn.baidu.com,25,0.01%,25,0,100.00%
s.xinshuru.com,25,0.01%,25,0,100.00%
hk1-4.nigirocloud.com,25,0.01%,25,0,100.00%
img-home.csdnimg.cn,25,0.01%,25,0,100.00%
securetoken.googleapis.com,25,0.01%,26,1,96.15%
readpaper.com,25,0.01%,25,0,100.00%
openway.guance.com,25,0.01%,25,0,100.00%
broadcast.chat.bilibili.com,24,0.01%,24,0,100.00%
api.github.com,24,0.01%,24,0,100.00%
mail.163.com,24,0.01%,24,0,100.00%
sl-log.oray.net,24,0.01%,24,0,100.00%
ssxd.mediav.com,24,0.01%,24,0,100.00%
shmmsns.qpic.cn,24,0.01%,78,54,30.77%
ss0.baidu.com,24,0.01%,36,12,66.67%
ss1.baidu.com,24,0.01%,38,14,63.16%
ty1-4.nigirocloud.com,24,0.01%,24,0,100.00%
os1-5.nigirocloud.com,24,0.01%,24,0,100.00%
res.wx.qq.com.sched.legopic1.tdnsv6.com,24,0.01%,24,0,100.00%
wss.im.qcloud.com,24,0.01%,24,0,100.00%
ntp.aliyun.com,24,0.01%,24,0,100.00%
clients.l.google.com,24,0.01%,32,8,75.00%
onedsblobprdwus16.westus.cloudapp.azure.com,24,0.01%,24,0,100.00%
au1-1.nigirocloud.com,24,0.01%,24,0,100.00%
ty2-3.nigirocloud.com,24,0.01%,24,0,100.00%
service.fanxing.kugou.com,24,0.01%,50,26,48.00%
fb98ab9159f51fd0.jijifun.com,24,0.01%,24,0,100.00%
webquotestaticpic.dfcfw.com,24,0.01%,24,0,100.00%
ee1-4.nigirocloud.com,24,0.01%,24,0,100.00%
us3-4.nigirocloud.com,24,0.01%,24,0,100.00%
pcrec.baidu.com,24,0.01%,38,14,63.16%
yqy2356.melissauvc.com,24,0.01%,24,0,100.00%
deepl.com,24,0.01%,24,0,100.00%
doc.wps.cn,24,0.01%,24,0,100.00%
ryrc.ruijienetworks.com,24,0.01%,24,0,100.00%
updates.os.nfschina.com,24,0.01%,24,0,100.00%
stream.zotero.org,23,0.01%,46,23,50.00%
ssl.gstatic.com,23,0.01%,68,45,33.82%
5.rlb.router.teamviewer.cn,23,0.01%,23,0,100.00%
tracker.openbittorrent.com,23,0.01%,23,0,100.00%
emoji.qpic.cn,23,0.01%,35,12,65.71%
newvpn.arp.cn,23,0.01%,23,0,100.00%
pgdt.gtimg.cn,23,0.01%,40,17,57.50%
ty2-2.nigirocloud.com,23,0.01%,23,0,100.00%
os1-3.nigirocloud.com,23,0.01%,23,0,100.00%
os1-7.nigirocloud.com,23,0.01%,23,0,100.00%
5kong4.com,23,0.01%,23,0,100.00%
fs.microsoft.com,23,0.01%,23,0,100.00%
mccontacts.mail.163.com,23,0.01%,23,0,100.00%
inference.location.live.net,23,0.01%,23,0,100.00%
au1-2.nigirocloud.com,23,0.01%,23,0,100.00%
ntp1.aliyun.com,23,0.01%,23,0,100.00%
software.drivergenius.com,23,0.01%,23,0,100.00%
l2.hiwifi.com,23,0.01%,23,0,100.00%
hk1-2.nigirocloud.com,23,0.01%,23,0,100.00%
us3-2.nigirocloud.com,23,0.01%,23,0,100.00%
gsp0.baidu.com,23,0.01%,23,0,100.00%
ck-groups.xyz,23,0.01%,23,0,100.00%
api-std.sunlogin.oray.com,23,0.01%,23,0,100.00%
aapl-maps.qtlcdn.com,22,0.01%,42,20,52.38%
e11290.dspg.akamaiedge.net,22,0.01%,49,27,44.90%
dashenga.com,22,0.01%,22,0,100.00%
k128-mzstatic.gslb.ksyuncdn.com,22,0.01%,22,0,100.00%
api.im.qcloud.com,22,0.01%,22,0,100.00%
pcfg.wps.cn,22,0.01%,22,0,100.00%
qdyn.wps.cn,22,0.01%,22,0,100.00%
b.bdstatic.com,22,0.01%,25,3,88.00%
us3-7.nigirocloud.com,22,0.01%,22,0,100.00%
ty1-3.nigirocloud.com,22,0.01%,22,0,100.00%
os2-2.nigirocloud.com,22,0.01%,22,0,100.00%
docs.google.com,22,0.01%,44,22,50.00%
c9b086079795c442.jijifun.com,22,0.01%,22,0,100.00%
live.github.com,22,0.01%,22,0,100.00%
outlook.gogo66.cloud,22,0.01%,43,21,51.16%
au1-3.nigirocloud.com,22,0.01%,22,0,100.00%
n114.boom.skin,22,0.01%,22,0,100.00%
gateway.fe.apple-dns.cn,22,0.01%,22,0,100.00%
music.163.com,22,0.01%,29,7,75.86%
webrtcpunch.video.qq.com,22,0.01%,22,0,100.00%
time-ios.g.aaplimg.com,22,0.01%,22,0,100.00%
www.liebao.cn,22,0.01%,22,0,100.00%
mam.netease.com,22,0.01%,22,0,100.00%
au2-3.nigirocloud.com,22,0.01%,22,0,100.00%
ee1-1.nigirocloud.com,22,0.01%,22,0,100.00%
us3-3.nigirocloud.com,22,0.01%,22,0,100.00%
ee1-2.nigirocloud.com,22,0.01%,22,0,100.00%
zz.bdstatic.com,22,0.01%,22,0,100.00%
pan.wps.cn,22,0.01%,22,0,100.00%
help.origin-apple.com.akadns.net,22,0.01%,22,0,100.00%
detectportal.prod.mozaws.net,21,0.01%,1710,1689,1.23%
opentracker.xyz,21,0.01%,2483,2462,0.85%
t.undefined-site.top,21,0.01%,21,0,100.00%
www.wshifen.com,21,0.01%,21,0,100.00%
adashx.m.taobao.com,21,0.01%,21,0,100.00%
d.skconf.f.360.cn,21,0.01%,21,0,100.00%
gm.mmstat.com,21,0.01%,21,0,100.00%
www.gstatic.com,21,0.01%,22,1,95.45%
officeclient.microsoft.com,21,0.01%,21,0,100.00%
ss2.baidu.com,21,0.01%,29,8,72.41%
ss3.baidu.com,21,0.01%,29,8,72.41%
vdwmto3.bdstatic.com,21,0.01%,35,14,60.00%
sp2.baidu.com,21,0.01%,39,18,53.85%
us3-6.nigirocloud.com,21,0.01%,21,0,100.00%
ty1-1.nigirocloud.com,21,0.01%,21,0,100.00%
ty1-2.nigirocloud.com,21,0.01%,21,0,100.00%
os1-1.nigirocloud.com,21,0.01%,21,0,100.00%
os1-4.nigirocloud.com,21,0.01%,21,0,100.00%
os2-1.nigirocloud.com,21,0.01%,21,0,100.00%
a1961.g2.akamai.net,21,0.01%,21,0,100.00%
afdo-tas-offload.trafficmanager.net,21,0.01%,21,0,100.00%
lax.link.ac.cn,21,0.01%,21,0,100.00%
repo.zotero.org,21,0.01%,21,0,100.00%
device.sangfor.com.cn,21,0.01%,21,0,100.00%
vpn.oceanum.cn,21,0.01%,21,0,100.00%
de1-3.nigirocloud.com,21,0.01%,21,0,100.00%
au2-1.nigirocloud.com,21,0.01%,21,0,100.00%
ty2-1.nigirocloud.com,21,0.01%,21,0,100.00%
push2.eastmoney.com,21,0.01%,39,18,53.85%
remind.api.weibo.com,21,0.01%,41,20,51.22%
lz4hlmtcf5.feishu.cn,21,0.01%,21,0,100.00%
appledownload.qtlcdn.com,21,0.01%,21,0,100.00%
fonts.gstatic.com,21,0.01%,23,2,91.30%
yuri.app.kdsec.org,21,0.01%,21,0,100.00%
us2-1.nigirocloud.com,21,0.01%,21,0,100.00%
us3-1.nigirocloud.com,21,0.01%,21,0,100.00%
hk1-6.nigirocloud.com,21,0.01%,21,0,100.00%
au1-4.nigirocloud.com,21,0.01%,21,0,100.00%
au2-4.nigirocloud.com,21,0.01%,21,0,100.00%
de1-2.nigirocloud.com,21,0.01%,21,0,100.00%
us2-3.nigirocloud.com,21,0.01%,21,0,100.00%
www.overleaf.com,21,0.01%,21,0,100.00%
www.jos.org.cn,21,0.01%,21,0,100.00%
vpn.ios.ac.cn,21,0.01%,21,0,100.00%
onedsblobprdeus17.eastus.cloudapp.azure.com,21,0.01%,21,0,100.00%
bsg.w.bilicdn1.com,20,0.01%,20,0,100.00%
qurl.f.360.cn,20,0.01%,20,0,100.00%
clients6.google.com,20,0.01%,22,2,90.91%
array506.prod.do.dsp.mp.microsoft.com,20,0.01%,39,19,51.28%
pubsub02.oray.net,20,0.01%,20,0,100.00%
messaging.engagement.office.com,20,0.01%,20,0,100.00%
t10.baidu.com,20,0.01%,26,6,76.92%
weather-data.apple.com,20,0.01%,40,20,50.00%
connect.unity.cn,20,0.01%,20,0,100.00%
app.jianguoyun.com,20,0.01%,20,0,100.00%
crl3.digicert.com,20,0.01%,34,14,58.82%
ty2-6.nigirocloud.com,20,0.01%,20,0,100.00%
ris-prod.trafficmanager.net,20,0.01%,20,0,100.00%
array607.prod.do.dsp.mp.microsoft.com,20,0.01%,20,0,100.00%
gspe35-ssl.ls.apple.com,20,0.01%,24,4,83.33%
c2.pcs.baidu.com,20,0.01%,35,15,57.14%
diskapi.n.shifen.com,20,0.01%,39,19,51.28%
ocsp.pki.goog,20,0.01%,24,4,83.33%
ai1.acciff.com,20,0.01%,20,0,100.00%
seafile.casisd.cn,20,0.01%,20,0,100.00%
tcloud.tim.qq.com,20,0.01%,20,0,100.00%
n09.boom.skin,20,0.01%,20,0,100.00%
atm-settingsfe-prod-geo2.trafficmanager.NET,20,0.01%,20,0,100.00%
config.qqpy.sogou.com,20,0.01%,20,0,100.00%
xpgw-xcdn.youku.com,20,0.01%,20,0,100.00%
o1013tn36u32026o.aliyunddos1010.com,20,0.01%,20,0,100.00%
partner.googleadservices.com,20,0.01%,20,0,100.00%
clientlogvodp2p.haplat.net,20,0.01%,20,0,100.00%
us1-3.nigirocloud.com,20,0.01%,20,0,100.00%
de1-1.nigirocloud.com,20,0.01%,20,0,100.00%
us2-4.nigirocloud.com,20,0.01%,20,0,100.00%
blog.csdn.net,20,0.01%,20,0,100.00%
img-blog.csdnimg.cn,20,0.01%,20,0,100.00%
cmrelay-basic-1.nodesub.com,20,0.01%,20,0,100.00%
transit1.wslog.chinanetcenter.com,20,0.01%,20,0,100.00%
pc-api.wondershare.cc,20,0.01%,20,0,100.00%
storage.googleapis.com,20,0.01%,25,5,80.00%
dss2.bdstatic.com,20,0.01%,20,0,100.00%
registry.centos.org,20,0.01%,20,0,100.00%
onedsblobprdcus15.centralus.cloudapp.azure.com,20,0.01%,20,0,100.00%
cdn-node.cn.cm.guangzhou-02.nekocloud.cn,20,0.01%,20,0,100.00%
outlook.ha.office365.com,19,0.01%,38,19,50.00%
ocsp.apple.com,19,0.01%,20,1,95.00%
gameplay.intel.com,19,0.01%,39,20,48.72%
c.urs.microsoft.com,19,0.01%,19,0,100.00%
pss.alicdn.com,19,0.01%,19,0,100.00%
wdcp.microsoft.com,19,0.01%,19,0,100.00%
ty2-8.nigirocloud.com,19,0.01%,19,0,100.00%
os1-2.nigirocloud.com,19,0.01%,19,0,100.00%
os2-6.nigirocloud.com,19,0.01%,19,0,100.00%
os2-8.nigirocloud.com,19,0.01%,19,0,100.00%
ins-qw3q8ofk.ias.tencent-cloud.net,19,0.01%,19,0,100.00%
e4518.dscapi7.akamaiedge.net,19,0.01%,40,21,47.50%
a.w.bilicdn1.com,19,0.01%,24,5,79.17%
aka.ms,19,0.01%,19,0,100.00%
cc-api-data.adobe.io,19,0.01%,19,0,100.00%
sslbaiduv6.jomodns.com,19,0.01%,29,10,65.52%
yun.tim.qq.com,19,0.01%,19,0,100.00%
hk1-3.nigirocloud.com,19,0.01%,19,0,100.00%
au2-2.nigirocloud.com,19,0.01%,19,0,100.00%
us1-1.nigirocloud.com,19,0.01%,19,0,100.00%
de1-4.nigirocloud.com,19,0.01%,19,0,100.00%
de2-1.nigirocloud.com,19,0.01%,19,0,100.00%
us2-2.nigirocloud.com,19,0.01%,19,0,100.00%
ieonlinews.microsoft.com,19,0.01%,34,15,55.88%
de2-3.nigirocloud.com,19,0.01%,19,0,100.00%
kiteweb.b-cdn.net,19,0.01%,44,25,43.18%
t.khd.2345.cc,19,0.01%,19,0,100.00%
www-www.bing.com.trafficmanager.net,18,0.01%,18,0,100.00%
gm.gds.mmstat.com,18,0.01%,18,0,100.00%
eclick.baidu.com,18,0.01%,18,0,100.00%
input.shouji.sogou.com,18,0.01%,18,0,100.00%
us3-8.nigirocloud.com,18,0.01%,18,0,100.00%
ty2-4.nigirocloud.com,18,0.01%,18,0,100.00%
os2-4.nigirocloud.com,18,0.01%,18,0,100.00%
nl1-4.nigirocloud.com,18,0.01%,18,0,100.00%
nl1-7.nigirocloud.com,18,0.01%,18,0,100.00%
nl3-2.nigirocloud.com,18,0.01%,18,0,100.00%
nl3-3.nigirocloud.com,18,0.01%,18,0,100.00%
nl3-6.nigirocloud.com,18,0.01%,18,0,100.00%
uk1-2.nigirocloud.com,18,0.01%,18,0,100.00%
www.tm.a.prd.aadg.trafficmanager.net,18,0.01%,18,0,100.00%
vtnt.cnode.xyz,18,0.01%,18,0,100.00%
api.insight.synology.com,18,0.01%,18,0,100.00%
array811.prod.do.dsp.mp.microsoft.com,18,0.01%,18,0,100.00%
dcldshlupt.alicdn.com.danuoyi.tbcache.com,18,0.01%,18,0,100.00%
tracker.opentrackr.org,18,0.01%,18,0,100.00%
bgpv4.music.ntes53.netease.com,18,0.01%,18,0,100.00%
os1-6.nigirocloud.com,18,0.01%,18,0,100.00%
os2-5.nigirocloud.com,18,0.01%,18,0,100.00%
new.weibo.cn,18,0.01%,18,0,100.00%
nk5.boom.skin,18,0.01%,18,0,100.00%
nsl.lenovo.com.cn,18,0.01%,18,0,100.00%
color.docer.wps.cn,18,0.01%,18,0,100.00%
2.rhel.pool.ntp.org,18,0.01%,18,0,100.00%
diana.ie.sogou.com,18,0.01%,18,0,100.00%
hsk-api.oray.com,18,0.01%,18,0,100.00%
de2-2.nigirocloud.com,18,0.01%,18,0,100.00%
us1-4.nigirocloud.com,18,0.01%,18,0,100.00%
f5-ck.zhhainiao.com,18,0.01%,18,0,100.00%
ee1-3.nigirocloud.com,18,0.01%,18,0,100.00%
array507.prod.do.dsp.mp.microsoft.com,18,0.01%,18,0,100.00%
tw02.ipv2.xyz,18,0.01%,18,0,100.00%
t15.baidu.com,18,0.01%,21,3,85.71%
firebaselogging-pa.googleapis.com,18,0.01%,21,3,85.71%
exmail.qq.com,18,0.01%,18,0,100.00%
ah.yd01.paopaocloud.cyou,18,0.01%,18,0,100.00%
shuc-other.ksord.com,17,0.01%,17,0,100.00%
df.cache.wpscdn.cn,17,0.01%,29,12,58.62%
tracker3.itzmx.com,17,0.01%,17,0,100.00%
video-tx-drcn.dbankcdn.cn,17,0.01%,35,18,48.57%
os1-8.nigirocloud.com,17,0.01%,17,0,100.00%
os2-7.nigirocloud.com,17,0.01%,17,0,100.00%
nl1-3.nigirocloud.com,17,0.01%,17,0,100.00%
nl1-5.nigirocloud.com,17,0.01%,17,0,100.00%
nl1-6.nigirocloud.com,17,0.01%,17,0,100.00%
nl3-1.nigirocloud.com,17,0.01%,17,0,100.00%
nl3-4.nigirocloud.com,17,0.01%,17,0,100.00%
nl3-7.nigirocloud.com,17,0.01%,17,0,100.00%
uk1-1.nigirocloud.com,17,0.01%,17,0,100.00%
uk1-3.nigirocloud.com,17,0.01%,17,0,100.00%
uk1-4.nigirocloud.com,17,0.01%,17,0,100.00%
guzzoni.apple.com,17,0.01%,17,0,100.00%
iris-de-prod-azsc-eas-b.eastasia.cloudapp.azure.com,17,0.01%,17,0,100.00%
wns.notify.trafficmanager.net,17,0.01%,38,21,44.74%
signaler-pa.clients6.google.com,17,0.01%,34,17,50.00%
public-cdn.cloud.unitychina.cn,17,0.01%,17,0,100.00%
webquoteklinepic.eastmoney.com,17,0.01%,17,0,100.00%
mm.ilovescholar.xyz,17,0.01%,17,0,100.00%
valid.apple.com,17,0.01%,17,0,100.00%
am.abc.wdpdk.link,17,0.01%,17,0,100.00%
hao.lenovo.com.cn,17,0.01%,17,0,100.00%
n37.boom.skin,17,0.01%,17,0,100.00%
n17.boom.skin,17,0.01%,17,0,100.00%
n11.boom.skin,17,0.01%,17,0,100.00%
n13.boom.skin,17,0.01%,17,0,100.00%
nf6.boom.skin,17,0.01%,17,0,100.00%
nf10.boom.skin,17,0.01%,17,0,100.00%
nf11.boom.skin,17,0.01%,17,0,100.00%
nf5.boom.skin,17,0.01%,17,0,100.00%
nf9.boom.skin,17,0.01%,17,0,100.00%
nf8.boom.skin,17,0.01%,17,0,100.00%
nf2.boom.skin,17,0.01%,17,0,100.00%
nf1.boom.skin,17,0.01%,17,0,100.00%
nf7.boom.skin,17,0.01%,17,0,100.00%
nf3.boom.skin,17,0.01%,17,0,100.00%
nf4.boom.skin,17,0.01%,17,0,100.00%
mesu.apple.com,17,0.01%,36,19,47.22%
time1.cloud.tencent.com,17,0.01%,17,0,100.00%
storecatalogrevocation.storequality.microsoft.com,17,0.01%,17,0,100.00%
upload.fp.measure.office.com,17,0.01%,32,15,53.12%
bizapi.csdn.net,17,0.01%,17,0,100.00%
ty2-5.nigirocloud.com,17,0.01%,17,0,100.00%
r3.o.lencr.org,17,0.01%,36,19,47.22%
dup.baidustatic.com,17,0.01%,17,0,100.00%
update.nsfocus.com,17,0.01%,17,0,100.00%
luckyvideo.peopletech.cn,17,0.01%,17,0,100.00%
cn-sh.sasg4e.ccddns.lol,17,0.01%,17,0,100.00%
cn-shenzhen.axt.aliyun.com,17,0.01%,17,0,100.00%
ncc.avast.com,16,0.01%,35,19,45.71%
pgyapi.oray.net,16,0.01%,16,0,100.00%
metrics1.data.hicloud.com,16,0.01%,16,0,100.00%
tracker.vanitycore.co,16,0.01%,28,12,57.14%
plussvr.wps.cn,16,0.01%,16,0,100.00%
hovv.yilanvaas.com,16,0.01%,38,22,42.11%
mail.126.com,16,0.01%,16,0,100.00%
c.msn.cn,16,0.01%,16,0,100.00%
os2-3.nigirocloud.com,16,0.01%,16,0,100.00%
nl3-5.nigirocloud.com,16,0.01%,16,0,100.00%
cs.dds.microsoft.com,16,0.01%,16,0,100.00%
waws-prod-sg1-051.cloudapp.net,16,0.01%,16,0,100.00%
ins-59d1h3tv.ias.tencent-cloud.net,16,0.01%,30,14,53.33%
reswx.tc.qq.com,16,0.01%,18,2,88.89%
aoufnebg.dayugslb.com,16,0.01%,16,0,100.00%
ds.kaspersky.com,16,0.01%,16,0,100.00%
mx.cstnet.cn,16,0.01%,16,0,100.00%
ty2-7.nigirocloud.com,16,0.01%,16,0,100.00%
dcdnhub.xfs.xcloud.sandai.net,16,0.01%,16,0,100.00%
router-default.apps.openshift4.gnome.org,16,0.01%,29,13,55.17%
s105.boom.skin,16,0.01%,16,0,100.00%
n96.boom.skin,16,0.01%,16,0,100.00%
ntemp01.boom.skin,16,0.01%,16,0,100.00%
miserupdate.aliyun.com,16,0.01%,16,0,100.00%
blades.aliyun.com,16,0.01%,16,0,100.00%
hashcloud.cz,16,0.01%,16,0,100.00%
pancake.apple.com,16,0.01%,16,0,100.00%
vinci.ie.sogou.com,16,0.01%,16,0,100.00%
bvc.bilivideo.com,16,0.01%,16,0,100.00%
n119.boom.skin,16,0.01%,16,0,100.00%
s100.boom.skin,16,0.01%,16,0,100.00%
nk9.boom.skin,16,0.01%,16,0,100.00%
n06.boom.skin,16,0.01%,16,0,100.00%
n57.boom.skin,16,0.01%,16,0,100.00%
nje.boom.skin,16,0.01%,16,0,100.00%
nm4.boom.skin,16,0.01%,16,0,100.00%
map.baidu.com,16,0.01%,41,25,39.02%
beacon.tingyun.com,16,0.01%,16,0,100.00%
cstm.baidu.com,16,0.01%,16,0,100.00%
silkroad.csdn.net,16,0.01%,16,0,100.00%
feilian-staging.bytedance.com,16,0.01%,16,0,100.00%
appcfg.v.qq.com,16,0.01%,16,0,100.00%
edge.activity.windows.com,16,0.01%,16,0,100.00%
dl.ijinshan.com,16,0.01%,16,0,100.00%
mail.nfschina.com,16,0.01%,16,0,100.00%
blobcollector.events.data.trafficmanager.NET,16,0.01%,18,2,88.89%
cdn-node.cn.cm.foshan-03.nekocloud.cn,16,0.01%,16,0,100.00%
image.sinajs.cn,16,0.01%,35,19,45.71%
message.bilibili.com,16,0.01%,29,13,55.17%
ipv6.l.google.com,16,0.01%,40,24,40.00%
alpha-cloud-log.cn-hangzhou.log.aliyuncs.com,16,0.01%,16,0,100.00%
www.n1ui5fms.net,16,0.01%,16,0,100.00%
security.bilibili.com,16,0.01%,16,0,100.00%
advanced-cm-2.nodesub.com,16,0.01%,16,0,100.00%
advanced-cm-1.nodesub.com,16,0.01%,16,0,100.00%
cn-bing-com.cn.a-0001.a-msedge.net,15,0.01%,16,1,93.75%
googlehosted.l.googleusercontent.com,15,0.01%,24,9,62.50%
outlook.ms-acdc.office.com,15,0.01%,29,14,51.72%
prod-w.nexus.live.com.akadns.net,15,0.01%,15,0,100.00%
edge.microsoft.com,15,0.01%,621,606,2.42%
upos-sz-mirrorcoso1.bilivideo.com,15,0.01%,29,14,51.72%
beacons3.gvt2.com,15,0.01%,15,0,100.00%
open.qurl.f.360.cn,15,0.01%,15,0,100.00%
wn.pos.baidu.com,15,0.01%,15,0,100.00%
hq.sinajs.cn,15,0.01%,15,0,100.00%
pis-pcdn.youku.com,15,0.01%,15,0,100.00%
vps02.net.orel.ru,15,0.01%,15,0,100.00%
download.pinyin.sogou.com,15,0.01%,15,0,100.00%
puui.qpic.cn,15,0.01%,15,0,100.00%
browser.events.data.msn.cn,15,0.01%,18,3,83.33%
nl1-1.nigirocloud.com,15,0.01%,15,0,100.00%
nl1-2.nigirocloud.com,15,0.01%,15,0,100.00%
jp04.v2netapp.com,15,0.01%,15,0,100.00%
public-treatment.prod-experimentation.grammarlyaws.com,15,0.01%,15,0,100.00%
browser.360.cn.qh-cdn.com,15,0.01%,16,1,93.75%
imap.163.com,15,0.01%,15,0,100.00%
2csvr-basic.wpsdns.com,15,0.01%,15,0,100.00%
jtypkz2w.sched.d2.tdnsdp1.cn.cjt.vwnti.yrzhcloud.cn,15,0.01%,15,0,100.00%
oauth.account.jetbrains.com,15,0.01%,15,0,100.00%
dotserver.douyucdn.cn,15,0.01%,15,0,100.00%
img0yjvjvvuvw.cdn.cache102.xyz,15,0.01%,15,0,100.00%
e8218.dscb1.akamaiedge.net,15,0.01%,32,17,46.88%
datacluster2.cipsup.cn,15,0.01%,15,0,100.00%
tracker.istole.it,15,0.01%,15,0,100.00%
n116.boom.skin,15,0.01%,15,0,100.00%
n48.boom.skin,15,0.01%,15,0,100.00%
us10.edge.boom.skin,15,0.01%,15,0,100.00%
us1.edge.boom.skin,15,0.01%,15,0,100.00%
s102.boom.skin,15,0.01%,15,0,100.00%
s103.boom.skin,15,0.01%,15,0,100.00%
us4.edge.boom.skin,15,0.01%,15,0,100.00%
s104.boom.skin,15,0.01%,15,0,100.00%
s01.boom.skin,15,0.01%,15,0,100.00%
n110.boom.skin,15,0.01%,15,0,100.00%
n27.boom.skin,15,0.01%,15,0,100.00%
n63.boom.skin,15,0.01%,15,0,100.00%
n92.boom.skin,15,0.01%,15,0,100.00%
n77.boom.skin,15,0.01%,15,0,100.00%
n60.boom.skin,15,0.01%,15,0,100.00%
n100.boom.skin,15,0.01%,15,0,100.00%
ntemp25.boom.skin,15,0.01%,15,0,100.00%
nk3.boom.skin,15,0.01%,15,0,100.00%
nk4.boom.skin,15,0.01%,15,0,100.00%
1.ubuntu.pool.ntp.org,15,0.01%,15,0,100.00%
0.cn.pool.ntp.org,15,0.01%,15,0,100.00%
glacial-ravine-7295.morning-tundra-7160.herokuspace.com,15,0.01%,15,0,100.00%
stats.g.doubleclick.net,15,0.01%,15,0,100.00%
s.symcb.com,15,0.01%,30,15,50.00%
g.live.com,15,0.01%,24,9,62.50%
c124a10e0db5e4b9.jijifun.com,15,0.01%,15,0,100.00%
nl7.boom.skin,15,0.01%,15,0,100.00%
nl9.boom.skin,15,0.01%,15,0,100.00%
ntemp15.boom.skin,15,0.01%,15,0,100.00%
nl8.boom.skin,15,0.01%,15,0,100.00%
ntemp10.boom.skin,15,0.01%,15,0,100.00%
n115.boom.skin,15,0.01%,15,0,100.00%
n23.boom.skin,15,0.01%,15,0,100.00%
nj6.boom.skin,15,0.01%,15,0,100.00%
nj7.boom.skin,15,0.01%,15,0,100.00%
nj8.boom.skin,15,0.01%,15,0,100.00%
nj9.boom.skin,15,0.01%,15,0,100.00%
nja.boom.skin,15,0.01%,15,0,100.00%
njb.boom.skin,15,0.01%,15,0,100.00%
njc.boom.skin,15,0.01%,15,0,100.00%
njd.boom.skin,15,0.01%,15,0,100.00%
nk8.boom.skin,15,0.01%,15,0,100.00%
nm8.boom.skin,15,0.01%,15,0,100.00%
nm5.boom.skin,15,0.01%,15,0,100.00%
nm6.boom.skin,15,0.01%,15,0,100.00%
nm7.boom.skin,15,0.01%,15,0,100.00%
nl1.boom.skin,15,0.01%,15,0,100.00%
nka.boom.skin,15,0.01%,15,0,100.00%
nkb.boom.skin,15,0.01%,15,0,100.00%
nkc.boom.skin,15,0.01%,15,0,100.00%
nkd.boom.skin,15,0.01%,15,0,100.00%
nke.boom.skin,15,0.01%,15,0,100.00%
nl4.boom.skin,15,0.01%,15,0,100.00%
nl2.boom.skin,15,0.01%,15,0,100.00%
nl3.boom.skin,15,0.01%,15,0,100.00%
n170.boom.skin,15,0.01%,15,0,100.00%
nj3.boom.skin,15,0.01%,15,0,100.00%
nj1.boom.skin,15,0.01%,15,0,100.00%
nj2.boom.skin,15,0.01%,15,0,100.00%
nl5.boom.skin,15,0.01%,15,0,100.00%
nm9.boom.skin,15,0.01%,15,0,100.00%
nma.boom.skin,15,0.01%,15,0,100.00%
nj4.boom.skin,15,0.01%,15,0,100.00%
nl6.boom.skin,15,0.01%,15,0,100.00%
apple-finance.query.yahoo.com,15,0.01%,15,0,100.00%
9.push2his.eastmoney.com,15,0.01%,15,0,100.00%
post.ksosoft.com,15,0.01%,15,0,100.00%
d2kaokxjvx18eu.cloudfront.net,15,0.01%,15,0,100.00%
devlog.ys7.com,15,0.01%,15,0,100.00%
us1-2.nigirocloud.com,15,0.01%,15,0,100.00%
kunpeng.csdn.net,15,0.01%,15,0,100.00%
tp.m-team.cc,15,0.01%,40,25,37.50%
pic.people.com.cn,15,0.01%,66,51,22.73%
v10.vortex-win.data.microsoft.com,15,0.01%,15,0,100.00%
17.push2his.eastmoney.com,15,0.01%,15,0,100.00%
zhihu-web-analytics.zhihu.com,15,0.01%,22,7,68.18%
ceea167a5a36dedd.jijifun.com,15,0.01%,15,0,100.00%
als.baidu.com,15,0.01%,15,0,100.00%
ssl.google-analytics.com,15,0.01%,17,2,88.24%
fc-ccimage.baidu.com,15,0.01%,15,0,100.00%
chihaya-heroku.120181311.xyz,15,0.01%,22,7,68.18%
repo.openeuler.org,15,0.01%,15,0,100.00%
android.l.google.com,14,0.01%,14,0,100.00%
wd-prod-ss.trafficmanager.net,14,0.01%,14,0,100.00%
umwatson.events.data.microsoft.com,14,0.01%,14,0,100.00%
k8s.gcr.io,14,0.01%,618,604,2.27%
array608.prod.do.dsp.mp.microsoft.com,14,0.01%,14,0,100.00%
beacons.gvt2.com,14,0.01%,36,22,38.89%
beacons2.gvt2.com,14,0.01%,15,1,93.33%
gateway.icloud.com,14,0.01%,28,14,50.00%
9.rarbg.com,14,0.01%,14,0,100.00%
restapi.amap.com,14,0.01%,14,0,100.00%
notifier-configs.airbrake.io,14,0.01%,29,15,48.28%
tracker.zemoj.com,14,0.01%,14,0,100.00%
pic.rmb.bdstatic.com,14,0.01%,15,1,93.33%
mcs.snssdk.com,14,0.01%,27,13,51.85%
t12.baidu.com,14,0.01%,18,4,77.78%
vv.video.qq.com,14,0.01%,14,0,100.00%
nl1-8.nigirocloud.com,14,0.01%,14,0,100.00%
asf-ris-prod-easia-azsc.eastasia.cloudapp.azure.com,14,0.01%,14,0,100.00%
k256.gslb.ksyuncdn.com,14,0.01%,14,0,100.00%
init.itunes.apple.com,14,0.01%,22,8,63.64%
na61-na62.wagbridge.alibaba.alibaba.com,14,0.01%,28,14,50.00%
cs22.wpc.v0cdn.net,14,0.01%,14,0,100.00%
4005f8da13f42943.jijifun.com,14,0.01%,14,0,100.00%
e15275.g.akamaiedge.net,14,0.01%,14,0,100.00%
a1887.dscq.akamai.net,14,0.01%,28,14,50.00%
ts.helper.2345.cc,14,0.01%,14,0,100.00%
array615.prod.do.dsp.mp.microsoft.com,14,0.01%,14,0,100.00%
api.mixpanel.com,14,0.01%,14,0,100.00%
pop.ie.sogou.com,14,0.01%,14,0,100.00%
static-pcs-sdk-server.alibaba.com,14,0.01%,22,8,63.64%
fe2cr.update.microsoft.com,14,0.01%,29,15,48.28%
upos-sz-mirrorhwo1.bilivideo.com,14,0.01%,18,4,77.78%
res.ldmnq.com,14,0.01%,14,0,100.00%
us6.edge.boom.skin,14,0.01%,14,0,100.00%
us7.edge.boom.skin,14,0.01%,14,0,100.00%
ntemp09.boom.skin,14,0.01%,14,0,100.00%
n47.boom.skin,14,0.01%,14,0,100.00%
us8.edge.boom.skin,14,0.01%,14,0,100.00%
us9.edge.boom.skin,14,0.01%,14,0,100.00%
mesu-china.apple.com.akadns.net,14,0.01%,30,16,46.67%
53.push2his.eastmoney.com,14,0.01%,14,0,100.00%
notify.adobe.io,14,0.01%,14,0,100.00%
opencdnbd.jomodns.com,14,0.01%,17,3,82.35%
ntp.msn.cn,14,0.01%,15,1,93.33%
nm3.boom.skin,14,0.01%,14,0,100.00%
nla.boom.skin,14,0.01%,14,0,100.00%
s101.boom.skin,14,0.01%,14,0,100.00%
n61.boom.skin,14,0.01%,14,0,100.00%
n67.boom.skin,14,0.01%,14,0,100.00%
n74.boom.skin,14,0.01%,14,0,100.00%
nm1.boom.skin,14,0.01%,14,0,100.00%
jp16.boom.skin,14,0.01%,14,0,100.00%
n30.boom.skin,14,0.01%,14,0,100.00%
n62.boom.skin,14,0.01%,14,0,100.00%
ntemp07.boom.skin,14,0.01%,14,0,100.00%
ntemp18.boom.skin,14,0.01%,14,0,100.00%
n04.boom.skin,14,0.01%,14,0,100.00%
xcx.www.gov.cn,14,0.01%,14,0,100.00%
apis.mosaic.analytics.awscommon.mcafee.com,14,0.01%,14,0,100.00%
passport.m3guo.com,14,0.01%,14,0,100.00%
rs-ny.rustdesk.com,14,0.01%,14,0,100.00%
msg.csdn.net,14,0.01%,14,0,100.00%
upmobile.v.qq.com,14,0.01%,14,0,100.00%
mambap2pvodh5.8686c.com,14,0.01%,14,0,100.00%
ocsp2-cn-lb.apple.com.akadns.net,14,0.01%,17,3,82.35%
serviceplus.phytium.com.cn,14,0.01%,14,0,100.00%
dtapp-pub.dingtalk.com,14,0.01%,14,0,100.00%
ms.bdimg.com,14,0.01%,14,0,100.00%
login.partner.microsoftonline.cn,14,0.01%,14,0,100.00%
g.ceipmsn.com,14,0.01%,14,0,100.00%
download.api.bsb.baidu.com,14,0.01%,14,0,100.00%
mt.lenovo.com.cn,14,0.01%,14,0,100.00%
btrace.video.qq.com,14,0.01%,14,0,100.00%
a-0001.a-msedge.net,13,0.01%,26,13,50.00%
pico.gtm.eset.com,13,0.01%,13,0,100.00%
weather-data.apple.com.akadns.net,13,0.01%,22,9,59.09%
notify3.note.youdao.com,13,0.01%,23,10,56.52%
wxapp.tc.qq.com,13,0.01%,28,15,46.43%
long.iwifi.360.cn,13,0.01%,13,0,100.00%
www.bilibili.com,13,0.01%,15,2,86.67%
mini.360.cn,13,0.01%,18,5,72.22%
data.hicloud.com,13,0.01%,13,0,100.00%
linux.kite.com,13,0.01%,62,49,20.97%
captcha.gtimg.com,13,0.01%,14,1,92.86%
contentsec.ac.cn,13,0.01%,13,0,100.00%
offlintab.firefoxchina.cn.wscdns.com,13,0.01%,13,0,100.00%
t11.baidu.com,13,0.01%,15,2,86.67%
cdn.jsdelivr.net,13,0.01%,28,15,46.43%
na61-na62.wagbridge.alibaba.alibaba.com.gds.alibabadns.com,13,0.01%,13,0,100.00%
time.ys7.com,13,0.01%,13,0,100.00%
gecko-bd.feishu.cn.w.cdngslb.com,13,0.01%,13,0,100.00%
i0.hdslb.com,13,0.01%,30,17,43.33%
2.pool.ntp.org,13,0.01%,25,12,52.00%
dns.rubyfish.cn,13,0.01%,13,0,100.00%
271509e17755a70d683b7f40cdb3eec6df604067.u.fdmpkg.org,13,0.01%,13,0,100.00%
rm-bp151dcc75aycqd80to.mysql.rds.aliyuncs.com,13,0.01%,13,0,100.00%
weather.kjjs.360.cn,13,0.01%,13,0,100.00%
stdtime.gov.hk,13,0.01%,13,0,100.00%
www.mi.com,13,0.01%,29,16,44.83%
www.vod.lxdns.com,13,0.01%,26,13,50.00%
smartdl.lenovo.com.cn,13,0.01%,13,0,100.00%
n22.boom.skin,13,0.01%,13,0,100.00%
n05.boom.skin,13,0.01%,13,0,100.00%
us5.edge.boom.skin,13,0.01%,13,0,100.00%
us2.edge.boom.skin,13,0.01%,13,0,100.00%
us3.edge.boom.skin,13,0.01%,13,0,100.00%
array807.prod.do.dsp.mp.microsoft.com,13,0.01%,13,0,100.00%
onedscolprdeus09.eastus.cloudapp.azure.com,13,0.01%,13,0,100.00%
quote.eastmoney.com,13,0.01%,28,15,46.43%
fp.msedge.net,13,0.01%,13,0,100.00%
pic2.zhimg.com,13,0.01%,18,5,72.22%
www.googletagmanager.com,13,0.01%,13,0,100.00%
lf3-cdn-tos.bytegoofy.com.w.alikunlun.com,13,0.01%,15,2,86.67%
n54.boom.skin,13,0.01%,13,0,100.00%
n32.boom.skin,13,0.01%,13,0,100.00%
nm2.boom.skin,13,0.01%,13,0,100.00%
nn12.boom.skin,13,0.01%,13,0,100.00%
n111.boom.skin,13,0.01%,13,0,100.00%
n117.boom.skin,13,0.01%,13,0,100.00%
jp6.boom.skin,13,0.01%,13,0,100.00%
jp15.boom.skin,13,0.01%,13,0,100.00%
n93.boom.skin,13,0.01%,13,0,100.00%
jp17.boom.skin,13,0.01%,13,0,100.00%
jp18.boom.skin,13,0.01%,13,0,100.00%
jp20.boom.skin,13,0.01%,13,0,100.00%
jp7.boom.skin,13,0.01%,13,0,100.00%
jp8.boom.skin,13,0.01%,13,0,100.00%
jp9.boom.skin,13,0.01%,13,0,100.00%
nn5.boom.skin,13,0.01%,13,0,100.00%
jp19.boom.skin,13,0.01%,13,0,100.00%
nn6.boom.skin,13,0.01%,13,0,100.00%
jp2.boom.skin,13,0.01%,13,0,100.00%
jp1.boom.skin,13,0.01%,13,0,100.00%
nn7.boom.skin,13,0.01%,13,0,100.00%
jp3.boom.skin,13,0.01%,13,0,100.00%
jp5.boom.skin,13,0.01%,13,0,100.00%
nn14.boom.skin,13,0.01%,13,0,100.00%
nn4.boom.skin,13,0.01%,13,0,100.00%
jp4.boom.skin,13,0.01%,13,0,100.00%
jp10.boom.skin,13,0.01%,13,0,100.00%
jp11.boom.skin,13,0.01%,13,0,100.00%
jp12.boom.skin,13,0.01%,13,0,100.00%
jp13.boom.skin,13,0.01%,13,0,100.00%
jp14.boom.skin,13,0.01%,13,0,100.00%
nn1.boom.skin,13,0.01%,13,0,100.00%
nn2.boom.skin,13,0.01%,13,0,100.00%
nn3.boom.skin,13,0.01%,13,0,100.00%
n24.boom.skin,13,0.01%,13,0,100.00%
nmb.boom.skin,13,0.01%,13,0,100.00%
nmc.boom.skin,13,0.01%,13,0,100.00%
nn13.boom.skin,13,0.01%,13,0,100.00%
nn8.boom.skin,13,0.01%,13,0,100.00%
nn9.boom.skin,13,0.01%,13,0,100.00%
nna.boom.skin,13,0.01%,13,0,100.00%
nn11.boom.skin,13,0.01%,13,0,100.00%
opt22.boom.skin,13,0.01%,13,0,100.00%
opt21.boom.skin,13,0.01%,13,0,100.00%
opt23.boom.skin,13,0.01%,13,0,100.00%
opt9.boom.skin,13,0.01%,13,0,100.00%
opt24.boom.skin,13,0.01%,13,0,100.00%
opt25.boom.skin,13,0.01%,13,0,100.00%
opt26.boom.skin,13,0.01%,13,0,100.00%
opt8.boom.skin,13,0.01%,13,0,100.00%
opt2.boom.skin,13,0.01%,13,0,100.00%
opt10.boom.skin,13,0.01%,13,0,100.00%
opt11.boom.skin,13,0.01%,13,0,100.00%
opt12.boom.skin,13,0.01%,13,0,100.00%
opt6.boom.skin,13,0.01%,13,0,100.00%
opt15.boom.skin,13,0.01%,13,0,100.00%
opt13.boom.skin,13,0.01%,13,0,100.00%
opt14.boom.skin,13,0.01%,13,0,100.00%
opt1.boom.skin,13,0.01%,13,0,100.00%
opt16.boom.skin,13,0.01%,13,0,100.00%
opt3.boom.skin,13,0.01%,13,0,100.00%
opt4.boom.skin,13,0.01%,13,0,100.00%
opt5.boom.skin,13,0.01%,13,0,100.00%
opt7.boom.skin,13,0.01%,13,0,100.00%
opt18.boom.skin,13,0.01%,13,0,100.00%
opt17.boom.skin,13,0.01%,13,0,100.00%
opt19.boom.skin,13,0.01%,13,0,100.00%
opt20.boom.skin,13,0.01%,13,0,100.00%
nj5.boom.skin,13,0.01%,13,0,100.00%
n28.boom.skin,13,0.01%,13,0,100.00%
gs-loc-cn.apple.com,13,0.01%,13,0,100.00%
api.live.bilibili.com,13,0.01%,13,0,100.00%
profile.csdnimg.cn,13,0.01%,13,0,100.00%
mediator.goodsync.com,13,0.01%,13,0,100.00%
file.drivergenius.com,13,0.01%,13,0,100.00%
odc.officeapps.live.com,13,0.01%,13,0,100.00%
wu-bg-shim.trafficmanager.NET,13,0.01%,14,1,92.86%
d1ucxc6xi3jabg.cloudfront.net,13,0.01%,13,0,100.00%
f7.baidu.com,13,0.01%,14,1,92.86%
fe2cr.update.msft.com.trafficmanager.net,12,0.01%,24,12,50.00%
d20wxjqjgi3st.cloudfront.net,12,0.01%,24,12,50.00%
internal-api.feishu.cn,12,0.01%,12,0,100.00%
steamcdn-a.akamaihd.net,12,0.01%,12,0,100.00%
www.csdn.net,12,0.01%,12,0,100.00%
fa000000105.resources.office.net,12,0.01%,25,13,48.00%
bn02pap001.storage.live.com,12,0.01%,16,4,75.00%
gss0.bdstatic.com,12,0.01%,12,0,100.00%
cpro.baidustatic.com,12,0.01%,21,9,57.14%
kstj.baidu.com,12,0.01%,12,0,100.00%
g.alicdn.com,12,0.01%,22,10,54.55%
cdn1.ime.sogou.com,12,0.01%,12,0,100.00%
venus.douyucdn.cn,12,0.01%,12,0,100.00%
events.gfe.nvidia.com,12,0.01%,12,0,100.00%
alb-wy5mqfy1o52wprnwel.cn-hangzhou.alb.aliyuncs.com,12,0.01%,12,0,100.00%
d33vwaa6rdensn.cloudfront.net,12,0.01%,13,1,92.31%
clients2.googleusercontent.com,12,0.01%,12,0,100.00%
nl3-8.nigirocloud.com,12,0.01%,12,0,100.00%
fsrcn.lenovomm.com,12,0.01%,12,0,100.00%
dldir1.legao.sched.dcloudstc.com,12,0.01%,12,0,100.00%
datarouter-weighted.ol.epicgames.com,12,0.01%,12,0,100.00%
wildcard.weather.microsoft.com.edgekey.net,12,0.01%,12,0,100.00%
0.pool.ntp.org,12,0.01%,12,0,100.00%
keyvalueservice.icloud.com.cn,12,0.01%,12,0,100.00%
api.appcues.net,12,0.01%,12,0,100.00%
1.pool.ntp.org,12,0.01%,12,0,100.00%
0.asia.pool.ntp.org,12,0.01%,12,0,100.00%
crl.certum.pl,12,0.01%,23,11,52.17%
array601.prod.do.dsp.mp.microsoft.com,12,0.01%,12,0,100.00%
vault.centos.org,12,0.01%,24,12,50.00%
tsbrowser.xiangtatech.com,12,0.01%,12,0,100.00%
d.dropbox.com,12,0.01%,25,13,48.00%
dl.pop.www.duba.net,12,0.01%,12,0,100.00%
11.benhuapp.com,12,0.01%,12,0,100.00%
s1.symcb.com,12,0.01%,23,11,52.17%
appsso.oh.isrc.ac.cn,12,0.01%,12,0,100.00%
img-s-msn-com.akamaized.net,12,0.01%,26,14,46.15%
video.yidianzixun.com,12,0.01%,12,0,100.00%
geover.prod.do.dsp.mp.microsoft.com,12,0.01%,12,0,100.00%
ntemp08.boom.skin,12,0.01%,12,0,100.00%
edf.eset.com,12,0.01%,12,0,100.00%
down.anticheatexpert.com,12,0.01%,12,0,100.00%
bdstatic.eastmoney.com,12,0.01%,12,0,100.00%
bdstatics.eastmoney.com,12,0.01%,12,0,100.00%
bdwblog.eastmoney.com,12,0.01%,12,0,100.00%
89.push2his.eastmoney.com,12,0.01%,12,0,100.00%
picx.zhimg.com,12,0.01%,19,7,63.16%
eopa.n.shifen.com,12,0.01%,16,4,75.00%
lf3-cdn-tos.bytescm.com.w.alikunlun.com,12,0.01%,14,2,85.71%
xxbg.snssdk.com.w.cdngslb.com,12,0.01%,12,0,100.00%
www-googletagmanager.l.google.com,12,0.01%,18,6,66.67%
0.ubuntu.pool.ntp.org,12,0.01%,12,0,100.00%
63.push2his.eastmoney.com,12,0.01%,12,0,100.00%
ntemp16.boom.skin,12,0.01%,12,0,100.00%
ntemp17.boom.skin,12,0.01%,12,0,100.00%
ntemp19.boom.skin,12,0.01%,12,0,100.00%
ntemp20.boom.skin,12,0.01%,12,0,100.00%
n43.boom.skin,12,0.01%,12,0,100.00%
ntemp02.boom.skin,12,0.01%,12,0,100.00%
ntemp03.boom.skin,12,0.01%,12,0,100.00%
ntemp04.boom.skin,12,0.01%,12,0,100.00%
ntemp05.boom.skin,12,0.01%,12,0,100.00%
ntemp06.boom.skin,12,0.01%,12,0,100.00%
dc.applicationinsights.microsoft.com,12,0.01%,12,0,100.00%
global.in.ai.monitor.azure.com,12,0.01%,12,0,100.00%
dc.trafficmanager.net,12,0.01%,12,0,100.00%
www.tm.a.prd.aadg.akadns.net,12,0.01%,12,0,100.00%
array616.prod.do.dsp.mp.microsoft.com,12,0.01%,12,0,100.00%
21.push2his.eastmoney.com,12,0.01%,12,0,100.00%
array614.prod.do.dsp.mp.microsoft.com,12,0.01%,12,0,100.00%
nat-port-1.verysync.cn,12,0.01%,12,0,100.00%
api.weibo.cn,12,0.01%,34,22,35.29%
www.tm.ak.prd.aadg.akadns.net,12,0.01%,12,0,100.00%
p2.shared.global.fastly.net,12,0.01%,12,0,100.00%
stun.xten.com,12,0.01%,12,0,100.00%
www.baidupcs.com,12,0.01%,12,0,100.00%
78.push2his.eastmoney.com,12,0.01%,12,0,100.00%
60.push2his.eastmoney.com,12,0.01%,12,0,100.00%
tw01.ipv2.xyz,12,0.01%,12,0,100.00%
l5-global.gslb.ksyuncdn.com,12,0.01%,12,0,100.00%
xsts.auth.xboxlive.com,12,0.01%,12,0,100.00%
gimg4.baidu.com,12,0.01%,14,2,85.71%
teams.events.data.microsoft.com,12,0.01%,12,0,100.00%
10.rarbg.com,12,0.01%,12,0,100.00%
12.rarbg.me,12,0.01%,12,0,100.00%
cv.duba.net,12,0.01%,12,0,100.00%
fonts.googleapis.com,12,0.01%,16,4,75.00%
dotbeats.douyucdn.cn,12,0.01%,12,0,100.00%
news.hexun.com,12,0.01%,12,0,100.00%
ksn-tcert-geo.kaspersky-labs.com,12,0.01%,12,0,100.00%
tile-service.weather.msn.cn,12,0.01%,12,0,100.00%
forw-sfo1.goodsync.com,12,0.01%,12,0,100.00%
r1---sn-2x3elnez.gvt1.com,12,0.01%,12,0,100.00%
aserver-heyi.m.taobao.com,12,0.01%,12,0,100.00%
sqm.telemetry.microsoft.com,12,0.01%,12,0,100.00%
apigate.10jqka.com.cn,12,0.01%,12,0,100.00%
steamstore-a.akamaihd.net,12,0.01%,12,0,100.00%
8d0968d6458e0ad0.jijifun.com,12,0.01%,12,0,100.00%
2535-ipv4e.clump.dprodmgd106.aa-rt.sharepoint.com,12,0.01%,12,0,100.00%
array509.prod.do.dsp.mp.microsoft.com,11,0.01%,11,0,100.00%
HND-efz.ms-acdc.office.com,11,0.01%,22,11,50.00%
gitea.com,11,0.01%,11,0,100.00%
dl.360safe.com,11,0.01%,31,20,35.48%
pico.eset.com,11,0.01%,11,0,100.00%
dsm01pap006.storage.live.com,11,0.01%,21,10,52.38%
onedscolprdwus05.westus.cloudapp.azure.com,11,0.01%,22,11,50.00%
vweixinf.tc.qq.com,11,0.01%,24,13,45.83%
flux.hcdn.qiyi.com,11,0.01%,11,0,100.00%
tracker.internetwarriors.net,11,0.01%,11,0,100.00%
static.mysmth.net,11,0.01%,19,8,57.89%
passport.baidu.com,11,0.01%,30,19,36.67%
bluedot.is.autonavi.com.gds.alibabadns.com,11,0.01%,11,0,100.00%
crteam.cn,11,0.01%,11,0,100.00%
alert-cn.battlenet.com.cn,11,0.01%,11,0,100.00%
init-china.itunes-apple.com.akadns.net,11,0.01%,22,11,50.00%
cipv6gn.v.trpcdn.net,11,0.01%,22,11,50.00%
browser.360.cn.ucloud.com.cn,11,0.01%,11,0,100.00%
expressapisv2.net,11,0.01%,24,13,45.83%
dataflow.biliapi.com.dy.galileo.jcloud-cdn.com,11,0.01%,11,0,100.00%
settings-prod-sea-1.southeastasia.cloudapp.azure.com,11,0.01%,11,0,100.00%
array612.prod.do.dsp.mp.microsoft.com,11,0.01%,19,8,57.89%
3.asia.pool.ntp.org,11,0.01%,11,0,100.00%
ocsp.verisign.com,11,0.01%,26,15,42.31%
rs-cn.rustdesk.com,11,0.01%,11,0,100.00%
3463d06de0ca9a15.jijifun.com,11,0.01%,11,0,100.00%
datacluster4.cipsup.cn,11,0.01%,11,0,100.00%
all.feishu.cn.w.kunluncan.com,11,0.01%,11,0,100.00%
14.tlu.dl.delivery.mp.microsoft.com,11,0.01%,11,0,100.00%
api.fanyi.baidu.com,11,0.01%,11,0,100.00%
xlinfopush.rcv.sandai.net,11,0.01%,11,0,100.00%
browser.events.data.microsoft.com,11,0.01%,12,1,91.67%
sqimg.qq.com,11,0.01%,11,0,100.00%
e8652.dscx.akamaiedge.net,11,0.01%,22,11,50.00%
emres.dfcfw.com,11,0.01%,24,13,45.83%
3.pool.ntp.org,11,0.01%,11,0,100.00%
swallow.apple.com,11,0.01%,11,0,100.00%
tsearch.snssdk.com,11,0.01%,11,0,100.00%
hpd.a.shifen.com,11,0.01%,11,0,100.00%
team-speed-cdn-vip.xunlei.com,11,0.01%,11,0,100.00%
common.docer.wps.cn,11,0.01%,11,0,100.00%
api.growingio.com,11,0.01%,11,0,100.00%
lf3-cdn-tos.bytegoofy.com,11,0.01%,13,2,84.62%
stats.l.doubleclick.net,11,0.01%,11,0,100.00%
nmd.boom.skin,11,0.01%,11,0,100.00%
n21.boom.skin,11,0.01%,11,0,100.00%
onedscolprdwus09.westus.cloudapp.azure.com,11,0.01%,11,0,100.00%
global.in.ai.privatelink.monitor.azure.com,11,0.01%,11,0,100.00%
study.huixiangtiandi.com,11,0.01%,11,0,100.00%
46.push2his.eastmoney.com,11,0.01%,11,0,100.00%
28.push2his.eastmoney.com,11,0.01%,11,0,100.00%
sync-1-us-west1-g.sync.services.mozilla.com,11,0.01%,11,0,100.00%
11.rarbg.com,11,0.01%,11,0,100.00%
tracker.ccc.de,11,0.01%,11,0,100.00%
rs-sg.rustdesk.com,11,0.01%,11,0,100.00%
redisdatarecall.csdn.net,11,0.01%,11,0,100.00%
position.csdnimg.cn,11,0.01%,11,0,100.00%
statistic.csdn.net,11,0.01%,11,0,100.00%
th.bing.com,11,0.01%,11,0,100.00%
dmd.metaservices.microsoft.com,11,0.01%,11,0,100.00%
50.push2his.eastmoney.com,11,0.01%,11,0,100.00%
ecn.dev.ditu.live.com,11,0.01%,11,0,100.00%
onedscolprdeus05.eastus.cloudapp.azure.com,11,0.01%,21,10,52.38%
consul-kv.app.kdsec.org,11,0.01%,11,0,100.00%
open.tracker.ink,11,0.01%,11,0,100.00%
c-msn-com-nsatc.trafficmanager.net,11,0.01%,11,0,100.00%
microsoftgraph.chinacloudapi.cn,11,0.01%,11,0,100.00%
szmmsns.qpic.cn,11,0.01%,22,11,50.00%
inappcheck-lb.itunes-apple.com.akadns.net,11,0.01%,12,1,91.67%
waconatm.officeapps.live.com,11,0.01%,11,0,100.00%
apis.live.net,11,0.01%,11,0,100.00%
44.push2his.eastmoney.com,11,0.01%,11,0,100.00%
cdn-node.cn.cm.foshan-02.nekocloud.cn,11,0.01%,11,0,100.00%
hub.fastgit.xyz,11,0.01%,11,0,100.00%
xp.apple.com,10,0.01%,15,5,66.67%
js1.pcfg.cache.wpscdn.cn,10,0.01%,23,13,43.48%
bubble.ic.ksosoft.com,10,0.01%,10,0,100.00%
iknowpc.bdimg.com,10,0.01%,10,0,100.00%
tracker.coppersurfer.tk,10,0.01%,10,0,100.00%
objects.githubusercontent.com,10,0.01%,10,0,100.00%
mmbiz.qlogo.cn,10,0.01%,10,0,100.00%
bubu.mapfactor.com,10,0.01%,10,0,100.00%
opentracker.i2p.rocks,10,0.01%,10,0,100.00%
plus.wps.cn,10,0.01%,10,0,100.00%
v9-hwllqv.onewsvod.com,10,0.01%,10,0,100.00%
ts.qq.com,10,0.01%,74,64,13.51%
addinsinstallation.store.office.com,10,0.01%,10,0,100.00%
api2.firefoxchina.cn,10,0.01%,10,0,100.00%
offlintab.firefoxchina.cn,10,0.01%,10,0,100.00%
feilian-staging.bytedance.com.w.cdngslb.com,10,0.01%,10,0,100.00%
l5.gslb.ksyuncdn.com,10,0.01%,19,9,52.63%
array801.prod.do.dsp.mp.microsoft.com,10,0.01%,10,0,100.00%
onedscolprdwus06.westus.cloudapp.azure.com,10,0.01%,10,0,100.00%
l-0003.l-msedge.net,10,0.01%,19,9,52.63%
be01mr9s.sched.d2.tdnsdp1.cn,10,0.01%,10,0,100.00%
browser.360.cn.ucloudnaming.cn,10,0.01%,10,0,100.00%
sz-ucloud-ipv4.ucloudnaming.info,10,0.01%,10,0,100.00%
settings-prod-wjp-1.japanwest.cloudapp.azure.com,10,0.01%,10,0,100.00%
rua.myddns.cyou,10,0.01%,10,0,100.00%
stun.counterpath.net,10,0.01%,10,0,100.00%
ddns-checkip.quickconnect.to,10,0.01%,10,0,100.00%
bag.itunes.apple.com,10,0.01%,20,10,50.00%
onedscolprdeus10.eastus.cloudapp.azure.com,10,0.01%,10,0,100.00%
ip-info.ff.avast.com,10,0.01%,10,0,100.00%
pushtrs.push.hicloud.com,10,0.01%,10,0,100.00%
s12.upd.kaspersky.com,10,0.01%,10,0,100.00%
cloud.google.com,10,0.01%,10,0,100.00%
soup.v.qq.com,10,0.01%,10,0,100.00%
settings-prod-cin-2.centralindia.cloudapp.azure.com,10,0.01%,10,0,100.00%
6qnz2sy8.sched.d2.tdnsdp1.cn.cjt.vwnti.yrzhcloud.cn,10,0.01%,10,0,100.00%
armmf.adobe.com,10,0.01%,21,11,47.62%
upos-sz-mirrorcos.bilivideo.com,10,0.01%,20,10,50.00%
bal-edf-pcs-trafmng-failover.trafficmanager.net,10,0.01%,10,0,100.00%
list.lvb.eastmoney.com,10,0.01%,10,0,100.00%
38.push2his.eastmoney.com,10,0.01%,10,0,100.00%
dc1-st.ksn.kaspersky-labs.com,10,0.01%,10,0,100.00%
profile.accounts.firefox.com,10,0.01%,10,0,100.00%
s.cn.bing.net,10,0.01%,10,0,100.00%
i.snssdk.com,10,0.01%,10,0,100.00%
pic4.zhimg.com,10,0.01%,15,5,66.67%
meeting.tencent.com,10,0.01%,10,0,100.00%
so.toutiao.com.w.cdngslb.com,10,0.01%,10,0,100.00%
a1894.r.akamai.net,10,0.01%,10,0,100.00%
lf-cdn-tos.bytescm.com.w.kunluncan.com,10,0.01%,12,2,83.33%
vcs.snssdk.com,10,0.01%,10,0,100.00%
verify.snssdk.com,10,0.01%,10,0,100.00%
verify.snssdk.com.w.kunluncan.com,10,0.01%,10,0,100.00%
p3-sign.toutiaoimg.com.w.alikunlun.com,10,0.01%,11,1,90.91%
lf3-config.bytetcc.com,10,0.01%,12,2,83.33%
helpdesk.bytedance.com.w.cdngslb.com,10,0.01%,10,0,100.00%
ecdn-aboav7gm.sched.d2.tdnsdp1.cn,10,0.01%,10,0,100.00%
nstool.netease.com,10,0.01%,13,3,76.92%
stun.voiparound.com,10,0.01%,10,0,100.00%
dc.applicationinsights.azure.com,10,0.01%,10,0,100.00%
69.push2his.eastmoney.com,10,0.01%,10,0,100.00%
94.push2his.eastmoney.com,10,0.01%,10,0,100.00%
16.push2his.eastmoney.com,10,0.01%,10,0,100.00%
kuaishou.com,10,0.01%,10,0,100.00%
v1-hwllqv.onewsvod.com,10,0.01%,10,0,100.00%
weixin.sogou.com,10,0.01%,10,0,100.00%
www.1k3j1blg.com,10,0.01%,10,0,100.00%
www2.bing.com,10,0.01%,10,0,100.00%
ntes53.mail.yeah.net,10,0.01%,10,0,100.00%
cm.bilibili.com,10,0.01%,11,1,90.91%
profile.pinyin.sogou.com,10,0.01%,10,0,100.00%
service.weather.msn.cn,10,0.01%,10,0,100.00%
ulink-pr-diskhealth.s3.amazonaws.com,10,0.01%,10,0,100.00%
ntes53.mail.163.com,10,0.01%,10,0,100.00%
kns.duba.net,10,0.01%,10,0,100.00%
cdn-node.cn.cm.jiangmen-01.nekocloud.cn,10,0.01%,10,0,100.00%
cloudcontrol.ai.xiaomi.com,10,0.01%,10,0,100.00%
43.push2his.eastmoney.com,10,0.01%,10,0,100.00%
2.push2his.eastmoney.com,10,0.01%,10,0,100.00%
ada.baidu.com,10,0.01%,10,0,100.00%
s1.url.cn,10,0.01%,10,0,100.00%
event.csdn.net,10,0.01%,23,13,43.48%
zhanzhang.toutiao.com.w.cdngslb.com,10,0.01%,10,0,100.00%
36d3af239dc2ead8aaa059a747d643c0c1645cee.u.fdmpkg.org,10,0.01%,10,0,100.00%
wss.tim.qq.com,10,0.01%,10,0,100.00%
46a2e5c3c5a64e218b60f2c2ee76b750.pacloudflare.com,10,0.01%,10,0,100.00%
chennuo.xyz,10,0.01%,10,0,100.00%
tracker1.bt.moack.co.kr,10,0.01%,10,0,100.00%
tracker.edkj.club,10,0.01%,10,0,100.00%
oth.str.beacon.qq.com,10,0.01%,10,0,100.00%
search-operate.cdn.bcebos.com,10,0.01%,10,0,100.00%
d2kpbcafi909wb.cloudfront.net,10,0.01%,10,0,100.00%
ini.update.360safe.com,10,0.01%,10,0,100.00%
onedscolprdweu04.westeurope.cloudapp.azure.com,10,0.01%,10,0,100.00%
api.b.qianxin.com,10,0.01%,10,0,100.00%
76.push2his.eastmoney.com,10,0.01%,10,0,100.00%
www.xilinx.com,10,0.01%,10,0,100.00%
open.acgnxtracker.com,10,0.01%,14,4,71.43%
helpdubaservice.ksmobile.com,10,0.01%,10,0,100.00%
token.services.mozilla.com,10,0.01%,10,0,100.00%
pconf.f.360.cn,10,0.01%,10,0,100.00%
onedscolprdaus00.australiasoutheast.cloudapp.azure.com,10,0.01%,10,0,100.00%
slardar-bd.feishu.cn.bytedns1.com,10,0.01%,10,0,100.00%
cloud.dell.com,10,0.01%,10,0,100.00%
cn-shanghai.axt.aliyun.com,10,0.01%,10,0,100.00%
cdn-node.cn.cm.ningbo-01.nekocloud.cn,10,0.01%,10,0,100.00%
www6.53kf.com,10,0.01%,10,0,100.00%
bizaladdin-image.baidu.com,10,0.01%,10,0,100.00%
china.bing123.com,9,0.00%,9,0,100.00%
SIN-efz.ms-acdc.office.com,9,0.00%,18,9,50.00%
gsas.apple.com,9,0.00%,9,0,100.00%
f-log-extension.grammarly.io,9,0.00%,9,0,100.00%
resources.jetbrains.com,9,0.00%,17,8,52.94%
docs2.gtimg.com,9,0.00%,11,2,81.82%
ts4.cn.mm.bing.net,9,0.00%,9,0,100.00%
rc09-fc01.oray.com,9,0.00%,9,0,100.00%
vortex-win.data.microsoft.com,9,0.00%,12,3,75.00%
tracker.tiny-vps.com,9,0.00%,9,0,100.00%
nyaa.tracker.wf,9,0.00%,9,0,100.00%
comtrade.un.org,9,0.00%,9,0,100.00%
baijiahao.baidu.com,9,0.00%,9,0,100.00%
s.bbm0v.cn,9,0.00%,9,0,100.00%
guzzoni-apple-com.v.aaplimg.com,9,0.00%,9,0,100.00%
sentry.eulix.xyz,9,0.00%,9,0,100.00%
ts.eset.com,9,0.00%,9,0,100.00%
waws-prod-sg1-057-feea.southeastasia.cloudapp.azure.com,9,0.00%,9,0,100.00%
easylist-downloads.adblockplus.org,9,0.00%,18,9,50.00%
extensions.gnome.org,9,0.00%,20,11,45.00%
init-cdn.itunes-apple.com.akadns.net,9,0.00%,11,2,81.82%
dcache.hub.sandai.net,9,0.00%,9,0,100.00%
ocsp.sca1b.amazontrust.com,9,0.00%,9,0,100.00%
array605.prod.do.dsp.mp.microsoft.com,9,0.00%,9,0,100.00%
newtab.firefoxchina.cn,9,0.00%,15,6,60.00%
data.bilicdn2.com,9,0.00%,19,10,47.37%
cdn.content.prod.cms.msn.com,9,0.00%,22,13,40.91%
appleimap.163.com,9,0.00%,9,0,100.00%
safebrowsing.googleapis-cn.com,9,0.00%,22,13,40.91%
sf.symcd.com,9,0.00%,22,13,40.91%
config.mobile.kugou.com,9,0.00%,9,0,100.00%
archive.kylinos.cn,9,0.00%,9,0,100.00%
se.360.cn,9,0.00%,13,4,69.23%
cp801.prod.do.dsp.mp.microsoft.com,9,0.00%,9,0,100.00%
11.courier-push-apple.com.akadns.net,9,0.00%,9,0,100.00%
opencdnqiniustaticv6.jomodns.com,9,0.00%,18,9,50.00%
42.push2his.eastmoney.com,9,0.00%,9,0,100.00%
disc601.prod.do.dsp.mp.microsoft.com,9,0.00%,9,0,100.00%
by3302.storage.live.com,9,0.00%,10,1,90.00%
openjmacs4uc.m.taobao.com,9,0.00%,9,0,100.00%
i2.hdslb.com,9,0.00%,22,13,40.91%
pic3.zhimg.com,9,0.00%,18,9,50.00%
pc-diffpack.wps.cn,9,0.00%,9,0,100.00%
lf-cdn-tos.bytescm.com,9,0.00%,11,2,81.82%
xxbg.snssdk.com,9,0.00%,9,0,100.00%
mrodevicemgr.officeapps.live.com,9,0.00%,17,8,52.94%
cdn.ghostery.com,9,0.00%,17,8,52.94%
ow1.res.office365.com,9,0.00%,9,0,100.00%
c.msn.com,9,0.00%,9,0,100.00%
45.push2his.eastmoney.com,9,0.00%,9,0,100.00%
smp-device-content.apple.com,9,0.00%,10,1,90.00%
settings-prod-wus2-1.westus2.cloudapp.azure.com,9,0.00%,9,0,100.00%
messaging.ccs.mcafee.com,9,0.00%,9,0,100.00%
86.push2his.eastmoney.com,9,0.00%,9,0,100.00%
59.push2his.eastmoney.com,9,0.00%,9,0,100.00%
fxtt.ru,9,0.00%,9,0,100.00%
stun.sipgate.net,9,0.00%,9,0,100.00%
ac.dun.163.com,9,0.00%,17,8,52.94%
39.push2his.eastmoney.com,9,0.00%,9,0,100.00%
13.push2his.eastmoney.com,9,0.00%,9,0,100.00%
73.push2his.eastmoney.com,9,0.00%,9,0,100.00%
download.jetbrains.com.cn,9,0.00%,12,3,75.00%
shrouded-wave-5410.morning-tundra-7160.herokuspace.com,9,0.00%,9,0,100.00%
fundingchoicesmessages.google.com,9,0.00%,9,0,100.00%
cb.e.shifen.com,9,0.00%,9,0,100.00%
3.ubuntu.pool.ntp.org,9,0.00%,9,0,100.00%
doh.360.cn,9,0.00%,9,0,100.00%
chouchou.top,9,0.00%,9,0,100.00%
81.push2his.eastmoney.com,9,0.00%,9,0,100.00%
onedsblobprdcus17.centralus.cloudapp.azure.com,9,0.00%,9,0,100.00%
track.plop.pm,9,0.00%,9,0,100.00%
plugin.browser.qq.com,9,0.00%,9,0,100.00%
tracker2.dler.org,9,0.00%,9,0,100.00%
mask-api.icloud.com,9,0.00%,11,2,81.82%
api.segment.io,9,0.00%,9,0,100.00%
s1.hdslb.com,9,0.00%,9,0,100.00%
zh-cn.content.prod.cms.msn.com,9,0.00%,9,0,100.00%
marketplace.opennebula.systems,9,0.00%,9,0,100.00%
investor.shutterstock.com,9,0.00%,12,3,75.00%
cloudnet.h3c.com,9,0.00%,9,0,100.00%
www.as.com,9,0.00%,9,0,100.00%
hdweb.mail.split.netease.com,8,0.00%,8,0,100.00%
k-ring.msedge.net,8,0.00%,8,0,100.00%
prebid-us.creativecdn.com,8,0.00%,8,0,100.00%
settings-prod-scus-2.southcentralus.cloudapp.azure.com,8,0.00%,8,0,100.00%
cn.patch.battle.net,8,0.00%,8,0,100.00%
channel-account-ssl.xunlei.com,8,0.00%,8,0,100.00%
onedscolprdwus08.westus.cloudapp.azure.com,8,0.00%,8,0,100.00%
www.qq.com,8,0.00%,216,208,3.70%
onedscolprdwus04.westus.cloudapp.azure.com,8,0.00%,8,0,100.00%
ksopush.kdocs.cn,8,0.00%,8,0,100.00%
vpn1.bjfu.edu.cn,8,0.00%,8,0,100.00%
pgw-tel-cld-sl.alicdn.com,8,0.00%,8,0,100.00%
open.qurl.f.qh-lb.com,8,0.00%,8,0,100.00%
iknow-pic.cdn.bcebos.com,8,0.00%,8,0,100.00%
www.zhihu.com,8,0.00%,18,10,44.44%
gorgon.youdao.com,8,0.00%,8,0,100.00%
up.ijinshan.com,8,0.00%,8,0,100.00%
array803.prod.do.dsp.mp.microsoft.com,8,0.00%,8,0,100.00%
a.safe.360.cn,8,0.00%,8,0,100.00%
log.ys7.com,8,0.00%,8,0,100.00%
tracker.tfile.co,8,0.00%,8,0,100.00%
fe.dealclub.de,8,0.00%,8,0,100.00%
p4p.arenabg.com,8,0.00%,8,0,100.00%
outlookmobile-office365-tas.msedge.net,8,0.00%,8,0,100.00%
news.qhstatic.com,8,0.00%,8,0,100.00%
prda.aadg.msidentity.com,8,0.00%,8,0,100.00%
keyvalueservice.fe.apple-dns.cn,8,0.00%,8,0,100.00%
www.download.windowsupdate.com.download.ks-cdn.com,8,0.00%,8,0,100.00%
ak.privatelink.msidentity.com,8,0.00%,8,0,100.00%
bolt.dropbox.com,8,0.00%,16,8,50.00%
wd-prod-ss-as-southeast-2-fe.southeastasia.cloudapp.azure.com,8,0.00%,8,0,100.00%
dldir1.qq.com.tcdn.qq.com,8,0.00%,8,0,100.00%
dldir1.qq.com.mid.dcloudstc.com,8,0.00%,8,0,100.00%
onedscolprdcus10.centralus.cloudapp.azure.com,8,0.00%,8,0,100.00%
iduxzj9.qiniudns.com,8,0.00%,17,9,47.06%
qt010.china.line.qiniudns.com,8,0.00%,17,9,47.06%
pub.idqqimg.com.sched.legopic1.tdnsv6.com,8,0.00%,8,0,100.00%
kjk3jf40.sched.sma-dk.tdnsstic1.cn,8,0.00%,16,8,50.00%
iplc-ji.cmy-dns.com,8,0.00%,8,0,100.00%
update-khd.2345.cc,8,0.00%,8,0,100.00%
array812.prod.do.dsp.mp.microsoft.com,8,0.00%,8,0,100.00%
k1.gslb.ksyuncdn.com,8,0.00%,16,8,50.00%
conf.wsm.360.cn,8,0.00%,16,8,50.00%
1.cn.pool.ntp.org,8,0.00%,8,0,100.00%
analytics.ff.avast.com,8,0.00%,8,0,100.00%
www.sourceinsight.com,8,0.00%,8,0,100.00%
onedsblobprdwus15.westus.cloudapp.azure.com,8,0.00%,8,0,100.00%
report.uchiha.ltd,8,0.00%,8,0,100.00%
list.wallpaper.cloud.duba.net,8,0.00%,8,0,100.00%
cfw.gti.mcafee.akadns.net,8,0.00%,8,0,100.00%
repper-lb-tokyo.gtinative.cloudplatform.mcafee.com,8,0.00%,8,0,100.00%
common-geo.ha.1drv.com,8,0.00%,8,0,100.00%
kms.xspace.in,8,0.00%,8,0,100.00%
sb.scorecardresearch.com,8,0.00%,8,0,100.00%
ip1880706122.funshion.com,8,0.00%,8,0,100.00%
ww1.sinaimg.cn.w.alikunlun.com,8,0.00%,18,10,44.44%
nsp-contentcenter-h5-drcn.obs.cn-north-2.myhwclouds.com,8,0.00%,8,0,100.00%
wechat.todesk.com,8,0.00%,8,0,100.00%
down.xinshuru.com,8,0.00%,8,0,100.00%
logservice1.hicloud.com,8,0.00%,8,0,100.00%
dm.video.qq.com,8,0.00%,8,0,100.00%
edf.gtm.eset.com,8,0.00%,8,0,100.00%
update.eset.com,8,0.00%,8,0,100.00%
array609.prod.do.dsp.mp.microsoft.com,8,0.00%,8,0,100.00%
6qnz2sy8.sched.d2.tdnsdp1.cn,8,0.00%,8,0,100.00%
same.eastmoney.com,8,0.00%,8,0,100.00%
emcharts.dftzj.com,8,0.00%,16,8,50.00%
emcharts.eastmoney.com,8,0.00%,16,8,50.00%
zimeiti-eastmoney-com.oss-cn-shanghai.aliyuncs.com,8,0.00%,8,0,100.00%
57.push2his.eastmoney.com,8,0.00%,8,0,100.00%
xpis-xcdn.youku.com,8,0.00%,8,0,100.00%
su.ff.avast.com,8,0.00%,8,0,100.00%
smarthome-drcn.dbankcdn.com,8,0.00%,8,0,100.00%
www.telecommandsvc.microsoft.com,8,0.00%,8,0,100.00%
www36oo.com,8,0.00%,8,0,100.00%
registry.npm.taobao.org,8,0.00%,8,0,100.00%
upos-sz-mirrorhw.bilivideo.com,8,0.00%,13,5,61.54%
pic1.zhimg.com,8,0.00%,15,7,53.33%
mqtt-web.zhihu.com,8,0.00%,8,0,100.00%
opencdnbdsimage.jomodns.com,8,0.00%,11,3,72.73%
opencdnbdimgtn.jomodns.com,8,0.00%,9,1,88.89%
cds.apple.com,8,0.00%,8,0,100.00%
help.apple.com,8,0.00%,8,0,100.00%
openapp.wpscdn.cn,8,0.00%,18,10,44.44%
bkssl.bdimg.com,8,0.00%,11,3,72.73%
www.ysgc.cc,8,0.00%,8,0,100.00%
sdk.51.la,8,0.00%,8,0,100.00%
collect-v6.51.la,8,0.00%,8,0,100.00%
m.toutiao.com,8,0.00%,8,0,100.00%
so.toutiao.com,8,0.00%,8,0,100.00%
p3-tt.byteimg.com.w.cdngslb.com,8,0.00%,10,2,80.00%
lf3-csp.bytetos.com.w.cdngslb.com,8,0.00%,10,2,80.00%
lf3-cdn-tos.bytescm.com,8,0.00%,10,2,80.00%
sf3-cdn-tos.toutiaostatic.com.w.cdngslb.com,8,0.00%,10,2,80.00%
p3.toutiaoimg.com.w.cdngslb.com,8,0.00%,10,2,80.00%
p6-sign.toutiaoimg.com,8,0.00%,8,0,100.00%
k5-toutiao-ml.gslb.ksyuncdn.com,8,0.00%,8,0,100.00%
sf3-cdn-tos.douyinstatic.com.w.cdngslb.com,8,0.00%,10,2,80.00%
stat.lianmeng.360.cn,8,0.00%,8,0,100.00%
helpdesk.bytedance.com,8,0.00%,8,0,100.00%
lf3-short.bytegoofy.com.w.kunluncan.com,8,0.00%,10,2,80.00%
path2.xtracloud.net,8,0.00%,8,0,100.00%
assets2.msn.com,8,0.00%,8,0,100.00%
data-detect.nie.netease.com,8,0.00%,8,0,100.00%
open.acgtracker.com,8,0.00%,8,0,100.00%
tracker.mywaifu.best,8,0.00%,8,0,100.00%
internal-api-lark-api.feishu.cn.w.cdngslb.com,8,0.00%,8,0,100.00%
97.push2his.eastmoney.com,8,0.00%,8,0,100.00%
79.push2his.eastmoney.com,8,0.00%,8,0,100.00%
hkbn2.doubledou.win,8,0.00%,8,0,100.00%
14.au.download.windowsupdate.com,8,0.00%,8,0,100.00%
mam.ntes53.netease.com,8,0.00%,8,0,100.00%
tracker.dler.org,8,0.00%,8,0,100.00%
zhannei-dm.csdn.net,8,0.00%,8,0,100.00%
ocsp.godaddy.com,8,0.00%,8,0,100.00%
forw-sfo2.goodsync.com,8,0.00%,8,0,100.00%
photo.cctv.com,8,0.00%,17,9,47.06%
nat-port-2.verysync.cn,8,0.00%,8,0,100.00%
time.nist.gov,8,0.00%,94,86,8.51%
smtp.flawcra.cc,8,0.00%,8,0,100.00%
acdc-direct.office.com,8,0.00%,16,8,50.00%
res.u-tools.cn,8,0.00%,8,0,100.00%
www.msftncsi.com.edgesuite.net,8,0.00%,8,0,100.00%
24.push2his.eastmoney.com,8,0.00%,8,0,100.00%
62.push2his.eastmoney.com,8,0.00%,8,0,100.00%
cp501.prod.do.dsp.mp.microsoft.com,8,0.00%,8,0,100.00%
plugins.jetbrains.com,8,0.00%,8,0,100.00%
84.push2his.eastmoney.com,8,0.00%,8,0,100.00%
down.anticheatexpert.com.wsdvs.com,8,0.00%,8,0,100.00%
statuse.digitalcertvalidation.com,8,0.00%,10,2,80.00%
a1806.dscb.akamai.net,8,0.00%,26,18,30.77%
ocws.officeapps.live.com,8,0.00%,8,0,100.00%
www.googletagservices.com,8,0.00%,8,0,100.00%
versioncheck-bg.addons.mozilla.org,8,0.00%,8,0,100.00%
mountain.zhidao.baidu.com,8,0.00%,8,0,100.00%
stun.services.mozilla.com,8,0.00%,8,0,100.00%
cn.overleaf.com,8,0.00%,8,0,100.00%
cstaticdun.126.net,8,0.00%,8,0,100.00%
wwads.cn,8,0.00%,8,0,100.00%
developer.download.nvidia.com,8,0.00%,8,0,100.00%
71.push2his.eastmoney.com,8,0.00%,8,0,100.00%
www.yuque.com,8,0.00%,8,0,100.00%
psg.pinyin.sogou.com,8,0.00%,8,0,100.00%
www.doc88.com,8,0.00%,8,0,100.00%
prod.ingestion-edge.prod.dataops.mozgcp.NET,8,0.00%,8,0,100.00%
fengling.7654.com,8,0.00%,8,0,100.00%
tracker.jordan.im,8,0.00%,8,0,100.00%
proxy.whaledata.com,8,0.00%,8,0,100.00%
bank.hexun.com,8,0.00%,8,0,100.00%
cr.file.cloud.duba.net,8,0.00%,8,0,100.00%
s01.upd.kaspersky.com,8,0.00%,8,0,100.00%
cdn.cvws.apple-dns.net,8,0.00%,16,8,50.00%
musicstatus.itunes.apple.com,8,0.00%,8,0,100.00%
pinyin.sogou.com,8,0.00%,8,0,100.00%
code.eulix.xyz,8,0.00%,8,0,100.00%
36.push2his.eastmoney.com,8,0.00%,8,0,100.00%
daka.dafa-dns.com,8,0.00%,8,0,100.00%
45.courier-push-apple.com.akadns.net,8,0.00%,8,0,100.00%
download.visualstudio.microsoft.com.mwcname.com,8,0.00%,8,0,100.00%
s3m5.fenxi.com,8,0.00%,8,0,100.00%
package-search.services.jetbrains.com,8,0.00%,16,8,50.00%
sdk.split.io,8,0.00%,8,0,100.00%
azwcus1-client-s.gateway.messenger.live.com,8,0.00%,8,0,100.00%
www.paypal.com,8,0.00%,8,0,100.00%
login.msa.msidentity.com,8,0.00%,8,0,100.00%
1.courier-sandbox-push-apple.com.akadns.net,8,0.00%,8,0,100.00%
internal-api-space.feishu.cn,8,0.00%,8,0,100.00%
archive2.kylinos.cn,8,0.00%,8,0,100.00%
www.annualcreditreport.com,8,0.00%,8,0,100.00%
ws-std01.sunlogin.oray.com,8,0.00%,8,0,100.00%
securityapi.d3-pr-tm.com,8,0.00%,8,0,100.00%
cdn.yinxiang.com,8,0.00%,8,0,100.00%
g1max.mediav.com,8,0.00%,8,0,100.00%
appcdcbjpip2.jianguoyun.com,8,0.00%,8,0,100.00%
g37.update.netease.com,8,0.00%,8,0,100.00%
down2.abckantu.com,8,0.00%,8,0,100.00%
gspe1-ssl.ls.apple.com,7,0.00%,7,0,100.00%
ocsp-lb.apple.com.akadns.net,7,0.00%,10,3,70.00%
www.update.microsoft.com,7,0.00%,7,0,100.00%
q8daiuc5.sched.sma.tdnsstic1.cn,7,0.00%,7,0,100.00%
onedscolprdeus08.eastus.cloudapp.azure.com,7,0.00%,14,7,50.00%
dnkeeper.platform.dbankcloud.cn,7,0.00%,7,0,100.00%
w.cnzz.com,7,0.00%,7,0,100.00%
img30.360buyimg.com,7,0.00%,11,4,63.64%
passport.jd.com,7,0.00%,7,0,100.00%
misc.360buyimg.com,7,0.00%,7,0,100.00%
gias.jd.com,7,0.00%,7,0,100.00%
cds.3.cn,7,0.00%,7,0,100.00%
static.360buyimg.com,7,0.00%,7,0,100.00%
fe2.update.microsoft.com,7,0.00%,17,10,41.18%
onedscolprdcus13.centralus.cloudapp.azure.com,7,0.00%,7,0,100.00%
gfwsl.geforce.cn,7,0.00%,7,0,100.00%
cs.weishi.ijinshan.com,7,0.00%,7,0,100.00%
c.tmyzer.com,7,0.00%,7,0,100.00%
commerce.safe.360.cn,7,0.00%,7,0,100.00%
s1.vip.wpscdn.cn,7,0.00%,15,8,46.67%
tracker.open-internet.nl,7,0.00%,7,0,100.00%
movies.zsw.ca,7,0.00%,7,0,100.00%
msgcenter.wps.cn,7,0.00%,7,0,100.00%
www.mysmth.net,7,0.00%,7,0,100.00%
dlswbr.baidu.com,7,0.00%,13,6,53.85%
e673.dsce9.akamaiedge.net,7,0.00%,14,7,50.00%
img-prod-cms-rt-microsoft-com.akamaized.net,7,0.00%,13,6,53.85%
shortv.cdp.qq.com,7,0.00%,8,1,87.50%
download.comodo.com,7,0.00%,12,5,58.33%
vscode-update.trafficmanager.net,7,0.00%,7,0,100.00%
vscode-update-sea.azurewebsites.net,7,0.00%,7,0,100.00%
24-courier.push.apple.com,7,0.00%,7,0,100.00%
e10499.dsce9.akamaiedge.net,7,0.00%,14,7,50.00%
msg.video.dns.iqiyi.com,7,0.00%,7,0,100.00%
s.ludashi.com,7,0.00%,7,0,100.00%
array613.prod.do.dsp.mp.microsoft.com,7,0.00%,7,0,100.00%
gspe35-ssl.ls-apple.com.akadns.net,7,0.00%,11,4,63.64%
2.debian.pool.ntp.org,7,0.00%,12,5,58.33%
ups.ksmobile.net,7,0.00%,11,4,63.64%
array508.prod.do.dsp.mp.microsoft.com,7,0.00%,7,0,100.00%
zhushou.huihui.cn,7,0.00%,7,0,100.00%
elb-telemetry-prod-external-1332413525.us-west-2.elb.amazonaws.com,7,0.00%,7,0,100.00%
sp1.sangfor.com.cn,7,0.00%,7,0,100.00%
portainer-io-assets.sfo2.digitaloceanspaces.com,7,0.00%,7,0,100.00%
fcmtoken.googleapis.com,7,0.00%,14,7,50.00%
wemeet-da2.qq.com,7,0.00%,7,0,100.00%
onedscolprdcus04.centralus.cloudapp.azure.com,7,0.00%,7,0,100.00%
ynote-statistic.lx.netease.com,7,0.00%,7,0,100.00%
tracking.miui.com,7,0.00%,7,0,100.00%
www.youtube.com,7,0.00%,15,8,46.67%
16.tlu.dl.delivery.mp.microsoft.com,7,0.00%,10,3,70.00%
XSP-efz.ms-acdc.office.com,7,0.00%,14,7,50.00%
2.cn.pool.ntp.org,7,0.00%,18,11,38.89%
fsrhk.lenovomm.com,7,0.00%,7,0,100.00%
e6913.dscx.akamaiedge.net,7,0.00%,14,7,50.00%
emcharts.dfcfw.com,7,0.00%,13,6,53.85%
58.push2his.eastmoney.com,7,0.00%,7,0,100.00%
onedriveclucprodbn20003.blob.core.windows.net,7,0.00%,7,0,100.00%
sb.firefox.com.cn,7,0.00%,16,9,43.75%
submit.acsac.org,7,0.00%,7,0,100.00%
kv801.prod.do.dsp.mp.microsoft.com,7,0.00%,7,0,100.00%
www.gditu.net,7,0.00%,7,0,100.00%
usage.projectcalico.org,7,0.00%,7,0,100.00%
grs.dbankcloud.com,7,0.00%,7,0,100.00%
mcs.zijieapi.com,7,0.00%,18,11,38.89%
fclick.e.shifen.com,7,0.00%,7,0,100.00%
opencdnglobalv6.jomodns.com,7,0.00%,10,3,70.00%
digitalassetlinks.googleapis.com,7,0.00%,8,1,87.50%
www.tnas.online,7,0.00%,7,0,100.00%
pan.cstcloud.cn,7,0.00%,7,0,100.00%
ip3026294313.funshion.com,7,0.00%,7,0,100.00%
11.push2his.eastmoney.com,7,0.00%,7,0,100.00%
array510.prod.do.dsp.mp.microsoft.com,7,0.00%,7,0,100.00%
settings-prod-scus-1.southcentralus.cloudapp.azure.com,7,0.00%,7,0,100.00%
wmgp-update.wmupd.com,7,0.00%,7,0,100.00%
tim.qq.com,7,0.00%,7,0,100.00%
smp-device-content.lb-apple.com.akadns.net,7,0.00%,8,1,87.50%
onedscolprdeus02.eastus.cloudapp.azure.com,7,0.00%,7,0,100.00%
54.push2his.eastmoney.com,7,0.00%,7,0,100.00%
6.push2his.eastmoney.com,7,0.00%,7,0,100.00%
49.push2his.eastmoney.com,7,0.00%,7,0,100.00%
32.push2his.eastmoney.com,7,0.00%,7,0,100.00%
slink.gifshow.com,7,0.00%,7,0,100.00%
datacluster3.cipsup.cn,7,0.00%,7,0,100.00%
gy.bzcv.cn,7,0.00%,7,0,100.00%
vaiwan.com,7,0.00%,7,0,100.00%
dcs.foxitreader.cn,7,0.00%,7,0,100.00%
google.com,7,0.00%,12,5,58.33%
i1.hdslb.com,7,0.00%,21,14,33.33%
phx02pap001.storage.live.com,7,0.00%,12,5,58.33%
ipv4.neubt.com,7,0.00%,7,0,100.00%
stun.ekiga.net,7,0.00%,7,0,100.00%
stun.schlund.de,7,0.00%,7,0,100.00%
www.scottyang8math.cn,7,0.00%,7,0,100.00%
helpdesktop1.ksmobile.com,7,0.00%,7,0,100.00%
gcs.sangfor.com,7,0.00%,7,0,100.00%
cntr.wps.cn,7,0.00%,7,0,100.00%
data.unistream.io,7,0.00%,7,0,100.00%
i3.c.eset.com,7,0.00%,7,0,100.00%
e12437.d.akamaiedge.net,7,0.00%,7,0,100.00%
96.push2his.eastmoney.com,7,0.00%,7,0,100.00%
48.push2his.eastmoney.com,7,0.00%,7,0,100.00%
cdn.ark.qq.com,7,0.00%,9,2,77.78%
aus5.mozilla.org,7,0.00%,7,0,100.00%
imap.mail.me.com.akadns.net,7,0.00%,7,0,100.00%
acstatic-dun.126.net,7,0.00%,7,0,100.00%
kunyu.csdn.net,7,0.00%,7,0,100.00%
bam.nr-data.net.cdn.cloudflare.net,7,0.00%,7,0,100.00%
sslzz.jomodns.com,7,0.00%,7,0,100.00%
delegation.a.shifen.com,7,0.00%,7,0,100.00%
sec23summer.usenix.hotcrp.com,7,0.00%,7,0,100.00%
stocks-edge.apple.com,7,0.00%,7,0,100.00%
stocks-sparkline.apple.com,7,0.00%,12,5,58.33%
14.push2his.eastmoney.com,7,0.00%,7,0,100.00%
csdn.log-global.aliyuncs.com.w.cdngslb.com,7,0.00%,14,7,50.00%
krgame04.graniterapids.com,7,0.00%,7,0,100.00%
bnz07pap001.storage.live.com,7,0.00%,9,2,77.78%
cdp.cloud.unity3d.com,7,0.00%,7,0,100.00%
img1.baidu.com,7,0.00%,7,0,100.00%
opencdn.jomodns.com,7,0.00%,7,0,100.00%
api1.origin.com,7,0.00%,7,0,100.00%
i8.hexun.com,7,0.00%,7,0,100.00%
roll.hexun.com,7,0.00%,7,0,100.00%
uqhdkynyqiccr0ff-gzo0ffeun6pvl9od-gebf7khwpyapzzta.prprmoe.xyz,7,0.00%,7,0,100.00%
disc801.prod.do.dsp.mp.microsoft.com,7,0.00%,7,0,100.00%
evolwallpaper-api.papegames.cn,7,0.00%,7,0,100.00%
hector.baidu.com,7,0.00%,7,0,100.00%
bcstobos.jomodns.com,7,0.00%,7,0,100.00%
array502.prod.do.dsp.mp.microsoft.com,7,0.00%,7,0,100.00%
w.deepl.com,7,0.00%,7,0,100.00%
onedsblobprdcus16.centralus.cloudapp.azure.com,7,0.00%,7,0,100.00%
api.panfanh.xyz,7,0.00%,7,0,100.00%
pop.cstnet.cn,7,0.00%,7,0,100.00%
tracker.skyts.net,7,0.00%,7,0,100.00%
cm-cn-central-00001.albatross.10086.cn,7,0.00%,7,0,100.00%
settings-prod-sea-2.southeastasia.cloudapp.azure.com,7,0.00%,7,0,100.00%
token.r53-2.services.mozilla.com,7,0.00%,7,0,100.00%
firebaseinstallations.googleapis.com,7,0.00%,7,0,100.00%
m701.music.126.net,7,0.00%,7,0,100.00%
70.push2his.eastmoney.com,7,0.00%,7,0,100.00%
login.wpscdn.cn,7,0.00%,7,0,100.00%
builds.parsecgaming.com,7,0.00%,12,5,58.33%
7.rlb.router.teamviewer.cn,7,0.00%,7,0,100.00%
41.push2his.eastmoney.com,7,0.00%,7,0,100.00%
wallpaper-redirect-api.cqttech.com,7,0.00%,7,0,100.00%
o.lencr.edgesuite.net,7,0.00%,8,1,87.50%
mbdp01.bdstatic.com,7,0.00%,7,0,100.00%
ext.baidu.com,7,0.00%,7,0,100.00%
onedscolprdaus02.australiasoutheast.cloudapp.azure.com,7,0.00%,7,0,100.00%
20.push2his.eastmoney.com,7,0.00%,7,0,100.00%
www.h3c.com.cn,7,0.00%,7,0,100.00%
d1tcio87buo4yy.cloudfront.net,7,0.00%,7,0,100.00%
android.googleapis.com,7,0.00%,8,1,87.50%
cdn-node.cn.cm.foshan-01.nekocloud.cn,7,0.00%,7,0,100.00%
dual-spo-0004.spo-msedge.net,7,0.00%,7,0,100.00%
wd-prod-ss-as-southeast-1-fe.southeastasia.cloudapp.azure.com,6,0.00%,6,0,100.00%
s-ring.msedge.net,6,0.00%,6,0,100.00%
tsfe.trafficmanager.net,6,0.00%,6,0,100.00%
onedriveclucprodbn20039.blob.core.windows.net,6,0.00%,6,0,100.00%
tracker.lelux.fi,6,0.00%,6,0,100.00%
nexus-websocket-a.intercom.io,6,0.00%,6,0,100.00%
www.ifeng.com,6,0.00%,6,0,100.00%
onedscolprdcus03.centralus.cloudapp.azure.com,6,0.00%,9,3,66.67%
array809.prod.do.dsp.mp.microsoft.com,6,0.00%,11,5,54.55%
www.tm.ak.prd.aadg.trafficmanager.net,6,0.00%,6,0,100.00%
onetag-sys.com,6,0.00%,6,0,100.00%
dl.pinyin.sogou.com,6,0.00%,6,0,100.00%
update.pan.n.shifen.com,6,0.00%,6,0,100.00%
wl.jd.com,6,0.00%,9,3,66.67%
reports.baidu.com,6,0.00%,6,0,100.00%
ts3.cn.mm.bing.net,6,0.00%,6,0,100.00%
cloudservice22.kingsoft-office-service.com,6,0.00%,6,0,100.00%
img.qwps.cn,6,0.00%,11,5,54.55%
static-xl.a.88cdn.com,6,0.00%,14,8,42.86%
sp3.baidu.com,6,0.00%,9,3,66.67%
www.tm.lg.prod.aadmsa.trafficmanager.net,6,0.00%,6,0,100.00%
telemetry.dropbox.com,6,0.00%,12,6,50.00%
a1992.dscd.akamai.net,6,0.00%,12,6,50.00%
configuration.ls.apple.com,6,0.00%,14,8,42.86%
d28139t0r7hg1k.cloudfront.net,6,0.00%,12,6,50.00%
ipv6.china.qiniu.com.trpcdn.net,6,0.00%,13,7,46.15%
pmpcdn1.wmupd.com,6,0.00%,6,0,100.00%
pmpcdn1.wmupd.com.cdn.dnsv1.com,6,0.00%,6,0,100.00%
k53k6ler.sched.sma.tdnsstic1.cn,6,0.00%,6,0,100.00%
22.courier-push-apple.com.akadns.net,6,0.00%,6,0,100.00%
settings-prod-wus2-2.westus2.cloudapp.azure.com,6,0.00%,6,0,100.00%
odrs.gnome.org,6,0.00%,12,6,50.00%
yd-02.paofunlink.com,6,0.00%,6,0,100.00%
onedscolprdwus03.westus.cloudapp.azure.com,6,0.00%,6,0,100.00%
crl.pki.goog,6,0.00%,6,0,100.00%
update.haozip.2345.com,6,0.00%,6,0,100.00%
public-cdn.cloud.unity3d.com,6,0.00%,6,0,100.00%
checkip.digitalocean.synology.com,6,0.00%,6,0,100.00%
skconf.f.360.cn,6,0.00%,6,0,100.00%
37-courier.push.apple.com,6,0.00%,6,0,100.00%
ocsp.apple.com.download.ks-cdn.com,6,0.00%,6,0,100.00%
dgapi.zhhainiao.com,6,0.00%,6,0,100.00%
ipm-klca.kaspersky.com,6,0.00%,6,0,100.00%
prod.balrog.prod.cloudops.mozgcp.net,6,0.00%,6,0,100.00%
aeventlog.beacon.qq.com,6,0.00%,6,0,100.00%
i.glzip.com,6,0.00%,6,0,100.00%
api.kz.naruto.red,6,0.00%,6,0,100.00%
settings-prod-eus2-1.eastus2.cloudapp.azure.com,6,0.00%,6,0,100.00%
cdnpcwallpaper.zhhainiao.com,6,0.00%,6,0,100.00%
tracker.publicbt.com,6,0.00%,6,0,100.00%
fd.api.iris.microsoft.com,6,0.00%,6,0,100.00%
weather-drcn.music.dbankcloud.cn,6,0.00%,6,0,100.00%
mime.baidu.com,6,0.00%,6,0,100.00%
sv.symcb.com,6,0.00%,12,6,50.00%
suggestion.baidu.com,6,0.00%,11,5,54.55%
xcast.netcond.qq.com,6,0.00%,6,0,100.00%
ipv6.msftncsi.com,6,0.00%,10,4,60.00%
i.hhrspb7.top,6,0.00%,6,0,100.00%
nd8.baidupcs.com,6,0.00%,6,0,100.00%
displaycatalog.mp.microsoft.com,6,0.00%,6,0,100.00%
pigai.youdao.com,6,0.00%,6,0,100.00%
d2ws9o8vfrpkyk.cloudfront.net,6,0.00%,6,0,100.00%
logservice.hicloud.com,6,0.00%,6,0,100.00%
tokyo3.link.ac.cn,6,0.00%,6,0,100.00%
dl-debug.dropbox.com,6,0.00%,14,8,42.86%
bal-kube-westus-02.westus.cloudapp.azure.com,6,0.00%,6,0,100.00%
settings-prod-uks-1.uksouth.cloudapp.azure.com,6,0.00%,6,0,100.00%
ishaep1o.nodedata.net,6,0.00%,6,0,100.00%
emres.eastmoney.com,6,0.00%,12,6,50.00%
68.push2his.eastmoney.com,6,0.00%,6,0,100.00%
35.push2his.eastmoney.com,6,0.00%,6,0,100.00%
upos-sz-mirrorali.bilivideo.com.w.kunluncan.com,6,0.00%,6,0,100.00%
loginserver.kuwo.cn,6,0.00%,6,0,100.00%
update.360safe.com,6,0.00%,6,0,100.00%
sn.webrootcloudav.com,6,0.00%,6,0,100.00%
sovv.yilanvaas.com,6,0.00%,16,10,37.50%
vweixinthumb.tc.qq.com,6,0.00%,12,6,50.00%
pinyin.thunisoft.com,6,0.00%,6,0,100.00%
prod.fus.aws.intellij.net,6,0.00%,6,0,100.00%
conn.meeting.work.weixin.qq.com,6,0.00%,6,0,100.00%
logintcpnv.wps.cn,6,0.00%,6,0,100.00%
flow.wps.cn,6,0.00%,6,0,100.00%
assets.leetcode-cn.com,6,0.00%,6,0,100.00%
newsie.2345.com,6,0.00%,6,0,100.00%
m.toutiao.com.w.kunlunle.com,6,0.00%,6,0,100.00%
p3-tt.byteimg.com,6,0.00%,8,2,75.00%
lf3-cdn2-tos.bytescm.com,6,0.00%,8,2,75.00%
lf3-cdn2-tos.bytescm.com.w.alikunlun.com,6,0.00%,8,2,75.00%
p3-sign.toutiaoimg.com,6,0.00%,8,2,75.00%
sf3-cdn-tos.toutiaostatic.com,6,0.00%,8,2,75.00%
p3.toutiaoimg.com,6,0.00%,8,2,75.00%
sf3-cdn-tos.douyinstatic.com,6,0.00%,8,2,75.00%
lf3-csp.bytetos.com,6,0.00%,8,2,75.00%
lf3-short.bytegoofy.com,6,0.00%,8,2,75.00%
downloadapi.n.shifen.com,6,0.00%,6,0,100.00%
oneclient.sfx.ms,6,0.00%,15,9,40.00%
partnerad.l.doubleclick.net,6,0.00%,6,0,100.00%
APAC01.azure-devices.net,6,0.00%,6,0,100.00%
htydhd.wmupd.com,6,0.00%,6,0,100.00%
www.zybuluo.com,6,0.00%,6,0,100.00%
i1.c.eset.com,6,0.00%,6,0,100.00%
smp-device-content-cn.lb-apple.com.akadns.net,6,0.00%,6,0,100.00%
77.push2his.eastmoney.com,6,0.00%,6,0,100.00%
99.push2his.eastmoney.com,6,0.00%,6,0,100.00%
31.push2his.eastmoney.com,6,0.00%,6,0,100.00%
34.push2his.eastmoney.com,6,0.00%,6,0,100.00%
12.push2his.eastmoney.com,6,0.00%,6,0,100.00%
slink.ksapisrv.com,6,0.00%,6,0,100.00%
nfs.iscas.ac.cn,6,0.00%,6,0,100.00%
openbittorrent.com,6,0.00%,6,0,100.00%
8a78cx75.gus0.buzz,6,0.00%,6,0,100.00%
gsp85-cn-ssl.ls.apple.com,6,0.00%,6,0,100.00%
p0.img.360kuai.com,6,0.00%,8,2,75.00%
public.tracker.vraphim.com,6,0.00%,6,0,100.00%
dataflow.biliapi.com,6,0.00%,11,5,54.55%
array512.prod.do.dsp.mp.microsoft.com,6,0.00%,6,0,100.00%
bbs.nga.cn,6,0.00%,6,0,100.00%
upspinarakor.com,6,0.00%,6,0,100.00%
hwid-drcn.platform.hicloud.com,6,0.00%,6,0,100.00%
stun.internetcalls.com,6,0.00%,6,0,100.00%
stun.voip.aebc.com,6,0.00%,6,0,100.00%
stun.callwithus.com,6,0.00%,6,0,100.00%
download.virtualbox.org,6,0.00%,6,0,100.00%
e2875.d.akamaiedge.net,6,0.00%,6,0,100.00%
sh-download.weiyun.com,6,0.00%,12,6,50.00%
jx.cdn.qhstatic.com,6,0.00%,8,2,75.00%
evoke-windowsservices-tas-msedge-net.e-0009.e-msedge.net,6,0.00%,6,0,100.00%
e28578.d.akamaiedge.net,6,0.00%,6,0,100.00%
33-courier.push.apple.com,6,0.00%,6,0,100.00%
i3.cwip.eset.com,6,0.00%,6,0,100.00%
82.push2his.eastmoney.com,6,0.00%,6,0,100.00%
play.itunes.apple.com,6,0.00%,10,4,60.00%
36.courier-push-apple.com.akadns.net,6,0.00%,6,0,100.00%
gsa.apple.com,6,0.00%,6,0,100.00%
aphone.v1.mgtv.com,6,0.00%,6,0,100.00%
ols.officeapps.live.com,6,0.00%,6,0,100.00%
p2pchunk-ws.douyucdn.cn,6,0.00%,6,0,100.00%
itunes.apple.com,6,0.00%,6,0,100.00%
compiles.overleaf.com,6,0.00%,6,0,100.00%
roaming.officeapps.partner.office365.cn,6,0.00%,6,0,100.00%
msg.iqiyi.com,6,0.00%,6,0,100.00%
toblog.ctobsnssdk.com,6,0.00%,6,0,100.00%
s3a.pstatp.com,6,0.00%,12,6,50.00%
dsm01pap002.storage.live.com,6,0.00%,10,4,60.00%
nv00.cdn.bcebos.com,6,0.00%,6,0,100.00%
19.push2his.eastmoney.com,6,0.00%,6,0,100.00%
hub.fastgit.org,6,0.00%,6,0,100.00%
www.tm.a.prd.aadg.akadns.NET,6,0.00%,6,0,100.00%
e12919.dscd.akamaiedge.net,6,0.00%,12,6,50.00%
csd-apt-eas-d-4.eastasia.cloudapp.azure.com,6,0.00%,6,0,100.00%
hb.apis.dell.com,6,0.00%,6,0,100.00%
stdl.qq.com,6,0.00%,6,0,100.00%
tracker3.dler.org,6,0.00%,6,0,100.00%
data.grammarly.com,6,0.00%,6,0,100.00%
pc-store.lenovomm.cn,6,0.00%,6,0,100.00%
ad.doubleclick.net,6,0.00%,6,0,100.00%
maps.gstatic.cn,6,0.00%,6,0,100.00%
aqv.hicloud.com,6,0.00%,6,0,100.00%
grs.dbankcloud.asia,6,0.00%,6,0,100.00%
hxjstool.hexun.com,6,0.00%,6,0,100.00%
reg.tool.hexun.com,6,0.00%,6,0,100.00%
i0.hexun.com,6,0.00%,6,0,100.00%
c.cnzz.com,6,0.00%,6,0,100.00%
s13.cnzz.com,6,0.00%,6,0,100.00%
push.zhanzhang.baidu.com,6,0.00%,6,0,100.00%
api.share.baidu.com,6,0.00%,6,0,100.00%
comment.tool.hexun.com,6,0.00%,6,0,100.00%
stock.hexun.com,6,0.00%,6,0,100.00%
nj.hexun.com,6,0.00%,6,0,100.00%
xianhuo.hexun.com,6,0.00%,6,0,100.00%
zhongchou.hexun.com,6,0.00%,6,0,100.00%
pcw-api.iqiyi.com,6,0.00%,12,6,50.00%
flux.iqiyi.com,6,0.00%,6,0,100.00%
90.push2his.eastmoney.com,6,0.00%,6,0,100.00%
tr.gingersoftware.com,6,0.00%,6,0,100.00%
pc-update-3.wpscdn.cn,6,0.00%,6,0,100.00%
www.2600.com,6,0.00%,6,0,100.00%
ssl-google-analytics.l.google.com,6,0.00%,6,0,100.00%
wildcard46.go-mpulse.net.edgekey.net,6,0.00%,12,6,50.00%
windows.jingyeqian.com,6,0.00%,6,0,100.00%
prod.fs.microsoft.com.akadns.NET,6,0.00%,6,0,100.00%
bt.3dmgame.com,6,0.00%,6,0,100.00%
www.freerainbowtables.com,6,0.00%,6,0,100.00%
92.push2his.eastmoney.com,6,0.00%,6,0,100.00%
10.push2his.eastmoney.com,6,0.00%,6,0,100.00%
80.push2his.eastmoney.com,6,0.00%,6,0,100.00%
update.minipage.2345.cc,6,0.00%,6,0,100.00%
s17.upd.kaspersky.com,6,0.00%,6,0,100.00%
clientnotification-userprodea1-2.servicebus.windows.net,6,0.00%,6,0,100.00%
pc.profile.pinyin.sogou.com,6,0.00%,6,0,100.00%
72.push2his.eastmoney.com,6,0.00%,6,0,100.00%
nodestore-kiros-prod-lb-132549143.us-east-1.elb.amazonaws.com,6,0.00%,6,0,100.00%
pc.ximalaya.com,6,0.00%,6,0,100.00%
share.jomodns.com,6,0.00%,6,0,100.00%
k1.com.br,6,0.00%,6,0,100.00%
log-upload.mihoyo.com,6,0.00%,6,0,100.00%
xtremex.herokuapp.com,6,0.00%,6,0,100.00%
onedscolprdeus14.eastus.cloudapp.azure.com,6,0.00%,6,0,100.00%
p13n.adobe.io,6,0.00%,6,0,100.00%
www.newsmth.net,6,0.00%,6,0,100.00%
45-courier.push.apple.com,6,0.00%,6,0,100.00%
748049e45d87b8c7.jijifun.com,6,0.00%,6,0,100.00%
ping.sogou.com,6,0.00%,6,0,100.00%
visualstudio.download.prss.trafficmanager.net,6,0.00%,6,0,100.00%
is-ssl.mzstatic.com.itunes-apple.com.akadns.net,6,0.00%,6,0,100.00%
is-ssl.mzstatic.com-cn-lb.itunes-apple.com.akadns.net,6,0.00%,6,0,100.00%
is1-ssl.mzstatic.com.download.ks-cdn.com,6,0.00%,6,0,100.00%
ins-gk5vby51.ias.tencent-cloud.net,6,0.00%,6,0,100.00%
ios.now163.com,6,0.00%,6,0,100.00%
weu015-breeziest-in.cloudapp.net,6,0.00%,6,0,100.00%
static.hdslb.com,6,0.00%,6,0,100.00%
tieba.baidu.com,6,0.00%,7,1,85.71%
cdn.wwads.cn,6,0.00%,6,0,100.00%
data.pendo.io,6,0.00%,6,0,100.00%
d3ra9679oeq3gx.cloudfront.net,6,0.00%,6,0,100.00%
btinstall-artifacts.bittorrent.com,6,0.00%,10,4,60.00%
x2.c.lencr.org,6,0.00%,12,6,50.00%
onedriveclucproddm20043.blob.core.windows.net,6,0.00%,6,0,100.00%
95.push2his.eastmoney.com,6,0.00%,6,0,100.00%
steamcommunity-a.akamaihd.net,6,0.00%,6,0,100.00%
ifzq.finance.qq.com,6,0.00%,6,0,100.00%
ovv.alllook.tv,6,0.00%,6,0,100.00%
tools.google.com,6,0.00%,8,2,75.00%
7.push2his.eastmoney.com,6,0.00%,6,0,100.00%
anidex.moe,6,0.00%,6,0,100.00%
nisc.nfschina.com,6,0.00%,6,0,100.00%
onedscolprdeus03.eastus.cloudapp.azure.com,6,0.00%,11,5,54.55%
pdf-file.pdfxd.com,6,0.00%,6,0,100.00%
contracts.canonical.com,6,0.00%,6,0,100.00%
adashx4yt.m.taobao.com,6,0.00%,6,0,100.00%
h01hxsame.hexun.com,6,0.00%,6,0,100.00%
futures.hexun.com,6,0.00%,6,0,100.00%
pe.hexun.com,6,0.00%,6,0,100.00%
quote.hexun.com,6,0.00%,6,0,100.00%
ims-prod06.adobelogin.com,6,0.00%,6,0,100.00%
baidubox-emoji.cdn.bcebos.com,6,0.00%,6,0,100.00%
android.apis.google.com,6,0.00%,6,0,100.00%
idcdo11948.netvigators.xyz,6,0.00%,6,0,100.00%
gtm-cn-zvp2o6fq301.gtm-a4b1.com,6,0.00%,6,0,100.00%
sd2.1dadan.com,6,0.00%,6,0,100.00%
odin.adobe.com,6,0.00%,6,0,100.00%
ios.rqd.qq.com,5,0.00%,9,4,55.56%
login.im.qcloud.com,5,0.00%,5,0,100.00%
onedscolprdcus12.centralus.cloudapp.azure.com,5,0.00%,10,5,50.00%
e6987.a.akamaiedge.net,5,0.00%,5,0,100.00%
hm.e.shifen.com,5,0.00%,32,27,15.62%
stat.y.qq.com,5,0.00%,5,0,100.00%
gsp64-ssl.ls.apple.com,5,0.00%,5,0,100.00%
himg.bdimg.com,5,0.00%,10,5,50.00%
31-courier.push.apple.com,5,0.00%,5,0,100.00%
as-tlx.3lift.com,5,0.00%,5,0,100.00%
prebid.smilewanted.com,5,0.00%,5,0,100.00%
200-service-tang-1544055741.us-east-1.elb.amazonaws.com,5,0.00%,5,0,100.00%
shadowshq.yi.org,5,0.00%,5,0,100.00%
ws-keyboard.shouji.sogou.com,5,0.00%,5,0,100.00%
iie.arp.cn,5,0.00%,5,0,100.00%
prod.roaming1.live.com.akadns.net,5,0.00%,5,0,100.00%
img14.360buyimg.com,5,0.00%,10,5,50.00%
onedscolprdfrc01.francecentral.cloudapp.azure.com,5,0.00%,5,0,100.00%
gfwsl.geforce.com,5,0.00%,5,0,100.00%
c2shb.ssp.yahoo.com,5,0.00%,5,0,100.00%
skin.se.360.cn,5,0.00%,5,0,100.00%
sug.so.360.cn,5,0.00%,5,0,100.00%
ecs.office.com,5,0.00%,122,117,4.10%
mts.tvbit.co,5,0.00%,5,0,100.00%
video-bd-drcn.dbankcdn.cn,5,0.00%,39,34,12.82%
learning.u.wpscdn.cn,5,0.00%,10,5,50.00%
pptsgs.officeapps.live.com,5,0.00%,5,0,100.00%
dldir1v6.qq.com,5,0.00%,10,5,50.00%
appct.jianguoyun.com,5,0.00%,5,0,100.00%
dfzximg02.dftoutiao.com,5,0.00%,5,0,100.00%
cdn.download.comodo.com,5,0.00%,11,6,45.45%
darwin.qianxin.com,5,0.00%,5,0,100.00%
go.microsoft.com.edgekey.net,5,0.00%,10,5,50.00%
24.courier-push-apple.com.akadns.net,5,0.00%,5,0,100.00%
glb.api.prod.dcat.dsp.trafficmanager.net,5,0.00%,10,5,50.00%
settings-prod-eus2-2.eastus2.cloudapp.azure.com,5,0.00%,5,0,100.00%
onedscolprdcus00.centralus.cloudapp.azure.com,5,0.00%,5,0,100.00%
prod.configsvc1.live.com.akadns.net,5,0.00%,5,0,100.00%
anv.duba.net,5,0.00%,5,0,100.00%
pancake.cdn-apple.com.akadns.net,5,0.00%,5,0,100.00%
v19.stream.tencentmusic.com,5,0.00%,5,0,100.00%
browser.360.cn.download.ks-cdn.com,5,0.00%,9,4,55.56%
emimpcpf.trafficmanager.cn,5,0.00%,5,0,100.00%
appvolcanoedc.jianguoyun.com,5,0.00%,5,0,100.00%
api.lsplayer.com,5,0.00%,5,0,100.00%
filedownload.csw.lenovo.com,5,0.00%,5,0,100.00%
oth.str.mdt.qq.com,5,0.00%,5,0,100.00%
35-courier.push.apple.com,5,0.00%,5,0,100.00%
dl.kkdownload.com,5,0.00%,5,0,100.00%
upext.chrome.360.cn,5,0.00%,5,0,100.00%
collect.kugou.com,5,0.00%,7,2,71.43%
tracker.xdvdz.com,5,0.00%,5,0,100.00%
csd-apt-eas-d-3.eastasia.cloudapp.azure.com,5,0.00%,5,0,100.00%
gw.alipayobjects.com,5,0.00%,6,1,83.33%
sv.symcd.com,5,0.00%,10,5,50.00%
img1.pcfg.cache.wpscdn.cn,5,0.00%,11,6,45.45%
securepubads.g.doubleclick.net,5,0.00%,5,0,100.00%
ip1865976393.funshion.com,5,0.00%,5,0,100.00%
ip1880706120.funshion.com,5,0.00%,5,0,100.00%
ade.googlesyndication.com,5,0.00%,5,0,100.00%
smtp.nfschina.com,5,0.00%,5,0,100.00%
v.qq.com,5,0.00%,5,0,100.00%
browser-api.2345.cc,5,0.00%,5,0,100.00%
hcfy.app,5,0.00%,10,5,50.00%
nav.smartscreen.microsoft.com,5,0.00%,5,0,100.00%
www.duba.com,5,0.00%,8,3,62.50%
bingciservice.koreasouth.cloudapp.azure.com,5,0.00%,5,0,100.00%
us-u.openx.net,5,0.00%,5,0,100.00%
onedscolprdcus02.centralus.cloudapp.azure.com,5,0.00%,5,0,100.00%
k1-ipv6.gslb.ksyuncdn.com,5,0.00%,9,4,55.56%
gce-beacons.gcp.gvt2.com,5,0.00%,5,0,100.00%
sqimg.qq.com.cloud.tcdn.qq.com,5,0.00%,5,0,100.00%
sqimg.qq.com.sched.legopic2.tdnsv6.com,5,0.00%,5,0,100.00%
onedscolprdeus01.eastus.cloudapp.azure.com,5,0.00%,10,5,50.00%
ocsp.entrust.net.edgekey.net,5,0.00%,11,6,45.45%
dc1-file.ksn.kaspersky-labs.com,5,0.00%,5,0,100.00%
valid.origin-apple.com.akadns.net,5,0.00%,5,0,100.00%
api-drcn.theme.dbankcloud.cn,5,0.00%,5,0,100.00%
int.dpool.sina.com.cn,5,0.00%,5,0,100.00%
s3.amazonaws.com,5,0.00%,5,0,100.00%
www.toutiao.com,5,0.00%,16,11,31.25%
static.zhihu.com,5,0.00%,12,7,41.67%
ping.ie.sogou.com,5,0.00%,5,0,100.00%
opencdnv6.jomodns.com,5,0.00%,10,5,50.00%
a5ad128f94f1fd400.awsglobalaccelerator.com,5,0.00%,5,0,100.00%
arms-retcode.aliyuncs.com,5,0.00%,5,0,100.00%
baikebcs.bdimg.com,5,0.00%,6,1,83.33%
lf3-static.bytednsdoc.com,5,0.00%,8,3,62.50%
sfstat.lianmeng.360.cn,5,0.00%,5,0,100.00%
a-0032.a-msedge.net,5,0.00%,10,5,50.00%
kb.vmware.com,5,0.00%,10,5,50.00%
api.wondercv.com,5,0.00%,5,0,100.00%
1min.pcfg.cache.wpscdn.cn.qiniudns.com,5,0.00%,5,0,100.00%
tiny009.china.line.qiniudns.com,5,0.00%,5,0,100.00%
tiny.china.qiniu.com.trpcdn.net,5,0.00%,5,0,100.00%
zqnweb.v.trpcdn.net,5,0.00%,5,0,100.00%
settings-prod-eus-1.eastus.cloudapp.azure.com,5,0.00%,5,0,100.00%
geo-applefinance-cache.internal.query.g03.yahoodns.net,5,0.00%,5,0,100.00%
stocks-sparkline-lb.apple.com.akadns.net,5,0.00%,10,5,50.00%
desktop.docker.com,5,0.00%,10,5,50.00%
88.push2his.eastmoney.com,5,0.00%,5,0,100.00%
67.push2his.eastmoney.com,5,0.00%,5,0,100.00%
3.push2his.eastmoney.com,5,0.00%,5,0,100.00%
55.push2his.eastmoney.com,5,0.00%,5,0,100.00%
172-104-107-135.ip.linodeusercontent.com,5,0.00%,5,0,100.00%
info.wps.cn,5,0.00%,5,0,100.00%
sconf.f.360.cn,5,0.00%,5,0,100.00%
psg1-collabhubrtc.officeapps.live.com,5,0.00%,5,0,100.00%
imap.mxhichina.com,5,0.00%,5,0,100.00%
p3.qhimgs0.com,5,0.00%,6,1,83.33%
www.techweb.com.cn,5,0.00%,5,0,100.00%
v.baoshiyun.com,5,0.00%,5,0,100.00%
d23iz4esrwkib6.cloudfront.net,5,0.00%,9,4,55.56%
api.interpreter.caiyunai.com,5,0.00%,5,0,100.00%
f.c2r.ts.cdn.office.net,5,0.00%,5,0,100.00%
filehouse.zhhainiao.com,5,0.00%,5,0,100.00%
www.xboxab.com,5,0.00%,5,0,100.00%
inappcheck.itunes.apple.com.w.alikunlun.com,5,0.00%,5,0,100.00%
www.news.cn,5,0.00%,11,6,45.45%
auth.hiwifi.com,5,0.00%,5,0,100.00%
stun.voipbuster.com,5,0.00%,5,0,100.00%
stun.freeswitch.org,5,0.00%,5,0,100.00%
dig.bdurl.net,5,0.00%,5,0,100.00%
tracker.bz,5,0.00%,5,0,100.00%
stun.counterpath.com,5,0.00%,5,0,100.00%
a2p-s01-drcn.cloud.dbankcloud.cn,5,0.00%,5,0,100.00%
cutiegirl.ru,5,0.00%,5,0,100.00%
tracker.ddunlimited.net,5,0.00%,5,0,100.00%
22-courier.push.apple.com,5,0.00%,5,0,100.00%
onedscolprdcus09.centralus.cloudapp.azure.com,5,0.00%,5,0,100.00%
api.openweathermap.org,5,0.00%,5,0,100.00%
37.push2his.eastmoney.com,5,0.00%,5,0,100.00%
75.push2his.eastmoney.com,5,0.00%,5,0,100.00%
5.push2his.eastmoney.com,5,0.00%,5,0,100.00%
track.customer.io,5,0.00%,5,0,100.00%
scrootca2.ocsp.secomtrust.net,5,0.00%,7,2,71.43%
mailsucasaccn-my.sharepoint.com,5,0.00%,5,0,100.00%
umdc.alibaba-inc.com,5,0.00%,5,0,100.00%
music-torrent.net,5,0.00%,5,0,100.00%
tmfsdk4.m.qq.com,5,0.00%,5,0,100.00%
cdn-file.ludashi.com.m.alikunlun.net,5,0.00%,5,0,100.00%
retracker.sevstar.net,5,0.00%,5,0,100.00%
onedscolprdeus00.eastus.cloudapp.azure.com,5,0.00%,5,0,100.00%
onedscolprdwus14.westus.cloudapp.azure.com,5,0.00%,5,0,100.00%
imap.sina.cn,5,0.00%,5,0,100.00%
www.dongchedi.com,5,0.00%,5,0,100.00%
umengjmacs.m.taobao.com,5,0.00%,5,0,100.00%
c.apple.news,5,0.00%,14,9,35.71%
download.sublimetext.com,5,0.00%,5,0,100.00%
position.dftoutiao.com,5,0.00%,5,0,100.00%
download.mozilla.org,5,0.00%,5,0,100.00%
tracker.darmowy-torrent.pl,5,0.00%,5,0,100.00%
g.163.com,5,0.00%,5,0,100.00%
gw.m.163.com,5,0.00%,5,0,100.00%
comment.api.163.com,5,0.00%,5,0,100.00%
ipservice.ws.126.net,5,0.00%,5,0,100.00%
nex.163.com,5,0.00%,5,0,100.00%
static.googleadsserving.cn,5,0.00%,5,0,100.00%
s0.2mdn.net,5,0.00%,5,0,100.00%
puui.qpic.cn.sched.legopic1.tdnsv6.com,5,0.00%,5,0,100.00%
onedscolprdcus06.centralus.cloudapp.azure.com,5,0.00%,5,0,100.00%
m.hexun.com,5,0.00%,5,0,100.00%
www.homeway.com.cn,5,0.00%,5,0,100.00%
img0.baidu.com,5,0.00%,5,0,100.00%
minor-api.mihoyo.com,5,0.00%,5,0,100.00%
docerad.wps.cn,5,0.00%,5,0,100.00%
store-drcn.hispace.dbankcloud.cn,5,0.00%,5,0,100.00%
laserver.logitech.io,5,0.00%,5,0,100.00%
array501.prod.do.dsp.mp.microsoft.com,5,0.00%,5,0,100.00%
weather2db.cmcm.com,5,0.00%,5,0,100.00%
opencdnbdcharon.jomodns.com,5,0.00%,6,1,83.33%
update.os.nfschina.com,5,0.00%,5,0,100.00%
go.microsoft.com.edgekey.NET,5,0.00%,6,1,83.33%
83.push2his.eastmoney.com,5,0.00%,5,0,100.00%
mirrors.almalinux.org,5,0.00%,9,4,55.56%
musicstatus-apac-n.edge-itunes-apple.com.akadns.net,5,0.00%,5,0,100.00%
bag-smoot.v.aaplimg.com,5,0.00%,5,0,100.00%
biglmdiag.blob.core.windows.net,5,0.00%,5,0,100.00%
aefd.nelreports.net,5,0.00%,10,5,50.00%
cn.hzcm.1aba.cn,5,0.00%,5,0,100.00%
torrentclub.space,5,0.00%,5,0,100.00%
public.publictracker.xyz,5,0.00%,5,0,100.00%
weu011-breeziest-in.cloudapp.net,5,0.00%,5,0,100.00%
d1ykf07e75w7ss.cloudfront.net,5,0.00%,5,0,100.00%
app-measurement.com,5,0.00%,11,6,45.45%
api.accounts.firefox.com,5,0.00%,5,0,100.00%
windows.msn.cn,5,0.00%,6,1,83.33%
tracker.torrentyorg.pl,5,0.00%,5,0,100.00%
ledger.bt.co,5,0.00%,5,0,100.00%
m701.music.126.net.w.alikunlun.com,5,0.00%,6,1,83.33%
retracker.spb.ru,5,0.00%,5,0,100.00%
26.push2his.eastmoney.com,5,0.00%,5,0,100.00%
cu004.www.duba.net,5,0.00%,5,0,100.00%
mail.mydomain.com,5,0.00%,5,0,100.00%
gdmf.apple.com,5,0.00%,5,0,100.00%
cms-bucket.ws.126.net,5,0.00%,5,0,100.00%
consumerapps.mcafee.com,5,0.00%,5,0,100.00%
cdn-ali-file-shc.shanhutech.cn,5,0.00%,5,0,100.00%
curlsshop.nl,5,0.00%,5,0,100.00%
f-log-editor.grammarly.io,5,0.00%,5,0,100.00%
vrzk9nuhhsudshnuvgoxfjx8lthwaqxy.yundunwaf2.com,5,0.00%,5,0,100.00%
api.rollbar.com,5,0.00%,5,0,100.00%
sp4.tf.360.cn,5,0.00%,5,0,100.00%
iof.hexun.com,5,0.00%,5,0,100.00%
live-s3m.mediav.com,5,0.00%,5,0,100.00%
play-china.itunes-apple.com.akadns.net,5,0.00%,9,4,55.56%
interface.bilibili.com,5,0.00%,6,1,83.33%
s.ssl.qhres2.com,5,0.00%,6,1,83.33%
yt.droid.ac.cn,5,0.00%,5,0,100.00%
xp.itunes-apple.com.akadns.net,4,0.00%,8,4,50.00%
ocsp-cn-lb.apple.com.akadns.net,4,0.00%,6,2,66.67%
data.bilivideo.com,4,0.00%,4,0,100.00%
push-rtmp-vr-l6.douyincdn.com,4,0.00%,4,0,100.00%
pull-f5-hs.pstatp.com,4,0.00%,4,0,100.00%
lcs-cops.adobe.io,4,0.00%,4,0,100.00%
p218-quota.icloud.com.cn,4,0.00%,4,0,100.00%
www.letv.com,4,0.00%,4,0,100.00%
www.ifeng.com.cdn.dnsv1.com,4,0.00%,4,0,100.00%
www.chinaz.com,4,0.00%,4,0,100.00%
www.chinaz.com.cdn20.com,4,0.00%,4,0,100.00%
clientnotification-userprodscus1-0.servicebus.windows.net,4,0.00%,4,0,100.00%
docs.gtimg.com,4,0.00%,9,5,44.44%
ssp.ads.betweendigital.com,4,0.00%,4,0,100.00%
henbt.com,4,0.00%,4,0,100.00%
gia.jd.com,4,0.00%,7,3,57.14%
img12.360buyimg.com,4,0.00%,9,5,44.44%
img13.360buyimg.com,4,0.00%,9,5,44.44%
img11.360buyimg.com,4,0.00%,9,5,44.44%
clk.lenovo.com.cn,4,0.00%,4,0,100.00%
pbjs.e-planning.net,4,0.00%,4,0,100.00%
ads.themoneytizer.com,4,0.00%,10,6,40.00%
vis.vip.com,4,0.00%,4,0,100.00%
www.beian.gov.cn,4,0.00%,4,0,100.00%
spinfo.wps.cn,4,0.00%,4,0,100.00%
isee.weishi.qq.com,4,0.00%,4,0,100.00%
learnreport.xiaoeknow.com,4,0.00%,4,0,100.00%
bdimg.share.baidu.com,4,0.00%,4,0,100.00%
asst-api.ksord.com,4,0.00%,4,0,100.00%
browser5.qhimg.com,4,0.00%,4,0,100.00%
mscareers.b2clogin.com,4,0.00%,4,0,100.00%
zip.update.360safe.com,4,0.00%,4,0,100.00%
addons.g-fox.cn,4,0.00%,4,0,100.00%
home.firefoxchina.cn,4,0.00%,4,0,100.00%
bookmarks-ssl.firefoxchina.cn,4,0.00%,4,0,100.00%
p0.qhimgs4.com,4,0.00%,4,0,100.00%
img.yiqikan8.com,4,0.00%,4,0,100.00%
k-static.xsfaya.com,4,0.00%,4,0,100.00%
adu.g-fox.cn,4,0.00%,4,0,100.00%
download.amd.com,4,0.00%,4,0,100.00%
cbjs.baidu.com,4,0.00%,4,0,100.00%
3wabxy9b.sched.sma.tdnsstic1.cn,4,0.00%,4,0,100.00%
cs-geo-dds.trafficmanager.net,4,0.00%,4,0,100.00%
wd-prod-cp.trafficmanager.net,4,0.00%,4,0,100.00%
www.microsoft.com-c-3.edgekey.net,4,0.00%,4,0,100.00%
www.microsoft.com-c-3.edgekey.net.globalredir.akadns.net,4,0.00%,4,0,100.00%
46.courier-push-apple.com.akadns.net,4,0.00%,4,0,100.00%
waws-prod-sg1-057.sip.azurewebsites.windows.net,4,0.00%,4,0,100.00%
onedscolprdjpe04.japaneast.cloudapp.azure.com,4,0.00%,4,0,100.00%
honeycomb.wpscdn.cn.download.ks-cdn.com,4,0.00%,8,4,50.00%
appsforoffice.microsoft.com,4,0.00%,4,0,100.00%
wp.safe.360.cn,4,0.00%,4,0,100.00%
a-0003.a-msedge.net,4,0.00%,8,4,50.00%
pub.idqqimg.com.tc.qq.com,4,0.00%,8,4,50.00%
web4.obit.ru,4,0.00%,4,0,100.00%
tracker.publictorrent.net,4,0.00%,4,0,100.00%
jfhwnewvideos.peopletech.cn,4,0.00%,4,0,100.00%
www.edbiji.com,4,0.00%,4,0,100.00%
d3blkd4k0wk9oj.cloudfront.net,4,0.00%,4,0,100.00%
ldc-fast.lenovo.com.cn,4,0.00%,4,0,100.00%
pancake-cn.cdn-apple.com.akadns.net,4,0.00%,4,0,100.00%
consumer-licensing-aks2aks.md.mp.microsoft.com.akadns.net,4,0.00%,4,0,100.00%
licensing-prod-frontdoor-geomap.trafficmanager.net,4,0.00%,4,0,100.00%
v19.stream.tencentmusic.com.tcdn.qq.com,4,0.00%,4,0,100.00%
inference-location-livenet.trafficmanager.net,4,0.00%,4,0,100.00%
gspe35-cn-ssl.ls-apple.com.akadns.net,4,0.00%,8,4,50.00%
37.courier-push-apple.com.akadns.net,4,0.00%,4,0,100.00%
onedscolprdcus01.centralus.cloudapp.azure.com,4,0.00%,4,0,100.00%
msg-frontier-lf.feishu.cn,4,0.00%,4,0,100.00%
dcagent.mecdn.synacast.com,4,0.00%,4,0,100.00%
crl.apple.com,4,0.00%,7,3,57.14%
netmon-control.dropbox.com,4,0.00%,8,4,50.00%
t-ruanjian.2345.cc,4,0.00%,4,0,100.00%
weather-api.extfans.com,4,0.00%,4,0,100.00%
restlbs.map.qq.com,4,0.00%,4,0,100.00%
sp2.sangfor.com.cn,4,0.00%,4,0,100.00%
tangram-config.gdt.qq.com,4,0.00%,4,0,100.00%
info.zb.qq.com,4,0.00%,4,0,100.00%
bk.info.zb.qq.com,4,0.00%,4,0,100.00%
15.push2his.eastmoney.com,4,0.00%,4,0,100.00%
ext.henzanapp.com,4,0.00%,4,0,100.00%
onedriveclucprodbn20036.blob.core.windows.net,4,0.00%,4,0,100.00%
storage.live.com,4,0.00%,4,0,100.00%
ocsp05.actalis.it,4,0.00%,4,0,100.00%
tracker.vectahosting.eu,4,0.00%,42,38,9.52%
api.weathercn.com,4,0.00%,8,4,50.00%
hiboardng.hicloud.com,4,0.00%,4,0,100.00%
www.xiaohongshu.com,4,0.00%,4,0,100.00%
connect-drcn.hispace.hicloud.com,4,0.00%,4,0,100.00%
cn-zhangjiakou.axt.aliyun.com,4,0.00%,4,0,100.00%
s2.symcb.com,4,0.00%,8,4,50.00%
api.msn.cn,4,0.00%,4,0,100.00%
myip.ipip.net,4,0.00%,4,0,100.00%
47-courier.push.apple.com,4,0.00%,4,0,100.00%
ip1865976387.funshion.com,4,0.00%,4,0,100.00%
hcdnv.bili.gslb.c.cdnhwc2.com,4,0.00%,6,2,66.67%
ib.adnxs.com,4,0.00%,4,0,100.00%
cm.g.doubleclick.net,4,0.00%,4,0,100.00%
pixel.mathtag.com,4,0.00%,4,0,100.00%
googleads4.g.doubleclick.net,4,0.00%,4,0,100.00%
papi.look.360.cn,4,0.00%,4,0,100.00%
vip.dingtalk.com,4,0.00%,4,0,100.00%
beacons4.gvt2.com,4,0.00%,8,4,50.00%
wapi.kuwo.cn,4,0.00%,4,0,100.00%
artistpicserver.kuwo.cn,4,0.00%,4,0,100.00%
docs.microsoft.com,4,0.00%,4,0,100.00%
array503.prod.do.dsp.mp.microsoft.com,4,0.00%,9,5,44.44%
onedscolprduks05.uksouth.cloudapp.azure.com,4,0.00%,4,0,100.00%
baoshi.qq.com.x2.sched.dcloudstc.com,4,0.00%,4,0,100.00%
config.officeapps.live.com,4,0.00%,4,0,100.00%
aegis.qq.com,4,0.00%,14,10,28.57%
checkip.synology.com,4,0.00%,4,0,100.00%
11-courier.push.apple.com,4,0.00%,4,0,100.00%
update.gtm.eset.com,4,0.00%,4,0,100.00%
ws.mmstat.com,4,0.00%,4,0,100.00%
telemetry-incoming.r53-2.services.mozilla.com,4,0.00%,4,0,100.00%
onedriveclucproddm20042.blob.core.windows.net,4,0.00%,4,0,100.00%
datacenter-web.eastmoney.com,4,0.00%,8,4,50.00%
87.push2his.eastmoney.com,4,0.00%,4,0,100.00%
array611.prod.do.dsp.mp.microsoft.com,4,0.00%,4,0,100.00%
ct.duba.net,4,0.00%,4,0,100.00%
swallow-apple-com.v.aaplimg.com,4,0.00%,4,0,100.00%
s73.cnzz.com,4,0.00%,4,0,100.00%
tools.jb51.net,4,0.00%,4,0,100.00%
unmc.cdn.bcebos.com,4,0.00%,4,0,100.00%
wework.qpic.cn,4,0.00%,5,1,80.00%
fsigns.duba.net,4,0.00%,4,0,100.00%
unionsug.baidu.com,4,0.00%,4,0,100.00%
dl.maxthon.cn,4,0.00%,4,0,100.00%
sslbaidu.jomodns.com,4,0.00%,6,2,66.67%
app.wpscdn.cn,4,0.00%,9,5,44.44%
softbus-msg.wps.cn,4,0.00%,4,0,100.00%
static.leetcode.cn,4,0.00%,4,0,100.00%
leetcode.cn,4,0.00%,4,0,100.00%
analysis.leetcode.cn,4,0.00%,4,0,100.00%
ws2.leetcode.cn,4,0.00%,4,0,100.00%
pic.leetcode-cn.com.w.kunlungr.com,4,0.00%,4,0,100.00%
zotero-repo.s3.amazonaws.com,4,0.00%,4,0,100.00%
assets.giocdn.com,4,0.00%,4,0,100.00%
pic.leetcode-cn.com,4,0.00%,4,0,100.00%
www.600dvd.com,4,0.00%,4,0,100.00%
pc.stgowan.com,4,0.00%,4,0,100.00%
p.hnnzwhyy.com,4,0.00%,4,0,100.00%
p1-tt.byteimg.com.wsglb0.com,4,0.00%,8,4,50.00%
v.sogowan.com,4,0.00%,4,0,100.00%
p9-tt.byteimg.com,4,0.00%,7,3,57.14%
sf1-cdn-tos.toutiaostatic.com,4,0.00%,8,4,50.00%
lf9-static.bytednsdoc.com,4,0.00%,8,4,50.00%
p1.toutiaoimg.com,4,0.00%,8,4,50.00%
sf6-cdn-tos.toutiaostatic.com,4,0.00%,8,4,50.00%
www.toutiao.com.w.kunluncan.com,4,0.00%,7,3,57.14%
lf3-beecdn.bytetos.com,4,0.00%,8,4,50.00%
path1.xtracloud.net,4,0.00%,4,0,100.00%
onedriveclucprodbn20019.blob.core.windows.net,4,0.00%,4,0,100.00%
service-cdn.qiqiuyun.net,4,0.00%,4,0,100.00%
shuc-pc-snow.ksord.com,4,0.00%,4,0,100.00%
www.nowcoder.com,4,0.00%,4,0,100.00%
down1.xinshuru.com,4,0.00%,4,0,100.00%
r3---sn-2x3elnes.gvt1.com,4,0.00%,4,0,100.00%
12.courier-push-apple.com.akadns.net,4,0.00%,4,0,100.00%
wmgp-update.wmupd.com.w.alikunlun.com,4,0.00%,4,0,100.00%
vconf.f.360.cn,4,0.00%,4,0,100.00%
htydhd.wmupd.com.w.kunluncan.com,4,0.00%,4,0,100.00%
zybuluo.com,4,0.00%,4,0,100.00%
50-courier.push.apple.com,4,0.00%,4,0,100.00%
30.push2his.eastmoney.com,4,0.00%,4,0,100.00%
4.push2his.eastmoney.com,4,0.00%,4,0,100.00%
44.newspush.eastmoney.com,4,0.00%,4,0,100.00%
tracker.baltracker.net,4,0.00%,4,0,100.00%
www.xwt-classics.net,4,0.00%,4,0,100.00%
retracker.telecom.by,4,0.00%,4,0,100.00%
pcstat.kugou.com,4,0.00%,4,0,100.00%
federatedml-pa.googleapis.com,4,0.00%,4,0,100.00%
dailyupdate.wangwang.taobao.com,4,0.00%,4,0,100.00%
jtrn.is.autonavi.com.gds.alibabadns.com,4,0.00%,4,0,100.00%
iphonesubmissions.apple.com,4,0.00%,4,0,100.00%
44-courier.push.apple.com,4,0.00%,4,0,100.00%
p2plog.douyucdn.cn,4,0.00%,10,6,40.00%
cloud.acrobat.com,4,0.00%,4,0,100.00%
configsvr.msf.3g.qq.com,4,0.00%,4,0,100.00%
view.csslcloud.net,4,0.00%,4,0,100.00%
class.csslcloud.net,4,0.00%,4,0,100.00%
ipinfo.io,4,0.00%,4,0,100.00%
tconf.f.360.cn,4,0.00%,4,0,100.00%
img.nga.178.com,4,0.00%,4,0,100.00%
stun.voipstunt.com,4,0.00%,4,0,100.00%
mirrors.huaweicloud.com,4,0.00%,4,0,100.00%
feed.wan.360.cn,4,0.00%,4,0,100.00%
linux.teamviewer.com,4,0.00%,8,4,50.00%
tracker.iamhansen.xyz,4,0.00%,4,0,100.00%
tracker.loadbt.com,4,0.00%,8,4,50.00%
uptime.sangfor.net,4,0.00%,4,0,100.00%
steam-chat.com,4,0.00%,4,0,100.00%
outlook.office.com,4,0.00%,9,5,44.44%
update-drcn.platform.hicloud.com,4,0.00%,4,0,100.00%
34-courier.push.apple.com,4,0.00%,4,0,100.00%
34.courier-push-apple.com.akadns.net,4,0.00%,4,0,100.00%
www.tm.lg.prod.aadmsa.akadns.net,4,0.00%,4,0,100.00%
r2---sn-2x3elnes.gvt1.com,4,0.00%,4,0,100.00%
caldav.fe.apple-dns.cn,4,0.00%,4,0,100.00%
dlied6.qq.com.tcdn.qq.com,4,0.00%,4,0,100.00%
onedscolprduks01.uksouth.cloudapp.azure.com,4,0.00%,6,2,66.67%
33.courier-push-apple.com.akadns.net,4,0.00%,4,0,100.00%
74.push2his.eastmoney.com,4,0.00%,4,0,100.00%
www.eastmoney.com,4,0.00%,8,4,50.00%
g1.dfcfw.com,4,0.00%,8,4,50.00%
j4.dfcfw.com,4,0.00%,8,4,50.00%
utclient.utorrent.com,4,0.00%,6,2,66.67%
mailsucasaccn.sharepoint.com,4,0.00%,4,0,100.00%
nibba.trade,4,0.00%,4,0,100.00%
onedscolprdneu02.northeurope.cloudapp.azure.com,4,0.00%,4,0,100.00%
sugar.zhihu.com,4,0.00%,10,6,40.00%
j1hqc7ee.sched.d0-dk.tdnsdp1.cn,4,0.00%,7,3,57.14%
ada.e.shifen.com,4,0.00%,4,0,100.00%
selfpage-gips.cdn.bcebos.com,4,0.00%,4,0,100.00%
le3-api.game.bilibili.com,4,0.00%,4,0,100.00%
le3-api.game.bilibili.com.dsa.dnsv1.com,4,0.00%,4,0,100.00%
fs-wildcard.microsoft.com.edgekey.net.globalredir.akadns.net,4,0.00%,4,0,100.00%
e1723.ca.s.tl88.net,4,0.00%,4,0,100.00%
mmbiz.qpic.cn.sched.legopic1.tdnsv6.com,4,0.00%,4,0,100.00%
gspe35-ssl.ls.apple.com.w.alikunlun.com,4,0.00%,4,0,100.00%
onedscolprdwus01.westus.cloudapp.azure.com,4,0.00%,6,2,66.67%
pica.zhimg.com,4,0.00%,10,6,40.00%
onedsblobprdeus15.eastus.cloudapp.azure.com,4,0.00%,4,0,100.00%
api.zhihu.com,4,0.00%,6,2,66.67%
at.idqqimg.com,4,0.00%,4,0,100.00%
services.addons.mozilla.org,4,0.00%,4,0,100.00%
sdk.congyicn.com,4,0.00%,4,0,100.00%
mobilep2.douyucdn2.cn,4,0.00%,4,0,100.00%
p.data.cctv.com,4,0.00%,4,0,100.00%
h-adashx.dingtalkapps.com,4,0.00%,4,0,100.00%
gateway.kugou.com,4,0.00%,7,3,57.14%
zhuanlan.zhihu.com,4,0.00%,10,6,40.00%
captcha.zhihu.com,4,0.00%,8,4,50.00%
inappcheck.itunes.apple.com,4,0.00%,4,0,100.00%
k128-inapp.gslb.ksyuncdn.com,4,0.00%,8,4,50.00%
aapl-edge0.qtlcdn.com,4,0.00%,4,0,100.00%
lvs.52tt.com,4,0.00%,4,0,100.00%
pcvideoaliyun.titan.mgtv.com,4,0.00%,4,0,100.00%
connect.rom.miui.com,4,0.00%,4,0,100.00%
api-access.pangolin-sdk-toutiao.com,4,0.00%,6,2,66.67%
images2015.cnblogs.com,4,0.00%,4,0,100.00%
kunpeng-sc.csdnimg.cn,4,0.00%,4,0,100.00%
ocsp.dcocsp.cn,4,0.00%,4,0,100.00%
9-courier.push.apple.com,4,0.00%,4,0,100.00%
hiswd.jd.com,4,0.00%,4,0,100.00%
www.jd.com,4,0.00%,4,0,100.00%
d.jd.com,4,0.00%,4,0,100.00%
im-x.jd.com,4,0.00%,4,0,100.00%
nfa.jd.com,4,0.00%,4,0,100.00%
ecomcbjs.jomodns.com,4,0.00%,4,0,100.00%
announce.partis.si,4,0.00%,8,4,50.00%
c.liepin.com,4,0.00%,4,0,100.00%
insideruser.microsoft.com,4,0.00%,4,0,100.00%
torrents-nn.cn,4,0.00%,4,0,100.00%
service.weibo.com,4,0.00%,4,0,100.00%
0.openwrt.pool.ntp.org,4,0.00%,4,0,100.00%
m0.mail.sina.com.cn,4,0.00%,4,0,100.00%
download-installer.cdn.mozilla.net,4,0.00%,7,3,57.14%
tbskip.taobao.com,4,0.00%,4,0,100.00%
mixfiend.com,4,0.00%,4,0,100.00%
phx02pap003.storage.live.com,4,0.00%,8,4,50.00%
bt.unionpeer.org,4,0.00%,4,0,100.00%
profile.firefox.com.cn,4,0.00%,4,0,100.00%
sync.firefox.com.cn,4,0.00%,4,0,100.00%
qtx4xi8lzc.feishu.cn,4,0.00%,4,0,100.00%
metrics1-drcn.dt.dbankcloud.cn,4,0.00%,4,0,100.00%
mylittleslaveponny.club,4,0.00%,4,0,100.00%
kvt.sddan.com,4,0.00%,4,0,100.00%
wps-file.obs.cn-north-4.myhuaweicloud.com,4,0.00%,4,0,100.00%
tracker2.wasabii.com.tw,4,0.00%,4,0,100.00%
sync.search.spotxchange.com,4,0.00%,4,0,100.00%
events-drcn.op.dbankcloud.cn,4,0.00%,4,0,100.00%
a5.behance.net,4,0.00%,6,2,66.67%
267.bshl.ieplgia9929.net,4,0.00%,4,0,100.00%
bakwebrtcpunch.video.qq.com,4,0.00%,4,0,100.00%
img.hexun.com,4,0.00%,4,0,100.00%
bond.hexun.com,4,0.00%,4,0,100.00%
i7.hexun.com,4,0.00%,4,0,100.00%
so.hexun.com,4,0.00%,4,0,100.00%
www.hexun.com,4,0.00%,4,0,100.00%
itv.hexun.com,4,0.00%,4,0,100.00%
apptrace.hexun.com,4,0.00%,4,0,100.00%
opentool.hexun.com,4,0.00%,4,0,100.00%
pcookie.cnzz.com,4,0.00%,4,0,100.00%
house.hexun.com,4,0.00%,4,0,100.00%
caidao.homeway.com.cn,4,0.00%,4,0,100.00%
passport.csdn.net,4,0.00%,4,0,100.00%
corp.hexun.com,4,0.00%,4,0,100.00%
kf.hexun.com,4,0.00%,4,0,100.00%
news.mydrivers.com,4,0.00%,7,3,57.14%
bschool.hexun.com,4,0.00%,4,0,100.00%
img2.baidu.com,4,0.00%,4,0,100.00%
nsp-logservice-hiview-p40-drcn.obs.cn-north-2.myhuaweicloud.com,4,0.00%,4,0,100.00%
report.idqqimg.com,4,0.00%,4,0,100.00%
httpdns.n.netease.com,4,0.00%,4,0,100.00%
imgcache.qq.com,4,0.00%,7,3,57.14%
docs.live.net,4,0.00%,5,1,80.00%
baidu.com,4,0.00%,4,0,100.00%
login.psvr.wps.cn,4,0.00%,4,0,100.00%
configuration.apple.com,4,0.00%,6,2,66.67%
login.chinacloudapi.cn,4,0.00%,4,0,100.00%
onedriveclucproddm20012.blob.core.windows.net,4,0.00%,4,0,100.00%
wwcdn.weixin.qq.com,4,0.00%,4,0,100.00%
mail2.zelenaya.net,4,0.00%,4,0,100.00%
dhupdateprod.blob.core.windows.net,4,0.00%,4,0,100.00%
su.itunes.apple.com,4,0.00%,8,4,50.00%
asimov.vortex.data.trafficmanager.NET,4,0.00%,4,0,100.00%
e1723.ca.s.tl88.NET,4,0.00%,4,0,100.00%
business.qqpy.sogou.com,4,0.00%,4,0,100.00%
config.safedog.cn,4,0.00%,4,0,100.00%
down.safedog.cn,4,0.00%,4,0,100.00%
ntp.ntsc.ac.cn,4,0.00%,4,0,100.00%
qgepodownload.mediatek.com,4,0.00%,4,0,100.00%
www.soupm25.com,4,0.00%,4,0,100.00%
ts.minipage.2345.cc,4,0.00%,4,0,100.00%
t.minipage.2345.cc,4,0.00%,4,0,100.00%
onedriveclucprodbn20037.blob.core.windows.net,4,0.00%,4,0,100.00%
3.openwrt.pool.ntp.org,4,0.00%,4,0,100.00%
fanyi.qq.com,4,0.00%,4,0,100.00%
api.smoot.apple.cn,4,0.00%,4,0,100.00%
dsm01pap007.storage.live.com,4,0.00%,8,4,50.00%
blob.bl6prdstr05a.store.core.windows.net,4,0.00%,4,0,100.00%
d1dagyb1ctngx1.cloudfront.net,4,0.00%,5,1,80.00%
25.push2his.eastmoney.com,4,0.00%,4,0,100.00%
ota.nvidia.com,4,0.00%,4,0,100.00%
flow.logitech.io,4,0.00%,4,0,100.00%
accwww6.53kf.com,4,0.00%,4,0,100.00%
forum.taichi.graphics,4,0.00%,4,0,100.00%
www.valadygators.com,4,0.00%,4,0,100.00%
www.wangpans.com,4,0.00%,4,0,100.00%
www.eclzy.com,4,0.00%,4,0,100.00%
www.epanso.com,4,0.00%,4,0,100.00%
www.ciligogo.vip,4,0.00%,4,0,100.00%
www.xbqgxs.net,4,0.00%,4,0,100.00%
www.mmkx8.cc,4,0.00%,4,0,100.00%
tracker3.ctix.cn,4,0.00%,4,0,100.00%
widemus.de,4,0.00%,4,0,100.00%
960303.xyz,4,0.00%,4,0,100.00%
camera.lei001.com,4,0.00%,4,0,100.00%
bt.ktrackers.com,4,0.00%,4,0,100.00%
www.btmovi.plus,4,0.00%,4,0,100.00%
aarsen.me,4,0.00%,4,0,100.00%
eclso.me,4,0.00%,4,0,100.00%
ben.kerbertools.xyz,4,0.00%,4,0,100.00%
astrr.ru,4,0.00%,4,0,100.00%
keke.re,4,0.00%,4,0,100.00%
cutscloud.duckdns.org,4,0.00%,4,0,100.00%
davidkirkevans.com,4,0.00%,4,0,100.00%
mail.zasaonsk.ga,4,0.00%,4,0,100.00%
fh2.cmp-gaming.com,4,0.00%,4,0,100.00%
laze.cc,4,0.00%,4,0,100.00%
psyco.fr,4,0.00%,4,0,100.00%
run-2.publictracker.xyz,4,0.00%,4,0,100.00%
new-line.net,4,0.00%,4,0,100.00%
tracker.4.babico.name.tr,4,0.00%,4,0,100.00%
tracker.0x.tf,4,0.00%,4,0,100.00%
rep-art.ynh.fr,4,0.00%,4,0,100.00%
sanincode.com,4,0.00%,4,0,100.00%
smtp-relay.odysseylabel.com.au,4,0.00%,4,0,100.00%
tracker.monitorit4.me,4,0.00%,4,0,100.00%
tracker.army,4,0.00%,4,0,100.00%
frp.zengwu.com.cn,4,0.00%,4,0,100.00%
print-data.houston.hp.com,4,0.00%,4,0,100.00%
a.jd.com.gslb.qianxun.com,4,0.00%,4,0,100.00%
uz95.v.bsclink.cn,4,0.00%,4,0,100.00%
aserver-heyi.m.taobao.com.gds.alibabadns.com,4,0.00%,4,0,100.00%
p214-quota.icloud.com.cn,4,0.00%,4,0,100.00%
static.hotjar.com,4,0.00%,4,0,100.00%
us.sinaimg.cn.w.alikunlun.net,4,0.00%,8,4,50.00%
weu012-breeziest-in.cloudapp.net,4,0.00%,4,0,100.00%
ux70.v.trpcdn.net,4,0.00%,4,0,100.00%
v1.go2yd.com.wjgslb.com,4,0.00%,4,0,100.00%
cdn-home-packages.chinauos.com,4,0.00%,4,0,100.00%
revive.outin.cn,4,0.00%,4,0,100.00%
api.steampowered.com,4,0.00%,4,0,100.00%
service.cqttech.com,4,0.00%,4,0,100.00%
client.apc.360.cn,4,0.00%,4,0,100.00%
update.khd.2345.cc,4,0.00%,4,0,100.00%
sslbdstatic.jomodns.com,4,0.00%,4,0,100.00%
rog-live-service.asus.com,4,0.00%,4,0,100.00%
service.dg.wps.cn,4,0.00%,4,0,100.00%
skydrivesync.policies.live.net,4,0.00%,4,0,100.00%
41.courier-push-apple.com.akadns.net,4,0.00%,4,0,100.00%
40-courier.push.apple.com,4,0.00%,4,0,100.00%
40.courier-push-apple.com.akadns.net,4,0.00%,4,0,100.00%
onedscolprdwus11.westus.cloudapp.azure.com,4,0.00%,8,4,50.00%
www.dvidshub.net,4,0.00%,4,0,100.00%
2-courier.push.apple.com,4,0.00%,4,0,100.00%
lhpay.gzcl999.com,4,0.00%,4,0,100.00%
bjk.163.com,4,0.00%,4,0,100.00%
cronus.ie.sogou.com,4,0.00%,4,0,100.00%
debug.anuson.com,4,0.00%,4,0,100.00%
s346.s2022.xyz,4,0.00%,4,0,100.00%
stun.hitv.com,4,0.00%,4,0,100.00%
wikipedia.firstpartyapps.oaspapps.com,4,0.00%,4,0,100.00%
proxy.sogou.com,4,0.00%,4,0,100.00%
torrentzilla.org,4,0.00%,4,0,100.00%
torrents.linuxmint.com,4,0.00%,4,0,100.00%
torrents.hikarinokiseki.com,4,0.00%,4,0,100.00%
lenovo.archive.canonical.com,4,0.00%,4,0,100.00%
dashboard.snapcraft.io,4,0.00%,4,0,100.00%
api.naea1.uds.lenovo.com,4,0.00%,4,0,100.00%
doh.zjurl.cn,4,0.00%,4,0,100.00%
high-frequency-gray-cdn.duba.net,4,0.00%,4,0,100.00%
onedriveclucproddm20008.blob.core.windows.net,4,0.00%,4,0,100.00%
newvip.duba.net,4,0.00%,4,0,100.00%
tracker.shittyurl.org,4,0.00%,8,4,50.00%
d1epqfzld01eon.cloudfront.net,4,0.00%,4,0,100.00%
intf-pc.ludashi.com,4,0.00%,4,0,100.00%
250.218.133.34.bc.googleusercontent.com,4,0.00%,4,0,100.00%
qiniustaticopencdn.jomodns.com,4,0.00%,4,0,100.00%
tracker.nighthawk.pw,4,0.00%,8,4,50.00%
beertracker.ml,4,0.00%,4,0,100.00%
p204-quota.icloud.com.cn,4,0.00%,4,0,100.00%
app.grammarly.com,4,0.00%,4,0,100.00%
content.dellsupportcenter.com,4,0.00%,4,0,100.00%
mapm.douyucdn.cn,4,0.00%,4,0,100.00%
hub5u.wap.sandai.net,4,0.00%,4,0,100.00%
hub5pn.wap.sandai.net,4,0.00%,4,0,100.00%
idx.m.hub.sandai.net,4,0.00%,4,0,100.00%
sr.m.hub.sandai.net,4,0.00%,4,0,100.00%
home.yxgz.vip,4,0.00%,4,0,100.00%
krsk05.graniterapids.com,4,0.00%,4,0,100.00%
t0.tiles.ditu.live.com,4,0.00%,4,0,100.00%
dynamic.api.tiles.ditu.live.com,4,0.00%,4,0,100.00%
juniper,4,0.00%,4,0,100.00%
me.apple-dns.net,4,0.00%,8,4,50.00%
musicstatus.edge-itunes-apple.com.akadns.net,4,0.00%,4,0,100.00%
musicstatus-apac.edge-itunes-apple.com.akadns.net,4,0.00%,4,0,100.00%
web.cs.dal.ca,4,0.00%,4,0,100.00%
otbs.azurewebsites.net,4,0.00%,4,0,100.00%
daws.azurewebsites.net,4,0.00%,4,0,100.00%
hz-jp.transit.freework.cyou,4,0.00%,4,0,100.00%
hd-jp.transit.freework.cyou,4,0.00%,4,0,100.00%
3g.163.com,4,0.00%,4,0,100.00%
channel.m.163.com,4,0.00%,4,0,100.00%
ifeng3.yylady.cn,4,0.00%,4,0,100.00%
download.mcafee.com,4,0.00%,4,0,100.00%
gaode-jmacs.m.taobao.com,4,0.00%,4,0,100.00%
windows.policies.live.net,4,0.00%,4,0,100.00%
cdn-ali-img-shstaticbz.shanhutech.cn,4,0.00%,4,0,100.00%
api.epicgames.dev,4,0.00%,4,0,100.00%
markets.businessinsider.com,4,0.00%,8,4,50.00%
telemetry-in.battlenet.com.cn,4,0.00%,4,0,100.00%
mbd.n.shifen.com,4,0.00%,4,0,100.00%
p0.ssl.img.360kuai.com,4,0.00%,5,1,80.00%
www.onlineregister.com,4,0.00%,4,0,100.00%
m801.music.126.net,4,0.00%,10,6,40.00%
scrootca1.ocsp.secomtrust.net,4,0.00%,4,0,100.00%
update-haozip.2345.cc,4,0.00%,4,0,100.00%
in.appcenter.ms,4,0.00%,4,0,100.00%
upos-sz-mirrorhw.bilivideo.com.ctdns.cn,4,0.00%,8,4,50.00%
210194c475687be6.jijifun.com,4,0.00%,4,0,100.00%
d2x0118v5hofu3.cloudfront.net,4,0.00%,4,0,100.00%
dellupdater.dell.com,4,0.00%,4,0,100.00%
33.push2his.eastmoney.com,4,0.00%,4,0,100.00%
47.push2his.eastmoney.com,4,0.00%,4,0,100.00%
ali-pc-x-speed-auth-vip.xunlei.com,4,0.00%,4,0,100.00%
ieonline.microsoft.com,4,0.00%,4,0,100.00%
sat02pap002.storage.live.com,4,0.00%,4,0,100.00%
goproxy.cn,4,0.00%,4,0,100.00%
logintool.hexun.com,4,0.00%,4,0,100.00%
web.hexun.com,4,0.00%,4,0,100.00%
i6.hexun.com,4,0.00%,4,0,100.00%
wuye.hexun.com,4,0.00%,4,0,100.00%
data.hexun.com,4,0.00%,4,0,100.00%
ds.hexun.com,4,0.00%,4,0,100.00%
gold.hexun.com,4,0.00%,4,0,100.00%
hk.stock.hexun.com,4,0.00%,4,0,100.00%
licaike.hexun.com,4,0.00%,4,0,100.00%
tech.hexun.com,4,0.00%,4,0,100.00%
1332791409-server.va.huya.com,4,0.00%,4,0,100.00%
a.shentonggo.cn,4,0.00%,4,0,100.00%
lf26-orange.byteorge.com,4,0.00%,4,0,100.00%
vip.foxitreader.cn,4,0.00%,4,0,100.00%
array805.prod.do.dsp.mp.microsoft.com,4,0.00%,4,0,100.00%
pcmgrmonitor.3g.qq.com,4,0.00%,4,0,100.00%
29.push2his.eastmoney.com,4,0.00%,4,0,100.00%
adashx.ut.youku.com,4,0.00%,4,0,100.00%
pinst.360.cn,4,0.00%,4,0,100.00%
na61-na62.wagbridge.alibaba.taobao.com,4,0.00%,4,0,100.00%
common.cnblogs.com,4,0.00%,4,0,100.00%
static.cnblogs.com,4,0.00%,4,0,100.00%
pic.cnblogs.com,4,0.00%,4,0,100.00%
imap.mail.rice.edu,4,0.00%,4,0,100.00%
v2.sohu.com,4,0.00%,8,4,50.00%
drpf-g37.proxima.nie.netease.com,4,0.00%,4,0,100.00%
p3.img.360kuai.com,4,0.00%,5,1,80.00%
apps-mzstatic-cdn.itunes-apple.com.akadns.net,4,0.00%,7,3,57.14%
play-cdn.itunes-apple.com.akadns.net,4,0.00%,7,3,57.14%
apne1-bytedance-cn.sentinelone.net,4,0.00%,4,0,100.00%
seal-api.bytedance.net.w.kunluncan.com,4,0.00%,4,0,100.00%
prod.odcsm1.live.com.akadns.net,4,0.00%,4,0,100.00%
d2h67oheeuigaw.cloudfront.net,4,0.00%,8,4,50.00%
connectivity.pod1.avatar.ext.hp.com,4,0.00%,4,0,100.00%
all.lv2.qnydns.com,4,0.00%,4,0,100.00%
newstock.finance.qq.com,4,0.00%,4,0,100.00%
data.eastmoney.com,4,0.00%,8,4,50.00%
ccm-frontier.feishu.cn,4,0.00%,4,0,100.00%
tm-prod-wd-csp-edge.trafficmanager.net,4,0.00%,4,0,100.00%
is4-ssl.mzstatic.com,4,0.00%,4,0,100.00%
n1.szjal.cn,4,0.00%,4,0,100.00%
gdown.baidu.com,4,0.00%,4,0,100.00%
vfiles.gtimg.cn,4,0.00%,4,0,100.00%
cdn.taboola.com,4,0.00%,4,0,100.00%
api.smoot.apple.com,4,0.00%,4,0,100.00%
people-lucky-videos.obs.cn-north-4.myhuaweicloud.com,4,0.00%,4,0,100.00%
onedriveclucproddm20021.blob.core.windows.net,4,0.00%,4,0,100.00%
www.sinfors.com.cn,4,0.00%,4,0,100.00%
jpedu-my.sharepoint.com,4,0.00%,4,0,100.00%
x.clearbitjs.com,4,0.00%,4,0,100.00%
munchkin.marketo.net,4,0.00%,4,0,100.00%
11762090.fls.doubleclick.net,4,0.00%,4,0,100.00%
ins-8y4ghcjp.ias.tencent-cloud.net,3,0.00%,3,0,100.00%
init-p01st.push.apple.com,3,0.00%,6,3,50.00%
b-0008.b-msedge.net,3,0.00%,6,3,50.00%
gsas.idms-apple.com.akadns.net,3,0.00%,3,0,100.00%
ic3.events.data.microsoft.com,3,0.00%,4,1,75.00%
onedscolprdeus12.eastus.cloudapp.azure.com,3,0.00%,3,0,100.00%
eas.outlook.com,3,0.00%,7,4,42.86%
x8.x9.client.api.vpngate2.jp,3,0.00%,4,1,75.00%
onedscolprdfrc06.francecentral.cloudapp.azure.com,3,0.00%,3,0,100.00%
fyzbgp.a.sohu.com,3,0.00%,6,3,50.00%
bl3301.storage.live.com,3,0.00%,5,2,60.00%
onedscolprdwus02.westus.cloudapp.azure.com,3,0.00%,3,0,100.00%
openlocation-drcn.platform.dbankcloud.com,3,0.00%,4,1,75.00%
eu-west-1.axt.aliyun.com,3,0.00%,3,0,100.00%
ali2.a.yximgs.com,3,0.00%,3,0,100.00%
shb.richaudience.com,3,0.00%,3,0,100.00%
prebid.a-mo.net,3,0.00%,3,0,100.00%
apa.vap.lijit.com,3,0.00%,3,0,100.00%
eqx.smartadserver.com,3,0.00%,5,2,60.00%
genuine.adobe.com,3,0.00%,5,2,60.00%
server1.9sheng.cn,3,0.00%,3,0,100.00%
fr01.xiaocloud.info,3,0.00%,3,0,100.00%
tracker.xfsub.com,3,0.00%,3,0,100.00%
eddie4.nl,3,0.00%,3,0,100.00%
mgtracker.org,3,0.00%,3,0,100.00%
tracker.leechers-paradise.org,3,0.00%,3,0,100.00%
wx3.sinaimg.cn,3,0.00%,34,31,8.82%
at.alicdn.com,3,0.00%,5,2,60.00%
dsp-impr2.youdao.com,3,0.00%,3,0,100.00%
mercury.jd.com,3,0.00%,5,2,60.00%
cd.jd.com,3,0.00%,3,0,100.00%
wlog.ksapisrv.com,3,0.00%,3,0,100.00%
fts.jd.com,3,0.00%,3,0,100.00%
chat1.jd.com,3,0.00%,5,2,60.00%
h5.360buyimg.com,3,0.00%,7,4,42.86%
asia.roaming1.live.com.akadns.net,3,0.00%,3,0,100.00%
img10.360buyimg.com,3,0.00%,7,4,42.86%
img20.360buyimg.com,3,0.00%,3,0,100.00%
blackhole-m.m.jd.com,3,0.00%,5,2,60.00%
10.rarbg.me,3,0.00%,3,0,100.00%
apidata.googleusercontent.com,3,0.00%,3,0,100.00%
tracker3.torrentino.com,3,0.00%,3,0,100.00%
anisaishuu.de,3,0.00%,3,0,100.00%
qcloud.gregchan.cn,3,0.00%,3,0,100.00%
www.vip.com,3,0.00%,3,0,100.00%
mapi.vip.com,3,0.00%,3,0,100.00%
mst.vip.com,3,0.00%,3,0,100.00%
glb-db52c2cf8be544.github.com,3,0.00%,3,0,100.00%
vibe.sleepyinternetfun.xyz,3,0.00%,3,0,100.00%
retracker.netbynet.ru,3,0.00%,3,0,100.00%
hcdndyn.zjtd01.gslb.c.cdnhwc2.com,3,0.00%,5,2,60.00%
www.download.windowsupdate.com,3,0.00%,4,1,75.00%
lqimg.dftoutiao.com,3,0.00%,3,0,100.00%
hcdnw101.gslb.c.cdnhwc2.com,3,0.00%,3,0,100.00%
px.ads.linkedin.com,3,0.00%,3,0,100.00%
www.amss.cas.cn,3,0.00%,3,0,100.00%
28-courier.push.apple.com,3,0.00%,3,0,100.00%
ts.gtm.eset.com,3,0.00%,3,0,100.00%
onedscolprdwus10.westus.cloudapp.azure.com,3,0.00%,5,2,60.00%
e15203.dscb.akamaiedge.net,3,0.00%,6,3,50.00%
havfw69955.lithium.com,3,0.00%,6,3,50.00%
asia.configsvc1.live.com.akadns.net,3,0.00%,3,0,100.00%
b1.nel.goog,3,0.00%,13,10,23.08%
tracker.supertracker.net,3,0.00%,3,0,100.00%
newtab.firefoxchina.cn.lxcvc.com,3,0.00%,5,2,60.00%
v19.stream.tencentmusic.com.dsp.sched.dcloudstc.com,3,0.00%,3,0,100.00%
inference-location-southeastasia.southeastasia.cloudapp.azure.com,3,0.00%,3,0,100.00%
ins-5i86z7w2.ias.tencent-cloud.net,3,0.00%,3,0,100.00%
bili-dyn-sched.jcloud-cdn.com,3,0.00%,3,0,100.00%
onedscolprdcus14.centralus.cloudapp.azure.com,3,0.00%,6,3,50.00%
skconf.f.qh-lb.com,3,0.00%,3,0,100.00%
drive.google.com,3,0.00%,6,3,50.00%
swscan.apple.com,3,0.00%,6,3,50.00%
swscan-cdn.apple.com.akadns.net,3,0.00%,6,3,50.00%
ts-helper.2345.cc,3,0.00%,3,0,100.00%
dns.pub,3,0.00%,3,0,100.00%
emupdate.avcdn.net,3,0.00%,6,3,50.00%
center.lanxin.cn,3,0.00%,3,0,100.00%
sp3.sangfor.com.cn,3,0.00%,3,0,100.00%
bkvv.video.qq.com,3,0.00%,3,0,100.00%
m.qpic.cn,3,0.00%,7,4,42.86%
qzonestyle.gtimg.cn,3,0.00%,3,0,100.00%
pcwallpaper.zhhainiao.com,3,0.00%,3,0,100.00%
report.im.qcloud.com,3,0.00%,3,0,100.00%
e8203.g.akamaiedge.net,3,0.00%,3,0,100.00%
harib-eir.info,3,0.00%,3,0,100.00%
tracker.fatkhoala.org,3,0.00%,3,0,100.00%
3.rlb.router.teamviewer.cn,3,0.00%,3,0,100.00%
tracker.ali213.net,3,0.00%,3,0,100.00%
bjacshow.kugou.com,3,0.00%,15,12,20.00%
conf-drcn.cloud.dbankcloud.cn,3,0.00%,3,0,100.00%
ip1880706121.funshion.com,3,0.00%,3,0,100.00%
ip3746756449.funshion.com,3,0.00%,3,0,100.00%
tls-amap.dingtalk.com,3,0.00%,3,0,100.00%
maven.aliyun.com,3,0.00%,3,0,100.00%
groupclient.qq.com,3,0.00%,3,0,100.00%
www.wegame.com.cn,3,0.00%,6,3,50.00%
discourse.itk.org,3,0.00%,3,0,100.00%
apps.arp.cn,3,0.00%,3,0,100.00%
sbeacon.sina.com.cn,3,0.00%,3,0,100.00%
metrics.icloud.com,3,0.00%,6,3,50.00%
nsp-logservice-hiview-p41-drcn.obs.cn-north-2.myhuaweicloud.com,3,0.00%,3,0,100.00%
tracker.tallpenguin.org,3,0.00%,3,0,100.00%
torr.ws,3,0.00%,3,0,100.00%
log.kuwo.cn,3,0.00%,3,0,100.00%
freerainbowtables.com,3,0.00%,3,0,100.00%
tracker.frozen-layer.com,3,0.00%,3,0,100.00%
ieonlinews.trafficmanager.NET,3,0.00%,6,3,50.00%
d2lfklupjnai2b.cloudfront.cn,3,0.00%,4,1,75.00%
mesu-cdn.apple.com.akadns.net,3,0.00%,6,3,50.00%
usa4.666670.xyz,3,0.00%,3,0,100.00%
api.ipify.org,3,0.00%,3,0,100.00%
array810.prod.do.dsp.mp.microsoft.com,3,0.00%,3,0,100.00%
xycrx.net,3,0.00%,3,0,100.00%
klbv2.wpsdns.com,3,0.00%,3,0,100.00%
ipv6-static.dns.iqiyi.com,3,0.00%,6,3,50.00%
gbfek.eastmoney.com,3,0.00%,6,3,50.00%
cmsjs.eastmoney.com,3,0.00%,6,3,50.00%
mirrors.aliyun.com.w.alikunlun.com,3,0.00%,6,3,50.00%
tracker.sjtu.edu.cn,3,0.00%,3,0,100.00%
gwp2-v19.rinet.ru,3,0.00%,3,0,100.00%
nplserver.kuwo.cn,3,0.00%,3,0,100.00%
ssldev.oes.avira.com,3,0.00%,3,0,100.00%
s1.cn.bing.net,3,0.00%,3,0,100.00%
id.rlcdn.com,3,0.00%,3,0,100.00%
en.wikipedia.org,3,0.00%,6,3,50.00%
addonlist.sync.maxthon.cn,3,0.00%,3,0,100.00%
opencdnssl.jomodns.com,3,0.00%,3,0,100.00%
opencdnglobal.jomodns.com,3,0.00%,3,0,100.00%
smarturl.sync.maxthon.cn,3,0.00%,3,0,100.00%
online.user.maxthon.cn,3,0.00%,3,0,100.00%
down-30005.sz.gfp.tencent-cloud.com,3,0.00%,6,3,50.00%
e11408.d.akamaiedge.net,3,0.00%,3,0,100.00%
update-windows.grammarly.com,3,0.00%,3,0,100.00%
69-46-75-53.nhost.00cdn.com,3,0.00%,3,0,100.00%
ic-business.ks3-cn-beijing.ksyun.com,3,0.00%,3,0,100.00%
vip-rec.ksord.com,3,0.00%,3,0,100.00%
rules.quantcount.com,3,0.00%,3,0,100.00%
quantcast.mgr.consensu.org,3,0.00%,6,3,50.00%
c.jia.mn,3,0.00%,3,0,100.00%
p0.meituan.net,3,0.00%,6,3,50.00%
chinaeast2-0.in.applicationinsights.azure.cn,3,0.00%,3,0,100.00%
connectivitycheck.platform.hihonorcloud.com,3,0.00%,3,0,100.00%
ese3a9b6c5d0ic-pub.pubssl.qiqiuyun.net,3,0.00%,6,3,50.00%
rgepodownload.mediatek.com,3,0.00%,3,0,100.00%
csd-apt-eas-d-1.eastasia.cloudapp.azure.com,3,0.00%,3,0,100.00%
onedscolprduks04.uksouth.cloudapp.azure.com,3,0.00%,6,3,50.00%
pc-plugin-plg-wpscdn-cn-idvh11c.qiniudns.com,3,0.00%,8,5,37.50%
chinaweb292.china.line.qiniudns.com,3,0.00%,8,5,37.50%
i1.cwip.eset.com,3,0.00%,3,0,100.00%
galaxy.safe.360.cn,3,0.00%,3,0,100.00%
e7279.dsce9.akamaiedge.net,3,0.00%,6,3,50.00%
91.push2his.eastmoney.com,3,0.00%,3,0,100.00%
95.newspush.eastmoney.com,3,0.00%,3,0,100.00%
8.push2his.eastmoney.com,3,0.00%,3,0,100.00%
87.newspush.eastmoney.com,3,0.00%,3,0,100.00%
abufinzio.monocul.us,3,0.00%,3,0,100.00%
p3.ssl.qhimgs0.com,3,0.00%,3,0,100.00%
lws.xuexi.cn,3,0.00%,3,0,100.00%
huizhou.gallerycdn.azure.cn,3,0.00%,3,0,100.00%
s04.upd.kaspersky.com,3,0.00%,3,0,100.00%
update.delivery.autodesk.com,3,0.00%,3,0,100.00%
dlassets-ssl.xboxlive.com,3,0.00%,6,3,50.00%
moe-moe.love,3,0.00%,3,0,100.00%
srtb.msn.com,3,0.00%,3,0,100.00%
WWW.SLAShDoT.ORG,3,0.00%,3,0,100.00%
www.mIt.EdU,3,0.00%,3,0,100.00%
lb2.overleaf.com,3,0.00%,3,0,100.00%
fmt1.link.ac.cn,3,0.00%,3,0,100.00%
time.ustc.edu.cn,3,0.00%,3,0,100.00%
ds.download.windowsupdate.com,3,0.00%,4,1,75.00%
phfwba-pro-g3.oray.net,3,0.00%,3,0,100.00%
p212-caldav.icloud.com.cn,3,0.00%,3,0,100.00%
ac-dun.security.ntes53.netease.com,3,0.00%,6,3,50.00%
52.newspush.eastmoney.com,3,0.00%,3,0,100.00%
fundact.eastmoney.com,3,0.00%,6,3,50.00%
sso.1234567.com.cn,3,0.00%,3,0,100.00%
d19h5bl8fn71bo.cloudfront.net,3,0.00%,3,0,100.00%
cdn-node.cn.cm.guangzhou-01.nekocloud.cn,3,0.00%,3,0,100.00%
update.utorrent.li,3,0.00%,3,0,100.00%
media.adaware.com,3,0.00%,3,0,100.00%
a1488.dscd.akamai.net,3,0.00%,6,3,50.00%
in02.graniterapids.com,3,0.00%,3,0,100.00%
20536-ipv4.gr.global.aa-rt.sharepoint.com,3,0.00%,3,0,100.00%
httpsdns.baidu.com,3,0.00%,3,0,100.00%
retracker.baikal-telecom.net,3,0.00%,3,0,100.00%
au.download.windowsupdate.com,3,0.00%,3,0,100.00%
onedsblobprdwus17.westus.cloudapp.azure.com,3,0.00%,3,0,100.00%
93.push2his.eastmoney.com,3,0.00%,3,0,100.00%
api.dropbox.com,3,0.00%,8,5,37.50%
med-fe.cdn.bcebos.com,3,0.00%,4,1,75.00%
static.youlai.cn,3,0.00%,3,0,100.00%
boss.hdslb.com,3,0.00%,5,2,60.00%
s.mzstatic.com,3,0.00%,5,2,60.00%
tmfsdktcpv4.m.qq.com,3,0.00%,3,0,100.00%
8m87j88z.sched.d0.tdnsdp1.cn,3,0.00%,3,0,100.00%
prod.fs.microsoft.com.akadns.net,3,0.00%,3,0,100.00%
fs-wildcard.microsoft.com.edgekey.net,3,0.00%,3,0,100.00%
pull-rtmp-l26-cny.douyincdn.com,3,0.00%,3,0,100.00%
10.courier-push-apple.com.akadns.net,3,0.00%,3,0,100.00%
push-rtmp-hs-f5.huoshanlive.com,3,0.00%,3,0,100.00%
csc3-2010-crl.verisign.com,3,0.00%,5,2,60.00%
push-rtmp-l6-hs.pstatp.com,3,0.00%,3,0,100.00%
uci.cdn.office.net,3,0.00%,6,3,50.00%
apic.douyucdn.cn,3,0.00%,6,3,50.00%
storage.360buyimg.com,3,0.00%,6,3,50.00%
knicks.jd.com,3,0.00%,6,3,50.00%
report-uri.baidu.com,3,0.00%,3,0,100.00%
pcoma.qq.com,3,0.00%,3,0,100.00%
kmrcdn.service.kugou.com,3,0.00%,3,0,100.00%
p3.dcarimg.com,3,0.00%,3,0,100.00%
verify.zijieapi.com,3,0.00%,3,0,100.00%
lf3-config.bytetcc.com.w.cdngslb.com,3,0.00%,3,0,100.00%
i.snssdk.com.w.kunluncan.com,3,0.00%,3,0,100.00%
wbapp.uve.weibo.com,3,0.00%,3,0,100.00%
s3a.pstatp.com.w.kunlungr.com,3,0.00%,6,3,50.00%
cos.wtaluo.com,3,0.00%,3,0,100.00%
stocks-data-service.apple.com,3,0.00%,8,5,37.50%
p207-contacts.icloud.com.cn,3,0.00%,3,0,100.00%
api.lxqp.360.cn,3,0.00%,3,0,100.00%
googlecm.hit.gemius.pl,3,0.00%,3,0,100.00%
webb.jomodns.com,3,0.00%,3,0,100.00%
cmp.quantcast.com,3,0.00%,6,3,50.00%
analytics.vdo.ai,3,0.00%,3,0,100.00%
e428b87fea828a0a.huaweisafedns.cn,3,0.00%,3,0,100.00%
d2cb5ad7002c4066.huaweisafedns.cn,3,0.00%,3,0,100.00%
lf1-cdn-tos.bytegoofy.com.wsglb0.com,3,0.00%,6,3,50.00%
common-afdrk.fe.1drv.com,3,0.00%,6,3,50.00%
erp.dianbabyshop.id,3,0.00%,3,0,100.00%
69-236-108-191.lightspeed.frokca.sbcglobal.net,3,0.00%,3,0,100.00%
app.yinxiang.com,3,0.00%,3,0,100.00%
web.sdk.qcloud.com,3,0.00%,7,4,42.86%
bnz05pap001.storage.live.com,3,0.00%,5,2,60.00%
tehconnection.eu,3,0.00%,3,0,100.00%
app.axure.cloud,3,0.00%,3,0,100.00%
fa000000005.resources.office.net,3,0.00%,6,3,50.00%
crl.microsoft.com,3,0.00%,6,3,50.00%
spoon.skyworthdigital.sjxrbj.com,3,0.00%,3,0,100.00%
p2.img.360kuai.com,3,0.00%,4,1,75.00%
bt.ali213.net,3,0.00%,3,0,100.00%
auth.grammarly.com,3,0.00%,3,0,100.00%
urswebzj.nosdn.127.net,3,0.00%,3,0,100.00%
dl.reg.163.com,3,0.00%,3,0,100.00%
s95.cnzz.com,3,0.00%,3,0,100.00%
h5.analytics.126.net,3,0.00%,3,0,100.00%
cc.adingo.jp,3,0.00%,3,0,100.00%
www.jipinyouwu.com,3,0.00%,3,0,100.00%
ieonlinews.trafficmanager.net,3,0.00%,6,3,50.00%
tiku.dhrest.com,3,0.00%,3,0,100.00%
xiaoyouxi.360.cn,3,0.00%,3,0,100.00%
gua2.qhimg.com,3,0.00%,3,0,100.00%
xueshu.baidu.com,3,0.00%,5,2,60.00%
tam.cdn-go.cn,3,0.00%,6,3,50.00%
hiya.browser.360.cn,3,0.00%,3,0,100.00%
gdfp.gifshow.com,3,0.00%,3,0,100.00%
cjhd.mediav.com,3,0.00%,4,1,75.00%
hwid.platform.hicloud.com,3,0.00%,3,0,100.00%
grs.dbankcloud.cn,3,0.00%,3,0,100.00%
sec.umeng.com,3,0.00%,3,0,100.00%
photo27.hexun.com,3,0.00%,5,2,60.00%
internalcheck.apple.com,3,0.00%,3,0,100.00%
wkbrs1.tingyun.com,3,0.00%,3,0,100.00%
22.push2his.eastmoney.com,3,0.00%,3,0,100.00%
v5-i.douyinvod.com,3,0.00%,3,0,100.00%
ubacollect-drcn.cloud.dbankcloud.cn,3,0.00%,3,0,100.00%
httpdns.huaweicloud.com,3,0.00%,3,0,100.00%
s.url.cn,3,0.00%,6,3,50.00%
cdn-go.cn,3,0.00%,3,0,100.00%
a-0019.standard.a-msedge.net,3,0.00%,3,0,100.00%
www.ctrip.com,3,0.00%,3,0,100.00%
yeet4iel.nodedata.net,3,0.00%,3,0,100.00%
p43-contacts.icloud.com,3,0.00%,4,1,75.00%
linux-updatepro.wps.cn,3,0.00%,3,0,100.00%
tracker.skyts.cn,3,0.00%,3,0,100.00%
api.pcloud.com,3,0.00%,3,0,100.00%
onedriveclucprodbn20004.blob.core.windows.net,3,0.00%,3,0,100.00%
google.cn,3,0.00%,6,3,50.00%
onedriveclucproddm20011.blob.core.windows.net,3,0.00%,3,0,100.00%
soso-xzdesktop-api.cqttech.com,3,0.00%,3,0,100.00%
dev,3,0.00%,3,0,100.00%
avator.eastmoney.com,3,0.00%,6,3,50.00%
sites.google.com,3,0.00%,6,3,50.00%
www.eclzz.plus,3,0.00%,3,0,100.00%
admin.videoenpoche.info,3,0.00%,3,0,100.00%
tracker.altrosky.nl,3,0.00%,3,0,100.00%
qtstm32fan.ru,3,0.00%,3,0,100.00%
tracker.filemail.com,3,0.00%,3,0,100.00%
bxjbqj09.e0.sched.ovscdns.com,3,0.00%,6,3,50.00%
oth.ludashi.com,3,0.00%,3,0,100.00%
qinfo.wps.cn,3,0.00%,3,0,100.00%
hectorstatic.baidu.com.a.bdydns.com,3,0.00%,6,3,50.00%
mbdp02.bdstatic.com,3,0.00%,4,1,75.00%
aliwsapubv46.suning.com.w.kunluncan.com,3,0.00%,5,2,60.00%
conn3.coloros.com,3,0.00%,3,0,100.00%
gstaticadssl.l.google.com,3,0.00%,5,2,60.00%
apkgf5hg.sched.v1hw-dk.tdnsvod1.cn,3,0.00%,6,3,50.00%
whoami.akamai.net,3,0.00%,4,1,75.00%
iosapps.itunes.apple.com,3,0.00%,6,3,50.00%
weibo.cn,3,0.00%,10,7,30.00%
pro-driver-packages.uniontech.com,3,0.00%,3,0,100.00%
fanyi-bfe.n.shifen.com,3,0.00%,3,0,100.00%
wn.pos.e.shifen.com,3,0.00%,3,0,100.00%
sz-qiniu-all.volcgtm.com,3,0.00%,7,4,42.86%
eclick.e.shifen.com,3,0.00%,3,0,100.00%
opencdnsslv6.jomodns.com,3,0.00%,6,3,50.00%
webtim.msf.tencent-cloud.com,3,0.00%,3,0,100.00%
species.missionsec.io,3,0.00%,3,0,100.00%
edge.api.myqnapcloud.cn,3,0.00%,7,4,42.86%
cdn.onenote.net,3,0.00%,6,3,50.00%
oa.yghcwy.com,3,0.00%,3,0,100.00%
uci.edog.cdn.office.net,3,0.00%,6,3,50.00%
push.khd.2345.cc,3,0.00%,3,0,100.00%
sns-video-bd.xhscdn.com,3,0.00%,5,2,60.00%
ocsp.globalsign.com,3,0.00%,3,0,100.00%
dss3.bdstatic.com,3,0.00%,3,0,100.00%
t7.baidu.com.a.bdydns.com,3,0.00%,4,1,75.00%
t9.baidu.com.a.bdydns.com,3,0.00%,4,1,75.00%
sslshare.jomodns.com,3,0.00%,3,0,100.00%
41-courier.push.apple.com,3,0.00%,3,0,100.00%
kae.wpsdns.com,3,0.00%,3,0,100.00%
update2.sangfor.net.cdn20.com,3,0.00%,3,0,100.00%
registry.npmmirror.com,3,0.00%,3,0,100.00%
passport.bilibili.com,3,0.00%,3,0,100.00%
config.app.yinxiang.com,3,0.00%,3,0,100.00%
th-a.pinduoduo.com,3,0.00%,3,0,100.00%
bj-a.bcebos.com.n.shifen.com,3,0.00%,3,0,100.00%
www.wenxm.cn,3,0.00%,3,0,100.00%
gomediago.baidu.com,3,0.00%,3,0,100.00%
s3m4.fenxi.com,3,0.00%,3,0,100.00%
0.debian.pool.ntp.org,3,0.00%,3,0,100.00%
scholar.google.com.hk,3,0.00%,4,1,75.00%
id.google.com,3,0.00%,3,0,100.00%
ip2091219971.funshion.com,3,0.00%,3,0,100.00%
opencdnpicrmb.jomodns.com,3,0.00%,4,1,75.00%
py.ucas.ac.cn,3,0.00%,3,0,100.00%
api.pinduoduo.com,3,0.00%,3,0,100.00%
jp_62.antchatxj.com,3,0.00%,3,0,100.00%
v.casmooc.cn,3,0.00%,3,0,100.00%
ali-bj-pcdn-30.biliapi.net,3,0.00%,3,0,100.00%
open.touki.ru,3,0.00%,3,0,100.00%
torrent.arjlover.net,3,0.00%,3,0,100.00%
archive.ubuntukylin.com,3,0.00%,3,0,100.00%
xtremewrestlingtorrents.net,3,0.00%,3,0,100.00%
e7695.dscg.akamaiedge.net,3,0.00%,6,3,50.00%
mobile-gtalk.l.google.com,3,0.00%,8,5,37.50%
cn.pool.ntp.org,3,0.00%,3,0,100.00%
98.push2his.eastmoney.com,3,0.00%,3,0,100.00%
23.push2his.eastmoney.com,3,0.00%,3,0,100.00%
56.push2his.eastmoney.com,3,0.00%,3,0,100.00%
infoc0.duba.net,3,0.00%,3,0,100.00%
cloud.safe.360.cn,3,0.00%,3,0,100.00%
store.steampowered.com,3,0.00%,3,0,100.00%
service.mail.sina.com.cn,3,0.00%,3,0,100.00%
ts-ocsp.ws.symantec.com,3,0.00%,6,3,50.00%
onedscolprdweu05.westeurope.cloudapp.azure.com,3,0.00%,6,3,50.00%
googlecn-lopri.l.google.com,3,0.00%,6,3,50.00%
setup.fe.apple-dns.net,3,0.00%,6,3,50.00%
aaaa.aaaa.gay,3,0.00%,3,0,100.00%
services.gfe.nvidia.com,3,0.00%,3,0,100.00%
b2b.baidu.com,3,0.00%,8,5,37.50%
s6.music.126.net,3,0.00%,6,3,50.00%
a1.cnblogs.com,3,0.00%,3,0,100.00%
analytics.cnblogs.com,3,0.00%,3,0,100.00%
account.cnblogs.com,3,0.00%,3,0,100.00%
www.zotero.org,3,0.00%,3,0,100.00%
grafana.net,3,0.00%,3,0,100.00%
www.runoob.com,3,0.00%,3,0,100.00%
static.runoob.com,3,0.00%,3,0,100.00%
track.mediav.com,3,0.00%,3,0,100.00%
auth.split.io,3,0.00%,3,0,100.00%
cdn-9f456ph4.slt.sched.tdnsv8.com,3,0.00%,3,0,100.00%
cn-huhehaote.axt.aliyun.com,3,0.00%,3,0,100.00%
m.weibo.cn,3,0.00%,7,4,42.86%
inappcheck-cn.itunes-apple.com.akadns.net,3,0.00%,4,1,75.00%
release.kite.com,3,0.00%,5,2,60.00%
kssv-w-yz01.kuaipandata.com,3,0.00%,3,0,100.00%
qup.b.360wscdn.com,3,0.00%,3,0,100.00%
cxcs.microsoft.net,3,0.00%,3,0,100.00%
sw.symcd.com,3,0.00%,5,2,60.00%
glb.api.prod.dcat.dsp.trafficmanager.NET,3,0.00%,7,4,42.86%
www.asdjkljfjaowjfq.net,3,0.00%,3,0,100.00%
66.push2his.eastmoney.com,3,0.00%,3,0,100.00%
42-200-11-53.static.imsbiz.com,3,0.00%,3,0,100.00%
kr08.graniterapids.com,3,0.00%,3,0,100.00%
d28dx6y1hfq314.cloudfront.net,3,0.00%,6,3,50.00%
statwup.huya.com,3,0.00%,3,0,100.00%
skin.wsm.360.cn,3,0.00%,3,0,100.00%
us2221.tomnode.com,3,0.00%,3,0,100.00%
zhibo.homeway.com.cn,3,0.00%,3,0,100.00%
qizhi.hexun.com,3,0.00%,3,0,100.00%
trust.hexun.com,3,0.00%,3,0,100.00%
tv.hexun.com,3,0.00%,3,0,100.00%
log-api.pangolin-sdk-toutiao.com,3,0.00%,3,0,100.00%
mssdk-bu.bytedance.com,3,0.00%,3,0,100.00%
livepatch.canonical.com,3,0.00%,3,0,100.00%
www.cnblogs.com,3,0.00%,3,0,100.00%
xdssp.mediav.com,3,0.00%,3,0,100.00%
data.chsmarttv.com,3,0.00%,3,0,100.00%
tools.l.google.com,3,0.00%,6,3,50.00%
settings-prod-uks-2.uksouth.cloudapp.azure.com,3,0.00%,3,0,100.00%
hooks.slack.com,3,0.00%,3,0,100.00%
human-tarantula-wy3gj0btg9vmv5qgdfoaab1p.herokudns.com,3,0.00%,3,0,100.00%
5d3fe70bad5446adb47e56e9e99c1a97-cn-beijing.alicloudapi.com,3,0.00%,3,0,100.00%
finance.eastmoney.com,3,0.00%,6,3,50.00%
cfw.gti.mcafee.akadns.NET,3,0.00%,3,0,100.00%
hpkaj.deepl.com,3,0.00%,3,0,100.00%
nav-edge.smartscreen.microsoft.com,3,0.00%,3,0,100.00%
bj-a.bcebos.com,3,0.00%,3,0,100.00%
8136128.fls.doubleclick.net,3,0.00%,3,0,100.00%
lh5.googleusercontent.com,3,0.00%,3,0,100.00%
common.be.1drv.com.l-0003.dc-msedge.net.l-0003.l-msedge.net,3,0.00%,4,1,75.00%
file.gsxservice.com,3,0.00%,3,0,100.00%
log.he2d.com,3,0.00%,3,0,100.00%
vs.biz.weibo.com,3,0.00%,3,0,100.00%
pics0.baidu.com,3,0.00%,3,0,100.00%
api.dongqiudi.com,3,0.00%,3,0,100.00%
im-ap.dongqiudi.com,3,0.00%,3,0,100.00%
feed.dongqiudi.com,3,0.00%,3,0,100.00%
i-43.b-46206.ut.bench.utorrent.com,3,0.00%,5,2,60.00%
414-xmy-838.mktoresp.com,3,0.00%,3,0,100.00%
edge-skype-com.s-0001.s-msedge.net,2,0.00%,4,2,50.00%
get.skype.com,2,0.00%,2,0,100.00%
prod.msgsearch.trafficmanager.net,2,0.00%,2,0,100.00%
s-0001.s-msedge.net,2,0.00%,4,2,50.00%
liveget.trafficmanager.net,2,0.00%,2,0,100.00%
people.skype.com,2,0.00%,2,0,100.00%
k-ring.k-9999.k-msedge.net,2,0.00%,2,0,100.00%
people-service-prod.trafficmanager.net,2,0.00%,2,0,100.00%
init-p01st-lb.push-apple.com.akadns.net,2,0.00%,4,2,50.00%
s-ring.s-9999.s-msedge.net,2,0.00%,2,0,100.00%
s-9999.s-msedge.net,2,0.00%,2,0,100.00%
16.courier-push-apple.com.akadns.net,2,0.00%,2,0,100.00%
azeus1-client-s.gateway.messenger.live.com,2,0.00%,2,0,100.00%
azeus1-client-s.msnmessenger.msn.com.akadns.net,2,0.00%,2,0,100.00%
api.aps.skype.com,2,0.00%,2,0,100.00%
api-aps-teams.trafficmanager.net,2,0.00%,2,0,100.00%
broadcast.chat.biliapi.com,2,0.00%,2,0,100.00%
onedscolprduks03.uksouth.cloudapp.azure.com,2,0.00%,2,0,100.00%
token.rubiconproject.com,2,0.00%,2,0,100.00%
e6603.g.akamaiedge.net,2,0.00%,2,0,100.00%
pull-flv-f29.douyincdn.com.ucloud.com.cn,2,0.00%,2,0,100.00%
m.hotmail.com,2,0.00%,4,2,50.00%
push-rtmp-l1.douyincdn.com,2,0.00%,2,0,100.00%
pull-flv-l3-enc.douyincdn.com.w.alikunlun.net,2,0.00%,2,0,100.00%
pull-flv-l3-encryption.douyincdn.com.w.alikunlun.net,2,0.00%,2,0,100.00%
pull-rtmp-l6-hs.pstatp.com,2,0.00%,4,2,50.00%
push-rtmp-vr-l6.douyincdn.com.upvcloud.ks-cdn.com,2,0.00%,2,0,100.00%
u01.gslb.ksyuncdn.com,2,0.00%,2,0,100.00%
pull-hls-f26.douyincdn.com,2,0.00%,4,2,50.00%
pull-rtmp-f96.douyincdn.com.d.live.cdn.chinamobile.com,2,0.00%,2,0,100.00%
pull-rtmp-f13.douyincdn.com.a.bcelive.com,2,0.00%,2,0,100.00%
pull-hls-f11.douyincdn.com.tcdnlive.com,2,0.00%,2,0,100.00%
bcelive.jomodns.com,2,0.00%,2,0,100.00%
pull-hls-f11.douyincdn.com.sched.l8.tdnsv5.com,2,0.00%,2,0,100.00%
push-rtmp-l6-enc.douyincdn.com.upvcloud.ks-cdn.com,2,0.00%,2,0,100.00%
push-vol-base.s.volcfcdndvs.com,2,0.00%,2,0,100.00%
config.edge.skype.com,2,0.00%,179,177,1.12%
bl6pap003.storage.live.com,2,0.00%,4,2,50.00%
bigdata.g60.letvlb.com,2,0.00%,2,0,100.00%
www.cntv.cn,2,0.00%,4,2,50.00%
tv.sohu.com,2,0.00%,4,2,50.00%
gs.a.sohu.com,2,0.00%,4,2,50.00%
www.126.com,2,0.00%,2,0,100.00%
any.edge.bing.com,2,0.00%,2,0,100.00%
dig.feishu.cn,2,0.00%,2,0,100.00%
grpc.biliapi.net,2,0.00%,2,0,100.00%
app.bilibili.com,2,0.00%,2,0,100.00%
bn1305.storage.live.com,2,0.00%,4,2,50.00%
puncher.dcdn.baidu.com,2,0.00%,2,0,100.00%
ns-sb2-prod-sn3-010.cloudapp.net,2,0.00%,2,0,100.00%
tj.psvr.wps.cn,2,0.00%,2,0,100.00%
c2shb.one-mobile-prod.aws.oath.cloud,2,0.00%,2,0,100.00%
chidc2.outbrain.org,2,0.00%,2,0,100.00%
geo-eu-us-sticky.delivery-prod-sas.akadns.net,2,0.00%,3,1,66.67%
ac-mqgidvz-shard-00-00.nmmxpgl.mongodb.net,2,0.00%,2,0,100.00%
ac-mqgidvz-shard-00-02.nmmxpgl.mongodb.net,2,0.00%,2,0,100.00%
rc10-g5.oray.com,2,0.00%,2,0,100.00%
wx1.sinaimg.cn,2,0.00%,24,22,8.33%
tracker.torrenty.org,2,0.00%,2,0,100.00%
club.jd.com,2,0.00%,3,1,66.67%
tracker.lilithraws.cf,2,0.00%,46,44,4.35%
ms-ceintl.gallerycdn.azure.cn,2,0.00%,2,0,100.00%
wd-prod-cp-as-southeast-4-fe.southeastasia.cloudapp.azure.com,2,0.00%,2,0,100.00%
c-pay.lingkou.com,2,0.00%,2,0,100.00%
r.bing.com,2,0.00%,2,0,100.00%
b1h.zemanta.com,2,0.00%,2,0,100.00%
ib.sin1.geoadnxs.com,2,0.00%,2,0,100.00%
1266287590.rsc.cdn77.org,2,0.00%,6,4,33.33%
cf.aliyun.com,2,0.00%,4,2,50.00%
mar.vip.com,2,0.00%,2,0,100.00%
captcha.vip.com,2,0.00%,2,0,100.00%
bootstrap.vipstatic.com,2,0.00%,2,0,100.00%
common.vip.com,2,0.00%,2,0,100.00%
cart.vip.com,2,0.00%,2,0,100.00%
fav.vip.com,2,0.00%,2,0,100.00%
myi.vip.com,2,0.00%,2,0,100.00%
list.vip.com,2,0.00%,2,0,100.00%
feedback.vip.com,2,0.00%,2,0,100.00%
rule.vip.com,2,0.00%,2,0,100.00%
stock.vip.com,2,0.00%,2,0,100.00%
h5charity.vip.com,2,0.00%,2,0,100.00%
site.browser.360.cn,2,0.00%,2,0,100.00%
api.game.360.cn,2,0.00%,2,0,100.00%
maxineapi.razersynapse.com,2,0.00%,2,0,100.00%
drive.kdocs.cn,2,0.00%,4,2,50.00%
vtmhz.ys7.com,2,0.00%,2,0,100.00%
etax.shenzhen.chinatax.gov.cn,2,0.00%,2,0,100.00%
extshort.weixin.qq.com,2,0.00%,160,158,1.25%
www.81.cn,2,0.00%,4,2,50.00%
s3m6.fenxi.com,2,0.00%,3,1,66.67%
mp.360.cn,2,0.00%,2,0,100.00%
cloudtips.1360.com,2,0.00%,2,0,100.00%
asst-stat.ksord.com,2,0.00%,2,0,100.00%
recruitapi.microsoft.com,2,0.00%,2,0,100.00%
spoprod-a.akamaihd.net,2,0.00%,2,0,100.00%
api.ivideo.sina.com.cn,2,0.00%,58,56,3.45%
www.360kuai.com,2,0.00%,2,0,100.00%
careers.microsoft.com,2,0.00%,2,0,100.00%
alog.iclick.com.cn,2,0.00%,2,0,100.00%
tracking.firefox.com.cn,2,0.00%,4,2,50.00%
tracking.firefox.com.cn.wswebpic.com,2,0.00%,4,2,50.00%
addons.g-fox.cn.w.kunlunca.com,2,0.00%,2,0,100.00%
bookmarks-ssl.firefoxchina.cn.wswebpic.com,2,0.00%,2,0,100.00%
p0.qhimgs4.com.webcdn.360qhcdn.com,2,0.00%,2,0,100.00%
eo91y88m.sched.sma.tdnsstic1.cn,2,0.00%,2,0,100.00%
hp.sched.legohp-dk.tdnsstic1.cn,2,0.00%,4,2,50.00%
k-static.xsfaya.com.wswebcdn.com,2,0.00%,2,0,100.00%
img1.wywyx.com,2,0.00%,2,0,100.00%
yxdt.game.keniub.com,2,0.00%,2,0,100.00%
home.360game.360.cn,2,0.00%,2,0,100.00%
v5.360game.360.cn,2,0.00%,2,0,100.00%
cispa-de.zoom.us,2,0.00%,2,0,100.00%
news-bos.cdn.bcebos.com,2,0.00%,2,0,100.00%
recruit.nimte.ac.cn,2,0.00%,2,0,100.00%
i3.ytimg.com,2,0.00%,3,1,66.67%
submit.sb.avast.com,2,0.00%,2,0,100.00%
s3.nzbdw.com,2,0.00%,2,0,100.00%
c.gj.qq.com,2,0.00%,2,0,100.00%
p209-contacts.icloud.com.cn,2,0.00%,2,0,100.00%
contacts.fe.apple-dns.cn,2,0.00%,2,0,100.00%
api.cdp.microsoft.com,2,0.00%,4,2,50.00%
asia.odcsm1.live.com.akadns.net,2,0.00%,2,0,100.00%
oneocsp.microsoft.com,2,0.00%,4,2,50.00%
tw13.clashcloud.tech,2,0.00%,2,0,100.00%
configuration-server-lb-1105093370.us-east-1.elb.amazonaws.com,2,0.00%,2,0,100.00%
yuanshen.xin,2,0.00%,2,0,100.00%
search.namequery.com,2,0.00%,2,0,100.00%
onedscolprdjpe05.japaneast.cloudapp.azure.com,2,0.00%,2,0,100.00%
e12358.g.akamaiedge.net,2,0.00%,2,0,100.00%
sea.frontdoor.licensing.commerce.microsoft.com,2,0.00%,2,0,100.00%
31.courier-push-apple.com.akadns.net,2,0.00%,2,0,100.00%
iris-de-prod-azsc-eas.eastasia.cloudapp.azure.com,2,0.00%,2,0,100.00%
onedscolprduks00.uksouth.cloudapp.azure.com,2,0.00%,4,2,50.00%
settings-prod-wus3-1.westus3.cloudapp.azure.com,2,0.00%,2,0,100.00%
gspe35-ssl.ls.apple.com.download.ks-cdn.com,2,0.00%,4,2,50.00%
njtbcsp2p.n.shifen.com,2,0.00%,2,0,100.00%
beacons6.gvt2.com,2,0.00%,4,2,50.00%
ocsp.digicert.cn,2,0.00%,2,0,100.00%
ocsp.digicert.cn.w.cdngslb.com,2,0.00%,2,0,100.00%
pc001.download.wh.cmcm.com,2,0.00%,2,0,100.00%
clIenTloGvOdp2P.hAplaT.neT,2,0.00%,2,0,100.00%
tRAnsit1.wsLog.cHiNAnEtCeNTeR.cOm,2,0.00%,2,0,100.00%
mambAP2PVODh5.8686c.cOM,2,0.00%,2,0,100.00%
CLIeNtlogvOdp2P.HAPLAT.nET,2,0.00%,2,0,100.00%
TRansIt1.wSlOG.cHInAneTcENTEr.COm,2,0.00%,2,0,100.00%
maMbAP2pvoDh5.8686C.Com,2,0.00%,2,0,100.00%
beacons5.gvt3.com,2,0.00%,4,2,50.00%
ccc.hpeprint.com,2,0.00%,2,0,100.00%
ssdkauth.hpplay.cn,2,0.00%,2,0,100.00%
circlevideo2.photo.qq.com,2,0.00%,4,2,50.00%
astrategy.beacon.qq.com,2,0.00%,2,0,100.00%
onedscolprdweu03.westeurope.cloudapp.azure.com,2,0.00%,2,0,100.00%
r3---sn-ni5een7s.gvt1.com,2,0.00%,2,0,100.00%
common-geo.onedrive.trafficmanager.net,2,0.00%,2,0,100.00%
dsm01pcor002-com.be.1drv.com,2,0.00%,2,0,100.00%
onedriveclubprodbn20018.blob.core.windows.net,2,0.00%,2,0,100.00%
sadownload-new.mcafee.com.edgekey.net,2,0.00%,2,0,100.00%
cu1pehnsmps01.servicebus.windows.net,2,0.00%,2,0,100.00%
www.thetradersden.org,2,0.00%,2,0,100.00%
cdn.ynuf.aliapp.org,2,0.00%,4,2,50.00%
downloads.metasploit.com,2,0.00%,2,0,100.00%
msgacs.m.taobao.com,2,0.00%,2,0,100.00%
e11744.g.akamaiedge.net,2,0.00%,2,0,100.00%
ali-stats.jpush.cn,2,0.00%,2,0,100.00%
s-gm.mmstat.com,2,0.00%,2,0,100.00%
acs-mum.alibabachengdun.com,2,0.00%,2,0,100.00%
fullscreen-detail.alicdn.com,2,0.00%,4,2,50.00%
hybrid.miniapp.taobao.com,2,0.00%,2,0,100.00%
guide-acs.m.taobao.com,2,0.00%,3,1,66.67%
mum.alibabachengdun.com,2,0.00%,2,0,100.00%
nsp-hicloud-cloudphotonorth4-p02-drcn.obs.cn-north-4.myhuaweicloud.cn,2,0.00%,2,0,100.00%
nsp-hicloud-cloudbackupnorth4-p01-drcn.obs.cn-north-4.myhuaweicloud.cn,2,0.00%,2,0,100.00%
nsp-hicloud-cloudphotonorth4-p03-drcn.obs.cn-north-4.myhuaweicloud.com,2,0.00%,2,0,100.00%
nsp-hicloud-cloudbackupnorth4-p03-drcn.obs.cn-north-4.myhuaweicloud.com,2,0.00%,2,0,100.00%
api-takumi.mihoyo.com,2,0.00%,2,0,100.00%
weather.ubuntukylin.com,2,0.00%,2,0,100.00%
bilibilihelper.com,2,0.00%,2,0,100.00%
wxsnsad.tc.qq.com,2,0.00%,2,0,100.00%
zerossl.ocsp.sectigo.com,2,0.00%,46,44,4.35%
hbopenbid.pubmatic.com,2,0.00%,2,0,100.00%
bid.g.doubleclick.net,2,0.00%,2,0,100.00%
gcdn.2mdn.net,2,0.00%,2,0,100.00%
cdn2.ghostery.com,2,0.00%,4,2,50.00%
archiva-maven-storage-prod.oss-cn-beijing.aliyuncs.com,2,0.00%,2,0,100.00%
dictionary.cambridge.org,2,0.00%,2,0,100.00%
push.ynote.youdao.com,2,0.00%,2,0,100.00%
study.163.com,2,0.00%,2,0,100.00%
fanyi.baidu.com,2,0.00%,6,4,33.33%
tbmsg.baidu.com,2,0.00%,2,0,100.00%
e2c21.gcp.gvt2.com,2,0.00%,2,0,100.00%
m804.music.126.net,2,0.00%,2,0,100.00%
gs-loc-new.ls-apple.com.akadns.net,2,0.00%,2,0,100.00%
api.pdfxd.com,2,0.00%,2,0,100.00%
shoppingcampaigns-api-drcn.ai.dbankcloud.com,2,0.00%,2,0,100.00%
ncomment.kuwo.cn,2,0.00%,2,0,100.00%
newlyric.kuwo.cn,2,0.00%,2,0,100.00%
a16638c16aa17238.natapp.cc,2,0.00%,2,0,100.00%
nearby-drcn.platform.dbankcloud.com,2,0.00%,2,0,100.00%
cn-pek-ali-r001.router.teamviewer.cn,2,0.00%,2,0,100.00%
cnc.quickconnect.cn,2,0.00%,2,0,100.00%
hcdnw.nozj.bili.c.cdnhwc2.com,2,0.00%,2,0,100.00%
cl3.apple.com,2,0.00%,3,1,66.67%
cl3-cdn.origin-apple.com.akadns.net,2,0.00%,3,1,66.67%
onedscolprdneu05.northeurope.cloudapp.azure.com,2,0.00%,2,0,100.00%
38.courier-push-apple.com.akadns.net,2,0.00%,2,0,100.00%
activity.hdslb.com.w.kunlungr.com,2,0.00%,2,0,100.00%
stun-2.chat.bilibili.com,2,0.00%,2,0,100.00%
stun-1.chat.bilibili.com,2,0.00%,2,0,100.00%
sub1.bgp.netarch-alisc1-edge-lb.l.bytedns.net,2,0.00%,2,0,100.00%
static.hdslb.com.w.kunlunhuf.com,2,0.00%,2,0,100.00%
game.gtimg.cn.sched.legopic2.tdnsv6.com,2,0.00%,2,0,100.00%
cdn-go.cn.sched.legopic1.tdnsv6.com,2,0.00%,2,0,100.00%
bgp.netarch-bjlgy-edge-lb-v3.bjlgy.bytedns.net,2,0.00%,2,0,100.00%
miserupdate.aliyun.com.danuoyi.tbcache.com,2,0.00%,2,0,100.00%
19.courier-push-apple.com.akadns.net,2,0.00%,2,0,100.00%
down.anticheatexpert.com.cdn.ettdnsv.com,2,0.00%,2,0,100.00%
ws.mmstat.com.gds.alibabadns.com,2,0.00%,2,0,100.00%
pgpstatic.games.wanmei.com,2,0.00%,4,2,50.00%
pgpstatic.games.wanmei.com.cdn.dnsv1.com,2,0.00%,4,2,50.00%
2v21nxa7.sched.sma-dk.tdnsstic1.cn,2,0.00%,4,2,50.00%
liveheart.video.iqiyi.com,2,0.00%,2,0,100.00%
livenet.video.iqiyi.com,2,0.00%,2,0,100.00%
e19240.ca.s.tl88.net,2,0.00%,2,0,100.00%
msn-china.bing123.com,2,0.00%,2,0,100.00%
msnzlxxglobal.v.lxcvc.com,2,0.00%,2,0,100.00%
imohy4to.nodedata.net,2,0.00%,2,0,100.00%
22.newspush.eastmoney.com,2,0.00%,2,0,100.00%
76.push2.eastmoney.com,2,0.00%,4,2,50.00%
1.newspush.eastmoney.com,2,0.00%,2,0,100.00%
15.push2.eastmoney.com,2,0.00%,4,2,50.00%
14.push2.eastmoney.com,2,0.00%,4,2,50.00%
16.push2.eastmoney.com,2,0.00%,4,2,50.00%
47.newspush.eastmoney.com,2,0.00%,2,0,100.00%
55.newspush.eastmoney.com,2,0.00%,2,0,100.00%
28.newspush.eastmoney.com,2,0.00%,2,0,100.00%
39.newspush.eastmoney.com,2,0.00%,2,0,100.00%
www.hdw66.com,2,0.00%,2,0,100.00%
hub-mirror.c.163.com,2,0.00%,2,0,100.00%
b-ring.msedge.net,2,0.00%,2,0,100.00%
bimp.hdslb.com,2,0.00%,7,5,28.57%
skyversion.webrootcloudav.com,2,0.00%,2,0,100.00%
c1.adform.net,2,0.00%,2,0,100.00%
img2.xs.cdnyes.com,2,0.00%,2,0,100.00%
img1.xs.cdnyes.com,2,0.00%,2,0,100.00%
www.szfs168.com,2,0.00%,2,0,100.00%
www.7e.hk,2,0.00%,4,2,50.00%
udiab1.jianshu.com,2,0.00%,2,0,100.00%
smarthome.hicloud.com,2,0.00%,2,0,100.00%
terms1.hicloud.com,2,0.00%,2,0,100.00%
udc-service.mathworks.com,2,0.00%,2,0,100.00%
spynet2.microsoft.com,2,0.00%,2,0,100.00%
updatecn.maxthon.com,2,0.00%,2,0,100.00%
i.w.bilicdn1.com,2,0.00%,4,2,50.00%
i0.hdslb.com.w.kunlunno.com,2,0.00%,4,2,50.00%
jd-abroad.cdn20.com,2,0.00%,4,2,50.00%
opencdnjd.jomodns.com,2,0.00%,2,0,100.00%
floor.jd.com.gslb.qianxun.com,2,0.00%,4,2,50.00%
pjapi.jd.com.gslb.qianxun.com,2,0.00%,2,0,100.00%
ipv4.gdt.qq.com,2,0.00%,2,0,100.00%
api-cname.growingio.com,2,0.00%,2,0,100.00%
open-search.docer.wps.cn,2,0.00%,2,0,100.00%
assets.leetcode.cn.w.kunluncan.com,2,0.00%,2,0,100.00%
static.leetcode.cn.w.cdngslb.com,2,0.00%,2,0,100.00%
assets.leetcode-cn.com.w.kunlungr.com,2,0.00%,2,0,100.00%
omg.wtftrackr.pw,2,0.00%,4,2,50.00%
assets.giocdn.com.wswebpic.com,2,0.00%,2,0,100.00%
xacu07.baidupcs.com,2,0.00%,2,0,100.00%
fantuantanshu.datasink.sensorsdata.cn,2,0.00%,2,0,100.00%
www.ccps.gov.cn,2,0.00%,2,0,100.00%
static.leetcode-cn.com,2,0.00%,2,0,100.00%
assets.leetcode.cn,2,0.00%,2,0,100.00%
csm.sg1.as.criteo.net,2,0.00%,2,0,100.00%
selfstock.10jqka.com.cn,2,0.00%,2,0,100.00%
appktavsiei5995.pc.xiaoe-tech.com,2,0.00%,2,0,100.00%
mg.yrqwnc.cn,2,0.00%,2,0,100.00%
pic.wujinpp.com,2,0.00%,2,0,100.00%
api2.branch.io,2,0.00%,3,1,66.67%
vkceyugu.cdn.bspapp.com,2,0.00%,2,0,100.00%
lf26-cdn-tos.bytecdntp.com,2,0.00%,2,0,100.00%
cdn.babakan.xyz,2,0.00%,2,0,100.00%
v.qisaoba.com,2,0.00%,2,0,100.00%
s1.zoubuting.com,2,0.00%,2,0,100.00%
hey03.cjkypo.com,2,0.00%,2,0,100.00%
apps.bdimg.com,2,0.00%,2,0,100.00%
c7.4199tv.com,2,0.00%,2,0,100.00%
officecdn.microsoft.com,2,0.00%,2,0,100.00%
landing.adobe.com,2,0.00%,4,2,50.00%
postoffice.adobe.com,2,0.00%,2,0,100.00%
slp2p-east-std1025.oray.net,2,0.00%,2,0,100.00%
487e1e9ab8894eed892c47b9452120c7.fp.measure.office.com,2,0.00%,2,0,100.00%
sgepodownload.mediatek.com,2,0.00%,4,2,50.00%
whoami.nie.netease.com,2,0.00%,2,0,100.00%
string.xy.163.com,2,0.00%,2,0,100.00%
onedriveclucproddm20044.blob.core.windows.net,2,0.00%,2,0,100.00%
yys.v.netease.com,2,0.00%,2,0,100.00%
play.qiqiuyun.net,2,0.00%,2,0,100.00%
service.mkey.163.com,2,0.00%,2,0,100.00%
service-stats.qiqiuyun.net,2,0.00%,2,0,100.00%
9.push2.eastmoney.com,2,0.00%,4,2,50.00%
78.push2.eastmoney.com,2,0.00%,4,2,50.00%
79.push2.eastmoney.com,2,0.00%,4,2,50.00%
62.newspush.eastmoney.com,2,0.00%,2,0,100.00%
ihsu-southeastasia-3.southeastasia.cloudapp.azure.com,2,0.00%,2,0,100.00%
accountv2.wpsdns.com,2,0.00%,2,0,100.00%
wd-prod-ss-as-southeast-4-fe.southeastasia.cloudapp.azure.com,2,0.00%,2,0,100.00%
radarsubmissions.apple.com,2,0.00%,2,0,100.00%
47.courier-push-apple.com.akadns.net,2,0.00%,2,0,100.00%
weu09-breeziest-in.cloudapp.net,2,0.00%,2,0,100.00%
weu016-breeziest-in.cloudapp.net,2,0.00%,2,0,100.00%
onedscolprdweu02.westeurope.cloudapp.azure.com,2,0.00%,2,0,100.00%
messaging.awsmcafeeccs.mcafee.com,2,0.00%,2,0,100.00%
valid-cn.origin-apple.com.akadns.net,2,0.00%,2,0,100.00%
50.courier-push-apple.com.akadns.net,2,0.00%,2,0,100.00%
captive.g.aaplimg.com,2,0.00%,8,6,25.00%
launches.appsflyer.com,2,0.00%,2,0,100.00%
conversions.appsflyer.com,2,0.00%,2,0,100.00%
onedscolprdwus12.westus.cloudapp.azure.com,2,0.00%,4,2,50.00%
68.push2.eastmoney.com,2,0.00%,4,2,50.00%
58.newspush.eastmoney.com,2,0.00%,2,0,100.00%
80.push2.eastmoney.com,2,0.00%,4,2,50.00%
www.iqiyi.com,2,0.00%,4,2,50.00%
phfwba-std-g1.oray.net,2,0.00%,2,0,100.00%
phsle5-std03.oray.net,2,0.00%,2,0,100.00%
krgame06.graniterapids.com,2,0.00%,2,0,100.00%
file.cmbimg.com,2,0.00%,2,0,100.00%
tracker.vraphim.com,2,0.00%,2,0,100.00%
api.pagenote.cn,2,0.00%,2,0,100.00%
tracker.noobsubs.net,2,0.00%,2,0,100.00%
upos-sz-mirrorcosb.bilivideo.com,2,0.00%,5,3,40.00%
adsmind.ugdtimg.com,2,0.00%,6,4,33.33%
quicpro.jd.com,2,0.00%,2,0,100.00%
jkbxcx-static.yqgz.beijing.gov.cn,2,0.00%,2,0,100.00%
mef7s4cr.sched.sma.tdnsstic1.cn,2,0.00%,2,0,100.00%
iphonesubmissions.v.aaplimg.com,2,0.00%,2,0,100.00%
iristech.co,2,0.00%,2,0,100.00%
ip-api.com,2,0.00%,2,0,100.00%
seed-siri-apple-com.v.aaplimg.com,2,0.00%,2,0,100.00%
usstartus1.eucdurl.me,2,0.00%,2,0,100.00%
eduall.buzzline.org,2,0.00%,2,0,100.00%
dcs.mspcloud.cn,2,0.00%,2,0,100.00%
learn.kaikeba.com,2,0.00%,2,0,100.00%
p.bokecc.com,2,0.00%,2,0,100.00%
res.baoshiyun.com,2,0.00%,2,0,100.00%
dasheng03.com,2,0.00%,2,0,100.00%
i3fneen3irt7ibp8car9551gmg147fue33vkv523hpqa6uofl7av.qc.x.bsgslb.cn,2,0.00%,2,0,100.00%
kcn-deal.kaikeba.com,2,0.00%,2,0,100.00%
interaction.kaikeba.com,2,0.00%,2,0,100.00%
ocsp.godaddy.com.akadns.net,2,0.00%,2,0,100.00%
ad-static-xg.tagtic.cn,2,0.00%,2,0,100.00%
xueqiu.glsc.com.cn,2,0.00%,2,0,100.00%
img8.file.cache.docer.com,2,0.00%,2,0,100.00%
onedriveclucprodbn20023.blob.core.windows.net,2,0.00%,2,0,100.00%
wss.dida365.com,2,0.00%,2,0,100.00%
eh17.foot5176.cf,2,0.00%,2,0,100.00%
tracker.grepler.com,2,0.00%,2,0,100.00%
svr.sangfor.com.cn,2,0.00%,2,0,100.00%
themaninashed.com,2,0.00%,2,0,100.00%
checkin.gstatic.com,2,0.00%,2,0,100.00%
caldav.126.com,2,0.00%,2,0,100.00%
r4---sn-2x3elnez.gvt1.com,2,0.00%,2,0,100.00%
assets.msn.com.edgekey.net,2,0.00%,2,0,100.00%
30.courier-push-apple.com.akadns.net,2,0.00%,2,0,100.00%
sea-displaycatalogrp.frontdoor.bigcatalog.commerce.microsoft.com,2,0.00%,2,0,100.00%
onedscolprdeus06.eastus.cloudapp.azure.com,2,0.00%,2,0,100.00%
fe2.update.msft.com.trafficmanager.net,2,0.00%,4,2,50.00%
cl5-cdn.origin-apple.com.akadns.net,2,0.00%,4,2,50.00%
ns2.cuhk.hk,2,0.00%,2,0,100.00%
update.bittorrent.com,2,0.00%,5,3,40.00%
i-29.b-46304.ut.bench.utorrent.com,2,0.00%,3,1,66.67%
llsw.download3.utorrent.com,2,0.00%,3,1,66.67%
i-139.b-46304.ut.bench.utorrent.com,2,0.00%,3,1,66.67%
i-32.b-46304.ut.bench.utorrent.com,2,0.00%,3,1,66.67%
i-43.b-46304.ut.bench.utorrent.com,2,0.00%,3,1,66.67%
rtclbs.xdrtc.com,2,0.00%,2,0,100.00%
krsk09.graniterapids.com,2,0.00%,2,0,100.00%
retracker.joxnet.ru,2,0.00%,2,0,100.00%
httpsdns.n.shifen.com,2,0.00%,2,0,100.00%
tracker.swarm3.network,2,0.00%,2,0,100.00%
tycs.hpccube.com,2,0.00%,2,0,100.00%
static.xf.qq.com,2,0.00%,2,0,100.00%
busuanzi.ibruce.info,2,0.00%,2,0,100.00%
a1737.b.akamai.net,2,0.00%,2,0,100.00%
connectivitycheck.platform.hicloud.com.80800000.c.cdnhwc1.com,2,0.00%,4,2,50.00%
hcdnd.wangluojiance.gslb.c.cdnhwc6.com,2,0.00%,3,1,66.67%
cdn-file.peasrch.com,2,0.00%,2,0,100.00%
cdn-file.peasrch.com.cdn.dnsv1.com.cn,2,0.00%,2,0,100.00%
h12o01dt.sched.sma.tdnsstic1.cn,2,0.00%,2,0,100.00%
cdn-file.cchytech.com,2,0.00%,2,0,100.00%
cdn-file.cchytech.com.cdn.dnsv1.com.cn,2,0.00%,2,0,100.00%
dxra5xll.sched.sma.tdnsstic1.cn,2,0.00%,2,0,100.00%
www.youxiaohou.com,2,0.00%,2,0,100.00%
pic4.zhimg.com.a.bdydns.com,2,0.00%,2,0,100.00%
opencdnzhihustatic.jomodns.com,2,0.00%,3,1,66.67%
api-msn-com.a-0003.a-msedge.net,2,0.00%,4,2,50.00%
APAC03.azure-devices.net,2,0.00%,2,0,100.00%
m.youlai.cn,2,0.00%,2,0,100.00%
file.youlai.cn,2,0.00%,2,0,100.00%
hm.youlai.cn,2,0.00%,2,0,100.00%
pull-flv-f13.douyincdn.com.a.bcelive.com,2,0.00%,2,0,100.00%
passport-client.bitcomet.com,2,0.00%,2,0,100.00%
i.imgur.com,2,0.00%,4,2,50.00%
ts2.cn.mm.bing.net.lxcvc.com,2,0.00%,2,0,100.00%
pull-tsl-spe-l1.douyincdn.com,2,0.00%,3,1,66.67%
bdns-dy-vod.bytegslb.com,2,0.00%,2,0,100.00%
gsa.idms-apple.com.akadns.net,2,0.00%,2,0,100.00%
pull-flv-l11-encryption.douyincdn.com.sched.l9.tdnsv5.com,2,0.00%,2,0,100.00%
bcefdyflvq.jomodns.com,2,0.00%,2,0,100.00%
toutiao.uplive.ks-cdn.com,2,0.00%,2,0,100.00%
pull-l3-hs.pstatp.com.w.alikunlun.net,2,0.00%,2,0,100.00%
yun.livepush.myqcloud.com,2,0.00%,2,0,100.00%
adashbc.ut.taobao.com,2,0.00%,2,0,100.00%
ip1880706116.funshion.com.HOST,2,0.00%,2,0,100.00%
api.foxitreader.cn,2,0.00%,2,0,100.00%
cse.google.com,2,0.00%,2,0,100.00%
adashx.ut.cainiao.com,2,0.00%,2,0,100.00%
m2.cn.bing.com,2,0.00%,2,0,100.00%
collector-hpn.ghostery.net,2,0.00%,2,0,100.00%
support.content.office.net,2,0.00%,2,0,100.00%
metadata.templates.cdn.office.net,2,0.00%,2,0,100.00%
messaging.office.com,2,0.00%,2,0,100.00%
loki.delve.office.com,2,0.00%,2,0,100.00%
applog.uc.cn,2,0.00%,2,0,100.00%
unpkg.zhimg.com,2,0.00%,4,2,50.00%
down-update.qq.com,2,0.00%,2,0,100.00%
api.niceax.net,2,0.00%,2,0,100.00%
g.wan.douyu.com,2,0.00%,2,0,100.00%
tc-tct.douyucdn2.cn,2,0.00%,2,0,100.00%
hlsh5p2.douyucdn2.cn,2,0.00%,2,0,100.00%
playweb.douyu.com,2,0.00%,2,0,100.00%
pis-s.alicdn.com,2,0.00%,2,0,100.00%
aliyun-pcdnts.douyucdn.cn,2,0.00%,2,0,100.00%
pss-s.alicdn.com,2,0.00%,2,0,100.00%
pcdnlive-slicerd-s.alicdn.com,2,0.00%,2,0,100.00%
mobilep1.douyucdn2.cn,2,0.00%,2,0,100.00%
yccdn3.douyucdn2.cn,2,0.00%,2,0,100.00%
msg.douyu.com,2,0.00%,2,0,100.00%
msgstatic.douyu.com,2,0.00%,2,0,100.00%
s.deepl.com,2,0.00%,2,0,100.00%
dyp2p-hw.douyucdn.cn,2,0.00%,2,0,100.00%
butterfly.douyucdn.cn,2,0.00%,2,0,100.00%
pslice.douyucdn.cn,2,0.00%,2,0,100.00%
adashbc.m.taobao.com,2,0.00%,2,0,100.00%
l-ring.msedge.net,2,0.00%,2,0,100.00%
jstatic.3.cn,2,0.00%,2,0,100.00%
wq.360buyimg.com,2,0.00%,2,0,100.00%
m.360buyimg.com,2,0.00%,4,2,50.00%
uranus.jd.com,2,0.00%,2,0,100.00%
c.3.cn,2,0.00%,4,2,50.00%
blackhole.m.jd.com,2,0.00%,2,0,100.00%
yx.3.cn,2,0.00%,2,0,100.00%
pe.3.cn,2,0.00%,2,0,100.00%
st.jingxi.com,2,0.00%,2,0,100.00%
cdn.overleaf.com,2,0.00%,3,1,66.67%
c.dun.163.com,2,0.00%,2,0,100.00%
m.mpl.dutils.com,2,0.00%,2,0,100.00%
h.m.mpl.dutils.com,2,0.00%,2,0,100.00%
lyrics.kugou.com,2,0.00%,4,2,50.00%
dreport.meituan.net,2,0.00%,2,0,100.00%
p1.meituan.net,2,0.00%,4,2,50.00%
met_mobile_sniffer.dreport.meituan.net,2,0.00%,2,0,100.00%
apps.apple.com.cdn30.com,2,0.00%,2,0,100.00%
is5-ssl.mzstatic.com,2,0.00%,2,0,100.00%
is2-ssl.mzstatic.com,2,0.00%,2,0,100.00%
is3-ssl.mzstatic.com,2,0.00%,2,0,100.00%
p3.dcarimg.com.w.kunluncan.com,2,0.00%,2,0,100.00%
v1.cnzz.com,2,0.00%,2,0,100.00%
p5-auto.dcarimg.com,2,0.00%,2,0,100.00%
lf1-cdn-tos.bytescm.com.wsglb0.com,2,0.00%,3,1,66.67%
vcs.zijieapi.com,2,0.00%,2,0,100.00%
sso.toutiao.com,2,0.00%,2,0,100.00%
vod.bytedanceapi.com,2,0.00%,2,0,100.00%
p26-sign.douyinpic.com,2,0.00%,3,1,66.67%
p3-dcd-sign.byteimg.com,2,0.00%,2,0,100.00%
dl-static.iqiyi.com,2,0.00%,4,2,50.00%
subscription.iqiyi.com,2,0.00%,4,2,50.00%
api-feedback.iqiyi.com,2,0.00%,2,0,100.00%
transit2.wslog.chinanetcenter.com,2,0.00%,2,0,100.00%
wx.gtimg.com,2,0.00%,2,0,100.00%
mediadata.api.weibo.com,2,0.00%,2,0,100.00%
tnc3-bjlgy.snssdk.com,2,0.00%,2,0,100.00%
sf3-fe-tos.pglstatp-toutiao.com,2,0.00%,2,0,100.00%
api.ad.xiaomi.com,2,0.00%,2,0,100.00%
map.sogou.com,2,0.00%,2,0,100.00%
so.csdn.net,2,0.00%,2,0,100.00%
onedriveclucprodbn20028.blob.core.windows.net,2,0.00%,2,0,100.00%
hub5emu.v6.shub.sandai.net,2,0.00%,4,2,50.00%
app-center.cdn.bcebos.com,2,0.00%,2,0,100.00%
api.qrserver.com,2,0.00%,2,0,100.00%
d.3.cn,2,0.00%,2,0,100.00%
h5static.m.jd.com,2,0.00%,2,0,100.00%
pjapi.jd.com,2,0.00%,2,0,100.00%
lapi.jd.com,2,0.00%,2,0,100.00%
imgcps.jd.com,2,0.00%,2,0,100.00%
h5speed.m.jd.com,2,0.00%,2,0,100.00%
item.jd.com,2,0.00%,4,2,50.00%
p.3.cn,2,0.00%,2,0,100.00%
x.jd.com,2,0.00%,2,0,100.00%
onedscolprdneu01.northeurope.cloudapp.azure.com,2,0.00%,2,0,100.00%
instruaccess.mcafee.com,2,0.00%,2,0,100.00%
fe1.hdfimg.com,2,0.00%,2,0,100.00%
i2.hdfimg.com,2,0.00%,2,0,100.00%
www.haodf.com,2,0.00%,2,0,100.00%
i1.hdfimg.com,2,0.00%,2,0,100.00%
ocsp.dcocsp.cn.w.kunlunar.com,2,0.00%,2,0,100.00%
apis.mcafee.com,2,0.00%,2,0,100.00%
tracker.linkomanija.org,2,0.00%,2,0,100.00%
home.mcafee.com,2,0.00%,2,0,100.00%
app.mcafee.com,2,0.00%,2,0,100.00%
pwo4tgrz.slt.sched.tdnsv8.com,2,0.00%,2,0,100.00%
16.au.download.windowsupdate.com,2,0.00%,2,0,100.00%
www.mmcs.org.cn,2,0.00%,2,0,100.00%
s.jiathis.com,2,0.00%,2,0,100.00%
subca.crl.certum.pl,2,0.00%,4,2,50.00%
settings-prod-cin-1.centralindia.cloudapp.azure.com,2,0.00%,2,0,100.00%
hr15.graniterapids.com,2,0.00%,2,0,100.00%
onedriveclubproddm20037.blob.core.windows.net,2,0.00%,2,0,100.00%
krsk02.graniterapids.com,2,0.00%,2,0,100.00%
apigtwb2c.us.dell.com,2,0.00%,2,0,100.00%
onedriveclucproddm20041.blob.core.windows.net,2,0.00%,2,0,100.00%
images.nvidia.cn,2,0.00%,2,0,100.00%
bt.zlofenix.org,2,0.00%,2,0,100.00%
itera.bz,2,0.00%,2,0,100.00%
dsm04pap001.storage.live.com,2,0.00%,4,2,50.00%
cpu.fire.skyworthdigital.jikedata.com,2,0.00%,2,0,100.00%
krgame08.graniterapids.com,2,0.00%,2,0,100.00%
s14-sync.firefox.com.cn,2,0.00%,2,0,100.00%
be01mr9s.sched.d2.tdnsdp1.cn.cjt.vwnti.yrzhcloud.cn,2,0.00%,2,0,100.00%
torrent.unix-ag.uni-kl.de,2,0.00%,2,0,100.00%
client.docer.wps.cn,2,0.00%,2,0,100.00%
static.ws.126.net,2,0.00%,5,3,40.00%
nimg.ws.126.net,2,0.00%,5,3,40.00%
vmonitor.ws.netease.com,2,0.00%,6,4,33.33%
jwxk.ucas.ac.cn,2,0.00%,2,0,100.00%
dl-cdn.oray.com,2,0.00%,2,0,100.00%
www.oray.com,2,0.00%,2,0,100.00%
www.dlzdm.com,2,0.00%,2,0,100.00%
v.sogowan.com.w.kunlunaq.com,2,0.00%,2,0,100.00%
iqiyi6.top,2,0.00%,2,0,100.00%
contacts.fe.apple-dns.net,2,0.00%,5,3,40.00%
mediaclub.tv,2,0.00%,4,2,50.00%
ohg5xoot.nodedata.net,2,0.00%,2,0,100.00%
v.qq.com.sched.ssd.tdnsv6.com,2,0.00%,2,0,100.00%
yuri-tracing.app.kdsec.org,2,0.00%,2,0,100.00%
gss0.baidu.com,2,0.00%,2,0,100.00%
dmpstatic.cdn.bcebos.com,2,0.00%,2,0,100.00%
bkimg.cdn.bcebos.com,2,0.00%,2,0,100.00%
ss0.bdstatic.com,2,0.00%,2,0,100.00%
app.getsentry.com,2,0.00%,2,0,100.00%
baikebcs.cdn.bcebos.com,2,0.00%,2,0,100.00%
nsclick.baidu.com,2,0.00%,5,3,40.00%
down.qq.com,2,0.00%,2,0,100.00%
pubnew.paperol.cn,2,0.00%,2,0,100.00%
pc-store-lb.lenovomm.cn,2,0.00%,2,0,100.00%
dsum-sec.casalemedia.com,2,0.00%,2,0,100.00%
analyticspixel.microsoft.com,2,0.00%,2,0,100.00%
ws-na.amazon-adsystem.com,2,0.00%,2,0,100.00%
aa.agkn.com,2,0.00%,2,0,100.00%
g-images.amazon.com,2,0.00%,2,0,100.00%
pixel.rubiconproject.com,2,0.00%,2,0,100.00%
beacon.krxd.net,2,0.00%,2,0,100.00%
p5.ssl.qhimg.com,2,0.00%,2,0,100.00%
hao5.qhimg.com,2,0.00%,3,1,66.67%
bs5.360sres.com,2,0.00%,2,0,100.00%
bs4.360sres.com,2,0.00%,2,0,100.00%
c2shb.pubgw.yahoo.com,2,0.00%,2,0,100.00%
se4.360simg.com,2,0.00%,2,0,100.00%
www.wjx.cn,2,0.00%,2,0,100.00%
p13.upd.kaspersky.com,2,0.00%,2,0,100.00%
cc-api-behance.adobe.io,2,0.00%,2,0,100.00%
mp-blog.csdn.net,2,0.00%,2,0,100.00%
mp-download.csdn.net,2,0.00%,2,0,100.00%
mp-others.csdn.net,2,0.00%,2,0,100.00%
cnzz.mmstat.com,2,0.00%,2,0,100.00%
h10hxsame.hexun.com,2,0.00%,2,0,100.00%
h06hxsame.hexun.com,2,0.00%,2,0,100.00%
gw.homeway.com.cn,2,0.00%,2,0,100.00%
i.csdn.net,2,0.00%,2,0,100.00%
castatic.fengkongcloud.com,2,0.00%,2,0,100.00%
g-api.csdn.net,2,0.00%,2,0,100.00%
onedriveclucprodbn20045.blob.core.windows.net,2,0.00%,2,0,100.00%
www.licaike.com,2,0.00%,4,2,50.00%
cdn.w.wanfangdata.com.cn,2,0.00%,2,0,100.00%
com.wf.pub,2,0.00%,2,0,100.00%
cdn.wanfangdata.com.cn,2,0.00%,2,0,100.00%
cdn.login.wanfangdata.com.cn,2,0.00%,2,0,100.00%
cdn.advert.wanfangdata.com.cn,2,0.00%,2,0,100.00%
g1.hub5pn.sandai.net,2,0.00%,2,0,100.00%
v26.douyinvod.com,2,0.00%,4,2,50.00%
nsp-hicloud-cloudphotoeast3-p01-drcn.obs.cn-east-3.myhuaweicloud.cn,2,0.00%,2,0,100.00%
a2pssl-drcn.dbankcdn.cn,2,0.00%,2,0,100.00%
browsercfg-drcn.cloud.dbankcloud.cn,2,0.00%,2,0,100.00%
push-rtmp-l11-encryption.douyincdn.com,2,0.00%,2,0,100.00%
push-rtmp-l1-cny.douyincdn.com,2,0.00%,2,0,100.00%
pull-flv-f13.douyincdn.com,2,0.00%,2,0,100.00%
push-rtmp-hs-f5.douyincdn.com,2,0.00%,2,0,100.00%
pull-tsl-vr-l3.douyincdn.com,2,0.00%,2,0,100.00%
pull-hs-f5.flive.ihuoshanlive.com,2,0.00%,2,0,100.00%
pull-hs-f5.flive.huoshanlive.com,2,0.00%,2,0,100.00%
pull-flv-l13.douyincdn.com,2,0.00%,2,0,100.00%
push-rtmp-hs-spe-f5.douyincdn.com,2,0.00%,2,0,100.00%
pull-hls-hs-f5-tsl.douyincdn.com,2,0.00%,2,0,100.00%
push-rtmp-spe-l1.douyincdn.com,2,0.00%,2,0,100.00%
pull-lls-spe-l3.douyincdn.com,2,0.00%,2,0,100.00%
push-rtmp-hs-vr-f5.douyincdn.com,2,0.00%,2,0,100.00%
pull-hls-spe-l26.douyincdn.com,2,0.00%,2,0,100.00%
pull-flv-l27.douyincdn.com,2,0.00%,2,0,100.00%
pull-rtmp-l13.douyincdn.com,2,0.00%,2,0,100.00%
push-rtmp-f5-cny.douyincdn.com,2,0.00%,2,0,100.00%
pull-rtmp-f13.douyincdn.com,2,0.00%,2,0,100.00%
push-rtmp-l3.douyincdn.com,2,0.00%,2,0,100.00%
push-rtmp-l27.douyincdn.com,2,0.00%,2,0,100.00%
pull-lls-spe-l11.douyincdn.com,2,0.00%,2,0,100.00%
push-rtmp-l29.douyincdn.com,2,0.00%,2,0,100.00%
pull-flv-l11-source.douyincdn.com,2,0.00%,2,0,100.00%
pull-f5-vs.flive.douyincdn.com,2,0.00%,2,0,100.00%
pull-flv-l1.ixigua.com,2,0.00%,2,0,100.00%
pull-lls-spe-l1.douyincdn.com,2,0.00%,2,0,100.00%
pull-f3.douyincdn.com,2,0.00%,2,0,100.00%
pull-lls-f5.flive.douyincdn.com,2,0.00%,2,0,100.00%
pull-rtmp-f11.douyincdn.com,2,0.00%,2,0,100.00%
pull-rtmp-l11.douyincdn.com,2,0.00%,2,0,100.00%
pull-rtmp-l1-cny.douyincdn.com,2,0.00%,2,0,100.00%
push-rtmp-l13.douyincdn.com,2,0.00%,2,0,100.00%
pull-rtmp-l27.douyincdn.com,2,0.00%,2,0,100.00%
push-rtmp-f5-enc.douyincdn.com,2,0.00%,2,0,100.00%
pull-rtmp-l1-hs.pstatp.com,2,0.00%,2,0,100.00%
pull-tsl-hs-spe-f5.douyincdn.com,2,0.00%,2,0,100.00%
pull-flv-vr-l26.douyincdn.com,2,0.00%,2,0,100.00%
pull-hls-f1.douyincdn.com,2,0.00%,2,0,100.00%
pull-flv-l11.douyincdn.com,2,0.00%,2,0,100.00%
pull-flv-l11-encryption.douyincdn.com,2,0.00%,2,0,100.00%
pull-rtmp-f1.douyincdn.com,2,0.00%,2,0,100.00%
pull-l3.douyincdn.com,2,0.00%,2,0,100.00%
pull-hs-f5-encryption.flive.douyincdn.com,2,0.00%,2,0,100.00%
pull-f5-hot.flive.douyincdn.com,2,0.00%,2,0,100.00%
pull-hs-spe-f5.douyincdn.com,2,0.00%,2,0,100.00%
pull-f3-proxy.douyincdn.com,2,0.00%,2,0,100.00%
pull-lls-spe-l26.douyincdn.com,2,0.00%,2,0,100.00%
pull-rtmp-l29.douyincdn.com,2,0.00%,2,0,100.00%
pull-f5-hs.flive.pstatp.com,2,0.00%,2,0,100.00%
pull-hls-f96.douyincdn.com,2,0.00%,2,0,100.00%
pull-hs-f5.flive.douyincdn.com,2,0.00%,2,0,100.00%
push-rtmp-l6.ixigua.com,2,0.00%,2,0,100.00%
pull-lls-l3.douyincdn.com,2,0.00%,2,0,100.00%
pull-rtmp-l1.ixigua.com,2,0.00%,2,0,100.00%
push-rtmp-f5.douyincdn.com,2,0.00%,2,0,100.00%
push-rtmp-l3-cny.douyincdn.com,2,0.00%,2,0,100.00%
pull-tsl-spe-l3.douyincdn.com,2,0.00%,2,0,100.00%
push-rtmp-l3-enc.douyincdn.com,2,0.00%,2,0,100.00%
push-rtmp-spe-l26.douyincdn.com,2,0.00%,2,0,100.00%
pull-flv-vr-l11.douyincdn.com,2,0.00%,2,0,100.00%
push-rtmp-spe-l11.douyincdn.com,2,0.00%,2,0,100.00%
pull-flv-f11.douyincdn.com,2,0.00%,2,0,100.00%
pull-spe-l3.douyincdn.com,2,0.00%,2,0,100.00%
pull-rtmp-f29.douyincdn.com,2,0.00%,2,0,100.00%
pull-hls-f11.douyincdn.com,2,0.00%,2,0,100.00%
push-rtmp-spe-l6.douyincdn.com,2,0.00%,2,0,100.00%
pull-rtmp-l1-source.douyincdn.com,2,0.00%,2,0,100.00%
pull-rtmp-f96.douyincdn.com,2,0.00%,2,0,100.00%
pull-tsl-l3.douyincdn.com,2,0.00%,2,0,100.00%
push-rtmp-l1.ixigua.com,2,0.00%,2,0,100.00%
pull-rtmp-l6.douyincdn.com,2,0.00%,2,0,100.00%
pull-rtmp-l1.douyincdn.com,2,0.00%,2,0,100.00%
push-rtmp-l6-encryption.douyincdn.com,2,0.00%,2,0,100.00%
pull-flv-spe-l26.douyincdn.com,2,0.00%,2,0,100.00%
pull-l3-source.douyincdn.com,2,0.00%,2,0,100.00%
pull-f5.flive.douyincdn.com,2,0.00%,2,0,100.00%
pull-lls-l11.douyincdn.com,2,0.00%,2,0,100.00%
push-rtmp-f5-hs.pstatp.com,2,0.00%,2,0,100.00%
pull-flv-f96.douyincdn.com,2,0.00%,2,0,100.00%
push-rtmp-vr-l26.douyincdn.com,2,0.00%,2,0,100.00%
pull-f5-mptcp.flive.douyincdn.com,2,0.00%,2,0,100.00%
push-rtmp-l6-enc.douyincdn.com,2,0.00%,2,0,100.00%
pull-hls-spe-l11.douyincdn.com,2,0.00%,2,0,100.00%
pull-vr-l3.douyincdn.com,2,0.00%,2,0,100.00%
pull-rtmp-f26.douyincdn.com,2,0.00%,2,0,100.00%
push-rtmp-l26-cny.douyincdn.com,2,0.00%,2,0,100.00%
push-rtmp-l6-cny.douyincdn.com,2,0.00%,2,0,100.00%
push-rtmp-l11-cny.douyincdn.com,2,0.00%,2,0,100.00%
pull-hls-f13.douyincdn.com,2,0.00%,2,0,100.00%
pull-flv-f5-enc.flive.douyincdn.com,2,0.00%,2,0,100.00%
pull-f3-hs.pstatp.com,2,0.00%,2,0,100.00%
pull-flv-l1-hs.pstatp.com,2,0.00%,2,0,100.00%
push-rtmp-l1-hs.pstatp.com,2,0.00%,2,0,100.00%
push-rtmp-l3-encryption.douyincdn.com,2,0.00%,2,0,100.00%
pull-flv-l6.douyincdn.com,2,0.00%,2,0,100.00%
pull-tsl-l11.douyincdn.com,2,0.00%,2,0,100.00%
pull-hls-f29.douyincdn.com,2,0.00%,2,0,100.00%
pull-hls-f6.douyincdn.com,2,0.00%,2,0,100.00%
pull-flv-l3-enc.douyincdn.com,2,0.00%,2,0,100.00%
push-rtmp-vr-l3.douyincdn.com,2,0.00%,2,0,100.00%
pull-flv-l1-cny.douyincdn.com,2,0.00%,2,0,100.00%
pull-flv-f11-proxy.douyincdn.com,2,0.00%,2,0,100.00%
pull-lls-l26.douyincdn.com,2,0.00%,2,0,100.00%
push-rtmp-spe-l3.douyincdn.com,2,0.00%,2,0,100.00%
pull-l3-hs.pstatp.com,2,0.00%,2,0,100.00%
push-rtmp-f5-io.flive.douyincdn.com,2,0.00%,2,0,100.00%
pull-flv-l29.douyincdn.com,2,0.00%,2,0,100.00%
pull-rtmp-f1-hs.pstatp.com,2,0.00%,2,0,100.00%
push-rtmp-vr-l11.douyincdn.com,2,0.00%,2,0,100.00%
pull-hls-vr-l11.douyincdn.com,2,0.00%,2,0,100.00%
pull-flv-f29.douyincdn.com,2,0.00%,2,0,100.00%
pull-hls-vr-l26.douyincdn.com,2,0.00%,2,0,100.00%
pull-rtmp-l11-source.douyincdn.com,2,0.00%,2,0,100.00%
push-rtmp-hs-f5-encryption.douyincdn.com,2,0.00%,2,0,100.00%
push-rtmp-f5.ihuoshanlive.com,2,0.00%,2,0,100.00%
pull-flv-l3-encryption.douyincdn.com,2,0.00%,2,0,100.00%
push-rtmp-l26.douyincdn.com,2,0.00%,2,0,100.00%
pull-f5.douyincdn.com,2,0.00%,2,0,100.00%
pull-f5-io.flive.douyincdn.com,2,0.00%,2,0,100.00%
push-rtmp-l11.douyincdn.com,2,0.00%,2,0,100.00%
fastapp-drcn.dbankcdn.cn,2,0.00%,2,0,100.00%
www.bytedance.com,2,0.00%,2,0,100.00%
v9.douyinvod.com,2,0.00%,4,2,50.00%
v1.douyinvod.com,2,0.00%,2,0,100.00%
auth2.sangfor.com.cn,2,0.00%,2,0,100.00%
top.news.sina.com.cn,2,0.00%,2,0,100.00%
r.dmp.sina.cn,2,0.00%,2,0,100.00%
docs-personalized-fonts-1251316161.file.myqcloud.com,2,0.00%,2,0,100.00%
onedriveclucproddm20007.blob.core.windows.net,2,0.00%,2,0,100.00%
r4---sn-2x3elnee.gvt1.com,2,0.00%,2,0,100.00%
s00.upd.kaspersky.com,2,0.00%,2,0,100.00%
recommend.docer.wps.cn,2,0.00%,2,0,100.00%
accwww11c1.53kf.com,2,0.00%,2,0,100.00%
cloudcache.tencent-cloud.com,2,0.00%,2,0,100.00%
api.getquicker.net,2,0.00%,2,0,100.00%
passport.n.shifen.com,2,0.00%,4,2,50.00%
opencdnspy.jomodns.com,2,0.00%,2,0,100.00%
7e1w8x45.dayugslb.com,2,0.00%,2,0,100.00%
writing-recommendation.youdao.com,2,0.00%,2,0,100.00%
juejin.cn,2,0.00%,2,0,100.00%
photoshare-drcn.cloud.dbankcloud.cn,2,0.00%,2,0,100.00%
paulridgway.co.uk,2,0.00%,2,0,100.00%
cdn.apc.360.cn,2,0.00%,2,0,100.00%
unah2wel.nodedata.net,2,0.00%,2,0,100.00%
ipm-provider.ff.avast.com,2,0.00%,2,0,100.00%
static.nvidiagrid.net,2,0.00%,2,0,100.00%
15min.pcfg.cache.wpscdn.cn,2,0.00%,2,0,100.00%
fpdownload2.macromedia.com,2,0.00%,4,2,50.00%
chatlink-yqsx06.netease.im,2,0.00%,2,0,100.00%
api.samsungcloudcn.com,2,0.00%,2,0,100.00%
ase2022.hotcrp.com,2,0.00%,2,0,100.00%
onedriveclucprodbn20026.blob.core.windows.net,2,0.00%,2,0,100.00%
cstat.apple.com,2,0.00%,4,2,50.00%
downloaddispatch.itunes.apple.com,2,0.00%,4,2,50.00%
tracker.kali.org,2,0.00%,2,0,100.00%
tracker.hiyj.cn,2,0.00%,2,0,100.00%
ir05.graniterapids.com,2,0.00%,2,0,100.00%
migration-geo-filter-prd.stargate.cse.ss-inf.net,2,0.00%,2,0,100.00%
account-public-service-prod.ak.epicgames.com,2,0.00%,4,2,50.00%
us10.graniterapids.com,2,0.00%,2,0,100.00%
n3plcpnl0276.prod.ams3.secureserver.net,2,0.00%,2,0,100.00%
ns5-65.akam.net,2,0.00%,2,0,100.00%
e2c18.gcp.gvt2.com,2,0.00%,2,0,100.00%
ns7-66.akam.net,2,0.00%,2,0,100.00%
update-ruanjian.2345.com,2,0.00%,2,0,100.00%
update.gamehall.2345.com,2,0.00%,2,0,100.00%
developer.download.nvidia.cn,2,0.00%,2,0,100.00%
imap.mail.me.com,2,0.00%,2,0,100.00%
r4---sn-j5o7dn7l.gvt1.com,2,0.00%,2,0,100.00%
file.cdn.cqttech.com,2,0.00%,2,0,100.00%
onedscolprdweu06.westeurope.cloudapp.azure.com,2,0.00%,2,0,100.00%
ins-jnd35913.ias.tencent-cloud.net,2,0.00%,2,0,100.00%
kt-prod.ess.apple.com,2,0.00%,2,0,100.00%
s1b.time.edu.cn,2,0.00%,2,0,100.00%
win-crashdump-upload-1255554080.cos.ap-beijing.myqcloud.com,2,0.00%,2,0,100.00%
14.newspush.eastmoney.com,2,0.00%,2,0,100.00%
queipo3w.nodedata.net,2,0.00%,2,0,100.00%
uo9aech2.nodedata.net,2,0.00%,2,0,100.00%
96.newspush.eastmoney.com,2,0.00%,2,0,100.00%
galleryapi.micloud.xiaomi.net,2,0.00%,2,0,100.00%
cdnws.api.huya.com,2,0.00%,2,0,100.00%
lf.esf.fang.com,2,0.00%,2,0,100.00%
vod.cn-shanghai.aliyuncs.com,2,0.00%,2,0,100.00%
clzzzxbf.cilizhizhu.club,2,0.00%,2,0,100.00%
clzzfzlj.cilizhizhu.club,2,0.00%,2,0,100.00%
tracker.auctor.tv,2,0.00%,2,0,100.00%
tracker.leech.ie,2,0.00%,2,0,100.00%
tracker.pomf.se,2,0.00%,2,0,100.00%
uspider.yuanshen.com,2,0.00%,2,0,100.00%
v2.iperson.xyz,2,0.00%,2,0,100.00%
uploads.gamecoast.net,2,0.00%,2,0,100.00%
sx-common-all.volcgtm.com,2,0.00%,5,3,40.00%
yahor.ftp.sh,2,0.00%,2,0,100.00%
d3v522mr175zqx.cloudfront.net,2,0.00%,2,0,100.00%
www.maxima.fm,2,0.00%,2,0,100.00%
mcloud.mcafee.com,2,0.00%,2,0,100.00%
h30155.www3.hp.com,2,0.00%,2,0,100.00%
support.amd.com,2,0.00%,2,0,100.00%
logintcp.wps.cn,2,0.00%,2,0,100.00%
res.qhupdate.com,2,0.00%,2,0,100.00%
ocsp.crlocsp.cn,2,0.00%,2,0,100.00%
mail.weain.mil.cn,2,0.00%,2,0,100.00%
img2.baidu.com.a.bdydns.com,2,0.00%,2,0,100.00%
img1.baidu.com.a.bdydns.com,2,0.00%,2,0,100.00%
img0.baidu.com.a.bdydns.com,2,0.00%,2,0,100.00%
mbdp02.bdstatic.com.a.bdydns.com,2,0.00%,4,2,50.00%
opencdnbaiduapp.jomodns.com,2,0.00%,4,2,50.00%
iceprime.a-0003.dc-msedge.net,2,0.00%,2,0,100.00%
assets.msn.cn-c.edgekey.net.globalredir.akadns.net,2,0.00%,2,0,100.00%
inst-fs-yul-prod.inscloudgate.net,2,0.00%,2,0,100.00%
relay-yul.sentry.insops.net,2,0.00%,2,0,100.00%
ipv4.tracker.harry.lu,2,0.00%,2,0,100.00%
ut85.v.bsclink.cn,2,0.00%,2,0,100.00%
zkres1.myzaker.com.bsclink.cn,2,0.00%,2,0,100.00%
telecommandsvcfabricv4.westus2.cloudapp.azure.com,2,0.00%,2,0,100.00%
stat.myzaker.com,2,0.00%,2,0,100.00%
stat.myzaker.com.w.kunlungr.com,2,0.00%,2,0,100.00%
a11224-20946131.cluster222.canvas-user-content.com,2,0.00%,2,0,100.00%
www.ximalaya.com,2,0.00%,2,0,100.00%
prod-ca-central-1.ally.ac,2,0.00%,2,0,100.00%
sf3-cn.feishucdn.com.w.cdngslb.com,2,0.00%,2,0,100.00%
prod-china.fs.microsoft.com.akadns.net,2,0.00%,2,0,100.00%
lf3-short.ibytedapm.com.w.kunluncan.com,2,0.00%,2,0,100.00%
unpkg.byted-static.com.w.alikunlun.com,2,0.00%,2,0,100.00%
script.hotjar.com,2,0.00%,2,0,100.00%
s23-sync.firefox.com.cn,2,0.00%,2,0,100.00%
kbgp.wpsdns.com,2,0.00%,2,0,100.00%
title.mgt.xboxlive.com,2,0.00%,4,2,50.00%
china3-lb.itunes-apple.com.akadns.net,2,0.00%,2,0,100.00%
dit.whatsapp.net,2,0.00%,4,2,50.00%
tn-api-prod-southcentralus.azurewebsites.net,2,0.00%,2,0,100.00%
waws-prod-sn1-111.sip.azurewebsites.windows.net,2,0.00%,2,0,100.00%
certs.apple.com,2,0.00%,3,1,66.67%
iask.gslb.sinaedge.com,2,0.00%,4,2,50.00%
edivideo.grid.sinaedge.com,2,0.00%,3,1,66.67%
vdwmto3.bdstatic.com.a.bdydns.com,2,0.00%,4,2,50.00%
zttvad.v.bsgslb.com,2,0.00%,2,0,100.00%
vars.hotjar.com,2,0.00%,2,0,100.00%
static-res.qq.com.sched.legopic2.tdnsv6.com,2,0.00%,2,0,100.00%
hcdnv.cbg.c.cdnhwc1.com,2,0.00%,2,0,100.00%
video-tx-drcn.dbankcdn.cn.cdn.dnsv1.com,2,0.00%,4,2,50.00%
static-asm-skype.trafficmanager.net,2,0.00%,2,0,100.00%
5a880faf6fb5e608.jijifun.com,2,0.00%,2,0,100.00%
ejp1-authgw-azsc.cloudapp.net,2,0.00%,2,0,100.00%
store-drcn-hispace-dbankcloud-cn-drcn.appacc.dbankedge.cn,2,0.00%,2,0,100.00%
appdl-12-drcn.dbankcdn.com,2,0.00%,2,0,100.00%
appdl-1-drcn.dbankcdn.com,2,0.00%,2,0,100.00%
appdl-11-drcn.dbankcdn.com,2,0.00%,2,0,100.00%
appdl-12-drcn.dbankcdn.com.akamaized.net,2,0.00%,2,0,100.00%
appdlv4.glb.c.cdnhwc2.com,2,0.00%,2,0,100.00%
appdl-1-drcn.dbankcdn.com.c.cdnhwc1.com,2,0.00%,2,0,100.00%
a1939.d.akamai.net,2,0.00%,2,0,100.00%
appdl.glb.c.cdnhwc1.com,2,0.00%,2,0,100.00%
midas.gtimg.cn.cloud.tc.qq.com,2,0.00%,2,0,100.00%
midas.gtimg.cn.sched.legopic1.tdnsv6.com,2,0.00%,2,0,100.00%
mmbiz.qlogo.cn.tc.qq.com,2,0.00%,2,0,100.00%
mg.uu.163.com,2,0.00%,2,0,100.00%
music.ntes53.netease.com,2,0.00%,3,1,66.67%
tracker2.dler.com,2,0.00%,2,0,100.00%
v83-017.douyinvod.com,2,0.00%,2,0,100.00%
su-china.itunes-apple.com.akadns.net,2,0.00%,4,2,50.00%
so0ujcb41lj79j3aguf20s3o7st09ih4i8c6nqlps4nqsql36p0fue10.tt.x.bsgslb.cn,2,0.00%,2,0,100.00%
imeres.baidu.com,2,0.00%,2,0,100.00%
imeres.baidu.com.a.bdydns.com,2,0.00%,2,0,100.00%
api.account.xiaomi.com,2,0.00%,2,0,100.00%
selfpage-gips.cdn.bcebos.com.a.bdydns.com,2,0.00%,2,0,100.00%
anti-bot.n.shifen.com,2,0.00%,2,0,100.00%
dss2.baidu.com,2,0.00%,2,0,100.00%
dss1.baidu.com,2,0.00%,2,0,100.00%
dss0.baidu.com,2,0.00%,2,0,100.00%
statistic.live.126.net,2,0.00%,2,0,100.00%
appsec.hicloud.com,2,0.00%,2,0,100.00%
k128-iosapps-all.gslb.ksyuncdn.com,2,0.00%,2,0,100.00%
p212-fmf.icloud.com.cn,2,0.00%,2,0,100.00%
home-packages.chinauos.com,2,0.00%,2,0,100.00%
s3.cn-north-1.amazonaws.com.cn,2,0.00%,2,0,100.00%
link.csdn.net,2,0.00%,2,0,100.00%
aeu.alicdn.com.danuoyi.alicdn.com,2,0.00%,4,2,50.00%
ifeng3.yylady.cn.w.kunlungr.com,2,0.00%,2,0,100.00%
g.alicdn.com.danuoyi.alicdn.com,2,0.00%,4,2,50.00%
upload-images.jianshu.io.w.cdngslb.com,2,0.00%,3,1,66.67%
lb.sae.sina.com.cn,2,0.00%,2,0,100.00%
adutp-corner.oss-cn-beijing.aliyuncs.com,2,0.00%,2,0,100.00%
ganmin-wrr.qhcdn.com,2,0.00%,2,0,100.00%
opencdnspyv6.jomodns.com,2,0.00%,4,2,50.00%
udiab1.jianshu.com.cname2235.yjs-cdn.com,2,0.00%,2,0,100.00%
sensors.ibreader.com,2,0.00%,2,0,100.00%
www.jianshu.com,2,0.00%,4,2,50.00%
all.cnzz.com.danuoyi.tbcache.com,2,0.00%,2,0,100.00%
array604.prod.do.dsp.mp.microsoft.com,2,0.00%,2,0,100.00%
control.mna.qq.com,2,0.00%,2,0,100.00%
onedscolprdneu00.northeurope.cloudapp.azure.com,2,0.00%,2,0,100.00%
grs.platform.dbankcloud.ru,2,0.00%,2,0,100.00%
update.qnap.com,2,0.00%,2,0,100.00%
download.get.live.cn,2,0.00%,2,0,100.00%
eeth9boh.nodedata.net,2,0.00%,2,0,100.00%
fanyi.sogou.com,2,0.00%,4,2,50.00%
extie.sogoucdn.com,2,0.00%,2,0,100.00%
startpage.ic.ksosoft.com,2,0.00%,2,0,100.00%
dynsrv.wps.cn,2,0.00%,2,0,100.00%
bl6pap004.storage.live.com,2,0.00%,5,3,40.00%
softm.update.360safe.com,2,0.00%,2,0,100.00%
dsm01pap005.storage.live.com,2,0.00%,4,2,50.00%
c.gsc.qq.com,2,0.00%,2,0,100.00%
t-khd.2345.cc,2,0.00%,2,0,100.00%
profile.blzstatic.cn,2,0.00%,2,0,100.00%
content-ui.battlenet.com.cn,2,0.00%,2,0,100.00%
oauth.battlenet.com.cn,2,0.00%,2,0,100.00%
gateway.battlenet.com.cn,2,0.00%,2,0,100.00%
contentstack-images.blzstatic.cn,2,0.00%,2,0,100.00%
cms.blzstatic.cn,2,0.00%,2,0,100.00%
uif.microsoft.com,2,0.00%,2,0,100.00%
cn.voice.gcloudcs.com,2,0.00%,2,0,100.00%
qosidc.gcloudsdk.com,2,0.00%,2,0,100.00%
tracker.pcdn.yximgs.com,2,0.00%,2,0,100.00%
dmp.brand-display.com,2,0.00%,2,0,100.00%
www.izaodao.com,2,0.00%,2,0,100.00%
dlswbr.baidu.com.cname3920.yjs-cdn.com,2,0.00%,3,1,66.67%
iknow-base.cdn.bcebos.com,2,0.00%,2,0,100.00%
crl.godaddy.com,2,0.00%,2,0,100.00%
tnsvmts.qqngzh.xyz,2,0.00%,2,0,100.00%
legittorrents.info,2,0.00%,2,0,100.00%
wppkg.baidupcs.com,2,0.00%,5,3,40.00%
log.dc.cn.happyelements.com,2,0.00%,2,0,100.00%
h-adashx-internal.ut.taobao.com.gds.alibabadns.com,2,0.00%,2,0,100.00%
9.courier-push-apple.com.akadns.net,2,0.00%,2,0,100.00%
2.courier-push-apple.com.akadns.net,2,0.00%,2,0,100.00%
collector.newrelic.com,2,0.00%,2,0,100.00%
space.bilibili.com,2,0.00%,2,0,100.00%
passport.biligame.com,2,0.00%,2,0,100.00%
passport.bigfun.cn,2,0.00%,2,0,100.00%
passport.shanghaihuanli.com,2,0.00%,2,0,100.00%
passport.bilibili.cn,2,0.00%,2,0,100.00%
passport.bigfunapp.cn,2,0.00%,2,0,100.00%
downv6.qq.com,2,0.00%,2,0,100.00%
myip.opendns.com,2,0.00%,3,1,66.67%
cdnimg.3g.qq.com,2,0.00%,2,0,100.00%
wemeet-log-1256380422.cos.ap-guangzhou.myqcloud.com,2,0.00%,2,0,100.00%
translate.googleapis.com,2,0.00%,2,0,100.00%
oimageb7.ydstatic.com,2,0.00%,2,0,100.00%
in1-gw2-02-ce7dd027.eastus2.cloudapp.azure.com,2,0.00%,2,0,100.00%
tencent-i.work.weixin.qq.com,2,0.00%,2,0,100.00%
www.weather.com.cn,2,0.00%,2,0,100.00%
sfp.safe.baidu.com,2,0.00%,2,0,100.00%
show-3.mediav.com,2,0.00%,2,0,100.00%
smad.ms.zhangyue.net,2,0.00%,2,0,100.00%
wan.sogou.com,2,0.00%,2,0,100.00%
mapsp0.bdimg.com,2,0.00%,2,0,100.00%
fc4tn.baidu.com,2,0.00%,2,0,100.00%
fc5tn.baidu.com,2,0.00%,2,0,100.00%
www.atguigu.com,2,0.00%,2,0,100.00%
tb.53kf.com,2,0.00%,2,0,100.00%
www.gulixueyuan.com,2,0.00%,2,0,100.00%
www.itdachang.com,2,0.00%,2,0,100.00%
www.mobiletrain.org,2,0.00%,2,0,100.00%
s.union.360.cn,2,0.00%,2,0,100.00%
360fenxi.mediav.com,2,0.00%,2,0,100.00%
www13.53kf.com,2,0.00%,2,0,100.00%
accwww13.53kf.com,2,0.00%,2,0,100.00%
cpro.baidu.com,2,0.00%,2,0,100.00%
filesys.53kf.com,2,0.00%,2,0,100.00%
32-courier.push.apple.com,2,0.00%,2,0,100.00%
sdkserver-drcn.op.dbankcloud.cn,2,0.00%,2,0,100.00%
common-us.onedrive.akadns.net,2,0.00%,2,0,100.00%
v1-play.log.mgtv.com,2,0.00%,2,0,100.00%
in1-gw2-01-ce7dd027.eastus2.cloudapp.azure.com,2,0.00%,4,2,50.00%
oss.zhixi.com,2,0.00%,2,0,100.00%
push-rest.zui.com,2,0.00%,2,0,100.00%
odc.officeapps.partner.office365.cn,2,0.00%,2,0,100.00%
pptpluginppt.keniu.com,2,0.00%,2,0,100.00%
img-blog.csdn.net,2,0.00%,2,0,100.00%
u966.v.bsclink.cn,2,0.00%,2,0,100.00%
wap.n.shifen.com,2,0.00%,2,0,100.00%
img.y.qq.com,2,0.00%,2,0,100.00%
m.ctrip.com,2,0.00%,2,0,100.00%
img.da.mgtv.com,2,0.00%,2,0,100.00%
hunantv.m.cn.miaozhen.com,2,0.00%,2,0,100.00%
ipm.atm.youku.com,2,0.00%,2,0,100.00%
cc.map.qq.com,2,0.00%,2,0,100.00%
agps.location.live.net,2,0.00%,2,0,100.00%
mobile.yangkeduo.com,2,0.00%,2,0,100.00%
funimg.pddpic.com,2,0.00%,2,0,100.00%
promotion.pddpic.com,2,0.00%,2,0,100.00%
pmmtk-a.pinduoduo.com,2,0.00%,2,0,100.00%
tne.pinduoduo.com,2,0.00%,2,0,100.00%
titan-ws.pinduoduo.com,2,0.00%,2,0,100.00%
img-1.pddpic.com,2,0.00%,2,0,100.00%
cmtw.pinduoduo.com,2,0.00%,2,0,100.00%
avatar2.pddpic.com,2,0.00%,2,0,100.00%
sec.sginput.qq.com,2,0.00%,2,0,100.00%
sign.utcsoft.com,2,0.00%,2,0,100.00%
jgwdb2.gaox.ml,2,0.00%,2,0,100.00%
tcbox.baidu.com,2,0.00%,2,0,100.00%
tb-video.bdstatic.com,2,0.00%,2,0,100.00%
stcglobal.beisen.com,2,0.00%,2,0,100.00%
catchoice.ceping.com,2,0.00%,2,0,100.00%
bl.nbmswl.com,2,0.00%,2,0,100.00%
zhifoukeji.datasink.sensorsdata.cn,2,0.00%,2,0,100.00%
im.tieba.baidu.com,2,0.00%,2,0,100.00%
ww3.mediaclub.tv,2,0.00%,2,0,100.00%
proaudiotorrents.org,2,0.00%,2,0,100.00%
msg.video.qiyi.com,2,0.00%,2,0,100.00%
configserver.hicloud.com,2,0.00%,2,0,100.00%
i-5600.b-2372.helper.bench.utorrent.com,2,0.00%,4,2,50.00%
mail.triinnboc.com,2,0.00%,2,0,100.00%
p4.music.126.net.w.alikunlun.com,2,0.00%,4,2,50.00%
u.jia.mn,2,0.00%,2,0,100.00%
license.unity.cn,2,0.00%,2,0,100.00%
saascdn.lenovo.com.cn,2,0.00%,2,0,100.00%
appdl.lenovo.com.cn,2,0.00%,2,0,100.00%
down1.abckantu.com,2,0.00%,2,0,100.00%
alltorrents.net,2,0.00%,2,0,100.00%
big-boss-tracker.net,2,0.00%,2,0,100.00%
tracker.gcvchp.com,2,0.00%,2,0,100.00%
tracker.frozen-layer.net,2,0.00%,2,0,100.00%
tracker.etree.org,2,0.00%,2,0,100.00%
www.theoccult.bz,2,0.00%,2,0,100.00%
tracker.trancetraffic.com,2,0.00%,2,0,100.00%
10-courier.push.apple.com,2,0.00%,2,0,100.00%
pop3.163.idns.yeah.net,2,0.00%,2,0,100.00%
onedscolprdneu06.northeurope.cloudapp.azure.com,2,0.00%,2,0,100.00%
13.courier-push-apple.com.akadns.net,2,0.00%,2,0,100.00%
wu-fg-shim.trafficmanager.net,2,0.00%,2,0,100.00%
sub2.bgp.netarch-alisc1-edge-lb.l.bytedns.net,2,0.00%,2,0,100.00%
48-courier.push.apple.com,2,0.00%,2,0,100.00%
48.courier-push-apple.com.akadns.net,2,0.00%,2,0,100.00%
88.newspush.eastmoney.com,2,0.00%,2,0,100.00%
cu010.www.duba.net,2,0.00%,2,0,100.00%
26.newspush.eastmoney.com,2,0.00%,2,0,100.00%
1.push2his.eastmoney.com,2,0.00%,2,0,100.00%
internal-api-space.feishu.cn.w.cdngslb.com,2,0.00%,2,0,100.00%
phsle5-young.oray.net,2,0.00%,2,0,100.00%
quota.fe.apple-dns.cn,2,0.00%,2,0,100.00%
asia.configsvc1.live.com.akadns.NET,2,0.00%,2,0,100.00%
api.wandb.ai,2,0.00%,2,0,100.00%
krsk01.graniterapids.com,2,0.00%,2,0,100.00%
wWW.vOD.LxdNS.coM,2,0.00%,4,2,50.00%
MAmbAP2pVOdH5.8686c.coM,2,0.00%,2,0,100.00%
traNsit1.WsLog.cHInAnEtcEnter.coM,2,0.00%,2,0,100.00%
CLiEnTlOGVODP2p.HapLaT.net,2,0.00%,2,0,100.00%
v3-default.ixigua.com,2,0.00%,2,0,100.00%
api.addins.omex.office.net,2,0.00%,2,0,100.00%
firstpartyapps.oaspapps.com,2,0.00%,2,0,100.00%
msftprod.firstpartyapps.oaspapps.com.akadns.net,2,0.00%,2,0,100.00%
pic2.pedaily.cn,2,0.00%,2,0,100.00%
office15client.microsoft.com,2,0.00%,2,0,100.00%
htp.miwifi.com,2,0.00%,2,0,100.00%
spatialsearch.is.autonavi.com,2,0.00%,2,0,100.00%
dida365.com,2,0.00%,2,0,100.00%
r1---sn-2x3elnel.gvt1.com,2,0.00%,2,0,100.00%
48.push2.eastmoney.com,2,0.00%,3,1,66.67%
s.symcd.com,2,0.00%,4,2,50.00%
logotool.hexun.com,2,0.00%,2,0,100.00%
mssdk.snssdk.com,2,0.00%,2,0,100.00%
a1.espncdn.com,2,0.00%,2,0,100.00%
master.wap.dphub.sandai.net,2,0.00%,2,0,100.00%
pbg0.market.xiaomi.com,2,0.00%,2,0,100.00%
pr.m.hub.sandai.net,2,0.00%,2,0,100.00%
rp.m.hub.sandai.net,2,0.00%,2,0,100.00%
ip1865110019.funshion.com,2,0.00%,2,0,100.00%
cds-cdn.v.aaplimg.com,2,0.00%,2,0,100.00%
ws.mcafee.com,2,0.00%,2,0,100.00%
iethie6i.nodedata.net,2,0.00%,2,0,100.00%
51.push2his.eastmoney.com,2,0.00%,2,0,100.00%
telemetry.sonarsource.com,2,0.00%,2,0,100.00%
h-adashx-internal.ut.taobao.com,2,0.00%,2,0,100.00%
14.courier-push-apple.com.akadns.net,2,0.00%,2,0,100.00%
ip.lx.netease.com,2,0.00%,2,0,100.00%
init.ess.apple.com,2,0.00%,2,0,100.00%
a239.gi3.akamai.net,2,0.00%,2,0,100.00%
edge.activity.windows.com.akadns.net,2,0.00%,2,0,100.00%
reswx.mid.tdnsv6.com,2,0.00%,4,2,50.00%
res.wx.qq.com.sched.legopic1-dk.tdnsv6.com,2,0.00%,4,2,50.00%
analytics.51ifonts.com,2,0.00%,2,0,100.00%
scicollection.las.ac.cn,2,0.00%,2,0,100.00%
api.juhedx.com,2,0.00%,2,0,100.00%
emdl.ws.microsoft.com,2,0.00%,2,0,100.00%
datacenter.eastmoney.com,2,0.00%,4,2,50.00%
www.c-s-a.org.cn,2,0.00%,2,0,100.00%
yanran.li,2,0.00%,2,0,100.00%
ajax.googleapis.com,2,0.00%,2,0,100.00%
arxiv.org,2,0.00%,2,0,100.00%
dl.ee.cuhk.edu.hk,2,0.00%,2,0,100.00%
www.linkedin.com,2,0.00%,2,0,100.00%
s3m6.nzwgs.com,2,0.00%,2,0,100.00%
in.hotjar.com,2,0.00%,2,0,100.00%
socket.tidio.co,2,0.00%,2,0,100.00%
twemoji.maxcdn.com,2,0.00%,2,0,100.00%
policy.video.iqiyi.com,2,0.00%,3,1,66.67%
api.dropboxapi.com,2,0.00%,4,2,50.00%
pss.alicdn.com.gds.alibabadns.com,2,0.00%,2,0,100.00%
bytedance.feishu.cn.bytedns1.com,2,0.00%,2,0,100.00%
mon.zijieapi.com.bytedns1.com,2,0.00%,2,0,100.00%
bytedance.feishu.cn.w.cdngslb.com,2,0.00%,2,0,100.00%
hz-tw.transit.freework.cyou,2,0.00%,2,0,100.00%
hd-tw.transit.freework.cyou,2,0.00%,2,0,100.00%
hk-5.transit.freework.cyou,2,0.00%,2,0,100.00%
hn-tw.transit.freework.cyou,2,0.00%,2,0,100.00%
hd-hk.transit.freework.cyou,2,0.00%,2,0,100.00%
hn-hk.transit.freework.cyou,2,0.00%,2,0,100.00%
hz-hk.transit.freework.cyou,2,0.00%,2,0,100.00%
hz-kr.transit.freework.cyou,2,0.00%,2,0,100.00%
hn-kr.transit.freework.cyou,2,0.00%,2,0,100.00%
hn-jp.transit.freework.cyou,2,0.00%,2,0,100.00%
hd-kr.transit.freework.cyou,2,0.00%,2,0,100.00%
hn-sgp.transit.freework.cyou,2,0.00%,2,0,100.00%
hz-sgp.transit.freework.cyou,2,0.00%,2,0,100.00%
hn-us.transit.freework.cyou,2,0.00%,2,0,100.00%
hd-sgp.transit.freework.cyou,2,0.00%,2,0,100.00%
hz-us.transit.freework.cyou,2,0.00%,2,0,100.00%
hd-us.transit.freework.cyou,2,0.00%,2,0,100.00%
hn-au.transit.freework.cyou,2,0.00%,2,0,100.00%
hz-au.transit.freework.cyou,2,0.00%,2,0,100.00%
hd-au.transit.freework.cyou,2,0.00%,2,0,100.00%
hn-ca.transit.freework.cyou,2,0.00%,2,0,100.00%
hz-ca.transit.freework.cyou,2,0.00%,2,0,100.00%
hd-ca.transit.freework.cyou,2,0.00%,2,0,100.00%
hn-gb.transit.freework.cyou,2,0.00%,2,0,100.00%
hz-gb.transit.freework.cyou,2,0.00%,2,0,100.00%
hd-gb.transit.freework.cyou,2,0.00%,2,0,100.00%
hn-fr.transit.freework.cyou,2,0.00%,2,0,100.00%
hz-fr.transit.freework.cyou,2,0.00%,2,0,100.00%
hd-fr.transit.freework.cyou,2,0.00%,2,0,100.00%
hn-de.transit.freework.cyou,2,0.00%,2,0,100.00%
hz-de.transit.freework.cyou,2,0.00%,2,0,100.00%
hd-de.transit.freework.cyou,2,0.00%,2,0,100.00%
hn-in.transit.freework.cyou,2,0.00%,2,0,100.00%
hz-in.transit.freework.cyou,2,0.00%,2,0,100.00%
hd-in.transit.freework.cyou,2,0.00%,2,0,100.00%
kr-1-1.transit.freework.cyou,2,0.00%,2,0,100.00%
kr-2-1.transit.freework.cyou,2,0.00%,2,0,100.00%
kr-3-1.transit.freework.cyou,2,0.00%,2,0,100.00%
kr-4-1.transit.freework.cyou,2,0.00%,2,0,100.00%
kr-5-1.transit.freework.cyou,2,0.00%,2,0,100.00%
kr-6-1.transit.freework.cyou,2,0.00%,2,0,100.00%
jp-1-1.transit.freework.cyou,2,0.00%,2,0,100.00%
jp-2-1.transit.freework.cyou,2,0.00%,2,0,100.00%
jp-3-1.transit.freework.cyou,2,0.00%,2,0,100.00%
jp-4-1.transit.freework.cyou,2,0.00%,2,0,100.00%
jp-5-1.transit.freework.cyou,2,0.00%,2,0,100.00%
jp-6-1.transit.freework.cyou,2,0.00%,2,0,100.00%
sgp-1-1.transit.freework.cyou,2,0.00%,2,0,100.00%
sgp-2-1.transit.freework.cyou,2,0.00%,2,0,100.00%
sgp-3-1.transit.freework.cyou,2,0.00%,2,0,100.00%
sgp-4-1.transit.freework.cyou,2,0.00%,2,0,100.00%
us-1-1.transit.freework.cyou,2,0.00%,2,0,100.00%
us-2-1.transit.freework.cyou,2,0.00%,2,0,100.00%
us-3-1.transit.freework.cyou,2,0.00%,2,0,100.00%
us-4-1.transit.freework.cyou,2,0.00%,2,0,100.00%
us-5-1.transit.freework.cyou,2,0.00%,2,0,100.00%
us-6-1.transit.freework.cyou,2,0.00%,2,0,100.00%
au-1-1.transit.freework.cyou,2,0.00%,2,0,100.00%
au-2-1.transit.freework.cyou,2,0.00%,2,0,100.00%
ca-1-1.transit.freework.cyou,2,0.00%,2,0,100.00%
ca-2-1.transit.freework.cyou,2,0.00%,2,0,100.00%
gb-1-1.transit.freework.cyou,2,0.00%,2,0,100.00%
gb-2-1.transit.freework.cyou,2,0.00%,2,0,100.00%
fr-1-1.transit.freework.cyou,2,0.00%,2,0,100.00%
fr-2-1.transit.freework.cyou,2,0.00%,2,0,100.00%
de-1-1.transit.freework.cyou,2,0.00%,2,0,100.00%
de-2-1.transit.freework.cyou,2,0.00%,2,0,100.00%
in-1-1.transit.freework.cyou,2,0.00%,2,0,100.00%
in-2-1.transit.freework.cyou,2,0.00%,2,0,100.00%
tw-1.transit.freework.cyou,2,0.00%,2,0,100.00%
tw-2.transit.freework.cyou,2,0.00%,2,0,100.00%
tw-3.transit.freework.cyou,2,0.00%,2,0,100.00%
tw-4.transit.freework.cyou,2,0.00%,2,0,100.00%
tw-5.transit.freework.cyou,2,0.00%,2,0,100.00%
hk-1.transit.freework.cyou,2,0.00%,2,0,100.00%
hk-2.transit.freework.cyou,2,0.00%,2,0,100.00%
hk-3.transit.freework.cyou,2,0.00%,2,0,100.00%
hk-4.transit.freework.cyou,2,0.00%,2,0,100.00%
api.iplay.163.com,2,0.00%,2,0,100.00%
image6.pubmatic.com,2,0.00%,2,0,100.00%
interface3.music.163.com,2,0.00%,2,0,100.00%
open.onebox.so.com,2,0.00%,2,0,100.00%
p.ssl.qhimg.com,2,0.00%,2,0,100.00%
onedscolprdgwc01.germanywestcentral.cloudapp.azure.com,2,0.00%,2,0,100.00%
p5.qhimg.com,2,0.00%,2,0,100.00%
wpsfile.ks3-cn-beijing.ksyun.com,2,0.00%,2,0,100.00%
tls13.taboola.map.fastly.net,2,0.00%,2,0,100.00%
paimgcdn.baidu.com,2,0.00%,5,3,40.00%
c.clarity.ms,2,0.00%,2,0,100.00%
onedscolprdwus00.westus.cloudapp.azure.com,2,0.00%,2,0,100.00%
www.hm.com.cn,2,0.00%,2,0,100.00%
static.hm.com.cn,2,0.00%,2,0,100.00%
yx.applesay.cn,2,0.00%,2,0,100.00%
inz5jaqbqg.feishu.cn,2,0.00%,2,0,100.00%
TRAnSIt1.wSlOG.ChiNAnetCeNtEr.CoM,2,0.00%,2,0,100.00%
clIENTlOGvodp2P.hApLaT.Net,2,0.00%,2,0,100.00%
mamBaP2pvodh5.8686C.COm,2,0.00%,2,0,100.00%
s1.biz.xunlei.com,2,0.00%,2,0,100.00%
cds-temp.apple.com.akadns.net,2,0.00%,2,0,100.00%
onedriveclucprodbn20022.blob.core.windows.net,2,0.00%,2,0,100.00%
pwapp.qunar.com,2,0.00%,2,0,100.00%
mail.nfs-china.com,2,0.00%,2,0,100.00%
sigma-performance-g37.proxima.nie.netease.com,2,0.00%,2,0,100.00%
dl.dropbox.com,2,0.00%,4,2,50.00%
cnlp.lp.cs.quickconnect.cn,2,0.00%,2,0,100.00%
ets99n9a.sched.sma.tdnsstic1.cn,2,0.00%,2,0,100.00%
ejewq6b2.sched.sma.tdnsstic1.cn,2,0.00%,2,0,100.00%
antispam.wanmei.com,2,0.00%,2,0,100.00%
www.adobe.com,2,0.00%,2,0,100.00%
a1815.co.w.tl88.net,2,0.00%,2,0,100.00%
images.newsmth.net,2,0.00%,2,0,100.00%
e11410.a.akamaiedge.net,2,0.00%,2,0,100.00%
snowplow-elb-prod1-clarivate-470512675.us-west-2.elb.amazonaws.com,2,0.00%,2,0,100.00%
cdn-ali-file-shfront.shanhutech.cn,2,0.00%,2,0,100.00%
wpad.shanhutech.cn,2,0.00%,2,0,100.00%
www.2.newsmth.net,2,0.00%,2,0,100.00%
apps.apple.com,2,0.00%,2,0,100.00%
ad.newsmth.net,2,0.00%,2,0,100.00%
passport.lenovo.com,2,0.00%,2,0,100.00%
submit.iacr.org,2,0.00%,2,0,100.00%
wm.xiajunhuagong.cn,2,0.00%,2,0,100.00%
dy.xiajunhuagong.cn,2,0.00%,2,0,100.00%
biteables.usabilityhub.com,2,0.00%,2,0,100.00%
macime.sogou.com,2,0.00%,2,0,100.00%
43.courier-push-apple.com.akadns.net,2,0.00%,2,0,100.00%
d21wlyhffxxqkt.cloudfront.net,2,0.00%,2,0,100.00%
iesoh0fa.nodedata.net,2,0.00%,2,0,100.00%
win.uu.163.com,2,0.00%,2,0,100.00%
bn1301.storage.live.com,2,0.00%,4,2,50.00%
onedriveclucproddm20013.blob.core.windows.net,2,0.00%,2,0,100.00%
blob.dm2prdstr04a.store.core.windows.net,2,0.00%,2,0,100.00%
42-courier.push.apple.com,2,0.00%,2,0,100.00%
license.chinauos.com,2,0.00%,2,0,100.00%
mirrors.elrepo.org,2,0.00%,2,0,100.00%
baijiahao.n.shifen.com,2,0.00%,2,0,100.00%
user.360kuai.com,2,0.00%,2,0,100.00%
local.info.g9hc4.cn,2,0.00%,2,0,100.00%
cube.3600.com,2,0.00%,3,1,66.67%
s.hao.360.com,2,0.00%,2,0,100.00%
p.ssl.img.360kuai.com,2,0.00%,4,2,50.00%
p4.img.360kuai.com,2,0.00%,2,0,100.00%
gua8.qhimg.com,2,0.00%,2,0,100.00%
ai.feishu.cn,2,0.00%,2,0,100.00%
ai.feishu.cn.w.cdngslb.com,2,0.00%,2,0,100.00%
signal.pod4.avatar.ext.hp.com,2,0.00%,2,0,100.00%
secfsr.lenovomm.com,2,0.00%,2,0,100.00%
crl.globalsign.net,2,0.00%,2,0,100.00%
watson.microsoft.com,2,0.00%,4,2,50.00%
sls.sourceinsight.com,2,0.00%,2,0,100.00%
CliEntlOgVodP2p.HApLAT.nET,2,0.00%,2,0,100.00%
MAmBaP2pvOdH5.8686c.cOm,2,0.00%,2,0,100.00%
show.3.mediav.com,2,0.00%,2,0,100.00%
3.debian.pool.ntp.org,2,0.00%,2,0,100.00%
t.quic.ws,2,0.00%,2,0,100.00%
firefox-settings-attachments.cdn.mozilla.net,2,0.00%,2,0,100.00%
notices.mattermost.com,2,0.00%,2,0,100.00%
www.mcafee.com,2,0.00%,2,0,100.00%
40.push2his.eastmoney.com,2,0.00%,2,0,100.00%
stocks-data-service.lb-apple.com.akadns.net,2,0.00%,4,2,50.00%
46-courier.push.apple.com,2,0.00%,2,0,100.00%
consumerapps-prod-53.awscommon.mcafee.com,2,0.00%,2,0,100.00%
downloadnonchinacdnenabled.mcafee.com.edgekey.NET,2,0.00%,2,0,100.00%
tracker.hdsky.me,2,0.00%,4,2,50.00%
e191.b.akamaiedge.net,2,0.00%,2,0,100.00%
bj.linyeming.pub,2,0.00%,2,0,100.00%
sdk.ai.wpscdn.cn,2,0.00%,2,0,100.00%
r2---sn-2x3elnez.gvt1.com,2,0.00%,2,0,100.00%
retracker.akado-ural.ru,2,0.00%,2,0,100.00%
home.penza.com.ru,2,0.00%,2,0,100.00%
us05.graniterapids.com,2,0.00%,2,0,100.00%
ca01.graniterapids.com,2,0.00%,2,0,100.00%
fp-as.azureedge.net,2,0.00%,4,2,50.00%
emsfs.autodesk.com,2,0.00%,2,0,100.00%
gfs-op.douyucdn.cn,2,0.00%,4,2,50.00%
slapi-prm.oray.net,2,0.00%,2,0,100.00%
login.microsoft.com,2,0.00%,2,0,100.00%
public-family.api.account.microsoft.com,2,0.00%,2,0,100.00%
19-courier.push.apple.com,2,0.00%,2,0,100.00%
6-courier.push.apple.com,2,0.00%,2,0,100.00%
r4---sn-2x3elnel.gvt1.com,2,0.00%,2,0,100.00%
array804.prod.do.dsp.mp.microsoft.com,2,0.00%,2,0,100.00%
canonical-lgw01.cdn.snapcraftcontent.com,2,0.00%,2,0,100.00%
prod.configsvc1.live.com.akadns.NET,2,0.00%,2,0,100.00%
7-courier.push.apple.com,2,0.00%,2,0,100.00%
kanjiantu.com,2,0.00%,4,2,50.00%
bg1.market.xiaomi.com,2,0.00%,2,0,100.00%
eth-mainnet.alchemyapi.io,2,0.00%,2,0,100.00%
98.newspush.eastmoney.com,2,0.00%,2,0,100.00%
45.newspush.eastmoney.com,2,0.00%,2,0,100.00%
thina8ae.nodedata.net,2,0.00%,2,0,100.00%
discovery.razerapi.com,2,0.00%,2,0,100.00%
gms.razersynapse.com,2,0.00%,2,0,100.00%
simpledesktops.azurewebsites.net,2,0.00%,2,0,100.00%
www.tm.a.prd.aadg.trafficmanager.NET,2,0.00%,2,0,100.00%
torrentclub.tech,2,0.00%,4,2,50.00%
kr02.graniterapids.com,2,0.00%,2,0,100.00%
jp-amz.abuxiaoxi.xyz,2,0.00%,2,0,100.00%
tw02.graniterapids.com,2,0.00%,2,0,100.00%
sw.symcb.com,2,0.00%,4,2,50.00%
rc10-linux.oray.com,2,0.00%,2,0,100.00%
90.newspush.eastmoney.com,2,0.00%,2,0,100.00%
65.push2his.eastmoney.com,2,0.00%,2,0,100.00%
appstore.uniontech.com,2,0.00%,2,0,100.00%
webim.tim.qq.com,2,0.00%,2,0,100.00%
onedriveclucprodbn20038.blob.core.windows.net,2,0.00%,2,0,100.00%
dotab.douyucdn.cn,2,0.00%,2,0,100.00%
udpolimeok.baidu.com,2,0.00%,2,0,100.00%
mirrors4.bfsu.edu.cn,2,0.00%,2,0,100.00%
dsm01pap001.storage.live.com,2,0.00%,3,1,66.67%
ug.snssdk.com,2,0.00%,2,0,100.00%
appstoreort-stsdk.vivo.com.cn,2,0.00%,2,0,100.00%
filter.appstore.vivo.com.cn,2,0.00%,2,0,100.00%
ort-stsdk.vivo.com.cn,2,0.00%,2,0,100.00%
main.appstore.vivo.com.cn,2,0.00%,2,0,100.00%
msch.f.360.cn,2,0.00%,2,0,100.00%
vcode-or.vivo.com.cn,2,0.00%,2,0,100.00%
ovv4.alllook.tv,2,0.00%,2,0,100.00%
u2-204.ecukwai.com,2,0.00%,2,0,100.00%
uslys.edgehelper.com,2,0.00%,2,0,100.00%
u1-204.ecukwai.com,2,0.00%,4,2,50.00%
phi4thuo.nodedata.net,2,0.00%,2,0,100.00%
cf.iadsdk.apple.com,2,0.00%,2,0,100.00%
dfp.informance.biz,2,0.00%,2,0,100.00%
onedscolprdcus11.centralus.cloudapp.azure.com,2,0.00%,2,0,100.00%
web.push.126.net,2,0.00%,2,0,100.00%
ins-j1yx5oul.ias.tencent-cloud.net,2,0.00%,2,0,100.00%
43-courier.push.apple.com,2,0.00%,2,0,100.00%
i5.hexun.com,2,0.00%,2,0,100.00%
utrack.hexun.com,2,0.00%,2,0,100.00%
i9.hexun.com,2,0.00%,2,0,100.00%
auto.hexun.com,2,0.00%,2,0,100.00%
h05hxsame.hexun.com,2,0.00%,2,0,100.00%
i1.hexun.com,2,0.00%,2,0,100.00%
insurance.hexun.com,2,0.00%,2,0,100.00%
shzjwxsns.video.qq.com,2,0.00%,4,2,50.00%
epay.hexun.com,2,0.00%,2,0,100.00%
forex.hexun.com,2,0.00%,2,0,100.00%
funds.hexun.com,2,0.00%,2,0,100.00%
i.hexun.com,2,0.00%,2,0,100.00%
money.hexun.com,2,0.00%,2,0,100.00%
opinion.hexun.com,2,0.00%,2,0,100.00%
p2p.hexun.com,2,0.00%,2,0,100.00%
biying.com,2,0.00%,2,0,100.00%
gecko-pangle-lq.snssdk.com,2,0.00%,2,0,100.00%
offline.specialcdnstatus.com,2,0.00%,2,0,100.00%
ossapi.baidu.com,2,0.00%,2,0,100.00%
www.douban.com,2,0.00%,2,0,100.00%
fundin.douban.com,2,0.00%,2,0,100.00%
apis.google.com,2,0.00%,2,0,100.00%
onedriveclucprodbn20029.blob.core.windows.net,2,0.00%,2,0,100.00%
ali-ky.static.yximgs.com,2,0.00%,2,0,100.00%
ns3.cstnet.cn,2,0.00%,2,0,100.00%
15.courier-push-apple.com.akadns.net,2,0.00%,2,0,100.00%
download.oracle.com.edgekey.net,2,0.00%,2,0,100.00%
static3.whatthemovie.net,2,0.00%,2,0,100.00%
APAC05.azure-devices.net,2,0.00%,2,0,100.00%
apac05.azure-devices.net,2,0.00%,2,0,100.00%
policyorchestration.ccs.mcafee.com,2,0.00%,2,0,100.00%
context-enroll.ccs.mcafee.com,2,0.00%,2,0,100.00%
hc2.tdm.qq.com,2,0.00%,2,0,100.00%
static.360.cn,2,0.00%,4,2,50.00%
62971.bodis.com,2,0.00%,2,0,100.00%
p38-buy.itunes.apple.com,2,0.00%,2,0,100.00%
agoo-report.m.taobao.com,2,0.00%,2,0,100.00%
na61-na62.wagbridge.alibaba.taobao.com.gds.alibabadns.com,2,0.00%,2,0,100.00%
985liteu.sched.skalego-dk.tdnsstic1.cn.cjt.vwnti.yrzhcloud.cn,2,0.00%,4,2,50.00%
count.cnblogs.com,2,0.00%,2,0,100.00%
imap.netfu.rice.edu,2,0.00%,2,0,100.00%
gv1.xdrig.com,2,0.00%,2,0,100.00%
impression.biligame.com,2,0.00%,2,0,100.00%
8667973.sched.sma.tdnsstic1.cn,2,0.00%,2,0,100.00%
e28.g.akamaiedge.net,2,0.00%,2,0,100.00%
mimg.127.net,2,0.00%,2,0,100.00%
utility.mail.163.com,2,0.00%,2,0,100.00%
onegoods.nosdn.127.net,2,0.00%,2,0,100.00%
mail-activity.nosdn.127.net,2,0.00%,2,0,100.00%
config.mail.163.com,2,0.00%,2,0,100.00%
weather.mail.163.com,2,0.00%,2,0,100.00%
s2.music.126.net,2,0.00%,2,0,100.00%
st.music.163.com,2,0.00%,2,0,100.00%
internal-api.feishu.cn.w.cdngslb.com,2,0.00%,2,0,100.00%
s.u7u9.com,2,0.00%,2,0,100.00%
zxgghn.25ku.com,2,0.00%,2,0,100.00%
cas.ys7.com,2,0.00%,2,0,100.00%
p1.ssl.img.360kuai.com,2,0.00%,2,0,100.00%
p6.img.360kuai.com,2,0.00%,2,0,100.00%
urs.microsoft.com,2,0.00%,2,0,100.00%
storecatalogrevocation.storequality.microsoft.com.edgekey.net,2,0.00%,2,0,100.00%
r6.mo.baidu.com,2,0.00%,2,0,100.00%
tmge.alicdn.com,2,0.00%,2,0,100.00%
tmge.alicdn.com.danuoyi.tbcache.com,2,0.00%,2,0,100.00%
iyes.youku.com,2,0.00%,2,0,100.00%
nbsdk-baichuan.alicdn.com,2,0.00%,2,0,100.00%
nbsdk-baichuan.alicdn.com.danuoyi.alicdn.com,2,0.00%,2,0,100.00%
p50-escrowproxy.icloud.com.cn,2,0.00%,2,0,100.00%
pns.alicdn.com,2,0.00%,2,0,100.00%
apiv4-iyes.youku.com,2,0.00%,2,0,100.00%
audid-api.taobao.com,2,0.00%,2,0,100.00%
e4578.dscb.akamaiedge.net,2,0.00%,4,2,50.00%
hiboardng-hicloud-com-drcn.appacc.dbankedge.net,2,0.00%,2,0,100.00%
deepviz-nlb-prod-ap-southeast-1-f64fb66f5d07c49a.elb.ap-southeast-1.amazonaws.com,2,0.00%,2,0,100.00%
file.market.xiaomi.com,2,0.00%,2,0,100.00%
k58.gslb.ksyuncdn.com,2,0.00%,2,0,100.00%
amd-infra.itunes.apple.com,2,0.00%,2,0,100.00%
amd-infra.apps-apple.com.akadns.net,2,0.00%,2,0,100.00%
update3.sangfor.net.cdn20.com,2,0.00%,2,0,100.00%
client-teamviewer-com.trafficmanager.net,2,0.00%,2,0,100.00%
cde-prod-eastasia.azurewebsites.net,2,0.00%,2,0,100.00%
waws-prod-hk1-037.sip.azurewebsites.windows.net,2,0.00%,2,0,100.00%
mmbiz.qpic.tc.qq.com,2,0.00%,2,0,100.00%
dispatcher.is.autonavi.com,2,0.00%,2,0,100.00%
p218-contacts.icloud.com.cn,2,0.00%,2,0,100.00%
hbrt.adobe.com,2,0.00%,2,0,100.00%
d3uniwo7xqjvhe.cloudfront.net,2,0.00%,2,0,100.00%
api.edgeoffer.microsoft.com,2,0.00%,2,0,100.00%
taxcache.51fapiao.cn,2,0.00%,2,0,100.00%
chineseime.chinauos.com,2,0.00%,2,0,100.00%
pro-store-packages.uniontech.com,2,0.00%,2,0,100.00%
cdn-professional-security.chinauos.com,2,0.00%,2,0,100.00%
cdn-update-platform-packages.uniontech.com,2,0.00%,2,0,100.00%
home-store-img.uniontech.com,2,0.00%,2,0,100.00%
cdn-professional-packages.chinauos.com,2,0.00%,2,0,100.00%
linux.profile.pinyin.sogou.com,2,0.00%,2,0,100.00%
fems.wps.cn,2,0.00%,2,0,100.00%
pcdn-proxy-tracker.xxpkg.com,2,0.00%,2,0,100.00%
e2682.g.akamaiedge.net,2,0.00%,2,0,100.00%
ajax.aspnetcdn.com,2,0.00%,2,0,100.00%
ocsp.thawte.com,2,0.00%,4,2,50.00%
crl.thawte.com,2,0.00%,4,2,50.00%
ts-crl.ws.symantec.com,2,0.00%,4,2,50.00%
12-courier.push.apple.com,2,0.00%,2,0,100.00%
onedriveclucproddm20003.blob.core.windows.net,2,0.00%,2,0,100.00%
APAC02.azure-devices.net,2,0.00%,2,0,100.00%
ali-origin.pull.yximgs.com,2,0.00%,2,0,100.00%
dldir2.qq.com,2,0.00%,2,0,100.00%
logincdn.msauth.net,2,0.00%,2,0,100.00%
lgincdnvzeuno.azureedge.net,2,0.00%,2,0,100.00%
hubciddata.sandai.net,2,0.00%,2,0,100.00%
fla.83.mclqp.link,2,0.00%,2,0,100.00%
mon.snssdk.com,2,0.00%,2,0,100.00%
kr09.graniterapids.com,2,0.00%,2,0,100.00%
v26-web.douyinvod.com,2,0.00%,2,0,100.00%
cdke.youdao.com,2,0.00%,2,0,100.00%
impservice.dictapp.youdao.com,2,0.00%,2,0,100.00%
sb.l.google.com,2,0.00%,2,0,100.00%
slp2p-east-std1068.oray.net,2,0.00%,2,0,100.00%
b.cqttech.com,2,0.00%,2,0,100.00%
8e8lbgse.sched.d2.tdnsdp1.cn,2,0.00%,2,0,100.00%
AMER02.azure-devices.net,2,0.00%,2,0,100.00%
s2.hdslb.com,2,0.00%,2,0,100.00%
ecs-workbench.aliyun.com,2,0.00%,2,0,100.00%
steambroadcast.akamaized.net,2,0.00%,2,0,100.00%
duer-news.cdn.bcebos.com,2,0.00%,2,0,100.00%
infinitedata-pa.googleapis.com,2,0.00%,4,2,50.00%
admin.iscas.ac.cn,2,0.00%,2,0,100.00%
p63-caldav.icloud.com.cn,2,0.00%,2,0,100.00%
s.search.bilibili.com,2,0.00%,2,0,100.00%
cu1pehnswad01.servicebus.windows.net,2,0.00%,2,0,100.00%
update.browser.qq.com,2,0.00%,2,0,100.00%
cdn.ap.bittorrent.com,2,0.00%,3,1,66.67%
1year.pcfg.cache.wpscdn.cn,2,0.00%,2,0,100.00%
us04.graniterapids.com,2,0.00%,2,0,100.00%
dldir1.legodlied1.sched.dcloudstc.com,2,0.00%,2,0,100.00%
7.courier-push-apple.com.akadns.net,2,0.00%,2,0,100.00%
sb-ssl.l.google.com,2,0.00%,2,0,100.00%
v5.douyinvod.com.zjgslb.com,2,0.00%,2,0,100.00%
v5-e.douyinvod.com,2,0.00%,2,0,100.00%
v5-e.douyinvod.com.yangyi19.com,2,0.00%,2,0,100.00%
streamingaudio.itunes.apple.com,2,0.00%,2,0,100.00%
mixv4-21.194610.xyz,2,0.00%,2,0,100.00%
api.frdic.com,2,0.00%,2,0,100.00%
gtm-cn-v0h17upzy07.frdic.com,2,0.00%,2,0,100.00%
www.cambridge.org,2,0.00%,2,0,100.00%
static.cambridge.org,2,0.00%,2,0,100.00%
bstatic.hdslb.com,2,0.00%,2,0,100.00%
s1.hdslb.com.w.kunlunar.com,2,0.00%,2,0,100.00%
kr10.graniterapids.com,2,0.00%,2,0,100.00%
bbs.nga.cn.wswebcdn.com,2,0.00%,2,0,100.00%
bbs.pku.edu.cn,2,0.00%,2,0,100.00%
lh3.googleusercontent.com,2,0.00%,2,0,100.00%
cdns.gigya.com,2,0.00%,2,0,100.00%
assets.cambridge.org,2,0.00%,2,0,100.00%
assets.bop.cupeng.org,2,0.00%,2,0,100.00%
login.www.cambridge.org,2,0.00%,2,0,100.00%
266509774928.gigya-api.com,2,0.00%,2,0,100.00%
c6e3ffd89ebddf1c990b23dede85d91e.dlied1.cdntips.net,2,0.00%,2,0,100.00%
t.quandangdang.net,2,0.00%,2,0,100.00%
www.meijutt.net,2,0.00%,2,0,100.00%
pengtu.cc,2,0.00%,4,2,50.00%
jspassport.ssl.qhimg.com,2,0.00%,4,2,50.00%
miaosha.jd.com,2,0.00%,2,0,100.00%
u.jd.com,2,0.00%,2,0,100.00%
ai.jd.com,2,0.00%,2,0,100.00%
www.guangsujx.com,2,0.00%,2,0,100.00%
statusapi.micloud.xiaomi.net,2,0.00%,2,0,100.00%
adashx.ut.shuqi.com,2,0.00%,2,0,100.00%
rv74e4cqic.feishu.cn,2,0.00%,2,0,100.00%
qdsdk.jd.com,2,0.00%,2,0,100.00%
keeplive.jd.com,2,0.00%,2,0,100.00%
h5static.jd.com,2,0.00%,2,0,100.00%
odo.jd.com,2,0.00%,2,0,100.00%
btshow.jd.com,2,0.00%,2,0,100.00%
bugou.jd.com,2,0.00%,2,0,100.00%
skunotify.jd.com,2,0.00%,2,0,100.00%
mygiftcard.jd.com,2,0.00%,2,0,100.00%
quan.jd.com,2,0.00%,2,0,100.00%
orderop.jd.com,2,0.00%,2,0,100.00%
awcas.jd.com,2,0.00%,2,0,100.00%
jelly-android-bi.cliapi.microfun.cn,2,0.00%,2,0,100.00%
newbuz.360buyimg.com,2,0.00%,2,0,100.00%
ad.3.cn,2,0.00%,2,0,100.00%
dx.3.cn,2,0.00%,2,0,100.00%
jcm.jd.com,2,0.00%,2,0,100.00%
cm.jd.com,2,0.00%,2,0,100.00%
jshop-rec.jd.com,2,0.00%,2,0,100.00%
p50-fmip.icloud.com.cn,2,0.00%,2,0,100.00%
p123-fmipmobile.icloud.com.cn,2,0.00%,2,0,100.00%
dart.l.doubleclick.net,2,0.00%,2,0,100.00%
s0-2mdn-net.l.google.com,2,0.00%,2,0,100.00%
smartdl.mbgcdn.lenovo.com.cn,2,0.00%,2,0,100.00%
dsp.mbgcdn.lenovo.com.cn,2,0.00%,2,0,100.00%
smartdl.lenovo.com.cn.trpcdn.net,2,0.00%,2,0,100.00%
zmptxy.v.trpcdn.net,2,0.00%,2,0,100.00%
nsl.mbgcdn.lenovo.com.cn,2,0.00%,2,0,100.00%
consumer.entitlement.skype.com,2,0.00%,2,0,100.00%
sconsentit9.trafficmanager.net,2,0.00%,2,0,100.00%
inappcheck.itunes.apple.com.download.ks-cdn.com,2,0.00%,4,2,50.00%
appcdcbj.jianguoyun.com,2,0.00%,2,0,100.00%
bgp.netarch-alisc1-edge-lb.l.bytedns.net,2,0.00%,2,0,100.00%
rtlog5-applog-lq.fqnovel.com,2,0.00%,2,0,100.00%
rtlog5-applog-lq.fqnovel.com.c.dsa.cdnbuild.net,2,0.00%,2,0,100.00%
in2-prod-east-us2-23fa330.trafficmanager.net,2,0.00%,2,0,100.00%
meta.pinduoduo.com,2,0.00%,2,0,100.00%
exp-new.bdstatic.com,2,0.00%,2,0,100.00%
fex.bdstatic.com,2,0.00%,2,0,100.00%
api.ticktick.com,2,0.00%,2,0,100.00%
cstaticdun.126.net.163jiasu.com,2,0.00%,2,0,100.00%
wuji.video.qq.com,2,0.00%,2,0,100.00%
trace.qq.com,2,0.00%,2,0,100.00%
ad.appier.net,2,0.00%,2,0,100.00%
ww1097.smartadserver.com,2,0.00%,2,0,100.00%
jp1-bid.adsrvr.org,2,0.00%,2,0,100.00%
eb2.3lift.com,2,0.00%,2,0,100.00%
tlx.3lift.com,2,0.00%,2,0,100.00%
ads.as.criteo.com,2,0.00%,4,2,50.00%
match.adsrvr.org,2,0.00%,2,0,100.00%
cat.sg1.as.criteo.com,2,0.00%,2,0,100.00%
35.courier-push-apple.com.akadns.net,2,0.00%,2,0,100.00%
baidu-cn-north-00001.bj-a.bcebos.com,2,0.00%,2,0,100.00%
fides-pol.apple.com,2,0.00%,2,0,100.00%
log-api.pangolin-sdk-toutiao-b.com,2,0.00%,3,1,66.67%
is.snssdk.com,2,0.00%,2,0,100.00%
ossimg.hitv.com,2,0.00%,2,0,100.00%
ad.360yield.com,2,0.00%,2,0,100.00%
nsp-hicloud-cloudphotoeast3-p02-drcn.obs.cn-east-3.myhuaweicloud.com,2,0.00%,2,0,100.00%
pgdt.ugdtimg.com,2,0.00%,2,0,100.00%
chi01pap002.storage.live.com,2,0.00%,2,0,100.00%
p5.d.meituan.net,2,0.00%,2,0,100.00%
www.comet.com,2,0.00%,2,0,100.00%
gateway.im.weibo.cn,2,0.00%,2,0,100.00%
g.cn.miaozhen.com,2,0.00%,2,0,100.00%
tp.9377s.com,2,0.00%,2,0,100.00%
static.9377ja.com,2,0.00%,2,0,100.00%
hisearch-static-drcn.dbankcdn.com,2,0.00%,2,0,100.00%
oauth-login-drcn.platform.dbankcloud.com,2,0.00%,2,0,100.00%
events.op.hicloud.com,2,0.00%,2,0,100.00%
acd.op.hicloud.com,2,0.00%,2,0,100.00%
appimg.dbankcdn.com,2,0.00%,2,0,100.00%
storeedgefd.dsx.mp.microsoft.com,2,0.00%,2,0,100.00%
a-ring.msedge.net,2,0.00%,2,0,100.00%
rum8.perf.linkedin.com,2,0.00%,2,0,100.00%
onedriveclucprodbn20024.blob.core.windows.net,2,0.00%,2,0,100.00%
stun.12voip.com,2,0.00%,2,0,100.00%
stun.3cx.com,2,0.00%,2,0,100.00%
api-sdk.mihoyo.com,2,0.00%,2,0,100.00%
sdk-static.mihoyo.com,2,0.00%,2,0,100.00%
api-static.mihoyo.com,2,0.00%,2,0,100.00%
webstatic.mihoyo.com,2,0.00%,2,0,100.00%
ys.mihoyo.com,2,0.00%,2,0,100.00%
autopatchcn.yuanshen.com,2,0.00%,2,0,100.00%
slapi-pro.oray.net,2,0.00%,2,0,100.00%
firebaseremoteconfig.mihoyo.com,2,0.00%,2,0,100.00%
continuum.dds.microsoft.com,2,0.00%,2,0,100.00%
socket-message.zhixi.com,2,0.00%,2,0,100.00%
push-gw.zhixi.com,2,0.00%,2,0,100.00%
stream.snssdk.com.w.cdngslb.com,2,0.00%,2,0,100.00%
stat.dongqiudi.com,2,0.00%,2,0,100.00%
cn-n1-app-router.leancloud.cn,2,0.00%,2,0,100.00%
p3-be-pack-sign.pglstatp-toutiao.com,2,0.00%,2,0,100.00%
s.apkevery.com,2,0.00%,2,0,100.00%
openmobile.qq.com,2,0.00%,2,0,100.00%
ocsp2.globalsign.com,2,0.00%,2,0,100.00%
pcstatbak.kugou.com,2,0.00%,2,0,100.00%
m704.music.126.net,2,0.00%,2,0,100.00%
s15.upd.kaspersky.com,2,0.00%,2,0,100.00%
hub5pr.sandai.net,2,0.00%,2,0,100.00%
update.ruanjian.2345.com,2,0.00%,2,0,100.00%
apt-geofence-parent.trafficmanager.net,2,0.00%,2,0,100.00%
dpi.networkorder.komect.com,2,0.00%,2,0,100.00%
i-29.b-46206.ut.bench.utorrent.com,2,0.00%,4,2,50.00%
ll.download3.utorrent.com,2,0.00%,4,2,50.00%
i-139.b-46206.ut.bench.utorrent.com,2,0.00%,4,2,50.00%
i-32.b-46206.ut.bench.utorrent.com,2,0.00%,4,2,50.00%
dsm04pap002.storage.live.com,2,0.00%,2,0,100.00%
onedriveclucprodbn20001.blob.core.windows.net,2,0.00%,2,0,100.00%
dasmey87ui65e.cloudfront.net,2,0.00%,2,0,100.00%
wap.sogou.com,2,0.00%,2,0,100.00%
gz3.520vpn.us,2,0.00%,2,0,100.00%
64.push2his.eastmoney.com,2,0.00%,2,0,100.00%
52.push2his.eastmoney.com,2,0.00%,2,0,100.00%
followservice.kugou.com,2,0.00%,2,0,100.00%
onedriveclucprodbn20040.blob.core.windows.net,2,0.00%,2,0,100.00%
zjueducn-my.sharepoint.com,2,0.00%,2,0,100.00%
skyapi.live.net,2,0.00%,2,0,100.00%
dsm01pcor004-com.be.1drv.com,2,0.00%,2,0,100.00%
sukebei.tracker.wf,2,0.00%,2,0,100.00%
4-courier.push.apple.com,2,0.00%,2,0,100.00%
officeci-mauservice.azurewebsites.net,2,0.00%,2,0,100.00%
waws-prod-bay-045a.sip.azurewebsites.windows.net,2,0.00%,2,0,100.00%
oauth.intservices.aws.intellij.net,2,0.00%,2,0,100.00%
18-courier.push.apple.com,2,0.00%,2,0,100.00%
18.courier-push-apple.com.akadns.net,2,0.00%,2,0,100.00%
www.scootersoftware.com,2,0.00%,2,0,100.00%
ddf.udpgetip.com,2,0.00%,2,0,100.00%
ddf.1proh.com,2,0.00%,2,0,100.00%
s3.us-east-1.amazonaws.com,2,0.00%,2,0,100.00%
jkotr.winsoft.aili.com,2,0.00%,2,0,100.00%
verification.console.aliyun.com,2,0.00%,2,0,100.00%
media8.smartstudy.com,2,0.00%,2,0,100.00%
wd-prod-ss-edge.trafficmanager.net,2,0.00%,2,0,100.00%
renew.console.aliyun.com,2,0.00%,2,0,100.00%
alioth.alicdn.com,2,0.00%,2,0,100.00%
pics5.baidu.com,2,0.00%,2,0,100.00%
pics6.baidu.com,2,0.00%,2,0,100.00%
pics4.baidu.com,2,0.00%,2,0,100.00%
author.baidu.com,2,0.00%,2,0,100.00%
jianyi.baidu.com,2,0.00%,2,0,100.00%
i.baidu.com,2,0.00%,2,0,100.00%
top.baidu.com,2,0.00%,2,0,100.00%
ecs-buy.aliyun.com,2,0.00%,2,0,100.00%
static.arxiv.org,2,0.00%,2,0,100.00%
security.ie.sogou.com,2,0.00%,2,0,100.00%
zhibo.sina.com.cn,2,0.00%,2,0,100.00%
file-corpus.zhan.com,2,0.00%,2,0,100.00%
blocklist.operachina.com,2,0.00%,2,0,100.00%
TRANSit1.wSloG.chInANETceNTER.cOm,2,0.00%,2,0,100.00%
cLIentLOgvOdP2P.haplat.nET,2,0.00%,2,0,100.00%
MaMBaP2PVodH5.8686C.COm,2,0.00%,2,0,100.00%
direwolf-903618df6d.herokuapp.com,2,0.00%,2,0,100.00%
boot-01.net.anydesk.com,2,0.00%,2,0,100.00%
mozilla.org,1,0.00%,1,0,100.00%
livegetwesteurope.cloudapp.net,1,0.00%,1,0,100.00%
sa2-prod-msgsearch-1.cloudapp.net,1,0.00%,1,0,100.00%
openmsf.msf.tencent-cloud.com,1,0.00%,1,0,100.00%
sconsentit911.cloudapp.net,1,0.00%,1,0,100.00%
k-9999.k-msedge.net,1,0.00%,1,0,100.00%
people-service-prod-asse-arm-a.southeastasia.cloudapp.azure.com,1,0.00%,1,0,100.00%
ip.azeus1-client-s.msnmessenger.msn.com.akadns.net,1,0.00%,1,0,100.00%
fpc.msedge.net,1,0.00%,2,1,50.00%
4.perf.msedge.net,1,0.00%,2,1,50.00%
b-aps-asea-01-skype.cloudapp.net,1,0.00%,1,0,100.00%
pull-flv-f1-proxy.douyincdn.com.wsdvs.com,1,0.00%,2,1,50.00%
cn-sdyt-cu-01-26.bilivideo.com,1,0.00%,1,0,100.00%
browser.pipe.aria.microsoft.com,1,0.00%,2,1,50.00%
browser.events.data.trafficmanager.net,1,0.00%,2,1,50.00%
onedscolprdfrc04.francecentral.cloudapp.azure.com,1,0.00%,1,0,100.00%
pixel.rubiconproject.net.akadns.net,1,0.00%,1,0,100.00%
dsum-sec.casalemedia.com.cdn.cloudflare.net,1,0.00%,1,0,100.00%
teams-events-data.trafficmanager.net,1,0.00%,2,1,50.00%
e11294.g.akamaiedge.net,1,0.00%,1,0,100.00%
toutiao.rtmplive.ks-cdn.com,1,0.00%,2,1,50.00%
s107.gslb.ksyuncdn.com,1,0.00%,2,1,50.00%
pull-hls-f26.douyincdn.com.c.cdnhwc1.com,1,0.00%,2,1,50.00%
zjcdnl.pullcmcc.gslb.d.live.cdn.chinamobile.com,1,0.00%,1,0,100.00%
hcdnl.pulldyin.hls.gslb.c.cdnhwc2.com,1,0.00%,2,1,50.00%
pull-flv-l6-encryption.douyincdn.com.hdlvcloud.ks-cdn.com,1,0.00%,2,1,50.00%
pull-flv-vr-l1.douyincdn.com.wsdvs.com,1,0.00%,2,1,50.00%
push-rtmp-vr-f5.s.bytefcdn.com,1,0.00%,1,0,100.00%
jnn-pa.googleapis.com,1,0.00%,2,1,50.00%
frenchofengland.ace.fordham.edu,1,0.00%,1,0,100.00%
edifice.opencityapps.org,1,0.00%,1,0,100.00%
www.blackcats-games.net,1,0.00%,1,0,100.00%
silk.lx.netease.com,1,0.00%,1,0,100.00%
mms-voice.cdn.bcebos.com,1,0.00%,1,0,100.00%
octopus.jovcloud.com,1,0.00%,1,0,100.00%
biociclo.agri.cl,1,0.00%,1,0,100.00%
cainiao-app-logs.cn-zhangjiakou.log.aliyuncs.com,1,0.00%,1,0,100.00%
p3.a.yximgs.com,1,0.00%,3,2,33.33%
www.kuaishou.com,1,0.00%,1,0,100.00%
onedscolprdgwc05.germanywestcentral.cloudapp.azure.com,1,0.00%,1,0,100.00%
ib.anycast.adnxs.com,1,0.00%,1,0,100.00%
hag-drcn.op.hicloud.com,1,0.00%,1,0,100.00%
ipv6.msftconnecttest.com,1,0.00%,127,126,0.79%
ac-mqgidvz-shard-00-01.nmmxpgl.mongodb.net,1,0.00%,1,0,100.00%
gocart-web-prod-ue1-477818442.us-east-1.elb.amazonaws.com,1,0.00%,1,0,100.00%
zn_0pxrmhobblncaad-hpsupport.siteintercept.qualtrics.com,1,0.00%,1,0,100.00%
udc-neb.kampyle.com,1,0.00%,1,0,100.00%
siteintercept.qualtrics.com,1,0.00%,1,0,100.00%
www.amap.com,1,0.00%,1,0,100.00%
a.amap.com,1,0.00%,1,0,100.00%
log.mmstat.com,1,0.00%,1,0,100.00%
p5.a.yximgs.com,1,0.00%,1,0,100.00%
oimagec1.ydstatic.com,1,0.00%,1,0,100.00%
httpdns.alicdn.com,1,0.00%,3,2,33.33%
question.jd.com,1,0.00%,1,0,100.00%
www.iie.cas.cn,1,0.00%,1,0,100.00%
newtab.browser.qq.com,1,0.00%,1,0,100.00%
mall.jd.com,1,0.00%,1,0,100.00%
jscss.360buyimg.com,1,0.00%,1,0,100.00%
f-mall.jd.com,1,0.00%,1,0,100.00%
module-jshop.jd.com,1,0.00%,1,0,100.00%
jscss.jd.com,1,0.00%,1,0,100.00%
cart.jd.com,1,0.00%,1,0,100.00%
qrimg.jd.com,1,0.00%,1,0,100.00%
v1.kwaicdn.com,1,0.00%,2,1,50.00%
cn-zjk-ali-r001.router.teamviewer.cn,1,0.00%,1,0,100.00%
yuri-websocket-serve.app.kdsec.org,1,0.00%,1,0,100.00%
search.ecnu.cf,1,0.00%,1,0,100.00%
moneytizer-d.openx.net,1,0.00%,1,0,100.00%
images.ppa030cjklwmlkkluiiah3nddnc.com,1,0.00%,1,0,100.00%
aeis.alicdn.com,1,0.00%,2,1,50.00%
static.ppa030cjklwmlkkluiiah3nddnc.com,1,0.00%,1,0,100.00%
t.vip.com,1,0.00%,1,0,100.00%
ms.vipstatic.com,1,0.00%,1,0,100.00%
a.vpimg1.com,1,0.00%,1,0,100.00%
sc.appvipshop.com,1,0.00%,1,0,100.00%
a.vpimg2.com,1,0.00%,1,0,100.00%
acs.vip.com,1,0.00%,1,0,100.00%
blog.vip.com,1,0.00%,1,0,100.00%
detail.vip.com,1,0.00%,1,0,100.00%
h5rsc.vip.com,1,0.00%,1,0,100.00%
help.vip.com,1,0.00%,1,0,100.00%
iclub.vip.com,1,0.00%,1,0,100.00%
ips.corp.vipshop.com,1,0.00%,1,0,100.00%
m.vip.com,1,0.00%,1,0,100.00%
order.vip.com,1,0.00%,1,0,100.00%
b.appsimg.com,1,0.00%,1,0,100.00%
h2.appsimg.com,1,0.00%,1,0,100.00%
pcapi.vip.com,1,0.00%,1,0,100.00%
s2.vipstatic.com,1,0.00%,1,0,100.00%
jr.vip.com,1,0.00%,1,0,100.00%
myvpal.vip.com,1,0.00%,1,0,100.00%
passport.vip.com,1,0.00%,1,0,100.00%
category.vip.com,1,0.00%,1,0,100.00%
stackoverflow.com,1,0.00%,1,0,100.00%
job.vip.com,1,0.00%,1,0,100.00%
xyt.xinchacha.com,1,0.00%,1,0,100.00%
lapp.corp.vipshop.com,1,0.00%,1,0,100.00%
weiquan.vip.com,1,0.00%,1,0,100.00%
www.12377.cn,1,0.00%,2,1,50.00%
www.gdjubao.cn,1,0.00%,1,0,100.00%
400.vip.com,1,0.00%,1,0,100.00%
xms.17win.com,1,0.00%,1,0,100.00%
184-15-25-249.dr01.chtn.wv.frontiernet.net,1,0.00%,1,0,100.00%
conf.cipsup.cn,1,0.00%,1,0,100.00%
log.u.wps.cn,1,0.00%,1,0,100.00%
smtp.cstnet.cn,1,0.00%,1,0,100.00%
wxsnsdy.wxs.qq.com,1,0.00%,2,1,50.00%
uhf.microsoft.com,1,0.00%,2,1,50.00%
apps.mzstatic.com,1,0.00%,2,1,50.00%
www.bangkokbank.com,1,0.00%,1,0,100.00%
www.amazon.co,1,0.00%,1,0,100.00%
data.osdknw.com,1,0.00%,1,0,100.00%
home.firefoxchina.cn.wswebpic.com,1,0.00%,1,0,100.00%
static.firefoxchina.cn,1,0.00%,2,1,50.00%
minipc.eastday.com,1,0.00%,3,2,33.33%
0i4k7t9l.sched.sma-dk.tdnsstic1.cn,1,0.00%,2,1,50.00%
img1.wywyx.com.w.kunlunca.com,1,0.00%,1,0,100.00%
zoom.us,1,0.00%,1,0,100.00%
api.wallpaper.xzdesktop.cqttech.com,1,0.00%,1,0,100.00%
raw.githubusercontent.com,1,0.00%,191,190,0.52%
wd-prod-cp-as-southeast-1-fe.southeastasia.cloudapp.azure.com,1,0.00%,1,0,100.00%
fg.download.windowsupdate.com.mwcname.com,1,0.00%,2,1,50.00%
p0.qhimg.com.webcdn.360qhcdn.com,1,0.00%,2,1,50.00%
yiyun.n.shifen.com,1,0.00%,39,38,2.56%
blob.dsm07prdstr09a.store.core.windows.net,1,0.00%,1,0,100.00%
oneocsp-microsoft-com.a-0003.a-msedge.net,1,0.00%,2,1,50.00%
wd-prod-ss-as-southeast-3-fe.southeastasia.cloudapp.azure.com,1,0.00%,1,0,100.00%
dailyupdate.wangwang.taobao.com.danuoyi.tbcache.com,1,0.00%,1,0,100.00%
autodiscover.ios.ac.cn,1,0.00%,1,0,100.00%
www.meituan.com,1,0.00%,128,127,0.78%
q.quora.com,1,0.00%,2,1,50.00%
you.csueastbay.edu,1,0.00%,1,0,100.00%
configuration.apple.com.akadns.net,1,0.00%,2,1,50.00%
lib.iscas.ac.cn,1,0.00%,1,0,100.00%
geo.prod.do.dsp.trafficmanager.net,1,0.00%,2,1,50.00%
ftp-hpcom.glb1.hp.com,1,0.00%,1,0,100.00%
cdn.ext.hp.com.c.footprint.net,1,0.00%,1,0,100.00%
staging-crackerjacks.herokuapp.com,1,0.00%,1,0,100.00%
blob.bnz13prdstr09a.store.core.windows.net,1,0.00%,1,0,100.00%
s.f.qh-lb.com,1,0.00%,2,1,50.00%
cx.soft.360.cn,1,0.00%,1,0,100.00%
e2c47.gcp.gvt2.com,1,0.00%,1,0,100.00%
onedscolprdfrc03.francecentral.cloudapp.azure.com,1,0.00%,1,0,100.00%
mx.miao.tk,1,0.00%,1,0,100.00%
dl.360safe.com.qh-cdn.com,1,0.00%,2,1,50.00%
dl.360safe.com.dl.360qhcdn.com,1,0.00%,2,1,50.00%
e-0014.e-msedge.NET,1,0.00%,1,0,100.00%
mirrors.tuna.tsinghua.edu.cn,1,0.00%,210,209,0.48%
qlikid.qlik.com,1,0.00%,1,0,100.00%
fiy.ewancle.tk,1,0.00%,1,0,100.00%
WWw.VoD.LXdNS.COm,1,0.00%,2,1,50.00%
gn.symcb.com,1,0.00%,2,1,50.00%
se.symcb.com,1,0.00%,2,1,50.00%
banjo.canonical.com,1,0.00%,1,0,100.00%
www.Vod.LxdnS.COm,1,0.00%,2,1,50.00%
cbs-i.sports.cctv.com,1,0.00%,36,35,2.78%
1610326326.D4EE073396E8.device.hiwifi.com,1,0.00%,1,0,100.00%
1610326352.D4EE073396E8.device.hiwifi.com,1,0.00%,1,0,100.00%
1610326372.D4EE073396E8.device.hiwifi.com,1,0.00%,1,0,100.00%
mirrorlist.centos.org,1,0.00%,38,37,2.63%
66.ucp-ntfy.kaspersky-labs.com,1,0.00%,1,0,100.00%
loc.map.baidu.com,1,0.00%,4,3,25.00%
vipauth.hpplay.cn,1,0.00%,1,0,100.00%
public.gdtimg.com,1,0.00%,3,2,33.33%
img.gamecenter.qq.com,1,0.00%,2,1,50.00%
product-setting-uat.haituncun.com,1,0.00%,1,0,100.00%
www.icloud.com,1,0.00%,6,5,16.67%
event-store-api-clarity-mainnet.make.services,1,0.00%,1,0,100.00%
autofrey100611.tjekvik.com,1,0.00%,1,0,100.00%
mail.inglyur.com,1,0.00%,1,0,100.00%
r3.sn-ni5een7s.gvt1.com,1,0.00%,1,0,100.00%
blob.bn9prdstr13a.store.core.windows.net,1,0.00%,1,0,100.00%
i-dsm01p-cor002.api.p001.1drv.com,1,0.00%,1,0,100.00%
blob.bn9prdstr14a.store.core.windows.net,1,0.00%,1,0,100.00%
res-scanner.zhhainiao.com,1,0.00%,2,1,50.00%
twgame06.graniterapids.com,1,0.00%,1,0,100.00%
rc10-fc12.oray.com,1,0.00%,1,0,100.00%
tw06.graniterapids.com,1,0.00%,1,0,100.00%
ir04.graniterapids.com,1,0.00%,1,0,100.00%
hkt02.graniterapids.com,1,0.00%,1,0,100.00%
hg05.ptrecord.com,1,0.00%,1,0,100.00%
bithq.org,1,0.00%,1,0,100.00%
upos-sz-staticcos-cmask.bilivideo.com,1,0.00%,2,1,50.00%
3gimg.qq.com,1,0.00%,2,1,50.00%
sdk.open.talk.getui.net,1,0.00%,2,1,50.00%
sdk.open.talk.gepush.com,1,0.00%,2,1,50.00%
sdk.open.talk.getui.com,1,0.00%,2,1,50.00%
easytomessage.com,1,0.00%,1,0,100.00%
sis.jpush.io,1,0.00%,1,0,100.00%
apppush.xiaohongshu.com,1,0.00%,1,0,100.00%
edith.xiaohongshu.com,1,0.00%,2,1,50.00%
cm-10-35.getui.com,1,0.00%,1,0,100.00%
geo-drcn.platform.hicloud.com,1,0.00%,1,0,100.00%
t2.xiaohongshu.com,1,0.00%,1,0,100.00%
findermp.video.qq.com,1,0.00%,3,2,33.33%
client-upload.cn-shanghai.log.aliyuncs.com,1,0.00%,1,0,100.00%
impaas-for-client.cn-shanghai.log.aliyuncs.com,1,0.00%,1,0,100.00%
gw.alicdn.com,1,0.00%,2,1,50.00%
phonef-drcn.cloud.dbankcloud.cn,1,0.00%,1,0,100.00%
amp-api-edge.apps.apple.com,1,0.00%,2,1,50.00%
dl1023.tcdn.qq.com,1,0.00%,1,0,100.00%
upos-sz-mirrorcoso1.bilivideo.com.cdn.dnsv1.com,1,0.00%,3,2,33.33%
show.chuangyi.taobao.com,1,0.00%,1,0,100.00%
mirrorcoso1.acglego-dk.sched.tdnsv2.com,1,0.00%,2,1,50.00%
www.aibtba.com,1,0.00%,1,0,100.00%
img.baidu.com.btba.xiaoeryi.com,1,0.00%,1,0,100.00%
sigkg.cn,1,0.00%,1,0,100.00%
10.mi.com,1,0.00%,1,0,100.00%
ise.sapi.so.com,1,0.00%,1,0,100.00%
zgrefgd03.standurl.xyz,1,0.00%,1,0,100.00%
c.aibtba.com,1,0.00%,1,0,100.00%
torrent.baidu.com.btba.xiaoeryi.com,1,0.00%,1,0,100.00%
www.xinfushe.com,1,0.00%,1,0,100.00%
webchat.7moor.com,1,0.00%,1,0,100.00%
xinfushe-1254330234.cos.ap-beijing.myqcloud.com,1,0.00%,1,0,100.00%
ntp.msn.com,1,0.00%,1,0,100.00%
weather-drcn.music.hicloud.com,1,0.00%,1,0,100.00%
k128.gslb.ksyuncdn.com,1,0.00%,2,1,50.00%
4o1.ptr5668.nolt.io,1,0.00%,1,0,100.00%
mobilegw.alipay.com,1,0.00%,1,0,100.00%
fundmobapi.eastmoney.com,1,0.00%,1,0,100.00%
service.jjxiangya.xyz,1,0.00%,2,1,50.00%
1610057031.D4EE073C2A20.device.hiwifi.com,1,0.00%,1,0,100.00%
1610057047.D4EE073C2A20.device.hiwifi.com,1,0.00%,1,0,100.00%
1610057062.D4EE073C2A20.device.hiwifi.com,1,0.00%,1,0,100.00%
1610057088.D4EE073C2A20.device.hiwifi.com,1,0.00%,1,0,100.00%
mmocgame.qpic.cn,1,0.00%,2,1,50.00%
mmocgame.qpic.cn.tc.qq.com,1,0.00%,2,1,50.00%
mmocgame.qpic.cn.sched.px-dk.tdnsv6.com,1,0.00%,2,1,50.00%
ulink.qq.com.x2.sched.dcloudstc.com,1,0.00%,1,0,100.00%
pugm-sgc.pubmnet.com,1,0.00%,1,0,100.00%
v11.douyinvod.com,1,0.00%,2,1,50.00%
v11.douyinvod.com.cdn.dnsv1.com,1,0.00%,2,1,50.00%
v11.sched.v4lego-dk.tdnsvod1.cn,1,0.00%,2,1,50.00%
hw-gz-live-p2p-07.chat.bilibili.com,1,0.00%,1,0,100.00%
biliv.d.cdn.10086.cn,1,0.00%,2,1,50.00%
tx-bj-live-comet-04.chat.bilibili.com,1,0.00%,1,0,100.00%
tasks.google.com,1,0.00%,2,1,50.00%
tx-bj-live-p2p-01.chat.bilibili.com,1,0.00%,1,0,100.00%
tx-gz-live-comet-01.chat.bilibili.com,1,0.00%,1,0,100.00%
ossweb-img.qq.com.sched.dlied1.tdnsv5.com,1,0.00%,1,0,100.00%
logs.game.qq.com,1,0.00%,1,0,100.00%
ulink.game.qq.com,1,0.00%,1,0,100.00%
hw-sh-live-p2p-backup-0002.chat.bilibili.com,1,0.00%,1,0,100.00%
ams.game.qq.com,1,0.00%,1,0,100.00%
tx-gz-live-stun-2.chat.bilibili.com,1,0.00%,1,0,100.00%
tx-bj-live-comet-03.chat.bilibili.com,1,0.00%,1,0,100.00%
v11-cold.douyinvod.com,1,0.00%,2,1,50.00%
v11-cold.douyinvod.com.cdn.dnsv1.com,1,0.00%,2,1,50.00%
v11-cold.sched.v4lego-dk.tdnsvod1.cn,1,0.00%,2,1,50.00%
v6-cold1.douyinvod.com,1,0.00%,2,1,50.00%
v6-cold1.douyinvod.com.download.ks-cdn.com,1,0.00%,2,1,50.00%
k2-dy-cold1-ml.gslb.ksyuncdn.com,1,0.00%,2,1,50.00%
a1904.v.akamai.net,1,0.00%,1,0,100.00%
mini.wps.cn,1,0.00%,1,0,100.00%
counter.ksosoft.com,1,0.00%,1,0,100.00%
e11.dsca.akamaiedge.net,1,0.00%,2,1,50.00%
ndct-data.video.iqiyi.com,1,0.00%,1,0,100.00%
appleimap.126.com,1,0.00%,1,0,100.00%
api.docer.wpscdn.cn.qiniudns.com,1,0.00%,2,1,50.00%
api.docer.wpscdn.china.line.qiniudns.com,1,0.00%,2,1,50.00%
41.newspush.eastmoney.com,1,0.00%,1,0,100.00%
34.push2.eastmoney.com,1,0.00%,2,1,50.00%
64.newspush.eastmoney.com,1,0.00%,1,0,100.00%
72.push2.eastmoney.com,1,0.00%,2,1,50.00%
10.newspush.eastmoney.com,1,0.00%,1,0,100.00%
53.newspush.eastmoney.com,1,0.00%,1,0,100.00%
16.newspush.eastmoney.com,1,0.00%,1,0,100.00%
twgame01.graniterapids.com,1,0.00%,1,0,100.00%
rc10-fc07.oray.com,1,0.00%,1,0,100.00%
ns3.canonical.com,1,0.00%,1,0,100.00%
tracker.ai.xiaomi.com,1,0.00%,1,0,100.00%
registry.docker-cn.com,1,0.00%,1,0,100.00%
ooe7wn09.mirror.aliyuncs.com,1,0.00%,1,0,100.00%
kay-javtube.herokuapp.com,1,0.00%,1,0,100.00%
anontelemetry.phusionpassenger.com,1,0.00%,1,0,100.00%
fp-as-nocache.azureedge.net,1,0.00%,4,3,25.00%
vl.ff.avast.com,1,0.00%,1,0,100.00%
filerep-replica.ff.avast.com,1,0.00%,1,0,100.00%
rc10-fc.oray.com,1,0.00%,1,0,100.00%
3.cn.pool.ntp.org,1,0.00%,1,0,100.00%
touch.kaspersky.com,1,0.00%,1,0,100.00%
us.pool.ntp.org,1,0.00%,1,0,100.00%
uk.pool.ntp.org,1,0.00%,1,0,100.00%
s07.upd.kaspersky.com,1,0.00%,1,0,100.00%
services.ucp.kaspersky-labs.com,1,0.00%,1,0,100.00%
s14.upd.kaspersky.com,1,0.00%,1,0,100.00%
api.webroot.com,1,0.00%,1,0,100.00%
nos.ns1.ff.avast.com,1,0.00%,1,0,100.00%
man7.org,1,0.00%,1,0,100.00%
updates.webroot.com,1,0.00%,1,0,100.00%
shepherd.ff.avast.com,1,0.00%,1,0,100.00%
shepherd.avcdn.net,1,0.00%,1,0,100.00%
download.bitdefender.com,1,0.00%,1,0,100.00%
g52.p4.webrootcloudav.com,1,0.00%,1,0,100.00%
caldav.fe.apple-dns.net,1,0.00%,3,2,33.33%
calendars.fe.apple-dns.net,1,0.00%,2,1,50.00%
aladin.wxqcloud.qq.com,1,0.00%,1,0,100.00%
cn4.monolink.net,1,0.00%,1,0,100.00%
51.renrenjiji.com,1,0.00%,1,0,100.00%
trace-ssl.ad7.com,1,0.00%,1,0,100.00%
lupic.cdn.bcebos.com,1,0.00%,4,3,25.00%
www.33ip.com,1,0.00%,1,0,100.00%
www.hncloud.com,1,0.00%,1,0,100.00%
scenario-drcn.things.dbankcloud.cn,1,0.00%,1,0,100.00%
ip1865110026.funshion.com,1,0.00%,1,0,100.00%
google-maps.gosur.com,1,0.00%,1,0,100.00%
www.desmos.com,1,0.00%,1,0,100.00%
extension.maxthon.cn,1,0.00%,1,0,100.00%
sslbaidu.gshifen.com,1,0.00%,1,0,100.00%
k128-gspe.gslb.ksyuncdn.com,1,0.00%,1,0,100.00%
opencdnbdbaike.jomodns.com,1,0.00%,1,0,100.00%
tool.oschina.net,1,0.00%,1,0,100.00%
open.a.shifen.com,1,0.00%,1,0,100.00%
leads.e.shifen.com,1,0.00%,1,0,100.00%
liquer.herokuapp.com,1,0.00%,1,0,100.00%
bloom-callback-sit.zaintl.com,1,0.00%,1,0,100.00%
service.dcloud.net.cn,1,0.00%,1,0,100.00%
item.jd.com.gslb.qianxun.com,1,0.00%,2,1,50.00%
h5static.jcloud-cdn.com,1,0.00%,1,0,100.00%
sz-spring-img.volcgtm.com,1,0.00%,4,3,25.00%
mercury.jd.com.gslb.qianxun.com,1,0.00%,2,1,50.00%
static.leetcode-cn.com.w.kunlungr.com,1,0.00%,1,0,100.00%
conn-im.xiaoeknow.com,1,0.00%,1,0,100.00%
open.tingjiandan.com,1,0.00%,1,0,100.00%
www.duku.cn,1,0.00%,2,1,50.00%
res1.wpsacdm.cache.wpscdn.cn,1,0.00%,2,1,50.00%
myhuiban.com,1,0.00%,1,0,100.00%
www.myhuiban.com,1,0.00%,1,0,100.00%
tags.growingio.com,1,0.00%,1,0,100.00%
cc-api-teamprojects.adobe.io,1,0.00%,1,0,100.00%
lf3-cdn-tos.bytecdntp.com,1,0.00%,2,1,50.00%
p9.toutiaoimg.com,1,0.00%,2,1,50.00%
img9.doubanio.com,1,0.00%,2,1,50.00%
pic5.iqiyipic.com,1,0.00%,2,1,50.00%
image11.m1905.cn,1,0.00%,1,0,100.00%
cdn.staticfile.org,1,0.00%,3,2,33.33%
lib.baomitu.com,1,0.00%,2,1,50.00%
diygod.me,1,0.00%,4,3,25.00%
ied-tqos-tgp.qq.com,1,0.00%,1,0,100.00%
only-49794-124-16-140-20.nstool.laiqukankan.com,1,0.00%,1,0,100.00%
only-929372-124-16-140-20.nstool.laiqukankan.com,1,0.00%,1,0,100.00%
only-803221-124-16-140-20.nstool.321fenx.com,1,0.00%,1,0,100.00%
only-735425-124-16-140-20.nstool.haowu.link,1,0.00%,1,0,100.00%
only-590775-124-16-140-20.nstool.zhuanzfx.com,1,0.00%,1,0,100.00%
only-631892-124-16-140-20.nstool.haowu.link,1,0.00%,1,0,100.00%
only-472622-124-16-140-20.nstool.zhuanzfx.com,1,0.00%,1,0,100.00%
only-54648-124-16-140-20.nstool.yqkk.link,1,0.00%,1,0,100.00%
only-683370-124-16-140-20.nstool.yqkk.link,1,0.00%,1,0,100.00%
ip3720517262.funshion.com,1,0.00%,1,0,100.00%
only-317090-124-16-140-20.nstool.yqkk.link,1,0.00%,1,0,100.00%
only-945826-124-16-140-20.nstool.yqkk.link,1,0.00%,1,0,100.00%
only-621234-124-16-140-20.nstool.321fenx.com,1,0.00%,1,0,100.00%
only-236875-124-16-140-20.nstool.haowu.link,1,0.00%,1,0,100.00%
only-892953-124-16-140-20.nstool.haowu.link,1,0.00%,1,0,100.00%
yys.res.netease.com,1,0.00%,2,1,50.00%
23.newspush.eastmoney.com,1,0.00%,1,0,100.00%
5.newspush.eastmoney.com,1,0.00%,1,0,100.00%
77.push2.eastmoney.com,1,0.00%,2,1,50.00%
3.newspush.eastmoney.com,1,0.00%,1,0,100.00%
80.newspush.eastmoney.com,1,0.00%,1,0,100.00%
45.push2.eastmoney.com,1,0.00%,2,1,50.00%
48.newspush.eastmoney.com,1,0.00%,1,0,100.00%
63.newspush.eastmoney.com,1,0.00%,1,0,100.00%
81.newspush.eastmoney.com,1,0.00%,1,0,100.00%
76.newspush.eastmoney.com,1,0.00%,1,0,100.00%
86.push2.eastmoney.com,1,0.00%,2,1,50.00%
www.worldboxingvideoarchive.com,1,0.00%,1,0,100.00%
e19233.dsca.akamaiedge.net,1,0.00%,2,1,50.00%
radarsubmissions.apple.com.akadns.net,1,0.00%,1,0,100.00%
vconf.f.qh-lb.com,1,0.00%,1,0,100.00%
phsle5-std01.oray.net,1,0.00%,1,0,100.00%
www.ccleaner.com,1,0.00%,2,1,50.00%
wx-love-ws.afunapp.com,1,0.00%,1,0,100.00%
wx-love-api.afunapp.com,1,0.00%,1,0,100.00%
captive.apple.com.edgekey.net,1,0.00%,2,1,50.00%
82.push2.eastmoney.com,1,0.00%,2,1,50.00%
25.newspush.eastmoney.com,1,0.00%,1,0,100.00%
2.newspush.eastmoney.com,1,0.00%,1,0,100.00%
77.newspush.eastmoney.com,1,0.00%,1,0,100.00%
keyvalueservice.fe.apple-dns.net,1,0.00%,2,1,50.00%
cxd.herokuapp.com,1,0.00%,1,0,100.00%
sxqkxvqgnrbdi.masiruju.cz,1,0.00%,1,0,100.00%
git.cipsup.cn,1,0.00%,1,0,100.00%
datacluster1.cipsup.cn,1,0.00%,1,0,100.00%
datacluster5.cipsup.cn,1,0.00%,1,0,100.00%
xd.x3.client.api.vpngate2.jp,1,0.00%,2,1,50.00%
rc10-fc10.oray.com,1,0.00%,1,0,100.00%
admin.quikly-ejh-untouched-br-ekyq53.quiklydemo.com,1,0.00%,1,0,100.00%
devteste.com.br,1,0.00%,1,0,100.00%
edge.skype.com,1,0.00%,2,1,50.00%
tracker.filepit.to,1,0.00%,1,0,100.00%
bili.cold.c.cdnhwc2.com,1,0.00%,2,1,50.00%
mail.mtd-tg.de,1,0.00%,1,0,100.00%
s3.fx.kgimg.com,1,0.00%,1,0,100.00%
p1.fx.kgimg.com,1,0.00%,1,0,100.00%
cozycountryredirectiv.addons.business,1,0.00%,1,0,100.00%
activity.pdf365.cn,1,0.00%,1,0,100.00%
mask-canary.icloud.com,1,0.00%,2,1,50.00%
init-p01md.apple.com,1,0.00%,2,1,50.00%
tmfmazu4.m.qq.com,1,0.00%,1,0,100.00%
ins-hbkhjmd8.ias.tencent-cloud.net,1,0.00%,1,0,100.00%
t.wg.360-api.cn,1,0.00%,1,0,100.00%
blued.irisdt.cn,1,0.00%,1,0,100.00%
live-im.blued.cn,1,0.00%,1,0,100.00%
seed.siri.apple.com,1,0.00%,1,0,100.00%
www.lianmenhu.com,1,0.00%,1,0,100.00%
cmmsns.qpic.cn,1,0.00%,14,13,7.14%
pd.ads.cn.miaozhen.com,1,0.00%,1,0,100.00%
g.dtv.cn.miaozhen.com,1,0.00%,1,0,100.00%
qypxcwweb.dongao.com,1,0.00%,1,0,100.00%
imap.googlemail.com,1,0.00%,2,1,50.00%
www.gstatic.cn,1,0.00%,1,0,100.00%
videocloud.cn-hangzhou.log.aliyuncs.com,1,0.00%,1,0,100.00%
h5hosting.dbankcdn.com,1,0.00%,2,1,50.00%
sr.kaikeba.com,1,0.00%,2,1,50.00%
sdk.alibaba.com.ailbaba.me,1,0.00%,1,0,100.00%
golang.gallerycdn.azure.cn,1,0.00%,1,0,100.00%
ms-python.gallerycdn.azure.cn,1,0.00%,1,0,100.00%
cn-jssz-cm-02-13.bilivideo.com,1,0.00%,1,0,100.00%
stun.chat.bilibili.com,1,0.00%,2,1,50.00%
ubc.topsports.com.cn,1,0.00%,1,0,100.00%
yb-safe.2345.cc,1,0.00%,1,0,100.00%
b.c2r.ts.cdn.office.net,1,0.00%,1,0,100.00%
0bf1d300bafeafb279fe9a0655ce1535.safeframe.googlesyndication.com,1,0.00%,1,0,100.00%
api.xueqiu.com,1,0.00%,1,0,100.00%
www.vocabulary.com,1,0.00%,1,0,100.00%
cl2.webterren.com,1,0.00%,1,0,100.00%
d.webterren.com,1,0.00%,1,0,100.00%
cl0.webterren.com,1,0.00%,1,0,100.00%
hzwwx.hangzhou.com.cn,1,0.00%,1,0,100.00%
cucshk4.debugex.xyz,1,0.00%,1,0,100.00%
open2.kaikeba.com,1,0.00%,1,0,100.00%
api-vod.baoshiyun.com,1,0.00%,1,0,100.00%
g1.tagtic.cn,1,0.00%,1,0,100.00%
xueqiu.com,1,0.00%,1,0,100.00%
relay-6556aec6.net.anydesk.com,1,0.00%,1,0,100.00%
px.ads.linkedin.cn,1,0.00%,1,0,100.00%
crl.sca1b.amazontrust.com,1,0.00%,1,0,100.00%
go.mocomarketplace.com,1,0.00%,1,0,100.00%
hub5sr.v6.shub.sandai.net,1,0.00%,11,10,9.09%
gfe.nvidia.com,1,0.00%,13,12,7.69%
sat02pap003.storage.live.com,1,0.00%,2,1,50.00%
www.SlAShdot.OrG,1,0.00%,1,0,100.00%
www.MiT.eDu,1,0.00%,1,0,100.00%
stg.bluebird.ac,1,0.00%,1,0,100.00%
mx20.mailspamprotection.com,1,0.00%,1,0,100.00%
mx10.mailspamprotection.com,1,0.00%,1,0,100.00%
ftp.de.debian.org,1,0.00%,1,0,100.00%
slp2p-east-std24.oray.net,1,0.00%,1,0,100.00%
download.jetbrains.com,1,0.00%,17,16,5.88%
sourcegraph.com,1,0.00%,1,0,100.00%
school.usefedorastage-pr-9679.devenv.website,1,0.00%,1,0,100.00%
slp2p-east-std1057.oray.net,1,0.00%,1,0,100.00%
vps.yinas.cf,1,0.00%,1,0,100.00%
llynholidays.co.uk,1,0.00%,1,0,100.00%
1608227430.D4EE071FA772.device.hiwifi.com,1,0.00%,1,0,100.00%
cdn.content.prod.cms.msn.com.edgekey.net,1,0.00%,2,1,50.00%
e10663.dscg.akamaiedge.net,1,0.00%,2,1,50.00%
dlied6.qq.com.yyb.sched.dcloudstc.com,1,0.00%,1,0,100.00%
onedscolprdjpw00.japanwest.cloudapp.azure.com,1,0.00%,1,0,100.00%
opencdnmsdl.jomodns.com,1,0.00%,1,0,100.00%
clientnotification-userprodea1-1.servicebus.windows.net,1,0.00%,1,0,100.00%
scootersoftware.com,1,0.00%,1,0,100.00%
mail.fy98.tk,1,0.00%,1,0,100.00%
ca04.graniterapids.com,1,0.00%,1,0,100.00%
api.pixso.cn,1,0.00%,1,0,100.00%
analytics.wondershare.cc,1,0.00%,1,0,100.00%
config.fp.measure.office.com,1,0.00%,1,0,100.00%
p203-contacts.icloud.com.cn,1,0.00%,1,0,100.00%
uk01.graniterapids.com,1,0.00%,1,0,100.00%
login.empfehlungsbund.de,1,0.00%,1,0,100.00%
swheritage.org.uk,1,0.00%,1,0,100.00%
d2ra6nuwn69ktl.cloudfront.net,1,0.00%,1,0,100.00%
www.baiduyun.wiki,1,0.00%,1,0,100.00%
a.tampermonkey.net,1,0.00%,1,0,100.00%
mail.beijing.gov.cn,1,0.00%,1,0,100.00%
zhuanjia.cdn.bcebos.com,1,0.00%,1,0,100.00%
ihsu-southeastasia-2.southeastasia.cloudapp.azure.com,1,0.00%,1,0,100.00%
mipcache.bdstatic.com,1,0.00%,2,1,50.00%
c.mipcdn.com,1,0.00%,2,1,50.00%
mipengine.baidu.com,1,0.00%,2,1,50.00%
pcgec-img-1258344701.image.myqcloud.com,1,0.00%,1,0,100.00%
k1-global.gslb.ksyuncdn.com,1,0.00%,2,1,50.00%
ip1882349061.funshion.com,1,0.00%,1,0,100.00%
cat.sh.vip.dianping.com,1,0.00%,1,0,100.00%
d1ey6b4lsxjlpc.cloudfront.net,1,0.00%,2,1,50.00%
hcdnw.bili.c.cdnhwc2.com,1,0.00%,2,1,50.00%
ins-vcomefk6.ias.tencent-cloud.net,1,0.00%,1,0,100.00%
a1333.q.akamai.net,1,0.00%,1,0,100.00%
msn-cn.a-0032.a-msedge.net,1,0.00%,2,1,50.00%
ts1.cn.mm.bing.chinacache.net,1,0.00%,1,0,100.00%
ts2.cn.mm.bing.chinacache.net,1,0.00%,1,0,100.00%
alt3.mobile-gtalk.l.google.com,1,0.00%,1,0,100.00%
websocket.pod4.avatar.ext.hp.com,1,0.00%,1,0,100.00%
kan.cc,1,0.00%,1,0,100.00%
emoji.qpic.tc.qq.com,1,0.00%,1,0,100.00%
emoji.qpic.cn.sched.legopic1.tdnsv6.com,1,0.00%,1,0,100.00%
cdnws.api.huya.com.w.kunlungr.com,1,0.00%,1,0,100.00%
pull-rtmp-l11-cny.douyincdn.com.sched.l9.tdnsv5.com,1,0.00%,1,0,100.00%
yunlivepush.msf.tencent-cloud.com,1,0.00%,1,0,100.00%
pull-rtmp-l26-cny.douyincdn.com.c.cdnhwc3.com,1,0.00%,1,0,100.00%
push-rtmp-l1.douyincdn.com.wsdvs.com,1,0.00%,1,0,100.00%
pull-rtmp-l11.douyincdn.com.sched.l8.tdnsv5.com,1,0.00%,1,0,100.00%
pull-f3-proxy.douyincdn.com.w.alikunlun.net,1,0.00%,1,0,100.00%
pull-rtmp-l1-source.douyincdn.com.wsdvs.com,1,0.00%,1,0,100.00%
pull-tsl-spe-l1.douyincdn.com.wsdvs.com,1,0.00%,1,0,100.00%
pull-flv-f11-proxy.douyincdn.com.sched.l8.tdnsv5.com,1,0.00%,1,0,100.00%
s6110-ml.gslb.ksyuncdn.com,1,0.00%,2,1,50.00%
pull-flv-f6-hs.pstatp.com.hdlvcloud.ks-cdn.com,1,0.00%,1,0,100.00%
s6130-ml.gslb.ksyuncdn.com,1,0.00%,2,1,50.00%
hcdnv.zjv6.zjtd.c.cdnhwc2.com,1,0.00%,2,1,50.00%
pull-rtmp-f6-hs.pstatp.com.rtmpvcloud.ks-cdn.com,1,0.00%,2,1,50.00%
s03-ml.gslb.ksyuncdn.com,1,0.00%,2,1,50.00%
pull-flv-f96.douyincdn.com.d.live.cdn.chinamobile.com,1,0.00%,1,0,100.00%
source-fcdn-spe-push.s.bytefcdn.com,1,0.00%,1,0,100.00%
pull-rtmp-l13.douyincdn.com.a.bcelive.com,1,0.00%,1,0,100.00%
bcedyrtmp.jomodns.com,1,0.00%,1,0,100.00%
push-rtmp-hs-f5.huoshanlive.com.c.volcfcdndvs.com,1,0.00%,1,0,100.00%
push-rtmp-l26.douyincdn.com.c.cdnhwc3.com,1,0.00%,1,0,100.00%
hcdnl.push.gslb.c.cdnhwc2.com,1,0.00%,1,0,100.00%
in03.graniterapids.com,1,0.00%,1,0,100.00%
p7.biz.weibo.com,1,0.00%,1,0,100.00%
pdata.log.mgtv.com,1,0.00%,1,0,100.00%
apm-s3.ejoy.com,1,0.00%,1,0,100.00%
static.tsbrowser.xiangtatech.com.w.kunlunca.com,1,0.00%,1,0,100.00%
sdkh5.9game.cn,1,0.00%,1,0,100.00%
paycenter-log.9game.cn,1,0.00%,1,0,100.00%
p10445-user-info.ejoy.com,1,0.00%,1,0,100.00%
obs.lz03-br-dy.cn-north-2.myhuaweicloud.com,1,0.00%,1,0,100.00%
p10445-holo.ejoy.com,1,0.00%,1,0,100.00%
p10445-game-adapter.ejoy.com,1,0.00%,1,0,100.00%
prod-pod4-dvc-avatarws-podlb-alb-227246374.us-east-1.elb.amazonaws.com,1,0.00%,1,0,100.00%
w.kancloud.cn,1,0.00%,1,0,100.00%
ai.alimebot.taobao.com,1,0.00%,1,0,100.00%
im.alimebot.com,1,0.00%,1,0,100.00%
cloud.tencent.com,1,0.00%,2,1,50.00%
binaries.templates.cdn.office.net,1,0.00%,2,1,50.00%
i-38.b-46304.ut.bench.utorrent.com,1,0.00%,3,2,33.33%
cl5.apple.com,1,0.00%,2,1,50.00%
sns-avatar-qc.xhscdn.com.cdn.dnsv1.com,1,0.00%,2,1,50.00%
audio-ak-spotify-com.akamaized.net,1,0.00%,2,1,50.00%
a297.dscc.akamai.net.0.1.cn.akamaitech.net,1,0.00%,2,1,50.00%
staticlive.douyucdn.cn,1,0.00%,2,1,50.00%
shark.douyucdn.cn,1,0.00%,2,1,50.00%
res.douyucdn.cn,1,0.00%,2,1,50.00%
rpic.douyucdn.cn,1,0.00%,2,1,50.00%
shark2.douyucdn.cn,1,0.00%,2,1,50.00%
static.galaxyclouds.cn,1,0.00%,1,0,100.00%
p2psdk.wscdns.com,1,0.00%,1,0,100.00%
conf.qvb.qcloud.com,1,0.00%,1,0,100.00%
img.douyucdn.cn,1,0.00%,2,1,50.00%
webconf.douyucdn.cn,1,0.00%,2,1,50.00%
hdl3a.douyucdn.cn,1,0.00%,1,0,100.00%
hdl5.douyucdn.cn,1,0.00%,1,0,100.00%
msgstatic.douyucdn.cn,1,0.00%,2,1,50.00%
tap-android-logs.cn-beijing.log.aliyuncs.com,1,0.00%,1,0,100.00%
c399e1eba3cafdcf71c1b49fbbabaf96.v.smtcdns.net,1,0.00%,1,0,100.00%
www.douyu.com,1,0.00%,2,1,50.00%
ip0467469273.livehwc3.cn,1,0.00%,1,0,100.00%
sta-op.douyucdn.cn,1,0.00%,2,1,50.00%
yuba.douyu.com,1,0.00%,2,1,50.00%
wsproxy.douyu.com,1,0.00%,1,0,100.00%
87b85e0bd14b9416c1439fcac8b8a929.v.smtcdns.net,1,0.00%,1,0,100.00%
iv6.gtimg.cn,1,0.00%,2,1,50.00%
p3.music.126.net,1,0.00%,3,2,33.33%
stat.tiara.kakao.com,1,0.00%,2,1,50.00%
wqs.jd.com,1,0.00%,2,1,50.00%
token.safebrowsing.apple,1,0.00%,2,1,50.00%
safebrowsing-re.aaplimg.com,1,0.00%,1,0,100.00%
res.servicewechat.com,1,0.00%,2,1,50.00%
d3afeddfd2d6b691141031ef6d8ecc1f.dlied1.cdntips.net,1,0.00%,1,0,100.00%
contentsync.onenote.com,1,0.00%,1,0,100.00%
osiprod-krc-blush-azsc-004.koreacentral.cloudapp.azure.com,1,0.00%,1,0,100.00%
gspe79-ssl.ls.apple.com,1,0.00%,2,1,50.00%
hlx.meituan.com,1,0.00%,1,0,100.00%
leopard.vip.meituan.com,1,0.00%,1,0,100.00%
t2-xhs-new-vpc-ipv6-2022140793.cn-north-1.elb.amazonaws.com.cn,1,0.00%,2,1,50.00%
s3plus.meituan.net,1,0.00%,2,1,50.00%
1126359.sched.skalego-dk.tdnsstic1.cn.cjt.vwnti.yrzhcloud.cn,1,0.00%,2,1,50.00%
lf3-motor.dcarstatic.com,1,0.00%,1,0,100.00%
lf3-motor.dcarstatic.com.w.kunluncan.com,1,0.00%,1,0,100.00%
lf1-cdn-tos.bytescm.com,1,0.00%,1,0,100.00%
www.dongchedi.com.w.cdngslb.com,1,0.00%,1,0,100.00%
p1-dcd.byteimg.com,1,0.00%,1,0,100.00%
488928.sched.skalego-dk.tdnsstic1.cn,1,0.00%,2,1,50.00%
p1-dcd.byteimg.com.wsglb0.com,1,0.00%,1,0,100.00%
lf3-static.bytednsdoc.com.w.alikunlun.com,1,0.00%,1,0,100.00%
v26-default.365yg.com,1,0.00%,1,0,100.00%
p9-dcd-sign.byteimg.com,1,0.00%,1,0,100.00%
p6-dcd-sign.byteimg.com,1,0.00%,1,0,100.00%
lf-rc1.yhgfb-cn-static.com,1,0.00%,1,0,100.00%
vcs.snssdk.com.w.cdngslb.com,1,0.00%,1,0,100.00%
vod.bytedanceapi.com.w.kunluncan.com,1,0.00%,1,0,100.00%
sso.toutiao.com.w.cdngslb.com,1,0.00%,1,0,100.00%
hcdnw.zjtd01.gslb.c.cdnhwc2.com,1,0.00%,1,0,100.00%
hcdnv.zjtd.v6.c.cdnhwc1.com,1,0.00%,1,0,100.00%
k5-toutiao-ipv6-ml.gslb.ksyuncdn.com,1,0.00%,1,0,100.00%
zttapk.v.bsgslb.com,1,0.00%,1,0,100.00%
pdata.log.mgtv.com.HOST,1,0.00%,1,0,100.00%
mambap2pvodmobile.8686c.com,1,0.00%,2,1,50.00%
dp.im.weibo.cn,1,0.00%,1,0,100.00%
api.uve.weibo.com,1,0.00%,1,0,100.00%
p2p.ehome.21cn.com,1,0.00%,1,0,100.00%
qq.com,1,0.00%,1,0,100.00%
update.powerword.wps.cn,1,0.00%,1,0,100.00%
tm1.dns-tm.com,1,0.00%,1,0,100.00%
tm2.dns-tm.com,1,0.00%,1,0,100.00%
sso.shoprunback.com,1,0.00%,1,0,100.00%
uss.lenovomm.com,1,0.00%,1,0,100.00%
vetadomicilio-it.socialacademy.me,1,0.00%,1,0,100.00%
fwupd.org,1,0.00%,1,0,100.00%
rads.rollingbonesoutfitters.com,1,0.00%,1,0,100.00%
tracker.nice-prod.pro,1,0.00%,1,0,100.00%
apache.jfrog.io,1,0.00%,1,0,100.00%
eccanova.herokuapp.com,1,0.00%,1,0,100.00%
onedscolprdweu00.westeurope.cloudapp.azure.com,1,0.00%,1,0,100.00%
mapsnap0.bdimg.com,1,0.00%,2,1,50.00%
floor.jd.com,1,0.00%,2,1,50.00%
img1.360buyimg.com,1,0.00%,2,1,50.00%
dd-search.jd.com,1,0.00%,2,1,50.00%
csc.jd.com,1,0.00%,2,1,50.00%
list.jd.com,1,0.00%,2,1,50.00%
services.zotero.org,1,0.00%,1,0,100.00%
s.go-mpulse.net,1,0.00%,2,1,50.00%
tags.tiqcdn.com,1,0.00%,1,0,100.00%
tr.doogh.club,1,0.00%,2,1,50.00%
minisite.zhhainiao.com,1,0.00%,1,0,100.00%
imasdk.googleapis.com,1,0.00%,6,5,16.67%
globalsign.com.w.kunlunar.com,1,0.00%,1,0,100.00%
en.mmcs.org.cn,1,0.00%,1,0,100.00%
tennis.start4all.com,1,0.00%,1,0,100.00%
mail.masslatemps.ml,1,0.00%,1,0,100.00%
dl.gi.de,1,0.00%,1,0,100.00%
inf.ldmnq.com,1,0.00%,1,0,100.00%
csd-apt-eas-d-2.eastasia.cloudapp.azure.com,1,0.00%,1,0,100.00%
dl.bintray.com,1,0.00%,1,0,100.00%
d20rj4el6vkp4c.cloudfront.net,1,0.00%,2,1,50.00%
buildlogs.centos.org,1,0.00%,1,0,100.00%
mail.rlfazone.cf,1,0.00%,1,0,100.00%
sl-collection.oray.net,1,0.00%,1,0,100.00%
twgame04.graniterapids.com,1,0.00%,1,0,100.00%
d3jq4x7ht7rl2f.cloudfront.net,1,0.00%,1,0,100.00%
onewhat.herokuapp.com,1,0.00%,1,0,100.00%
pr.33663368.xyz,1,0.00%,1,0,100.00%
irrenhaus.dyndns.dk,1,0.00%,1,0,100.00%
mvgroup.org,1,0.00%,1,0,100.00%
datarouter-prod.ak.epicgames.com,1,0.00%,2,1,50.00%
stage.attensa.net,1,0.00%,1,0,100.00%
jp06.graniterapids.com,1,0.00%,1,0,100.00%
jp20.graniterapids.com,1,0.00%,1,0,100.00%
my.opalstack.com,1,0.00%,1,0,100.00%
contacts.icloud.com,1,0.00%,2,1,50.00%
p06-caldav.icloud.com,1,0.00%,2,1,50.00%
twct04.graniterapids.com,1,0.00%,1,0,100.00%
calendar.safe.360.cn,1,0.00%,1,0,100.00%
p1.img.360kuai.com,1,0.00%,2,1,50.00%
note.ntes53.netease.com,1,0.00%,1,0,100.00%
ns1.mopa.ae,1,0.00%,1,0,100.00%
ns2.mopa.ae,1,0.00%,1,0,100.00%
live.video.weibocdn.com,1,0.00%,2,1,50.00%
hlws.huanle.qq.com,1,0.00%,1,0,100.00%
z86b6g.deeqrr.dscew.ml,1,0.00%,1,0,100.00%
ahtai3ie.nodedata.net,1,0.00%,1,0,100.00%
ksn-url-geo.kaspersky-labs.com,1,0.00%,1,0,100.00%
font.docer.wps.cn,1,0.00%,1,0,100.00%
cngdcm.debugex.xyz,1,0.00%,1,0,100.00%
lf1-cdn-tos.bytegoofy.com,1,0.00%,4,3,25.00%
mobile.163.com,1,0.00%,1,0,100.00%
img3.126.net,1,0.00%,1,0,100.00%
api.money.126.net,1,0.00%,1,0,100.00%
webstat.ws.126.net,1,0.00%,1,0,100.00%
cms-bucket.nosdn.127.net,1,0.00%,1,0,100.00%
msg.mail.163.com,1,0.00%,1,0,100.00%
s4.cnzz.com,1,0.00%,1,0,100.00%
yp.ws.126.net,1,0.00%,1,0,100.00%
api.cloud.huawei.com,1,0.00%,1,0,100.00%
talent-fe.cdn.bcebos.com,1,0.00%,1,0,100.00%
img3.xs.cdnyes.com,1,0.00%,1,0,100.00%
www.qlspx.com,1,0.00%,1,0,100.00%
api.97bike.com,1,0.00%,1,0,100.00%
n48scu3p.n.sudun-cname.com,1,0.00%,1,0,100.00%
aojxxqus.slt.sched.tdnsv8.com,1,0.00%,1,0,100.00%
1b5e7de2ce344d8a.huaweisafedns.cn,1,0.00%,1,0,100.00%
a.cdd5090t.tk,1,0.00%,1,0,100.00%
o58bvl93.sched.sma-dk.tdnsstic1.cn,1,0.00%,2,1,50.00%
v.qisaoba.com.w.kunlunaq.com,1,0.00%,1,0,100.00%
t891.ts2.1633mu.com.w.kunlunaq.com,1,0.00%,1,0,100.00%
plus.uploadtu.cn.cdn.fun,1,0.00%,1,0,100.00%
ad.rxjiasu.com.cdn.fun,1,0.00%,1,0,100.00%
statistics.yozsc.com,1,0.00%,1,0,100.00%
yk.rongxingvr.cc,1,0.00%,1,0,100.00%
cdn1.gosur.com,1,0.00%,1,0,100.00%
tile2.gosurmaps.com,1,0.00%,1,0,100.00%
tc.forward.douban.com,1,0.00%,1,0,100.00%
www.mgtv.com.wscdns.com,1,0.00%,2,1,50.00%
d2bytcopxu066p.cloudfront.net,1,0.00%,1,0,100.00%
qqtv1.xyz,1,0.00%,1,0,100.00%
baike.baidu.com,1,0.00%,4,3,25.00%
ipads.se.sjtu.edu.cn,1,0.00%,1,0,100.00%
report.meeting.tencent.com,1,0.00%,2,1,50.00%
quic.conn.wemeet.qq.com,1,0.00%,1,0,100.00%
settings-ssl.xboxlive.com,1,0.00%,3,2,33.33%
www.datadoghq-browser-agent.com,1,0.00%,1,0,100.00%
rum-http-intake.logs.datadoghq.com,1,0.00%,2,1,50.00%
aax-us-east.amazon-adsystem.com,1,0.00%,1,0,100.00%
qn1-next.xuetangonline.com,1,0.00%,2,1,50.00%
wlog.gifshow.com,1,0.00%,1,0,100.00%
idsync.rlcdn.com,1,0.00%,1,0,100.00%
qn-sc0.yuketang.cn,1,0.00%,2,1,50.00%
public-prod-dspcookiematching.dmxleo.com,1,0.00%,1,0,100.00%
hao0.qhimg.com,1,0.00%,2,1,50.00%
onedscolprdweu01.westeurope.cloudapp.azure.com,1,0.00%,2,1,50.00%
nydc1.outbrain.org,1,0.00%,1,0,100.00%
api-xiuxiupro.meitu.com,1,0.00%,1,0,100.00%
image.laifeng.com,1,0.00%,2,1,50.00%
image.laifeng.com.w.cdngslb.com,1,0.00%,2,1,50.00%
1610107587.D4EE073C2A20.device.hiwifi.com,1,0.00%,1,0,100.00%
ieeexplore.ieee.org,1,0.00%,2,1,50.00%
e2c28.gcp.gvt2.com,1,0.00%,1,0,100.00%
log.snssdk.com,1,0.00%,1,0,100.00%
log.snssdk.com.w.kunlunhuf.com,1,0.00%,1,0,100.00%
fma-1.get-ser7.xyz,1,0.00%,1,0,100.00%
mp.csdn.net,1,0.00%,1,0,100.00%
mp-activity.csdn.net,1,0.00%,1,0,100.00%
a.cnzz.com,1,0.00%,1,0,100.00%
www.myhack58.com,1,0.00%,1,0,100.00%
c2s3.jamjams3.net,1,0.00%,1,0,100.00%
student.csdn.net,1,0.00%,1,0,100.00%
editor.csdn.net,1,0.00%,1,0,100.00%
mobi2.hexin.cn,1,0.00%,2,1,50.00%
www.wanfangdata.com.cn,1,0.00%,2,1,50.00%
apps.wanfangdata.com.cn,1,0.00%,1,0,100.00%
w.wanfangdata.com.cn,1,0.00%,1,0,100.00%
advertnew.wanfangdata.com.cn,1,0.00%,1,0,100.00%
login.wanfangdata.com.cn,1,0.00%,1,0,100.00%
pull-rtmp-l6-source.douyincdn.com,1,0.00%,2,1,50.00%
pull-tsl-vr-l11.douyincdn.com,1,0.00%,2,1,50.00%
pull-tsl-spe-l11.douyincdn.com,1,0.00%,2,1,50.00%
pull-l3-cny.douyincdn.com,1,0.00%,2,1,50.00%
pull-flv-f1-hs.pstatp.com,1,0.00%,2,1,50.00%
pull-rtmp-l95.douyincdn.com,1,0.00%,2,1,50.00%
pull-flv-f6-hs.pstatp.com,1,0.00%,2,1,50.00%
pull-flv-l6-source.douyincdn.com,1,0.00%,2,1,50.00%
push-rtmp-f5-vs.douyincdn.com,1,0.00%,1,0,100.00%
pull-lls-spe-l6.douyincdn.com,1,0.00%,2,1,50.00%
pull-flv-l6.ixigua.com,1,0.00%,2,1,50.00%
pull-flv-vr-l1.douyincdn.com,1,0.00%,2,1,50.00%
pull-tsl-vr-l26.douyincdn.com,1,0.00%,1,0,100.00%
pull-flv-l6-hs.pstatp.com,1,0.00%,2,1,50.00%
pull-flv-l1.douyincdn.com,1,0.00%,2,1,50.00%
pull-tsl-vr-l1.douyincdn.com,1,0.00%,1,0,100.00%
pull-flv-spe-l1.douyincdn.com,1,0.00%,2,1,50.00%
pull-flv-f26-proxy.douyincdn.com,1,0.00%,2,1,50.00%
pull-flv-l1-source.douyincdn.com,1,0.00%,2,1,50.00%
pull-hls-vr-l6.douyincdn.com,1,0.00%,2,1,50.00%
pull-flv-f26.douyincdn.com,1,0.00%,2,1,50.00%
pull-flv-l26.douyincdn.com,1,0.00%,2,1,50.00%
pull-flv-f1.douyincdn.com,1,0.00%,2,1,50.00%
pull-flv-l6-enc.douyincdn.com,1,0.00%,2,1,50.00%
pull-flv-l6-cny.douyincdn.com,1,0.00%,2,1,50.00%
pull-tsl-spe-l26.douyincdn.com,1,0.00%,2,1,50.00%
pull-rtmp-f6.douyincdn.com,1,0.00%,2,1,50.00%
pull-flv-f6.douyincdn.com,1,0.00%,2,1,50.00%
pull-hls-f5-tsl.douyincdn.com,1,0.00%,2,1,50.00%
pull-rtmp-l6-cny.douyincdn.com,1,0.00%,2,1,50.00%
pull-hls-spe-l6.douyincdn.com,1,0.00%,2,1,50.00%
pull-rtmp-l11-cny.douyincdn.com,1,0.00%,1,0,100.00%
pull-hls-f5-enc.flive.douyincdn.com,1,0.00%,1,0,100.00%
pull-flv-vr-l6.douyincdn.com,1,0.00%,2,1,50.00%
pull-tsl-spe-l6.douyincdn.com,1,0.00%,2,1,50.00%
pull-flv-spe-l6.douyincdn.com,1,0.00%,2,1,50.00%
pull-tsl-vr-l6.douyincdn.com,1,0.00%,2,1,50.00%
pull-flv-l26-cny.douyincdn.com,1,0.00%,2,1,50.00%
pull-flv-spe-l11.douyincdn.com,1,0.00%,1,0,100.00%
pull-flv-f1-proxy.douyincdn.com,1,0.00%,1,0,100.00%
pull-hls-vr-l1.douyincdn.com,1,0.00%,2,1,50.00%
pull-hls-f5-vs-tsl.douyincdn.com,1,0.00%,2,1,50.00%
pull-flv-l11-cny.douyincdn.com,1,0.00%,2,1,50.00%
push-rtmp-l95.douyincdn.com,1,0.00%,2,1,50.00%
v83-016.douyinvod.com,1,0.00%,2,1,50.00%
v26-cold.douyinvod.com,1,0.00%,2,1,50.00%
v5-h.douyinvod.com,1,0.00%,2,1,50.00%
weu08-breeziest-in.cloudapp.net,1,0.00%,1,0,100.00%
matukhloting.scontrinoshop.com,1,0.00%,1,0,100.00%
notify.privy-staging-pr-8267.privy-staging.com,1,0.00%,1,0,100.00%
docs.idqqimg.com,1,0.00%,2,1,50.00%
pic1.iqiyipic.com,1,0.00%,2,1,50.00%
pic3.iqiyipic.com,1,0.00%,2,1,50.00%
pic7.iqiyipic.com,1,0.00%,2,1,50.00%
preimage0.iqiyipic.com,1,0.00%,2,1,50.00%
docimg9.docs.qq.com,1,0.00%,2,1,50.00%
www.ludashi.com,1,0.00%,1,0,100.00%
assets.imedao.com.w.alikunlun.com,1,0.00%,1,0,100.00%
www.91boshuo.com,1,0.00%,1,0,100.00%
cnallaz.eucdurl.me,1,0.00%,1,0,100.00%
www.yisu.com,1,0.00%,1,0,100.00%
juejin.cn.w.cdngslb.com,1,0.00%,1,0,100.00%
p3-juejin.byteimg.com,1,0.00%,2,1,50.00%
p3-juejin.byteimg.com.w.cdngslb.com,1,0.00%,2,1,50.00%
api.juejin.cn,1,0.00%,1,0,100.00%
api.juejin.cn.w.cdngslb.com,1,0.00%,1,0,100.00%
abtestvm.bytedance.com,1,0.00%,1,0,100.00%
abtestvm.bytedance.com.w.cdngslb.com,1,0.00%,1,0,100.00%
usstartus2.eucdurl.me,1,0.00%,1,0,100.00%
c.4dex.io,1,0.00%,1,0,100.00%
dict.iciba.com,1,0.00%,1,0,100.00%
cryptonomicon.mit.edu,1,0.00%,1,0,100.00%
ca-en.jowae.com,1,0.00%,1,0,100.00%
ws.lanhuapp.com,1,0.00%,1,0,100.00%
lanhu-logger.cn-beijing.log.aliyuncs.com,1,0.00%,1,0,100.00%
disruptnetwork.podigee.io,1,0.00%,1,0,100.00%
pgy-api.oray.com,1,0.00%,1,0,100.00%
kds.wps.cn,1,0.00%,1,0,100.00%
office3.dawei.tk,1,0.00%,1,0,100.00%
csng.ok.getambassador.com,1,0.00%,1,0,100.00%
direwolf-de2f830349.herokuapp.com,1,0.00%,1,0,100.00%
creator.zoho.com,1,0.00%,1,0,100.00%
mail.presfawdobu.tk,1,0.00%,1,0,100.00%
mail.ushsdabababsa.ga,1,0.00%,1,0,100.00%
1610060676.D4EE073C2A20.device.hiwifi.com,1,0.00%,1,0,100.00%
1610060697.D4EE073C2A20.device.hiwifi.com,1,0.00%,1,0,100.00%
mail.pipimorederhau.ml,1,0.00%,1,0,100.00%
chatlink-yqsx04.netease.im,1,0.00%,1,0,100.00%
chatlink-yqsx07.netease.im,1,0.00%,1,0,100.00%
chatlink-yqsx12.netease.im,1,0.00%,1,0,100.00%
ioversea.mobileapi.ucnewtest.wanyol.com,1,0.00%,1,0,100.00%
chatlink-yqsx09.netease.im,1,0.00%,1,0,100.00%
chatlink-yqsx10.netease.im,1,0.00%,1,0,100.00%
chatlink-yqsx11.netease.im,1,0.00%,1,0,100.00%
chatlink-yqsx05.netease.im,1,0.00%,1,0,100.00%
direwolf-ff717ed8f1.herokuapp.com,1,0.00%,1,0,100.00%
ns5.cstnet.cn,1,0.00%,1,0,100.00%
ns6.cstnet.cn,1,0.00%,1,0,100.00%
atomolsonfitness.gymmasteronline.com,1,0.00%,1,0,100.00%
www.scio.gov.cn,1,0.00%,11,10,9.09%
www.thevault.bz,1,0.00%,1,0,100.00%
a28-67.akam.net,1,0.00%,1,0,100.00%
staging.gatewayresourcelibrary.com,1,0.00%,1,0,100.00%
mail.tiobeschcow.tk,1,0.00%,1,0,100.00%
chi01pap001.storage.live.com,1,0.00%,1,0,100.00%
update-minipage.2345.cc,1,0.00%,1,0,100.00%
training.izonesoftware.co.uk,1,0.00%,1,0,100.00%
onedscolprdgwc07.germanywestcentral.cloudapp.azure.com,1,0.00%,1,0,100.00%
share.tiktokcloud.tk,1,0.00%,1,0,100.00%
strong4-server.herokuapp.com,1,0.00%,1,0,100.00%
gsp64-ssl.ls-apple.com.akadns.net,1,0.00%,1,0,100.00%
kt-prod.v.aaplimg.com,1,0.00%,1,0,100.00%
1.openwrt.pool.ntp.org,1,0.00%,1,0,100.00%
rt.optizone.ru,1,0.00%,1,0,100.00%
bt.firebit.org,1,0.00%,1,0,100.00%
gateway-remote.homedns.org,1,0.00%,1,0,100.00%
xue.zerobo.ml,1,0.00%,1,0,100.00%
v2hk3-ws-tls.ytv2line.top,1,0.00%,1,0,100.00%
b.scorecardresearch.com,1,0.00%,1,0,100.00%
widget-api.heweather.net,1,0.00%,1,0,100.00%
38.push2.eastmoney.com,1,0.00%,2,1,50.00%
3.push2.eastmoney.com,1,0.00%,2,1,50.00%
94.newspush.eastmoney.com,1,0.00%,1,0,100.00%
86.newspush.eastmoney.com,1,0.00%,1,0,100.00%
ns1.canonical.com,1,0.00%,1,0,100.00%
abacus.ideocambridge.com,1,0.00%,1,0,100.00%
s02.solidfilesusercontent.com,1,0.00%,1,0,100.00%
crl-symcprod.digicert.com,1,0.00%,2,1,50.00%
cname.micloud.xiaomi.net,1,0.00%,1,0,100.00%
al.p2p.huya.com,1,0.00%,10,9,10.00%
connectivity-check.ubuntu.com.HOST,1,0.00%,1,0,100.00%
smt.admaster.com.cn,1,0.00%,1,0,100.00%
dig.lianjia.com,1,0.00%,1,0,100.00%
countpvn.3g.fang.com,1,0.00%,1,0,100.00%
imap.mail-aipo.apple-dns.cn,1,0.00%,1,0,100.00%
iterable.scribd.com,1,0.00%,1,0,100.00%
imgv2-2-f.scribdassets.com,1,0.00%,1,0,100.00%
imgv2-1-f.scribdassets.com,1,0.00%,1,0,100.00%
blog.scribd.com,1,0.00%,1,0,100.00%
email.hello.scribd.com,1,0.00%,1,0,100.00%
mailgun.org,1,0.00%,1,0,100.00%
scribd.map.fastly.net,1,0.00%,3,2,33.33%
mail.secretosdemadrid.es,1,0.00%,1,0,100.00%
transkaroo.joustasie.net,1,0.00%,1,0,100.00%
u4.trakx.crim.ist,1,0.00%,1,0,100.00%
ordoelecra-blog.logdown.com,1,0.00%,1,0,100.00%
m.121du.cc,1,0.00%,1,0,100.00%
www.hp.com,1,0.00%,2,1,50.00%
1610078778.D4EE073C2A20.device.hiwifi.com,1,0.00%,1,0,100.00%
accounts.logi.com,1,0.00%,1,0,100.00%
o.ss2.us,1,0.00%,1,0,100.00%
www.weain.mil.cn,1,0.00%,1,0,100.00%
gfzscq.weain.mil.cn,1,0.00%,1,0,100.00%
ztb.weain.mil.cn,1,0.00%,1,0,100.00%
www.mod.gov.cn,1,0.00%,2,1,50.00%
offline.aps.amap.com,1,0.00%,2,1,50.00%
inst-fs-yul-prod-sfyv6gptlf-286754664.ca-central-1.elb.amazonaws.com,1,0.00%,1,0,100.00%
canvas-yul-prod-c222-1474529541.ca-central-1.elb.amazonaws.com,1,0.00%,1,0,100.00%
www.ctcbs.ximalaya.com,1,0.00%,1,0,100.00%
waws-prod-sn1-111.cloudapp.net,1,0.00%,1,0,100.00%
daycount-1450237091.cn-north-1.elb.amazonaws.com.cn,1,0.00%,1,0,100.00%
restpublicalbloadbalancer-165328169.ca-central-1.elb.amazonaws.com,1,0.00%,1,0,100.00%
www.feishu.cn.w.cdngslb.com,1,0.00%,1,0,100.00%
sf1-scmcdn-cn.feishucdn.com.wsglb0.com,1,0.00%,2,1,50.00%
na61-na62.wagbridge.alibaba.aliyun.com.gds.alibabadns.com,1,0.00%,1,0,100.00%
picwebws.pstatp.com.wsglb0.com,1,0.00%,2,1,50.00%
p3-hera.byteimg.com.w.cdngslb.com,1,0.00%,2,1,50.00%
guide-acs.m.taobao.com.gds.alibabadns.com,1,0.00%,2,1,50.00%
ironbank-guide-v6-publish.m.taobao.com,1,0.00%,2,1,50.00%
ironbank-guide-v6-publish.m.taobao.com.gds.alibabadns.com,1,0.00%,2,1,50.00%
blob.bn9prdstr08a.store.core.windows.net,1,0.00%,1,0,100.00%
wa.qq.com.sched.legopic2-dk.tdnsv6.com,1,0.00%,2,1,50.00%
xsts.auth.xboxlive.com.akadns.net,1,0.00%,1,0,100.00%
title.mgt.xboxlive.com.akadns.net,1,0.00%,2,1,50.00%
v9-be-pack.pglstatp-toutiao.com,1,0.00%,1,0,100.00%
crates.io,1,0.00%,2,1,50.00%
static.crates.io,1,0.00%,2,1,50.00%
d19xqa3lc3clo8.cloudfront.net,1,0.00%,2,1,50.00%
img.meituan.net,1,0.00%,2,1,50.00%
p1.meituan.net.cdn.dnsv1.com,1,0.00%,2,1,50.00%
p0.meituan.net.cdn.dnsv1.com,1,0.00%,2,1,50.00%
img.meituan.net.download.ks-cdn.com,1,0.00%,2,1,50.00%
k5-v6-meituan.gslb.ksyuncdn.com,1,0.00%,2,1,50.00%
46kwytew.sched.skalego-dk.tdnsstic1.cn,1,0.00%,2,1,50.00%
meituan.sched.skalego-dk.tdnsstic1.cn,1,0.00%,2,1,50.00%
static.zdassets.com,1,0.00%,1,0,100.00%
certs-lb.apple.com.akadns.net,1,0.00%,2,1,50.00%
certs-cn-lb.apple.com.akadns.net,1,0.00%,2,1,50.00%
static-cdn.hotjar.com,1,0.00%,1,0,100.00%
ekr.zdassets.com,1,0.00%,1,0,100.00%
web.archive.org,1,0.00%,2,1,50.00%
m.sogo.com,1,0.00%,1,0,100.00%
orcid.zendesk.com,1,0.00%,1,0,100.00%
video-hw-drcn.dbankcdn.globalsign.c.cdnhwc1.cn,1,0.00%,2,1,50.00%
audio.ali.xmcdn.com,1,0.00%,2,1,50.00%
audio.ali.xmcdn.com.w.alikunlun.com,1,0.00%,2,1,50.00%
dynapix.jp,1,0.00%,1,0,100.00%
only-748571-124-16-137-11.nstool.laiqukankan.com,1,0.00%,1,0,100.00%
b.nstool.ntes53.netease.com,1,0.00%,1,0,100.00%
cambrian-images.cdn.bcebos.com.a.bdydns.com,1,0.00%,2,1,50.00%
store-drcn-hispace-dbankcloud-cn-drcn.appacc-region.dbankedge.cn,1,0.00%,1,0,100.00%
appdl6-drcn.dbankcdn.cn,1,0.00%,2,1,50.00%
appdl-3-drcn.dbankcdn.com,1,0.00%,1,0,100.00%
appdl6-drcn.dbankcdn.80800000.globalsign.c.cdnhwc1.cn,1,0.00%,2,1,50.00%
appdl-3-drcn.dbankcdn.com.a.bdydns.com,1,0.00%,1,0,100.00%
d3azwz0fcakc5.cloudfront.net,1,0.00%,1,0,100.00%
vpn.nju.edu.cn,1,0.00%,1,0,100.00%
opencdnhwapp.jomodns.com,1,0.00%,1,0,100.00%
mg.uu.163.com.w.kunluncan.com,1,0.00%,1,0,100.00%
trackermore.dler.org,1,0.00%,1,0,100.00%
t02img.yangkeduo.com,1,0.00%,2,1,50.00%
apps.itunes.apple.com.edgekey.net,1,0.00%,2,1,50.00%
sf-api-token-service-lb.itunes-apple.com.akadns.net,1,0.00%,2,1,50.00%
pd-cdn.itunes-apple.com.akadns.net,1,0.00%,2,1,50.00%
v83-017.douyinvod.com.w.cdngslb.com,1,0.00%,1,0,100.00%
n.cg.163.com,1,0.00%,1,0,100.00%
v9-cold1.douyinvod.com,1,0.00%,2,1,50.00%
v9-cold1.douyinvod.com.bsgslb.com,1,0.00%,2,1,50.00%
zttvc2.v.bsgslb.com,1,0.00%,2,1,50.00%
su-cdn.itunes-apple.com.akadns.net,1,0.00%,2,1,50.00%
astraeus.feralhosting.com,1,0.00%,1,0,100.00%
mstatic.cdn.bcebos.com,1,0.00%,2,1,50.00%
mstatic.cdn.bcebos.com.a.bdydns.com,1,0.00%,2,1,50.00%
med-fe.cdn.bcebos.com.a.bdydns.com,1,0.00%,2,1,50.00%
tg35.syscdn.zjsxlt.com,1,0.00%,1,0,100.00%
cambrian-images.cdn.bcebos.com,1,0.00%,4,3,25.00%
i0.hdslb.com.download.ks-cdn.com,1,0.00%,2,1,50.00%
f2.video.weibocdn.com,1,0.00%,2,1,50.00%
f2video.gslb.sinaedge.com,1,0.00%,2,1,50.00%
yunxin-data-live-126-net-yq.ntes53.netease.com,1,0.00%,1,0,100.00%
downloaddispatch-cdn.itunes-apple.com.akadns.net,1,0.00%,2,1,50.00%
se-edge.itunes-apple.com.akadns.net,1,0.00%,2,1,50.00%
iosapps.itunes.g.aaplimg.com,1,0.00%,2,1,50.00%
iosapps-tp.g.aaplimg.com,1,0.00%,1,0,100.00%
iosapps-cn-lb.dl-apple.com.akadns.net,1,0.00%,1,0,100.00%
iosapps.itunes.apple.com.download.ks-cdn.com,1,0.00%,1,0,100.00%
notifications.liquipedia.net,1,0.00%,1,0,100.00%
fmf.fe.apple-dns.cn,1,0.00%,1,0,100.00%
login.sina.com.cn,1,0.00%,1,0,100.00%
jcew-748738.pilot-supports.net,1,0.00%,1,0,100.00%
media-shxiya-yijia10.sn3oss.ctyunxs.cn,1,0.00%,1,0,100.00%
max-dr.mdvdns.qihucdn.cn,1,0.00%,1,0,100.00%
math.jianshu.com,1,0.00%,1,0,100.00%
cloudtim.msf.tencent-cloud.com,1,0.00%,1,0,100.00%
home-store-packages.uniontech.com,1,0.00%,1,0,100.00%
kuaishou.httpdns.pro,1,0.00%,1,0,100.00%
wx.conn.wemeet.tencent.com,1,0.00%,1,0,100.00%
hw2.a.kwimgs.com,1,0.00%,2,1,50.00%
1610071603.D4EE073C2A20.device.hiwifi.com,1,0.00%,1,0,100.00%
mon11-misc-lf.fqnovel.com,1,0.00%,2,1,50.00%
bsync3-normal-lf.zijieapi.com,1,0.00%,2,1,50.00%
d2f1dr3088xot5.cloudfront.net,1,0.00%,2,1,50.00%
dralot.ie.sogou.com,1,0.00%,1,0,100.00%
ns2.sap-ag.de,1,0.00%,1,0,100.00%
ns4.sap-ag.de,1,0.00%,1,0,100.00%
ns.sap-ag.de,1,0.00%,1,0,100.00%
ns3.sap-ag.de,1,0.00%,1,0,100.00%
stocks-edge.news.apple-dns.net,1,0.00%,1,0,100.00%
p207-caldav.icloud.com.cn,1,0.00%,1,0,100.00%
mdm.oneplus.net,1,0.00%,1,0,100.00%
cnc.hub5pnc.sandai.net,1,0.00%,1,0,100.00%
fixed-187-189-37-179.totalplay.net,1,0.00%,1,0,100.00%
cn-legal.battlenet.com.cn,1,0.00%,1,0,100.00%
www.battlenet.com.cn,1,0.00%,1,0,100.00%
smtpdm.aliyun.com.gds.alibabadns.com,1,0.00%,1,0,100.00%
salesforce1andriod.herokuapp.com,1,0.00%,1,0,100.00%
gameplayapi.intel.com,1,0.00%,1,0,100.00%
sns-video-hw.xhscdn.com,1,0.00%,2,1,50.00%
vi.xiaohongshu.com,1,0.00%,1,0,100.00%
y.gtimg.cn,1,0.00%,1,0,100.00%
vd3.bdstatic.com,1,0.00%,1,0,100.00%
ad.mrtnsvr.com,1,0.00%,1,0,100.00%
tags.bluekai.com,1,0.00%,1,0,100.00%
sportradarserving.com,1,0.00%,1,0,100.00%
u.ipw.metadsp.co.uk,1,0.00%,1,0,100.00%
www.thirdparty.com,1,0.00%,1,0,100.00%
s.cpx.to,1,0.00%,1,0,100.00%
oxp.mxptint.net,1,0.00%,1,0,100.00%
fuckwenku8.herokuapp.com,1,0.00%,1,0,100.00%
vdn6.vzuu.com,1,0.00%,2,1,50.00%
comapi.izaodao.com,1,0.00%,1,0,100.00%
keeperapi.izaodao.com,1,0.00%,1,0,100.00%
5al6ec7yfhqkwikrip63inxedk2mcuub.yundunwaf4.com,1,0.00%,1,0,100.00%
iknow.n.shifen.com,1,0.00%,3,2,33.33%
iknowstatic.jomodns.com,1,0.00%,1,0,100.00%
opencdn00.jomodns.com,1,0.00%,1,0,100.00%
opencdnbdfctn.jomodns.com,1,0.00%,1,0,100.00%
mountain.zhidao.baidu.com.cname3466.yjs-cdn.com,1,0.00%,1,0,100.00%
kstjorp.n.shifen.com,1,0.00%,1,0,100.00%
d422.upstore.net,1,0.00%,1,0,100.00%
ebrualoglu.co.uk,1,0.00%,1,0,100.00%
cognito-identity.us-east-1.amazonaws.com,1,0.00%,4,3,25.00%
jp1.chuqiangtou.net,1,0.00%,1,0,100.00%
weather.noaa.gov,1,0.00%,1,0,100.00%
mail.cryptosweethearts.com,1,0.00%,1,0,100.00%
r1---sn-2x3elnee.gvt1.com,1,0.00%,1,0,100.00%
fsoe.happyelements.cn,1,0.00%,1,0,100.00%
tw01.graniterapids.com,1,0.00%,1,0,100.00%
jp30.graniterapids.com,1,0.00%,1,0,100.00%
ckjelite.classic.kicksite.net,1,0.00%,1,0,100.00%
mail.cisitaronseagy.cf,1,0.00%,1,0,100.00%
decotv.rockpie.com,1,0.00%,1,0,100.00%
hw.pull.yximgs.com,1,0.00%,2,1,50.00%
onedscolprdwus13.westus.cloudapp.azure.com,1,0.00%,1,0,100.00%
clock.cuhk.edu.hk,1,0.00%,1,0,100.00%
clock.redhat.com,1,0.00%,1,0,100.00%
weu010-breeziest-in.cloudapp.net,1,0.00%,1,0,100.00%
setup.icloud.com,1,0.00%,2,1,50.00%
phsle5-std04.oray.net,1,0.00%,1,0,100.00%
cb10bdfbd90f88db560d0ad1e8f78722.dlied1.cdntips.net,1,0.00%,1,0,100.00%
mapp.3g.qq.com,1,0.00%,1,0,100.00%
tp-b.pinduoduo.com,1,0.00%,1,0,100.00%
i.guancha.cn,1,0.00%,2,1,50.00%
r.avlab.qq.com,1,0.00%,1,0,100.00%
dsum.casalemedia.com,1,0.00%,1,0,100.00%
i.tq121.com.cn,1,0.00%,1,0,100.00%
pic.weather.com.cn,1,0.00%,1,0,100.00%
i.weather.com.cn,1,0.00%,1,0,100.00%
wgeo.weather.com.cn,1,0.00%,1,0,100.00%
d1.weather.com.cn,1,0.00%,1,0,100.00%
tb5.bdstatic.com,1,0.00%,1,0,100.00%
tb3.bdstatic.com,1,0.00%,1,0,100.00%
tb1.bdstatic.com,1,0.00%,1,0,100.00%
imgsa.baidu.com,1,0.00%,1,0,100.00%
ecma.bdimg.com,1,0.00%,1,0,100.00%
tieba-ares.cdn.bcebos.com,1,0.00%,1,0,100.00%
tiebapic.baidu.com,1,0.00%,1,0,100.00%
tb2.bdstatic.com,1,0.00%,1,0,100.00%
ns-strategy.cdn.bcebos.com,1,0.00%,1,0,100.00%
sofire.baidu.com,1,0.00%,3,2,33.33%
wappass.baidu.com,1,0.00%,2,1,50.00%
ppui-static-pc.cdn.bcebos.com,1,0.00%,1,0,100.00%
mediago-static.cdn.bcebos.com,1,0.00%,1,0,100.00%
client.uu.me,1,0.00%,1,0,100.00%
dss3.baidu.com,1,0.00%,1,0,100.00%
e.so.com,1,0.00%,1,0,100.00%
repos.os.nfschina.com,1,0.00%,1,0,100.00%
dnkeeper.hicloud.com,1,0.00%,1,0,100.00%
contentcenter-drcn.dbankcdn.com,1,0.00%,2,1,50.00%
logbak.hicloud.com,1,0.00%,1,0,100.00%
h5hosting-drcn.dbankcdn.cn,1,0.00%,2,1,50.00%
d2335eacoaawg9.cloudfront.net,1,0.00%,1,0,100.00%
web-seminare.beton-webakademie.36chambers.de,1,0.00%,1,0,100.00%
api.777ppt.com,1,0.00%,1,0,100.00%
video.weibo.com,1,0.00%,1,0,100.00%
app2.myzaker.com.w.cdngslb.com,1,0.00%,1,0,100.00%
app.myzaker.com.w.kunlungr.com,1,0.00%,1,0,100.00%
zkres.myzaker.com.w.kunlunhuf.com,1,0.00%,1,0,100.00%
ggs.myzaker.com,1,0.00%,1,0,100.00%
syz.phic.org.cn,1,0.00%,1,0,100.00%
r.img.cctvpic.com,1,0.00%,2,1,50.00%
p3.img.cctvpic.com,1,0.00%,2,1,50.00%
sep.ucas.ac.cn,1,0.00%,2,1,50.00%
cdn.icloud-content.com,1,0.00%,2,1,50.00%
i-chi01p-cor001.api.p001.1drv.com,1,0.00%,1,0,100.00%
web.da.mgtv.com,1,0.00%,1,0,100.00%
v2.da.mgtv.com,1,0.00%,1,0,100.00%
ys.da.mgtv.com,1,0.00%,1,0,100.00%
vt.ipinyou.com,1,0.00%,1,0,100.00%
vectormap0.bdimg.com,1,0.00%,2,1,50.00%
worldwide.sogou.com,1,0.00%,1,0,100.00%
static.pddpic.com,1,0.00%,2,1,50.00%
img.pddpic.com,1,0.00%,2,1,50.00%
th.yangkeduo.com,1,0.00%,1,0,100.00%
video3.pddpic.com,1,0.00%,2,1,50.00%
avatar2-1.pddpic.com,1,0.00%,2,1,50.00%
video-snapshot.pddpic.com,1,0.00%,2,1,50.00%
transfer.ceping.com,1,0.00%,1,0,100.00%
liangcang-material.alicdn.com,1,0.00%,2,1,50.00%
citicbank.ceping.com,1,0.00%,1,0,100.00%
stcms.beisen.com,1,0.00%,1,0,100.00%
image.dayi.org.cn,1,0.00%,1,0,100.00%
torrent-team.net,1,0.00%,2,1,50.00%
forum.qt.io,1,0.00%,1,0,100.00%
eo.dbpedia.org,1,0.00%,1,0,100.00%
deff.nelreports.net,1,0.00%,1,0,100.00%
dl.fedoraproject.org,1,0.00%,1,0,100.00%
c-uaa.if.iqiyi.com,1,0.00%,1,0,100.00%
bleisure.ba.com,1,0.00%,1,0,100.00%
upd2.sangfor.com.cn,1,0.00%,1,0,100.00%
upd2.sangfor.com.cn.localdomain,1,0.00%,1,0,100.00%
rgmb.classic.kicksite.net,1,0.00%,1,0,100.00%
g.msn.com,1,0.00%,2,1,50.00%
www.catererglobal.com,1,0.00%,1,0,100.00%
images-eu.ssl-images-amazon.com,1,0.00%,1,0,100.00%
cbwh5s4.i3zmbs.com,1,0.00%,1,0,100.00%
activation.unity.cn,1,0.00%,1,0,100.00%
23-92-30-53.3f5ffcbecff340969874c9eb90a37eeb.plex.direct,1,0.00%,1,0,100.00%
tracker.minglong.org,1,0.00%,1,0,100.00%
tracker.theempire.bz,1,0.00%,1,0,100.00%
www.theplace.bz,1,0.00%,1,0,100.00%
onedscolprdjpw03.japanwest.cloudapp.azure.com,1,0.00%,1,0,100.00%
megaone.acrothemes.com,1,0.00%,1,0,100.00%
e1553.dspg.akamaiedge.net,1,0.00%,2,1,50.00%
vol3rd.herokuapp.com,1,0.00%,1,0,100.00%
ocsp-ds.ws.symantec.com.edgekey.net,1,0.00%,2,1,50.00%
link-dit3la5z.gaapqcloud.com,1,0.00%,1,0,100.00%
oracle-gia-fhc-free.wisdomfree.tk,1,0.00%,1,0,100.00%
70.newspush.eastmoney.com,1,0.00%,1,0,100.00%
15.newspush.eastmoney.com,1,0.00%,1,0,100.00%
96.push2.eastmoney.com,1,0.00%,2,1,50.00%
29.push2.eastmoney.com,1,0.00%,2,1,50.00%
66.newspush.eastmoney.com,1,0.00%,1,0,100.00%
57.newspush.eastmoney.com,1,0.00%,1,0,100.00%
jp.567568.ml,1,0.00%,1,0,100.00%
e2c53.gcp.gvt2.com,1,0.00%,1,0,100.00%
hr10.graniterapids.com,1,0.00%,1,0,100.00%
sg07.graniterapids.com,1,0.00%,1,0,100.00%
jp29.graniterapids.com,1,0.00%,1,0,100.00%
fr01.graniterapids.com,1,0.00%,1,0,100.00%
itunes.com,1,0.00%,1,0,100.00%
google.co.jp,1,0.00%,2,1,50.00%
v2ray.papio.cf,1,0.00%,1,0,100.00%
archive1.kylinos.cn,1,0.00%,1,0,100.00%
staging.curbjam.com,1,0.00%,1,0,100.00%
eloraartigosmisticos.com.br,1,0.00%,1,0,100.00%
upgrades.verysync.cn,1,0.00%,2,1,50.00%
prometheus.findmykids.app,1,0.00%,1,0,100.00%
autopush.prod.mozaws.NET,1,0.00%,1,0,100.00%
blobcollector.events.data.trafficmanager.net,1,0.00%,1,0,100.00%
denis.stalker.upeer.me,1,0.00%,1,0,100.00%
glw-old.kg-mtl.com,1,0.00%,1,0,100.00%
62.push2.eastmoney.com,1,0.00%,2,1,50.00%
tw04.graniterapids.com,1,0.00%,1,0,100.00%
1608223856.D4EE071FA772.device.hiwifi.com,1,0.00%,1,0,100.00%
firehose.us-east-1.amazonaws.com,1,0.00%,1,0,100.00%
dl.dell.com,1,0.00%,2,1,50.00%
1608223922.D4EE071FA772.device.hiwifi.com,1,0.00%,1,0,100.00%
repositorynocdn.eset.com,1,0.00%,1,0,100.00%
wns2-sg2p.wns.windows.com,1,0.00%,1,0,100.00%
business.wedesignitall.com,1,0.00%,1,0,100.00%
1608227385.D4EE071FA772.device.hiwifi.com,1,0.00%,1,0,100.00%
dl1.gj.qq.com,1,0.00%,2,1,50.00%
webmail.micolegio.cl,1,0.00%,1,0,100.00%
webmail.sjbnrexcellent.ga,1,0.00%,1,0,100.00%
swr.cn-north-4.myhuaweicloud.com,1,0.00%,1,0,100.00%
1.uk.pool.ntp.org,1,0.00%,1,0,100.00%
techcrunch.com.anum.clonezone.link,1,0.00%,1,0,100.00%
my.hideu.org,1,0.00%,1,0,100.00%
bnz05pap002.storage.live.com,1,0.00%,2,1,50.00%
prod-addinsinstallation.omexexternallfb.office.net.akadns.net,1,0.00%,1,0,100.00%
live-trace.bilibili.com,1,0.00%,2,1,50.00%
learn.wisely.academy,1,0.00%,1,0,100.00%
bili.acglego-dk.sched.tdnsv2.com,1,0.00%,2,1,50.00%
apkgf5hg.sched.v1hw-dk.tdnsvod1.cn.cvod.vwnti.yrzhcloud.cn,1,0.00%,2,1,50.00%
ins-2ybret5v.ias.tencent-cloud.net,1,0.00%,3,2,33.33%
cn-jiangsu001-g3.edge.dbankedge.cn,1,0.00%,1,0,100.00%
upfile1.hicloud.com,1,0.00%,1,0,100.00%
hovv.yilanvaas.com.bsclink.cn,1,0.00%,2,1,50.00%
pf001.v.bsclink.cn,1,0.00%,2,1,50.00%
e11271.dscg.akamaiedge.net,1,0.00%,2,1,50.00%
www-dida-313720269.cn-north-1.elb.amazonaws.com.cn,1,0.00%,1,0,100.00%
voipfinderliveplay.wxqcloud.qq.com,1,0.00%,2,1,50.00%
voipfinderliveplay.wxqcloud.qq.com.l4vip-dk.sched.dcloudlive.com.clive.cdnjn01.cenvandns.com,1,0.00%,2,1,50.00%
voipfinderliveplay.wxqcloud.qq.com.l4vip-dk.sched.dcloudlive.com.clive.cdncloud.idc400.com,1,0.00%,2,1,50.00%
67.newspush.eastmoney.com,1,0.00%,1,0,100.00%
91.push2.eastmoney.com,1,0.00%,2,1,50.00%
20.newspush.eastmoney.com,1,0.00%,1,0,100.00%
17.push2.eastmoney.com,1,0.00%,2,1,50.00%
secure.globalsign.com,1,0.00%,2,1,50.00%
api-eu.mixpanel.com,1,0.00%,1,0,100.00%
www.casmooc.cn,1,0.00%,1,0,100.00%
9i61iidn1kfvp3fscs3p6k2prqrjri086di17hu4lv85hlb60afvuna1.qc.x.bsgslb.cn,1,0.00%,1,0,100.00%
bt-tracker.gamexp.ru,1,0.00%,1,0,100.00%
suisunrcd.systemcatalog.net,1,0.00%,1,0,100.00%
tracker.gigatorrents.ws,1,0.00%,1,0,100.00%
updates.3t.io,1,0.00%,1,0,100.00%
hr01.graniterapids.com,1,0.00%,1,0,100.00%
academy-di-vincenzo.socialacademy.me,1,0.00%,1,0,100.00%
ppt.pptsupermarket.com,1,0.00%,1,0,100.00%
mail.hostcurrchlorov.tk,1,0.00%,1,0,100.00%
gsp10-ssl.ls-apple.com.akadns.net,1,0.00%,1,0,100.00%
api.51ifonts.com,1,0.00%,1,0,100.00%
Telemetry-alb-Prod-1043652844.eu-central-1.elb.amazonaws.com,1,0.00%,1,0,100.00%
h-adashx.ut.taobao.com.gds.alibabadns.com,1,0.00%,1,0,100.00%
slp2p-east-std1017.oray.net,1,0.00%,1,0,100.00%
www.zhihu.com.ipv6.dsa.dnsv1.com,1,0.00%,2,1,50.00%
alb-fqpg5b5fb7n0izq8et.cn-hangzhou.alb.aliyuncs.com,1,0.00%,1,0,100.00%
unpkg.zhimg.com.w.kunlunar.com,1,0.00%,2,1,50.00%
pf2sg2-edge.activity.windows.com.akadns.net,1,0.00%,1,0,100.00%
allall01.n.shifen.com,1,0.00%,2,1,50.00%
3c1w7cb7.sched.vip-dk.tdnsvod1.cn,1,0.00%,2,1,50.00%
1610401952.D4EE073396E8.device.hiwifi.com,1,0.00%,1,0,100.00%
dsp.ads.umeng.com,1,0.00%,2,1,50.00%
mqtt-internal-public.zhihu.com,1,0.00%,2,1,50.00%
mqtt-internal-public.zhihu.com.dsa.dnsv1.com,1,0.00%,2,1,50.00%
517ap08y.sched.d0-dk.tdnsdp1.cn,1,0.00%,2,1,50.00%
dsm01pcor007-meta.fe.1drv.com,1,0.00%,2,1,50.00%
odc-dsm01pap007-meta-geo.onedrive.akadns.net,1,0.00%,2,1,50.00%
odc-dsm01pap007-meta-brs.onedrive.akadns.net,1,0.00%,2,1,50.00%
dsm01pcor007-meta.be.1drv.com.l-0003.dc-msedge.net.l-0003.l-msedge.net,1,0.00%,2,1,50.00%
magnet.arthivap.tk,1,0.00%,1,0,100.00%
msgapi.teams.live.com,1,0.00%,1,0,100.00%
rili.wps.cn,1,0.00%,1,0,100.00%
sfxtcs.mynatapp.cc,1,0.00%,1,0,100.00%
api.weixin.qq.com,1,0.00%,1,0,100.00%
ban.zhengsj.top,1,0.00%,1,0,100.00%
ex01.ios.ac.cn,1,0.00%,1,0,100.00%
www.goodsync.com,1,0.00%,1,0,100.00%
provision.ccs.mcafee.com,1,0.00%,1,0,100.00%
plus.google.com,1,0.00%,2,1,50.00%
www.amazon.cn,1,0.00%,1,0,100.00%
mademistakes.com,1,0.00%,2,1,50.00%
www.reddit.com,1,0.00%,2,1,50.00%
www4.comp.polyu.edu.hk,1,0.00%,1,0,100.00%
it.alljournals.cn,1,0.00%,1,0,100.00%
www.jsmastery.pro,1,0.00%,1,0,100.00%
widget.trustpilot.com,1,0.00%,1,0,100.00%
code.tidio.co,1,0.00%,1,0,100.00%
x22npxvj.apicdn.sanity.io,1,0.00%,1,0,100.00%
www.xbbshuwu.com,1,0.00%,1,0,100.00%
mq.focustodo.net,1,0.00%,1,0,100.00%
doh.pub,1,0.00%,1,0,100.00%
cl2-cdn.origin-apple.com.akadns.net,1,0.00%,2,1,50.00%
console-api.apipost.cn,1,0.00%,1,0,100.00%
popup.browser.360.cn,1,0.00%,1,0,100.00%
nl6.chuqianglai.com,1,0.00%,1,0,100.00%
avator.eastmoney.com.m.alikunlun.com,1,0.00%,2,1,50.00%
onedscolprdjpw02.japanwest.cloudapp.azure.com,1,0.00%,1,0,100.00%
hk-vip001.taboola.com,1,0.00%,1,0,100.00%
datasink.hm.com.cn,1,0.00%,1,0,100.00%
wWW.vod.LXdNs.COM,1,0.00%,2,1,50.00%
content.fe.apple-dns.cn,1,0.00%,1,0,100.00%
se2.itunes.apple.com,1,0.00%,2,1,50.00%
v2tw.51717277.tk,1,0.00%,1,0,100.00%
smtp.nfs-china.com,1,0.00%,1,0,100.00%
lcdn-locator-usms11.apple.com.akadns.net,1,0.00%,1,0,100.00%
ss.wlmnzf.xyz,1,0.00%,2,1,50.00%
exp.mysmth.net,1,0.00%,1,0,100.00%
sqt.gtimg.cn,1,0.00%,1,0,100.00%
s3-us-west-2.amazonaws.com,1,0.00%,1,0,100.00%
e.dop.mediav.com,1,0.00%,1,0,100.00%
ss.shanhutech.cn,1,0.00%,1,0,100.00%
wpapi.shanhutech.cn,1,0.00%,1,0,100.00%
hys.people-health.cn,1,0.00%,1,0,100.00%
qr04.cn,1,0.00%,1,0,100.00%
www.hailiangxinxi.com,1,0.00%,1,0,100.00%
m.mysmth.net,1,0.00%,1,0,100.00%
twgame05.graniterapids.com,1,0.00%,1,0,100.00%
hr14.graniterapids.com,1,0.00%,1,0,100.00%
dsany3.sgnic.sg,1,0.00%,2,1,50.00%
dsany.sgnic.sg,1,0.00%,2,1,50.00%
dsany2.sgnic.sg,1,0.00%,2,1,50.00%
pow7.com,1,0.00%,2,1,50.00%
partnerschule.corona-school.de,1,0.00%,1,0,100.00%
canonical-bos01.cdn.snapcraftcontent.com,1,0.00%,1,0,100.00%
chatwootwong.herokuapp.com,1,0.00%,1,0,100.00%
dl.cloudsmith.io,1,0.00%,2,1,50.00%
puf6no0k.nodedata.net,1,0.00%,1,0,100.00%
uu.update.netease.com,1,0.00%,1,0,100.00%
clientnotification-userprodscus1-4.servicebus.windows.net,1,0.00%,1,0,100.00%
mail.ios.ac.cn,1,0.00%,1,0,100.00%
vulnerability-search.europe-north1-gke.intellij.net,1,0.00%,1,0,100.00%
bifrost-public-v4.gw.postman.com,1,0.00%,2,1,50.00%
sentry-app.postmanlabs.com,1,0.00%,1,0,100.00%
na61-na62.wagbridge.work.alibabacorp.com.gds.alibabadns.com,1,0.00%,1,0,100.00%
pics7.baidu.com,1,0.00%,1,0,100.00%
hao.360.com,1,0.00%,1,0,100.00%
hao2.qhimg.com,1,0.00%,1,0,100.00%
s5.ssl.qhres2.com,1,0.00%,2,1,50.00%
hao4.qhimg.com,1,0.00%,2,1,50.00%
guess.mediav.com,1,0.00%,3,2,33.33%
rcmdsites.dhrest.com,1,0.00%,1,0,100.00%
hao.ssl.dhrest.com,1,0.00%,1,0,100.00%
query.rec.360.cn,1,0.00%,1,0,100.00%
i.dhrest.com,1,0.00%,1,0,100.00%
cube.dhrest.com,1,0.00%,1,0,100.00%
show-g.mediav.com,1,0.00%,1,0,100.00%
cdn.weather.hao.360.cn,1,0.00%,1,0,100.00%
smart.sug.so.com,1,0.00%,1,0,100.00%
p7.img.360kuai.com,1,0.00%,2,1,50.00%
imgx.mediav.com,1,0.00%,2,1,50.00%
mpadmin.browser.360.cn,1,0.00%,1,0,100.00%
s1.ssl.qhimg.com,1,0.00%,3,2,33.33%
top.ssl.dhrest.com,1,0.00%,1,0,100.00%
app.terra-master.com,1,0.00%,1,0,100.00%
git.qemu.org,1,0.00%,1,0,100.00%
1610333521.D4EE073396E8.device.hiwifi.com,1,0.00%,1,0,100.00%
1610333547.D4EE073396E8.device.hiwifi.com,1,0.00%,1,0,100.00%
1610333573.D4EE073396E8.device.hiwifi.com,1,0.00%,1,0,100.00%
sunwk.fun,1,0.00%,1,0,100.00%
sec.cmbchina.com,1,0.00%,1,0,100.00%
z163picipv6.v.bsclink.cn,1,0.00%,2,1,50.00%
ac.dun.163yun.com,1,0.00%,2,1,50.00%
WwW.VOd.LXDnS.cOM,1,0.00%,2,1,50.00%
tranSIT1.WSloG.chiNAnetcEnTER.CoM,1,0.00%,1,0,100.00%
p215-keyvalueservice.icloud.com.cn,1,0.00%,1,0,100.00%
ifu.nobelpearl.zeramex.com,1,0.00%,1,0,100.00%
d5nxst8fruw4z.cloudfront.net,1,0.00%,1,0,100.00%
mail.harndislelira.tk,1,0.00%,1,0,100.00%
e13363.dsca.akamaiedge.net,1,0.00%,2,1,50.00%
a1091.dscb.akamai.net,1,0.00%,2,1,50.00%
a1091.dscb.akamai.net.0.1.cn.akamaitech.net,1,0.00%,2,1,50.00%
dev.approveme.me,1,0.00%,1,0,100.00%
metrika.1site.eu,1,0.00%,1,0,100.00%
in2-gw2-01-ce7dd027.eastus2.cloudapp.azure.com,1,0.00%,1,0,100.00%
retracker.maxnet.ua,1,0.00%,1,0,100.00%
dm2306.storage.live.com,1,0.00%,2,1,50.00%
jp07.graniterapids.com,1,0.00%,1,0,100.00%
bahamasrealty.luxuryrealestate.com,1,0.00%,1,0,100.00%
slp2p-east-std1061.oray.net,1,0.00%,1,0,100.00%
i-sat02p-cor005.api.p001.1drv.com,1,0.00%,1,0,100.00%
weu07-breeziest-in.cloudapp.net,1,0.00%,1,0,100.00%
go.gunicom.ml,1,0.00%,1,0,100.00%
prediovilla-sw001.website.smartoo.pandevstudio.com,1,0.00%,1,0,100.00%
p43-caldav.icloud.com,1,0.00%,2,1,50.00%
x.spac.me,1,0.00%,1,0,100.00%
snsvideo.c2c.wechat.com,1,0.00%,1,0,100.00%
onedscolprdfrc02.francecentral.cloudapp.azure.com,1,0.00%,1,0,100.00%
tripod.westfly.ml,1,0.00%,1,0,100.00%
ns4.etisalatdomains.ae,1,0.00%,1,0,100.00%
telecommand.telemetry.microsoft.com,1,0.00%,1,0,100.00%
net-2-42-138-122.cust.vodafonedsl.it,1,0.00%,1,0,100.00%
mail.alkuhaimi.com,1,0.00%,1,0,100.00%
repo.fdzh.org,1,0.00%,2,1,50.00%
1.debian.pool.ntp.org,1,0.00%,1,0,100.00%
flowcontroll.dcdn.sandai.net,1,0.00%,1,0,100.00%
greatest-side-violet.discover.quiknode.pro,1,0.00%,1,0,100.00%
safe.track.uc.360.cn,1,0.00%,1,0,100.00%
d8fajseshwsed.cloudfront.net,1,0.00%,1,0,100.00%
66.push2.eastmoney.com,1,0.00%,1,0,100.00%
58.push2.eastmoney.com,1,0.00%,1,0,100.00%
97.newspush.eastmoney.com,1,0.00%,1,0,100.00%
30.push2.eastmoney.com,1,0.00%,1,0,100.00%
56.newspush.eastmoney.com,1,0.00%,1,0,100.00%
42.push2.eastmoney.com,1,0.00%,1,0,100.00%
72.newspush.eastmoney.com,1,0.00%,1,0,100.00%
37.newspush.eastmoney.com,1,0.00%,1,0,100.00%
1608241907.D4EE071FA772.device.hiwifi.com,1,0.00%,1,0,100.00%
pauldebevec.herokuapp.com,1,0.00%,1,0,100.00%
plfz.herokuapp.com,1,0.00%,1,0,100.00%
atm-fp-direct.office.com,1,0.00%,2,1,50.00%
webmail.padikkattugal.org,1,0.00%,1,0,100.00%
online.equipe.com,1,0.00%,1,0,100.00%
krgame02.graniterapids.com,1,0.00%,1,0,100.00%
sg01.graniterapids.com,1,0.00%,1,0,100.00%
hg03.ptrecord.com,1,0.00%,1,0,100.00%
amiunique.org,1,0.00%,1,0,100.00%
cds.apple.com.akadns.net,1,0.00%,1,0,100.00%
bench.utorrent.com,1,0.00%,2,1,50.00%
slp2p-east-std08.oray.net,1,0.00%,1,0,100.00%
staging.steamer10theatre.org,1,0.00%,1,0,100.00%
mail.ersitaronseagy.ml,1,0.00%,1,0,100.00%
api.elisiapp.com,1,0.00%,1,0,100.00%
iberdrola.optimization.energy,1,0.00%,1,0,100.00%
mail.4mcollision.net,1,0.00%,1,0,100.00%
onedscolprdneu04.northeurope.cloudapp.azure.com,1,0.00%,1,0,100.00%
t.publictracker.xyz,1,0.00%,2,1,50.00%
v2oracle.catv2.cf,1,0.00%,1,0,100.00%
deb.opera.com,1,0.00%,1,0,100.00%
g-aicloud.alibaba.com,1,0.00%,1,0,100.00%
secgw-default.wagbridge.ws.alibabacorp.com.gds.alibabadns.com,1,0.00%,1,0,100.00%
pccw07.graniterapids.com,1,0.00%,1,0,100.00%
us02.graniterapids.com,1,0.00%,1,0,100.00%
25.push2.eastmoney.com,1,0.00%,2,1,50.00%
36.push2.eastmoney.com,1,0.00%,2,1,50.00%
32.newspush.eastmoney.com,1,0.00%,1,0,100.00%
50.newspush.eastmoney.com,1,0.00%,1,0,100.00%
31.newspush.eastmoney.com,1,0.00%,1,0,100.00%
24.newspush.eastmoney.com,1,0.00%,1,0,100.00%
random.osu.bet,1,0.00%,1,0,100.00%
w3.lopon.org.tw,1,0.00%,1,0,100.00%
collector-hpn.privacy.ghostery.net,1,0.00%,1,0,100.00%
rc10.oray.com,1,0.00%,1,0,100.00%
iepl-node-gab.wowvip.xyz,1,0.00%,1,0,100.00%
ocsp.rootg2.amazontrust.com,1,0.00%,2,1,50.00%
p4.music.126.net.163jiasu.com,1,0.00%,1,0,100.00%
p1.music.126.net.163jiasu.com,1,0.00%,2,1,50.00%
p2.music.126.net,1,0.00%,2,1,50.00%
p3.music.126.net.163jiasu.com,1,0.00%,2,1,50.00%
only-887312-159-226-95-47.nstool.zhuanzfx.com,1,0.00%,1,0,100.00%
m7.music.126.net,1,0.00%,2,1,50.00%
c.nstool.ntes53.netease.com,1,0.00%,1,0,100.00%
api.crossref.org,1,0.00%,1,0,100.00%
onedscolprduks02.uksouth.cloudapp.azure.com,1,0.00%,1,0,100.00%
5e5ccc262d4ba94a5579e843c0f7ef33.safeframe.googlesyndication.com,1,0.00%,1,0,100.00%
uapi.ads.heytapmobi.com,1,0.00%,1,0,100.00%
isecure.vivo.com.cn,1,0.00%,1,0,100.00%
proapi.azurewebsites.net,1,0.00%,1,0,100.00%
test-ic.ks3-cn-beijing.ksyun.com,1,0.00%,1,0,100.00%
CLIENTLOGVoDP2p.HaPlAT.NET,1,0.00%,1,0,100.00%
tRANSIT1.wslog.CHINANetcenTEr.COm,1,0.00%,1,0,100.00%
mamBaP2pvOdh5.8686c.cOM,1,0.00%,1,0,100.00%
perfdata.portswigger.net,1,0.00%,1,0,100.00%
www.mozilla.org,1,0.00%,1,0,100.00%
dev.trumptaxsecrets.com,1,0.00%,1,0,100.00%
js2.a.yximgs.com,1,0.00%,2,1,50.00%
scan-13.shadowserver.org,1,0.00%,1,0,100.00%
u1-000.ecukwai.com,1,0.00%,2,1,50.00%
kddi.iggfastweb.com,1,0.00%,1,0,100.00%
newyork.edgehelper.com,1,0.00%,1,0,100.00%
ip2100177549.funshion.com,1,0.00%,1,0,100.00%
assets.privacytollfree.com,1,0.00%,1,0,100.00%
api.canary.mydomastudio.com,1,0.00%,1,0,100.00%
iadsdk.qtlcdn.com,1,0.00%,1,0,100.00%
partiality.itunes.apple.com,1,0.00%,2,1,50.00%
1610333542.D4EE073396E8.device.hiwifi.com,1,0.00%,1,0,100.00%
1610333567.D4EE073396E8.device.hiwifi.com,1,0.00%,1,0,100.00%
1610333588.D4EE073396E8.device.hiwifi.com,1,0.00%,1,0,100.00%
duba-triton-srv.zhhainiao.com,1,0.00%,1,0,100.00%
e2cs54.gcp.gvt2.com,1,0.00%,1,0,100.00%
xjpd.wytf.fun,1,0.00%,1,0,100.00%
whois-upload-srv.zhhainiao.com,1,0.00%,1,0,100.00%
hexun.com,1,0.00%,1,0,100.00%
aecebpny5shcpj4v.node.ppio.cloud,1,0.00%,1,0,100.00%
cs.10jqka.com.cn,1,0.00%,1,0,100.00%
push.douban.com,1,0.00%,1,0,100.00%
market.wsskj520.cn,1,0.00%,1,0,100.00%
p6-be-pack-sign.pglstatp-toutiao.com,1,0.00%,2,1,50.00%
only-346168-159-226-95-71.nstool.321fenx.com,1,0.00%,1,0,100.00%
a.nstool.ntes53.netease.com,1,0.00%,1,0,100.00%
github.githubassets.com,1,0.00%,1,0,100.00%
toolbar3.diigo.com,1,0.00%,1,0,100.00%
twitter.com,1,0.00%,2,1,50.00%
device-provisioning.googleapis.com,1,0.00%,2,1,50.00%
ns-1189.awsdns-20.org,1,0.00%,2,1,50.00%
emiratesnbd-com.mail.protection.outlook.com,1,0.00%,1,0,100.00%
sc.icodef.com,1,0.00%,1,0,100.00%
mail.seorankerpro101.ml,1,0.00%,1,0,100.00%
d0.awsstatic.com,1,0.00%,2,1,50.00%
mail.seobacklinks151.cf,1,0.00%,1,0,100.00%
retreats.selina.com,1,0.00%,1,0,100.00%
oraybox.com,1,0.00%,1,0,100.00%
erigon-mainnet--rpc.datahub.figment.io,1,0.00%,1,0,100.00%
eulixos.com,1,0.00%,1,0,100.00%
imsp.cas.uplb.edu.ph,1,0.00%,1,0,100.00%
binapi.pcloud.com,1,0.00%,1,0,100.00%
javadl-esd-secure.oracle.com,1,0.00%,1,0,100.00%
mail.oihghhj.ga,1,0.00%,1,0,100.00%
mxa-00165c01.gslb.pphosted.com,1,0.00%,1,0,100.00%
mxb-00165c01.gslb.pphosted.com,1,0.00%,1,0,100.00%
ip.xinshuru.com,1,0.00%,1,0,100.00%
apps.game.qq.com,1,0.00%,1,0,100.00%
a.xinyue.qq.com,1,0.00%,1,0,100.00%
m.xinyue.qq.com,1,0.00%,1,0,100.00%
filerep.ff.avast.com,1,0.00%,1,0,100.00%
retracker.lanta.me,1,0.00%,1,0,100.00%
www.360.cn,1,0.00%,1,0,100.00%
tardis.tiny-vps.com,1,0.00%,1,0,100.00%
tracker.swateam.org.uk,1,0.00%,1,0,100.00%
amigacity.xyz,1,0.00%,1,0,100.00%
tracker.mg64.net,1,0.00%,1,0,100.00%
z.crazyhd.com,1,0.00%,1,0,100.00%
tracker.zer0day.to,1,0.00%,2,1,50.00%
tracker.piratepublic.com,1,0.00%,1,0,100.00%
tracker.halfchub.club,1,0.00%,1,0,100.00%
download.2.1212338883.wz.gcloudgbs.com,1,0.00%,1,0,100.00%
c.s.360.cn,1,0.00%,2,1,50.00%
api.kjjs.360.cn,1,0.00%,1,0,100.00%
yxzjfaas.native.qq.com,1,0.00%,1,0,100.00%
tracker.bluefrog.pw,1,0.00%,2,1,50.00%
tracker-2.msm8916.com,1,0.00%,1,0,100.00%
retracker.nts.su,1,0.00%,1,0,100.00%
retracker.coltel.ru,1,0.00%,1,0,100.00%
peerfect.org,1,0.00%,1,0,100.00%
oscar.reyesleon.xyz,1,0.00%,1,0,100.00%
open.facedatabg.net,1,0.00%,1,0,100.00%
ipv6.open-internet.nl,1,0.00%,1,0,100.00%
tracker.ex.ua,1,0.00%,1,0,100.00%
www.eddie4.nl,1,0.00%,1,0,100.00%
xxxtor.com,1,0.00%,1,0,100.00%
tracker.zum.bi,1,0.00%,1,0,100.00%
tracker.yoshi210.com,1,0.00%,1,0,100.00%
bt.ruxox.ru,1,0.00%,1,0,100.00%
bt2.54new.com,1,0.00%,1,0,100.00%
lbs.mail.163.com,1,0.00%,1,0,100.00%
p38-buy-lb.itunes-apple.com.akadns.net,1,0.00%,1,0,100.00%
max.mdvdns.qhcdn.com,1,0.00%,1,0,100.00%
oaagent.n.shifen.com,1,0.00%,1,0,100.00%
download.csdn.net,1,0.00%,1,0,100.00%
dl-preview.csdnimg.cn,1,0.00%,1,0,100.00%
avatar.csdn.net,1,0.00%,1,0,100.00%
mp-luckydraw1.csdn.net,1,0.00%,1,0,100.00%
img2018.cnblogs.com,1,0.00%,1,0,100.00%
images.cnblogs.com,1,0.00%,1,0,100.00%
t14.baidu.com.a.bdydns.com,1,0.00%,2,1,50.00%
t13.baidu.com.a.bdydns.com,1,0.00%,2,1,50.00%
8667973.sched.sma.tdnsstic1.cn.cjt.krcdn.idatacube.com,1,0.00%,1,0,100.00%
v1.go2yd.com.a.vvipcdn.com,1,0.00%,1,0,100.00%
rescdn.qqmail.com,1,0.00%,2,1,50.00%
res.mail.qq.com,1,0.00%,1,0,100.00%
cdnfile2.msstatic.com.w.kunlunhuf.com,1,0.00%,1,0,100.00%
app.nlark.com.w.cdngslb.com,1,0.00%,1,0,100.00%
socwxsns.video.qq.com,1,0.00%,2,1,50.00%
you.163.com,1,0.00%,1,0,100.00%
s3.music.126.net,1,0.00%,1,0,100.00%
p4.music.126.net,1,0.00%,2,1,50.00%
s5.music.126.net,1,0.00%,2,1,50.00%
s4.music.126.net,1,0.00%,1,0,100.00%
prod-dem-collector-elb-611025824.eu-west-1.elb.amazonaws.com,1,0.00%,1,0,100.00%
ads-bid.l.doubleclick.net,1,0.00%,1,0,100.00%
wileypublishing.sc.omtrdc.net,1,0.00%,1,0,100.00%
scontent.whatsapp.net,1,0.00%,2,1,50.00%
mmx-ds.cdn.whatsapp.net,1,0.00%,2,1,50.00%
3312050987-server.va.huya.com,1,0.00%,1,0,100.00%
q8daiuc5.sched.sma.tdnsstic1.cn.cjt.krcdn.idatacube.com,1,0.00%,1,0,100.00%
hk27.zxcv.men,1,0.00%,1,0,100.00%
xyclient.xyz,1,0.00%,1,0,100.00%
sax.sina.com.cn,1,0.00%,1,0,100.00%
saxn.sina.com.cn,1,0.00%,1,0,100.00%
cre.mix.sina.com.cn,1,0.00%,1,0,100.00%
s.u7u9.com.w.kunlunle.com,1,0.00%,1,0,100.00%
zxgghn.25ku.com.cname3868.yjs-cdn.com,1,0.00%,1,0,100.00%
lupic.cdn.bcebos.com.a.bdydns.com,1,0.00%,2,1,50.00%
v.agicogroup.com,1,0.00%,1,0,100.00%
mmsns.qpic.cn,1,0.00%,2,1,50.00%
only-111858-159-226-95-72.nstool.laiqukankan.com,1,0.00%,1,0,100.00%
p5.img.360kuai.com,1,0.00%,1,0,100.00%
only-794326-159-226-95-72.nstool.laiqukankan.com,1,0.00%,1,0,100.00%
p3.ssl.qhimg.com,1,0.00%,1,0,100.00%
p4.ssl.qhimg.com,1,0.00%,1,0,100.00%
only-476672-159-226-95-72.nstool.netease.com,1,0.00%,1,0,100.00%
s0.ssl.qhres2.com,1,0.00%,1,0,100.00%
s0.ssl.res.360kuai.com,1,0.00%,1,0,100.00%
static.mediav.com,1,0.00%,1,0,100.00%
s5.ssl.res.360kuai.com,1,0.00%,1,0,100.00%
s4.ssl.res.360kuai.com,1,0.00%,1,0,100.00%
p3.ssl.img.360kuai.com,1,0.00%,1,0,100.00%
p2.ssl.img.360kuai.com,1,0.00%,1,0,100.00%
p5.ssl.img.360kuai.com,1,0.00%,1,0,100.00%
p4.ssl.img.360kuai.com,1,0.00%,1,0,100.00%
kzx1.360kan.com,1,0.00%,1,0,100.00%
only-487282-159-226-95-72.nstool.zhuanzfx.com,1,0.00%,1,0,100.00%
only-733594-159-226-95-72.nstool.haowu.link,1,0.00%,1,0,100.00%
js.aq.qq.com,1,0.00%,1,0,100.00%
s3m.mediav.com,1,0.00%,1,0,100.00%
s3m.nzwgs.com,1,0.00%,1,0,100.00%
bho.xl7.xunlei.com,1,0.00%,1,0,100.00%
s9bglt9mj7fq5ifbhh3cipv3sdpi8hsj9698734ebe69smnps2uvvcve.qc.x.bsgslb.cn,1,0.00%,1,0,100.00%
hlmri2t85dljh4hai0u8mlj267upaklqroctfnpkqn22v2bde30fu8c8.qc.x.bsgslb.cn,1,0.00%,1,0,100.00%
jmy-pic.wejianzhan.com,1,0.00%,1,0,100.00%
e10198.b.akamaiedge.net,1,0.00%,1,0,100.00%
r6.mo.n.shifen.com,1,0.00%,1,0,100.00%
mime.n.shifen.com,1,0.00%,1,0,100.00%
36-courier.push.apple.com,1,0.00%,1,0,100.00%
m.ykimg.com,1,0.00%,2,1,50.00%
m.ykimg.com.w.cdngslb.com,1,0.00%,2,1,50.00%
escrowproxy.fe.apple-dns.cn,1,0.00%,1,0,100.00%
adashx4yt.m.taobao.com.gds.alibabadns.com,1,0.00%,1,0,100.00%
opencloud.wostore.cn,1,0.00%,1,0,100.00%
experiments.apple.com,1,0.00%,2,1,50.00%
ab.apple.com.akadns.net,1,0.00%,2,1,50.00%
dmd-ilp-hd.youku.com,1,0.00%,2,1,50.00%
dmd-ilp-hd.youku.com.w.cdngslb.com,1,0.00%,2,1,50.00%
zconfig.alibabausercontent.com.w.cdngslb.com,1,0.00%,2,1,50.00%
tyjr-cn-zhangjiakou.aliyun.com,1,0.00%,1,0,100.00%
ssl.adobe.com.edgekey.net,1,0.00%,2,1,50.00%
hiboardng-hicloud-com-drcn.appacc-region.dbankedge.net,1,0.00%,1,0,100.00%
amp-api.media.apple.com,1,0.00%,2,1,50.00%
amp-api.media-lb.apple.com.akadns.net,1,0.00%,2,1,50.00%
discovery-v4.syncthing.net,1,0.00%,1,0,100.00%
s.mzstatic.itunes-apple.com.akadns.net,1,0.00%,2,1,50.00%
s-china.mzstatic.itunes-apple.com.akadns.net,1,0.00%,2,1,50.00%
wd-prod-cp-as-southeast-2-fe.southeastasia.cloudapp.azure.com,1,0.00%,1,0,100.00%
waws-prod-hk1-037-8347.eastasia.cloudapp.azure.com,1,0.00%,1,0,100.00%
pc-store.mbgstore.lenovo.com.cn,1,0.00%,1,0,100.00%
dispatcher.is.autonavi.com.gds.alibabadns.com,1,0.00%,1,0,100.00%
magpie.xhscdn.com,1,0.00%,2,1,50.00%
magpie.xhscdn.com.cdn.dnsv1.com,1,0.00%,2,1,50.00%
udps.adobe.com,1,0.00%,1,0,100.00%
cc-api-teamprojects-ue1.adobe.io,1,0.00%,1,0,100.00%
api.whchenxiang.com,1,0.00%,1,0,100.00%
gzjg.casholdings.com.cn,1,0.00%,1,0,100.00%
www.rhhz.net,1,0.00%,1,0,100.00%
o4175vz27.qnssl.com,1,0.00%,2,1,50.00%
iat-api.xfyun.cn,1,0.00%,1,0,100.00%
professional-packages.chinauos.com,1,0.00%,1,0,100.00%
professional-security.chinauos.com,1,0.00%,1,0,100.00%
query.v-secure.cn,1,0.00%,1,0,100.00%
daop.xfyun.cn,1,0.00%,1,0,100.00%
cx.cnki.net,1,0.00%,1,0,100.00%
linux.ime.sogou.com,1,0.00%,1,0,100.00%
prt.jss.com.cn,1,0.00%,1,0,100.00%
pdns99.ultradns.biz,1,0.00%,1,0,100.00%
plvuwomuvgur.oneworldbuttons.com,1,0.00%,1,0,100.00%
fa000000043.resources.office.net,1,0.00%,2,1,50.00%
sg.usxx.ml,1,0.00%,1,0,100.00%
swdist.apple.com,1,0.00%,2,1,50.00%
updates.cdn-apple.com,1,0.00%,1,0,100.00%
jgwhdlb1.gaox.ml,1,0.00%,1,0,100.00%
grs-iot.platform.dbankcloud.com,1,0.00%,1,0,100.00%
memberapi.bjx.com.cn,1,0.00%,1,0,100.00%
newmail.guazi.com,1,0.00%,1,0,100.00%
solarhouse.tycg.gov.tw,1,0.00%,1,0,100.00%
d3hndmbr6e28d5.cloudfront.net,1,0.00%,1,0,100.00%
www.holidayiq.com,1,0.00%,1,0,100.00%
pcdn-proxy-crc.xxpkg.com,1,0.00%,1,0,100.00%
fennec-catalog-cdn.prod.mozaws.net,1,0.00%,1,0,100.00%
upos-sz-mirrorhwb.bilivideo.com,1,0.00%,2,1,50.00%
exo.nel.measure.office.net,1,0.00%,2,1,50.00%
dlcontrol.chub.sandai.net,1,0.00%,1,0,100.00%
p9-pc-sign.douyinpic.com,1,0.00%,2,1,50.00%
www.douyin.com,1,0.00%,1,0,100.00%
v3-web.douyinvod.com,1,0.00%,2,1,50.00%
p3-pc.douyinpic.com,1,0.00%,2,1,50.00%
jvod.300hu.com,1,0.00%,2,1,50.00%
p3-sign.douyinpic.com,1,0.00%,2,1,50.00%
m.runoob.com,1,0.00%,1,0,100.00%
adservice.google.com.hk,1,0.00%,2,1,50.00%
ssum-sec.casalemedia.com,1,0.00%,1,0,100.00%
APAC04.azure-devices.net,1,0.00%,1,0,100.00%
api.ludashi.com,1,0.00%,1,0,100.00%
www.geoplugin.net,1,0.00%,1,0,100.00%
geo.homenewtab.com,1,0.00%,1,0,100.00%
upos-sz-mirrorcos.bilivideo.com.cdn.dnsv1.com,1,0.00%,2,1,50.00%
diagnosis.ludashi.com,1,0.00%,1,0,100.00%
onedscolprdeus11.eastus.cloudapp.azure.com,1,0.00%,1,0,100.00%
xbroker-z1-i5.ngxcld.com,1,0.00%,1,0,100.00%
s.conf.wsm.360.cn,1,0.00%,2,1,50.00%
www.icbc-ltd.com,1,0.00%,2,1,50.00%
sctauditing-pa.googleapis.com,1,0.00%,1,0,100.00%
rc10-fc13.oray.com,1,0.00%,1,0,100.00%
time.pool.aliyun.com,1,0.00%,1,0,100.00%
play.kakao.com,1,0.00%,2,1,50.00%
track.tiara.daum.net,1,0.00%,2,1,50.00%
84.newspush.eastmoney.com,1,0.00%,1,0,100.00%
18.newspush.eastmoney.com,1,0.00%,1,0,100.00%
31.push2.eastmoney.com,1,0.00%,2,1,50.00%
59.push2.eastmoney.com,1,0.00%,2,1,50.00%
74.push2.eastmoney.com,1,0.00%,2,1,50.00%
83.newspush.eastmoney.com,1,0.00%,1,0,100.00%
46.newspush.eastmoney.com,1,0.00%,1,0,100.00%
appportal2.cmy.network,1,0.00%,1,0,100.00%
imap.sina.com.cn,1,0.00%,1,0,100.00%
cdn-3.brodude.ru,1,0.00%,1,0,100.00%
www.iie.ac.cn,1,0.00%,1,0,100.00%
glb.sls.prod.dcat.dsp.trafficmanager.NET,1,0.00%,1,0,100.00%
memory.fire.skyworthdigital.jikedata.com,1,0.00%,1,0,100.00%
d3my7gygxlhw3x.cloudfront.net,1,0.00%,1,0,100.00%
twct09.graniterapids.com,1,0.00%,1,0,100.00%
fr03.graniterapids.com,1,0.00%,1,0,100.00%
order.chezgaby.ae,1,0.00%,1,0,100.00%
ru01.ptrecord.com,1,0.00%,1,0,100.00%
path3.xtracloud.net,1,0.00%,1,0,100.00%
web-img.oss-cn-hangzhou.aliyuncs.com,1,0.00%,1,0,100.00%
map-img.oss.aliyuncs.com,1,0.00%,1,0,100.00%
packages.osrfoundation.org,1,0.00%,1,0,100.00%
analyticsdcs.awsmcafeeccs.mcafee.com,1,0.00%,2,1,50.00%
fileserver.cdn.huya.com.w.kunluncan.com,1,0.00%,1,0,100.00%
weu014-breeziest-in.cloudapp.net,1,0.00%,1,0,100.00%
swdist.apple.com.akadns.net,1,0.00%,2,1,50.00%
china4-lb.itunes-apple.com.akadns.net,1,0.00%,2,1,50.00%
stat.wup.huya.com,1,0.00%,1,0,100.00%
e4578.dscg.akamaiedge.net,1,0.00%,2,1,50.00%
client-api.itunes.apple.com,1,0.00%,1,0,100.00%
v26-cold.douyinvod.com.c.cdnhwc1.com,1,0.00%,2,1,50.00%
hcdnv.zjtd04.v6.c.cdnhwc1.com,1,0.00%,2,1,50.00%
v9.douyinvod.com.bsgslb.com,1,0.00%,2,1,50.00%
zttvp.v.bsgslb.com,1,0.00%,2,1,50.00%
activity-geo.trafficmanager.net,1,0.00%,1,0,100.00%
prod-commercial-systems.kubernetes-ingress.canonical.com,1,0.00%,1,0,100.00%
dblp.org,1,0.00%,1,0,100.00%
tt-vod-cold1-sched.jcloudimg.com,1,0.00%,2,1,50.00%
e16126.dscg.akamaiedge.net,1,0.00%,2,1,50.00%
cn1b.frdic.com,1,0.00%,1,0,100.00%
uddxy.shiyiyx.com,1,0.00%,1,0,100.00%
analytics.awsmcafeeccs.mcafee.com,1,0.00%,1,0,100.00%
pccw01.graniterapids.com,1,0.00%,1,0,100.00%
tw09.graniterapids.com,1,0.00%,1,0,100.00%
b3f23744e6e9003a-cl2.qcloudcjgj.com,1,0.00%,1,0,100.00%
g-msn-com-nsatc.trafficmanager.net,1,0.00%,2,1,50.00%
a1834.dscg2.akamai.net,1,0.00%,2,1,50.00%
kylin.im.weibo.cn,1,0.00%,1,0,100.00%
event-drcn.push.dbankcloud.com,1,0.00%,1,0,100.00%
hr16.graniterapids.com,1,0.00%,1,0,100.00%
bdwm.net,1,0.00%,1,0,100.00%
e8333.g.akamaiedge.net,1,0.00%,1,0,100.00%
assets-ext01-684130249.eu-west-1.elb.amazonaws.com,1,0.00%,1,0,100.00%
d2hifmcrdlhbcy.cloudfront.net,1,0.00%,1,0,100.00%
e316d1f5c13a425fe9a8b30bb24c072b.dlied1.cdntips.net,1,0.00%,1,0,100.00%
e4578.dscf.akamaiedge.net,1,0.00%,2,1,50.00%
analytics-union.xunlei.com,1,0.00%,1,0,100.00%
www.juyouquan.net,1,0.00%,1,0,100.00%
e1.monidai.com,1,0.00%,1,0,100.00%
xugeed0e.nodedata.net,1,0.00%,1,0,100.00%
archiva-maven-storage-prod.oss-cn-beijing.aliyuncs.com.gds.alibabadns.com,1,0.00%,1,0,100.00%
onmyoji.fp.ps.netease.com,1,0.00%,2,1,50.00%
success.jd.com,1,0.00%,2,1,50.00%
payc.m.jd.com,1,0.00%,2,1,50.00%
order.jd.com,1,0.00%,2,1,50.00%
m.au2gam.ga,1,0.00%,1,0,100.00%
rtb-x.jd.com,1,0.00%,2,1,50.00%
b-plus.jd.com,1,0.00%,1,0,100.00%
push2.msgpush.ccb.com,1,0.00%,1,0,100.00%
soft.qianxin.com,1,0.00%,2,1,50.00%
fmip.fe.apple-dns.cn,1,0.00%,1,0,100.00%
fmipmobile.fe.apple-dns.cn,1,0.00%,1,0,100.00%
slack.com,1,0.00%,1,0,100.00%
array813.prod.do.dsp.mp.microsoft.com,1,0.00%,1,0,100.00%
cdn-china.ampproject.org,1,0.00%,2,1,50.00%
api.mousegesturesapi.com,1,0.00%,1,0,100.00%
slb-browser-traffic.mbgcdn.lenovo.com.cn,1,0.00%,1,0,100.00%
cloudrest.mbgcdn.lenovo.com.cn,1,0.00%,1,0,100.00%
e2c25.gcp.gvt2.com,1,0.00%,1,0,100.00%
a1158.g.akamai.net,1,0.00%,1,0,100.00%
cstaticdun.126.net.w.kunluncan.com,1,0.00%,1,0,100.00%
appcdcbjpip1.jianguoyun.com,1,0.00%,1,0,100.00%
p9.itc.cn,1,0.00%,2,1,50.00%
best.sched.skalego-dk.tdnsstic1.cn,1,0.00%,2,1,50.00%
mon3-misc-lq.fqnovel.com,1,0.00%,2,1,50.00%
t8.baidu.com.a.bdydns.com,1,0.00%,2,1,50.00%
jx0tc5tw.sched.d2-dk.tdnsdp1.cn,1,0.00%,1,0,100.00%
t15.baidu.com.a.bdydns.com,1,0.00%,2,1,50.00%
jx0tc5tw.sched.d2-dk.tdnsdp1.cn.cjt.vwnti.yrzhcloud.cn,1,0.00%,2,1,50.00%
rq.kpcct.cloud.duba.net,1,0.00%,1,0,100.00%
s.safe.360.cn,1,0.00%,4,3,25.00%
th-b.pinduoduo.com,1,0.00%,1,0,100.00%
gw-c-sht.pinduoduo.com,1,0.00%,1,0,100.00%
jingyan.baidu.com,1,0.00%,2,1,50.00%
picx.zhimg.com.volcgslb.com,1,0.00%,2,1,50.00%
exp-picture.cdn.bcebos.com,1,0.00%,2,1,50.00%
36d64ce2.sched.skalego.tdnsstic1.cn.cjt.vwnti.yrzhcloud.cn,1,0.00%,1,0,100.00%
lb-pkx01-offline.zhihu.com,1,0.00%,1,0,100.00%
gslb-dsa-tc.zhihu.com,1,0.00%,2,1,50.00%
match.p4p.1688.com,1,0.00%,1,0,100.00%
login.360.com,1,0.00%,1,0,100.00%
appc.baidu.com,1,0.00%,2,1,50.00%
iwan-s.video.qq.com,1,0.00%,1,0,100.00%
pingjs.qq.com,1,0.00%,1,0,100.00%
tj.video.qq.com,1,0.00%,1,0,100.00%
apd-5bc3bfadf20fc138169092cf798dcd04.v.smtcdns.com,1,0.00%,1,0,100.00%
iota211.rtb.appier.net,1,0.00%,1,0,100.00%
vst.c.appier.net,1,0.00%,1,0,100.00%
userlocation.googleapis.com,1,0.00%,2,1,50.00%
ox-delivery-prod-asia-northeast1.openx.net,1,0.00%,1,0,100.00%
choices.truste.com,1,0.00%,1,0,100.00%
ib.3lift.com,1,0.00%,1,0,100.00%
csm.as.criteo.net,1,0.00%,1,0,100.00%
pix.as.criteo.net,1,0.00%,1,0,100.00%
choices.trustarc.com,1,0.00%,1,0,100.00%
www.bejson.com,1,0.00%,1,0,100.00%
edge-142.hkhkg.icloud-content.com,1,0.00%,1,0,100.00%
iphone-ld.origin-apple.com.akadns.net,1,0.00%,2,1,50.00%
api-access.pangolin-sdk-toutiao.com.dsa.dnsv1.com.cn,1,0.00%,1,0,100.00%
3valw9gt.sched.d2.tdnsdp1.cn,1,0.00%,1,0,100.00%
3valw9gt.sched.d2.tdnsdp1.cn.cjt.vwnti.yrzhcloud.cn,1,0.00%,1,0,100.00%
www.recaptcha.net,1,0.00%,1,0,100.00%
r2---sn-ni5eln7e.gvt1.com,1,0.00%,1,0,100.00%
push.zhihu.com,1,0.00%,1,0,100.00%
e4094fc1d98c915a.ksyunad.com,1,0.00%,2,1,50.00%
1685738.sched.v1lego-dk.tdnsvod1.cn,1,0.00%,2,1,50.00%
jwcg.ucas.ac.cn,1,0.00%,1,0,100.00%
a-0003.dc-msedge.net,1,0.00%,1,0,100.00%
a1830.dscg2.akamai.net,1,0.00%,2,1,50.00%
dual-a-0001.a-msedge.net,1,0.00%,2,1,50.00%
fides-pol.cdn-apple.com.akadns.net,1,0.00%,1,0,100.00%
mini.360.cn.webcdn.360qhcdn.com,1,0.00%,2,1,50.00%
amp-api.apps-lb-cn.itunes-apple.com.akadns.net,1,0.00%,1,0,100.00%
cdn.permutive.com,1,0.00%,1,0,100.00%
d2pbcviywxotf2.cloudfront.net,1,0.00%,2,1,50.00%
2076077.sched.d0.tdnsdp1.cn,1,0.00%,1,0,100.00%
zqhd.eastmoney.com,1,0.00%,1,0,100.00%
disc801.prod.do.dsp.mp.microsoft.com.edgekey.net,1,0.00%,1,0,100.00%
down1.xinshuru.com.wsdvs.com,1,0.00%,1,0,100.00%
e751.dscd.akamaiedge.net,1,0.00%,2,1,50.00%
vip.asus.com,1,0.00%,1,0,100.00%
hkgame06.graniterapids.com,1,0.00%,1,0,100.00%
mail.zhile.ml,1,0.00%,1,0,100.00%
careers.oppo.com,1,0.00%,1,0,100.00%
gecko-pangle-hl.snssdk.com,1,0.00%,1,0,100.00%
cloudphoto-drcn.cloud.dbankcloud.cn,1,0.00%,1,0,100.00%
dcs.conac.cn,1,0.00%,1,0,100.00%
js.cgpnews.cn,1,0.00%,1,0,100.00%
search.ccgp.gov.cn,1,0.00%,1,0,100.00%
www.ccgp-fujian.gov.cn,1,0.00%,1,0,100.00%
bszs.conac.cn,1,0.00%,1,0,100.00%
www.ccgp-shanxi.gov.cn,1,0.00%,1,0,100.00%
www.ccgp-sichuan.gov.cn,1,0.00%,1,0,100.00%
www.ccgp-xinjiang.gov.cn,1,0.00%,1,0,100.00%
www.ccgp-xizang.gov.cn,1,0.00%,1,0,100.00%
www.ccgp-zhejiang.gov.cn,1,0.00%,1,0,100.00%
www.plap.cn,1,0.00%,1,0,100.00%
www.ccgp-guangdong.gov.cn,1,0.00%,1,0,100.00%
www.ccgp-yunnan.gov.cn,1,0.00%,1,0,100.00%
www.ccgp-guangxi.gov.cn,1,0.00%,1,0,100.00%
www.ccgp-guizhou.gov.cn,1,0.00%,1,0,100.00%
www.ccgp-hainan.gov.cn,1,0.00%,1,0,100.00%
www.ccgp-heilongj.gov.cn,1,0.00%,1,0,100.00%
www.ccgp-henan.gov.cn,1,0.00%,1,0,100.00%
www.ccgp-hubei.gov.cn,1,0.00%,1,0,100.00%
www.ccgp-hunan.gov.cn,1,0.00%,1,0,100.00%
www.ccgp-jiangsu.gov.cn,1,0.00%,1,0,100.00%
www.ccgp-jiangxi.gov.cn,1,0.00%,1,0,100.00%
www.ccgp-liaoning.gov.cn,1,0.00%,1,0,100.00%
www.ccgp-ningxia.gov.cn,1,0.00%,1,0,100.00%
www.ccgp-qinghai.gov.cn,1,0.00%,1,0,100.00%
www.ccgp-shaanxi.gov.cn,1,0.00%,1,0,100.00%
www.ccgp-shandong.gov.cn,1,0.00%,1,0,100.00%
www.ccgp-shanghai.gov.cn,1,0.00%,1,0,100.00%
bd0.d.meituan.net,1,0.00%,1,0,100.00%
s0.d.meituan.net,1,0.00%,1,0,100.00%
img4.nga.178.com,1,0.00%,1,0,100.00%
r4---sn-2x3elnes.gvt1.com,1,0.00%,1,0,100.00%
docteamapi.wps.cn,1,0.00%,1,0,100.00%
videoimg.ws.126.net,1,0.00%,1,0,100.00%
phonecallapi.micloud.xiaomi.net,1,0.00%,1,0,100.00%
capi.grammarly.com,1,0.00%,1,0,100.00%
pc-index-static.cdn.bcebos.com,1,0.00%,1,0,100.00%
cloud.tenable.com,1,0.00%,1,0,100.00%
alsc-ug-monitor-callback.alibaba.com,1,0.00%,1,0,100.00%
pushbos.baidu.com,1,0.00%,1,0,100.00%
wbapp.mobile.sina.cn,1,0.00%,1,0,100.00%
ttpcstatic.dftoutiao.com,1,0.00%,1,0,100.00%
cidzxpc.dfxwdc.com,1,0.00%,1,0,100.00%
unionstatis.dfxwdc.com,1,0.00%,1,0,100.00%
location.dftoutiao.com,1,0.00%,1,0,100.00%
ad.xwdsp.com,1,0.00%,1,0,100.00%
dnvp.xsvncxh.cn,1,0.00%,1,0,100.00%
zsrp.admamax.com,1,0.00%,1,0,100.00%
pcunionreportlog.dfxwdc.com,1,0.00%,1,0,100.00%
zsrp02.admamax.com,1,0.00%,1,0,100.00%
zsrp03.admamax.com,1,0.00%,1,0,100.00%
shzzzz.dftoutiao.com,1,0.00%,1,0,100.00%
zsrp01.admamax.com,1,0.00%,1,0,100.00%
jprp.admamax.com,1,0.00%,1,0,100.00%
jprp03.admamax.com,1,0.00%,1,0,100.00%
jprp02.admamax.com,1,0.00%,1,0,100.00%
e.cn.miaozhen.com,1,0.00%,1,0,100.00%
trace.rtbasia.com,1,0.00%,1,0,100.00%
ads.betweendigital.com,1,0.00%,1,0,100.00%
comets.blog.sina.com.cn,1,0.00%,1,0,100.00%
open.e.kuaishou.cn,1,0.00%,1,0,100.00%
jprp01.admamax.com,1,0.00%,1,0,100.00%
s45.astd.6711.com,1,0.00%,1,0,100.00%
m.eyagu.com,1,0.00%,1,0,100.00%
dspadlogger.waimai.meituan.com,1,0.00%,1,0,100.00%
wzrypclog.dftoutiao.com,1,0.00%,1,0,100.00%
dnkeeper.dbankcloud.com,1,0.00%,1,0,100.00%
hisearch-drcn.dt.dbankcloud.com,1,0.00%,1,0,100.00%
pushservice-drcn.dt.dbankcloud.cn,1,0.00%,1,0,100.00%
sdkserver.op.hicloud.com,1,0.00%,1,0,100.00%
pubgw.api.ddxq.mobi,1,0.00%,2,1,50.00%
st.music.163.com.w.kunluncan.com,1,0.00%,1,0,100.00%
i-bn2b-cor002.api.p001.1drv.com,1,0.00%,1,0,100.00%
hijack.baidu.com,1,0.00%,2,1,50.00%
cma.itunes.apple.com,1,0.00%,2,1,50.00%
flow.lavasoft.com,1,0.00%,3,2,33.33%
geo2.adobe.com,1,0.00%,2,1,50.00%
video.yidianzixun.com.HOST,1,0.00%,1,0,100.00%
d1--cn-gotcha208.bilivideo.com,1,0.00%,1,0,100.00%
tbm.snssdk.com,1,0.00%,1,0,100.00%
ib.snssdk.com,1,0.00%,1,0,100.00%
0wkoqygn64x5mqz2lwfned1eph2cjx5q.yundunwaf1.com,1,0.00%,1,0,100.00%
member.bilibili.com,1,0.00%,2,1,50.00%
subca.ocsp-certum.com,1,0.00%,2,1,50.00%
ocsp.certum.pl,1,0.00%,2,1,50.00%
alibaba.cdn.servers.hbly0592.com.cn,1,0.00%,1,0,100.00%
cscasha2.ocsp-certum.com,1,0.00%,2,1,50.00%
apd-d59eb41d265adc96a2616c48aba8c01a.v.smtcdns.com,1,0.00%,1,0,100.00%
s.pdfxd.com,1,0.00%,1,0,100.00%
update-zl.2345.cc,1,0.00%,1,0,100.00%
pufferstatis.xdrtc.com,1,0.00%,1,0,100.00%
t4s.cdn2020.com,1,0.00%,1,0,100.00%
webrtcice.video.qq.com,1,0.00%,1,0,100.00%
onedriveclucprodbn20007.blob.core.windows.net,1,0.00%,1,0,100.00%
abudhabiculture-ae.mail.protection.outlook.com,1,0.00%,1,0,100.00%
onedriveclucproddm20009.blob.core.windows.net,1,0.00%,1,0,100.00%
teacher.cyc.org.tw,1,0.00%,1,0,100.00%
app.shopmium.com,1,0.00%,1,0,100.00%
mail.tesoreria01.ga,1,0.00%,1,0,100.00%
mail.ionsprohair.ml,1,0.00%,1,0,100.00%
promotions.privy-staging-pr-3286.privy-staging.com,1,0.00%,1,0,100.00%
log.getadblock.com,1,0.00%,1,0,100.00%
muenster.studentenring.de,1,0.00%,1,0,100.00%
openweathermap.org,1,0.00%,1,0,100.00%
ray.fengjing.ml,1,0.00%,1,0,100.00%
e2c54.gcp.gvt2.com,1,0.00%,1,0,100.00%
lkiksdhxpcps.phone-delivery.com,1,0.00%,1,0,100.00%
d2k1ftgv7pobq7.cloudfront.net,1,0.00%,1,0,100.00%
app.josephprince.com,1,0.00%,1,0,100.00%
arrowmaf.classic.kicksite.net,1,0.00%,1,0,100.00%
blago.km.ua,1,0.00%,1,0,100.00%
orch.isrc.ac.cn,1,0.00%,1,0,100.00%
api.fund.eastmoney.com,1,0.00%,1,0,100.00%
85.newspush.eastmoney.com,1,0.00%,1,0,100.00%
tencent-doc.cdn-go.cn,1,0.00%,2,1,50.00%
phx02pap002.storage.live.com,1,0.00%,2,1,50.00%
odc-commonafdrk-geo.onedrive.akadns.net,1,0.00%,2,1,50.00%
odc-commonafdrk-brs.onedrive.akadns.net,1,0.00%,2,1,50.00%
et-ae.mail.protection.outlook.com,1,0.00%,1,0,100.00%
hazel-server-pxufsrwofl.now.sh,1,0.00%,1,0,100.00%
www.01os.org,1,0.00%,1,0,100.00%
3.1808.cf,1,0.00%,1,0,100.00%
outlookmobile-office365-tas-msedge-net.e-0009.e-msedge.net,1,0.00%,1,0,100.00%
iris-de-ppe-azsc-eas.eastasia.cloudapp.azure.com,1,0.00%,1,0,100.00%
waws-prod-bay-045a.cloudapp.net,1,0.00%,1,0,100.00%
360.dallassuiteshotel.com,1,0.00%,1,0,100.00%
addons-pa.clients6.google.com,1,0.00%,2,1,50.00%
account.synology.com,1,0.00%,1,0,100.00%
toutiao.com,1,0.00%,1,0,100.00%
e15275.g.akamaiedge.net.0.1.cn.akamaiedge.net,1,0.00%,1,0,100.00%
mail.tockhundieclaper.cf,1,0.00%,1,0,100.00%
mail.arubafin.com,1,0.00%,1,0,100.00%
weu017-breeziest-in.cloudapp.net,1,0.00%,1,0,100.00%
prod-oauth-public-alb-939786626.eu-west-1.elb.amazonaws.com,1,0.00%,1,0,100.00%
s.safe.360.cn.webcdn.360qhcdn.com,1,0.00%,2,1,50.00%
dns4.easydns.info,1,0.00%,4,3,25.00%
ltzproxy.zhxcshop.com,1,0.00%,1,0,100.00%
qb5x4edlyistb6qd2xzmaoe97c1s2aoo.yundunwaf5.com,1,0.00%,1,0,100.00%
ta.trs.cn,1,0.00%,1,0,100.00%
cmhk.tcpbbr.xyz,1,0.00%,1,0,100.00%
zgovweb.v.bsgslb.cn,1,0.00%,2,1,50.00%
zgovweb.v.bsclink.cn,1,0.00%,2,1,50.00%
zmoegovweb.cache.dbappwaf.cn,1,0.00%,2,1,50.00%
www.moj.gov.cn.w.alikunlun.com,1,0.00%,2,1,50.00%
hhgh9tcf.sched.sma-dk.tdnsstic1.cn,1,0.00%,2,1,50.00%
www.mnr.gov.cn.wswebcdn.com,1,0.00%,2,1,50.00%
zgovweb.v.trpcdn.net,1,0.00%,2,1,50.00%
zgovweb.v.dolfincdnx.com,1,0.00%,2,1,50.00%
uportipv6.v.trpcdn.net,1,0.00%,2,1,50.00%
vmi979140.contaboserver.net,1,0.00%,1,0,100.00%
correctxt.baidu.com,1,0.00%,2,1,50.00%
fanyiapp.cdn.bcebos.com,1,0.00%,2,1,50.00%
arxiv-org.atlassian.net,1,0.00%,1,0,100.00%
arxivcu.containers.piwik.pro,1,0.00%,1,0,100.00%
api.amplitude.com,1,0.00%,2,1,50.00%
stock.eastmoney.com,1,0.00%,2,1,50.00%
e10776.b.akamaiedge.net,1,0.00%,1,0,100.00%
global-v2.clearbit.com,1,0.00%,1,0,100.00%
proxy.golang.org,1,0.00%,2,1,50.00%
i.ytimg.com,1,0.00%,2,1,50.00%
vpn.xidian.edu.cn,1,0.00%,1,0,100.00%
pudn-static.oss-cn-beijing.aliyuncs.com,1,0.00%,1,0,100.00%
t.zoukankan.com,1,0.00%,1,0,100.00%
www.cooboys.com,1,0.00%,1,0,100.00%
passport.zhan.com,1,0.00%,1,0,100.00%
top-static.zhan.com,1,0.00%,1,0,100.00%
top.zhan.com,1,0.00%,1,0,100.00%
channel-service.zhan.com,1,0.00%,1,0,100.00%
codeload.github.com,1,0.00%,1,0,100.00%
tracker.msm8916.com,1,0.00%,2,1,50.00%
ns51.solindohost.net,1,0.00%,1,0,100.00%
ssd.tcdn.qq.com,1,0.00%,1,0,100.00%
ins-5776sx9h.ias.tencent-cloud.net,1,0.00%,1,0,100.00%
accelerator.tencent-cloud-gslb.com,1,0.00%,1,0,100.00%
tim.tencent-cloud-gslb.com,1,0.00%,1,0,100.00%
git.linux-kernel.at,1,0.00%,1,0,100.00%
forum.bradleysmoker.com,1,0.00%,1,0,100.00%
msg-push.duba.net,1,0.00%,1,0,100.00%
WWW.voD.LXDNS.CoM,1,0.00%,2,1,50.00%
143-198-155-251.brd-cdn.com,1,0.00%,1,0,100.00%
shop.oasiswildlifefuerteventura.com,1,0.00%,1,0,100.00%
d.f.ip6.arpa,1,0.00%,1,0,100.00%
direwolf-9dc577bed2-renamed.herokuapp.com,1,0.00%,1,0,100.00%
mail2.tdic.ae,1,0.00%,1,0,100.00%
bluebird-hd.org,1,0.00%,1,0,100.00%
www.legittorrents.info,1,0.00%,1,0,100.00%
tracker.tambovnet.org,1,0.00%,1,0,100.00%
prod.detectportal.prod.cloudops.mozgcp.net,0,0.00%,1727,1727,0.00%
dns.msftncsi.com,0,0.00%,2984,2984,0.00%
ntp.ubuntu.com,0,0.00%,38610,38610,0.00%
glb.cws.prod.dcat.dsp.trafficmanager.net,0,0.00%,50,50,0.00%
api.opensubtitles.com,0,0.00%,5,5,0.00%
imap.qq.com,0,0.00%,76,76,0.00%
dual-a-0036.a-msedge.net,0,0.00%,50,50,0.00%
dav.qq.com,0,0.00%,27,27,0.00%
ins-2n7ixenz.ias.tencent-cloud.net,0,0.00%,2,2,0.00%
grafana.com,0,0.00%,452,452,0.00%
example.org,0,0.00%,374,374,0.00%
www.cordcloud.one,0,0.00%,3,3,0.00%
localhost,0,0.00%,946,946,0.00%
localhost.localdomain,0,0.00%,4,4,0.00%
time.apple.com,0,0.00%,66,66,0.00%
dns.google,0,0.00%,741,741,0.00%
tracker.1337x.org,0,0.00%,1017,1017,0.00%
potuk.com,0,0.00%,151,151,0.00%
siambit.com,0,0.00%,1064,1064,0.00%
szextshort.weixin.qq.com,0,0.00%,76,76,0.00%
h5.qzone.qq.com,0,0.00%,369,369,0.00%
peersteers.org,0,0.00%,166,166,0.00%
api.aliyundrive.com,0,0.00%,5,5,0.00%
api.blockcypher.com,0,0.00%,69,69,0.00%
db.local.clamav.net,0,0.00%,509,509,0.00%
szdx.txddns.cn,0,0.00%,21,21,0.00%
slscr.update.microsoft.com,0,0.00%,109,109,0.00%
dns.weixin.qq.com.cn,0,0.00%,349,349,0.00%
az700632.vo.msecnd.net,0,0.00%,58,58,0.00%
analysis-acc-ssl.xunlei.com,0,0.00%,35,35,0.00%
0d.kebhana.mx,0,0.00%,23,23,0.00%
tracker.nanoha.org,0,0.00%,36,36,0.00%
all4nothin.net,0,0.00%,20,20,0.00%
www.21cn.com,0,0.00%,4,4,0.00%
edgedl.me.gvt1.com,0,0.00%,49,49,0.00%
w.wwwww.wtf,0,0.00%,16,16,0.00%
swh.app,0,0.00%,14,14,0.00%
news.qq.com,0,0.00%,4,4,0.00%
wx.qlogo.cn,0,0.00%,274,274,0.00%
dns.weixin.qq.com,0,0.00%,53,53,0.00%
voice.baidu.com,0,0.00%,1,1,0.00%
mmsvg.n.shifen.com,0,0.00%,1,1,0.00%
badjs.weixinbridge.com,0,0.00%,39,39,0.00%
mp.weixin.qq.com,0,0.00%,36,36,0.00%
kdocs.cn,0,0.00%,46,46,0.00%
www.kdocs.cn,0,0.00%,57,57,0.00%
u.wwwww.wtf,0,0.00%,21,21,0.00%
api.vstsusers.visualstudio.com,0,0.00%,4,4,0.00%
api.1e2ea27c13e7d7dff999bc904d79a0a8.pw,0,0.00%,2,2,0.00%
doh.dns.apple.com,0,0.00%,4,4,0.00%
docs.joern.io,0,0.00%,2,2,0.00%
cgi.ark.qq.com,0,0.00%,9,9,0.00%
app.vssps.visualstudio.com,0,0.00%,17,17,0.00%
1337.abcvg.info,0,0.00%,39,39,0.00%
iecvlist.microsoft.com,0,0.00%,12,12,0.00%
ins-r23tsuuf.ias.tencent-cloud.net,0,0.00%,25,25,0.00%
v4-vod.kwaicdn.com,0,0.00%,1,1,0.00%
sns-avatar-qc.xhscdn.com,0,0.00%,2,2,0.00%
sns-img-hw.xhscdn.com,0,0.00%,1,1,0.00%
p4.a.yximgs.com,0,0.00%,1,1,0.00%
ping.manjaro.org,0,0.00%,60,60,0.00%
szminorshort.weixin.qq.com,0,0.00%,34,34,0.00%
weixin.qq.com,0,0.00%,9,9,0.00%
surl.amap.com,0,0.00%,1,1,0.00%
wx2.sinaimg.cn,0,0.00%,30,30,0.00%
wx4.sinaimg.cn,0,0.00%,21,21,0.00%
wb.amap.com,0,0.00%,1,1,0.00%
tracker.ipv6tracker.ru,0,0.00%,27,27,0.00%
h5.sinaimg.cn,0,0.00%,29,29,0.00%
tvax2.sinaimg.cn,0,0.00%,31,31,0.00%
tvax1.sinaimg.cn,0,0.00%,20,20,0.00%
tvax4.sinaimg.cn,0,0.00%,25,25,0.00%
webapi.amap.com,0,0.00%,3,3,0.00%
short.weixin.qq.com,0,0.00%,20,20,0.00%
vdata.amap.com,0,0.00%,1,1,0.00%
vdata02.amap.com,0,0.00%,1,1,0.00%
vdata01.amap.com,0,0.00%,1,1,0.00%
fourier.taobao.com,0,0.00%,1,1,0.00%
i5df1.tdum.alibaba.com,0,0.00%,1,1,0.00%
ynuf.aliapp.org,0,0.00%,3,3,0.00%
vdata03.amap.com,0,0.00%,1,1,0.00%
vdata04.amap.com,0,0.00%,1,1,0.00%
store.is.autonavi.com,0,0.00%,1,1,0.00%
img.t.sinajs.cn,0,0.00%,1,1,0.00%
www.notion.so,0,0.00%,42,42,0.00%
dm.video.weibocdn.com,0,0.00%,1,1,0.00%
www.cas.cn,0,0.00%,3,3,0.00%
tracker.imgoingto.icu,0,0.00%,21,21,0.00%
client.mail.163.com,0,0.00%,59,59,0.00%
otheve.beacon.qq.com,0,0.00%,37,37,0.00%
tracker-cdn.moeking.me,0,0.00%,8,8,0.00%
update.bjca.org.cn,0,0.00%,4,4,0.00%
tagged-by.rubiconproject.net.akadns.net,0,0.00%,2,2,0.00%
tracker.iriseden.eu,0,0.00%,7,7,0.00%
countly.mail.163.com,0,0.00%,10,10,0.00%
gchat.qpic.cn,0,0.00%,42,42,0.00%
cgicol.amap.com,0,0.00%,9,9,0.00%
cgicol.amap.com.gds.alibabadns.com,0,0.00%,9,9,0.00%
www.bt.cn,0,0.00%,21,21,0.00%
bk.n.shifen.com,0,0.00%,69,69,0.00%
apd-ef1d4e4c1ea9898e441fef0017ad517108632f5a868c5ce6.v.smtcdns.com,0,0.00%,1,1,0.00%
minorshort.weixin.qq.com,0,0.00%,61,61,0.00%
shop.vipstatic.com,0,0.00%,1,1,0.00%
d.vpimg1.com,0,0.00%,1,1,0.00%
c.vpimg1.com,0,0.00%,1,1,0.00%
beian.miit.gov.cn,0,0.00%,10,10,0.00%
ir.vip.com,0,0.00%,1,1,0.00%
ss.knet.cn,0,0.00%,1,1,0.00%
wx.mail.qq.com,0,0.00%,12,12,0.00%
t2.leech.ie,0,0.00%,5,5,0.00%
graph.qq.com,0,0.00%,43,43,0.00%
www.torrent.eu.org,0,0.00%,2,2,0.00%
tracker.anirena.com,0,0.00%,57,57,0.00%
t.nyaatracker.com,0,0.00%,41,41,0.00%
tracker.gbitt.info,0,0.00%,32,32,0.00%
tracker.0o.is,0,0.00%,3,3,0.00%
tracker.ds.is,0,0.00%,3,3,0.00%
trk.publictracker.xyz,0,0.00%,3,3,0.00%
6rt.tace.ru,0,0.00%,4,4,0.00%
discord.heihachi.pw,0,0.00%,3,3,0.00%
exodus.desync.com,0,0.00%,2,2,0.00%
ipv6.tracker.zerobytes.xyz,0,0.00%,3,3,0.00%
node.video.qq.com,0,0.00%,41,41,0.00%
open.demonii.com,0,0.00%,6,6,0.00%
ratings-wrs.norton.com,0,0.00%,2,2,0.00%
h.trace.qq.com,0,0.00%,100,100,0.00%
shasta-rrs.norton.com,0,0.00%,2,2,0.00%
recruitprod.azurefd.net,0,0.00%,4,4,0.00%
recruit.microsoft.com,0,0.00%,4,4,0.00%
wcpstatic.microsoft.com,0,0.00%,4,4,0.00%
libs.baidu.com,0,0.00%,2,2,0.00%
acs-ui.azureedge.net,0,0.00%,2,2,0.00%
consentreceiverfd-prod.azurefd.net,0,0.00%,2,2,0.00%
wwfile.work.weixin.qq.com,0,0.00%,42,42,0.00%
apd-bf858887be56629f5e8387983960b23dd6420ff9a7f7b03b.v.smtcdns.com,0,0.00%,2,2,0.00%
www.dropbox.com,0,0.00%,13,13,0.00%
stat.download.xunlei.com,0,0.00%,2,2,0.00%
excashier.alipay.com,0,0.00%,2,2,0.00%
lab.alipay.com,0,0.00%,2,2,0.00%
kcart.alipay.com,0,0.00%,2,2,0.00%
collect.alipay.com,0,0.00%,4,4,0.00%
c.bing.com,0,0.00%,15,15,0.00%
apd-6dc2592165268630e5e81885b161ea9094fb91d1cf4b7b4b.v.smtcdns.com,0,0.00%,2,2,0.00%
yangzhangalmo.github.io,0,0.00%,4,4,0.00%
23a72c571eab6919.cdn.jiashule.com,0,0.00%,2,2,0.00%
apd-7a3c059307d194c1953157782742893b1193182453d495c0.v.smtcdns.com,0,0.00%,2,2,0.00%
lookup.nextcloud.com,0,0.00%,808,808,0.00%
captive.apple.com,0,0.00%,94,94,0.00%
v6-1.nigirocloud.com,0,0.00%,37,37,0.00%
v6-2.nigirocloud.com,0,0.00%,38,38,0.00%
v6-3.nigirocloud.com,0,0.00%,37,37,0.00%
astat.bugly.qq.com,0,0.00%,48,48,0.00%
security.ubuntu.com,0,0.00%,129,129,0.00%
cn.archive.ubuntu.com,0,0.00%,80,80,0.00%
fedoraproject.org,0,0.00%,73,73,0.00%
config.teams.microsoft.com,0,0.00%,18,18,0.00%
edge-microsoft-com.dual-a-0036.a-msedge.net,0,0.00%,29,29,0.00%
wx1.qq.com,0,0.00%,75,75,0.00%
inner-all.toutiao-internal-all-v3.lf.bytelb.net,0,0.00%,33,33,0.00%
aloha.maxhub.vip.wsglb0.com,0,0.00%,105,105,0.00%
ins-diu1q33u.ias.tencent-cloud.net,0,0.00%,10,10,0.00%
crl.sectigo.com,0,0.00%,10,10,0.00%
crl.comodoca.com.cdn.cloudflare.net,0,0.00%,15,15,0.00%
speedtest.snape3058.info,0,0.00%,48,48,0.00%
swdlcdn.eastmoney.com.w.cdngslb.com,0,0.00%,20,20,0.00%
mpv6.weixin.qq.com,0,0.00%,18,18,0.00%
aloha.maxhub.vip,0,0.00%,56,56,0.00%
config.edge.skype.com.trafficmanager.net,0,0.00%,40,40,0.00%
config-edge-skype.l-0007.l-msedge.net,0,0.00%,20,20,0.00%
l-0007.l-msedge.net,0,0.00%,33,33,0.00%
premium.eastmoney.com,0,0.00%,2,2,0.00%
jsdelivr.map.fastly.net,0,0.00%,4,4,0.00%
time.g.aaplimg.com,0,0.00%,51,51,0.00%
time-ios.apple.com,0,0.00%,8,8,0.00%
esm.ubuntu.com,0,0.00%,4,4,0.00%
ntes53v6.mail.yeah.net,0,0.00%,2,2,0.00%
hub.upyun.com,0,0.00%,367,367,0.00%
smtp.qq.com,0,0.00%,173,173,0.00%
log.tailscale.io,0,0.00%,719,719,0.00%
controlplane.tailscale.com,0,0.00%,348,348,0.00%
haiwenzhang.github.io,0,0.00%,61,61,0.00%
gitlab.com,0,0.00%,133,133,0.00%
tpstelemetry.tencent.com,0,0.00%,62,62,0.00%
60-fps.org,0,0.00%,20,20,0.00%
baibako.tv,0,0.00%,23,23,0.00%
natdetection.onethingpcs.com,0,0.00%,17,17,0.00%
filehelper.weixin.qq.com,0,0.00%,1206,1206,0.00%
open.nyap2p.com,0,0.00%,14,14,0.00%
crl.comodoca.com,0,0.00%,46,46,0.00%
ppa.launchpad.net,0,0.00%,86,86,0.00%
ipv6.torrent.centos.org,0,0.00%,2,2,0.00%
releases.turnkeylinux.org,0,0.00%,2,2,0.00%
debian.map.fastlydns.NET,0,0.00%,2,2,0.00%
debian.map.fastlydns.net,0,0.00%,2,2,0.00%
ncsi.6-c-0003.c-msedge.net,0,0.00%,8,8,0.00%
6-c-0003.c-msedge.net,0,0.00%,31,31,0.00%
v6ncsi.msedge.net,0,0.00%,10,10,0.00%
oss.hpconnected.com,0,0.00%,4,4,0.00%
oss.hpconnected.com.cdn.cloudflare.net,0,0.00%,2,2,0.00%
vcsa.vmware.com,0,0.00%,6,6,0.00%
update.client.163.com,0,0.00%,72,72,0.00%
support.weixin.qq.com,0,0.00%,14,14,0.00%
map.n.shifen.com,0,0.00%,41,41,0.00%
updatem.360safe.com,0,0.00%,2,2,0.00%
database.clamav.net,0,0.00%,155,155,0.00%
mirrors.ustc.edu.cn,0,0.00%,64,64,0.00%
ppa.launchpadcontent.net,0,0.00%,2,2,0.00%
tw3.fnwl.ml,0,0.00%,1,1,0.00%
jackroy1992.github.io,0,0.00%,61,61,0.00%
motd.ubuntu.com,0,0.00%,90,90,0.00%
dns.twnic.tw,0,0.00%,14,14,0.00%
public.dns.iij.jp,0,0.00%,43,43,0.00%
simsunny22.github.io,0,0.00%,61,61,0.00%
ping.dgraph.io,0,0.00%,664,664,0.00%
mirrorz.org,0,0.00%,27,27,0.00%
hub5pn.v6.sandai.net,0,0.00%,70,70,0.00%
az667904.vo.msecnd.net,0,0.00%,68,68,0.00%
xui.ptlogin2.qq.com,0,0.00%,48,48,0.00%
P2PSTUNTEst.HAPlAT.Net,0,0.00%,2,2,0.00%
appconf.mail.163.com,0,0.00%,48,48,0.00%
pypi.org,0,0.00%,53821,53821,0.00%
platform.bing.com,0,0.00%,13,13,0.00%
hk-proxy.isrc.ac.cn,0,0.00%,79,79,0.00%
report.url.cn,0,0.00%,72,72,0.00%
win10-trt.msedge.net,0,0.00%,27,27,0.00%
wup.imtt.qq.com,0,0.00%,50,50,0.00%
mirrors.fedoraproject.org,0,0.00%,243,243,0.00%
mirrors.nju.edu.cn,0,0.00%,31,31,0.00%
mirrors.neusoft.edu.cn,0,0.00%,5,5,0.00%
stun-h5.qvb.qcloud.com,0,0.00%,23,23,0.00%
rmonitor.qq.com,0,0.00%,5,5,0.00%
dp3.qq.com,0,0.00%,4,4,0.00%
tdid.m.qq.com,0,0.00%,2,2,0.00%
worldgz.photo.store.qq.com,0,0.00%,6,6,0.00%
yun-hl.3g.qq.com,0,0.00%,7,7,0.00%
sdk.e.qq.com,0,0.00%,6,6,0.00%
v6.mobilelog.upqzfile.com,0,0.00%,2,2,0.00%
tools.3g.qq.com,0,0.00%,10,10,0.00%
api.bitbucket.org,0,0.00%,32,32,0.00%
r1---sn-4g5lznez.gvt1.com,0,0.00%,2,2,0.00%
files.pfsense.org,0,0.00%,16,16,0.00%
hub.docker.com,0,0.00%,28,28,0.00%
lp.open.weixin.qq.com,0,0.00%,28,28,0.00%
dstore-metadata.deepin.cn,0,0.00%,153,153,0.00%
access.toggle.qq.com,0,0.00%,67,67,0.00%
docs.qq.com,0,0.00%,53,53,0.00%
fe3cr.delivery.mp.microsoft.com,0,0.00%,125,125,0.00%
event.toggle.qq.com,0,0.00%,9,9,0.00%
theodoric.fr,0,0.00%,15,15,0.00%
inferno.demonoid.is,0,0.00%,19,19,0.00%
tracker.openzim.org,0,0.00%,22,22,0.00%
masters-tb.com,0,0.00%,17,17,0.00%
tracker.moeking.me,0,0.00%,30,30,0.00%
v6-zb-alibaba-clould.tengine.alibaba.com.gds.alibabadns.com,0,0.00%,18,18,0.00%
api.languagetoolplus.com,0,0.00%,6,6,0.00%
marketplace.visualstudio.com,0,0.00%,16,16,0.00%
download.zerotier.com,0,0.00%,2,2,0.00%
archive.canonical.com,0,0.00%,6,6,0.00%
deb.anydesk.com,0,0.00%,2,2,0.00%
trade-acs.m.taobao.com,0,0.00%,2,2,0.00%
dualstack-a.apilocate.amap.com,0,0.00%,2,2,0.00%
ifs.tanx.com,0,0.00%,2,2,0.00%
acs.m.taobao.com,0,0.00%,6,6,0.00%
tbshop.m.taobao.com,0,0.00%,2,2,0.00%
api-takumi-record.mihoyo.com,0,0.00%,2,2,0.00%
edgeassetservice.azureedge.net,0,0.00%,8,8,0.00%
kgb-ifs.tanx.com,0,0.00%,2,2,0.00%
tva1.sinaimg.cn,0,0.00%,21,21,0.00%
pixel.quantserve.com,0,0.00%,3,3,0.00%
r10---sn-2x3eln76.c.2mdn.net,0,0.00%,1,1,0.00%
r18---sn-ni57rn7s.c.2mdn.net,0,0.00%,2,2,0.00%
weiboimgwx.grid.sinaedge.com,0,0.00%,4,4,0.00%
us.grid.sinaedge.com,0,0.00%,7,7,0.00%
mpvideo.qpic.cn,0,0.00%,1,1,0.00%
weibo.com,0,0.00%,230,230,0.00%
kln.grid.sinaedge.com,0,0.00%,4,4,0.00%
mozilla.cloudflare-dns.com,0,0.00%,22,22,0.00%
aks.jdpay.com,0,0.00%,4,4,0.00%
p3.qhmsg.com,0,0.00%,1,1,0.00%
ssl.captcha.qq.com,0,0.00%,13,13,0.00%
t.captcha.qq.com,0,0.00%,7,7,0.00%
cacerts.digicert.com,0,0.00%,2,2,0.00%
devtools.azureedge.net,0,0.00%,1,1,0.00%
tvax3.sinaimg.cn,0,0.00%,21,21,0.00%
tva2.sinaimg.cn,0,0.00%,7,7,0.00%
p.qlogo.cn,0,0.00%,5,5,0.00%
dualstack.r.ssl.global.fastly.net,0,0.00%,4,4,0.00%
stat.wifi.360.cn,0,0.00%,3,3,0.00%
qb-extension.firebaseio.com,0,0.00%,15,15,0.00%
i.y.qq.com,0,0.00%,8,8,0.00%
surfacedma.azurefd.net,0,0.00%,2,2,0.00%
thirdwx.qlogo.cn,0,0.00%,12,12,0.00%
dict.youdao.com,0,0.00%,68,68,0.00%
promo.lu.com,0,0.00%,4,4,0.00%
httpd.apache.org,0,0.00%,1,1,0.00%
bugs.launchpad.net,0,0.00%,1,1,0.00%
static.debian.org,0,0.00%,1,1,0.00%
conda.anaconda.org,0,0.00%,2,2,0.00%
owncloud.org,0,0.00%,2,2,0.00%
dagmar.owncloud.systems,0,0.00%,2,2,0.00%
f.video.weibocdn.com,0,0.00%,9,9,0.00%
tracker.kuroy.me,0,0.00%,18,18,0.00%
gz-lb1.internet-g.spanner.alipaydns.com,0,0.00%,14,14,0.00%
gz-lb1.internet.v6.spanner.alipaydns.com,0,0.00%,16,16,0.00%
fireworks.eu.org,0,0.00%,16,16,0.00%
kubernetes-charts.storage.googleapis.com,0,0.00%,32,32,0.00%
torrent.ubuntu.com,0,0.00%,23,23,0.00%
opentracker.cc,0,0.00%,13,13,0.00%
tracker.exorditech.com.tr,0,0.00%,8,8,0.00%
tracker.nucozer-tracker.ml,0,0.00%,21,21,0.00%
www.megatorrents.kg,0,0.00%,8,8,0.00%
bt2.edwardk.info,0,0.00%,11,11,0.00%
tracker.corpscorp.online,0,0.00%,25,25,0.00%
torrent.fedoraproject.org,0,0.00%,40,40,0.00%
aps.amap.com,0,0.00%,5,5,0.00%
secclientgw.alipay.com,0,0.00%,13,13,0.00%
tracker.kamigami.org,0,0.00%,16,16,0.00%
t.jaekr.sh,0,0.00%,4,4,0.00%
js.monitor.azure.com,0,0.00%,2,2,0.00%
worldtj.photo.store.qq.com,0,0.00%,2,2,0.00%
p.qpic.cn,0,0.00%,2,2,0.00%
global.px.quantserve.com,0,0.00%,2,2,0.00%
sls.update.microsoft.com,0,0.00%,27,27,0.00%
glb.sls.prod.dcat.dsp.trafficmanager.net,0,0.00%,38,38,0.00%
E.ROOT-SERVERS.NET,0,0.00%,14,14,0.00%
G.ROOT-SERVERS.NET,0,0.00%,13,13,0.00%
fe3.delivery.mp.microsoft.com,0,0.00%,15,15,0.00%
pingfore.qq.com,0,0.00%,4,4,0.00%
dmplog.qq.com,0,0.00%,2,2,0.00%
ecs.office.trafficmanager.net,0,0.00%,4,4,0.00%
ecs-office.s-0005.s-msedge.net,0,0.00%,4,4,0.00%
s-0005.s-msedge.net,0,0.00%,6,6,0.00%
cn-jssz-cm-02-40.bilivideo.com,0,0.00%,2,2,0.00%
cn.ntp.org.cn,0,0.00%,15,15,0.00%
edu.ntp.org.cn,0,0.00%,16,16,0.00%
edge-misc-env.dropbox-dns.com,0,0.00%,10,10,0.00%
tracker-public.tjupt.org,0,0.00%,7,7,0.00%
channels.weixin.qq.com,0,0.00%,4,4,0.00%
aewebproxy.weixin.qq.com,0,0.00%,2,2,0.00%
tracker.tongyifan.me,0,0.00%,2,2,0.00%
nvidia.github.io,0,0.00%,62,62,0.00%
hdwebv6.mail.split.netease.com,0,0.00%,4,4,0.00%
hd.mmstat.com,0,0.00%,4,4,0.00%
hd.mmstat.com.gds.alibabadns.com,0,0.00%,4,4,0.00%
tracker-campus.tjupt.org,0,0.00%,2,2,0.00%
lab-a.tongyifan.me,0,0.00%,2,2,0.00%
dict.ntes53.netease.com,0,0.00%,22,22,0.00%
quay.io,0,0.00%,97,97,0.00%
myfavor.eastmoney.com,0,0.00%,6,6,0.00%
searchapi.eastmoney.com,0,0.00%,10,10,0.00%
np-listapi.eastmoney.com,0,0.00%,6,6,0.00%
huaxiang.eastmoney.com,0,0.00%,8,8,0.00%
recommend.eastmoney.com,0,0.00%,7,7,0.00%
vote.eastmoney.com,0,0.00%,6,6,0.00%
reportapi.eastmoney.com,0,0.00%,2,2,0.00%
s1.nsatu.com,0,0.00%,13,13,0.00%
us.archive.ubuntu.com,0,0.00%,8,8,0.00%
ns4-35.azure-dns.info,0,0.00%,3,3,0.00%
ns2-35.azure-dns.net,0,0.00%,5,5,0.00%
mariadb.org,0,0.00%,13,13,0.00%
docker.mirrors.ustc.edu.cn,0,0.00%,2,2,0.00%
c.gtld-servers.net,0,0.00%,2,2,0.00%
j.gtld-servers.net,0,0.00%,2,2,0.00%
g.gtld-servers.net,0,0.00%,2,2,0.00%
thirdqq.qlogo.cn,0,0.00%,3,3,0.00%
s-iavs9x.avcdn.net,0,0.00%,1,1,0.00%
h1785399.iavs9x.avg.u.avcdn.net,0,0.00%,1,1,0.00%
k6951768.iavs9x.avg.u.avcdn.net,0,0.00%,1,1,0.00%
f4973661.iavs9x.avg.u.avcdn.net,0,0.00%,1,1,0.00%
s8784910.iavs9x.avg.u.avcdn.net,0,0.00%,1,1,0.00%
s5445469.iavs9x.avg.u.avcdn.net,0,0.00%,1,1,0.00%
s5445469.avi18.u.avcdn.net,0,0.00%,1,1,0.00%
k6951768.avi18.u.avcdn.net,0,0.00%,1,1,0.00%
d9217321.avi18.u.avcdn.net,0,0.00%,1,1,0.00%
k8136955.avi18.u.avcdn.net,0,0.00%,1,1,0.00%
y7637820.avi18.u.avcdn.net,0,0.00%,1,1,0.00%
tva3.sinaimg.cn,0,0.00%,4,4,0.00%
face.t.sinajs.cn,0,0.00%,1,1,0.00%
s-nuistatic.avcdn.net,0,0.00%,1,1,0.00%
graph.microsoft.com,0,0.00%,24,24,0.00%
www.avast.com,0,0.00%,1,1,0.00%
szlong.weixin.qq.com,0,0.00%,8,8,0.00%
hub5pr.v6.phub.sandai.net,0,0.00%,67,67,0.00%
pcapp.youku.com,0,0.00%,10,10,0.00%
long.weixin.qq.com,0,0.00%,7,7,0.00%
6f956519e3f44ba5b388228717d12229.fp.measure.office.com,0,0.00%,1,1,0.00%
log.m.sm.cn,0,0.00%,2,2,0.00%
unpm-upaas.uc.cn,0,0.00%,4,4,0.00%
px.ucweb.com,0,0.00%,2,2,0.00%
maps.windows.com,0,0.00%,4,4,0.00%
rating.collaboraonline.com,0,0.00%,2,2,0.00%
paimgcdn.jomodns.com,0,0.00%,2,2,0.00%
dns.adguard.com,0,0.00%,1,1,0.00%
fanyi.youdao.com,0,0.00%,10,10,0.00%
fanyi.ntes53.netease.com,0,0.00%,8,8,0.00%
cdn.globalsigncdn.com.cdn.cloudflare.net,0,0.00%,3,3,0.00%
i.work.weixin.qq.com,0,0.00%,123,123,0.00%
gap.work.weixin.qq.com,0,0.00%,14,14,0.00%
drive.weixin.qq.com,0,0.00%,14,14,0.00%
ten.sngapm.qq.com,0,0.00%,6,6,0.00%
jubao.qq.com,0,0.00%,6,6,0.00%
wx.qq.com,0,0.00%,6,6,0.00%
webpush.wx.qq.com,0,0.00%,2,2,0.00%
pcapp-data-collect.youku.com,0,0.00%,2,2,0.00%
labuladong.github.io,0,0.00%,2,2,0.00%
login2.dingtalk.com,0,0.00%,5,5,0.00%
space.dingtalk.com,0,0.00%,5,5,0.00%
vals.atm.youku.com,0,0.00%,2,2,0.00%
acs.youku.com,0,0.00%,2,2,0.00%
new.qq.com,0,0.00%,2,2,0.00%
hits.kankandy.xyz,0,0.00%,1,1,0.00%
img1.doubanio.com,0,0.00%,2,2,0.00%
cm.l.qq.com,0,0.00%,4,4,0.00%
c5.rgstatic.net.cdn.cloudflare.net,0,0.00%,4,4,0.00%
www.researchgate.net.cdn.cloudflare.net,0,0.00%,6,6,0.00%
cdn.paddle.com,0,0.00%,2,2,0.00%
i1.rgstatic.net.cdn.cloudflare.net,0,0.00%,8,8,0.00%
waconafd.officeapps.live.com,0,0.00%,10,10,0.00%
ipv6.neubt.com,0,0.00%,22,22,0.00%
l.sinaimg.cn,0,0.00%,2,2,0.00%
newsapi.sina.cn,0,0.00%,2,2,0.00%
fb.video.weibocdn.com,0,0.00%,2,2,0.00%
newsinfo.eastmoney.com,0,0.00%,4,4,0.00%
t1.appmeasurements.com,0,0.00%,5,5,0.00%
ping3.teamviewer.com,0,0.00%,95,95,0.00%
btracker.top,0,0.00%,29,29,0.00%
h3o2.me,0,0.00%,16,16,0.00%
tracker.lilithraws.org,0,0.00%,13,13,0.00%
data-bg.net,0,0.00%,16,16,0.00%
dualstack.q3.shared.global.fastly.net,0,0.00%,2,2,0.00%
discovery-v6.syncthing.net,0,0.00%,2,2,0.00%
dashi.163.com,0,0.00%,5,5,0.00%
dashiwebv6.mail.split.netease.com,0,0.00%,2,2,0.00%
ace.pgp.wanmei.com,0,0.00%,10,10,0.00%
cname.dict.ntes53.netease.com,0,0.00%,10,10,0.00%
ipv6.ts.qq.com,0,0.00%,2,2,0.00%
open.weixin.qq.com,0,0.00%,25,25,0.00%
downloads-aws-prod-alb-134617303.eu-west-1.elb.amazonaws.com,0,0.00%,4,4,0.00%
login.weixin.qq.com,0,0.00%,6,6,0.00%
think.afunapp.com,0,0.00%,2,2,0.00%
captive-cidr.origin-apple.com.akadns.net,0,0.00%,6,6,0.00%
captive-cdn.origin-apple.com.akadns.net,0,0.00%,4,4,0.00%
ulogs.umeng.com,0,0.00%,10,10,0.00%
ios.bugly.qq.com,0,0.00%,2,2,0.00%
ulogs.umeng.com.gds.alibabadns.com,0,0.00%,4,4,0.00%
alog-default.umeng.com,0,0.00%,4,4,0.00%
gbapi.eastmoney.com,0,0.00%,24,24,0.00%
www.icloud.g.aaplimg.com,0,0.00%,1,1,0.00%
bcc42b420c334fa2aee093da10222739.fp.measure.office.com,0,0.00%,1,1,0.00%
wappass.n.shifen.com,0,0.00%,12,12,0.00%
sz.mp.weixin.qq.com,0,0.00%,8,8,0.00%
data-ai.microsoft.com,0,0.00%,2,2,0.00%
ibank.bankofbeijing.com.cn,0,0.00%,4,4,0.00%
www.clarity.ms,0,0.00%,8,8,0.00%
speeddials.opera.com,0,0.00%,6,6,0.00%
extension-updates.opera.com,0,0.00%,2,2,0.00%
carapax.net,0,0.00%,4,4,0.00%
hub5btmain.v6.shub.sandai.net,0,0.00%,30,30,0.00%
tracker.loligirl.cn,0,0.00%,11,11,0.00%
mail.qq.com,0,0.00%,15,15,0.00%
blackz.ro,0,0.00%,14,14,0.00%
open.trackerlist.xyz,0,0.00%,35,35,0.00%
jinliangxx.github.io,0,0.00%,1,1,0.00%
datascene.net,0,0.00%,10,10,0.00%
www.all4nothin.net,0,0.00%,7,7,0.00%
tr.bangumi.moe,0,0.00%,12,12,0.00%
trackme.theom.nz,0,0.00%,20,20,0.00%
btx.anifilm.tv,0,0.00%,26,26,0.00%
tracker.birkenwald.de,0,0.00%,5,5,0.00%
tracker.imgoingto.icu.cdn.cloudflare.net,0,0.00%,1,1,0.00%
hc.tdm.qq.com,0,0.00%,4,4,0.00%
mask-api.fe.apple-dns.net,0,0.00%,2,2,0.00%
zafirshi.github.io,0,0.00%,1,1,0.00%
v6-4.nigirocloud.com,0,0.00%,45,45,0.00%
tmfmazu.m.qq.com,0,0.00%,2,2,0.00%
networkcheck.kde.org,0,0.00%,11,11,0.00%
apiaccess-toutiao-com-1308810737.file.myqcloud.com,0,0.00%,2,2,0.00%
updpct.info,0,0.00%,4,4,0.00%
www.gravatar.com,0,0.00%,8,8,0.00%
news.hangzhou.com.cn,0,0.00%,1,1,0.00%
www.collinsdictionary.com,0,0.00%,1,1,0.00%
www.hangzhou.com.cn,0,0.00%,1,1,0.00%
turingapi-rapiddeploy.microsoft.com,0,0.00%,1,1,0.00%
api.panawyt.xyz,0,0.00%,1,1,0.00%
stup7.appmeasurements.com,0,0.00%,6,6,0.00%
bae.appmeasurements.com,0,0.00%,8,8,0.00%
t4.appmeasurements.com,0,0.00%,1,1,0.00%
t5.appmeasurements.com,0,0.00%,2,2,0.00%
tracker.foreverpirates.co,0,0.00%,26,26,0.00%
tracker.tamersunion.org,0,0.00%,31,31,0.00%
repo.zabbix.com,0,0.00%,2,2,0.00%
WwW.Google.coM,0,0.00%,3,3,0.00%
wWW.yAhOo.coM,0,0.00%,3,3,0.00%
n.guanjia.qq.com,0,0.00%,36,36,0.00%
ssl.ptlogin2.graph.qq.com,0,0.00%,35,35,0.00%
qqdata.ab.qq.com,0,0.00%,16,16,0.00%
stun.ideasip.com,0,0.00%,7,7,0.00%
discovery-v6.verysync.cn,0,0.00%,23,23,0.00%
mirrors.bupt.edu.cn,0,0.00%,2,2,0.00%
mirror.sjtu.edu.cn,0,0.00%,332,332,0.00%
www.chinanews.com.cn,0,0.00%,19,19,0.00%
iscas1-my.sharepoint.cn,0,0.00%,20,20,0.00%
e7nvur.qqscml.ml,0,0.00%,1,1,0.00%
www.GOOgle.CoM,0,0.00%,1,1,0.00%
WwW.yAHoo.coM,0,0.00%,1,1,0.00%
mirrors.bfsu.edu.cn,0,0.00%,27,27,0.00%
amyclogan.writerfolio.com,0,0.00%,1,1,0.00%
msgstore.www.notion.so,0,0.00%,12,12,0.00%
helm.elastic.co,0,0.00%,14,14,0.00%
kubernetes-charts-incubator.storage.googleapis.com,0,0.00%,8,8,0.00%
www.thegeeks.bz,0,0.00%,9,9,0.00%
tr.abiir.top,0,0.00%,14,14,0.00%
bttracker.debian.org,0,0.00%,21,21,0.00%
cqc-download.weiyun.com,0,0.00%,11,11,0.00%
ipv4announce.sktorrent.eu,0,0.00%,2,2,0.00%
tr.abir.ga,0,0.00%,14,14,0.00%
torrent.mp3quran.net,0,0.00%,24,24,0.00%
d26u1qpb8nca0s.cloudfront.net,0,0.00%,1,1,0.00%
dns.alidns.com,0,0.00%,14,14,0.00%
bt.edwardk.info,0,0.00%,8,8,0.00%
tracker.electro-torrent.pl,0,0.00%,12,12,0.00%
tracker.torrentleech.org,0,0.00%,10,10,0.00%
7f408d220f4244adbff238ec142a507b.fp.measure.office.com,0,0.00%,1,1,0.00%
driverupdate.lenovo.com.cn,0,0.00%,1,1,0.00%
q.qlogo.cn,0,0.00%,2,2,0.00%
rpt.gdt.qq.com,0,0.00%,4,4,0.00%
adsmind.gdtimg.com,0,0.00%,1,1,0.00%
v.gdt.qq.com,0,0.00%,2,2,0.00%
worldnj.photo.store.qq.com,0,0.00%,1,1,0.00%
world.qpic.cn,0,0.00%,1,1,0.00%
pdns99.ultradns.net,0,0.00%,3,3,0.00%
myfavor1.eastmoney.com,0,0.00%,2,2,0.00%
az667904-pme.ec.azureedge.net,0,0.00%,6,6,0.00%
cs9.wpc.v0cdn.net,0,0.00%,4,4,0.00%
astat-bugly-tgw4l.mig.tencent-cloud.net,0,0.00%,30,30,0.00%
time-macos.apple.com,0,0.00%,6,6,0.00%
dfscdn.dfcfw.com,0,0.00%,10,10,0.00%
gbres.dfcfw.com,0,0.00%,8,8,0.00%
ns2.cuhk.edu.hk,0,0.00%,2,2,0.00%
p2pstuntest.haplat.net,0,0.00%,20,20,0.00%
changelogs.ubuntu.com,0,0.00%,13,13,0.00%
albarqouni.github.io,0,0.00%,61,61,0.00%
euleryang.github.io,0,0.00%,1,1,0.00%
gsp-ssl.ls.apple.com,0,0.00%,5,5,0.00%
mirror.xtom.com.hk,0,0.00%,2,2,0.00%
download.opensuse.org,0,0.00%,2,2,0.00%
spo-ring.msedge.net,0,0.00%,7,7,0.00%
v6-zb-alibaba-clould.tengine.alibaba.com,0,0.00%,1,1,0.00%
statics.teams.cdn.office.net,0,0.00%,1,1,0.00%
teams.microsoft.com,0,0.00%,2,2,0.00%
uaqg.github.io,0,0.00%,1,1,0.00%
tracker.teambelgium.net,0,0.00%,1,1,0.00%
blingblingxuanxuan.github.io,0,0.00%,2,2,0.00%
greasyfork.org,0,0.00%,2,2,0.00%
unpkg.com,0,0.00%,2,2,0.00%
yhxw.tj.beijing.gov.cn,0,0.00%,2,2,0.00%
7075ff241a6174cd.cdn.jiashule.com,0,0.00%,2,2,0.00%
rsj.beijing.gov.cn,0,0.00%,4,4,0.00%
wza.beijing.gov.cn,0,0.00%,2,2,0.00%
play.shipin.beijing.gov.cn,0,0.00%,2,2,0.00%
c4c8ac57389cdbaa.cdn.jiashule.com,0,0.00%,2,2,0.00%
6b516f81c9cbe1a4.cdn.jiashule.com,0,0.00%,2,2,0.00%
www.beijing.gov.cn,0,0.00%,2,2,0.00%
banshi.beijing.gov.cn,0,0.00%,4,4,0.00%
da259f9b03852fbb.cname.365cyd.cn,0,0.00%,2,2,0.00%
smp-device-content.g.aaplimg.com,0,0.00%,2,2,0.00%
feeds-drcn.cloud.huawei.com.cn,0,0.00%,2,2,0.00%
a1838.dscb.akamai.net,0,0.00%,8,8,0.00%
p.meituan.com,0,0.00%,2,2,0.00%
ipv4-ipv6-phase4.web.vip.meituan.com,0,0.00%,4,4,0.00%
tmfsdktcp.m.qq.com,0,0.00%,4,4,0.00%
cs11.wpc.v0cdn.net,0,0.00%,1,1,0.00%
remote.syslinq.co,0,0.00%,1,1,0.00%
pull-tsl-vr-l26.douyincdn.com.51296c5e.c.cdnhwc1.com,0,0.00%,1,1,0.00%
pull-tsl-vr-l6.douyincdn.com.hlsvcloud.ks-cdn.com,0,0.00%,2,2,0.00%
dualstack-na61-na62.wagbridge.alibaba.taobao.com.gds.alibabadns.com,0,0.00%,5,5,0.00%
ipv6-aserver-heyi.m.taobao.com,0,0.00%,1,1,0.00%
ipv6-aserver-heyi.m.taobao.com.gds.alibabadns.com,0,0.00%,1,1,0.00%
mirrors.rockylinux.org,0,0.00%,1,1,0.00%
rockylinux.map.fastly.net,0,0.00%,2,2,0.00%
tr.burnabyhighstar.com,0,0.00%,19,19,0.00%
updatecenter.qq.com,0,0.00%,2,2,0.00%
augloop.office.com,0,0.00%,2,2,0.00%
spclient.wg.spotify.com,0,0.00%,2,2,0.00%
i.scdn.co,0,0.00%,2,2,0.00%
www.malwaretech.com,0,0.00%,2,2,0.00%
p2perrorlog.douyucdn.cn,0,0.00%,2,2,0.00%
sdkapi.douyucdn.cn,0,0.00%,2,2,0.00%
q3.qlogo.cn,0,0.00%,2,2,0.00%
q2.qlogo.cn,0,0.00%,2,2,0.00%
httpdns-sdk.n.netease.com,0,0.00%,1,1,0.00%
interface3.music.163.com.163jiasu.com,0,0.00%,2,2,0.00%
fp-vs-nocache.azureedge.net,0,0.00%,7,7,0.00%
item.m.jd.com,0,0.00%,2,2,0.00%
api.m.jd.com,0,0.00%,6,6,0.00%
mapi.m.jd.com,0,0.00%,2,2,0.00%
wq.jd.com,0,0.00%,4,4,0.00%
hermes.jd.com,0,0.00%,2,2,0.00%
fd.3.cn,0,0.00%,6,6,0.00%
cwx.qlogo.cn,0,0.00%,14,14,0.00%
azurecomcdn.azureedge.net,0,0.00%,12,12,0.00%
bj.bcebos.com,0,0.00%,2,2,0.00%
sst.taptap.com,0,0.00%,1,1,0.00%
sns-img-hw.xhscdn.com.ctdns.cn,0,0.00%,2,2,0.00%
catdot.dianping.com,0,0.00%,2,2,0.00%
wmapi.meituan.com,0,0.00%,1,1,0.00%
appsec-mobile.meituan.com,0,0.00%,2,2,0.00%
mars.meituan.com,0,0.00%,2,2,0.00%
lx0.meituan.com,0,0.00%,2,2,0.00%
api.neixin.cn,0,0.00%,2,2,0.00%
mapi.dianping.com,0,0.00%,2,2,0.00%
smarthome.extend.ott4china.com,0,0.00%,2,2,0.00%
iwx.mail.qq.com,0,0.00%,4,4,0.00%
tva4.sinaimg.cn,0,0.00%,7,7,0.00%
cache.datamart.windows.com,0,0.00%,2,2,0.00%
code2chicken.nl,0,0.00%,6,6,0.00%
www.weibo.com,0,0.00%,32,32,0.00%
pypi.tuna.tsinghua.edu.cn,0,0.00%,3,3,0.00%
jiu.linyeming.pub,0,0.00%,12,12,0.00%
xinpub.bj.bcebos.com,0,0.00%,2,2,0.00%
search.jd.com,0,0.00%,1,1,0.00%
device.auth.xboxlive.com,0,0.00%,4,4,0.00%
buny.uk,0,0.00%,6,6,0.00%
www.pianshen.com,0,0.00%,3,3,0.00%
images4.pianshen.com,0,0.00%,2,2,0.00%
securepubads46.g.doubleclick.net,0,0.00%,4,4,0.00%
thumb4.pianshen.com,0,0.00%,4,4,0.00%
pubads46.g.doubleclick.net,0,0.00%,4,4,0.00%
a.vdo.ai,0,0.00%,6,6,0.00%
images1.pianshen.com,0,0.00%,2,2,0.00%
images2.pianshen.com,0,0.00%,2,2,0.00%
thumb3.pianshen.com,0,0.00%,4,4,0.00%
thumb1.pianshen.com,0,0.00%,4,4,0.00%
thumb2.pianshen.com,0,0.00%,2,2,0.00%
vm.aicdn.com,0,0.00%,2,2,0.00%
images3.pianshen.com,0,0.00%,2,2,0.00%
targeting.vdo.ai,0,0.00%,4,4,0.00%
bitbucket.org,0,0.00%,27,27,0.00%
exp.notion.so,0,0.00%,19,19,0.00%
static.deepl.com,0,0.00%,47,47,0.00%
archive.ubuntu.com,0,0.00%,6,6,0.00%
packages.gitlab.com,0,0.00%,2,2,0.00%
deb.nodesource.com,0,0.00%,2,2,0.00%
web.p.qq.com,0,0.00%,9,9,0.00%
release-75570.gzc.vod.tencent-cloud.com,0,0.00%,26,26,0.00%
b.config.skype.com,0,0.00%,2,2,0.00%
retracker.hotplug.ru,0,0.00%,2,2,0.00%
torrenttracker.nwc.acsalaska.net,0,0.00%,10,10,0.00%
grouptalk.c2c.qq.com,0,0.00%,20,20,0.00%
4th.rcv.sandai.net,0,0.00%,2,2,0.00%
xlmacclient.rcv.sandai.net,0,0.00%,2,2,0.00%
9c7014a46c0245869d50f70a4b2b632b.fp.measure.office.com,0,0.00%,1,1,0.00%
ntd-asus-2014b-en.fbs20.trendmicro.com,0,0.00%,4,4,0.00%
api.jiasu.qq.com,0,0.00%,2,2,0.00%
seal-inner.bytedance.net,0,0.00%,10,10,0.00%
autoupdate.geo.opera.com,0,0.00%,4,4,0.00%
factors.sofire.baidu.com,0,0.00%,2,2,0.00%
bannedbook.github.io,0,0.00%,1,1,0.00%
d1agt99uerx7mo.cloudfront.net,0,0.00%,1,1,0.00%
6c9df887729a4051a17e7866ea3d6402.fp.measure.office.com,0,0.00%,1,1,0.00%
d2-toutiao-ipv6-ml.gslb.ksyuncdn.com,0,0.00%,8,8,0.00%
oss.mail.qq.com,0,0.00%,5,5,0.00%
www.terracotta.org,0,0.00%,1,1,0.00%
yt-adp.ws.126.net,0,0.00%,2,2,0.00%
news.163.com,0,0.00%,2,2,0.00%
dldir1v6.qq.com.legodlied1-dk.sched.dcloudstc.com,0,0.00%,2,2,0.00%
files.pythonhosted.org,0,0.00%,4,4,0.00%
qappcenterv6.3g.qq.com,0,0.00%,1,1,0.00%
cwxlive.qlogo.cn,0,0.00%,1,1,0.00%
cmshow.gtimg.cn,0,0.00%,1,1,0.00%
i.loli.net.cdn.cloudflare.net,0,0.00%,2,2,0.00%
i.imgtg.com.cname2477.yjs-cdn.com,0,0.00%,2,2,0.00%
ipv6check-udp.steamcontent.com,0,0.00%,29,29,0.00%
v.baidu.com,0,0.00%,2,2,0.00%
a.tribalfusion.com,0,0.00%,2,2,0.00%
commobibank.bankofbeijing.com.cn,0,0.00%,2,2,0.00%
www.sinaimg.cn,0,0.00%,2,2,0.00%
xiuxiu-pro.meitudata.com,0,0.00%,2,2,0.00%
im.dingtalk.com,0,0.00%,14,14,0.00%
impaas.alicdn.com,0,0.00%,2,2,0.00%
z7.cnzz.com,0,0.00%,4,4,0.00%
w8249s.iosedge.com,0,0.00%,1,1,0.00%
cidian.youdao.com,0,0.00%,10,10,0.00%
localsaasgap.work.weixin.qq.com,0,0.00%,2,2,0.00%
a.fxltsbl.com,0,0.00%,2,2,0.00%
docs.wps.cn,0,0.00%,7,7,0.00%
terms-drcn.platform.dbankcloud.cn,0,0.00%,2,2,0.00%
pull-rtmp-f6-hs.pstatp.com,0,0.00%,1,1,0.00%
pull-flv-l6-encryption.douyincdn.com,0,0.00%,1,1,0.00%
pull-flv-l95.douyincdn.com,0,0.00%,1,1,0.00%
pull-rtmp-l6.ixigua.com,0,0.00%,1,1,0.00%
pull-hls-spe-l1.douyincdn.com,0,0.00%,1,1,0.00%
push-rtmp-l6.douyincdn.com,0,0.00%,1,1,0.00%
v1-x.douyinvod.com,0,0.00%,2,2,0.00%
v3-cold.douyinvod.com,0,0.00%,2,2,0.00%
a-ring-fallback.msedge.net,0,0.00%,4,4,0.00%
static-asm.secure.skypeassets.com,0,0.00%,14,14,0.00%
beatree.github.io,0,0.00%,1,1,0.00%
v-2a384bf5.71edge.com,0,0.00%,2,2,0.00%
v-2a384401.71edge.com,0,0.00%,2,2,0.00%
v-7a8dc824.71edge.com,0,0.00%,2,2,0.00%
v-7a8dc829.71edge.com,0,0.00%,1,1,0.00%
write-feedback.youdao.com,0,0.00%,2,2,0.00%
p9-passport.byteacctimg.com,0,0.00%,1,1,0.00%
p1-jj.byteimg.com,0,0.00%,1,1,0.00%
hub5idx.v6.shub.sandai.net,0,0.00%,2,2,0.00%
477ddbe756dd4c1475764c89906ebfd0.nrb.footprintdns.com,0,0.00%,1,1,0.00%
v1.hitokoto.cn,0,0.00%,1,1,0.00%
tracker.byr.pt,0,0.00%,8,8,0.00%
3025306375904a22b8abe21a44cf6c34.fp.measure.office.com,0,0.00%,2,2,0.00%
lancache.steamcontent.com,0,0.00%,2,2,0.00%
appdownload.deepl.com,0,0.00%,8,8,0.00%
gd.twy8.tk,0,0.00%,1,1,0.00%
nvd.nist.gov,0,0.00%,2,2,0.00%
tr.fuckbitcoin.xyz,0,0.00%,8,8,0.00%
tracker.open.cd,0,0.00%,2,2,0.00%
5df1b5f826a1418f99964dbe7c50b5ec.fp.measure.office.com,0,0.00%,2,2,0.00%
forgetall.github.io,0,0.00%,1,1,0.00%
a.config.skype.com,0,0.00%,2,2,0.00%
ns3.lacnic.net,0,0.00%,2,2,0.00%
apnic.authdns.ripe.net,0,0.00%,2,2,0.00%
apnic1.dnsnode.net,0,0.00%,2,2,0.00%
ns2.apnic.net,0,0.00%,2,2,0.00%
rirns.arin.net,0,0.00%,2,2,0.00%
polyester-dead-5f6.notion.site,0,0.00%,18,18,0.00%
time4.google.com,0,0.00%,6,6,0.00%
tracker.yarr.pt,0,0.00%,1,1,0.00%
tracker.xn--vzyr4p.top,0,0.00%,12,12,0.00%
698c4c79707a4a0a9ff2a26d75602f92.fp.measure.office.com,0,0.00%,1,1,0.00%
d57xhc.qqscml.ga,0,0.00%,1,1,0.00%
messaging.contact-module.ibm.com,0,0.00%,7,7,0.00%
www.hao123.com,0,0.00%,1,1,0.00%
api.cloud.189.cn,0,0.00%,43,43,0.00%
ins-81eqktfa.ias.tencent-cloud.net,0,0.00%,17,17,0.00%
tedgraham.github.io,0,0.00%,1,1,0.00%
www.tm.prd.ags.trafficmanager.NET,0,0.00%,2,2,0.00%
releases.obsidian.md,0,0.00%,6,6,0.00%
msgacs.youku.com,0,0.00%,9,9,0.00%
tracker.byr.cn,0,0.00%,6,6,0.00%
gslb.xcloud.sandai.net,0,0.00%,9,9,0.00%
hostupdate.vmware.com,0,0.00%,1,1,0.00%
gerpoly.github.io,0,0.00%,1,1,0.00%
t.hdhome.org,0,0.00%,15,15,0.00%
accounts.nvgs.nvidia.com,0,0.00%,3,3,0.00%
hd-v6.mmstat.com.gds.alibabadns.com,0,0.00%,2,2,0.00%
login.tailscale.com,0,0.00%,211,211,0.00%
www.aliyundrive.com,0,0.00%,4,4,0.00%
bt.oiyo.tk,0,0.00%,4,4,0.00%
gzc-download.weiyun.com,0,0.00%,6,6,0.00%
6.beyondth.cn,0,0.00%,2,2,0.00%
tracker.theoks.net,0,0.00%,2,2,0.00%
tracker.nrx.me,0,0.00%,7,7,0.00%
tracker.torrent.eu.org,0,0.00%,5,5,0.00%
open.stealth.si,0,0.00%,4,4,0.00%
playerflash.com,0,0.00%,1,1,0.00%
tracker.iro.moe,0,0.00%,2,2,0.00%
mirror.aptus.co.tz,0,0.00%,2,2,0.00%
tracker.logirl.moe,0,0.00%,4,4,0.00%
upos-sz-staticcos.bilivideo.com,0,0.00%,1,1,0.00%
tamaegis.com,0,0.00%,2,2,0.00%
pti.store.microsoft.com,0,0.00%,2,2,0.00%
ii.gdt.qq.com,0,0.00%,2,2,0.00%
web.qun.qq.com,0,0.00%,3,3,0.00%
clientlog3.music.163.com,0,0.00%,2,2,0.00%
clientlog3.music.ntes53.netease.com,0,0.00%,2,2,0.00%
wagbridge.amap.com,0,0.00%,6,6,0.00%
wagbridge.amap.com.gds.alibabadns.com,0,0.00%,6,6,0.00%
ea119-su121-na610.wagbridge.gaode.com,0,0.00%,4,4,0.00%
ea119-su121-na610.wagbridge.gaode.com.gds.alibabadns.com,0,0.00%,4,4,0.00%
default.cn.zb.na610.wagbridge.amap.alibabacorp.com.gds.alibabadns.com,0,0.00%,8,8,0.00%
apm3.music.ntes53.netease.com,0,0.00%,2,2,0.00%
pk-toutiao-ipv6-ml.gslb.ksyuncdn.com,0,0.00%,2,2,0.00%
zone1-services-cdn.com,0,0.00%,2,2,0.00%
szshort.weixin.qq.com,0,0.00%,3,3,0.00%
zb-443-wagbridge.advertisement.alibaba-inc.com,0,0.00%,2,2,0.00%
zb-443-wagbridge.advertisement.alibaba-inc.com.gds.alibabadns.com,0,0.00%,6,6,0.00%
fp-afd.azurefd.us,0,0.00%,2,2,0.00%
polyfill.io,0,0.00%,2,2,0.00%
pay.weixin.qq.com,0,0.00%,6,6,0.00%
forward.weixin.qq.com,0,0.00%,2,2,0.00%
forwardtmp.weixin.qq.com,0,0.00%,2,2,0.00%
wx.tenpay.com,0,0.00%,6,6,0.00%
forwardwx.weixin.qq.com,0,0.00%,2,2,0.00%
game.weixin.qq.com,0,0.00%,6,6,0.00%
orcid.org,0,0.00%,2,2,0.00%
cdnma.cdnservice.space,0,0.00%,2,2,0.00%
tg35v6.syscdn.zjsxlt.com,0,0.00%,4,4,0.00%
ipv4-ipv6-phase4.inf.vip.meituan.com,0,0.00%,2,2,0.00%
ins-ryzwhfd8.ias.tencent-cloud.net,0,0.00%,2,2,0.00%
video-bd-drcn.dbankcdn.cn.a.bdydns.com,0,0.00%,4,4,0.00%
opencdnhwv6.jomodns.com,0,0.00%,5,5,0.00%
1180c.ec.azureedge.net,0,0.00%,2,2,0.00%
lb.apr-1180c.edgecastdns.net,0,0.00%,2,2,0.00%
cs10.wpc.v0cdn.net,0,0.00%,2,2,0.00%
tracker-udp.gbitt.info,0,0.00%,4,4,0.00%
qg.lorzl.gq,0,0.00%,2,2,0.00%
ipv6.tracker.harry.lu,0,0.00%,4,4,0.00%
tracker.btsync.gq,0,0.00%,4,4,0.00%
liquipedia.net,0,0.00%,2,2,0.00%
fvideo.gslb.sinaedge.com,0,0.00%,2,2,0.00%
mam6.netease.com,0,0.00%,2,2,0.00%
weibointl.api.weibo.cn,0,0.00%,2,2,0.00%
weicolog.api.weibo.cn,0,0.00%,2,2,0.00%
opencdnbaiduwm.jomodns.com,0,0.00%,6,6,0.00%
z.gds.cnzz.com,0,0.00%,4,4,0.00%
nj.cschannel.anticheatexpert.com,0,0.00%,4,4,0.00%
clientlog.music.163.com,0,0.00%,9,9,0.00%
d2rb60829qiz9y.cloudfront.net,0,0.00%,5,5,0.00%
ipv6check-http.steamcontent.com,0,0.00%,7,7,0.00%
api-kos.wps.cn,0,0.00%,3,3,0.00%
bbs-api.mihoyo.com,0,0.00%,2,2,0.00%
default.tdatamaster.com,0,0.00%,1,1,0.00%
v.xiaohongshu.com,0,0.00%,1,1,0.00%
sns-video-qc.xhscdn.com,0,0.00%,1,1,0.00%
store.xiaohongshu.com,0,0.00%,1,1,0.00%
ads-video-al.xhscdn.com,0,0.00%,1,1,0.00%
hyperledger.github.io,0,0.00%,1,1,0.00%
cdnjs.cloudflare.com,0,0.00%,5,5,0.00%
errlog.umeng.com,0,0.00%,2,2,0.00%
zijunsoftware.github.io,0,0.00%,1,1,0.00%
tracker.fdn.fr,0,0.00%,2,2,0.00%
d4530f092085467290e7294583c9e271.fp.measure.office.com,0,0.00%,1,1,0.00%
summer.igamantasenta.tk,0,0.00%,1,1,0.00%
kooofly.github.io,0,0.00%,61,61,0.00%
l-0007.config.skype.com,0,0.00%,8,8,0.00%
api.8864029a8b01d50a95d558b5792ce2d6.com,0,0.00%,2,2,0.00%
education-certification.youdao.com,0,0.00%,1,1,0.00%
ydpushserver.youdao.com,0,0.00%,1,1,0.00%
wow.youdao.com,0,0.00%,2,2,0.00%
wow-activity.youdao.com,0,0.00%,2,2,0.00%
v2.shyonghui.xyz,0,0.00%,1,1,0.00%
sofire.bdstatic.com,0,0.00%,1,1,0.00%
music.91q.com,0,0.00%,1,1,0.00%
passport.bdimg.com,0,0.00%,1,1,0.00%
aqyzmedia.yunaq.com,0,0.00%,2,2,0.00%
v.yunaq.com,0,0.00%,2,2,0.00%
tjs.sjs.sinajs.cn,0,0.00%,2,2,0.00%
set.gosts.gq,0,0.00%,1,1,0.00%
loggw.alipay.com.cn,0,0.00%,2,2,0.00%
brxt-research.mendeley.com,0,0.00%,2,2,0.00%
s.c-ctrip.com,0,0.00%,2,2,0.00%
static-ecst.licdn.com,0,0.00%,2,2,0.00%
newclient.map.baidu.com,0,0.00%,2,2,0.00%
client.map.baidu.com,0,0.00%,2,2,0.00%
mx3.qq.com,0,0.00%,4,4,0.00%
mx2.qq.com,0,0.00%,4,4,0.00%
mx1.qq.com,0,0.00%,4,4,0.00%
bdbus-turbonet.baidu.com,0,0.00%,2,2,0.00%
android.bugly.qq.com,0,0.00%,2,2,0.00%
data.ab.qq.com,0,0.00%,6,6,0.00%
s.1688.com,0,0.00%,2,2,0.00%
crl.usertrust.com,0,0.00%,20,20,0.00%
inversine.elseway.tk,0,0.00%,61,61,0.00%
vcityteam.github.io,0,0.00%,1,1,0.00%
hello-sherlock.github.io,0,0.00%,1,1,0.00%
discuss.pytorch.org,0,0.00%,2,2,0.00%
mailhz.qiye.163.com,0,0.00%,4,4,0.00%
whois.apnic.net,0,0.00%,2,2,0.00%
sports.sina.com.cn,0,0.00%,4,4,0.00%
spool.grid.sinaedge.com,0,0.00%,6,6,0.00%
77cc0354e07c40e594af60b5dc28cfa9.fp.measure.office.com,0,0.00%,1,1,0.00%
features.opera-api.com,0,0.00%,2,2,0.00%
upgrade.xl9.xunlei.com,0,0.00%,2,2,0.00%
weaverluke.github.io,0,0.00%,1,1,0.00%
community.adobe.com,0,0.00%,1,1,0.00%
i-45.b-45966.bench.utorrent.com,0,0.00%,2,2,0.00%
tracker.parrotsec.org,0,0.00%,12,12,0.00%
ws.sidequestvr.com,0,0.00%,2,2,0.00%
aruni-01.github.io,0,0.00%,61,61,0.00%
www.usps.com,0,0.00%,1,1,0.00%
ui.ptlogin2.qq.com,0,0.00%,3,3,0.00%
test.chenguaself.tk,0,0.00%,1,1,0.00%
P2pstunTesT.HApLAT.nET,0,0.00%,2,2,0.00%
ifrcye.qqscml.ml,0,0.00%,61,61,0.00%
xsf1re.github.io,0,0.00%,1,1,0.00%
mirrors.sjtug.sjtu.edu.cn,0,0.00%,2,2,0.00%
trouter-azsc-asse-0-b.trouter.skype.com,0,0.00%,2,2,0.00%
ipv4-ipv6.inf-epd.vip.meituan.com,0,0.00%,2,2,0.00%
pbaccess.video.qq.com,0,0.00%,8,8,0.00%
www.tm.prd.ags.akadns.net,0,0.00%,4,4,0.00%
connectivitycheck.cbg-app.huawei.com,0,0.00%,4,4,0.00%
m.gtld-servers.net,0,0.00%,2,2,0.00%
dacc1cab04424825bac7fcecb69b083b.fp.measure.office.com,0,0.00%,1,1,0.00%
time1.google.com,0,0.00%,10,10,0.00%
de10774d9ac04277893691c9a05b1ddb.fp.measure.office.com,0,0.00%,1,1,0.00%
as.com,0,0.00%,3,3,0.00%
s.booster-up.cf,0,0.00%,1,1,0.00%
ssv6.zhengmingz.top,0,0.00%,3,3,0.00%
az700632-pme.ec.azureedge.net,0,0.00%,5,5,0.00%
updates.logitech.com,0,0.00%,1,1,0.00%
amd-infra.itunes.g.aaplimg.com,0,0.00%,2,2,0.00%
amd-infra-overflow.itunes-apple.com.akadns.net,0,0.00%,1,1,0.00%
az667904-pme.azureedge.net,0,0.00%,6,6,0.00%
default.dualstack.cn.zb.wagbridge.umeng.alibabacorp.com,0,0.00%,2,2,0.00%
default.dualstack.cn.zb.wagbridge.umeng.alibabacorp.com.gds.alibabadns.com,0,0.00%,2,2,0.00%
udp.ipv6check.akadns.net,0,0.00%,2,2,0.00%
east-asia.udp.ipv6check.akadns.net,0,0.00%,2,2,0.00%
teams.live.com,0,0.00%,1,1,0.00%
data6.video.iqiyi.com,0,0.00%,1,1,0.00%
swdlcdn.eastmoney.com,0,0.00%,2,2,0.00%
cdn.mathjax.org,0,0.00%,2,2,0.00%
jekyllrb.com,0,0.00%,2,2,0.00%
registry.npmjs.org,0,0.00%,2,2,0.00%
widget-v4.tidiochat.com,0,0.00%,2,2,0.00%
download.gfe.nvidia.com,0,0.00%,1,1,0.00%
avatars.githubusercontent.com,0,0.00%,3,3,0.00%
bat.bing.com,0,0.00%,2,2,0.00%
vscodeexperiments.azureedge.net,0,0.00%,2,2,0.00%
apd-2238e910f61afaa3600f4a1a886aec1016e99dc1782446f4.v.smtcdns.com,0,0.00%,2,2,0.00%
cdn.plyr.io,0,0.00%,5,5,0.00%
cloudflare-dns.com,0,0.00%,2,2,0.00%
apd-fd674f5234f262048297f0b2d59a42809f5c1e825b7db8b3.v.smtcdns.com,0,0.00%,4,4,0.00%
mhjhjt.ncvhvdd.ga,0,0.00%,1,1,0.00%
dualstack.tls13.taboola.map.fastly.net,0,0.00%,2,2,0.00%
p2PStuntEST.hAplaT.NeT,0,0.00%,2,2,0.00%
adsp.xunlei.com,0,0.00%,2,2,0.00%
baoxian.pingan.com,0,0.00%,4,4,0.00%
baoxian.pingan.com.paxdn.com,0,0.00%,4,4,0.00%
www.ct.glbs.qunar.com,0,0.00%,2,2,0.00%
vata.ct.glbs.qunar.com,0,0.00%,2,2,0.00%
4-courier2.push.apple.com,0,0.00%,2,2,0.00%
comm.weixinbridge.com,0,0.00%,1,1,0.00%
cgyx.ccgp.gov.cn,0,0.00%,4,4,0.00%
xbtrutor.com,0,0.00%,6,6,0.00%
free.open.tracker.4.starka.st,0,0.00%,4,4,0.00%
xtvj.github.io,0,0.00%,61,61,0.00%
osint.bambenekconsulting.com,0,0.00%,10,10,0.00%
ns3-38.azure-dns.org,0,0.00%,2,2,0.00%
ns4-04.azure-dns.info,0,0.00%,2,2,0.00%
sh.mp.weixin.qq.com,0,0.00%,4,4,0.00%
q1.qlogo.cn,0,0.00%,2,2,0.00%
valid-apple.g.aaplimg.com,0,0.00%,2,2,0.00%
mirrors.coreix.net,0,0.00%,4,4,0.00%
nginx.org,0,0.00%,4,4,0.00%
s0.ssl.qhimg.com,0,0.00%,2,2,0.00%
hao1.qhimg.com,0,0.00%,1,1,0.00%
hao3.qhimg.com,0,0.00%,2,2,0.00%
s1.ssl.qhres2.com,0,0.00%,1,1,0.00%
P2pSTUnTEST.HAPlAT.Net,0,0.00%,2,2,0.00%
conf.wifi.360.cn,0,0.00%,2,2,0.00%
cs3.wpc.v0cdn.net,0,0.00%,2,2,0.00%
discovery-v6-4.syncthing.net,0,0.00%,4,4,0.00%
time2.google.com,0,0.00%,4,4,0.00%
time3.google.com,0,0.00%,4,4,0.00%
t.btcland.xyz,0,0.00%,10,10,0.00%
chienlungcheung.github.io,0,0.00%,1,1,0.00%
www263.ff-01.com,0,0.00%,1,1,0.00%
ivanzhangwb.github.io,0,0.00%,1,1,0.00%
gsp-ssl.ls-apple.com.akadns.net,0,0.00%,2,2,0.00%
gsp-ssl-geomap.ls-apple.com.akadns.net,0,0.00%,2,2,0.00%
gspx-ssl.ls.apple.com,0,0.00%,1,1,0.00%
get-bx.g.aaplimg.com,0,0.00%,2,2,0.00%
ftp.sjtu.edu.cn,0,0.00%,2,2,0.00%
ns-cloud-c4.googledomains.com,0,0.00%,2,2,0.00%
ns-cloud-c1.googledomains.com,0,0.00%,2,2,0.00%
ns-206.awsdns-25.com,0,0.00%,2,2,0.00%
18ad87839a385ab34d95d0cb4cb02cf0.clo.footprintdns.com,0,0.00%,1,1,0.00%
fp-vs.azureedge.net,0,0.00%,4,4,0.00%
caldavhz.qiye.163.com,0,0.00%,2,2,0.00%
7e8d16d81f094aa4a419f922602d3ff8.fp.measure.office.com,0,0.00%,2,2,0.00%
account.live.com,0,0.00%,4,4,0.00%
acctcdn.msauth.net,0,0.00%,2,2,0.00%
wildcard.fedoraproject.org,0,0.00%,4,4,0.00%
update.glados-config.com,0,0.00%,2,2,0.00%
dsiw.github.io,0,0.00%,61,61,0.00%
gabrielpict.github.io,0,0.00%,1,1,0.00%
bfdmirrors.s.tuna.tsinghua.edu.cn,0,0.00%,10,10,0.00%
c332e8a52b80421d98475ee9ac54529c.fp.measure.office.com,0,0.00%,1,1,0.00%
wheat.fggfcgf.ga,0,0.00%,1,1,0.00%
channel2rss.bitmachine.org,0,0.00%,2,2,0.00%
ea193d47272b4903a646225029b56c4f.fp.measure.office.com,0,0.00%,1,1,0.00%
acc.qq.com,0,0.00%,1,1,0.00%
zhong0316.github.io,0,0.00%,1,1,0.00%
www1613.ff-04.com,0,0.00%,1,1,0.00%
s2.xoimg.com,0,0.00%,2,2,0.00%
mengzelev.github.io,0,0.00%,1,1,0.00%
clients.config.office.net,0,0.00%,2,2,0.00%
view.inews.qq.com,0,0.00%,2,2,0.00%
ugg.weishi.qq.com,0,0.00%,2,2,0.00%
apm-and.zhipin.com,0,0.00%,2,2,0.00%
ocsps.ssl.com,0,0.00%,6,6,0.00%
db5716534253222d0bf6b12502546a0b.nrb.footprintdns.com,0,0.00%,1,1,0.00%
dualstack-restsdk.amap.com,0,0.00%,2,2,0.00%
masdkv6.3g.qq.com,0,0.00%,2,2,0.00%
ant.design,0,0.00%,2,2,0.00%
2bb3ea7b630d02d73d1b78cc36ab71d8040199cce97f5fc6.dlied1.cdntips.net,0,0.00%,1,1,0.00%
P2pSTUntEst.hAPLat.net,0,0.00%,1,1,0.00%
Www.vOd.lxDns.COM,0,0.00%,1,1,0.00%
ocsp.comodoca.com,0,0.00%,2,2,0.00%
ocsp.comodoca.com.cdn.cloudflare.net,0,0.00%,8,8,0.00%
ocsp.usertrust.com,0,0.00%,10,10,0.00%
ocsp.sectigo.com,0,0.00%,4,4,0.00%
my.maxon.net,0,0.00%,6,6,0.00%
awaken.amap.com,0,0.00%,2,2,0.00%
awaken.amap.com.gds.alibabadns.com,0,0.00%,2,2,0.00%
tracker.m-team.cc,0,0.00%,2,2,0.00%
vd6.l.qq.com,0,0.00%,4,4,0.00%
seedbay.net,0,0.00%,2,2,0.00%
tr.greenhat.be,0,0.00%,2,2,0.00%
q-client.cn-hongkong.log.aliyuncs.com,0,0.00%,4,4,0.00%
teams-ring.msedge.net,0,0.00%,2,2,0.00%
fp-afd-nocache-ccp.azureedge.net,0,0.00%,2,2,0.00%
zhengxin-pub.bj.bcebos.com,0,0.00%,2,2,0.00%
prod.detectportal.prod.cloudops.mozgcp.NET,0,0.00%,2,2,0.00%
repo.steampowered.com,0,0.00%,2,2,0.00%
jp.tiar.app,0,0.00%,1,1,0.00%
az700632-pme.azureedge.net,0,0.00%,2,2,0.00%
ose.caiyun.feixin.10086.cn,0,0.00%,2,2,0.00%
ose1.caiyun.feixin.10086.cn,0,0.00%,2,2,0.00%
explodie.org,0,0.00%,2,2,0.00%
trackerxyz.tk,0,0.00%,2,2,0.00%
tracker.sandrotracker.biz,0,0.00%,2,2,0.00%
glotorrents.pw,0,0.00%,2,2,0.00%
bt.xxxtor.com,0,0.00%,2,2,0.00%
tracker.sbsub.com,0,0.00%,2,2,0.00%
img2x-v6-sched.jcloudedge.com,0,0.00%,1,1,0.00%
default.cn.zb.na610.wagbridge.amap.alibabacorp.com,0,0.00%,1,1,0.00%
rl.mail.qq.com,0,0.00%,2,2,0.00%
ssl.ptlogin2.qq.com,0,0.00%,2,2,0.00%
img-hxy021.didistatic.com,0,0.00%,1,1,0.00%
img-hxy021.didistatic.com.download.ks-cdn.com,0,0.00%,2,2,0.00%
k112.gslb.ksyuncdn.com,0,0.00%,2,2,0.00%
mp.4dex.io,0,0.00%,2,2,0.00%
mail.dingtalk.com,0,0.00%,6,6,0.00%
d2.sina.com.cn,0,0.00%,2,2,0.00%
mjs.sinaimg.cn,0,0.00%,2,2,0.00%
d7.sina.com.cn,0,0.00%,2,2,0.00%
mjs.gslb.sinaedge.com,0,0.00%,2,2,0.00%
cpro.baidustatic.com.a.bdydns.com,0,0.00%,2,2,0.00%
d6.sina.com.cn,0,0.00%,2,2,0.00%
d0.sina.com.cn,0,0.00%,2,2,0.00%
18a61f12f06b43b5960070b536ac8362.fp.measure.office.com,0,0.00%,1,1,0.00%
g37.gph.netease.com,0,0.00%,1,1,0.00%
file.wx2.qq.com,0,0.00%,1,1,0.00%
kzx.yilanvaas.cn,0,0.00%,1,1,0.00%
collabrtc.officeapps.live.com,0,0.00%,1,1,0.00%
fsandroid.hw.kugou.com,0,0.00%,1,1,0.00%
push.m.youku.com,0,0.00%,4,4,0.00%
secgw-ipv6-aserver-heyi.m.taobao.com,0,0.00%,4,4,0.00%
secgw-ipv6-aserver-heyi.m.taobao.com.gds.alibabadns.com,0,0.00%,6,6,0.00%
acs.m.taobao.com.gds.alibabadns.com,0,0.00%,2,2,0.00%
dualstack-na610-na620.acs.m.taobao.com,0,0.00%,2,2,0.00%
dualstack-na610-na620.acs.m.taobao.com.gds.alibabadns.com,0,0.00%,2,2,0.00%
mum.m.alibaba.com,0,0.00%,2,2,0.00%
mum.m.alibaba.com.gds.alibabadns.com,0,0.00%,2,2,0.00%
secgw-dualstack-na61-na62.wagbridge.alibaba.alibaba.com,0,0.00%,2,2,0.00%
secgw-dualstack-na61-na62.wagbridge.alibaba.alibaba.com.gds.alibabadns.com,0,0.00%,6,6,0.00%
eco.taobao.com,0,0.00%,2,2,0.00%
eco.taobao.com.gds.alibabadns.com,0,0.00%,4,4,0.00%
dualstack-na61-na62.wagbridge.alibaba.taobao.com,0,0.00%,4,4,0.00%
abtest.alibaba.com,0,0.00%,2,2,0.00%
abtest.alibaba.com.gds.alibabadns.com,0,0.00%,2,2,0.00%
report.imtt.qq.com,0,0.00%,2,2,0.00%
tax.51fapiao.cn,0,0.00%,2,2,0.00%
piccolofe.qunar.com,0,0.00%,2,2,0.00%
sghtt.readvi.cf,0,0.00%,1,1,0.00%
odinvzc.azureedge.net,0,0.00%,2,2,0.00%
a1-6.akam.net,0,0.00%,2,2,0.00%
bhrutledge.github.io,0,0.00%,1,1,0.00%
xingwenzhang.github.io,0,0.00%,1,1,0.00%
ns2.ena.com,0,0.00%,2,2,0.00%
aaid.umeng.com,0,0.00%,2,2,0.00%
api-overmind.youdao.com,0,0.00%,2,2,0.00%
foundation.youdao.com,0,0.00%,2,2,0.00%
t11.baidu.com.a.bdydns.com,0,0.00%,1,1,0.00%
a.nel.cloudflare.com,0,0.00%,1,1,0.00%
api.snoopi.io,0,0.00%,4,4,0.00%
d.wn51.com,0,0.00%,2,2,0.00%
studio.youtube.com,0,0.00%,1,1,0.00%
t2.appmeasurements.com,0,0.00%,2,2,0.00%
jia-shijie.github.io,0,0.00%,2,2,0.00%
cdn.clustrmaps.com,0,0.00%,1,1,0.00%
clustrmaps.com,0,0.00%,2,2,0.00%
merchandise.opera-api.com,0,0.00%,2,2,0.00%
1fw4seq.daae.ml,0,0.00%,1,1,0.00%
upload.wikimedia.org,0,0.00%,2,2,0.00%
radio.itunes.apple.com,0,0.00%,1,1,0.00%
radio-activity.itunes.apple.com,0,0.00%,1,1,0.00%
v27-cold1.douyinvod.com,0,0.00%,1,1,0.00%
v27-cold1.douyinvod.com.vod.galileo.jcloud-cdn.com,0,0.00%,1,1,0.00%
sapphire.azurefd.net,0,0.00%,2,2,0.00%
star-azurefd-prod.trafficmanager.net,0,0.00%,2,2,0.00%
part-0021.t-0009.t-msedge.net,0,0.00%,2,2,0.00%
ukibm.ptuu.ga,0,0.00%,33,33,0.00%
www.letpub.com.cn,0,0.00%,1,1,0.00%
1688living.alicdn.com,0,0.00%,2,2,0.00%
trade.jd.com,0,0.00%,2,2,0.00%
jdqd.jd.com,0,0.00%,2,2,0.00%
cm.e.qq.com,0,0.00%,2,2,0.00%
mybank.landbank.com.tw,0,0.00%,1,1,0.00%
xkx1ga8a2k.fowce.gq,0,0.00%,1,1,0.00%
d1flfk77wl2xk4.cloudfront.net,0,0.00%,61,61,0.00%
mon3-misc-lq.fqnovel.com.w.cdngslb.com,0,0.00%,1,1,0.00%
loggw-ex.alipay.com,0,0.00%,2,2,0.00%
loggw.alipay.com,0,0.00%,2,2,0.00%
loggw.alipaydns.com,0,0.00%,1,1,0.00%
video.qq.com,0,0.00%,2,2,0.00%
p9.img.360kuai.com,0,0.00%,1,1,0.00%
telv6.music.ntes53.netease.com,0,0.00%,2,2,0.00%
187jlff4syi785wh.aliyunddos1006.com,0,0.00%,1,1,0.00%
s.marvellousmachine.net,0,0.00%,2,2,0.00%
public.popcorn-tracker.org,0,0.00%,2,2,0.00%
2535b3af5a8f87c587fee54c4f369c98.nrb.footprintdns.com,0,0.00%,1,1,0.00%
9258f60d44405386fbd0098ab2bce39d.clo.footprintdns.com,0,0.00%,1,1,0.00%
static.tieba.baidu.com,0,0.00%,4,4,0.00%
dmd-fifajs-h5-ikuweb-hb.youku.com,0,0.00%,4,4,0.00%
aec2b66bf6a74432b0e196159b85cf24.fp.measure.office.com,0,0.00%,1,1,0.00%
mi.gdt.qq.com,0,0.00%,1,1,0.00%
v2.gdt.qq.com,0,0.00%,2,2,0.00%
www.ccgp.gov.cn,0,0.00%,1,1,0.00%
download.ccgp.gov.cn,0,0.00%,1,1,0.00%
cgjh.ccgp.gov.cn,0,0.00%,1,1,0.00%
pub.ccgp.gov.cn,0,0.00%,1,1,0.00%
www.ccgp-beijing.gov.cn,0,0.00%,1,1,0.00%
www.ccgp-chongqing.gov.cn,0,0.00%,1,1,0.00%
www.ccgp-dalian.gov.cn,0,0.00%,2,2,0.00%
www.ccgp-tianjin.gov.cn,0,0.00%,1,1,0.00%
www.ccgp-anhui.gov.cn,0,0.00%,2,2,0.00%
xygh.ccgp.gov.cn,0,0.00%,1,1,0.00%
www.ccgp-gansu.gov.cn,0,0.00%,1,1,0.00%
www.ccgp-hebei.gov.cn,0,0.00%,1,1,0.00%
www.ccgp-jilin.gov.cn,0,0.00%,1,1,0.00%
www.ccgp-neimenggu.gov.cn,0,0.00%,2,2,0.00%
xluser-ssl.xunlei.com,0,0.00%,1,1,0.00%
flv0.bn.netease.com,0,0.00%,1,1,0.00%
zfwzgl.www.gov.cn,0,0.00%,3,3,0.00%
as.weixin.qq.com,0,0.00%,1,1,0.00%
h5.gdt.qq.com,0,0.00%,1,1,0.00%
apd-e5a728a6ff408136351b8652bc5b1f659cca5770f7c014b7.v.smtcdns.com,0,0.00%,1,1,0.00%
p26-be-pack-sign.pglstatp-toutiao.com,0,0.00%,1,1,0.00%
pc.us.sinaimg.cn,0,0.00%,1,1,0.00%
ad.us.sinaimg.cn,0,0.00%,1,1,0.00%
mini.eastday.com,0,0.00%,1,1,0.00%
ttpcssp.dftoutiao.com,0,0.00%,1,1,0.00%
cclibraries-defaults-cdn.adobe.com,0,0.00%,1,1,0.00%
k.us.sinaimg.cn,0,0.00%,1,1,0.00%
simg.s.weibo.com,0,0.00%,3,3,0.00%
jczy.ccgp.gov.cn,0,0.00%,1,1,0.00%
livewebbs2.msstatic.com,0,0.00%,1,1,0.00%
pypi.python.org,0,0.00%,1,1,0.00%
unmc.bj.bcebos.com,0,0.00%,1,1,0.00%
c.l.qq.com,0,0.00%,2,2,0.00%
fw.bjrcgz.gov.cn,0,0.00%,2,2,0.00%
yzt.beijing.gov.cn,0,0.00%,2,2,0.00%
fp-vp.azureedge.net,0,0.00%,2,2,0.00%
t-ring.msedge.net,0,0.00%,2,2,0.00%
k-ring-fallback.msedge.net,0,0.00%,2,2,0.00%
17c3525ea373e7dcd755c44614cab498.clo.footprintdns.com,0,0.00%,2,2,0.00%
apm3.music.163.com,0,0.00%,2,2,0.00%
metrics.raptr.com,0,0.00%,4,4,0.00%
ap.dongqiudi.com,0,0.00%,3,3,0.00%
voc.dongqiudi.com,0,0.00%,1,1,0.00%
pom.gslb.topgslb.com,0,0.00%,4,4,0.00%
detail.dongqiudi.com,0,0.00%,3,3,0.00%
hwvv.yilanvaas.com,0,0.00%,1,1,0.00%
default.cn.nt.wagbridge.amap.alibabacorp.com.gds.alibabadns.com,0,0.00%,1,1,0.00%
qv2ray.net,0,0.00%,4,4,0.00%
71af3c49ed2440e0aab9aaa2c992dd6a.fp.measure.office.com,0,0.00%,1,1,0.00%
asanzdiego.github.io,0,0.00%,1,1,0.00%
lana.ns.cloudflare.com,0,0.00%,2,2,0.00%
jim.ns.cloudflare.com,0,0.00%,2,2,0.00%
faxu.github.io,0,0.00%,1,1,0.00%
packagecloud.io,0,0.00%,2,2,0.00%
upd-pct.info,0,0.00%,2,2,0.00%
dd16a5f677c14ac98f667e7cb350bdb0.fp.measure.office.com,0,0.00%,1,1,0.00%
globalconfig.flashlightproxy.com,0,0.00%,2,2,0.00%
erodner.github.io,0,0.00%,1,1,0.00%
sumihui.github.io,0,0.00%,61,61,0.00%
hideuvpn.github.io,0,0.00%,3,3,0.00%
middle.yun.139.com,0,0.00%,2,2,0.00%
derwh.github.io,0,0.00%,1,1,0.00%
oclc-research.github.io,0,0.00%,1,1,0.00%
www.tm.prd.ags.trafficmanager.net,0,0.00%,2,2,0.00%
config.teams.trafficmanager.net,0,0.00%,2,2,0.00%
s-0005-teams.config.skype.com,0,0.00%,1,1,0.00%
config-teams.s-0005.s-msedge.net,0,0.00%,2,2,0.00%
secgw-dualstack-na61-na62.wagbridge.alibaba.alibabacorp.com.gds.alibabadns.com,0,0.00%,2,2,0.00%
dl.yarnpkg.com,0,0.00%,1,1,0.00%
C.ROOT-SERVERS.NET,0,0.00%,1,1,0.00%
s.safe.360.cn.qh-cdn.com,0,0.00%,2,2,0.00%
community.dynv6.com,0,0.00%,1,1,0.00%
efc.console.aliyun.com,0,0.00%,2,2,0.00%
1j6fp2.tdum.alibaba.com,0,0.00%,1,1,0.00%
rlsbj.cq.gov.cn,0,0.00%,2,2,0.00%
ggfw.rlsbj.cq.gov.cn,0,0.00%,2,2,0.00%
www.cq.gov.cn,0,0.00%,2,2,0.00%
www.mfa.gov.cn.wswebpic.com,0,0.00%,2,2,0.00%
www.most.gov.cn,0,0.00%,2,2,0.00%
f12692e13eedebb5.cname.365cyd.cn,0,0.00%,2,2,0.00%
d40dac83244cce3f.cname.365cyd.cn,0,0.00%,2,2,0.00%
c04d9a6c18a75906.qaxcloudwaf.com,0,0.00%,2,2,0.00%
www.mwr.gov.cn,0,0.00%,2,2,0.00%
www.mofcom.gov.cn.wswebcdn.com,0,0.00%,2,2,0.00%
8b5acd0b352d6794.icloudwaf.com,0,0.00%,2,2,0.00%
1c7c823fec3c8fe6.vip.jiasule.org,0,0.00%,2,2,0.00%
bff48095604a493c.qaxanyuv6.com,0,0.00%,2,2,0.00%
www.mem.gov.cn.wswebpic.com,0,0.00%,2,2,0.00%
23c693c079a30bf1.cdn.jiashule.com,0,0.00%,2,2,0.00%
b56e8d53ceb0ac5b.cdn.jiashule.com,0,0.00%,2,2,0.00%
062493db1b0f999e.vip.jiasule.org,0,0.00%,2,2,0.00%
www.chinatax.gov.cn.wswebcdn.com,0,0.00%,2,2,0.00%
www.nrta.gov.cn.wsssec.com,0,0.00%,2,2,0.00%
www.sport.gov.cn.cdn20.com,0,0.00%,2,2,0.00%
0417861b351234d9.qaxcloudwaf.com,0,0.00%,2,2,0.00%
d0b39c937db1d9e8.qaxcloudwaf.com,0,0.00%,2,2,0.00%
ce5c4cf757a9a3e1.cname.365cyd.cn,0,0.00%,2,2,0.00%
a45ca037923a741f.qaxcloudwaf.com,0,0.00%,2,2,0.00%
www.ln.gov.cn,0,0.00%,2,2,0.00%
3f84049c68b5289d.qaxcloudwaf.com,0,0.00%,2,2,0.00%
451e4e8b7e80208a.qaxcloudwaf.com,0,0.00%,2,2,0.00%
hlj-gov-cn.cname.saaswaf.com,0,0.00%,2,2,0.00%
817b85f24b69fdf8.vip.jiasule.org,0,0.00%,2,2,0.00%
www.zj.gov.cn.v6lvs.com,0,0.00%,2,2,0.00%
www.fujian.gov.cn,0,0.00%,2,2,0.00%
www.henan.gov.cn.cdn30.com,0,0.00%,2,2,0.00%
sdgov.cache.dbappwaf.cn,0,0.00%,2,2,0.00%
jyhpt00.llb.chutianyun.gov.cn,0,0.00%,2,2,0.00%
www.gd.gov.cn,0,0.00%,2,2,0.00%
www.gxzf.gov.cn,0,0.00%,2,2,0.00%
www.sc.gov.cn,0,0.00%,2,2,0.00%
www.guizhou.gov.cn,0,0.00%,2,2,0.00%
www.xizang.gov.cn,0,0.00%,2,2,0.00%
ordercenter.console.aliyun.com,0,0.00%,2,2,0.00%
api.wordtune.com,0,0.00%,2,2,0.00%
arxiv.paperswithcode.com,0,0.00%,2,2,0.00%
replicate.com,0,0.00%,2,2,0.00%
code.jquery.com,0,0.00%,2,2,0.00%
index.docker.io,0,0.00%,1,1,0.00%
finance.sina.com.cn,0,0.00%,4,4,0.00%
ddaiservices.azurefd.net,0,0.00%,2,2,0.00%
d19drxlmdpc1ad.cloudfront.net,0,0.00%,61,61,0.00%
P2PStuNteST.HaPLAt.NET,0,0.00%,2,2,0.00%
ns1-03.azure-dns.com,0,0.00%,2,2,0.00%
