domain,num_a_fail,rate_all,num_a_all,num_a_success,rate_a_fail
rq.r9t1.com,4678,8.15%,9112,4434,51.34%
asia.pool.ntp.org,4394,7.65%,9006,4612,48.79%
cn.pool.ntp.org,4228,7.36%,9004,4776,46.96%
optimizationguide-pa.googleapis.com,3440,5.99%,6994,3554,49.19%
big1.f5.lenovo.com.cn,1599,2.79%,1599,0,100.00%
big2.f5.lenovo.com.cn,1586,2.76%,1586,0,100.00%
1.ubuntu.pool.ntp.org,1314,2.29%,1336,22,98.35%
3.ubuntu.pool.ntp.org,1197,2.09%,1223,26,97.87%
2.ubuntu.pool.ntp.org,1150,2.00%,1170,20,98.29%
0.ubuntu.pool.ntp.org,1121,1.95%,1137,16,98.59%
safebrowsing.googleapis.com,1094,1.91%,2325,1231,47.05%
www.taobao.com,886,1.54%,1860,974,47.63%
clientservices.googleapis.com,843,1.47%,1736,893,48.56%
registry-1.docker.io,830,1.45%,1088,258,76.29%
liveupdate5.f5.lenovo.com.cn,793,1.38%,793,0,100.00%
femetrics.grammarly.io,734,1.28%,1543,809,47.57%
update.googleapis.com,733,1.28%,1202,469,60.98%
browser.360.cn,675,1.18%,1461,786,46.20%
ipv6.msftconnecttest.com,631,1.10%,1187,556,53.16%
android.clients.google.com,582,1.01%,1256,674,46.34%
data.bilibili.com,579,1.01%,1236,657,46.84%
d27xxe7juh1us6.cloudfront.net,578,1.01%,1184,606,48.82%
zyx.qq.com,547,0.95%,1327,780,41.22%
clients1.google.com,493,0.86%,1115,622,44.22%
eth.2miners.com,448,0.78%,449,1,99.78%
asia1.ethermine.org,447,0.78%,462,15,96.75%
ns2.namebrightdns.com,445,0.78%,1040,595,42.79%
mirrors.aliyun.com,439,0.76%,474,35,92.62%
us2.ethermine.org,436,0.76%,436,0,100.00%
ns1.namebrightdns.com,435,0.76%,996,561,43.67%
us1.ethermine.org,434,0.76%,435,1,99.77%
eu1.ethermine.org,434,0.76%,436,2,99.54%
2.centos.pool.ntp.org,392,0.68%,536,144,73.13%
www.sohu.com,322,0.56%,725,403,44.41%
hub5pn.v6.sandai.net,312,0.54%,312,0,100.00%
gecko-bd.feishu.cn,307,0.53%,638,331,48.12%
vconf.f.360.cn,290,0.51%,577,287,50.26%
1hkclu.pronetworklink.net,289,0.50%,681,392,42.44%
www.qq.com,286,0.50%,4088,3802,7.00%
ntp.sjtu.edu.cn,253,0.44%,253,0,100.00%
www.ieee.org,246,0.43%,546,300,45.05%
gateway.fe.apple-dns.net,236,0.41%,554,318,42.60%
0.centos.pool.ntp.org,234,0.41%,234,0,100.00%
firefox.settings.services.mozilla.com,229,0.40%,370,141,61.89%
honeycomb.wpscdn.cn,228,0.40%,484,256,47.11%
go.microsoft.com,228,0.40%,485,257,47.01%
pool.ntp.org,226,0.39%,324,98,69.75%
internal-api-lark-api.feishu.cn,226,0.39%,442,216,51.13%
3.centos.pool.ntp.org,225,0.39%,225,0,100.00%
n-devs-sgw.tplinkcloud.com.cn,214,0.37%,442,228,48.42%
clients4.google.com,213,0.37%,465,252,45.81%
1.centos.pool.ntp.org,209,0.36%,209,0,100.00%
mimg.127.net,203,0.35%,207,4,98.07%
content-autofill.googleapis.com,197,0.34%,481,284,40.96%
treatment.grammarly.com,193,0.34%,415,222,46.51%
a.gtld-servers.net,187,0.33%,16722,16535,1.12%
gateway.icloud.com.cn,183,0.32%,422,239,43.36%
mask-api.icloud.com,179,0.31%,197,18,90.86%
nstld.verisign-grs.com,179,0.31%,179,0,100.00%
update1.sangfor.net,176,0.31%,360,184,48.89%
www.zhihu.com,164,0.29%,353,189,46.46%
api.mathpix.com,157,0.27%,325,168,48.31%
gateway.icloud.com,155,0.27%,339,184,45.72%
translate.google.cn,155,0.27%,339,184,45.72%
mcs-bd.feishu.cn,154,0.27%,317,163,48.58%
content-signature-2.cdn.mozilla.net,154,0.27%,281,127,54.80%
newtab.firefoxchina.cn,151,0.26%,215,64,70.23%
slardar-bd.feishu.cn,147,0.26%,307,160,47.88%
dcldshlupt.alicdn.com,146,0.25%,309,163,47.25%
api2.firefoxchina.cn,145,0.25%,211,66,68.72%
h.trace.qq.com,137,0.24%,302,165,45.36%
www.chinauos.com,136,0.24%,6970,6834,1.95%
prd-elb-smbdevconnnc-cnnw1-0-695323148.cn-northwest-1.elb.amazonaws.com.cn,135,0.24%,145,10,93.10%
mathpix.com,134,0.23%,277,143,48.38%
0.openwrt.pool.ntp.org,133,0.23%,148,15,89.86%
ioshost.qtlcdn.com,132,0.23%,280,148,47.14%
www.apple.com,132,0.23%,295,163,44.75%
img-xlppc-zhan.xunlei.com,132,0.23%,290,158,45.52%
init.push.apple.com,131,0.23%,270,139,48.52%
beacons.gcp.gvt2.com,131,0.23%,303,172,43.23%
checkip.amazonaws.com,127,0.22%,130,3,97.69%
a1961.g2.akamai.net,126,0.22%,250,124,50.40%
play.googleapis.com,126,0.22%,286,160,44.06%
1.openwrt.pool.ntp.org,126,0.22%,151,25,83.44%
cdn-file.ludashi.com,125,0.22%,272,147,45.96%
play.google.com,121,0.21%,278,157,43.53%
mesu.apple.com,120,0.21%,277,157,43.32%
fs.microsoft.com,120,0.21%,143,23,83.92%
s.safe.360.cn,119,0.21%,291,172,40.89%
discovery-v6.verysync.cn,118,0.21%,118,0,100.00%
nat.emule.org.cn,115,0.20%,120,5,95.83%
assets.msn.com,114,0.20%,269,155,42.38%
3.openwrt.pool.ntp.org,112,0.20%,133,21,84.21%
cv.duba.net,110,0.19%,233,123,47.21%
2.openwrt.pool.ntp.org,109,0.19%,130,21,83.85%
gateway.fe.apple-dns.cn,107,0.19%,290,183,36.90%
api.docer.wpscdn.cn,107,0.19%,235,128,45.53%
ncsi.6-c-0003.c-msedge.net,103,0.18%,103,0,100.00%
ssl.gstatic.com,103,0.18%,263,160,39.16%
accounts.google.com,103,0.18%,260,157,39.62%
df.cache.wpscdn.cn,103,0.18%,215,112,47.91%
kv601.prod.do.dsp.mp.microsoft.com,102,0.18%,214,112,47.66%
sdup.qihucdn.com,101,0.18%,139,38,72.66%
ntp1.tummy.com,101,0.18%,101,0,100.00%
update.todesk.com,100,0.17%,226,126,44.25%
ini.update.360safe.com,100,0.17%,224,124,44.64%
qurl.f.360.cn,98,0.17%,220,122,44.55%
hotfix.lenovo.com.cn,97,0.17%,220,123,44.09%
docs.google.com,95,0.17%,254,159,37.40%
cache.tv.qq.com,92,0.16%,204,112,45.10%
www.belkin.com,90,0.16%,177,87,50.85%
storage.googleapis.com,89,0.16%,174,85,51.15%
toblog.snssdk.com,88,0.15%,181,93,48.62%
r4.res.office365.com,86,0.15%,188,102,45.74%
jtypkz2w.sched.d2.tdnsdp1.cn,85,0.15%,137,52,62.04%
c.apple.news,85,0.15%,201,116,42.29%
www.google.com.hk,83,0.14%,173,90,47.98%
sjy6.stream.qqmusic.qq.com,78,0.14%,173,95,45.09%
dss0.bdstatic.com,78,0.14%,180,102,43.33%
ts1.cn.mm.bing.net,77,0.13%,171,94,45.03%
api.m.jd.com,77,0.13%,157,80,49.04%
wxapp.tc.qq.com,76,0.13%,172,96,44.19%
service.fanxing.kugou.com,76,0.13%,176,100,43.18%
download.windowsupdate.com,74,0.13%,168,94,44.05%
ts2.cn.mm.bing.net,74,0.13%,167,93,44.31%
streamdot.douyucdn.cn,73,0.13%,153,80,47.71%
webrd04.is.autonavi.com,73,0.13%,152,79,48.03%
qmzgh5-1251003022.file.myqcloud.com,72,0.13%,173,101,41.62%
i2.hdslb.com,72,0.13%,161,89,44.72%
hub5pr.v6.phub.sandai.net,71,0.12%,123,52,57.72%
broadcast.chat.bilibili.com,69,0.12%,148,79,46.62%
e6858.e19.s.tl88.net,69,0.12%,149,80,46.31%
p0.qhimg.com,69,0.12%,140,71,49.29%
client.dropbox.com,69,0.12%,146,77,47.26%
pss.bdstatic.com,68,0.12%,164,96,41.46%
dataflow.biliapi.com,67,0.12%,150,83,44.67%
oneclient.sfx.ms,67,0.12%,123,56,54.47%
apk.cdn.bleachcarnival.com,67,0.12%,153,86,43.79%
ichannel.snssdk.com,67,0.12%,153,86,43.79%
xp.apple.com,66,0.11%,136,70,48.53%
mainnet.infura.io,65,0.11%,160,95,40.62%
software-down.keniu.com,65,0.11%,145,80,44.83%
webrd02.is.autonavi.com,64,0.11%,145,81,44.14%
docs2.gtimg.com,63,0.11%,136,73,46.32%
google.com,63,0.11%,162,99,38.89%
webrd01.is.autonavi.com,62,0.11%,135,73,45.93%
beacons.gvt2.com,62,0.11%,153,91,40.52%
imap.gmail.com,61,0.11%,138,77,44.20%
webrd03.is.autonavi.com,61,0.11%,136,75,44.85%
facebook.com,61,0.11%,139,78,43.88%
notifier-configs.airbrake.io,60,0.10%,128,68,46.88%
datarouter.ol.epicgames.com,60,0.10%,128,68,46.88%
fsigns.duba.net,60,0.10%,125,65,48.00%
safebrowsing.googleapis-cn.com,60,0.10%,139,79,43.17%
kinesis.us-east-1.amazonaws.com,60,0.10%,129,69,46.51%
smartdl.lenovo.com.cn,60,0.10%,130,70,46.15%
repo.huaweicloud.com,60,0.10%,126,66,47.62%
outlook.ha.office365.com,59,0.10%,100,41,59.00%
ocsp.pki.goog,59,0.10%,138,79,42.75%
down3.huorong.cn,59,0.10%,122,63,48.36%
config.i.duba.net,57,0.10%,110,53,51.82%
googleads.g.doubleclick.net,56,0.10%,133,77,42.11%
ss1.baidu.com,55,0.10%,126,71,43.65%
dss1.bdstatic.com,55,0.10%,137,82,40.15%
opencdnmsdl1.jomodns.com,55,0.10%,118,63,46.61%
auth.docker.io,55,0.10%,146,91,37.67%
api.appcues.net,54,0.09%,120,66,45.00%
docs.gtimg.com,54,0.09%,118,64,45.76%
drive.google.com,54,0.09%,154,100,35.06%
release-75570.gzc.vod.tencent-cloud.com,53,0.09%,141,88,37.59%
www3.l.google.com,53,0.09%,106,53,50.00%
emoji.qpic.cn,52,0.09%,131,79,39.69%
cdn.content.prod.cms.msn.com,52,0.09%,117,65,44.44%
redirector.gvt1.com,52,0.09%,113,61,46.02%
fa000000105.resources.office.net,51,0.09%,109,58,46.79%
t7.baidu.com,50,0.09%,125,75,40.00%
metrics.icloud.com,50,0.09%,102,52,49.02%
dldir1v6.qq.com,50,0.09%,107,57,46.73%
f-log-win-extension.grammarly.io,50,0.09%,133,83,37.59%
pagead2.googlesyndication.com,49,0.09%,110,61,44.55%
img.alicdn.com,49,0.09%,110,61,44.55%
retracker.lanta-net.ru,49,0.09%,620,571,7.90%
gimg3.baidu.com,48,0.08%,125,77,38.40%
ss0.baidu.com,48,0.08%,119,71,40.34%
csdnimg.cn,47,0.08%,106,59,44.34%
ss2.baidu.com,46,0.08%,126,80,36.51%
stocks-data-service.apple.com,46,0.08%,100,54,46.00%
t8.baidu.com,45,0.08%,118,73,38.14%
b.bdstatic.com,45,0.08%,118,73,38.14%
ss3.baidu.com,45,0.08%,122,77,36.89%
img-s-msn-com.akamaized.net,45,0.08%,104,59,43.27%
signaler-pa.clients6.google.com,45,0.08%,105,60,42.86%
detectportal.firefox.com,43,0.07%,2460,2417,1.75%
kv501.prod.do.dsp.mp.microsoft.com,43,0.07%,143,100,30.07%
gates.grammarly.com,43,0.07%,114,71,37.72%
g.alicdn.com,41,0.07%,101,60,40.59%
bifrost-v4.getpostman.com,41,0.07%,107,66,38.32%
picx.zhimg.com,40,0.07%,103,63,38.83%
inappcheck-lb.itunes-apple.com.akadns.net,38,0.07%,133,95,28.57%
g.api.mega.co.nz,37,0.06%,148,111,25.00%
ip.42.pl,34,0.06%,666,632,5.11%
zhihu-web-analytics.zhihu.com,34,0.06%,132,98,25.76%
clients2.google.com,28,0.05%,554,526,5.05%
a2p-s01-drcn.xcm.xyx-xylo.com,27,0.05%,127,100,21.26%
inappcheck.itunes.apple.com,26,0.05%,127,101,20.47%
www.wodaywo100001.com,24,0.04%,426,402,5.63%
self.events.data.microsoft.com,21,0.04%,2650,2629,0.79%
v10.events.data.microsoft.com,19,0.03%,3876,3857,0.49%
self-events-data.trafficmanager.net,17,0.03%,107,90,15.89%
msedge.api.cdp.microsoft.com,16,0.03%,268,252,5.97%
www.google.com,15,0.03%,1792,1777,0.84%
login.live.com,15,0.03%,1161,1146,1.29%
atm-settingsfe-prod-geo2.trafficmanager.net,13,0.02%,140,127,9.29%
global.asimov.events.data.trafficmanager.net,12,0.02%,165,153,7.27%
outlook.office365.com,12,0.02%,333,321,3.60%
h-adashx.ut.taobao.com,12,0.02%,885,873,1.36%
www.msftncsi.com,10,0.02%,2274,2264,0.44%
x1.c.lencr.org,10,0.02%,975,965,1.03%
vscode-sync.trafficmanager.net,10,0.02%,315,305,3.17%
bt.okmp3.ru,10,0.02%,101,91,9.90%
switch.pcfg.cache.wpscdn.cn,9,0.02%,1130,1121,0.80%
tile-service.weather.microsoft.com,9,0.02%,938,929,0.96%
mon.zijieapi.com,8,0.01%,1058,1050,0.76%
mv.music.tc.qq.com,8,0.01%,251,243,3.19%
assets.msn.cn,8,0.01%,567,559,1.41%
tconf.f.360.cn,8,0.01%,824,816,0.97%
v20.events.data.microsoft.com,7,0.01%,718,711,0.97%
updatem.360safe.com,7,0.01%,636,629,1.10%
mobile.events.data.microsoft.com,7,0.01%,893,886,0.78%
tconf2.f.360.cn,7,0.01%,530,523,1.32%
www.icloud.com,7,0.01%,105,98,6.67%
www.sina.com,7,0.01%,627,620,1.12%
yiyun.n.shifen.com,7,0.01%,109,102,6.42%
detectportal.prod.mozaws.net,6,0.01%,1737,1731,0.35%
ldc.lenovo.com.cn,6,0.01%,718,712,0.84%
www.baidu.com,6,0.01%,26092,26086,0.02%
pcs-sdk-server.alibaba.com,6,0.01%,1186,1180,0.51%
d.skconf.f.360.cn,6,0.01%,830,824,0.72%
duba-defend.zhhainiao.com,6,0.01%,1284,1278,0.47%
config.edge.skype.com,6,0.01%,786,780,0.76%
dldir1.qq.com,6,0.01%,458,452,1.31%
i0.hdslb.com,6,0.01%,182,176,3.30%
post.ksosoft.com,6,0.01%,197,191,3.05%
bag.itunes.apple.com,6,0.01%,183,177,3.28%
outlook.office.com,6,0.01%,143,137,4.20%
prod.detectportal.prod.cloudops.mozgcp.net,5,0.01%,1523,1518,0.33%
substrate.office.com,5,0.01%,259,254,1.93%
ctldl.windowsupdate.com,5,0.01%,2777,2772,0.18%
drive.wps.cn,5,0.01%,525,520,0.95%
dl.360safe.com,5,0.01%,132,127,3.79%
db.local.clamav.net,5,0.01%,519,514,0.96%
cloud-rest.lenovomm.com,5,0.01%,178,173,2.81%
client.wns.windows.com,5,0.01%,921,916,0.54%
le.wps.cn,5,0.01%,129,124,3.88%
notice.wps.cn,5,0.01%,154,149,3.25%
qr.wps.cn,5,0.01%,127,122,3.94%
update.wps.cn,5,0.01%,678,673,0.74%
ecs.office.com,5,0.01%,517,512,0.97%
ieonlinews.microsoft.com,5,0.01%,121,116,4.13%
imap-mail.outlook.com,5,0.01%,126,121,3.97%
v10.vortex-win.data.microsoft.com,5,0.01%,100,95,5.00%
conf.f.360.cn,5,0.01%,111,106,4.50%
ping.pinyin.sogou.com,4,0.01%,1450,1446,0.28%
default.exp-tas.com,4,0.01%,1505,1501,0.27%
az764295.vo.msecnd.net,4,0.01%,1163,1159,0.34%
sjy.stream.qqmusic.qq.com,4,0.01%,177,173,2.26%
s.f.360.cn,4,0.01%,2987,2983,0.13%
vortex.data.microsoft.com,4,0.01%,975,971,0.41%
dyn.wps.cn,4,0.01%,186,182,2.15%
account.wps.cn,4,0.01%,202,198,1.98%
lucky.wps.cn,4,0.01%,139,135,2.88%
roaming.wps.cn,4,0.01%,142,138,2.82%
vasapi.wps.cn,4,0.01%,156,152,2.56%
dl.vas.wpscdn.cn,4,0.01%,164,160,2.44%
zj-roaming.wps.cn,4,0.01%,144,140,2.78%
ue.lenovomm.cn,4,0.01%,123,119,3.25%
slscr.update.microsoft.com,4,0.01%,321,317,1.25%
music.163.com,4,0.01%,148,144,2.70%
mrodevicemgr.officeapps.live.com,4,0.01%,109,105,3.67%
helpdubaclient.ksmobile.com,4,0.01%,249,245,1.61%
open.tracker.cl,4,0.01%,174,170,2.30%
sadownload.mcafee.com,4,0.01%,124,120,3.23%
ipv6.google.com,4,0.01%,256,252,1.56%
info.pinyin.sogou.com,3,0.01%,1055,1052,0.28%
x.research.qq.com,3,0.01%,4547,4544,0.07%
incoming.telemetry.mozilla.org,3,0.01%,740,737,0.41%
pub.idqqimg.com,3,0.01%,549,546,0.55%
config.pinyin.sogou.com,3,0.01%,2115,2112,0.14%
aqqmusic.tc.qq.com,3,0.01%,179,176,1.68%
wp.safe.360.cn,3,0.01%,1596,1593,0.19%
get.sogou.com,3,0.01%,1541,1538,0.19%
sconf.f.360.cn,3,0.01%,373,370,0.80%
qing.wps.cn,3,0.01%,579,576,0.52%
www.yuwabits.net,3,0.01%,281,278,1.07%
cloud.browser.360.cn,3,0.01%,404,401,0.74%
api.onedrive.com,3,0.01%,244,241,1.23%
cn.bing.com,3,0.01%,603,600,0.50%
www.a.shifen.com,3,0.01%,149,146,2.01%
docer.wps.cn,3,0.01%,169,166,1.78%
kdocs.cn,3,0.01%,144,141,2.08%
zt.wps.cn,3,0.01%,123,120,2.44%
infoc2.duba.net,3,0.01%,124,121,2.42%
update.code.visualstudio.com,3,0.01%,274,271,1.09%
functional.events.data.microsoft.com,3,0.01%,174,171,1.72%
hub.upyun.com,3,0.01%,367,364,0.82%
www.tribalmixes.com,3,0.01%,325,322,0.92%
dns.msftncsi.com,2,0.00%,8005,8003,0.02%
www.msftncsi.com.edgesuite.net,2,0.00%,200,198,1.00%
teredo.ipv6.microsoft.com,2,0.00%,11393,11391,0.02%
smartscreen-prod.microsoft.com,2,0.00%,1216,1214,0.16%
oth.eve.mdt.qq.com,2,0.00%,614,612,0.33%
time.apple.com,2,0.00%,444,442,0.45%
mail.cstnet.cn,2,0.00%,1227,1225,0.16%
slapi.oray.net,2,0.00%,1252,1250,0.16%
sl-tk.oray.com,2,0.00%,1548,1546,0.13%
qingcenter.wps.cn,2,0.00%,843,841,0.24%
1min.pcfg.cache.wpscdn.cn,2,0.00%,376,374,0.53%
isure6.stream.qqmusic.qq.com,2,0.00%,165,163,1.21%
pconf.f.360.cn,2,0.00%,574,572,0.35%
gameplay.intel.com,2,0.00%,135,133,1.48%
cl.vd.f.360.cn,2,0.00%,517,515,0.39%
conf.wsm.360.cn,2,0.00%,224,222,0.89%
www.mvgroup.org,2,0.00%,194,192,1.03%
mvgforumtracker.mvgroup.org,2,0.00%,377,375,0.53%
www.msftconnecttest.com,2,0.00%,791,789,0.25%
ic.wps.cn,2,0.00%,227,225,0.88%
pc-plugin-plg.wpscdn.cn,2,0.00%,648,646,0.31%
7a37563370ded05f.jijifun.com,2,0.00%,125,123,1.60%
mini.browser.360.cn,2,0.00%,466,464,0.43%
broker.miwifi.com,2,0.00%,691,689,0.29%
wx.qlogo.cn,2,0.00%,1043,1041,0.19%
crl4.digicert.com,2,0.00%,133,131,1.50%
dw-online.ksosoft.com,2,0.00%,144,142,1.39%
ulogs.umeng.com,2,0.00%,133,131,1.50%
message.bilibili.com,2,0.00%,144,142,1.39%
home.wps.cn,2,0.00%,145,143,1.38%
vip.wps.cn,2,0.00%,158,156,1.27%
sms.wps.cn,2,0.00%,132,130,1.52%
wdl1.file.cache.docer.com,2,0.00%,159,157,1.26%
wdl1.cache.wps.cn,2,0.00%,405,403,0.49%
zw-roaming.wps.cn,2,0.00%,127,125,1.57%
dsp.lenovo.com.cn,2,0.00%,525,523,0.38%
cc-api-data.adobe.io,2,0.00%,103,101,1.94%
g.csdnimg.cn,2,0.00%,104,102,1.92%
g.live.com,2,0.00%,133,131,1.50%
i1.hdslb.com,2,0.00%,144,142,1.39%
www.notion.so,2,0.00%,189,187,1.06%
www.meituan.com,2,0.00%,145,143,1.38%
vm.gtimg.cn,2,0.00%,237,235,0.84%
help-tower.2345.cc,2,0.00%,105,103,1.90%
config.teams.microsoft.com,2,0.00%,144,142,1.39%
time1.cloud.tencent.com,2,0.00%,105,103,1.90%
ntp1.aliyun.com,2,0.00%,103,101,1.94%
cn.ntp.org.cn,2,0.00%,114,112,1.75%
www.msn.cn,2,0.00%,183,181,1.09%
www.youtube.com,2,0.00%,222,220,0.90%
update.client.163.com,2,0.00%,166,164,1.20%
ocsp.entrust.net,2,0.00%,230,228,0.87%
f5-ck.zhhainiao.com,2,0.00%,254,252,0.79%
mirrors.tuna.tsinghua.edu.cn,2,0.00%,199,197,1.01%
www.microvirt.com,2,0.00%,115,113,1.74%
tr.abirxo.cf,2,0.00%,297,295,0.67%
tracker.tasvideos.org,2,0.00%,290,288,0.69%
api.vc.bilibili.com,1,0.00%,2047,2046,0.05%
settings-win.data.microsoft.com,1,0.00%,5441,5440,0.02%
btrace.qq.com,1,0.00%,807,806,0.12%
daisy.ubuntu.com,1,0.00%,5863,5862,0.02%
ns01.domaincontrol.com,1,0.00%,747,746,0.13%
dns.google,1,0.00%,2348,2347,0.04%
ns1.dnsnw.com,1,0.00%,1897,1896,0.05%
ns2.dnsnw.com,1,0.00%,1884,1883,0.05%
api.apple-cloudkit.com,1,0.00%,157,156,0.64%
www.microsoft.com,1,0.00%,586,585,0.17%
softbus-device.wps.cn,1,0.00%,151,150,0.66%
s.360.cn,1,0.00%,295,294,0.34%
api.msn.com,1,0.00%,297,296,0.34%
isure.stream.qqmusic.qq.com,1,0.00%,166,165,0.60%
tr.p.360.cn,1,0.00%,158,157,0.63%
catalog.gamepass.com,1,0.00%,275,274,0.36%
api.snapcraft.io,1,0.00%,236,235,0.42%
www.yahoo.com,1,0.00%,627,626,0.16%
time.windows.com,1,0.00%,236,235,0.42%
init.itunes.apple.com,1,0.00%,229,228,0.44%
extshort.weixin.qq.com,1,0.00%,589,588,0.17%
activity.windows.com,1,0.00%,175,174,0.57%
hao.lenovo.com.cn,1,0.00%,139,138,0.72%
map.baidu.com,1,0.00%,143,142,0.70%
res.wx.qq.com,1,0.00%,187,186,0.53%
t14.baidu.com,1,0.00%,106,105,0.94%
tsfe.trafficshaping.dsp.mp.microsoft.com,1,0.00%,242,241,0.41%
www.youku.com,1,0.00%,116,115,0.86%
www.bing.com,1,0.00%,1015,1014,0.10%
mmbiz.qpic.cn,1,0.00%,1071,1070,0.09%
docer-api.kdocs.cn,1,0.00%,134,133,0.75%
www.kdocs.cn,1,0.00%,186,185,0.54%
otheve.beacon.qq.com,1,0.00%,177,176,0.56%
update.360safe.com,1,0.00%,284,283,0.35%
www.sangfor.com,1,0.00%,346,345,0.29%
licensing.mp.microsoft.com,1,0.00%,195,194,0.51%
client.mail.163.com,1,0.00%,158,157,0.63%
dig.bdurl.net,1,0.00%,129,128,0.78%
lens.zhihu.com,1,0.00%,106,105,0.94%
galaxy.safe.360.cn,1,0.00%,156,155,0.64%
pgdt.gtimg.cn,1,0.00%,135,134,0.74%
bvc.bilivideo.com,1,0.00%,109,108,0.92%
update-khd.2345.cc,1,0.00%,103,102,0.97%
www.expressapisv2.net,1,0.00%,216,215,0.46%
ts.qq.com,1,0.00%,255,254,0.39%
t.khd.2345.cc,1,0.00%,442,441,0.23%
outlook.live.com,1,0.00%,146,145,0.68%
mirrors.163.com,1,0.00%,404,403,0.25%
alive.github.com,1,0.00%,253,252,0.40%
crl.comodoca.com,1,0.00%,148,147,0.68%
router9.teamviewer.com,1,0.00%,234,233,0.43%
msg.qy.net,1,0.00%,165,164,0.61%
nsl.lenovo.com.cn,1,0.00%,138,137,0.72%
hsk-api.oray.com,1,0.00%,621,620,0.16%
translate.google.com,1,0.00%,163,162,0.61%
www.sina.com.cn,1,0.00%,1210,1209,0.08%
api.github.com,0,0.00%,227,227,0.00%
home.hicloud.com,0,0.00%,1011,1011,0.00%
wwfile.work.weixin.qq.com,0,0.00%,116,116,0.00%
ntp.ubuntu.com,0,0.00%,36956,36956,0.00%
edge.microsoft.com,0,0.00%,2613,2613,0.00%
alfred.ixiacom.com,0,0.00%,386,386,0.00%
fe2cr.update.microsoft.com,0,0.00%,133,133,0.00%
pan.baidu.com,0,0.00%,2896,2896,0.00%
a.w.bilicdn1.com,0,0.00%,109,109,0.00%
bsg.w.bilicdn1.com,0,0.00%,116,116,0.00%
connectivity-check.ubuntu.com,0,0.00%,5767,5767,0.00%
flbgpi.meiquankongjian.com,0,0.00%,174,174,0.00%
hw-web-player-tracker.biliapi.net,0,0.00%,108,108,0.00%
pico.gtm.eset.com,0,0.00%,106,106,0.00%
contile.services.mozilla.com,0,0.00%,1023,1023,0.00%
weather.kjjs.360.cn,0,0.00%,123,123,0.00%
dl.min.io,0,0.00%,1763,1763,0.00%
dispatch.integrate.updrv.com,0,0.00%,523,523,0.00%
umwatson.events.data.microsoft.com,0,0.00%,268,268,0.00%
api.miwifi.com,0,0.00%,4273,4273,0.00%
dav.qq.com,0,0.00%,129,129,0.00%
high-frequency-gray.zhhainiao.com,0,0.00%,297,297,0.00%
rq.upgrade.cmpc.cmcm.com,0,0.00%,384,384,0.00%
ocsp.digicert.com,0,0.00%,423,423,0.00%
watson.telemetry.microsoft.com,0,0.00%,444,444,0.00%
dns.weixin.qq.com.cn,0,0.00%,1565,1565,0.00%
musicps.p2p.qq.com,0,0.00%,225,225,0.00%
update100.sangfor.com.cn,0,0.00%,275,275,0.00%
nexus.officeapps.live.com,0,0.00%,303,303,0.00%
u.y.qq.com,0,0.00%,292,292,0.00%
win10.ipv6.microsoft.com,0,0.00%,1080,1080,0.00%
weather-data.apple.com,0,0.00%,286,286,0.00%
github.com,0,0.00%,469,469,0.00%
ocsp2-lb.apple.com.akadns.net,0,0.00%,198,198,0.00%
bluedot.is.autonavi.com.gds.alibabadns.com,0,0.00%,131,131,0.00%
ns-cloud-d3.googledomains.com,0,0.00%,1442,1442,0.00%
ns2.wordpress.com,0,0.00%,489,489,0.00%
ns-cloud-b4.googledomains.com,0,0.00%,1477,1477,0.00%
ns73.domaincontrol.com,0,0.00%,698,698,0.00%
ns04.domaincontrol.com,0,0.00%,677,677,0.00%
ns47.domaincontrol.com,0,0.00%,797,797,0.00%
perla.ns.cloudflare.com,0,0.00%,234,234,0.00%
ns74.domaincontrol.com,0,0.00%,770,770,0.00%
ns-cloud-b3.googledomains.com,0,0.00%,1458,1458,0.00%
ns48.domaincontrol.com,0,0.00%,784,784,0.00%
dns1.p01.nsone.net,0,0.00%,185,185,0.00%
salvador.porkbun.com,0,0.00%,466,466,0.00%
ns35.domaincontrol.com,0,0.00%,1192,1192,0.00%
ns1.parkingcrew.net,0,0.00%,1442,1442,0.00%
ns07.domaincontrol.com,0,0.00%,590,590,0.00%
ns-cloud-d2.googledomains.com,0,0.00%,1368,1368,0.00%
ns1.dynadot.com,0,0.00%,732,732,0.00%
ns2.parkingcrew.net,0,0.00%,1368,1368,0.00%
ns01.one.com,0,0.00%,346,346,0.00%
ns36.domaincontrol.com,0,0.00%,1217,1217,0.00%
curitiba.porkbun.com,0,0.00%,454,454,0.00%
ns08.domaincontrol.com,0,0.00%,647,647,0.00%
dns2.namecheaphosting.com,0,0.00%,1274,1274,0.00%
ns-cloud-d4.googledomains.com,0,0.00%,1397,1397,0.00%
ns2.dynadot.com,0,0.00%,746,746,0.00%
ns02.one.com,0,0.00%,335,335,0.00%
dns1.registrar-servers.com,0,0.00%,8276,8276,0.00%
ns2.dns-parking.com,0,0.00%,2104,2104,0.00%
ns.udag.de,0,0.00%,138,138,0.00%
ns2.crazydomains.com,0,0.00%,385,385,0.00%
ns23.domaincontrol.com,0,0.00%,943,943,0.00%
dns23.hichina.com,0,0.00%,139,139,0.00%
ns2.openprovider.be,0,0.00%,189,189,0.00%
ns1.dns-parking.com,0,0.00%,2058,2058,0.00%
ns-cloud-b1.googledomains.com,0,0.00%,1498,1498,0.00%
ns54.domaincontrol.com,0,0.00%,637,637,0.00%
ns14.domaincontrol.com,0,0.00%,601,601,0.00%
ns15.wixdns.net,0,0.00%,409,409,0.00%
ns2.matbao.com,0,0.00%,173,173,0.00%
ns3.openprovider.eu,0,0.00%,186,186,0.00%
dns2.registrar-servers.com,0,0.00%,8442,8442,0.00%
ns.udag.org,0,0.00%,134,134,0.00%
nsn1.mijndomein.nl,0,0.00%,166,166,0.00%
ns02.domaincontrol.com,0,0.00%,727,727,0.00%
ns1.crazydomains.com,0,0.00%,362,362,0.00%
eu.dnsenable.com,0,0.00%,324,324,0.00%
ns1.openprovider.nl,0,0.00%,192,192,0.00%
ns1.matbao.com,0,0.00%,178,178,0.00%
nsn2.mijndomein.nl,0,0.00%,170,170,0.00%
ns.udag.net,0,0.00%,121,121,0.00%
ns2.reg.ru,0,0.00%,2061,2061,0.00%
ns0.centralnic.net,0,0.00%,1066,1066,0.00%
ns53.domaincontrol.com,0,0.00%,664,664,0.00%
nsn3.mijndomein.nl,0,0.00%,169,169,0.00%
ns1.hosting.reg.ru,0,0.00%,484,484,0.00%
ns-a1.tenten.vn,0,0.00%,183,183,0.00%
ns.zxcs.nl,0,0.00%,127,127,0.00%
fortaleza.porkbun.com,0,0.00%,470,470,0.00%
ns2.digitalocean.com,0,0.00%,172,172,0.00%
us.dnsenable.com,0,0.00%,332,332,0.00%
ns7.wixdns.net,0,0.00%,351,351,0.00%
02.dnsv.jp,0,0.00%,1182,1182,0.00%
tr.dnsenable.com,0,0.00%,306,306,0.00%
ns1.reg.ru,0,0.00%,2023,2023,0.00%
ns3.dreamhost.com,0,0.00%,399,399,0.00%
ns6.wixdns.net,0,0.00%,361,361,0.00%
ns26.domaincontrol.com,0,0.00%,449,449,0.00%
dns31.hichina.com,0,0.00%,169,169,0.00%
ns1.dan.com,0,0.00%,1537,1537,0.00%
ns3.digitalocean.com,0,0.00%,184,184,0.00%
ns2.dan.com,0,0.00%,1531,1531,0.00%
dns1.hichina.com,0,0.00%,143,143,0.00%
ns2.hosting.reg.ru,0,0.00%,438,438,0.00%
ns-a2.conoha.io,0,0.00%,210,210,0.00%
ns-a3.conoha.io,0,0.00%,197,197,0.00%
dns2.hichina.com,0,0.00%,144,144,0.00%
ns17.domaincontrol.com,0,0.00%,539,539,0.00%
ns4.xserver.jp,0,0.00%,386,386,0.00%
ns1.natrohost.com,0,0.00%,274,274,0.00%
ns2.natrohost.com,0,0.00%,285,285,0.00%
ns60.domaincontrol.com,0,0.00%,145,145,0.00%
ns1.bluehost.com,0,0.00%,863,863,0.00%
ns2.bluehost.com,0,0.00%,862,862,0.00%
ns-a3.tenten.vn,0,0.00%,198,198,0.00%
ns-a2.tenten.vn,0,0.00%,202,202,0.00%
ns14.wixdns.net,0,0.00%,425,425,0.00%
dns.pub,0,0.00%,775,775,0.00%
dns.rubyfish.cn,0,0.00%,769,769,0.00%
whsmarthome.hwcloudtest.cn,0,0.00%,963,963,0.00%
dd.browser.360.cn,0,0.00%,350,350,0.00%
grafana.com,0,0.00%,433,433,0.00%
ns25.domaincontrol.com,0,0.00%,454,454,0.00%
dns2.onamae.com,0,0.00%,178,178,0.00%
ns6.myhostadmin.net,0,0.00%,143,143,0.00%
git.rancher.io,0,0.00%,2769,2769,0.00%
ns72.domaincontrol.com,0,0.00%,674,674,0.00%
ns24.domaincontrol.com,0,0.00%,1002,1002,0.00%
ns2.myhostadmin.net,0,0.00%,149,149,0.00%
ns3.myhostadmin.net,0,0.00%,147,147,0.00%
ns5.xserver.jp,0,0.00%,395,395,0.00%
ns4.myhostadmin.net,0,0.00%,167,167,0.00%
ns-cloud-d1.googledomains.com,0,0.00%,1381,1381,0.00%
ns18.domaincontrol.com,0,0.00%,559,559,0.00%
ns5.myhostadmin.net,0,0.00%,136,136,0.00%
ns1.digitalocean.com,0,0.00%,175,175,0.00%
ns13.domaincontrol.com,0,0.00%,603,603,0.00%
ns59.domaincontrol.com,0,0.00%,143,143,0.00%
ustc-edu-cn.mirror.aliyuncs.com,0,0.00%,271,271,0.00%
ns3cna.name.com,0,0.00%,282,282,0.00%
ns1.register.it,0,0.00%,170,170,0.00%
03.dnsv.jp,0,0.00%,1139,1139,0.00%
dns1.onamae.com,0,0.00%,179,179,0.00%
ns1.loopia.se,0,0.00%,176,176,0.00%
dns1.namecheaphosting.com,0,0.00%,1243,1243,0.00%
ns71.domaincontrol.com,0,0.00%,679,679,0.00%
ns.zxcs.eu,0,0.00%,123,123,0.00%
ns4.nic.ru,0,0.00%,350,350,0.00%
ns8.nic.ru,0,0.00%,340,340,0.00%
ns.zxcs.be,0,0.00%,120,120,0.00%
ns1.value-domain.com,0,0.00%,227,227,0.00%
ns1.xserver.jp,0,0.00%,383,383,0.00%
ns2.sedoparking.com,0,0.00%,834,834,0.00%
ns76.domaincontrol.com,0,0.00%,517,517,0.00%
04.dnsv.jp,0,0.00%,1153,1153,0.00%
ns2.dreamhost.com,0,0.00%,379,379,0.00%
ns3.nic.ru,0,0.00%,356,356,0.00%
dns28.hichina.com,0,0.00%,148,148,0.00%
ns2.xserver.jp,0,0.00%,403,403,0.00%
ns1.dreamhost.com,0,0.00%,390,390,0.00%
ns1.dnsowl.com,0,0.00%,951,951,0.00%
ns2.inet.vn,0,0.00%,100,100,0.00%
ns51.domaincontrol.com,0,0.00%,213,213,0.00%
01.dnsv.jp,0,0.00%,1186,1186,0.00%
ns1cvw.name.com,0,0.00%,153,153,0.00%
ns2.dnsowl.com,0,0.00%,922,922,0.00%
ns52.domaincontrol.com,0,0.00%,237,237,0.00%
ns1.niagahoster.com,0,0.00%,189,189,0.00%
ns1.bodis.com,0,0.00%,1288,1288,0.00%
ns1.siteground.net,0,0.00%,602,602,0.00%
ns2.siteground.net,0,0.00%,610,610,0.00%
ns1.systemdns.com,0,0.00%,277,277,0.00%
ns10.wixdns.net,0,0.00%,402,402,0.00%
maceio.porkbun.com,0,0.00%,443,443,0.00%
ns11.wixdns.net,0,0.00%,390,390,0.00%
shuc-pc-hunt.ksord.com,0,0.00%,1331,1331,0.00%
osfsr.lenovomm.com,0,0.00%,1728,1728,0.00%
doh.pub,0,0.00%,544,544,0.00%
jm1.dns.com,0,0.00%,3549,3549,0.00%
jm2.dns.com,0,0.00%,3716,3716,0.00%
ns9.wixdns.net,0,0.00%,349,349,0.00%
ns-cloud-a3.googledomains.com,0,0.00%,1410,1410,0.00%
ns-cloud-e4.googledomains.com,0,0.00%,1371,1371,0.00%
ns1.sedoparking.com,0,0.00%,830,830,0.00%
ns5.lwsdns.com,0,0.00%,175,175,0.00%
ns6.lwsdns.com,0,0.00%,168,168,0.00%
ns-cloud-c2.googledomains.com,0,0.00%,1387,1387,0.00%
dns4.name-services.com,0,0.00%,279,279,0.00%
dns1.name-services.com,0,0.00%,297,297,0.00%
ns7.lwsdns.com,0,0.00%,179,179,0.00%
ns2.register.it,0,0.00%,176,176,0.00%
ns8.lwsdns.com,0,0.00%,185,185,0.00%
dns3.name-services.com,0,0.00%,280,280,0.00%
dns4.p07.nsone.net,0,0.00%,165,165,0.00%
ns37.domaincontrol.com,0,0.00%,514,514,0.00%
dns5.name-services.com,0,0.00%,269,269,0.00%
ns38.domaincontrol.com,0,0.00%,541,541,0.00%
ns-cloud-e1.googledomains.com,0,0.00%,1366,1366,0.00%
ns11.domaincontrol.com,0,0.00%,464,464,0.00%
ns2.niagahoster.com,0,0.00%,190,190,0.00%
dns2.name-services.com,0,0.00%,258,258,0.00%
ns-cloud-e2.googledomains.com,0,0.00%,1361,1361,0.00%
ns2.hosting.co.kr,0,0.00%,111,111,0.00%
ns2.loopia.se,0,0.00%,181,181,0.00%
ns-cloud-a4.googledomains.com,0,0.00%,1369,1369,0.00%
ns1.wordpress.com,0,0.00%,494,494,0.00%
ns3.wordpress.com,0,0.00%,472,472,0.00%
dns8.hichina.com,0,0.00%,156,156,0.00%
st.todesk.com,0,0.00%,163,163,0.00%
c.y.qq.com,0,0.00%,141,141,0.00%
ns-cloud-a2.googledomains.com,0,0.00%,1366,1366,0.00%
pdns2.registrar-servers.com,0,0.00%,139,139,0.00%
ns1.hover.com,0,0.00%,283,283,0.00%
ns1.huaweicloud-dns.com,0,0.00%,394,394,0.00%
ns2.gname.net,0,0.00%,12739,12739,0.00%
ns-cloud-c3.googledomains.com,0,0.00%,1391,1391,0.00%
dm1.dns.com,0,0.00%,1303,1303,0.00%
dm2.dns.com,0,0.00%,1288,1288,0.00%
ns-cloud-c4.googledomains.com,0,0.00%,1356,1356,0.00%
ns45.domaincontrol.com,0,0.00%,662,662,0.00%
ns1.maff.com,0,0.00%,167,167,0.00%
ns65.domaincontrol.com,0,0.00%,567,567,0.00%
ns2.livedns.co.uk,0,0.00%,251,251,0.00%
ns46.domaincontrol.com,0,0.00%,699,699,0.00%
ns2.maff.com,0,0.00%,166,166,0.00%
ns66.domaincontrol.com,0,0.00%,495,495,0.00%
ns1.gname.net,0,0.00%,12524,12524,0.00%
ns1.livedns.co.uk,0,0.00%,257,257,0.00%
ns3.livedns.co.uk,0,0.00%,258,258,0.00%
ns1.domain.com,0,0.00%,309,309,0.00%
es-cn-0pp1l8f1v001204h1.public.elasticsearch.aliyuncs.com,0,0.00%,1338,1338,0.00%
ns2.parktons.com,0,0.00%,1732,1732,0.00%
ipv4only.arpa,0,0.00%,1882,1882,0.00%
example.org,0,0.00%,758,758,0.00%
ns3.xserver.jp,0,0.00%,375,375,0.00%
ns3.bdm.microsoftonline.com,0,0.00%,130,130,0.00%
ns4.bdm.microsoftonline.com,0,0.00%,118,118,0.00%
localhost,0,0.00%,1012,1012,0.00%
ns.parktons.com,0,0.00%,1718,1718,0.00%
ns3.afternic.com,0,0.00%,104,104,0.00%
ns4.afternic.com,0,0.00%,111,111,0.00%
ns0.wixdns.net,0,0.00%,384,384,0.00%
ns1.wixdns.net,0,0.00%,394,394,0.00%
ns49.domaincontrol.com,0,0.00%,545,545,0.00%
ns50.domaincontrol.com,0,0.00%,591,591,0.00%
query.hicloud.com,0,0.00%,9004,9004,0.00%
ns55.domaincontrol.com,0,0.00%,565,565,0.00%
ns56.domaincontrol.com,0,0.00%,602,602,0.00%
ns3.rumahweb.net,0,0.00%,100,100,0.00%
ns1.rumahweb.com,0,0.00%,107,107,0.00%
ns2.rumahweb.com,0,0.00%,104,104,0.00%
ns67.domaincontrol.com,0,0.00%,452,452,0.00%
ns68.domaincontrol.com,0,0.00%,441,441,0.00%
authds.todesk.com,0,0.00%,373,373,0.00%
v1s2.xundns.com,0,0.00%,679,679,0.00%
p2pupgrade.gamedl.qq.com,0,0.00%,117,117,0.00%
dlied6.qq.com,0,0.00%,232,232,0.00%
connc.gj.qq.com,0,0.00%,326,326,0.00%
zod.ns.cloudflare.com,0,0.00%,131,131,0.00%
dns1.p08.nsone.net,0,0.00%,154,154,0.00%
dns2.p08.nsone.net,0,0.00%,158,158,0.00%
dns3.p08.nsone.net,0,0.00%,148,148,0.00%
dns4.p08.nsone.net,0,0.00%,138,138,0.00%
config.gamedl.qq.com,0,0.00%,118,118,0.00%
stat.gamedl.qq.com,0,0.00%,119,119,0.00%
ps2.gamedl.qq.com,0,0.00%,116,116,0.00%
stun.qqlive.qq.com,0,0.00%,128,128,0.00%
p2pupdate.gamedl.qq.com,0,0.00%,120,120,0.00%
gy2.brnt.fun,0,0.00%,442,442,0.00%
ns2.above.com,0,0.00%,1367,1367,0.00%
ns-cloud-c1.googledomains.com,0,0.00%,1405,1405,0.00%
ns1.uniregistrymarket.link,0,0.00%,125,125,0.00%
ns1.panamans.com,0,0.00%,996,996,0.00%
ns2.panamans.com,0,0.00%,1023,1023,0.00%
ns2.zhaimandns.com,0,0.00%,299,299,0.00%
ns1.zhaimandns.com,0,0.00%,331,331,0.00%
ns2.uniregistrymarket.link,0,0.00%,101,101,0.00%
ns12.wixdns.net,0,0.00%,434,434,0.00%
verify-contact-details.namecheap.com,0,0.00%,305,305,0.00%
ns13.wixdns.net,0,0.00%,441,441,0.00%
v1s1.xundns.com,0,0.00%,691,691,0.00%
ns12.domaincontrol.com,0,0.00%,473,473,0.00%
ns1.myhostadmin.net,0,0.00%,151,151,0.00%
ns-cloud-e3.googledomains.com,0,0.00%,1349,1349,0.00%
ns-cloud-a1.googledomains.com,0,0.00%,1398,1398,0.00%
dns9.hichina.com,0,0.00%,140,140,0.00%
dns10.hichina.com,0,0.00%,143,143,0.00%
a.root-servers.net,0,0.00%,4518,4518,0.00%
ns31.domaincontrol.com,0,0.00%,488,488,0.00%
ns32.domaincontrol.com,0,0.00%,492,492,0.00%
ns3.dnsowl.com,0,0.00%,990,990,0.00%
gitee.com,0,0.00%,249,249,0.00%
api.apple-cloudkit.fe.apple-dns.net,0,0.00%,112,112,0.00%
ns4.epik.com,0,0.00%,169,169,0.00%
dns11.hichina.com,0,0.00%,172,172,0.00%
ns77.domaincontrol.com,0,0.00%,579,579,0.00%
dns12.hichina.com,0,0.00%,185,185,0.00%
failed-whois-verification.namecheap.com,0,0.00%,321,321,0.00%
ns78.domaincontrol.com,0,0.00%,595,595,0.00%
ns1.inmotionhosting.com,0,0.00%,102,102,0.00%
ns1.22.cn,0,0.00%,111,111,0.00%
ns2.22.cn,0,0.00%,132,132,0.00%
mitchell.ns.cloudflare.com,0,0.00%,174,174,0.00%
dns111.ovh.net,0,0.00%,504,504,0.00%
ns111.ovh.net,0,0.00%,499,499,0.00%
ns-cloud-b2.googledomains.com,0,0.00%,1482,1482,0.00%
ns4.domainnamedns.com,0,0.00%,188,188,0.00%
ns3.wixdns.net,0,0.00%,383,383,0.00%
ns2.wixdns.net,0,0.00%,372,372,0.00%
ns1.undeveloped.com,0,0.00%,120,120,0.00%
ns2.undeveloped.com,0,0.00%,127,127,0.00%
verification-e4d900f2.ns3.dan.hosting,0,0.00%,176,176,0.00%
dns1.p02.nsone.net,0,0.00%,132,132,0.00%
dns22.hichina.com,0,0.00%,138,138,0.00%
apple.com,0,0.00%,379,379,0.00%
1-courier.push.apple.com,0,0.00%,165,165,0.00%
bugly.qq.com,0,0.00%,105,105,0.00%
dns3.p02.nsone.net,0,0.00%,134,134,0.00%
ns42.domaincontrol.com,0,0.00%,450,450,0.00%
dns4.p02.nsone.net,0,0.00%,137,137,0.00%
dns21.hichina.com,0,0.00%,143,143,0.00%
dns7.hichina.com,0,0.00%,142,142,0.00%
ns8.wixdns.net,0,0.00%,335,335,0.00%
aisha.ns.cloudflare.com,0,0.00%,130,130,0.00%
salvador.ns.cloudflare.com,0,0.00%,126,126,0.00%
ns2.domain.com,0,0.00%,292,292,0.00%
ns1.above.com,0,0.00%,1399,1399,0.00%
ns2.inmotionhosting.com,0,0.00%,108,108,0.00%
boyd.ns.cloudflare.com,0,0.00%,108,108,0.00%
dns15.hichina.com,0,0.00%,121,121,0.00%
now1.dns.com,0,0.00%,149,149,0.00%
now2.dns.com,0,0.00%,125,125,0.00%
dns16.hichina.com,0,0.00%,126,126,0.00%
natasha.ns.cloudflare.com,0,0.00%,688,688,0.00%
ns41.domaincontrol.com,0,0.00%,464,464,0.00%
monovm.mars.orderbox-dns.com,0,0.00%,126,126,0.00%
ns2.bodis.com,0,0.00%,1244,1244,0.00%
monovm.earth.orderbox-dns.com,0,0.00%,105,105,0.00%
monovm.mercury.orderbox-dns.com,0,0.00%,113,113,0.00%
ns1.ecpage.com,0,0.00%,124,124,0.00%
kellen.ns.cloudflare.com,0,0.00%,206,206,0.00%
ns2.ecpage.com,0,0.00%,139,139,0.00%
dns1.p04.nsone.net,0,0.00%,168,168,0.00%
dns2.p04.nsone.net,0,0.00%,162,162,0.00%
dns4.p04.nsone.net,0,0.00%,150,150,0.00%
ns5.wixdns.net,0,0.00%,329,329,0.00%
ns4.wixdns.net,0,0.00%,326,326,0.00%
dns1.hostgator.com.br,0,0.00%,104,104,0.00%
dns2.hostgator.com.br,0,0.00%,110,110,0.00%
p.f.360.cn,0,0.00%,269,269,0.00%
vipapi.wps.cn,0,0.00%,441,441,0.00%
rq.upgrade.drivergenius.com,0,0.00%,356,356,0.00%
www.tp-link.com,0,0.00%,314,314,0.00%
clock.fmt.he.net,0,0.00%,111,111,0.00%
edragent.sangfor.com.cn,0,0.00%,2788,2788,0.00%
note.youdao.com,0,0.00%,2037,2037,0.00%
tracker.1337x.org,0,0.00%,1006,1006,0.00%
task.browser.360.cn,0,0.00%,150,150,0.00%
wup.browser.qq.com,0,0.00%,288,288,0.00%
p3p.sogou.com,0,0.00%,696,696,0.00%
sl-log.oray.net,0,0.00%,236,236,0.00%
win8.ipv6.microsoft.com,0,0.00%,872,872,0.00%
88dsf5l.003.1.mclqp.link,0,0.00%,191,191,0.00%
kns.duba.net,0,0.00%,119,119,0.00%
www.jd.com,0,0.00%,1500,1500,0.00%
apd-pcdnwxstat.teg.tencent-cloud.net,0,0.00%,246,246,0.00%
stat.y.qq.com,0,0.00%,195,195,0.00%
client-api.oray.com,0,0.00%,184,184,0.00%
6ahddutb1ucc3cp.ru,0,0.00%,435,435,0.00%
im.eulix.xyz,0,0.00%,269,269,0.00%
www.csdn.net,0,0.00%,1046,1046,0.00%
api.cloud.tenda.com.cn,0,0.00%,268,268,0.00%
hkb.cloudnnnn.com,0,0.00%,528,528,0.00%
gsp64-ssl.ls.apple.com,0,0.00%,123,123,0.00%
bash.givemexyz.in,0,0.00%,657,657,0.00%
shdf01-iopq.cgroads.com,0,0.00%,110,110,0.00%
socm.dmp.360.cn,0,0.00%,277,277,0.00%
apd-pcdnwxlogin.teg.tencent-cloud.net,0,0.00%,274,274,0.00%
t.kite.com,0,0.00%,173,173,0.00%
puv.tt.browser.360.cn,0,0.00%,264,264,0.00%
szextshort.weixin.qq.com,0,0.00%,277,277,0.00%
deault-exp-tas-com.e-0014.e-msedge.net,0,0.00%,201,201,0.00%
h5.qzone.qq.com,0,0.00%,1473,1473,0.00%
uapi.mp.360.cn,0,0.00%,141,141,0.00%
stat.sd.360.cn,0,0.00%,141,141,0.00%
rq.upgrade.lbmini.cmcm.com,0,0.00%,259,259,0.00%
agd2.p.360.cn,0,0.00%,211,211,0.00%
agt.p.360.cn,0,0.00%,152,152,0.00%
v2.get.sogou.com,0,0.00%,180,180,0.00%
aegis.qq.com,0,0.00%,183,183,0.00%
api.safe.360.cn,0,0.00%,445,445,0.00%
update.pan.baidu.com,0,0.00%,553,553,0.00%
time.nist.gov,0,0.00%,153,153,0.00%
minorshort.weixin.qq.com,0,0.00%,256,256,0.00%
rq.wh.cmcm.com,0,0.00%,1170,1170,0.00%
apd-pcdnwxnat.teg.tencent-cloud.net,0,0.00%,249,249,0.00%
shortconn.im.qcloud.com,0,0.00%,365,365,0.00%
hub5p.sandai.net,0,0.00%,6613,6613,0.00%
retracker.mgts.by,0,0.00%,741,741,0.00%
arc.msn.com,0,0.00%,615,615,0.00%
k8s.gcr.io,0,0.00%,616,616,0.00%
time.g.aaplimg.com,0,0.00%,383,383,0.00%
az700632.vo.msecnd.net,0,0.00%,168,168,0.00%
edgedl.me.gvt1.com,0,0.00%,168,168,0.00%
checkappexec.microsoft.com,0,0.00%,467,467,0.00%
hwid-drcn.platform.hicloud.com,0,0.00%,118,118,0.00%
metrics1-drcn.dt.dbankcloud.cn,0,0.00%,146,146,0.00%
nexusrules.officeapps.live.com,0,0.00%,1205,1205,0.00%
ris.api.iris.microsoft.com,0,0.00%,407,407,0.00%
short.weixin.qq.com,0,0.00%,140,140,0.00%
fb98ab9159f51fd0.jijifun.com,0,0.00%,141,141,0.00%
www.jetbrains.com,0,0.00%,206,206,0.00%
account.jetbrains.com,0,0.00%,117,117,0.00%
qdun-data.qq.com,0,0.00%,153,153,0.00%
qd-update.qq.com,0,0.00%,115,115,0.00%
t2.pow7.com,0,0.00%,178,178,0.00%
www.tvnihon.com,0,0.00%,356,356,0.00%
www.googleapis.com,0,0.00%,313,313,0.00%
ww62.uatracker.net,0,0.00%,165,165,0.00%
public.dns.iij.jp,0,0.00%,636,636,0.00%
dns.twnic.tw,0,0.00%,342,342,0.00%
public1.114dns.com,0,0.00%,234,234,0.00%
upd.sangfor.com.cn,0,0.00%,471,471,0.00%
hb-b.services.vnc.com,0,0.00%,155,155,0.00%
hb-a.services.vnc.com,0,0.00%,199,199,0.00%
hb-c.services.vnc.com,0,0.00%,202,202,0.00%
xgpolardb.mysql.polardb.rds.aliyuncs.com,0,0.00%,3818,3818,0.00%
openbenchmarking.org,0,0.00%,100,100,0.00%
skydrive.wns.windows.com,0,0.00%,200,200,0.00%
assets.contentstack.io,0,0.00%,760,760,0.00%
c.hljzfkyy.com,0,0.00%,1120,1120,0.00%
tt.browser.360.cn,0,0.00%,116,116,0.00%
app.huabao.360.cn,0,0.00%,185,185,0.00%
sp1.baidu.com,0,0.00%,227,227,0.00%
hectorstatic.baidu.com,0,0.00%,219,219,0.00%
hpd.baidu.com,0,0.00%,164,164,0.00%
ug.baidu.com,0,0.00%,147,147,0.00%
az667904.vo.msecnd.net,0,0.00%,155,155,0.00%
packages.deepin.com,0,0.00%,519,519,0.00%
m.baidu.com,0,0.00%,105,105,0.00%
t9.baidu.com,0,0.00%,128,128,0.00%
rubyfish.cn,0,0.00%,109,109,0.00%
metrics1.data.hicloud.com,0,0.00%,299,299,0.00%
caldav.163.com,0,0.00%,231,231,0.00%
sourcegraph.com,0,0.00%,114,114,0.00%
geo.prod.do.dsp.mp.microsoft.com,0,0.00%,204,204,0.00%
configuration.ls.apple.com,0,0.00%,173,173,0.00%
es.proj217.app.kdsec.org,0,0.00%,220,220,0.00%
yapi.kdsec.org,0,0.00%,3437,3437,0.00%
au.download.windowsupdate.com,0,0.00%,377,377,0.00%
dns.cloudflare.com,0,0.00%,172,172,0.00%
visualstudio-devdiv-c2s.msedge.net,0,0.00%,186,186,0.00%
rs1.qq.com,0,0.00%,489,489,0.00%
ts1.qq.com,0,0.00%,511,511,0.00%
rs2.qq.com,0,0.00%,524,524,0.00%
ts2.qq.com,0,0.00%,521,521,0.00%
dns.weixin.qq.com,0,0.00%,290,290,0.00%
s.ludashi.com,0,0.00%,110,110,0.00%
www.bilibili.com,0,0.00%,203,203,0.00%
stun1.douyucdn.cn,0,0.00%,144,144,0.00%
c.xzhwdz.com,0,0.00%,203,203,0.00%
gsp85-cn-ssl.ls.apple.com,0,0.00%,111,111,0.00%
captive.apple.com,0,0.00%,158,158,0.00%
safebrowsing.urlsec.qq.com,0,0.00%,253,253,0.00%
d.pcs.baidu.com,0,0.00%,153,153,0.00%
c3.pcs.baidu.com,0,0.00%,102,102,0.00%
miao.baidu.com,0,0.00%,106,106,0.00%
badjs.weixinbridge.com,0,0.00%,142,142,0.00%
mp.weixin.qq.com,0,0.00%,239,239,0.00%
dispatch.s.xzdesktop.cqttech.com,0,0.00%,103,103,0.00%
crl.verisign.com,0,0.00%,214,214,0.00%
zhidao.baidu.com,0,0.00%,256,256,0.00%
cloudflare-dns.com,0,0.00%,332,332,0.00%
geo.wps.cn,0,0.00%,135,135,0.00%
iaas.wps.cn,0,0.00%,107,107,0.00%
docer.kdocs.cn,0,0.00%,116,116,0.00%
avatar.qwps.cn,0,0.00%,118,118,0.00%
pay.wps.cn,0,0.00%,164,164,0.00%
js1.pcfg.cache.wpscdn.cn,0,0.00%,103,103,0.00%
cn-hangzhou.axt.aliyun.com,0,0.00%,152,152,0.00%
vcode-od.vivo.com.cn,0,0.00%,119,119,0.00%
cn-qingdao.axt.aliyun.com,0,0.00%,173,173,0.00%
autoupdater.updrv.com,0,0.00%,232,232,0.00%
aps.amap.com,0,0.00%,265,265,0.00%
loc.map.baidu.com,0,0.00%,241,241,0.00%
conna.gj.qq.com,0,0.00%,129,129,0.00%
cn-beijing.axt.aliyun.com,0,0.00%,141,141,0.00%
grs.dbankcloud.com,0,0.00%,131,131,0.00%
api.bilibili.com,0,0.00%,222,222,0.00%
cm.bilibili.com,0,0.00%,159,159,0.00%
api.live.bilibili.com,0,0.00%,153,153,0.00%
mail.163.com,0,0.00%,424,424,0.00%
hm.baidu.com,0,0.00%,455,455,0.00%
cn-zhangjiakou.axt.aliyun.com,0,0.00%,108,108,0.00%
e-0014.e-msedge.net,0,0.00%,128,128,0.00%
qqdata.ab.qq.com,0,0.00%,129,129,0.00%
rq.cct.cloud.duba.net,0,0.00%,410,410,0.00%
store-drcn.hispace.dbankcloud.cn,0,0.00%,102,102,0.00%
login.microsoftonline.com,0,0.00%,245,245,0.00%
sl-collection.oray.net,0,0.00%,129,129,0.00%
event.csdn.net,0,0.00%,105,105,0.00%
nav-edge.smartscreen.microsoft.com,0,0.00%,207,207,0.00%
sp0.baidu.com,0,0.00%,201,201,0.00%
pos.baidu.com,0,0.00%,103,103,0.00%
ime.sogou.com,0,0.00%,128,128,0.00%
imap.qq.com,0,0.00%,313,313,0.00%
ocsp2.apple.com,0,0.00%,289,289,0.00%
hq.sinajs.cn,0,0.00%,115,115,0.00%
api.im.qcloud.com,0,0.00%,203,203,0.00%
c.go-mpulse.net,0,0.00%,257,257,0.00%
c.bing.com,0,0.00%,106,106,0.00%
pubsub02.oray.net,0,0.00%,1239,1239,0.00%
www.sogou.com,0,0.00%,114,114,0.00%
diskapi.baidu.com,0,0.00%,657,657,0.00%
graph.microsoft.com,0,0.00%,114,114,0.00%
tracking.miui.com,0,0.00%,108,108,0.00%
wup.imtt.qq.com,0,0.00%,144,144,0.00%
connectivitycheck.platform.hicloud.com,0,0.00%,1717,1717,0.00%
c.skconf.f.360.cn,0,0.00%,141,141,0.00%
www.google.cn,0,0.00%,112,112,0.00%
cgicol.amap.com,0,0.00%,222,222,0.00%
long.weixin.qq.com,0,0.00%,147,147,0.00%
info.wps.cn,0,0.00%,115,115,0.00%
events.gfe.nvidia.com,0,0.00%,2678,2678,0.00%
location.services.mozilla.com,0,0.00%,117,117,0.00%
appconf.mail.163.com,0,0.00%,116,116,0.00%
go.ie.sogou.com,0,0.00%,114,114,0.00%
pcfg.wps.cn,0,0.00%,173,173,0.00%
akn.safe.360.cn,0,0.00%,218,218,0.00%
connb.gj.qq.com,0,0.00%,133,133,0.00%
clock.nyc.he.net,0,0.00%,103,103,0.00%
dnkeeper.platform.dbankcloud.cn,0,0.00%,141,141,0.00%
clock.sjc.he.net,0,0.00%,107,107,0.00%
www.163.com,0,0.00%,19877,19877,0.00%
eugen-rx0.pwndns.pw,0,0.00%,646,646,0.00%
router12.teamviewer.com,0,0.00%,396,396,0.00%
boot-01.net.anydesk.com,0,0.00%,207,207,0.00%
www.scumall.com,0,0.00%,216,216,0.00%
imap.163.com,0,0.00%,174,174,0.00%
rm.api.weibo.com,0,0.00%,152,152,0.00%
vpn.maskvpn.org,0,0.00%,200,200,0.00%
amazon.com,0,0.00%,488,488,0.00%
3ba0c177-1b23-42a6-be9d-a8bdf1c2bb22.hk.node.touhou.earth,0,0.00%,113,113,0.00%
boot-02.net.anydesk.com,0,0.00%,210,210,0.00%
guzzoni.apple.com,0,0.00%,136,136,0.00%
shmmsns.qpic.cn,0,0.00%,355,355,0.00%
security.ubuntu.com,0,0.00%,126,126,0.00%
officeclient.microsoft.com,0,0.00%,160,160,0.00%
telemetry-in.battle.net,0,0.00%,168,168,0.00%
www.w3.org,0,0.00%,28983,28983,0.00%
router15.teamviewer.com,0,0.00%,347,347,0.00%
relay-b8d08ecc.net.anydesk.com,0,0.00%,104,104,0.00%
mail.google.com,0,0.00%,193,193,0.00%
graph.qq.com,0,0.00%,231,231,0.00%
raw.githubusercontent.com,0,0.00%,221,221,0.00%
tieba.baidu.com,0,0.00%,107,107,0.00%
server.reverse.ac.cn,0,0.00%,543,543,0.00%
weibo.com,0,0.00%,364,364,0.00%
roaming.officeapps.live.com,0,0.00%,180,180,0.00%
node.video.qq.com,0,0.00%,166,166,0.00%
www.m9ynqi6d.com,0,0.00%,177,177,0.00%
nzk.woqu365.com,0,0.00%,148,148,0.00%
xui.ptlogin2.qq.com,0,0.00%,233,233,0.00%
u.zyinfotech.com,0,0.00%,112,112,0.00%
router16.teamviewer.com,0,0.00%,291,291,0.00%
ssl.look.360.cn,0,0.00%,128,128,0.00%
szlong.weixin.qq.com,0,0.00%,124,124,0.00%
ins-r23tsuuf.ias.tencent-cloud.net,0,0.00%,100,100,0.00%
vpn.maskvpn.cc,0,0.00%,218,218,0.00%
qdyn.wps.cn,0,0.00%,159,159,0.00%
dev.ditu.live.com,0,0.00%,209,209,0.00%
log.tbs.qq.com,0,0.00%,195,195,0.00%
passport.baidu.com,0,0.00%,169,169,0.00%
mtalk.google.com,0,0.00%,487,487,0.00%
hsk-embed.oray.com,0,0.00%,1008,1008,0.00%
mcafee-sustainability.azurewebsites.net,0,0.00%,158,158,0.00%
router2.teamviewer.com,0,0.00%,310,310,0.00%
dr.ime.baidu.com,0,0.00%,104,104,0.00%
dict.youdao.com,0,0.00%,198,198,0.00%
mobile.pipe.aria.microsoft.com,0,0.00%,169,169,0.00%
rq.lbcct.cloud.duba.net,0,0.00%,265,265,0.00%
openlocation-drcn.platform.dbankcloud.com,0,0.00%,127,127,0.00%
time.asia.apple.com,0,0.00%,150,150,0.00%
connect.unity.cn,0,0.00%,150,150,0.00%
fe3cr.delivery.mp.microsoft.com,0,0.00%,399,399,0.00%
router1.teamviewer.com,0,0.00%,325,325,0.00%
report.url.cn,0,0.00%,309,309,0.00%
router10.teamviewer.com,0,0.00%,276,276,0.00%
rq.drcct.cloud.duba.net,0,0.00%,472,472,0.00%
gtm-sg-6wr2u201t05.gtm-i2d4.com,0,0.00%,131,131,0.00%
router5.teamviewer.com,0,0.00%,265,265,0.00%
lookup.nextcloud.com,0,0.00%,801,801,0.00%
vv.video.qq.com,0,0.00%,144,144,0.00%
rq.upgrade.cloud.duba.net,0,0.00%,243,243,0.00%
dns1.p06.nsone.net,0,0.00%,181,181,0.00%
jm1.alidns.com,0,0.00%,275,275,0.00%
ns2.domainnamedns.com,0,0.00%,185,185,0.00%
ns2.hover.com,0,0.00%,284,284,0.00%
ns03.domaincontrol.com,0,0.00%,718,718,0.00%
ns1.dns.com,0,0.00%,1095,1095,0.00%
ns1.taoa.com,0,0.00%,420,420,0.00%
ns2.dns.com,0,0.00%,1116,1116,0.00%
ns2.taoa.com,0,0.00%,431,431,0.00%
dns101.registrar-servers.com,0,0.00%,1331,1331,0.00%
dns102.registrar-servers.com,0,0.00%,1333,1333,0.00%
ns63.domaincontrol.com,0,0.00%,572,572,0.00%
ns1.parklogic.com,0,0.00%,138,138,0.00%
ns64.domaincontrol.com,0,0.00%,553,553,0.00%
ns2.parklogic.com,0,0.00%,146,146,0.00%
ns3.domainnamedns.com,0,0.00%,185,185,0.00%
ns5.afternic.com,0,0.00%,127,127,0.00%
ns6.afternic.com,0,0.00%,119,119,0.00%
ns19.domaincontrol.com,0,0.00%,1093,1093,0.00%
ns20.domaincontrol.com,0,0.00%,1133,1133,0.00%
ns2626.ztomy.com,0,0.00%,140,140,0.00%
ns1626.ztomy.com,0,0.00%,136,136,0.00%
dns2.p01.nsone.net,0,0.00%,192,192,0.00%
ns1.huaweicloud-dns.cn,0,0.00%,381,381,0.00%
ns1.huaweicloud-dns.org,0,0.00%,391,391,0.00%
ns15.domaincontrol.com,0,0.00%,563,563,0.00%
ns75.domaincontrol.com,0,0.00%,510,510,0.00%
ns16.domaincontrol.com,0,0.00%,674,674,0.00%
dns.technorail.com,0,0.00%,226,226,0.00%
jm2.alidns.com,0,0.00%,271,271,0.00%
dns3.arubadns.net,0,0.00%,213,213,0.00%
dns4.arubadns.cz,0,0.00%,218,218,0.00%
bugreport.huorong.cn,0,0.00%,142,142,0.00%
prod-sav-park-lb01-1919960993.us-east-2.elb.amazonaws.com,0,0.00%,503,503,0.00%
f1g1ns1.dnspod.net,0,0.00%,178,178,0.00%
ns200.anycast.me,0,0.00%,101,101,0.00%
dns26.hichina.com,0,0.00%,163,163,0.00%
dns3.p01.nsone.net,0,0.00%,209,209,0.00%
dns4.p01.nsone.net,0,0.00%,172,172,0.00%
ns1.yeyehaidns.com,0,0.00%,148,148,0.00%
ns2.yeyehaidns.com,0,0.00%,146,146,0.00%
dns2.p02.nsone.net,0,0.00%,154,154,0.00%
dns200.anycast.me,0,0.00%,115,115,0.00%
dns2.p06.nsone.net,0,0.00%,168,168,0.00%
dns3.p06.nsone.net,0,0.00%,173,173,0.00%
dns4.p06.nsone.net,0,0.00%,166,166,0.00%
ns1.domainnamedns.com,0,0.00%,190,190,0.00%
ip.sb,0,0.00%,165,165,0.00%
kenneth.ns.cloudflare.com,0,0.00%,646,646,0.00%
ns12.xincache.com,0,0.00%,185,185,0.00%
ns11.xincache.com,0,0.00%,188,188,0.00%
ns1.alidns.com,0,0.00%,290,290,0.00%
ns2.alidns.com,0,0.00%,276,276,0.00%
in.appcenter.ms,0,0.00%,113,113,0.00%
push.thanos.ams.eulix.xyz,0,0.00%,211,211,0.00%
auth.sangfor.com.cn,0,0.00%,1404,1404,0.00%
ins-qw3q8ofk.ias.tencent-cloud.net,0,0.00%,104,104,0.00%
iguvmbs.roygxe.xyz,0,0.00%,141,141,0.00%
time-ios.g.aaplimg.com,0,0.00%,182,182,0.00%
aloha.maxhub.vip.wsglb0.com,0,0.00%,108,108,0.00%
locprod2-elb-us-west-2.prod.mozaws.net,0,0.00%,184,184,0.00%
www.so.com,0,0.00%,146,146,0.00%
mail.qq.com,0,0.00%,128,128,0.00%
zhuanlan.zhihu.com,0,0.00%,182,182,0.00%
picupload.weibo.com,0,0.00%,126,126,0.00%
i.work.weixin.qq.com,0,0.00%,162,162,0.00%
update.huorong.cn,0,0.00%,153,153,0.00%
color.docer.wps.cn,0,0.00%,121,121,0.00%
rc.kite.com,0,0.00%,121,121,0.00%
nj.t.bcsp2p.baidu.com,0,0.00%,291,291,0.00%
smtp.qq.com,0,0.00%,182,182,0.00%
teredo-debian.remlab.net,0,0.00%,109,109,0.00%
log.tailscale.io,0,0.00%,754,754,0.00%
access.video.qq.com,0,0.00%,251,251,0.00%
alpha-cloud-log.cn-hangzhou.log.aliyuncs.com,0,0.00%,138,138,0.00%
controlplane.tailscale.com,0,0.00%,369,369,0.00%
dns.alidns.com,0,0.00%,118,118,0.00%
comet.jianguoyun.com,0,0.00%,110,110,0.00%
softcenter-all.os.nfschina.com,0,0.00%,101,101,0.00%
ssl.ptlogin2.graph.qq.com,0,0.00%,210,210,0.00%
api.dida365.com,0,0.00%,136,136,0.00%
analytics.yinxiang.com,0,0.00%,264,264,0.00%
kmd.antpool.com,0,0.00%,433,433,0.00%
sg.minexmr.com,0,0.00%,419,419,0.00%
verushash.mine.zergpool.com,0,0.00%,430,430,0.00%
sbtc.uupool.cn,0,0.00%,438,438,0.00%
pool.minexmr.com,0,0.00%,453,453,0.00%
donate.ssl.xmrig.com,0,0.00%,436,436,0.00%
awsmx.f2pool.com,0,0.00%,440,440,0.00%
fliplc.getxlx.com,0,0.00%,876,876,0.00%
ns41.hashvault.pro,0,0.00%,406,406,0.00%
api.mymonero.com,0,0.00%,425,425,0.00%
fr.minexmr.com,0,0.00%,453,453,0.00%
toa.mygametoa.com,0,0.00%,444,444,0.00%
donate.v2.xmrig.com,0,0.00%,424,424,0.00%
nhmws.nicehash.com,0,0.00%,462,462,0.00%
zec.uupool.cn,0,0.00%,409,409,0.00%
sea.wafflepool.com,0,0.00%,441,441,0.00%
de.minexmr.com,0,0.00%,444,444,0.00%
btc.f2pool.com,0,0.00%,432,432,0.00%
dcr.f2pool.com,0,0.00%,425,425,0.00%
penef6f8f734.slushpool.com,0,0.00%,448,448,0.00%
www.fullskystar.top,0,0.00%,442,442,0.00%
asia2.ethermine.org,0,0.00%,460,460,0.00%
stratum.okpool.me,0,0.00%,470,470,0.00%
k8s.entrypoint.ops.sparkpool.com,0,0.00%,436,436,0.00%
xmr.flooder.org,0,0.00%,431,431,0.00%
pool-fr.supportxmr.com,0,0.00%,442,442,0.00%
eth.f2pool.com,0,0.00%,447,447,0.00%
asia1.ethpool.org,0,0.00%,448,448,0.00%
btw.uupool.cn,0,0.00%,408,408,0.00%
b4c.f2pool.com,0,0.00%,443,443,0.00%
ss.antpool.com,0,0.00%,444,444,0.00%
cn.sparkpool.com,0,0.00%,412,412,0.00%
docs.nicehash.com,0,0.00%,406,406,0.00%
pool.hashvault.pro,0,0.00%,448,448,0.00%
turtlecoin.herominers.com,0,0.00%,436,436,0.00%
us1.ethpool.org,0,0.00%,450,450,0.00%
du.testjj.com,0,0.00%,402,402,0.00%
ns11.hashvault.pro,0,0.00%,441,441,0.00%
mailer.nicehash.com,0,0.00%,426,426,0.00%
btm.f2pool.com,0,0.00%,454,454,0.00%
rx.thegov.win,0,0.00%,1649,1649,0.00%
pool.supportxmr.com,0,0.00%,424,424,0.00%
etc.f2pool.com,0,0.00%,464,464,0.00%
pool.flooder.org,0,0.00%,436,436,0.00%
eth.ss.poolin.com,0,0.00%,407,407,0.00%
eth.antpool.com,0,0.00%,436,436,0.00%
miner.nicehash.com,0,0.00%,453,453,0.00%
raven.f2pool.com,0,0.00%,430,430,0.00%
monerohash.com,0,0.00%,421,421,0.00%
pool.minergate.com,0,0.00%,432,432,0.00%
blog.nicehash.com,0,0.00%,442,442,0.00%
www.jvmonline.com,0,0.00%,426,426,0.00%
smtp.nicehash.com,0,0.00%,455,455,0.00%
eth.uupool.cn,0,0.00%,413,413,0.00%
ca.minexmr.com,0,0.00%,450,450,0.00%
test.nicehash.com,0,0.00%,440,440,0.00%
ar.hpool.com,0,0.00%,413,413,0.00%
ckb.antpool.com,0,0.00%,410,410,0.00%
jp.sparkpool.com,0,0.00%,444,444,0.00%
api.nicehash.com,0,0.00%,448,448,0.00%
mail.nicehash.com,0,0.00%,412,412,0.00%
dcr.uupool.cn,0,0.00%,404,404,0.00%
gitlab.com,0,0.00%,160,160,0.00%
xmr.remuser.win,0,0.00%,1784,1784,0.00%
sources.openembedded.org,0,0.00%,2650,2650,0.00%
ws-std01.sunlogin.oray.com,0,0.00%,122,122,0.00%
mirror.iscas.ac.cn,0,0.00%,150,150,0.00%
pushtrs.push.hicloud.com,0,0.00%,141,141,0.00%
upload.fp.measure.office.com,0,0.00%,134,134,0.00%
usa1v2.jsssline.top,0,0.00%,298,298,0.00%
share.camoe.cn,0,0.00%,170,170,0.00%
filehelper.weixin.qq.com,0,0.00%,1206,1206,0.00%
cn2888.v2free.xyz,0,0.00%,216,216,0.00%
mam.netease.com,0,0.00%,122,122,0.00%
tracker.pow7.com,0,0.00%,156,156,0.00%
secure.pow7.com,0,0.00%,148,148,0.00%
docs.qq.com,0,0.00%,258,258,0.00%
t.overflow.biz,0,0.00%,290,290,0.00%
t1.pow7.com,0,0.00%,180,180,0.00%
www.bit-hdtv.com,0,0.00%,310,310,0.00%
iphone-ld.apple.com,0,0.00%,106,106,0.00%
frp.zwlin.top,0,0.00%,271,271,0.00%
soup.v.qq.com,0,0.00%,111,111,0.00%
api-std.sunlogin.oray.com,0,0.00%,167,167,0.00%
ns1.bdm.microsoftonline.com,0,0.00%,122,122,0.00%
pdns1.registrar-servers.com,0,0.00%,132,132,0.00%
ns2.bdm.microsoftonline.com,0,0.00%,121,121,0.00%
dns02.muumuu-domain.com,0,0.00%,174,174,0.00%
dns01.muumuu-domain.com,0,0.00%,181,181,0.00%
dns17.hichina.com,0,0.00%,157,157,0.00%
ns2.systemdns.com,0,0.00%,255,255,0.00%
lakas.ns.cloudflare.com,0,0.00%,140,140,0.00%
ns3.systemdns.com,0,0.00%,278,278,0.00%
dns1.p07.nsone.net,0,0.00%,153,153,0.00%
dns2.p07.nsone.net,0,0.00%,175,175,0.00%
yolanda.ns.cloudflare.com,0,0.00%,152,152,0.00%
augustus.ns.cloudflare.com,0,0.00%,322,322,0.00%
laura.ns.cloudflare.com,0,0.00%,344,344,0.00%
ns2.nic53.de,0,0.00%,259,259,0.00%
dns4.hichina.com,0,0.00%,140,140,0.00%
ns-a1.conoha.io,0,0.00%,196,196,0.00%
dns036.c.register.com,0,0.00%,110,110,0.00%
dns27.hichina.com,0,0.00%,147,147,0.00%
dns3.hichina.com,0,0.00%,147,147,0.00%
dns083.d.register.com,0,0.00%,127,127,0.00%
ns1.nic53.net,0,0.00%,262,262,0.00%
dns30.hichina.com,0,0.00%,142,142,0.00%
ns.hostpoint.ch,0,0.00%,137,137,0.00%
ns2.hostpoint.ch,0,0.00%,122,122,0.00%
ns3.hostpoint.ch,0,0.00%,126,126,0.00%
dns25.hichina.com,0,0.00%,171,171,0.00%
dns223.c.register.com,0,0.00%,107,107,0.00%
dns176.d.register.com,0,0.00%,120,120,0.00%
uns01.lolipop.jp,0,0.00%,108,108,0.00%
dns29.hichina.com,0,0.00%,152,152,0.00%
ns3.stackdns.com,0,0.00%,189,189,0.00%
ns1.stackdns.com,0,0.00%,192,192,0.00%
ns2.stackdns.com,0,0.00%,183,183,0.00%
ns4.stackdns.com,0,0.00%,169,169,0.00%
dns3.p07.nsone.net,0,0.00%,164,164,0.00%
ns2.domainesia.net,0,0.00%,101,101,0.00%
ns42.infomaniak.com,0,0.00%,174,174,0.00%
dns4.p03.nsone.net,0,0.00%,134,134,0.00%
ns.gabia.co.kr,0,0.00%,149,149,0.00%
ns1.gabia.co.kr,0,0.00%,156,156,0.00%
ns.gabia.net,0,0.00%,153,153,0.00%
dns18.hichina.com,0,0.00%,150,150,0.00%
ns1cnb.name.com,0,0.00%,275,275,0.00%
router14.teamviewer.com,0,0.00%,338,338,0.00%
router7.teamviewer.com,0,0.00%,255,255,0.00%
router8.teamviewer.com,0,0.00%,303,303,0.00%
qbwup.imtt.qq.com,0,0.00%,122,122,0.00%
router4.teamviewer.com,0,0.00%,245,245,0.00%
router6.teamviewer.com,0,0.00%,292,292,0.00%
ip.parrotdns.com,0,0.00%,147,147,0.00%
goldengate.grammarly.com,0,0.00%,188,188,0.00%
cx.soft.360.cn,0,0.00%,166,166,0.00%
database.clamav.net,0,0.00%,151,151,0.00%
hp3.mail.netease.com,0,0.00%,123,123,0.00%
software.drivergenius.com,0,0.00%,138,138,0.00%
api.tabnine.com,0,0.00%,111,111,0.00%
midinfo.baofeng.com,0,0.00%,266,266,0.00%
pcoma.qq.com,0,0.00%,212,212,0.00%
acc.qq.com,0,0.00%,192,192,0.00%
ping.dgraph.io,0,0.00%,677,677,0.00%
ntp.aliyun.com,0,0.00%,163,163,0.00%
qup.b.qianxin.com,0,0.00%,2818,2818,0.00%
bam.nr-data.net,0,0.00%,189,189,0.00%
api.basedata.union.longu.xyz,0,0.00%,731,731,0.00%
pypi.org,0,0.00%,56654,56654,0.00%
us-v20.events.data.microsoft.com,0,0.00%,512,512,0.00%
a.sox.si,0,0.00%,1364,1364,0.00%
winatp-gw-cus3.microsoft.com,0,0.00%,115,115,0.00%
websv.aliyundrive.com,0,0.00%,197,197,0.00%
analysis.sangfor.com.cn,0,0.00%,161,161,0.00%
sdl.360safe.com,0,0.00%,191,191,0.00%
sp.sangfor.com.cn,0,0.00%,698,698,0.00%
dc.services.visualstudio.com,0,0.00%,151,151,0.00%
bitbucket.bidinte.top,0,0.00%,113,113,0.00%
chpm.sangfor.com.cn,0,0.00%,138,138,0.00%
mirrors.fedoraproject.org,0,0.00%,246,246,0.00%
oth.str.mdt.qq.com,0,0.00%,114,114,0.00%
weather-api.extfans.com,0,0.00%,106,106,0.00%
yun-hl.3g.qq.com,0,0.00%,110,110,0.00%
ns1.mytrafficmanagement.com,0,0.00%,277,277,0.00%
ns2.value-domain.com,0,0.00%,230,230,0.00%
donald.ns.cloudflare.com,0,0.00%,122,122,0.00%
ns05.domaincontrol.com,0,0.00%,523,523,0.00%
leia.ns.cloudflare.com,0,0.00%,102,102,0.00%
ns2.mytrafficmanagement.com,0,0.00%,288,288,0.00%
ns06.domaincontrol.com,0,0.00%,613,613,0.00%
ns27.domaincontrol.com,0,0.00%,522,522,0.00%
ns28.domaincontrol.com,0,0.00%,378,378,0.00%
guss.ns.cloudflare.com,0,0.00%,250,250,0.00%
ns43.domaincontrol.com,0,0.00%,765,765,0.00%
ns44.domaincontrol.com,0,0.00%,726,726,0.00%
ns7.alidns.com,0,0.00%,204,204,0.00%
ns10.domaincontrol.com,0,0.00%,208,208,0.00%
ns8.alidns.com,0,0.00%,200,200,0.00%
cloudinfo.rising.com.cn,0,0.00%,349,349,0.00%
dns3.p04.nsone.net,0,0.00%,145,145,0.00%
grace.ns.cloudflare.com,0,0.00%,115,115,0.00%
dns1.p03.nsone.net,0,0.00%,137,137,0.00%
dns2.p03.nsone.net,0,0.00%,144,144,0.00%
dns3.p03.nsone.net,0,0.00%,135,135,0.00%
dns24.hichina.com,0,0.00%,132,132,0.00%
dns1.cscdns.net,0,0.00%,175,175,0.00%
dns2.cscdns.net,0,0.00%,166,166,0.00%
dns14.hichina.com,0,0.00%,167,167,0.00%
ns2ckr.name.com,0,0.00%,105,105,0.00%
00000000000000000000000000000000000000000000000000000000000015a.rui77.com,0,0.00%,100,100,0.00%
ns1.sedopark.net,0,0.00%,467,467,0.00%
kate.ns.cloudflare.com,0,0.00%,127,127,0.00%
ns29.domaincontrol.com,0,0.00%,530,530,0.00%
ns30.domaincontrol.com,0,0.00%,543,543,0.00%
dan.ns.cloudflare.com,0,0.00%,116,116,0.00%
dns32.hichina.com,0,0.00%,157,157,0.00%
dns20.hichina.com,0,0.00%,129,129,0.00%
dns19.hichina.com,0,0.00%,124,124,0.00%
dns2.technorail.com,0,0.00%,239,239,0.00%
rscloud.rising.net.cn,0,0.00%,173,173,0.00%
ns41.infomaniak.com,0,0.00%,135,135,0.00%
ns2.sedopark.net,0,0.00%,446,446,0.00%
ns2.o2switch.net,0,0.00%,101,101,0.00%
ns2.phase8.net,0,0.00%,218,218,0.00%
ns1.phase8.net,0,0.00%,229,229,0.00%
ns0.phase8.net,0,0.00%,223,223,0.00%
a.gmoregistry.net,0,0.00%,211,211,0.00%
ns2.beget.ru,0,0.00%,457,457,0.00%
ns1.beget.pro,0,0.00%,729,729,0.00%
ns21.domaincontrol.com,0,0.00%,525,525,0.00%
ns22.domaincontrol.com,0,0.00%,522,522,0.00%
ns1.beget.com,0,0.00%,722,722,0.00%
ns4.timeweb.org,0,0.00%,317,317,0.00%
ns1.timeweb.ru,0,0.00%,319,319,0.00%
ns3.timeweb.org,0,0.00%,311,311,0.00%
ns2.timeweb.ru,0,0.00%,321,321,0.00%
ns1.tildadns.com,0,0.00%,149,149,0.00%
ns2.beget.pro,0,0.00%,693,693,0.00%
ns2.beget.com,0,0.00%,696,696,0.00%
ns1.beget.ru,0,0.00%,473,473,0.00%
ns2.tildadns.com,0,0.00%,133,133,0.00%
ns1.huaweicloud-dns.net,0,0.00%,375,375,0.00%
api.appstore.deepin.org,0,0.00%,325,325,0.00%
ntp.ntsc.ac.cn,0,0.00%,114,114,0.00%
dstore-metadata.deepin.cn,0,0.00%,154,154,0.00%
cip.cc,0,0.00%,136,136,0.00%
prom-monitorproxy1.fastsdwan.com,0,0.00%,126,126,0.00%
3.rlb.router.teamviewer.cn,0,0.00%,1750,1750,0.00%
access.toggle.qq.com,0,0.00%,200,200,0.00%
clock.via.net,0,0.00%,103,103,0.00%
cdn.packages.deepin.com,0,0.00%,143,143,0.00%
community-store-packages.deepin.com,0,0.00%,289,289,0.00%
mail.nfschina.com,0,0.00%,150,150,0.00%
ios.ac.cn,0,0.00%,115,115,0.00%
tracker.fixr.pro,0,0.00%,104,104,0.00%
www.google-analytics.com,0,0.00%,153,153,0.00%
www.weibo.com,0,0.00%,114,114,0.00%
www.getdropbox.com,0,0.00%,104,104,0.00%
api.kylinos.cn,0,0.00%,124,124,0.00%
user.cn.union.longu.xyz,0,0.00%,162,162,0.00%
vip.dingtalk.com,0,0.00%,119,119,0.00%
qmzgh5gm.gameserver.youxigu.com,0,0.00%,167,167,0.00%
h5-api.appstore.vivo.com.cn,0,0.00%,583,583,0.00%
report.idqqimg.com,0,0.00%,116,116,0.00%
ping3.teamviewer.com,0,0.00%,286,286,0.00%
atrack.pow7.com,0,0.00%,166,166,0.00%
ws.666liushen.tk,0,0.00%,122,122,0.00%
flbgpi.yixuedianzishu.com,0,0.00%,113,113,0.00%
pdcweb.micloud.xiaomi.net,0,0.00%,163,163,0.00%
ns69.domaincontrol.com,0,0.00%,137,137,0.00%
ns70.domaincontrol.com,0,0.00%,152,152,0.00%
ns09.domaincontrol.com,0,0.00%,228,228,0.00%
anastasia.ns.cloudflare.com,0,0.00%,164,164,0.00%
devpay.cn.sy.longu.xyz,0,0.00%,153,153,0.00%
data.bleachcarnival.com,0,0.00%,181,181,0.00%
center.bleachcarnival.com,0,0.00%,333,333,0.00%
o.andfx.cn,0,0.00%,754,754,0.00%
ns1.99midns.com,0,0.00%,192,192,0.00%
ns2.99midns.com,0,0.00%,153,153,0.00%
dns1.p05.nsone.net,0,0.00%,149,149,0.00%
dns2.p05.nsone.net,0,0.00%,158,158,0.00%
dns3.p05.nsone.net,0,0.00%,157,157,0.00%
dns4.p05.nsone.net,0,0.00%,154,154,0.00%
ns3.epik.com,0,0.00%,146,146,0.00%
dns13.hichina.com,0,0.00%,160,160,0.00%
desi.ns.cloudflare.com,0,0.00%,737,737,0.00%
router13.teamviewer.com,0,0.00%,266,266,0.00%
isrc.iscas.ac.cn,0,0.00%,180,180,0.00%
s1a.time.edu.cn,0,0.00%,270,270,0.00%
hal.ns.cloudflare.com,0,0.00%,104,104,0.00%
web-drcn.hispace.dbankcloud.cn,0,0.00%,130,130,0.00%
h5.do889.com,0,0.00%,155,155,0.00%
rita.ns.cloudflare.com,0,0.00%,103,103,0.00%
bing.com,0,0.00%,108,108,0.00%
mirror.sjtu.edu.cn,0,0.00%,334,334,0.00%
downloads.yoctoproject.org,0,0.00%,8145,8145,0.00%
router11.teamviewer.com,0,0.00%,319,319,0.00%
mail.digidown.de,0,0.00%,122,122,0.00%
ns39.domaincontrol.com,0,0.00%,294,294,0.00%
ns40.domaincontrol.com,0,0.00%,319,319,0.00%
ns57.domaincontrol.com,0,0.00%,595,595,0.00%
ns9.szhot.com,0,0.00%,228,228,0.00%
aragorn.ns.cloudflare.com,0,0.00%,654,654,0.00%
router3.teamviewer.com,0,0.00%,301,301,0.00%
ns33.domaincontrol.com,0,0.00%,296,296,0.00%
ns34.domaincontrol.com,0,0.00%,302,302,0.00%
ns58.domaincontrol.com,0,0.00%,577,577,0.00%
huggingface.co,0,0.00%,337,337,0.00%
frp.zwlin.store,0,0.00%,111,111,0.00%
www.yuque.com,0,0.00%,155,155,0.00%
ss.hk5.se.sx.cn,0,0.00%,178,178,0.00%
serviceplus.phytium.com.cn,0,0.00%,103,103,0.00%
www.360.com,0,0.00%,1297,1297,0.00%
nvh6bk7t.mirror.aliyuncs.com,0,0.00%,245,245,0.00%
a2f3e71d9181a67b.jijifun.com,0,0.00%,129,129,0.00%
dns1.nic.uk,0,0.00%,365,365,0.00%
www.tplink.com,0,0.00%,523,523,0.00%
www.oray.com,0,0.00%,153,153,0.00%
tkysenwhezsrteagubzihkhhxcbhhsyc.yundunwaf1.com,0,0.00%,138,138,0.00%
api.st615.com,0,0.00%,140,140,0.00%
login.tailscale.com,0,0.00%,245,245,0.00%
dyncli.ping-ipv6.com,0,0.00%,1979,1979,0.00%
tw1v.acrossgw.info,0,0.00%,119,119,0.00%
api.wandb.ai,0,0.00%,160,160,0.00%
a0.org.afilias-nst.info,0,0.00%,166,166,0.00%
testip.internet-census.org,0,0.00%,154,154,0.00%
a0.info.afilias-nst.info,0,0.00%,199,199,0.00%
ns1.dns.nic.buzz,0,0.00%,100,100,0.00%
cstestarea.leagsoft.net,0,0.00%,103,103,0.00%
s2a.time.edu.cn,0,0.00%,264,264,0.00%
verification-d5901584.ns3.dan.hosting,0,0.00%,202,202,0.00%
