domain,num_aaaa_fail,rate_all,num_aaaa_all,num_aaaa_success,rate_aaaa_fail
hub5p.sandai.net,97184,6.41%,97184,0,100.00%
www.baidu.com,79661,5.25%,152826,73165,52.13%
www.chinauos.com,79193,5.22%,79193,0,100.00%
asimov.vortex.data.trafficmanager.net,58509,3.86%,58509,0,100.00%
downloads.yoctoproject.org,43816,2.89%,43816,0,100.00%
note.youdao.com,36083,2.38%,36083,0,100.00%
connectivity-check.ubuntu.com,36007,2.38%,36007,0,100.00%
rq.r9t1.com,28755,1.90%,28755,0,100.00%
optimizationguide-pa.googleapis.com,26365,1.74%,27075,710,97.38%
api.miwifi.com,25594,1.69%,25594,0,100.00%
daisy.ubuntu.com,25338,1.67%,66446,41108,38.13%
xgpolardb.mysql.polardb.rds.aliyuncs.com,21206,1.40%,21206,0,100.00%
sources.openembedded.org,20322,1.34%,20322,0,100.00%
yapi.kdsec.org,16876,1.11%,16876,0,100.00%
www.msftncsi.com,16836,1.11%,16836,0,100.00%
edragent.sangfor.com.cn,16489,1.09%,16489,0,100.00%
settings-win.data.microsoft.com,15534,1.02%,15534,0,100.00%
retracker.mgts.by,12627,0.83%,12627,0,100.00%
retracker.lanta-net.ru,12115,0.80%,12115,0,100.00%
es.proj217.app.kdsec.org,11982,0.79%,11982,0,100.00%
cu1pehnswss01.servicebus.windows.net,11288,0.74%,11288,0,100.00%
x.research.qq.com,11285,0.74%,11285,0,100.00%
connectivitycheck.platform.hicloud.com,10865,0.72%,16032,5167,67.77%
v10.events.data.microsoft.com,10691,0.71%,11409,718,93.71%
safebrowsing.googleapis.com,10158,0.67%,10403,245,97.64%
ipv4only.arpa,9800,0.65%,9800,0,100.00%
hsk-embed.oray.com,9386,0.62%,9386,0,100.00%
2.ubuntu.pool.ntp.org,9100,0.60%,9250,150,98.38%
osfsr.lenovomm.com,9027,0.60%,9027,0,100.00%
us-v20.events.data.microsoft.com,8533,0.56%,8656,123,98.58%
assets.contentstack.io,8414,0.55%,8414,0,100.00%
www.expressapisv2.net,8328,0.55%,15395,7067,54.10%
mail.cstnet.cn,8117,0.54%,15773,7656,51.46%
h5-api.appstore.vivo.com.cn,7975,0.53%,7975,0,100.00%
qup.b.qianxin.com,7810,0.52%,7810,0,100.00%
ip.42.pl,6781,0.45%,6781,0,100.00%
browser.360.cn,6741,0.44%,6814,73,98.93%
ctldl.windowsupdate.com,6697,0.44%,6858,161,97.65%
mvgforumtracker.mvgroup.org,6431,0.42%,6431,0,100.00%
www.tribalmixes.com,5904,0.39%,5904,0,100.00%
www.tvnihon.com,5851,0.39%,5851,0,100.00%
github.com,5768,0.38%,5768,0,100.00%
i5.cwip.eset.com,5609,0.37%,5609,0,100.00%
analytics.yinxiang.com,5502,0.36%,5502,0,100.00%
vortex.data.microsoft.com,5477,0.36%,5477,0,100.00%
self.events.data.microsoft.com,5392,0.36%,6159,767,87.55%
www.bit-hdtv.com,5318,0.35%,5318,0,100.00%
allall01.baidupcs.com,5022,0.33%,9436,4414,53.22%
www.yuwabits.net,4655,0.31%,4655,0,100.00%
api.vc.bilibili.com,4633,0.31%,5479,846,84.56%
duba-defend.zhhainiao.com,4616,0.30%,4616,0,100.00%
incoming.telemetry.mozilla.org,4533,0.30%,4533,0,100.00%
t.overflow.biz,4467,0.29%,4467,0,100.00%
stun.douyucdn.cn,4326,0.29%,8154,3828,53.05%
mirrors.aliyun.com,4305,0.28%,4560,255,94.41%
shuc-pc-hunt.ksord.com,4291,0.28%,4291,0,100.00%
default.exp-tas.com,4287,0.28%,8682,4395,49.38%
android.clients.google.com,4286,0.28%,4286,0,100.00%
ping.pinyin.sogou.com,4278,0.28%,4278,0,100.00%
stun1.douyucdn.cn,4249,0.28%,4249,0,100.00%
get.sogou.com,4147,0.27%,4147,0,100.00%
update1.sangfor.net,4103,0.27%,4103,0,100.00%
2.centos.pool.ntp.org,4065,0.27%,5383,1318,75.52%
clientservices.googleapis.com,3892,0.26%,4088,196,95.21%
contile.services.mozilla.com,3884,0.26%,3884,0,100.00%
share.camoe.cn,3547,0.23%,3547,0,100.00%
slapi.oray.net,3478,0.23%,3478,0,100.00%
nj.t.bcsp2p.baidu.com,3462,0.23%,3462,0,100.00%
mobile.events.data.microsoft.com,3282,0.22%,3627,345,90.49%
alfred.ixiacom.com,3278,0.22%,3278,0,100.00%
pan.baidu.com,3240,0.21%,9204,5964,35.20%
e-0014.e-msedge.net,3212,0.21%,3212,0,100.00%
pool.ntp.org,3167,0.21%,3167,0,100.00%
www.mvgroup.org,3105,0.20%,3105,0,100.00%
open.tracker.cl,3091,0.20%,3091,0,100.00%
tracker.tasvideos.org,2848,0.19%,5176,2328,55.02%
sl-tk.oray.com,2834,0.19%,2834,0,100.00%
config.pinyin.sogou.com,2802,0.18%,5381,2579,52.07%
locprod2-elb-us-west-2.prod.mozaws.net,2779,0.18%,2779,0,100.00%
rscloud.rising.net.cn,2659,0.18%,2659,0,100.00%
login.live.com,2585,0.17%,2585,0,100.00%
router14.teamviewer.com,2542,0.17%,2760,218,92.10%
tr.abirxo.cf,2506,0.17%,4708,2202,53.23%
router2.teamviewer.com,2503,0.17%,2638,135,94.88%
watson.telemetry.microsoft.com,2489,0.16%,3195,706,77.90%
git.rancher.io,2485,0.16%,24849,22364,10.00%
tile-service.weather.microsoft.com,2479,0.16%,2479,0,100.00%
router7.teamviewer.com,2415,0.16%,2578,163,93.68%
router5.teamviewer.com,2342,0.15%,2501,159,93.64%
router9.teamviewer.com,2337,0.15%,2485,148,94.04%
router6.teamviewer.com,2323,0.15%,2468,145,94.12%
packages.deepin.com,2318,0.15%,2318,0,100.00%
router16.teamviewer.com,2315,0.15%,2573,258,89.97%
router12.teamviewer.com,2305,0.15%,2526,221,91.25%
router3.teamviewer.com,2298,0.15%,2444,146,94.03%
router15.teamviewer.com,2296,0.15%,2554,258,89.90%
play.googleapis.com,2258,0.15%,2357,99,95.80%
frp.zwlin.top,2249,0.15%,2249,0,100.00%
router10.teamviewer.com,2229,0.15%,2357,128,94.57%
router1.teamviewer.com,2198,0.14%,2376,178,92.51%
router13.teamviewer.com,2191,0.14%,2378,187,92.14%
router8.teamviewer.com,2179,0.14%,2380,201,91.55%
ww62.uatracker.net,2168,0.14%,2168,0,100.00%
router4.teamviewer.com,2160,0.14%,2263,103,95.45%
p3p.sogou.com,2147,0.14%,2147,0,100.00%
www.belkin.com,2130,0.14%,2130,0,100.00%
update.googleapis.com,2095,0.14%,2303,208,90.97%
update.pan.baidu.com,2090,0.14%,2090,0,100.00%
router11.teamviewer.com,2060,0.14%,2234,174,92.21%
ntp.sjtu.edu.cn,2015,0.13%,2015,0,100.00%
bt.okmp3.ru,2006,0.13%,2006,0,100.00%
content-autofill.googleapis.com,1962,0.13%,2065,103,95.01%
d27xxe7juh1us6.cloudfront.net,1957,0.13%,3875,1918,50.50%
www.bing.com,1946,0.13%,2288,342,85.05%
arc.msn.com,1946,0.13%,1946,0,100.00%
usa1v2.jsssline.top,1925,0.13%,1925,0,100.00%
tracker.fixr.pro,1905,0.13%,1905,0,100.00%
pcs-sdk-server.alibaba.com,1896,0.13%,3420,1524,55.44%
midinfo.baofeng.com,1764,0.12%,1764,0,100.00%
femetrics.grammarly.io,1763,0.12%,1763,0,100.00%
mirror.iscas.ac.cn,1751,0.12%,1751,0,100.00%
h-adashx.ut.taobao.com,1750,0.12%,1750,0,100.00%
clients2.google.com,1745,0.12%,1820,75,95.88%
global.quickconnect.cn,1729,0.11%,1729,0,100.00%
monorepo-production-edge-alb-985829473.us-east-1.elb.amazonaws.com,1723,0.11%,1723,0,100.00%
nexusrules.officeapps.live.com,1713,0.11%,3224,1511,53.13%
client.wns.windows.com,1614,0.11%,2932,1318,55.05%
t1.pow7.com,1613,0.11%,3124,1511,51.63%
data.bilibili.com,1598,0.11%,2908,1310,54.95%
t2.pow7.com,1580,0.10%,3070,1490,51.47%
atrack.pow7.com,1573,0.10%,3043,1470,51.69%
t.acg.rip,1570,0.10%,1570,0,100.00%
wup.browser.qq.com,1544,0.10%,1544,0,100.00%
88dsf5l.003.1.mclqp.link,1536,0.10%,1536,0,100.00%
ipv6.google.com,1530,0.10%,2102,572,72.79%
mtalk.google.com,1526,0.10%,4232,2706,36.06%
ldc.lenovo.com.cn,1501,0.10%,1501,0,100.00%
erickson514-my.sharepoint.com,1487,0.10%,1487,0,100.00%
secure.pow7.com,1485,0.10%,2871,1386,51.72%
nzk.woqu365.com,1476,0.10%,1476,0,100.00%
huggingface.co,1474,0.10%,3246,1772,45.41%
pdcweb.micloud.xiaomi.net,1461,0.10%,1461,0,100.00%
tracker.pow7.com,1440,0.09%,2769,1329,52.00%
cn2888.v2free.xyz,1417,0.09%,1417,0,100.00%
accounts.google.com,1405,0.09%,1502,97,93.54%
mmbiz.qpic.cn,1404,0.09%,1525,121,92.07%
prom-monitorproxy1.fastsdwan.com,1398,0.09%,1398,0,100.00%
info.pinyin.sogou.com,1390,0.09%,2597,1207,53.52%
fedora.riscv.rocks,1364,0.09%,1364,0,100.00%
switch.pcfg.cache.wpscdn.cn,1363,0.09%,2909,1546,46.85%
winatp-gw-cus3.microsoft.com,1355,0.09%,1355,0,100.00%
location.services.mozilla.com,1354,0.09%,1354,0,100.00%
array504.prod.do.dsp.mp.microsoft.com,1323,0.09%,1323,0,100.00%
hk4.v2u9.top,1305,0.09%,1305,0,100.00%
www.microsoft.com,1292,0.09%,1368,76,94.44%
visualstudio-devdiv-c2s.msedge.net,1262,0.08%,1262,0,100.00%
clients1.google.com,1248,0.08%,1257,9,99.28%
treatment.grammarly.com,1246,0.08%,1246,0,100.00%
v2.get.sogou.com,1240,0.08%,1240,0,100.00%
v20.events.data.microsoft.com,1232,0.08%,1331,99,92.56%
cn.bing.com,1229,0.08%,1434,205,85.70%
cloud.browser.360.cn,1221,0.08%,1221,0,100.00%
redirector.gvt1.com,1206,0.08%,1241,35,97.18%
d11.baidupcs.com,1203,0.08%,1203,0,100.00%
btrace.qq.com,1200,0.08%,2239,1039,53.60%
qingcenter.wps.cn,1195,0.08%,2360,1165,50.64%
ris.api.iris.microsoft.com,1195,0.08%,1195,0,100.00%
hk.tcpbbr.net,1153,0.08%,2154,1001,53.53%
gitee.com,1148,0.08%,1148,0,100.00%
dldir1.qq.com,1127,0.07%,1131,4,99.65%
mini.browser.360.cn,1113,0.07%,1113,0,100.00%
api.snapcraft.io,1108,0.07%,1108,0,100.00%
diskapi.baidu.com,1067,0.07%,1979,912,53.92%
assets.msn.cn,1052,0.07%,1052,0,100.00%
c.pcs.baidu.com,1044,0.07%,1931,887,54.07%
mon.zijieapi.com,1041,0.07%,1041,0,100.00%
shortconn.im.qcloud.com,1036,0.07%,1036,0,100.00%
push.thanos.ams.eulix.xyz,1003,0.07%,1003,0,100.00%
www.a.shifen.com,998,0.07%,1904,906,52.42%
checkappexec.microsoft.com,991,0.07%,991,0,100.00%
qing.wps.cn,989,0.07%,2178,1189,45.41%
www.google.com,985,0.06%,5185,4200,19.00%
server-m.pp.cn,980,0.06%,980,0,100.00%
tuna05.mcddns01.com,978,0.06%,978,0,100.00%
beacons.gcp.gvt2.com,974,0.06%,1020,46,95.49%
lp-push-server-253.lastpass.com,970,0.06%,970,0,100.00%
community-store-packages.deepin.com,957,0.06%,957,0,100.00%
d.docs.live.net,956,0.06%,1646,690,58.08%
www.taobao.com,953,0.06%,1801,848,52.92%
cdn-cn.nekocloud.cn,953,0.06%,953,0,100.00%
api.appstore.deepin.org,952,0.06%,952,0,100.00%
vipapi.wps.cn,951,0.06%,951,0,100.00%
alive.github.com,949,0.06%,949,0,100.00%
frp.zwlin.store,946,0.06%,946,0,100.00%
nexus.officeapps.live.com,945,0.06%,945,0,100.00%
x1.c.lencr.org,943,0.06%,2003,1060,47.08%
tunnel.cfw.trustedsource.org,942,0.06%,942,0,100.00%
h4.trakx.nibba.trade,939,0.06%,939,0,100.00%
firefox.settings.services.mozilla.com,924,0.06%,924,0,100.00%
2.openwrt.pool.ntp.org,917,0.06%,960,43,95.52%
caldav.163.com,914,0.06%,914,0,100.00%
s.360.cn,912,0.06%,912,0,100.00%
imap.gmail.com,907,0.06%,1105,198,82.08%
tracker4.itzmx.com,907,0.06%,1676,769,54.12%
clients4.google.com,892,0.06%,1038,146,85.93%
hub5pnc.sandai.net,890,0.06%,890,0,100.00%
proxy.client.163.com,890,0.06%,890,0,100.00%
www3.l.google.com,871,0.06%,899,28,96.89%
www.msftconnecttest.com,861,0.06%,872,11,98.74%
telemetry-in.battle.net,858,0.06%,858,0,100.00%
ping.avast.com,855,0.06%,1838,983,46.52%
tracker2.itzmx.com,851,0.06%,851,0,100.00%
az764295.vo.msecnd.net,849,0.06%,849,0,100.00%
1hkclu.pronetworklink.net,842,0.06%,842,0,100.00%
mail.bjtu.edu.cn,818,0.05%,818,0,100.00%
dsp.lenovo.com.cn,814,0.05%,814,0,100.00%
www.bitseduce.com,808,0.05%,808,0,100.00%
www.biztorrents.com,806,0.05%,806,0,100.00%
array808.prod.do.dsp.mp.microsoft.com,806,0.05%,806,0,100.00%
1min.pcfg.cache.wpscdn.cn,805,0.05%,805,0,100.00%
play.google.com,804,0.05%,997,193,80.64%
update.wps.cn,802,0.05%,802,0,100.00%
e6858.e19.s.tl88.net,801,0.05%,801,0,100.00%
allall02.baidupcs.com,795,0.05%,1607,812,49.47%
tracker1.itzmx.com,786,0.05%,786,0,100.00%
mirrors.nwafu.edu.cn,786,0.05%,786,0,100.00%
www.googleapis.com,785,0.05%,821,36,95.62%
registry-1.docker.io,783,0.05%,783,0,100.00%
vscode-sync.trafficmanager.net,783,0.05%,783,0,100.00%
dev.ditu.live.com,782,0.05%,782,0,100.00%
update2.sangfor.net,781,0.05%,781,0,100.00%
roaming.wps.cn,776,0.05%,776,0,100.00%
translate.google.com,774,0.05%,776,2,99.74%
api2.firefoxchina.cn.wswebpic.com,773,0.05%,773,0,100.00%
cip.cc,768,0.05%,768,0,100.00%
agt.p.qianxin.com,763,0.05%,763,0,100.00%
hpd.baidu.com,761,0.05%,761,0,100.00%
tsfe.trafficshaping.dsp.mp.microsoft.com,754,0.05%,754,0,100.00%
time.windows.com,753,0.05%,753,0,100.00%
i5.c.eset.com,753,0.05%,753,0,100.00%
socm.dmp.360.cn,752,0.05%,752,0,100.00%
o.andfx.cn,751,0.05%,751,0,100.00%
dcldshlupt.alicdn.com,749,0.05%,749,0,100.00%
account.wps.cn,748,0.05%,748,0,100.00%
isrc.iscas.ac.cn,746,0.05%,746,0,100.00%
ztxdjj-my.sharepoint.com,746,0.05%,746,0,100.00%
bp.335.wdpdk.link,744,0.05%,744,0,100.00%
atm-settingsfe-prod-geo2.trafficmanager.net,735,0.05%,735,0,100.00%
odoooacnz-my.sharepoint.com,733,0.05%,733,0,100.00%
api.apple-cloudkit.com,730,0.05%,730,0,100.00%
h5.do889.com,728,0.05%,728,0,100.00%
searchrecommend.kugou.com,724,0.05%,724,0,100.00%
hk1-7.nigirocloud.com,724,0.05%,724,0,100.00%
zw-roaming.wps.cn,711,0.05%,711,0,100.00%
ntp4.aliyun.com,709,0.05%,709,0,100.00%
translate.google.cn,703,0.05%,1383,680,50.83%
api.tabnine.com,702,0.05%,702,0,100.00%
update3.sangfor.net,702,0.05%,702,0,100.00%
chpm.sangfor.com.cn,700,0.05%,700,0,100.00%
apac-china-courier-4.push-apple.com.akadns.net,697,0.05%,697,0,100.00%
pc-plugin-plg.wpscdn.cn,696,0.05%,1525,829,45.64%
auth.docker.io,694,0.05%,694,0,100.00%
dw-online.ksosoft.com,684,0.05%,684,0,100.00%
softcenter-all.os.nfschina.com,676,0.04%,676,0,100.00%
ts2.qq.com,674,0.04%,674,0,100.00%
dc.services.visualstudio.com,673,0.04%,673,0,100.00%
u.zyinfotech.com,673,0.04%,673,0,100.00%
rs1.qq.com,670,0.04%,670,0,100.00%
drive.wps.cn,667,0.04%,2042,1375,32.66%
apphub.aliyuncs.com,663,0.04%,663,0,100.00%
global.asimov.events.data.trafficmanager.net,662,0.04%,676,14,97.93%
bam.nr-data.net,661,0.04%,661,0,100.00%
go.microsoft.com,661,0.04%,1476,815,44.78%
ocsp.digicert.com,659,0.04%,1241,582,53.10%
sg02.ipv2.xyz,658,0.04%,658,0,100.00%
us-west-las-5.openssl3.com,658,0.04%,658,0,100.00%
discovery-v4-1.verysync.cn,655,0.04%,655,0,100.00%
opencdnmsdl1.jomodns.com,648,0.04%,648,0,100.00%
d2nxq2uap88usk.cloudfront.net,647,0.04%,974,327,66.43%
load-balancing-system.cmy-dns.com,645,0.04%,645,0,100.00%
dd.browser.360.cn,644,0.04%,644,0,100.00%
docer.wps.cn,644,0.04%,644,0,100.00%
www.apple.com,642,0.04%,648,6,99.07%
v1.go2yd.com,641,0.04%,641,0,100.00%
normandy.cdn.mozilla.net,638,0.04%,638,0,100.00%
update.todesk.com,636,0.04%,636,0,100.00%
discovery-v4-3.verysync.cn,635,0.04%,635,0,100.00%
www.tg5tj2cu.com,634,0.04%,634,0,100.00%
www.microvirt.com,632,0.04%,632,0,100.00%
shdf01-iopq.cgroads.com,631,0.04%,631,0,100.00%
smtp.iscas.ac.cn,625,0.04%,625,0,100.00%
push.services.mozilla.com,621,0.04%,621,0,100.00%
assets.msn.com,621,0.04%,621,0,100.00%
prod.ingestion-edge.prod.dataops.mozgcp.net,618,0.04%,618,0,100.00%
content-signature-2.cdn.mozilla.net,618,0.04%,1308,690,47.25%
tracker.ccp.ovh,607,0.04%,607,0,100.00%
ts1.qq.com,605,0.04%,605,0,100.00%
home.wps.cn,605,0.04%,605,0,100.00%
rs2.qq.com,604,0.04%,604,0,100.00%
e13678.ca2.s.tl88.net,601,0.04%,601,0,100.00%
cn-hangzhou.axt.aliyun.com,598,0.04%,598,0,100.00%
vasapi.wps.cn,597,0.04%,597,0,100.00%
d9caa6e02c990b0a.jijifun.com,595,0.04%,595,0,100.00%
mobile.pipe.aria.microsoft.com,594,0.04%,671,77,88.52%
honeycomb.wpscdn.cn,592,0.04%,1133,541,52.25%
deault-exp-tas-com.e-0014.e-msedge.net,592,0.04%,1126,534,52.58%
mainnet.infura.io,589,0.04%,1033,444,57.02%
vip.wps.cn,587,0.04%,587,0,100.00%
api.kylinos.cn,583,0.04%,583,0,100.00%
access.video.qq.com,581,0.04%,581,0,100.00%
cn-qingdao.axt.aliyun.com,578,0.04%,578,0,100.00%
console.cloud.google.com,576,0.04%,576,0,100.00%
rq.wh.cmcm.com,573,0.04%,573,0,100.00%
rinkeby.infura.io,571,0.04%,571,0,100.00%
ioshost.qtlcdn.com,569,0.04%,1133,564,50.22%
cdn-file.ludashi.com,568,0.04%,568,0,100.00%
adashx.ut.dingtalk.com,564,0.04%,564,0,100.00%
www.kanjiantu.com,562,0.04%,562,0,100.00%
signalings.verysync.cn,556,0.04%,556,0,100.00%
cn-beijing.axt.aliyun.com,555,0.04%,555,0,100.00%
docer-api.kdocs.cn,553,0.04%,553,0,100.00%
hp3.mail.netease.com,552,0.04%,552,0,100.00%
pay.wps.cn,550,0.04%,550,0,100.00%
notice.wps.cn,550,0.04%,550,0,100.00%
api.zotero.org,546,0.04%,546,0,100.00%
docer.kdocs.cn,545,0.04%,545,0,100.00%
le.wps.cn,544,0.04%,544,0,100.00%
cmrelay-basic-2.nodesub.com,540,0.04%,540,0,100.00%
lucky.wps.cn,528,0.03%,528,0,100.00%
avatar.qwps.cn,527,0.03%,527,0,100.00%
qr.wps.cn,525,0.03%,525,0,100.00%
download.visualstudio.microsoft.com,522,0.03%,522,0,100.00%
iplc-ji.mielink-dns2.com,521,0.03%,521,0,100.00%
zlxx.v.lxcvc.com,520,0.03%,1025,505,50.73%
123.sogou.com,520,0.03%,520,0,100.00%
auth.sangfor.com.cn,520,0.03%,520,0,100.00%
geo.wps.cn,520,0.03%,520,0,100.00%
repo.huaweicloud.com,519,0.03%,519,0,100.00%
ios.ac.cn,519,0.03%,519,0,100.00%
sms.wps.cn,518,0.03%,518,0,100.00%
discovery-v4-2.verysync.cn,518,0.03%,518,0,100.00%
puv.tt.browser.360.cn,517,0.03%,517,0,100.00%
db-safe.2345.cc,517,0.03%,517,0,100.00%
1-courier.push.apple.com,515,0.03%,515,0,100.00%
iaas.wps.cn,514,0.03%,514,0,100.00%
todolist.redirect.xzdesktop.cqttech.com,512,0.03%,512,0,100.00%
hsk-api.oray.com,511,0.03%,511,0,100.00%
dc1.ksn.kaspersky-labs.com,508,0.03%,508,0,100.00%
vamd.cnode.xyz,505,0.03%,505,0,100.00%
discovery-v4.verysync.cn,502,0.03%,502,0,100.00%
bugly.qq.com,501,0.03%,501,0,100.00%
1-courier.sandbox.push.apple.com,496,0.03%,496,0,100.00%
gateway.fe.apple-dns.net,489,0.03%,983,494,49.75%
catalog.gamepass.com,489,0.03%,1057,568,46.26%
zj-roaming.wps.cn,487,0.03%,487,0,100.00%
pub.idqqimg.com,486,0.03%,1205,719,40.33%
tr.cili001.com,482,0.03%,482,0,100.00%
msg.qy.net,480,0.03%,480,0,100.00%
helpdubaclient.ksmobile.com,480,0.03%,480,0,100.00%
zt.wps.cn,479,0.03%,479,0,100.00%
cdn.packages.deepin.com,477,0.03%,477,0,100.00%
download.windowsupdate.com,476,0.03%,507,31,93.89%
rub.myddns.cyou,476,0.03%,476,0,100.00%
go.ie.sogou.com,471,0.03%,471,0,100.00%
client.dropbox.com,471,0.03%,984,513,47.87%
search.apps.ubuntu.com,470,0.03%,470,0,100.00%
tracker.1337x.org,470,0.03%,9584,9114,4.90%
wdl1.cache.wps.cn,470,0.03%,774,304,60.72%
licensing.mp.microsoft.com,469,0.03%,469,0,100.00%
g.api.mega.co.nz,468,0.03%,1960,1492,23.88%
cn-hongkong.axt.aliyun.com,466,0.03%,466,0,100.00%
tracker.files.fm,465,0.03%,465,0,100.00%
pr.x.hub.sandai.net,465,0.03%,465,0,100.00%
drive.wpsdns.com,463,0.03%,968,505,47.83%
poll.exmail.qq.com,463,0.03%,463,0,100.00%
service.account.weibo.com,463,0.03%,463,0,100.00%
hotfix.lenovo.com.cn,457,0.03%,457,0,100.00%
p0.qhimg.com,456,0.03%,568,112,80.28%
res.wx.qq.com,454,0.03%,515,61,88.16%
c.go-mpulse.net,454,0.03%,990,536,45.86%
comet.jianguoyun.com,454,0.03%,454,0,100.00%
goldengate.grammarly.com,448,0.03%,448,0,100.00%
login.microsoftonline.com,448,0.03%,448,0,100.00%
jtypkz2w.sched.d2.tdnsdp1.cn,448,0.03%,448,0,100.00%
odobagg-my.sharepoint.com,446,0.03%,446,0,100.00%
www.sohu.com,446,0.03%,1011,565,44.11%
shcuac.aag436.ccddns.lol,444,0.03%,444,0,100.00%
zhidao.baidu.com,439,0.03%,826,387,53.15%
mail.google.com,438,0.03%,953,515,45.96%
passport.weibo.com,437,0.03%,437,0,100.00%
vm.gtimg.cn,424,0.03%,522,98,81.23%
yd-02.paofunlink.com,422,0.03%,422,0,100.00%
us-sandbox-courier-4.push-apple.com.akadns.net,419,0.03%,419,0,100.00%
hm.baidu.com,418,0.03%,996,578,41.97%
1.courier-push-apple.com.akadns.net,417,0.03%,417,0,100.00%
thetracker.org,417,0.03%,417,0,100.00%
high-frequency-gray.zhhainiao.com,415,0.03%,415,0,100.00%
api.apple-cloudkit.fe.apple-dns.net,414,0.03%,414,0,100.00%
honeycomb.wps.cn,413,0.03%,413,0,100.00%
mubu.com,413,0.03%,413,0,100.00%
9.rarbg.me,413,0.03%,413,0,100.00%
cstestarea.leagsoft.net,413,0.03%,413,0,100.00%
zephir.monocul.us,411,0.03%,411,0,100.00%
9.rarbg.to,411,0.03%,411,0,100.00%
ksn-file-geo.kaspersky-labs.com,410,0.03%,410,0,100.00%
dlied6.qq.com,409,0.03%,409,0,100.00%
update100.sangfor.com.cn,408,0.03%,779,371,52.37%
infoc2.duba.net,406,0.03%,406,0,100.00%
apple.com,406,0.03%,406,0,100.00%
safebrowsing.urlsec.qq.com,405,0.03%,405,0,100.00%
sadownload.mcafee.com,403,0.03%,403,0,100.00%
tracker.zerobytes.xyz,403,0.03%,403,0,100.00%
br.666.mapow.link,402,0.03%,402,0,100.00%
mail.163.com,400,0.03%,400,0,100.00%
sf.symcb.com,398,0.03%,694,296,57.35%
ib.sin1.geoadnxs.com,396,0.03%,396,0,100.00%
tm-sdk.platinumai.net,395,0.03%,395,0,100.00%
loki.ams.eulix.xyz,394,0.03%,394,0,100.00%
api.mathpix.com,393,0.03%,393,0,100.00%
pagead2.googlesyndication.com,391,0.03%,417,26,93.76%
crl.verisign.com,390,0.03%,705,315,55.32%
browser6.qhimg.com,387,0.03%,412,25,93.93%
cache.tv.qq.com,385,0.03%,472,87,81.57%
admin.kdsec.org,384,0.03%,384,0,100.00%
softcenter.os3.win.nfschina.com,383,0.03%,383,0,100.00%
usercount.dockernb.com,381,0.03%,381,0,100.00%
opentor.org,381,0.03%,719,338,52.99%
adashx.m.taobao.com,380,0.03%,380,0,100.00%
push.hicloud.com,379,0.02%,379,0,100.00%
7a37563370ded05f.jijifun.com,379,0.02%,379,0,100.00%
googlecode.l.googleusercontent.com,374,0.02%,725,351,51.59%
app.huabao.360.cn,373,0.02%,705,332,52.91%
msgsrv01.oray.net,373,0.02%,373,0,100.00%
accscdn.m.taobao.com,372,0.02%,372,0,100.00%
fs.microsoft.com,372,0.02%,372,0,100.00%
api.msn.com,371,0.02%,676,305,54.88%
free.publictracker.xyz,369,0.02%,369,0,100.00%
edu.uifr.ru,368,0.02%,368,0,100.00%
code.osssc.ac.cn,367,0.02%,367,0,100.00%
developer.unity.cn,366,0.02%,366,0,100.00%
init.push.apple.com,366,0.02%,723,357,50.62%
tracker.v6speed.org,366,0.02%,366,0,100.00%
interface.music.163.com,362,0.02%,363,1,99.72%
valakas.rollo.dnsabr.com,362,0.02%,362,0,100.00%
evalai.cn,361,0.02%,361,0,100.00%
tracker0.ufibox.com,360,0.02%,360,0,100.00%
bt.nfshost.com,359,0.02%,359,0,100.00%
hectorstatic.baidu.com,358,0.02%,473,115,75.69%
s.f.360.cn,358,0.02%,626,268,57.19%
fonts.googleapis.com,358,0.02%,370,12,96.76%
newtoncity.org,357,0.02%,357,0,100.00%
tracker.uw0.xyz,357,0.02%,357,0,100.00%
udp-tracker.shittyurl.org,357,0.02%,357,0,100.00%
1595096.sched.d0-dk.tdnsdp1.cn,356,0.02%,729,373,48.83%
skydrive.wns.windows.com,356,0.02%,657,301,54.19%
torrentclub.online,355,0.02%,355,0,100.00%
vibe.community,355,0.02%,355,0,100.00%
dss0.bdstatic.com,352,0.02%,360,8,97.78%
engplus.ru,352,0.02%,352,0,100.00%
torrentsmd.com,352,0.02%,352,0,100.00%
ryrc.ruijienetworks.com,351,0.02%,351,0,100.00%
sp1.sangfor.com.cn,351,0.02%,351,0,100.00%
mail.realliferpg.de,351,0.02%,351,0,100.00%
ts1.cn.mm.bing.net,348,0.02%,348,0,100.00%
update1.sangfor.net.cdn20.com,347,0.02%,347,0,100.00%
crl4.digicert.com,345,0.02%,621,276,55.56%
tracker.shkinev.me,345,0.02%,345,0,100.00%
mobile.events.data.trafficmanager.net,343,0.02%,379,36,90.50%
detectportal.firefox.com,341,0.02%,22983,22642,1.48%
www.jetbrains.com,341,0.02%,782,441,43.61%
googleads.g.doubleclick.net,340,0.02%,357,17,95.24%
substrate.office.com,340,0.02%,756,416,44.97%
ocsp2-lb.apple.com.akadns.net,337,0.02%,374,37,90.11%
roaming.officeapps.live.com,336,0.02%,336,0,100.00%
papi.funshion.com,336,0.02%,336,0,100.00%
e11290.dspg.akamaiedge.net,336,0.02%,688,352,48.84%
ic.wps.cn,336,0.02%,336,0,100.00%
autopush.prod.mozaws.net,336,0.02%,336,0,100.00%
account.jetbrains.com,335,0.02%,335,0,100.00%
static.asm.skype.com,333,0.02%,333,0,100.00%
www.gsd92gov.com,333,0.02%,333,0,100.00%
d.pcs.baidu.com,332,0.02%,690,358,48.12%
targetednotifications-tm.trafficmanager.net,332,0.02%,332,0,100.00%
officeclient.microsoft.com,331,0.02%,331,0,100.00%
imap.sina.com,330,0.02%,330,0,100.00%
notify.tabnine.com,330,0.02%,330,0,100.00%
ts2.cn.mm.bing.net,329,0.02%,329,0,100.00%
mathpix.com,329,0.02%,642,313,51.25%
mirrors.163.com,329,0.02%,329,0,100.00%
fanghu.qianxin.com,329,0.02%,329,0,100.00%
client-api.oray.com,328,0.02%,328,0,100.00%
v4.tiamato.com,327,0.02%,327,0,100.00%
cu005.www.duba.net,326,0.02%,326,0,100.00%
tracker.bt4g.com,325,0.02%,904,579,35.95%
shcu1.myddns.cyou,325,0.02%,325,0,100.00%
kv501.prod.do.dsp.mp.microsoft.com,324,0.02%,324,0,100.00%
classify-client.services.mozilla.com,324,0.02%,324,0,100.00%
gtm-sg-6wr2n62gk0f.gtm-i1d1.com,323,0.02%,323,0,100.00%
trakx.herokuapp.com,323,0.02%,323,0,100.00%
filetracker.xyz,322,0.02%,789,467,40.81%
outlook.office365.com,322,0.02%,705,383,45.67%
time1.apple.com,322,0.02%,322,0,100.00%
pss.bdstatic.com,321,0.02%,425,104,75.53%
uapi.mp.360.cn,320,0.02%,320,0,100.00%
gateway.icloud.com.cn,320,0.02%,320,0,100.00%
img-xlppc-zhan.xunlei.com,319,0.02%,734,415,43.46%
api.ultimaker.com,318,0.02%,318,0,100.00%
hk1-1.nigirocloud.com,318,0.02%,318,0,100.00%
tracker.trackerfix.com,318,0.02%,318,0,100.00%
2.cn.pool.ntp.org,317,0.02%,362,45,87.57%
wu-bg-shim.trafficmanager.net,316,0.02%,316,0,100.00%
nleditor.osi.office.net,315,0.02%,315,0,100.00%
tconf.b.qianxin.com,313,0.02%,313,0,100.00%
img.alicdn.com.danuoyi.alicdn.com,313,0.02%,638,325,49.06%
download.docker.com,313,0.02%,409,96,76.53%
api.atlassian.com,311,0.02%,311,0,100.00%
f062936a96d3c8bd.jijifun.com,311,0.02%,311,0,100.00%
download.windowsupdate.com.a.bdydns.com,310,0.02%,310,0,100.00%
de2-4.nigirocloud.com,309,0.02%,309,0,100.00%
shavar.services.mozilla.com,309,0.02%,309,0,100.00%
df.cache.wpscdn.cn,308,0.02%,501,193,61.48%
wp.mail.qq.com,308,0.02%,308,0,100.00%
www.xilinx.com,307,0.02%,307,0,100.00%
datarouter.ol.epicgames.com,307,0.02%,307,0,100.00%
ns-eh2-prod-dm2-511.cloudapp.net,306,0.02%,306,0,100.00%
video-hw-drcn.dbankcdn.cn,305,0.02%,686,381,44.46%
pico.eset.com,305,0.02%,305,0,100.00%
tracker.nitrix.me,304,0.02%,623,319,48.80%
cloud.streamsets.com,303,0.02%,303,0,100.00%
www.163.com,302,0.02%,775,473,38.97%
array606.prod.do.dsp.mp.microsoft.com,302,0.02%,302,0,100.00%
webquotepic.eastmoney.com,301,0.02%,301,0,100.00%
init.push-apple.com.akadns.net,300,0.02%,655,355,45.80%
www.deepl.com,299,0.02%,299,0,100.00%
tlu.dl.delivery.mp.microsoft.com.w.alikunlun.com,297,0.02%,297,0,100.00%
q.cnblogs.com,296,0.02%,296,0,100.00%
remind.api.weibo.com,296,0.02%,569,273,52.02%
2535-ipv4e.clump.dprodmgd106.aa-rt.sharepoint.com,296,0.02%,296,0,100.00%
updates.os.nfschina.com,296,0.02%,296,0,100.00%
oth.eve.mdt.qq.com,295,0.02%,295,0,100.00%
ds.kaspersky.com,295,0.02%,295,0,100.00%
web-drcn.hispace.dbankcloud.cn,295,0.02%,295,0,100.00%
pki-goog.l.google.com,294,0.02%,335,41,87.76%
sp1.baidu.com,293,0.02%,541,248,54.16%
dl.google.com,293,0.02%,310,17,94.52%
geo.prod.do.dsp.mp.microsoft.com,292,0.02%,299,7,97.66%
p1.ssl.qhimg.com,291,0.02%,301,10,96.68%
dss1.bdstatic.com,288,0.02%,293,5,98.29%
hk1-8.nigirocloud.com,288,0.02%,288,0,100.00%
s.xinshuru.com,288,0.02%,288,0,100.00%
rm.api.weibo.com,287,0.02%,515,228,55.73%
miserupdate.aliyun.com,286,0.02%,286,0,100.00%
client.teamviewer.com,285,0.02%,285,0,100.00%
api-std.sunlogin.oray.com,284,0.02%,284,0,100.00%
task.browser.360.cn,283,0.02%,283,0,100.00%
array513.prod.do.dsp.mp.microsoft.com,282,0.02%,556,274,50.72%
www.google.com.hk,281,0.02%,534,253,52.62%
visualstudio-devdiv-c2s-msedge-net.e-0009.e-msedge.net,280,0.02%,280,0,100.00%
www.m9ynqi6d.com,280,0.02%,280,0,100.00%
msedge.api.cdp.microsoft.com,279,0.02%,614,335,45.44%
usa.cloudv2a.com,279,0.02%,279,0,100.00%
mcs-bd.feishu.cn,278,0.02%,278,0,100.00%
clients.l.google.com,278,0.02%,384,106,72.40%
tracker.hama3.net,278,0.02%,561,283,49.55%
help-tower.2345.cc,277,0.02%,277,0,100.00%
filedownload.lenovo.com,275,0.02%,275,0,100.00%
ai1.acciff.com,275,0.02%,275,0,100.00%
ug.baidu.com,274,0.02%,488,214,56.15%
changer8.net,274,0.02%,274,0,100.00%
nk1.boom.skin,273,0.02%,273,0,100.00%
ue.lenovomm.cn,270,0.02%,270,0,100.00%
tracker.coalition.space,270,0.02%,519,249,52.02%
cs9.wac.phicdn.net,269,0.02%,629,360,42.77%
update.code.visualstudio.com,267,0.02%,267,0,100.00%
fm.dl.126.net,267,0.02%,267,0,100.00%
shmmsns.qpic.cn,266,0.02%,662,396,40.18%
mail.nfschina.com,266,0.02%,266,0,100.00%
tlu.dl.delivery.mp.microsoft.com,266,0.02%,274,8,97.08%
gecko-bd.feishu.cn,265,0.02%,265,0,100.00%
ins-mfa9hirw.ias.tencent-cloud.net,265,0.02%,265,0,100.00%
hk1-5.nigirocloud.com,264,0.02%,264,0,100.00%
t-safe.2345.cc,264,0.02%,264,0,100.00%
runc.myddns.cyou,263,0.02%,263,0,100.00%
us1-2.nigirocloud.com,262,0.02%,262,0,100.00%
k128-mzstatic.gslb.ksyuncdn.com,262,0.02%,262,0,100.00%
softbus-device.wps.cn,262,0.02%,262,0,100.00%
api2.firefoxchina.cn,262,0.02%,262,0,100.00%
vhyifw.top,262,0.02%,262,0,100.00%
ime.sogou.com,261,0.02%,261,0,100.00%
flbgpi.meiquankongjian.com,260,0.02%,260,0,100.00%
nowpick.nowcoder.com,260,0.02%,260,0,100.00%
ck-groups.xyz,260,0.02%,260,0,100.00%
client-office365-tas.msedge.net,258,0.02%,258,0,100.00%
dyn.wps.cn,256,0.02%,256,0,100.00%
hk1-4.nigirocloud.com,256,0.02%,256,0,100.00%
c2.pcs.baidu.com,255,0.02%,469,214,54.37%
l2.hiwifi.com,253,0.02%,253,0,100.00%
ocsp.entrust.net,252,0.02%,559,307,45.08%
mcs-bd.feishu.cn.w.cdngslb.com,252,0.02%,252,0,100.00%
ins-g4ztq7u7.ias.tencent-cloud.net,252,0.02%,252,0,100.00%
upos-sz-mirrorali.bilivideo.com,252,0.02%,252,0,100.00%
r4.res.office365.com,252,0.02%,544,292,46.32%
array607.prod.do.dsp.mp.microsoft.com,251,0.02%,251,0,100.00%
rum.h5.weibo.cn,251,0.02%,251,0,100.00%
imap-mail.outlook.com,250,0.02%,528,278,47.35%
de2-1.nigirocloud.com,250,0.02%,250,0,100.00%
developer.atlassian.com,250,0.02%,250,0,100.00%
ty2-6.nigirocloud.com,249,0.02%,249,0,100.00%
zconfig.alibabausercontent.com,249,0.02%,546,297,45.60%
pos.baidu.com,248,0.02%,248,0,100.00%
array802.prod.do.dsp.mp.microsoft.com,248,0.02%,248,0,100.00%
api.onedrive.com,248,0.02%,390,142,63.59%
st.todesk.com,247,0.02%,247,0,100.00%
gameplay.intel.com,247,0.02%,509,262,48.53%
push2.eastmoney.com,247,0.02%,456,209,54.17%
au1-3.nigirocloud.com,247,0.02%,247,0,100.00%
ee1-1.nigirocloud.com,247,0.02%,247,0,100.00%
pgdt.gtimg.cn,247,0.02%,420,173,58.81%
cdn.fwupd.org,246,0.02%,246,0,100.00%
is.iscas.ac.cn,246,0.02%,246,0,100.00%
tuna02.mcddns01.com,246,0.02%,246,0,100.00%
webquotestaticpic.dfcfw.com,245,0.02%,245,0,100.00%
sp0.baidu.com,244,0.02%,428,184,57.01%
stream.zotero.org,244,0.02%,459,215,53.16%
us2-4.nigirocloud.com,243,0.02%,243,0,100.00%
au1-1.nigirocloud.com,243,0.02%,243,0,100.00%
us1-1.nigirocloud.com,243,0.02%,243,0,100.00%
us2-3.nigirocloud.com,243,0.02%,243,0,100.00%
hk1-6.nigirocloud.com,242,0.02%,242,0,100.00%
au2-4.nigirocloud.com,242,0.02%,242,0,100.00%
a.w.bilicdn1.com,242,0.02%,317,75,76.34%
ty1-4.nigirocloud.com,241,0.02%,241,0,100.00%
imap.cstnet.cn,241,0.02%,241,0,100.00%
us3-3.nigirocloud.com,240,0.02%,240,0,100.00%
au1-2.nigirocloud.com,240,0.02%,240,0,100.00%
de1-2.nigirocloud.com,240,0.02%,240,0,100.00%
de1-3.nigirocloud.com,240,0.02%,240,0,100.00%
de2-3.nigirocloud.com,240,0.02%,240,0,100.00%
os2-2.nigirocloud.com,240,0.02%,240,0,100.00%
weather-data.apple.com,240,0.02%,470,230,51.06%
gateway.bitrenren.com,240,0.02%,515,275,46.60%
csdnimg.cn,240,0.02%,240,0,100.00%
os1-5.nigirocloud.com,240,0.02%,240,0,100.00%
array806.prod.do.dsp.mp.microsoft.com,239,0.02%,239,0,100.00%
us3-7.nigirocloud.com,239,0.02%,239,0,100.00%
au2-2.nigirocloud.com,239,0.02%,239,0,100.00%
ee1-3.nigirocloud.com,239,0.02%,239,0,100.00%
ty2-3.nigirocloud.com,239,0.02%,239,0,100.00%
nl3-2.nigirocloud.com,239,0.02%,239,0,100.00%
www.tm.a.prd.aadg.trafficmanager.net,239,0.02%,239,0,100.00%
www.msn.cn,238,0.02%,255,17,93.33%
us3-6.nigirocloud.com,238,0.02%,238,0,100.00%
ty2-4.nigirocloud.com,238,0.02%,238,0,100.00%
os1-3.nigirocloud.com,238,0.02%,238,0,100.00%
t-safe.2345.com,237,0.02%,237,0,100.00%
ssl.gstatic.com,237,0.02%,679,442,34.90%
nl1-1.nigirocloud.com,237,0.02%,237,0,100.00%
ee1-4.nigirocloud.com,237,0.02%,237,0,100.00%
nl1-5.nigirocloud.com,237,0.02%,237,0,100.00%
vdwmto3.bdstatic.com,237,0.02%,395,158,60.00%
nl1-7.nigirocloud.com,237,0.02%,237,0,100.00%
qbwup.imtt.qq.com,237,0.02%,237,0,100.00%
us3-2.nigirocloud.com,236,0.02%,236,0,100.00%
au2-1.nigirocloud.com,236,0.02%,236,0,100.00%
os1-6.nigirocloud.com,236,0.02%,236,0,100.00%
ty1-1.nigirocloud.com,236,0.02%,236,0,100.00%
internal-api-lark-api.feishu.cn,235,0.02%,235,0,100.00%
nl1-2.nigirocloud.com,234,0.02%,234,0,100.00%
us3-1.nigirocloud.com,234,0.02%,234,0,100.00%
us3-4.nigirocloud.com,234,0.02%,234,0,100.00%
os1-7.nigirocloud.com,234,0.02%,234,0,100.00%
nl1-6.nigirocloud.com,234,0.02%,234,0,100.00%
securetoken.googleapis.com,234,0.02%,246,12,95.12%
adservice.google.com,233,0.02%,256,23,91.02%
us3-8.nigirocloud.com,233,0.02%,233,0,100.00%
ty1-2.nigirocloud.com,233,0.02%,233,0,100.00%
nl1-8.nigirocloud.com,233,0.02%,233,0,100.00%
nl3-6.nigirocloud.com,233,0.02%,233,0,100.00%
device.sangfor.com.cn,233,0.02%,233,0,100.00%
o.lencr.edgesuite.net,233,0.02%,235,2,99.15%
mail.iie.ac.cn,232,0.02%,423,191,54.85%
mumu.nie.netease.com,232,0.02%,421,189,55.11%
5kong4.com,232,0.02%,232,0,100.00%
t8.baidu.com,231,0.02%,293,62,78.84%
ipv6.l.google.com,231,0.02%,539,308,42.86%
service.fanxing.kugou.com,231,0.02%,481,250,48.02%
ee1-2.nigirocloud.com,231,0.02%,231,0,100.00%
us1-4.nigirocloud.com,231,0.02%,231,0,100.00%
kv601.prod.do.dsp.mp.microsoft.com,231,0.02%,231,0,100.00%
au1-4.nigirocloud.com,231,0.02%,231,0,100.00%
uk1-4.nigirocloud.com,231,0.02%,231,0,100.00%
us2-2.nigirocloud.com,230,0.02%,230,0,100.00%
os2-5.nigirocloud.com,230,0.02%,230,0,100.00%
os2-6.nigirocloud.com,230,0.02%,230,0,100.00%
uk1-2.nigirocloud.com,230,0.02%,230,0,100.00%
gcr.io,230,0.02%,431,201,53.36%
msedge.b.tlu.dl.delivery.mp.microsoft.com,229,0.02%,230,1,99.57%
tracker.moeblog.cn,229,0.02%,536,307,42.72%
de1-1.nigirocloud.com,229,0.02%,229,0,100.00%
nl3-1.nigirocloud.com,229,0.02%,229,0,100.00%
us3-5.nigirocloud.com,228,0.02%,228,0,100.00%
hk1-2.nigirocloud.com,228,0.02%,228,0,100.00%
ty2-2.nigirocloud.com,228,0.02%,228,0,100.00%
os2-3.nigirocloud.com,228,0.02%,228,0,100.00%
de1-4.nigirocloud.com,227,0.01%,227,0,100.00%
mccontacts.mail.163.com,227,0.01%,227,0,100.00%
blades.aliyun.com,227,0.01%,227,0,100.00%
os2-8.nigirocloud.com,226,0.01%,226,0,100.00%
aapl-maps.qtlcdn.com,226,0.01%,436,210,51.83%
outlook.ha.office365.com,226,0.01%,463,237,48.81%
au2-3.nigirocloud.com,226,0.01%,226,0,100.00%
uz95.v.trpcdn.net,226,0.01%,226,0,100.00%
api.bilibili.com,225,0.01%,271,46,83.03%
gimg3.baidu.com,225,0.01%,286,61,78.67%
de2-2.nigirocloud.com,225,0.01%,225,0,100.00%
os2-1.nigirocloud.com,225,0.01%,225,0,100.00%
nl1-3.nigirocloud.com,225,0.01%,225,0,100.00%
os1-4.nigirocloud.com,225,0.01%,225,0,100.00%
t.helper.2345.cc,225,0.01%,225,0,100.00%
ins-qw3q8ofk.ias.tencent-cloud.net,225,0.01%,225,0,100.00%
lax.link.ac.cn,225,0.01%,225,0,100.00%
normandy-cdn.services.mozilla.com,224,0.01%,224,0,100.00%
ty2-1.nigirocloud.com,224,0.01%,224,0,100.00%
ty2-8.nigirocloud.com,224,0.01%,224,0,100.00%
ty2-5.nigirocloud.com,224,0.01%,224,0,100.00%
nl3-7.nigirocloud.com,224,0.01%,224,0,100.00%
t7.baidu.com,223,0.01%,300,77,74.33%
api.geetest.com,223,0.01%,223,0,100.00%
gateway.fe.apple-dns.cn,223,0.01%,223,0,100.00%
us2-1.nigirocloud.com,223,0.01%,223,0,100.00%
hk1-3.nigirocloud.com,223,0.01%,223,0,100.00%
us1-3.nigirocloud.com,223,0.01%,223,0,100.00%
os1-8.nigirocloud.com,223,0.01%,223,0,100.00%
help.origin-apple.com.akadns.net,223,0.01%,223,0,100.00%
nl3-8.nigirocloud.com,223,0.01%,223,0,100.00%
smartscreen-prod.microsoft.com,223,0.01%,223,0,100.00%
vv.video.qq.com,223,0.01%,223,0,100.00%
emoji.qpic.cn,222,0.01%,264,42,84.09%
g.live.com,222,0.01%,404,182,54.95%
bt2.archive.org,222,0.01%,447,225,49.66%
ntp.aliyun.com,222,0.01%,222,0,100.00%
t.undefined-site.top,222,0.01%,222,0,100.00%
cmrelay-basic-1.nodesub.com,222,0.01%,222,0,100.00%
advanced-cm-1.nodesub.com,222,0.01%,222,0,100.00%
alpha-cloud-log.cn-hangzhou.log.aliyuncs.com,221,0.01%,221,0,100.00%
config.i.duba.net,221,0.01%,221,0,100.00%
bsg.w.bilicdn1.com,221,0.01%,221,0,100.00%
uk1-1.nigirocloud.com,221,0.01%,221,0,100.00%
aus5.mozilla.org,221,0.01%,221,0,100.00%
c9b086079795c442.jijifun.com,221,0.01%,221,0,100.00%
tls-eleme.dingtalk.com,221,0.01%,221,0,100.00%
yqy2356.melissauvc.com,221,0.01%,221,0,100.00%
transit1.wslog.chinanetcenter.com,219,0.01%,219,0,100.00%
glacial-ravine-7295.morning-tundra-7160.herokuspace.com,219,0.01%,219,0,100.00%
app.jianguoyun.com,219,0.01%,219,0,100.00%
nl3-5.nigirocloud.com,219,0.01%,219,0,100.00%
message.bilibili.com,219,0.01%,351,132,62.39%
g.csdnimg.cn,218,0.01%,218,0,100.00%
os2-7.nigirocloud.com,218,0.01%,218,0,100.00%
uk1-3.nigirocloud.com,218,0.01%,218,0,100.00%
nl3-4.nigirocloud.com,217,0.01%,217,0,100.00%
max-l.mediav.com,217,0.01%,217,0,100.00%
advanced-cm-2.nodesub.com,217,0.01%,217,0,100.00%
prod.nexusrules.live.com.akadns.net,216,0.01%,428,212,50.47%
nl3-3.nigirocloud.com,216,0.01%,216,0,100.00%
api.github.com,215,0.01%,215,0,100.00%
ty2-7.nigirocloud.com,215,0.01%,215,0,100.00%
os1-1.nigirocloud.com,215,0.01%,215,0,100.00%
outlook.gogo66.cloud,215,0.01%,414,199,51.93%
functional.events.data.microsoft.com,214,0.01%,235,21,91.06%
os2-4.nigirocloud.com,214,0.01%,214,0,100.00%
pc-plugin.wpscdn.cn,213,0.01%,213,0,100.00%
2.debian.pool.ntp.org,213,0.01%,346,133,61.56%
os1-2.nigirocloud.com,213,0.01%,213,0,100.00%
cn-shenzhen.axt.aliyun.com,213,0.01%,213,0,100.00%
www.sogou.com,212,0.01%,212,0,100.00%
arc.trafficmanager.net,212,0.01%,212,0,100.00%
beacons2.gvt2.com,212,0.01%,221,9,95.93%
dl.qianxin.com,212,0.01%,212,0,100.00%
prod-classifyclient.normandy.prod.cloudops.mozgcp.net,211,0.01%,211,0,100.00%
pss.alicdn.com,211,0.01%,211,0,100.00%
bugreport.huorong.cn,211,0.01%,633,422,33.33%
account.sogou.com,211,0.01%,211,0,100.00%
sqm.telemetry.microsoft.com,211,0.01%,211,0,100.00%
api.docer.wpscdn.cn,211,0.01%,436,225,48.39%
vpn.oceanum.cn,211,0.01%,211,0,100.00%
nk5.boom.skin,210,0.01%,210,0,100.00%
yd-01.paofunlink.com,210,0.01%,210,0,100.00%
api.im.qcloud.com,210,0.01%,210,0,100.00%
vscode-sync-ase-01.azurewebsites.net,210,0.01%,210,0,100.00%
na61-na62.wagbridge.alibaba.alibaba.com,210,0.01%,390,180,53.85%
tt.browser.360.cn,208,0.01%,208,0,100.00%
packages.microsoft.com,207,0.01%,207,0,100.00%
vpn.ios.ac.cn,207,0.01%,207,0,100.00%
appsso.oh.isrc.ac.cn,206,0.01%,206,0,100.00%
ty1-3.nigirocloud.com,206,0.01%,206,0,100.00%
downloads.upd.kaspersky.com,206,0.01%,206,0,100.00%
array511.prod.do.dsp.mp.microsoft.com,206,0.01%,206,0,100.00%
e4518.dscapi7.akamaiedge.net,204,0.01%,406,202,50.25%
array506.prod.do.dsp.mp.microsoft.com,204,0.01%,392,188,52.04%
dashenga.com,204,0.01%,204,0,100.00%
evoke-windowsservices-tas.msedge.net,204,0.01%,204,0,100.00%
upload.fp.measure.office.com,204,0.01%,367,163,55.59%
clients6.google.com,204,0.01%,241,37,84.65%
ogf.gaoliang.im,204,0.01%,204,0,100.00%
www.wshifen.com,203,0.01%,203,0,100.00%
tracker1.myporn.club,203,0.01%,311,108,65.27%
bt1.archive.org,203,0.01%,411,208,49.39%
submit.sb.avast.com,203,0.01%,203,0,100.00%
t9.baidu.com,202,0.01%,270,68,74.81%
qdyn.wps.cn,202,0.01%,202,0,100.00%
ocsp2.apple.com,202,0.01%,231,29,87.45%
6fe97759aa27a0c9.jijifun.com,202,0.01%,202,0,100.00%
deepl.com,202,0.01%,202,0,100.00%
update.cs2c.com.cn,201,0.01%,201,0,100.00%
tracker.bitsearch.to,201,0.01%,315,114,63.81%
e-0009.e-msedge.net,201,0.01%,201,0,100.00%
newtab.firefoxchina.cn,201,0.01%,371,170,54.18%
docs.google.com,200,0.01%,393,193,50.89%
nl1-4.nigirocloud.com,200,0.01%,200,0,100.00%
mbsug.ssl.so.com,200,0.01%,200,0,100.00%
tracker.pussytorrents.org,199,0.01%,312,113,63.78%
cc-api-data.adobe.io,199,0.01%,199,0,100.00%
wss.im.qcloud.com,199,0.01%,199,0,100.00%
rm-2zelg248g7y2034w7do.mysql.rds.aliyuncs.com,198,0.01%,198,0,100.00%
www.googletagmanager.com,198,0.01%,208,10,95.19%
tw02.ipv2.xyz,198,0.01%,198,0,100.00%
webrtcpunch.video.qq.com,197,0.01%,197,0,100.00%
info.lenovo.com.cn,197,0.01%,197,0,100.00%
dig.bdurl.net,197,0.01%,197,0,100.00%
t.khd.2345.cc,195,0.01%,195,0,100.00%
seapp.stat.360safe.com,195,0.01%,195,0,100.00%
all.feishu.cn.w.kunluncan.com,195,0.01%,195,0,100.00%
tpc.googlesyndication.com,194,0.01%,215,21,90.23%
connect.unity.cn,194,0.01%,194,0,100.00%
cloud-rest.lenovomm.com,194,0.01%,194,0,100.00%
fb98ab9159f51fd0.jijifun.com,194,0.01%,194,0,100.00%
fonts.gstatic.com,194,0.01%,197,3,98.48%
ncc.avast.com,193,0.01%,410,217,47.07%
pcfg.wps.cn,193,0.01%,193,0,100.00%
ocsp.pki.goog,193,0.01%,214,21,90.19%
tp.m-team.cc,192,0.01%,424,232,45.28%
video.yidianzixun.com,192,0.01%,192,0,100.00%
gates.grammarly.com,191,0.01%,191,0,100.00%
dl.pop.www.duba.net,191,0.01%,191,0,100.00%
edge.ivideo.sina.com.cn,190,0.01%,457,267,41.58%
self-events-data.trafficmanager.net,190,0.01%,222,32,85.59%
www.bilibili.com,188,0.01%,224,36,83.93%
miao.baidu.com,188,0.01%,188,0,100.00%
mbd.baidu.com,188,0.01%,188,0,100.00%
orange-pcsafe.2345.cc,188,0.01%,188,0,100.00%
video-tx-drcn.dbankcdn.cn,188,0.01%,399,211,47.12%
pc-api.wondershare.cc,187,0.01%,187,0,100.00%
webquoteklinepic.eastmoney.com,187,0.01%,187,0,100.00%
inference.location.live.net,186,0.01%,186,0,100.00%
wss.tim.qq.com,186,0.01%,186,0,100.00%
signaler-pa.clients6.google.com,186,0.01%,349,163,53.30%
ocsp2-cn-lb.apple.com.akadns.net,185,0.01%,204,19,90.69%
nk2.boom.skin,185,0.01%,185,0,100.00%
dup.baidustatic.com,184,0.01%,184,0,100.00%
al04.bb.wdpdk.link,184,0.01%,184,0,100.00%
t14.baidu.com,183,0.01%,258,75,70.93%
notifier-configs.airbrake.io,183,0.01%,390,207,46.92%
www.n1ui5fms.net,183,0.01%,183,0,100.00%
1.ubuntu.pool.ntp.org,181,0.01%,181,0,100.00%
upos-sz-mirrorhwo1.bilivideo.com,181,0.01%,279,98,64.87%
color.docer.wps.cn,181,0.01%,181,0,100.00%
lz4hlmtcf5.feishu.cn,181,0.01%,181,0,100.00%
a1961.g2.akamai.net,181,0.01%,181,0,100.00%
2.rhel.pool.ntp.org,180,0.01%,186,6,96.77%
b.bdstatic.com,179,0.01%,246,67,72.76%
f5-ck.zhhainiao.com,179,0.01%,179,0,100.00%
map.baidu.com,179,0.01%,429,250,41.72%
www.jos.org.cn,179,0.01%,179,0,100.00%
img0yjvjvvuvw.cdn.cache102.xyz,179,0.01%,179,0,100.00%
ss0.baidu.com,178,0.01%,304,126,58.55%
www.overleaf.com,178,0.01%,178,0,100.00%
www.liebao.cn,178,0.01%,178,0,100.00%
officecdn.microsoft.com,178,0.01%,178,0,100.00%
ss1.baidu.com,177,0.01%,302,125,58.61%
diskapi.n.shifen.com,177,0.01%,350,173,50.57%
mambap2pvodh5.8686c.com,177,0.01%,177,0,100.00%
pic.people.com.cn,177,0.01%,762,585,23.23%
activity.windows.com,176,0.01%,176,0,100.00%
ocsp.apple.com,176,0.01%,196,20,89.80%
ss2.baidu.com,175,0.01%,292,117,59.93%
ss3.baidu.com,174,0.01%,289,115,60.21%
am.abc.wdpdk.link,174,0.01%,174,0,100.00%
luckyvideo.peopletech.cn,174,0.01%,174,0,100.00%
tracker.tfile.co,174,0.01%,174,0,100.00%
time-ios.g.aaplimg.com,173,0.01%,173,0,100.00%
hovv.yilanvaas.com,173,0.01%,394,221,43.91%
shavar.prod.mozaws.net,173,0.01%,173,0,100.00%
fclick.baidu.com,172,0.01%,172,0,100.00%
telemetry-incoming.r53-2.services.mozilla.com,172,0.01%,172,0,100.00%
array601.prod.do.dsp.mp.microsoft.com,171,0.01%,171,0,100.00%
update.eset.com,171,0.01%,171,0,100.00%
c2s3.jamjams3.net,171,0.01%,171,0,100.00%
broadcast.chat.bilibili.com,170,0.01%,170,0,100.00%
wdl1.file.cache.docer.com,170,0.01%,253,83,67.19%
g.ceipmsn.com,170,0.01%,170,0,100.00%
dl.ijinshan.com,169,0.01%,169,0,100.00%
ceea167a5a36dedd.jijifun.com,169,0.01%,169,0,100.00%
gsp0.baidu.com,168,0.01%,168,0,100.00%
cs22.wpc.v0cdn.net,168,0.01%,168,0,100.00%
aka.ms,168,0.01%,168,0,100.00%
waws-prod-sg1-051.sip.azurewebsites.windows.net,168,0.01%,168,0,100.00%
tracker.istole.it,168,0.01%,168,0,100.00%
www.i0rp1l2j.com,167,0.01%,167,0,100.00%
ins-59d1h3tv.ias.tencent-cloud.net,167,0.01%,316,149,52.85%
sl-log.oray.net,166,0.01%,166,0,100.00%
input.shouji.sogou.com,166,0.01%,166,0,100.00%
xcx.www.gov.cn,166,0.01%,166,0,100.00%
down.anticheatexpert.com,165,0.01%,165,0,100.00%
slardar-bd.feishu.cn.w.cdngslb.com,165,0.01%,165,0,100.00%
feilian-staging.bytedance.com,165,0.01%,165,0,100.00%
array615.prod.do.dsp.mp.microsoft.com,164,0.01%,164,0,100.00%
music.163.com,164,0.01%,214,50,76.64%
eu-west-1.axt.aliyun.com,164,0.01%,164,0,100.00%
yuri.app.kdsec.org,163,0.01%,163,0,100.00%
0.cn.pool.ntp.org,163,0.01%,163,0,100.00%
safebrowsing.google.com,162,0.01%,162,0,100.00%
pubsub02.oray.net,162,0.01%,162,0,100.00%
dl.delivery.mp.microsoft.com,162,0.01%,176,14,92.05%
update.nsfocus.com,162,0.01%,162,0,100.00%
opentracker.xyz,161,0.01%,20905,20744,0.77%
metrics1.data.hicloud.com,161,0.01%,161,0,100.00%
res.ldmnq.com,161,0.01%,161,0,100.00%
gecko-bd.feishu.cn.w.cdngslb.com,161,0.01%,161,0,100.00%
clientlogvodp2p.haplat.net,160,0.01%,160,0,100.00%
download.api.bsb.baidu.com,160,0.01%,160,0,100.00%
passport.escience.cn,159,0.01%,159,0,100.00%
crl3.digicert.com,159,0.01%,286,127,55.59%
5.rlb.router.teamviewer.cn,159,0.01%,159,0,100.00%
zhanzhang.toutiao.com,159,0.01%,159,0,100.00%
ts.eset.com,159,0.01%,159,0,100.00%
profile-avatar.csdnimg.cn,158,0.01%,158,0,100.00%
ts4.cn.mm.bing.net,158,0.01%,158,0,100.00%
stock2.finance.sina.com.cn,158,0.01%,158,0,100.00%
openway.guance.com,158,0.01%,158,0,100.00%
new.weibo.cn,157,0.01%,157,0,100.00%
ieonlinews.microsoft.com,157,0.01%,284,127,55.28%
s.ludashi.com,157,0.01%,157,0,100.00%
api.insight.synology.com,157,0.01%,157,0,100.00%
china.bing123.com,157,0.01%,157,0,100.00%
e8652.dscx.akamaiedge.net,157,0.01%,317,160,49.53%
umwatson.events.data.microsoft.com,156,0.01%,181,25,86.19%
mm.ilovescholar.xyz,156,0.01%,156,0,100.00%
ssxd.mediav.com,156,0.01%,156,0,100.00%
wns.notify.trafficmanager.net,156,0.01%,298,142,52.35%
marketplace.opennebula.systems,155,0.01%,155,0,100.00%
nk7.boom.skin,154,0.01%,154,0,100.00%
www.google-analytics.com,154,0.01%,297,143,51.85%
ss1.bdstatic.com,153,0.01%,153,0,100.00%
t13.baidu.com,153,0.01%,207,54,73.91%
array507.prod.do.dsp.mp.microsoft.com,153,0.01%,153,0,100.00%
nk3.boom.skin,153,0.01%,153,0,100.00%
android.l.google.com,153,0.01%,153,0,100.00%
login.partner.microsoftonline.cn,153,0.01%,153,0,100.00%
tracker.vanitycore.co,153,0.01%,261,108,58.62%
wn.pos.baidu.com,152,0.01%,152,0,100.00%
r3.o.lencr.org,152,0.01%,330,178,46.06%
appledownload.qtlcdn.com,152,0.01%,152,0,100.00%
www.qq.com,151,0.01%,2125,1974,7.11%
dc1-st.ksn.kaspersky-labs.com,151,0.01%,151,0,100.00%
services.addons.mozilla.org,151,0.01%,151,0,100.00%
3.ubuntu.pool.ntp.org,151,0.01%,151,0,100.00%
zhihu-web-analytics.zhihu.com,151,0.01%,182,31,82.97%
shuc-other.ksord.com,151,0.01%,151,0,100.00%
gm.mmstat.com,151,0.01%,151,0,100.00%
na61-na62.wagbridge.alibaba.alibaba.com.gds.alibabadns.com,151,0.01%,151,0,100.00%
mail.126.com,150,0.01%,150,0,100.00%
www.mi.com,150,0.01%,321,171,46.73%
mrodevicemgr.officeapps.live.com,150,0.01%,285,135,52.63%
readpaper.com,149,0.01%,149,0,100.00%
a1887.dscq.akamai.net,149,0.01%,299,150,49.83%
dotbeats.douyucdn.cn,149,0.01%,149,0,100.00%
hashcloud.cz,149,0.01%,149,0,100.00%
nat-port-1.verysync.cn,149,0.01%,149,0,100.00%
apis.mosaic.analytics.awscommon.mcafee.com,148,0.01%,148,0,100.00%
gateway.icloud.com,148,0.01%,269,121,55.02%
1.courier-sandbox-push-apple.com.akadns.net,148,0.01%,148,0,100.00%
outlook.ms-acdc.office.com,148,0.01%,323,175,45.82%
fsrcn.lenovomm.com,148,0.01%,148,0,100.00%
live.github.com,147,0.01%,147,0,100.00%
mam.netease.com,147,0.01%,147,0,100.00%
4005f8da13f42943.jijifun.com,147,0.01%,147,0,100.00%
7.rlb.router.teamviewer.cn,147,0.01%,147,0,100.00%
cm-cn-central-00001.albatross.10086.cn,146,0.01%,146,0,100.00%
ocsp.verisign.com,145,0.01%,302,157,48.01%
wdcp.microsoft.com,145,0.01%,145,0,100.00%
imap.163.com,145,0.01%,145,0,100.00%
tracker.internetwarriors.net,144,0.01%,144,0,100.00%
uqhdkynyqiccr0ff-gzo0ffeun6pvl9od-gebf7khwpyapzzta.prprmoe.xyz,144,0.01%,144,0,100.00%
notify.adobe.io,143,0.01%,143,0,100.00%
file.drivergenius.com,143,0.01%,143,0,100.00%
proxy.whaledata.com,143,0.01%,143,0,100.00%
browser.360.cn.qh-cdn.com,143,0.01%,148,5,96.62%
tw01.ipv2.xyz,143,0.01%,143,0,100.00%
pcrec.baidu.com,142,0.01%,250,108,56.80%
14.tlu.dl.delivery.mp.microsoft.com,142,0.01%,142,0,100.00%
dcagent.mecdn.synacast.com,142,0.01%,142,0,100.00%
HND-efz.ms-acdc.office.com,142,0.01%,316,174,44.94%
gm.gds.mmstat.com,142,0.01%,142,0,100.00%
jp04.v2netapp.com,142,0.01%,142,0,100.00%
e15275.g.akamaiedge.net,142,0.01%,142,0,100.00%
post.ksosoft.com,142,0.01%,142,0,100.00%
dynsrv.wps.cn,142,0.01%,142,0,100.00%
beacons.gvt2.com,141,0.01%,334,193,42.22%
skl.la1.mclqp.link,141,0.01%,141,0,100.00%
www-www.bing.com.trafficmanager.net,141,0.01%,151,10,93.38%
t15.baidu.com,140,0.01%,182,42,76.92%
nk6.boom.skin,140,0.01%,140,0,100.00%
res.wx.qq.com.sched.legopic1.tdnsv6.com,140,0.01%,140,0,100.00%
storecatalogrevocation.storequality.microsoft.com,139,0.01%,139,0,100.00%
zz.bdstatic.com,139,0.01%,139,0,100.00%
2.pool.ntp.org,139,0.01%,254,115,54.72%
img-home.csdnimg.cn,138,0.01%,138,0,100.00%
kiteweb.b-cdn.net,138,0.01%,322,184,42.86%
st.pinyin.sogou.com,138,0.01%,138,0,100.00%
fe2cr.update.microsoft.com,137,0.01%,297,160,46.13%
mini.360.cn,137,0.01%,163,26,84.05%
exmail.qq.com,137,0.01%,137,0,100.00%
bizapi.csdn.net,136,0.01%,136,0,100.00%
update-khd.2345.cc,136,0.01%,136,0,100.00%
helpdesktop1.ksmobile.com,136,0.01%,136,0,100.00%
atm-settingsfe-prod-geo2.trafficmanager.NET,136,0.01%,136,0,100.00%
api.live.bilibili.com,135,0.01%,151,16,89.40%
ntes53.mail.163.com,135,0.01%,135,0,100.00%
vtnt.cnode.xyz,135,0.01%,135,0,100.00%
api.appcues.net,135,0.01%,135,0,100.00%
pc.profile.qqpy.sogou.com,135,0.01%,135,0,100.00%
cs.dds.microsoft.com,134,0.01%,134,0,100.00%
fa000000105.resources.office.net,134,0.01%,277,143,48.38%
ts.qq.com,134,0.01%,941,807,14.24%
dc1-file.ksn.kaspersky-labs.com,134,0.01%,134,0,100.00%
objects.githubusercontent.com,134,0.01%,134,0,100.00%
hw-web-player-tracker.biliapi.net,133,0.01%,133,0,100.00%
api.weibo.cn,133,0.01%,317,184,41.96%
bgpv4.music.ntes53.netease.com,133,0.01%,133,0,100.00%
nsl.lenovo.com.cn,133,0.01%,133,0,100.00%
pis-pcdn.youku.com,133,0.01%,133,0,100.00%
datacluster4.cipsup.cn,133,0.01%,133,0,100.00%
array812.prod.do.dsp.mp.microsoft.com,133,0.01%,133,0,100.00%
beacon.tingyun.com,132,0.01%,132,0,100.00%
ts3.cn.mm.bing.net,132,0.01%,132,0,100.00%
c124a10e0db5e4b9.jijifun.com,132,0.01%,132,0,100.00%
geover.prod.do.dsp.mp.microsoft.com,131,0.01%,131,0,100.00%
plugin.browser.qq.com,131,0.01%,131,0,100.00%
pico.gtm.eset.com,131,0.01%,131,0,100.00%
weather-data.apple.com.akadns.net,131,0.01%,261,130,50.19%
www.microsoft.com-c-3.edgekey.net,131,0.01%,131,0,100.00%
hao.lenovo.com.cn,130,0.01%,130,0,100.00%
array811.prod.do.dsp.mp.microsoft.com,130,0.01%,130,0,100.00%
www.freerainbowtables.com,130,0.01%,130,0,100.00%
api1.origin.com,130,0.01%,130,0,100.00%
blog.csdn.net,129,0.01%,129,0,100.00%
long.iwifi.360.cn,129,0.01%,129,0,100.00%
pop.ie.sogou.com,129,0.01%,129,0,100.00%
onedsblobprdwus15.westus.cloudapp.azure.com,129,0.01%,129,0,100.00%
onedsblobprdcus15.centralus.cloudapp.azure.com,129,0.01%,129,0,100.00%
eclick.baidu.com,128,0.01%,128,0,100.00%
edge.microsoft.com,128,0.01%,5438,5310,2.35%
sslbaiduv6.jomodns.com,128,0.01%,155,27,82.58%
datacluster2.cipsup.cn,128,0.01%,128,0,100.00%
8d0968d6458e0ad0.jijifun.com,128,0.01%,128,0,100.00%
diana.ie.sogou.com,128,0.01%,128,0,100.00%
dual-spo-0004.spo-msedge.net,128,0.01%,128,0,100.00%
disc801.prod.do.dsp.mp.microsoft.com,128,0.01%,128,0,100.00%
passport.m3guo.com,128,0.01%,128,0,100.00%
googlehosted.l.googleusercontent.com,127,0.01%,230,103,55.22%
s1.url.cn,127,0.01%,127,0,100.00%
down2.abckantu.com,127,0.01%,127,0,100.00%
stun.voiparound.com,127,0.01%,127,0,100.00%
registry.centos.org,127,0.01%,127,0,100.00%
array614.prod.do.dsp.mp.microsoft.com,126,0.01%,126,0,100.00%
easylist-downloads.adblockplus.org,126,0.01%,254,128,49.61%
cn-sh.sasg4e.ccddns.lol,126,0.01%,126,0,100.00%
dotserver.douyucdn.cn,126,0.01%,126,0,100.00%
d2kaokxjvx18eu.cloudfront.net,125,0.01%,128,3,97.66%
prod.balrog.prod.cloudops.mozgcp.net,125,0.01%,125,0,100.00%
mx.cstnet.cn,125,0.01%,125,0,100.00%
2csvr-basic.wpsdns.com,125,0.01%,125,0,100.00%
sentry.eulix.xyz,125,0.01%,125,0,100.00%
init.itunes.apple.com,124,0.01%,218,94,56.88%
dcache.hub.sandai.net,124,0.01%,124,0,100.00%
ru01.ipv2.xyz,124,0.01%,124,0,100.00%
izn4cyqeu8.feishu.cn,124,0.01%,124,0,100.00%
firebaselogging-pa.googleapis.com,123,0.01%,141,18,87.23%
detectportal.prod.mozaws.net,123,0.01%,16432,16309,0.75%
mesu.apple.com,123,0.01%,231,108,53.25%
cp601.prod.do.dsp.mp.microsoft.com,123,0.01%,123,0,100.00%
download.pinyin.sogou.com,123,0.01%,123,0,100.00%
nk4.boom.skin,123,0.01%,123,0,100.00%
reswx.tc.qq.com,123,0.01%,133,10,92.48%
iris-de-prod-azsc-eas-b.eastasia.cloudapp.azure.com,123,0.01%,123,0,100.00%
list.lvb.eastmoney.com,123,0.01%,123,0,100.00%
ws.666liushen.tk,123,0.01%,123,0,100.00%
ecn.dev.ditu.live.com,122,0.01%,122,0,100.00%
www.gstatic.com,122,0.01%,135,13,90.37%
notify3.note.youdao.com,122,0.01%,230,108,53.04%
services.gfe.nvidia.com,122,0.01%,122,0,100.00%
open.qurl.f.360.cn,122,0.01%,122,0,100.00%
gitea.com,122,0.01%,122,0,100.00%
cloud.dell.com,122,0.01%,122,0,100.00%
software.drivergenius.com,122,0.01%,122,0,100.00%
cloud.google.com,122,0.01%,122,0,100.00%
aoufnebg.dayugslb.com,122,0.01%,122,0,100.00%
bdwblog.eastmoney.com,122,0.01%,122,0,100.00%
dedi.1808.cf,122,0.01%,122,0,100.00%
pietro-pezzani.divisare.pro,122,0.01%,122,0,100.00%
megacrit-metrics.herokuapp.com,122,0.01%,122,0,100.00%
mail.digidown.de,122,0.01%,122,0,100.00%
m.iliveok.com,122,0.01%,122,0,100.00%
v1.skddefi99.cf,122,0.01%,122,0,100.00%
mail.forcemail.de,122,0.01%,122,0,100.00%
downloads.skewed.de,122,0.01%,122,0,100.00%
jobs.plenigo.com,122,0.01%,122,0,100.00%
exchange.mercadomedianetwork.do,122,0.01%,122,0,100.00%
us9929.azus.ml,122,0.01%,122,0,100.00%
goya.com.au,122,0.01%,122,0,100.00%
fisher-trails-21.myzeki.com,122,0.01%,122,0,100.00%
ccsw.ac.uk,122,0.01%,122,0,100.00%
app.d3mnetworks.com,122,0.01%,122,0,100.00%
webmail.flytowardsthehiddensecret.tk,122,0.01%,122,0,100.00%
mail.travtextgentcesscongju.ml,122,0.01%,122,0,100.00%
oracle-001.kaka123.ml,122,0.01%,122,0,100.00%
bluedot.is.autonavi.com.gds.alibabadns.com,121,0.01%,121,0,100.00%
cv.duba.net,120,0.01%,120,0,100.00%
archive.kylinos.cn,120,0.01%,120,0,100.00%
0.ubuntu.pool.ntp.org,120,0.01%,120,0,100.00%
array509.prod.do.dsp.mp.microsoft.com,120,0.01%,120,0,100.00%
waws-prod-sg1-051.cloudapp.net,120,0.01%,120,0,100.00%
partner.googleadservices.com,119,0.01%,120,1,99.17%
datacluster3.cipsup.cn,119,0.01%,119,0,100.00%
stun.counterpath.net,119,0.01%,119,0,100.00%
be01mr9s.sched.d2.tdnsdp1.cn,119,0.01%,119,0,100.00%
array807.prod.do.dsp.mp.microsoft.com,119,0.01%,119,0,100.00%
flux.hcdn.qiyi.com,118,0.01%,118,0,100.00%
info.wps.cn,118,0.01%,118,0,100.00%
repo.openeuler.org,118,0.01%,118,0,100.00%
nat-port-2.verysync.cn,118,0.01%,118,0,100.00%
sv.symcb.com,117,0.01%,218,101,53.67%
pushtrs.push.hicloud.com,117,0.01%,117,0,100.00%
messaging.ccs.mcafee.com,117,0.01%,117,0,100.00%
ddns-checkip.quickconnect.to,117,0.01%,117,0,100.00%
t11.baidu.com,116,0.01%,154,38,75.32%
sp2.baidu.com,116,0.01%,210,94,55.24%
array608.prod.do.dsp.mp.microsoft.com,116,0.01%,116,0,100.00%
hk-4.upjs.xyz,116,0.01%,116,0,100.00%
guzzoni.apple.com,116,0.01%,116,0,100.00%
image.sinajs.cn,116,0.01%,236,120,49.15%
pgyapi.oray.net,115,0.01%,115,0,100.00%
f-log-extension.grammarly.io,115,0.01%,115,0,100.00%
cp501.prod.do.dsp.mp.microsoft.com,115,0.01%,115,0,100.00%
l7-online-self-max.s.dsa.cdnbuild.net,115,0.01%,115,0,100.00%
stun.sipgate.net,115,0.01%,115,0,100.00%
t12.baidu.com,114,0.01%,150,36,76.00%
img-blog.csdnimg.cn,114,0.01%,114,0,100.00%
gs-loc-cn.apple.com,114,0.01%,114,0,100.00%
e6913.dscx.akamaiedge.net,114,0.01%,228,114,50.00%
init-china.itunes-apple.com.akadns.net,114,0.01%,208,94,54.81%
upos-sz-mirrorcoso1.bilivideo.com,114,0.01%,256,142,44.53%
dcldshlupt.alicdn.com.danuoyi.tbcache.com,114,0.01%,114,0,100.00%
messaging.engagement.office.com,114,0.01%,114,0,100.00%
wildcard.weather.microsoft.com.edgekey.net,114,0.01%,114,0,100.00%
hubble.netease.com,114,0.01%,114,0,100.00%
bubble.ic.ksosoft.com,113,0.01%,113,0,100.00%
update.os.nfschina.com,113,0.01%,113,0,100.00%
newvpn.arp.cn,113,0.01%,113,0,100.00%
cn.hncu.1aba.cn,113,0.01%,113,0,100.00%
opencdnbd.jomodns.com,112,0.01%,168,56,66.67%
study.huixiangtiandi.com,112,0.01%,112,0,100.00%
d.skconf.f.360.cn,112,0.01%,112,0,100.00%
venus.douyucdn.cn,112,0.01%,112,0,100.00%
api.mixpanel.com,112,0.01%,112,0,100.00%
pkgupdate7.synology.com,112,0.01%,112,0,100.00%
sync-1-us-west1-g.sync.services.mozilla.com,111,0.01%,111,0,100.00%
tracking.miui.com,111,0.01%,111,0,100.00%
opentracker.acgnx.se,111,0.01%,229,118,48.47%
bjbgp01.baidupcs.com,111,0.01%,111,0,100.00%
v10.vortex-win.data.microsoft.com,111,0.01%,138,27,80.43%
hdweb.mail.split.netease.com,111,0.01%,111,0,100.00%
ww1.sinaimg.cn.w.alikunlun.com,111,0.01%,236,125,47.03%
weixin.sogou.com,111,0.01%,111,0,100.00%
smtp.163.com,111,0.01%,111,0,100.00%
mon.zijieapi.com.bytedns1.com,111,0.01%,111,0,100.00%
i.snssdk.com,110,0.01%,110,0,100.00%
beacons3.gvt2.com,110,0.01%,110,0,100.00%
k8s.gcr.io,110,0.01%,5462,5352,2.01%
271509e17755a70d683b7f40cdb3eec6df604067.u.fdmpkg.org,110,0.01%,110,0,100.00%
inappcheck-lb.itunes-apple.com.akadns.net,110,0.01%,130,20,84.62%
tracker.opentrackr.org,110,0.01%,110,0,100.00%
public-treatment.prod-experimentation.grammarlyaws.com,110,0.01%,110,0,100.00%
ext.henzanapp.com,110,0.01%,110,0,100.00%
s.symcb.com,110,0.01%,199,89,55.28%
stdtime.gov.hk,110,0.01%,110,0,100.00%
bdstatic.eastmoney.com,110,0.01%,110,0,100.00%
crteam.cn,109,0.01%,109,0,100.00%
s1.symcb.com,109,0.01%,201,92,54.23%
d33vwaa6rdensn.cloudfront.net,109,0.01%,119,10,91.60%
openjmacs4uc.m.taobao.com,109,0.01%,109,0,100.00%
comtrade.un.org,109,0.01%,109,0,100.00%
alert-cn.battlenet.com.cn,109,0.01%,109,0,100.00%
datarouter-weighted.ol.epicgames.com,109,0.01%,109,0,100.00%
wildcard.feishu.cn.bytedns1.com,109,0.01%,109,0,100.00%
rs-cn.rustdesk.com,108,0.01%,108,0,100.00%
linux.kite.com,108,0.01%,757,649,14.27%
ocsp.apple.com.download.ks-cdn.com,108,0.01%,108,0,100.00%
69.push2his.eastmoney.com,108,0.01%,108,0,100.00%
ris-prod.trafficmanager.net,108,0.01%,108,0,100.00%
stun.schlund.de,108,0.01%,108,0,100.00%
soup.v.qq.com,107,0.01%,107,0,100.00%
t10.baidu.com,107,0.01%,149,42,71.81%
cu010.www.duba.net,107,0.01%,107,0,100.00%
21.push2his.eastmoney.com,107,0.01%,107,0,100.00%
bdstatics.eastmoney.com,107,0.01%,107,0,100.00%
6qnz2sy8.sched.d2.tdnsdp1.cn,107,0.01%,107,0,100.00%
us01.ptrecord.com,107,0.01%,107,0,100.00%
rs-sg.rustdesk.com,106,0.01%,106,0,100.00%
windows.msn.cn,106,0.01%,120,14,88.33%
9.rarbg.com,106,0.01%,106,0,100.00%
dl.vas.wpscdn.cn,106,0.01%,235,129,45.11%
ocsp.digicert.cn,106,0.01%,106,0,100.00%
img-s-msn-com.akamaized.net,106,0.01%,230,124,46.09%
62.push2his.eastmoney.com,106,0.01%,106,0,100.00%
array616.prod.do.dsp.mp.microsoft.com,106,0.01%,106,0,100.00%
36d3af239dc2ead8aaa059a747d643c0c1645cee.u.fdmpkg.org,106,0.01%,106,0,100.00%
sd2.1dadan.com,106,0.01%,106,0,100.00%
blobcollector.events.data.trafficmanager.NET,105,0.01%,123,18,85.37%
browser.events.data.msn.cn,105,0.01%,139,34,75.54%
mask-api.icloud.com,105,0.01%,131,26,80.15%
wu-bg-shim.trafficmanager.NET,105,0.01%,107,2,98.13%
pc-store.lenovomm.cn,105,0.01%,105,0,100.00%
www.microsoft.com-c-3.edgekey.net.globalredir.akadns.net,105,0.01%,107,2,98.13%
array801.prod.do.dsp.mp.microsoft.com,105,0.01%,105,0,100.00%
dataflow.biliapi.com.dy.galileo.jcloud-cdn.com,105,0.01%,105,0,100.00%
d.dropbox.com,105,0.01%,214,109,49.07%
profile.firefox.com.cn,105,0.01%,105,0,100.00%
rm-bp151dcc75aycqd80to.mysql.rds.aliyuncs.com,105,0.01%,105,0,100.00%
rua.myddns.cyou,105,0.01%,105,0,100.00%
wxapp.tc.qq.com,104,0.01%,265,161,39.25%
pic4.zhimg.com,104,0.01%,149,45,69.80%
www.vod.lxdns.com,104,0.01%,238,134,43.70%
v1-hwllqv.onewsvod.com,104,0.01%,104,0,100.00%
wd-prod-ss.trafficmanager.net,104,0.01%,104,0,100.00%
54.push2his.eastmoney.com,104,0.01%,104,0,100.00%
lb-pkx01-offline.zhihu.com,104,0.01%,104,0,100.00%
dtapp-pub.dingtalk.com,103,0.01%,103,0,100.00%
0.pool.ntp.org,103,0.01%,103,0,100.00%
zhushou.huihui.cn,103,0.01%,103,0,100.00%
e10499.dsce9.akamaiedge.net,103,0.01%,205,102,50.24%
gspe35-ssl.ls.apple.com,103,0.01%,139,36,74.10%
mediator.goodsync.com,103,0.01%,103,0,100.00%
stun.xten.com,103,0.01%,103,0,100.00%
apple-finance.query.yahoo.com,102,0.01%,102,0,100.00%
ups.ksmobile.net,102,0.01%,181,79,56.35%
docs2.gtimg.com,102,0.01%,112,10,91.07%
pic1.zhimg.com,102,0.01%,134,32,76.12%
k256.gslb.ksyuncdn.com,102,0.01%,102,0,100.00%
keyvalueservice.icloud.com.cn,102,0.01%,102,0,100.00%
internal-api-lark-api.feishu.cn.w.cdngslb.com,102,0.01%,102,0,100.00%
sync.firefox.com.cn,102,0.01%,102,0,100.00%
3463d06de0ca9a15.jijifun.com,102,0.01%,102,0,100.00%
www.tm.a.prd.aadg.akadns.net,102,0.01%,102,0,100.00%
szmmsns.qpic.cn,101,0.01%,210,109,48.10%
cdn.content.prod.cms.msn.com,101,0.01%,237,136,42.62%
data.unistream.io,101,0.01%,101,0,100.00%
inews.gtimg.com,101,0.01%,112,11,90.18%
api.dropbox.com,101,0.01%,228,127,44.30%
onedsblobprdeus17.eastus.cloudapp.azure.com,101,0.01%,101,0,100.00%
cdn-node.cn.cm.foshan-02.nekocloud.cn,101,0.01%,101,0,100.00%
ntp.msn.cn,100,0.01%,110,10,90.91%
e8218.dscb1.akamaiedge.net,100,0.01%,200,100,50.00%
news.qhstatic.com,100,0.01%,100,0,100.00%
smartdl.lenovo.com.cn,100,0.01%,100,0,100.00%
i0.hdslb.com,99,0.01%,203,104,48.77%
xp.apple.com,99,0.01%,151,52,65.56%
bkssl.bdimg.com,98,0.01%,130,32,75.38%
www.zhihu.com,98,0.01%,224,126,43.75%
package-search.services.jetbrains.com,97,0.01%,189,92,51.32%
pic2.zhimg.com,97,0.01%,131,34,74.05%
pic3.zhimg.com,97,0.01%,140,43,69.29%
upos-sz-mirrorhw.bilivideo.com,96,0.01%,151,55,63.58%
se.360.cn,96,0.01%,124,28,77.42%
safebrowsing.googleapis-cn.com,95,0.01%,227,132,41.85%
img-prod-cms-rt-microsoft-com.akamaized.net,95,0.01%,195,100,48.72%
storage.googleapis.com,95,0.01%,114,19,83.33%
oneclient.sfx.ms,94,0.01%,213,119,44.13%
event.csdn.net,94,0.01%,220,126,42.73%
cdn.cvws.apple-dns.net,94,0.01%,198,104,47.47%
expressapisv2.net,94,0.01%,180,86,52.22%
cdn.jsdelivr.net,93,0.01%,180,87,51.67%
upos-sz-mirrorcos.bilivideo.com,92,0.01%,200,108,46.00%
data.bilicdn2.com,92,0.01%,178,86,51.69%
opencdnglobalv6.jomodns.com,91,0.01%,135,44,67.41%
fe2cr.update.msft.com.trafficmanager.net,89,0.01%,189,100,47.09%
teams.events.data.microsoft.com,89,0.01%,104,15,85.58%
opencdnbdsimage.jomodns.com,88,0.01%,128,40,68.75%
linux.teamviewer.com,88,0.01%,149,61,59.06%
cipv6gn.v.trpcdn.net,88,0.01%,179,91,49.16%
vweixinf.tc.qq.com,87,0.01%,193,106,45.08%
video-bd-drcn.dbankcdn.cn,87,0.01%,345,258,25.22%
go.microsoft.com.edgekey.net,87,0.01%,191,104,45.55%
mesu-china.apple.com.akadns.net,86,0.01%,164,78,52.44%
d20wxjqjgi3st.cloudfront.net,86,0.01%,175,89,49.14%
bvc.bilivideo.com,85,0.01%,101,16,84.16%
eopa.n.shifen.com,85,0.01%,160,75,53.12%
cdn.ghostery.com,85,0.01%,175,90,48.57%
configuration.ls.apple.com,84,0.01%,182,98,46.15%
static-pcs-sdk-server.alibaba.com,84,0.01%,120,36,70.00%
conf.wsm.360.cn,83,0.01%,161,78,51.55%
array612.prod.do.dsp.mp.microsoft.com,83,0.01%,161,78,51.55%
bag.itunes.apple.com,83,0.01%,151,68,54.97%
resources.jetbrains.com,82,0.01%,139,57,58.99%
google.com,82,0.01%,166,84,49.40%
gimg4.baidu.com,82,0.01%,111,29,73.87%
eas.outlook.com,82,0.01%,141,59,58.16%
filehelper.weixin.qq.com,81,0.01%,10357,10276,0.78%
static.nvidiagrid.net,81,0.01%,101,20,80.20%
download.comodo.com,80,0.01%,148,68,54.05%
crl.certum.pl,79,0.01%,171,92,46.20%
ac.dun.163.com,78,0.01%,149,71,52.35%
opencdnbdcharon.jomodns.com,77,0.01%,127,50,60.63%
router-default.apps.openshift4.gnome.org,76,0.01%,139,63,54.68%
static-xl.a.88cdn.com,76,0.01%,177,101,42.94%
l5.gslb.ksyuncdn.com,76,0.01%,149,73,51.01%
wildcard46.go-mpulse.net.edgekey.net,75,0.00%,158,83,47.47%
investor.shutterstock.com,75,0.00%,114,39,65.79%
a1992.dscd.akamai.net,73,0.00%,154,81,47.40%
ocsp.entrust.net.edgekey.net,73,0.00%,157,84,46.50%
d28139t0r7hg1k.cloudfront.net,72,0.00%,146,74,49.32%
www.news.cn,72,0.00%,162,90,44.44%
mcs.snssdk.com,71,0.00%,151,80,47.02%
fe2.update.microsoft.com,71,0.00%,150,79,47.33%
js1.pcfg.cache.wpscdn.cn,71,0.00%,162,91,43.83%
open.acgnxtracker.com,71,0.00%,120,49,59.17%
quote.eastmoney.com,70,0.00%,161,91,43.48%
emres.dfcfw.com,69,0.00%,156,87,44.23%
onedscolprdeus05.eastus.cloudapp.azure.com,68,0.00%,130,62,52.31%
download.jetbrains.com.cn,68,0.00%,111,43,61.26%
emcharts.eastmoney.com,68,0.00%,155,87,43.87%
cdn.onenote.net,67,0.00%,136,69,49.26%
c.apple.news,67,0.00%,151,84,44.37%
SIN-efz.ms-acdc.office.com,67,0.00%,151,84,44.37%
dsm01pap006.storage.live.com,67,0.00%,111,44,60.36%
bolt.dropbox.com,67,0.00%,138,71,48.55%
passport.baidu.com,66,0.00%,204,138,32.35%
dlswbr.baidu.com,66,0.00%,117,51,56.41%
sv.symcd.com,66,0.00%,139,73,47.48%
extensions.gnome.org,66,0.00%,120,54,55.00%
emcharts.dftzj.com,66,0.00%,151,85,43.71%
emcharts.dfcfw.com,66,0.00%,147,81,44.90%
picx.zhimg.com,65,0.00%,121,56,53.72%
builds.parsecgaming.com,64,0.00%,118,54,54.24%
bn02pap001.storage.live.com,64,0.00%,107,43,59.81%
kjk3jf40.sched.sma-dk.tdnsstic1.cn,64,0.00%,137,73,46.72%
sf.symcd.com,63,0.00%,141,78,44.68%
acdc-direct.office.com,63,0.00%,137,74,45.99%
l-0003.l-msedge.net,63,0.00%,100,37,63.00%
XSP-efz.ms-acdc.office.com,63,0.00%,159,96,39.62%
openapp.wpscdn.cn,62,0.00%,134,72,46.27%
pica.zhimg.com,61,0.00%,135,74,45.19%
i2.hdslb.com,60,0.00%,125,65,48.00%
array503.prod.do.dsp.mp.microsoft.com,60,0.00%,117,57,51.28%
web.sdk.qcloud.com,59,0.00%,129,70,45.74%
hm.e.shifen.com,58,0.00%,290,232,20.00%
cdn.download.comodo.com,58,0.00%,141,83,41.13%
i1.hdslb.com,57,0.00%,125,68,45.60%
hcfy.app,57,0.00%,105,48,54.29%
opencdnqiniustaticv6.jomodns.com,57,0.00%,116,59,49.14%
photo.cctv.com,57,0.00%,137,80,41.61%
www.youtube.com,56,0.00%,113,57,49.56%
vweixinthumb.tc.qq.com,56,0.00%,122,66,45.90%
dl-debug.dropbox.com,56,0.00%,116,60,48.28%
hcdnw.bili.c.cdnhwc2.com,56,0.00%,116,60,48.28%
outlook.office.com,55,0.00%,133,78,41.35%
k1.gslb.ksyuncdn.com,54,0.00%,102,48,52.94%
sp3.baidu.com,54,0.00%,100,46,54.00%
datacenter-web.eastmoney.com,54,0.00%,122,68,44.26%
emres.eastmoney.com,53,0.00%,121,68,43.80%
aegis.qq.com,52,0.00%,183,131,28.42%
k1-ipv6.gslb.ksyuncdn.com,52,0.00%,114,62,45.61%
a-0001.a-msedge.net,51,0.00%,105,54,48.57%
havfw69955.lithium.com,51,0.00%,112,61,45.54%
mirrors.aliyun.com.w.alikunlun.com,51,0.00%,101,50,50.50%
himg.bdimg.com,51,0.00%,110,59,46.36%
static.zhihu.com,51,0.00%,122,71,41.80%
armmf.adobe.com,51,0.00%,117,66,43.59%
e673.dsce9.akamaiedge.net,50,0.00%,102,52,49.02%
sovv.yilanvaas.com,50,0.00%,121,71,41.32%
dl.360safe.com,49,0.00%,146,97,33.56%
dldir1v6.qq.com,48,0.00%,108,60,44.44%
cmmsns.qpic.cn,47,0.00%,111,64,42.34%
iduxzj9.qiniudns.com,46,0.00%,103,57,44.66%
wx3.sinaimg.cn,45,0.00%,288,243,15.62%
docs.gtimg.com,45,0.00%,101,56,44.55%
cpro.baidustatic.com,44,0.00%,134,90,32.84%
adsmind.ugdtimg.com,43,0.00%,102,59,42.16%
sugar.zhihu.com,42,0.00%,102,60,41.18%
app-measurement.com,41,0.00%,135,94,30.37%
wx2.sinaimg.cn,38,0.00%,268,230,14.18%
wx1.sinaimg.cn,36,0.00%,267,231,13.48%
wx4.sinaimg.cn,36,0.00%,276,240,13.04%
ecs.office.com,35,0.00%,1356,1321,2.58%
bjacshow.kugou.com,33,0.00%,113,80,29.20%
time.nist.gov,29,0.00%,663,634,4.37%
mirrors.tuna.tsinghua.edu.cn,27,0.00%,1387,1360,1.95%
tracker.vectahosting.eu,27,0.00%,373,346,7.24%
ipv6.msftconnecttest.com,24,0.00%,922,898,2.60%
gfe.nvidia.com,20,0.00%,127,107,15.75%
config.edge.skype.com,19,0.00%,1474,1455,1.29%
hub.upyun.com,15,0.00%,3502,3487,0.43%
www.meituan.com,15,0.00%,1134,1119,1.32%
cn.archive.ubuntu.com,12,0.00%,1355,1343,0.89%
yiyun.n.shifen.com,10,0.00%,379,369,2.64%
tracker.lilithraws.cf,9,0.00%,400,391,2.25%
database.clamav.net,8,0.00%,2376,2368,0.34%
fe3cr.delivery.mp.microsoft.com,8,0.00%,1117,1109,0.72%
astat.bugly.qq.com,8,0.00%,259,251,3.09%
config.teams.microsoft.com,8,0.00%,260,252,3.08%
client.mail.163.com,7,0.00%,534,527,1.31%
extshort.weixin.qq.com,6,0.00%,1320,1314,0.45%
tvax4.sinaimg.cn,6,0.00%,228,222,2.63%
tvax2.sinaimg.cn,6,0.00%,274,268,2.19%
zerossl.ocsp.sectigo.com,6,0.00%,371,365,1.62%
hub5sr.v6.shub.sandai.net,6,0.00%,151,145,3.97%
tracker.gbitt.info,5,0.00%,396,391,1.26%
raw.githubusercontent.com,4,0.00%,2031,2027,0.20%
tracker.openzim.org,4,0.00%,184,180,2.17%
graph.microsoft.com,4,0.00%,270,266,1.48%
tvax3.sinaimg.cn,4,0.00%,245,241,1.63%
aps.amap.com,3,0.00%,136,133,2.21%
www.weibo.com,3,0.00%,367,364,0.82%
platform.bing.com,3,0.00%,163,160,1.84%
captive.apple.com,3,0.00%,1093,1090,0.27%
www.chinanews.com.cn,3,0.00%,159,156,1.89%
gz-lb1.internet-g.spanner.alipaydns.com,3,0.00%,189,186,1.59%
h.trace.qq.com,2,0.00%,835,833,0.24%
api.ivideo.sina.com.cn,2,0.00%,476,474,0.42%
tva1.sinaimg.cn,2,0.00%,104,102,1.92%
security.ubuntu.com,2,0.00%,1648,1646,0.12%
h5.sinaimg.cn,2,0.00%,215,213,0.93%
mirrorlist.centos.org,2,0.00%,436,434,0.46%
win10-trt.msedge.net,2,0.00%,243,241,0.82%
config.edge.skype.com.trafficmanager.net,2,0.00%,211,209,0.95%
config-edge-skype.l-0007.l-msedge.net,2,0.00%,159,157,1.26%
n.guanjia.qq.com,2,0.00%,339,337,0.59%
grafana.com,1,0.00%,4527,4526,0.02%
slscr.update.microsoft.com,1,0.00%,1139,1138,0.09%
E.ROOT-SERVERS.NET,1,0.00%,129,128,0.78%
G.ROOT-SERVERS.NET,1,0.00%,117,116,0.85%
p2pstuntest.haplat.net,1,0.00%,224,223,0.45%
ppa.launchpad.net,1,0.00%,606,605,0.17%
bttracker.debian.org,1,0.00%,132,131,0.76%
map.n.shifen.com,1,0.00%,413,412,0.24%
crl.comodoca.com,1,0.00%,253,252,0.40%
bk.n.shifen.com,1,0.00%,788,787,0.13%
mirrors.ustc.edu.cn,1,0.00%,371,370,0.27%
node.video.qq.com,1,0.00%,337,336,0.30%
update.client.163.com,1,0.00%,535,534,0.19%
hub.docker.com,1,0.00%,253,252,0.40%
mail.qq.com,1,0.00%,148,147,0.68%
edge-microsoft-com.dual-a-0036.a-msedge.net,1,0.00%,257,256,0.39%
open.weixin.qq.com,1,0.00%,260,259,0.38%
cbs-i.sports.cctv.com,1,0.00%,347,346,0.29%
tracker.tamersunion.org,1,0.00%,304,303,0.33%
download.jetbrains.com,1,0.00%,130,129,0.77%
api.aliyundrive.com,1,0.00%,106,105,0.94%
szdx.txddns.cn,1,0.00%,183,182,0.55%
tracker.imgoingto.icu,1,0.00%,227,226,0.44%
s-0005.s-msedge.net,1,0.00%,127,126,0.79%
ipv6check-udp.steamcontent.com,1,0.00%,278,277,0.36%
hub5btmain.v6.shub.sandai.net,1,0.00%,135,134,0.74%
iscas1-my.sharepoint.cn,1,0.00%,201,200,0.50%
www.scio.gov.cn,1,0.00%,121,120,0.83%
wappass.n.shifen.com,1,0.00%,222,221,0.45%
ntp.ubuntu.com,0,0.00%,384262,384262,0.00%
log.tailscale.io,0,0.00%,8176,8176,0.00%
smtp.qq.com,0,0.00%,1618,1618,0.00%
controlplane.tailscale.com,0,0.00%,3455,3455,0.00%
fedoraproject.org,0,0.00%,623,623,0.00%
dns.google,0,0.00%,6790,6790,0.00%
ulogs.umeng.com,0,0.00%,105,105,0.00%
time.g.aaplimg.com,0,0.00%,365,365,0.00%
wx.qlogo.cn,0,0.00%,2079,2079,0.00%
i.work.weixin.qq.com,0,0.00%,344,344,0.00%
badjs.weixinbridge.com,0,0.00%,373,373,0.00%
www.notion.so,0,0.00%,373,373,0.00%
mp.weixin.qq.com,0,0.00%,349,349,0.00%
dns.msftncsi.com,0,0.00%,30083,30083,0.00%
mozilla.cloudflare-dns.com,0,0.00%,288,288,0.00%
db.local.clamav.net,0,0.00%,5593,5593,0.00%
h5.qzone.qq.com,0,0.00%,3777,3777,0.00%
docs.qq.com,0,0.00%,475,475,0.00%
quay.io,0,0.00%,985,985,0.00%
wup.imtt.qq.com,0,0.00%,578,578,0.00%
wx1.qq.com,0,0.00%,879,879,0.00%
weibo.com,0,0.00%,2772,2772,0.00%
glb.sls.prod.dcat.dsp.trafficmanager.net,0,0.00%,413,413,0.00%
dns.weixin.qq.com.cn,0,0.00%,3219,3219,0.00%
access.toggle.qq.com,0,0.00%,721,721,0.00%
short.weixin.qq.com,0,0.00%,190,190,0.00%
tracker.ipv6tracker.ru,0,0.00%,249,249,0.00%
tpstelemetry.tencent.com,0,0.00%,599,599,0.00%
natdetection.onethingpcs.com,0,0.00%,144,144,0.00%
szextshort.weixin.qq.com,0,0.00%,783,783,0.00%
gchat.qpic.cn,0,0.00%,299,299,0.00%
appconf.mail.163.com,0,0.00%,456,456,0.00%
gitlab.com,0,0.00%,1357,1357,0.00%
lookup.nextcloud.com,0,0.00%,6673,6673,0.00%
ping.dgraph.io,0,0.00%,5028,5028,0.00%
60-fps.org,0,0.00%,153,153,0.00%
btracker.top,0,0.00%,189,189,0.00%
kubernetes-charts.storage.googleapis.com,0,0.00%,235,235,0.00%
siambit.com,0,0.00%,8673,8673,0.00%
ping3.teamviewer.com,0,0.00%,746,746,0.00%
nvidia.github.io,0,0.00%,405,405,0.00%
tracker.anirena.com,0,0.00%,448,448,0.00%
open.trackerlist.xyz,0,0.00%,224,224,0.00%
tracker.foreverpirates.co,0,0.00%,300,300,0.00%
potuk.com,0,0.00%,1244,1244,0.00%
0d.kebhana.mx,0,0.00%,142,142,0.00%
all4nothin.net,0,0.00%,160,160,0.00%
tracker.nanoha.org,0,0.00%,297,297,0.00%
tracker.moeking.me,0,0.00%,222,222,0.00%
hub5pn.v6.sandai.net,0,0.00%,838,838,0.00%
report.url.cn,0,0.00%,692,692,0.00%
crl.usertrust.com,0,0.00%,159,159,0.00%
public.dns.iij.jp,0,0.00%,322,322,0.00%
t.nyaatracker.com,0,0.00%,371,371,0.00%
mirrors.bfsu.edu.cn,0,0.00%,240,240,0.00%
localhost,0,0.00%,14363,14363,0.00%
mirrorz.org,0,0.00%,234,234,0.00%
ping.manjaro.org,0,0.00%,692,692,0.00%
osint.bambenekconsulting.com,0,0.00%,175,175,0.00%
www.kdocs.cn,0,0.00%,385,385,0.00%
msgacs.youku.com,0,0.00%,134,134,0.00%
minorshort.weixin.qq.com,0,0.00%,511,511,0.00%
pypi.org,0,0.00%,568801,568801,0.00%
masters-tb.com,0,0.00%,159,159,0.00%
peersteers.org,0,0.00%,1329,1329,0.00%
data-bg.net,0,0.00%,141,141,0.00%
tracker.nucozer-tracker.ml,0,0.00%,153,153,0.00%
tracker.xn--vzyr4p.top,0,0.00%,131,131,0.00%
grouptalk.c2c.qq.com,0,0.00%,130,130,0.00%
torrent.fedoraproject.org,0,0.00%,252,252,0.00%
datascene.net,0,0.00%,144,144,0.00%
open.nyap2p.com,0,0.00%,153,153,0.00%
trackme.theom.nz,0,0.00%,139,139,0.00%
1337.abcvg.info,0,0.00%,403,403,0.00%
torrent.ubuntu.com,0,0.00%,130,130,0.00%
tr.abiir.top,0,0.00%,139,139,0.00%
torrenttracker.nwc.acsalaska.net,0,0.00%,113,113,0.00%
tr.burnabyhighstar.com,0,0.00%,156,156,0.00%
login.tailscale.com,0,0.00%,2707,2707,0.00%
v6-4.nigirocloud.com,0,0.00%,524,524,0.00%
api.blockcypher.com,0,0.00%,652,652,0.00%
time.apple.com,0,0.00%,663,663,0.00%
qb-extension.firebaseio.com,0,0.00%,274,274,0.00%
files.pfsense.org,0,0.00%,131,131,0.00%
dstore-metadata.deepin.cn,0,0.00%,1292,1292,0.00%
messaging.contact-module.ibm.com,0,0.00%,118,118,0.00%
www.bt.cn,0,0.00%,199,199,0.00%
example.org,0,0.00%,3800,3800,0.00%
otheve.beacon.qq.com,0,0.00%,239,239,0.00%
tva4.sinaimg.cn,0,0.00%,103,103,0.00%
tvax1.sinaimg.cn,0,0.00%,222,222,0.00%
szminorshort.weixin.qq.com,0,0.00%,248,248,0.00%
dict.youdao.com,0,0.00%,546,546,0.00%
bitbucket.org,0,0.00%,148,148,0.00%
kdocs.cn,0,0.00%,267,267,0.00%
static-asm.secure.skypeassets.com,0,0.00%,197,197,0.00%
dns.twnic.tw,0,0.00%,189,189,0.00%
motd.ubuntu.com,0,0.00%,639,639,0.00%
tracker.byr.pt,0,0.00%,145,145,0.00%
imap.qq.com,0,0.00%,625,625,0.00%
az667904.vo.msecnd.net,0,0.00%,697,697,0.00%
ssl.ptlogin2.graph.qq.com,0,0.00%,481,481,0.00%
xui.ptlogin2.qq.com,0,0.00%,496,496,0.00%
graph.qq.com,0,0.00%,493,493,0.00%
dns.weixin.qq.com,0,0.00%,478,478,0.00%
az700632.vo.msecnd.net,0,0.00%,568,568,0.00%
dav.qq.com,0,0.00%,177,177,0.00%
analysis-acc-ssl.xunlei.com,0,0.00%,272,272,0.00%
torrent.mp3quran.net,0,0.00%,137,137,0.00%
baibako.tv,0,0.00%,154,154,0.00%
drive.weixin.qq.com,0,0.00%,120,120,0.00%
theodoric.fr,0,0.00%,114,114,0.00%
tracker.parrotsec.org,0,0.00%,147,147,0.00%
prod.detectportal.prod.cloudops.mozgcp.net,0,0.00%,16201,16201,0.00%
btx.anifilm.tv,0,0.00%,142,142,0.00%
tracker.torrentleech.org,0,0.00%,134,134,0.00%
tracker.lilithraws.org,0,0.00%,167,167,0.00%
t.btcland.xyz,0,0.00%,109,109,0.00%
fireworks.eu.org,0,0.00%,113,113,0.00%
v6-2.nigirocloud.com,0,0.00%,508,508,0.00%
v6-1.nigirocloud.com,0,0.00%,511,511,0.00%
v6-3.nigirocloud.com,0,0.00%,496,496,0.00%
t.hdhome.org,0,0.00%,135,135,0.00%
crl.comodoca.com.cdn.cloudflare.net,0,0.00%,100,100,0.00%
cgicol.amap.com,0,0.00%,120,120,0.00%
ins-r23tsuuf.ias.tencent-cloud.net,0,0.00%,147,147,0.00%
static.deepl.com,0,0.00%,375,375,0.00%
secclientgw.alipay.com,0,0.00%,142,142,0.00%
edgedl.me.gvt1.com,0,0.00%,477,477,0.00%
tracker.kuroy.me,0,0.00%,182,182,0.00%
opentracker.cc,0,0.00%,146,146,0.00%
inferno.demonoid.is,0,0.00%,118,118,0.00%
tracker.corpscorp.online,0,0.00%,175,175,0.00%
tracker.loligirl.cn,0,0.00%,114,114,0.00%
tracker.electro-torrent.pl,0,0.00%,171,171,0.00%
h3o2.me,0,0.00%,133,133,0.00%
hub5pr.v6.phub.sandai.net,0,0.00%,620,620,0.00%
gslb.xcloud.sandai.net,0,0.00%,168,168,0.00%
speedtest.snape3058.info,0,0.00%,411,411,0.00%
dual-a-0036.a-msedge.net,0,0.00%,614,614,0.00%
cname.dict.ntes53.netease.com,0,0.00%,145,145,0.00%
dict.ntes53.netease.com,0,0.00%,251,251,0.00%
mpv6.weixin.qq.com,0,0.00%,139,139,0.00%
6-c-0003.c-msedge.net,0,0.00%,291,291,0.00%
stun-h5.qvb.qcloud.com,0,0.00%,223,223,0.00%
tracker-public.tjupt.org,0,0.00%,121,121,0.00%
us.archive.ubuntu.com,0,0.00%,324,324,0.00%
mirrors.fedoraproject.org,0,0.00%,624,624,0.00%
waconafd.officeapps.live.com,0,0.00%,110,110,0.00%
hk-proxy.isrc.ac.cn,0,0.00%,909,909,0.00%
tr.bangumi.moe,0,0.00%,149,149,0.00%
xbtrutor.com,0,0.00%,146,146,0.00%
tracker.kamigami.org,0,0.00%,129,129,0.00%
tracker.exorditech.com.tr,0,0.00%,117,117,0.00%
wwfile.work.weixin.qq.com,0,0.00%,480,480,0.00%
exp.notion.so,0,0.00%,150,150,0.00%
qqdata.ab.qq.com,0,0.00%,152,152,0.00%
archive.ubuntu.com,0,0.00%,152,152,0.00%
marketplace.visualstudio.com,0,0.00%,151,151,0.00%
blackz.ro,0,0.00%,150,150,0.00%
mirrors.nju.edu.cn,0,0.00%,106,106,0.00%
glb.cws.prod.dcat.dsp.trafficmanager.net,0,0.00%,370,370,0.00%
w.wwwww.wtf,0,0.00%,261,261,0.00%
u.wwwww.wtf,0,0.00%,271,271,0.00%
app.vssps.visualstudio.com,0,0.00%,109,109,0.00%
tracker-cdn.moeking.me,0,0.00%,139,139,0.00%
tracker.iriseden.eu,0,0.00%,162,162,0.00%
wx.mail.qq.com,0,0.00%,100,100,0.00%
trk.publictracker.xyz,0,0.00%,135,135,0.00%
inner-all.toutiao-internal-all-v3.lf.bytelb.net,0,0.00%,329,329,0.00%
aloha.maxhub.vip.wsglb0.com,0,0.00%,866,866,0.00%
aloha.maxhub.vip,0,0.00%,386,386,0.00%
l-0007.l-msedge.net,0,0.00%,252,252,0.00%
support.weixin.qq.com,0,0.00%,111,111,0.00%
web.p.qq.com,0,0.00%,151,151,0.00%
cdnjs.cloudflare.com,0,0.00%,134,134,0.00%
api.bitbucket.org,0,0.00%,257,257,0.00%
astat-bugly-tgw4l.mig.tencent-cloud.net,0,0.00%,297,297,0.00%
gbapi.eastmoney.com,0,0.00%,251,251,0.00%
lp.open.weixin.qq.com,0,0.00%,318,318,0.00%
cwx.qlogo.cn,0,0.00%,231,231,0.00%
fe3.delivery.mp.microsoft.com,0,0.00%,121,121,0.00%
tr.abir.ga,0,0.00%,166,166,0.00%
release-75570.gzc.vod.tencent-cloud.com,0,0.00%,239,239,0.00%
www.example.com,0,0.00%,153,153,0.00%
sls.update.microsoft.com,0,0.00%,222,222,0.00%
polyester-dead-5f6.notion.site,0,0.00%,171,171,0.00%
gkaracha.github.io,0,0.00%,122,122,0.00%
v6-zb-alibaba-clould.tengine.alibaba.com.gds.alibabadns.com,0,0.00%,114,114,0.00%
discovery-v6.verysync.cn,0,0.00%,205,205,0.00%
mirror.sjtu.edu.cn,0,0.00%,375,375,0.00%
gz-lb1.internet.v6.spanner.alipaydns.com,0,0.00%,159,159,0.00%
ins-81eqktfa.ias.tencent-cloud.net,0,0.00%,191,191,0.00%
ukibm.ptuu.ga,0,0.00%,104,104,0.00%
api.cloud.189.cn,0,0.00%,309,309,0.00%
shuaitq.github.io,0,0.00%,122,122,0.00%
mail.massimomendola.tk,0,0.00%,122,122,0.00%
home.dedejoker.tk,0,0.00%,122,122,0.00%
api.14pikpak.cf,0,0.00%,122,122,0.00%
04.sendcdn.com,0,0.00%,122,122,0.00%
rr5---sn-aigl6ns6.googlevideo.com,0,0.00%,956,956,0.00%
repo1.coderoot.ml,0,0.00%,122,122,0.00%
