domain,num_aaaa_fail,rate_all,num_aaaa_all,num_aaaa_success,rate_aaaa_fail
www.chinauos.com,9394,16.36%,9394,0,100.00%
www.baidu.com,6103,10.63%,11160,5057,54.69%
hub5p.sandai.net,2191,3.82%,2191,0,100.00%
rq.r9t1.com,1791,3.12%,1791,0,100.00%
connectivity-check.ubuntu.com,1119,1.95%,1119,0,100.00%
optimizationguide-pa.googleapis.com,1080,1.88%,1090,10,99.08%
www.msftncsi.com,896,1.56%,896,0,100.00%
xgpolardb.mysql.polardb.rds.aliyuncs.com,874,1.52%,874,0,100.00%
edragent.sangfor.com.cn,771,1.34%,771,0,100.00%
api.miwifi.com,648,1.13%,648,0,100.00%
note.youdao.com,644,1.12%,644,0,100.00%
yapi.kdsec.org,559,0.97%,559,0,100.00%
daisy.ubuntu.com,480,0.84%,1756,1276,27.33%
safebrowsing.googleapis.com,469,0.82%,475,6,98.74%
settings-win.data.microsoft.com,466,0.81%,466,0,100.00%
x.research.qq.com,422,0.74%,422,0,100.00%
hsk-embed.oray.com,393,0.68%,393,0,100.00%
assets.contentstack.io,372,0.65%,372,0,100.00%
mail.cstnet.cn,363,0.63%,689,326,52.69%
analytics.yinxiang.com,356,0.62%,356,0,100.00%
connectivitycheck.platform.hicloud.com,344,0.60%,683,339,50.37%
retracker.mgts.by,309,0.54%,309,0,100.00%
v10.events.data.microsoft.com,306,0.53%,319,13,95.92%
www.expressapisv2.net,299,0.52%,572,273,52.27%
es.proj217.app.kdsec.org,298,0.52%,298,0,100.00%
ip.42.pl,298,0.52%,298,0,100.00%
retracker.lanta-net.ru,278,0.48%,278,0,100.00%
mirrors.aliyun.com,233,0.41%,246,13,94.72%
self.events.data.microsoft.com,211,0.37%,218,7,96.79%
ctldl.windowsupdate.com,209,0.36%,216,7,96.76%
osfsr.lenovomm.com,209,0.36%,209,0,100.00%
2.ubuntu.pool.ntp.org,202,0.35%,205,3,98.54%
browser.360.cn,200,0.35%,201,1,99.50%
downloads.yoctoproject.org,194,0.34%,194,0,100.00%
api.vc.bilibili.com,190,0.33%,208,18,91.35%
pan.baidu.com,185,0.32%,398,213,46.48%
cu1pehnswss01.servicebus.windows.net,178,0.31%,178,0,100.00%
incoming.telemetry.mozilla.org,177,0.31%,177,0,100.00%
mvgforumtracker.mvgroup.org,170,0.30%,170,0,100.00%
update1.sangfor.net,169,0.29%,169,0,100.00%
duba-defend.zhhainiao.com,164,0.29%,164,0,100.00%
allall01.baidupcs.com,164,0.29%,333,169,49.25%
get.sogou.com,160,0.28%,160,0,100.00%
contile.services.mozilla.com,156,0.27%,156,0,100.00%
www.tribalmixes.com,148,0.26%,148,0,100.00%
clientservices.googleapis.com,143,0.25%,146,3,97.95%
mobile.events.data.microsoft.com,139,0.24%,147,8,94.56%
nj.t.bcsp2p.baidu.com,137,0.24%,137,0,100.00%
www.tvnihon.com,134,0.23%,134,0,100.00%
vortex.data.microsoft.com,133,0.23%,133,0,100.00%
stun.douyucdn.cn,133,0.23%,266,133,50.00%
packages.deepin.com,128,0.22%,128,0,100.00%
www.bit-hdtv.com,126,0.22%,126,0,100.00%
mail.bjtu.edu.cn,123,0.21%,123,0,100.00%
stun1.douyucdn.cn,122,0.21%,122,0,100.00%
ping.pinyin.sogou.com,121,0.21%,121,0,100.00%
android.clients.google.com,121,0.21%,121,0,100.00%
sl-tk.oray.com,117,0.20%,117,0,100.00%
default.exp-tas.com,116,0.20%,239,123,48.54%
ipv4only.arpa,112,0.20%,112,0,100.00%
us-v20.events.data.microsoft.com,110,0.19%,110,0,100.00%
router14.teamviewer.com,108,0.19%,114,6,94.74%
slapi.oray.net,106,0.18%,106,0,100.00%
www.belkin.com,104,0.18%,104,0,100.00%
t.overflow.biz,104,0.18%,104,0,100.00%
shuc-pc-hunt.ksord.com,102,0.18%,102,0,100.00%
c.pcs.baidu.com,101,0.18%,180,79,56.11%
router9.teamviewer.com,98,0.17%,113,15,86.73%
2.centos.pool.ntp.org,97,0.17%,97,0,100.00%
content-autofill.googleapis.com,96,0.17%,99,3,96.97%
play.googleapis.com,96,0.17%,102,6,94.12%
www.yuwabits.net,94,0.16%,94,0,100.00%
tile-service.weather.microsoft.com,89,0.16%,89,0,100.00%
router5.teamviewer.com,89,0.16%,89,0,100.00%
router15.teamviewer.com,89,0.16%,101,12,88.12%
router7.teamviewer.com,82,0.14%,96,14,85.42%
usercount.dockernb.com,79,0.14%,79,0,100.00%
btrace.qq.com,78,0.14%,141,63,55.32%
ntp.sjtu.edu.cn,78,0.14%,78,0,100.00%
pcs-sdk-server.alibaba.com,77,0.13%,124,47,62.10%
accounts.google.com,77,0.13%,81,4,95.06%
router11.teamviewer.com,76,0.13%,80,4,95.00%
git.rancher.io,76,0.13%,325,249,23.38%
mirror.iscas.ac.cn,76,0.13%,76,0,100.00%
router10.teamviewer.com,75,0.13%,89,14,84.27%
router6.teamviewer.com,73,0.13%,77,4,94.81%
mon.zijieapi.com,72,0.13%,72,0,100.00%
router8.teamviewer.com,71,0.12%,90,19,78.89%
sg02.ipv2.xyz,71,0.12%,71,0,100.00%
wup.browser.qq.com,70,0.12%,70,0,100.00%
www.mvgroup.org,68,0.12%,68,0,100.00%
tracker.tasvideos.org,68,0.12%,131,63,51.91%
content-signature-2.cdn.mozilla.net,68,0.12%,152,84,44.74%
p3p.sogou.com,67,0.12%,67,0,100.00%
router13.teamviewer.com,67,0.12%,79,12,84.81%
prom-monitorproxy1.fastsdwan.com,67,0.12%,67,0,100.00%
auth.sangfor.com.cn,66,0.11%,66,0,100.00%
open.tracker.cl,66,0.11%,66,0,100.00%
router16.teamviewer.com,63,0.11%,81,18,77.78%
redirector.gvt1.com,63,0.11%,64,1,98.44%
www.bing.com,62,0.11%,75,13,82.67%
api.snapcraft.io,62,0.11%,62,0,100.00%
router3.teamviewer.com,62,0.11%,69,7,89.86%
router2.teamviewer.com,62,0.11%,68,6,91.18%
login.live.com,61,0.11%,61,0,100.00%
3n.1513ke.ga,61,0.11%,61,0,100.00%
p01330820392.huyacdn.xyz,61,0.11%,61,0,100.00%
loanfin.com.au,61,0.11%,61,0,100.00%
sl-arm2.azure-100.tk,61,0.11%,61,0,100.00%
imap.tgs-mail.de,61,0.11%,61,0,100.00%
panel.cercisnetwork.net,61,0.11%,61,0,100.00%
kt2.pipecandyinc.co,61,0.11%,61,0,100.00%
message.user.camp,61,0.11%,61,0,100.00%
1hkclu.pronetworklink.net,60,0.10%,60,0,100.00%
config.pinyin.sogou.com,59,0.10%,111,52,53.15%
referrals.getambassador.com,59,0.10%,59,0,100.00%
imap.gmail.com,58,0.10%,59,1,98.31%
update.pan.baidu.com,58,0.10%,58,0,100.00%
erickson514-my.sharepoint.com,58,0.10%,58,0,100.00%
router4.teamviewer.com,56,0.10%,56,0,100.00%
router12.teamviewer.com,56,0.10%,59,3,94.92%
api.zotero.org,55,0.10%,55,0,100.00%
alfred.ixiacom.com,55,0.10%,55,0,100.00%
e-0014.e-msedge.net,55,0.10%,55,0,100.00%
femetrics.grammarly.io,54,0.09%,54,0,100.00%
gitee.com,54,0.09%,54,0,100.00%
clients2.google.com,54,0.09%,54,0,100.00%
update.googleapis.com,54,0.09%,57,3,94.74%
ww62.uatracker.net,54,0.09%,54,0,100.00%
arc.msn.com,53,0.09%,53,0,100.00%
atrack.pow7.com,53,0.09%,106,53,50.00%
tr.abirxo.cf,53,0.09%,106,53,50.00%
data.bilibili.com,52,0.09%,98,46,53.06%
clients1.google.com,52,0.09%,54,2,96.30%
h-adashx.ut.taobao.com,52,0.09%,52,0,100.00%
t1.pow7.com,52,0.09%,104,52,50.00%
tuna05.mcddns01.com,52,0.09%,52,0,100.00%
client.wns.windows.com,52,0.09%,92,40,56.52%
d27xxe7juh1us6.cloudfront.net,51,0.09%,101,50,50.50%
softcenter.os3.win.nfschina.com,51,0.09%,51,0,100.00%
bam.nr-data.net,50,0.09%,50,0,100.00%
tracker.fixr.pro,50,0.09%,50,0,100.00%
info.pinyin.sogou.com,49,0.09%,89,40,55.06%
mtalk.google.com,49,0.09%,104,55,47.12%
dldir1.qq.com,48,0.08%,49,1,97.96%
secure.pow7.com,48,0.08%,96,48,50.00%
msg.qy.net,48,0.08%,48,0,100.00%
router1.teamviewer.com,48,0.08%,49,1,97.96%
oth.eve.mdt.qq.com,47,0.08%,47,0,100.00%
firefox.settings.services.mozilla.com,47,0.08%,47,0,100.00%
caldav.163.com,46,0.08%,46,0,100.00%
agt.p.qianxin.com,45,0.08%,45,0,100.00%
www.microsoft.com,45,0.08%,56,11,80.36%
cmrelay-basic-2.nodesub.com,45,0.08%,45,0,100.00%
nexusrules.officeapps.live.com,44,0.08%,85,41,51.76%
sp1.sangfor.com.cn,44,0.08%,44,0,100.00%
registry-1.docker.io,43,0.07%,43,0,100.00%
2535-ipv4e.clump.dprodmgd106.aa-rt.sharepoint.com,43,0.07%,43,0,100.00%
clients4.google.com,42,0.07%,49,7,85.71%
bt.okmp3.ru,42,0.07%,42,0,100.00%
qingcenter.wps.cn,41,0.07%,82,41,50.00%
array504.prod.do.dsp.mp.microsoft.com,41,0.07%,41,0,100.00%
isrc.iscas.ac.cn,40,0.07%,40,0,100.00%
gecko-bd.feishu.cn,40,0.07%,40,0,100.00%
auth.docker.io,39,0.07%,39,0,100.00%
switch.pcfg.cache.wpscdn.cn,39,0.07%,82,43,47.56%
static.asm.skype.com,39,0.07%,39,0,100.00%
123.sogou.com,38,0.07%,38,0,100.00%
cn.bing.com,38,0.07%,43,5,88.37%
frp.zwlin.top,38,0.07%,38,0,100.00%
diskapi.baidu.com,38,0.07%,63,25,60.32%
v20.events.data.microsoft.com,37,0.06%,43,6,86.05%
beacons.gcp.gvt2.com,37,0.06%,38,1,97.37%
v2.get.sogou.com,37,0.06%,37,0,100.00%
q.cnblogs.com,37,0.06%,37,0,100.00%
mini.browser.360.cn,37,0.06%,37,0,100.00%
nk2.boom.skin,37,0.06%,37,0,100.00%
api2.firefoxchina.cn.wswebpic.com,36,0.06%,36,0,100.00%
assets.msn.cn,36,0.06%,36,0,100.00%
vipapi.wps.cn,36,0.06%,36,0,100.00%
d11.baidupcs.com,36,0.06%,36,0,100.00%
az764295.vo.msecnd.net,36,0.06%,36,0,100.00%
v1.go2yd.com,36,0.06%,36,0,100.00%
visualstudio-devdiv-c2s.msedge.net,36,0.06%,36,0,100.00%
hk-4.upjs.xyz,36,0.06%,36,0,100.00%
changer8.net,35,0.06%,35,0,100.00%
ipv6.google.com,35,0.06%,52,17,67.31%
helpdubaclient.ksmobile.com,35,0.06%,35,0,100.00%
mail.iie.ac.cn,34,0.06%,52,18,65.38%
nexus.officeapps.live.com,34,0.06%,34,0,100.00%
d.pcs.baidu.com,34,0.06%,64,30,53.12%
www.googleapis.com,34,0.06%,34,0,100.00%
infoc2.duba.net,34,0.06%,34,0,100.00%
update2.sangfor.net,34,0.06%,34,0,100.00%
ldc.lenovo.com.cn,34,0.06%,34,0,100.00%
cip.cc,34,0.06%,34,0,100.00%
api.tabnine.com,34,0.06%,34,0,100.00%
www.sogou.com,34,0.06%,34,0,100.00%
d.docs.live.net,33,0.06%,42,9,78.57%
tracker.pow7.com,33,0.06%,66,33,50.00%
odoooacnz-my.sharepoint.com,33,0.06%,33,0,100.00%
imap.sina.com,33,0.06%,33,0,100.00%
locprod2-elb-us-west-2.prod.mozaws.net,33,0.06%,33,0,100.00%
yd-02.paofunlink.com,33,0.06%,33,0,100.00%
lp-push-server-253.lastpass.com,32,0.06%,32,0,100.00%
treatment.grammarly.com,32,0.06%,32,0,100.00%
t2.pow7.com,32,0.06%,64,32,50.00%
2.openwrt.pool.ntp.org,32,0.06%,32,0,100.00%
high-frequency-gray.zhhainiao.com,31,0.05%,31,0,100.00%
pub.idqqimg.com,31,0.05%,65,34,47.69%
go.ie.sogou.com,31,0.05%,31,0,100.00%
d2nxq2uap88usk.cloudfront.net,30,0.05%,58,28,51.72%
mmbiz.qpic.cn,30,0.05%,33,3,90.91%
zlxx.v.lxcvc.com,30,0.05%,54,24,55.56%
www.tg5tj2cu.com,30,0.05%,30,0,100.00%
ztxdjj-my.sharepoint.com,30,0.05%,30,0,100.00%
softcenter-all.os.nfschina.com,29,0.05%,29,0,100.00%
hpd.baidu.com,29,0.05%,29,0,100.00%
hub5pnc.sandai.net,29,0.05%,29,0,100.00%
dcldshlupt.alicdn.com,29,0.05%,29,0,100.00%
x1.c.lencr.org,29,0.05%,59,30,49.15%
shcuac.aag436.ccddns.lol,29,0.05%,29,0,100.00%
hectorstatic.baidu.com,28,0.05%,31,3,90.32%
qing.wps.cn,28,0.05%,54,26,51.85%
ipv6.l.google.com,28,0.05%,53,25,52.83%
checkappexec.microsoft.com,28,0.05%,28,0,100.00%
hk4.v2u9.top,28,0.05%,28,0,100.00%
hm.baidu.com,27,0.05%,47,20,57.45%
ris.api.iris.microsoft.com,27,0.05%,27,0,100.00%
h4.trakx.nibba.trade,27,0.05%,27,0,100.00%
rq.wh.cmcm.com,27,0.05%,27,0,100.00%
1min.pcfg.cache.wpscdn.cn,27,0.05%,27,0,100.00%
pc-plugin-plg.wpscdn.cn,27,0.05%,56,29,48.21%
asimov.vortex.data.trafficmanager.net,26,0.05%,26,0,100.00%
search.apps.ubuntu.com,26,0.05%,26,0,100.00%
wdl1.cache.wps.cn,26,0.05%,39,13,66.67%
vdwmto3.bdstatic.com,26,0.05%,27,1,96.30%
c2.pcs.baidu.com,25,0.04%,44,19,56.82%
g.csdnimg.cn,25,0.04%,25,0,100.00%
dc1.ksn.kaspersky-labs.com,25,0.04%,25,0,100.00%
ios.ac.cn,25,0.04%,25,0,100.00%
dss0.bdstatic.com,24,0.04%,24,0,100.00%
pss.bdstatic.com,24,0.04%,26,2,92.31%
translate.google.cn,24,0.04%,47,23,51.06%
share.camoe.cn,24,0.04%,24,0,100.00%
www.a.shifen.com,24,0.04%,46,22,52.17%
mail.google.com,24,0.04%,45,21,53.33%
update3.sangfor.net,24,0.04%,24,0,100.00%
login.partner.microsoftonline.cn,24,0.04%,24,0,100.00%
dc.services.visualstudio.com,23,0.04%,23,0,100.00%
dev.ditu.live.com,23,0.04%,23,0,100.00%
notify.tabnine.com,23,0.04%,23,0,100.00%
github.com,22,0.04%,22,0,100.00%
www.taobao.com,22,0.04%,45,23,48.89%
www.biztorrents.com,22,0.04%,22,0,100.00%
ts1.qq.com,22,0.04%,22,0,100.00%
poll.exmail.qq.com,22,0.04%,22,0,100.00%
geo.wps.cn,22,0.04%,22,0,100.00%
luckyvideo.peopletech.cn,22,0.04%,22,0,100.00%
chpm.sangfor.com.cn,22,0.04%,22,0,100.00%
normandy-cdn.services.mozilla.com,21,0.04%,21,0,100.00%
webrtcpunch.video.qq.com,21,0.04%,21,0,100.00%
www.apple.com,21,0.04%,24,3,87.50%
push.services.mozilla.com,21,0.04%,21,0,100.00%
d20rj4el6vkp4c.cloudfront.net,21,0.04%,42,21,50.00%
sp1.baidu.com,20,0.03%,34,14,58.82%
gimg3.baidu.com,20,0.03%,22,2,90.91%
crl4.digicert.com,20,0.03%,31,11,64.52%
play.google.com,20,0.03%,21,1,95.24%
www.msftconnecttest.com,20,0.03%,20,0,100.00%
www.bitseduce.com,20,0.03%,20,0,100.00%
apphub.aliyuncs.com,20,0.03%,20,0,100.00%
normandy.cdn.mozilla.net,20,0.03%,20,0,100.00%
monorepo-production-edge-alb-985829473.us-east-1.elb.amazonaws.com,20,0.03%,20,0,100.00%
filedownload.lenovo.com,20,0.03%,20,0,100.00%
interface.music.163.com,20,0.03%,20,0,100.00%
developer.unity.cn,20,0.03%,20,0,100.00%
p0.qhimg.com,20,0.03%,23,3,86.96%
array808.prod.do.dsp.mp.microsoft.com,20,0.03%,20,0,100.00%
dup.baidustatic.com,20,0.03%,20,0,100.00%
zt.wps.cn,20,0.03%,20,0,100.00%
vm.gtimg.cn,20,0.03%,20,0,100.00%
console.cloud.google.com,20,0.03%,20,0,100.00%
advanced-cm-2.nodesub.com,20,0.03%,20,0,100.00%
prod.ingestion-edge.prod.dataops.mozgcp.net,19,0.03%,19,0,100.00%
t8.baidu.com,19,0.03%,20,1,95.00%
zhidao.baidu.com,19,0.03%,34,15,55.88%
mobile.pipe.aria.microsoft.com,19,0.03%,24,5,79.17%
api.ultimaker.com,19,0.03%,19,0,100.00%
rs1.qq.com,19,0.03%,19,0,100.00%
huggingface.co,19,0.03%,24,5,79.17%
1-courier.push.apple.com,19,0.03%,19,0,100.00%
nexus-websocket-a.intercom.io,19,0.03%,19,0,100.00%
cm-cn-central-00001.albatross.10086.cn,19,0.03%,19,0,100.00%
sms.wps.cn,19,0.03%,19,0,100.00%
home.wps.cn,19,0.03%,19,0,100.00%
cache.tv.qq.com,19,0.03%,19,0,100.00%
hk1-7.nigirocloud.com,19,0.03%,19,0,100.00%
googlecode.l.googleusercontent.com,19,0.03%,39,20,48.72%
shdf01-iopq.cgroads.com,19,0.03%,19,0,100.00%
yd-01.paofunlink.com,19,0.03%,19,0,100.00%
cn2888.v2free.xyz,19,0.03%,19,0,100.00%
client-api.oray.com,18,0.03%,18,0,100.00%
profile-avatar.csdnimg.cn,18,0.03%,18,0,100.00%
update.todesk.com,18,0.03%,18,0,100.00%
login.microsoftonline.com,18,0.03%,18,0,100.00%
metrics1.data.hicloud.com,18,0.03%,18,0,100.00%
tunnel.cfw.trustedsource.org,18,0.03%,18,0,100.00%
pay.wps.cn,18,0.03%,18,0,100.00%
searchrecommend.kugou.com,18,0.03%,18,0,100.00%
ts2.qq.com,18,0.03%,18,0,100.00%
todolist.redirect.xzdesktop.cqttech.com,18,0.03%,18,0,100.00%
time.windows.com,18,0.03%,18,0,100.00%
download.visualstudio.microsoft.com,18,0.03%,18,0,100.00%
dl.google.com,18,0.03%,18,0,100.00%
www.xilinx.com,18,0.03%,18,0,100.00%
iaas.wps.cn,18,0.03%,18,0,100.00%
roaming.wps.cn,18,0.03%,18,0,100.00%
docer-api.kdocs.cn,18,0.03%,18,0,100.00%
vip.wps.cn,18,0.03%,18,0,100.00%
account.wps.cn,18,0.03%,18,0,100.00%
zw-roaming.wps.cn,18,0.03%,18,0,100.00%
nowpick.nowcoder.com,18,0.03%,18,0,100.00%
smtp.iscas.ac.cn,18,0.03%,18,0,100.00%
db-safe.2345.cc,18,0.03%,18,0,100.00%
cmrelay-basic-1.nodesub.com,18,0.03%,18,0,100.00%
advanced-cm-1.nodesub.com,18,0.03%,18,0,100.00%
adashx.ut.dingtalk.com,17,0.03%,17,0,100.00%
gateway.fe.apple-dns.net,17,0.03%,34,17,50.00%
sp0.baidu.com,17,0.03%,24,7,70.83%
ts1.cn.mm.bing.net,17,0.03%,17,0,100.00%
mainnet.infura.io,17,0.03%,35,18,48.57%
t7.baidu.com,17,0.03%,22,5,77.27%
array507.prod.do.dsp.mp.microsoft.com,17,0.03%,17,0,100.00%
sdk.split.io,17,0.03%,17,0,100.00%
apac-china-courier-4.push-apple.com.akadns.net,17,0.03%,17,0,100.00%
deault-exp-tas-com.e-0014.e-msedge.net,17,0.03%,31,14,54.84%
download.windowsupdate.com,17,0.03%,18,1,94.44%
accscdn.m.taobao.com,17,0.03%,17,0,100.00%
update.wps.cn,17,0.03%,17,0,100.00%
csdnimg.cn,17,0.03%,17,0,100.00%
ksn-file-geo.kaspersky-labs.com,17,0.03%,17,0,100.00%
vasapi.wps.cn,17,0.03%,17,0,100.00%
lucky.wps.cn,17,0.03%,17,0,100.00%
le.wps.cn,17,0.03%,17,0,100.00%
docer.wps.cn,17,0.03%,17,0,100.00%
docer.kdocs.cn,17,0.03%,17,0,100.00%
avatar.qwps.cn,17,0.03%,17,0,100.00%
access.video.qq.com,17,0.03%,17,0,100.00%
nk4.boom.skin,17,0.03%,17,0,100.00%
dual-spo-0004.spo-msedge.net,17,0.03%,17,0,100.00%
detectportal.firefox.com,16,0.03%,292,276,5.48%
ug.baidu.com,16,0.03%,27,11,59.26%
dss1.bdstatic.com,16,0.03%,17,1,94.12%
dd.browser.360.cn,16,0.03%,16,0,100.00%
array806.prod.do.dsp.mp.microsoft.com,16,0.03%,16,0,100.00%
config.i.duba.net,16,0.03%,16,0,100.00%
repo.huaweicloud.com,16,0.03%,16,0,100.00%
d9caa6e02c990b0a.jijifun.com,16,0.03%,16,0,100.00%
hk1-1.nigirocloud.com,16,0.03%,16,0,100.00%
k128-mzstatic.gslb.ksyuncdn.com,16,0.03%,16,0,100.00%
fb98ab9159f51fd0.jijifun.com,16,0.03%,16,0,100.00%
pki-goog.l.google.com,16,0.03%,16,0,100.00%
ds.kaspersky.com,16,0.03%,16,0,100.00%
s.xinshuru.com,16,0.03%,16,0,100.00%
puv.tt.browser.360.cn,15,0.03%,15,0,100.00%
drive.wps.cn,15,0.03%,48,33,31.25%
www.google.com.hk,15,0.03%,25,10,60.00%
go.microsoft.com,15,0.03%,36,21,41.67%
t9.baidu.com,15,0.03%,17,2,88.24%
shortconn.im.qcloud.com,15,0.03%,15,0,100.00%
pc-api.wondershare.cc,15,0.03%,15,0,100.00%
ping.avast.com,15,0.03%,38,23,39.47%
dsp.lenovo.com.cn,15,0.03%,15,0,100.00%
cn-qingdao.axt.aliyun.com,15,0.03%,15,0,100.00%
msgsrv01.oray.net,15,0.03%,15,0,100.00%
qr.wps.cn,15,0.03%,15,0,100.00%
bj.linyeming.pub,15,0.03%,15,0,100.00%
api.bilibili.com,14,0.02%,14,0,100.00%
googleads.g.doubleclick.net,14,0.02%,15,1,93.33%
prod-classifyclient.normandy.prod.cloudops.mozgcp.net,14,0.02%,14,0,100.00%
res.wx.qq.com,14,0.02%,14,0,100.00%
msedge.b.tlu.dl.delivery.mp.microsoft.com,14,0.02%,14,0,100.00%
adservice.google.com,14,0.02%,14,0,100.00%
mcs-bd.feishu.cn,14,0.02%,14,0,100.00%
odobagg-my.sharepoint.com,14,0.02%,14,0,100.00%
rs2.qq.com,14,0.02%,14,0,100.00%
gateway.icloud.com.cn,14,0.02%,14,0,100.00%
www.kanjiantu.com,14,0.02%,14,0,100.00%
update-khd.2345.cc,14,0.02%,14,0,100.00%
ins-g4ztq7u7.ias.tencent-cloud.net,14,0.02%,14,0,100.00%
mail.nfschina.com,14,0.02%,14,0,100.00%
notice.wps.cn,14,0.02%,14,0,100.00%
r4.res.office365.com,14,0.02%,28,14,50.00%
gcr.io,14,0.02%,28,14,50.00%
lz4hlmtcf5.feishu.cn,14,0.02%,14,0,100.00%
dl.ijinshan.com,14,0.02%,14,0,100.00%
autopush.prod.mozaws.net,14,0.02%,14,0,100.00%
ss0.baidu.com,13,0.02%,23,10,56.52%
ss1.baidu.com,13,0.02%,24,11,54.17%
ocsp.digicert.com,13,0.02%,24,11,54.17%
beacon.tingyun.com,13,0.02%,13,0,100.00%
www.msn.cn,13,0.02%,15,2,86.67%
www.sohu.com,13,0.02%,27,14,48.15%
vpn.ios.ac.cn,13,0.02%,13,0,100.00%
socm.dmp.360.cn,13,0.02%,13,0,100.00%
update.cs2c.com.cn,13,0.02%,13,0,100.00%
1595096.sched.d0-dk.tdnsdp1.cn,13,0.02%,26,13,50.00%
2.debian.pool.ntp.org,13,0.02%,20,7,65.00%
cdn-file.ludashi.com,13,0.02%,13,0,100.00%
ocsp2-lb.apple.com.akadns.net,13,0.02%,14,1,92.86%
zhanzhang.toutiao.com,13,0.02%,13,0,100.00%
safebrowsing.urlsec.qq.com,13,0.02%,13,0,100.00%
array802.prod.do.dsp.mp.microsoft.com,13,0.02%,13,0,100.00%
ic.wps.cn,13,0.02%,13,0,100.00%
dw-online.ksosoft.com,13,0.02%,13,0,100.00%
skydrive.wns.windows.com,13,0.02%,23,10,56.52%
vv.video.qq.com,13,0.02%,13,0,100.00%
e4518.dscapi7.akamaiedge.net,12,0.02%,25,13,48.00%
ss3.baidu.com,12,0.02%,20,8,60.00%
t14.baidu.com,12,0.02%,12,0,100.00%
goldengate.grammarly.com,12,0.02%,12,0,100.00%
crl.verisign.com,12,0.02%,24,12,50.00%
ts2.cn.mm.bing.net,12,0.02%,12,0,100.00%
apigate.10jqka.com.cn,12,0.02%,12,0,100.00%
inference.location.live.net,12,0.02%,12,0,100.00%
img-home.csdnimg.cn,12,0.02%,12,0,100.00%
bizapi.csdn.net,12,0.02%,12,0,100.00%
api.msn.com,12,0.02%,23,11,52.17%
api.geetest.com,12,0.02%,12,0,100.00%
opencdnmsdl1.jomodns.com,12,0.02%,12,0,100.00%
upmobile.v.qq.com,12,0.02%,12,0,100.00%
pss.alicdn.com,12,0.02%,12,0,100.00%
shmmsns.qpic.cn,12,0.02%,37,25,32.43%
array506.prod.do.dsp.mp.microsoft.com,12,0.02%,22,10,54.55%
update.code.visualstudio.com,12,0.02%,12,0,100.00%
img.alicdn.com.danuoyi.alicdn.com,12,0.02%,23,11,52.17%
service.fanxing.kugou.com,12,0.02%,22,10,54.55%
connect.unity.cn,12,0.02%,12,0,100.00%
cn-hangzhou.axt.aliyun.com,12,0.02%,12,0,100.00%
cn-beijing.axt.aliyun.com,12,0.02%,12,0,100.00%
cn-hongkong.axt.aliyun.com,12,0.02%,12,0,100.00%
1.courier-sandbox-push-apple.com.akadns.net,12,0.02%,12,0,100.00%
usa1v2.jsssline.top,12,0.02%,12,0,100.00%
d3pi17oyma2pxs.cloudfront.net,12,0.02%,12,0,100.00%
www.n1ui5fms.net,12,0.02%,12,0,100.00%
rscloud.rising.net.cn,12,0.02%,12,0,100.00%
evoke-windowsservices-tas.msedge.net,12,0.02%,12,0,100.00%
r3.o.lencr.org,12,0.02%,27,15,44.44%
honeycomb.wps.cn,12,0.02%,12,0,100.00%
cs22.wpc.v0cdn.net,12,0.02%,12,0,100.00%
cv.duba.net,12,0.02%,12,0,100.00%
dlied6.qq.com,12,0.02%,12,0,100.00%
www.i0rp1l2j.com,12,0.02%,12,0,100.00%
pico.eset.com,12,0.02%,12,0,100.00%
global.quickconnect.cn,12,0.02%,12,0,100.00%
tsfe.trafficshaping.dsp.mp.microsoft.com,12,0.02%,12,0,100.00%
fm.dl.126.net,12,0.02%,12,0,100.00%
browser6.qhimg.com,12,0.02%,12,0,100.00%
log.cmbchina.com,12,0.02%,12,0,100.00%
nk1.boom.skin,12,0.02%,12,0,100.00%
nk6.boom.skin,12,0.02%,12,0,100.00%
assets.msn.com,12,0.02%,12,0,100.00%
pagead2.googlesyndication.com,11,0.02%,11,0,100.00%
api.apple-cloudkit.com,11,0.02%,11,0,100.00%
api.apple-cloudkit.fe.apple-dns.net,11,0.02%,11,0,100.00%
mbd.baidu.com,11,0.02%,11,0,100.00%
ss2.baidu.com,11,0.02%,18,7,61.11%
pcrec.baidu.com,11,0.02%,16,5,68.75%
ioshost.qtlcdn.com,11,0.02%,22,11,50.00%
crteam.cn,11,0.02%,11,0,100.00%
imap.mail.me.com.akadns.net,11,0.02%,11,0,100.00%
apis.live.net,11,0.02%,11,0,100.00%
img-blog.csdnimg.cn,11,0.02%,11,0,100.00%
sadownload.mcafee.com,11,0.02%,11,0,100.00%
apple.com,11,0.02%,11,0,100.00%
functional.events.data.microsoft.com,11,0.02%,12,1,91.67%
admin.kdsec.org,11,0.02%,11,0,100.00%
serviceplus.phytium.com.cn,11,0.02%,11,0,100.00%
packages.microsoft.com,11,0.02%,11,0,100.00%
2.pool.ntp.org,11,0.02%,22,11,50.00%
www.gsd92gov.com,11,0.02%,11,0,100.00%
task.browser.360.cn,11,0.02%,11,0,100.00%
ntp4.aliyun.com,11,0.02%,11,0,100.00%
catalog.gamepass.com,11,0.02%,22,11,50.00%
ryrc.ruijienetworks.com,11,0.02%,11,0,100.00%
help-tower.2345.cc,11,0.02%,11,0,100.00%
zj-roaming.wps.cn,11,0.02%,11,0,100.00%
d33vwaa6rdensn.cloudfront.net,11,0.02%,11,0,100.00%
targetednotifications-tm.trafficmanager.net,11,0.02%,11,0,100.00%
hw-web-player-tracker.biliapi.net,10,0.02%,10,0,100.00%
yun.tim.qq.com,10,0.02%,10,0,100.00%
cloud.browser.360.cn,10,0.02%,10,0,100.00%
fclick.baidu.com,10,0.02%,10,0,100.00%
b.bdstatic.com,10,0.02%,11,1,90.91%
fc1tn.baidu.com,10,0.02%,10,0,100.00%
ecn.dev.ditu.live.com,10,0.02%,10,0,100.00%
honeycomb.wpscdn.cn,10,0.02%,20,10,50.00%
f5-ck.zhhainiao.com,10,0.02%,10,0,100.00%
mini.360.cn,10,0.02%,13,3,76.92%
blog.csdn.net,10,0.02%,10,0,100.00%
img-blog.csdn.net,10,0.02%,10,0,100.00%
profile.csdnimg.cn,10,0.02%,10,0,100.00%
kv501.prod.do.dsp.mp.microsoft.com,10,0.02%,10,0,100.00%
proxy.client.163.com,10,0.02%,10,0,100.00%
g.api.mega.co.nz,10,0.02%,46,36,21.74%
mathpix.com,10,0.02%,17,7,58.82%
www.163.com,10,0.02%,22,12,45.45%
push.thanos.ams.eulix.xyz,10,0.02%,10,0,100.00%
mam.netease.com,10,0.02%,10,0,100.00%
0.cn.pool.ntp.org,10,0.02%,10,0,100.00%
m701.music.126.net.w.alikunlun.com,10,0.02%,12,2,83.33%
disc601.prod.do.dsp.mp.microsoft.com,10,0.02%,10,0,100.00%
pc-plugin.wpscdn.cn,10,0.02%,10,0,100.00%
c.go-mpulse.net,10,0.02%,20,10,50.00%
t.acg.rip,10,0.02%,10,0,100.00%
cloud.streamsets.com,10,0.02%,10,0,100.00%
stream.zotero.org,10,0.02%,19,9,52.63%
common-geo.ha.1drv.com,10,0.02%,10,0,100.00%
mccontacts.mail.163.com,10,0.02%,10,0,100.00%
sqm.telemetry.microsoft.com,10,0.02%,10,0,100.00%
filedownload.csw.lenovo.com,10,0.02%,10,0,100.00%
update100.sangfor.com.cn,10,0.02%,22,12,45.45%
t.helper.2345.cc,10,0.02%,10,0,100.00%
docs2.gtimg.com,10,0.02%,10,0,100.00%
download.docker.com,10,0.02%,14,4,71.43%
37.courier-push-apple.com.akadns.net,10,0.02%,10,0,100.00%
api.onedrive.com,10,0.02%,19,9,52.63%
blades.aliyun.com,10,0.02%,10,0,100.00%
onedsblobprdcus17.centralus.cloudapp.azure.com,10,0.02%,10,0,100.00%
cs9.wac.phicdn.net,9,0.02%,17,8,52.94%
filetracker.xyz,9,0.02%,15,6,60.00%
broadcast.chat.bilibili.com,9,0.02%,9,0,100.00%
ms.bdimg.com,9,0.02%,9,0,100.00%
gsp0.baidu.com,9,0.02%,9,0,100.00%
passport.baidu.com,9,0.02%,15,6,60.00%
vinci.ie.sogou.com,9,0.02%,9,0,100.00%
t15.baidu.com,9,0.02%,10,1,90.00%
pos.baidu.com,9,0.02%,9,0,100.00%
tconf.b.qianxin.com,9,0.02%,9,0,100.00%
www.google.com,9,0.02%,75,66,12.00%
silkroad.csdn.net,9,0.02%,9,0,100.00%
token.services.mozilla.com,9,0.02%,9,0,100.00%
c.msn.cn,9,0.02%,9,0,100.00%
drive.wpsdns.com,9,0.02%,28,19,32.14%
a1887.dscq.akamai.net,9,0.02%,14,5,64.29%
l2.hiwifi.com,9,0.02%,9,0,100.00%
3.pool.ntp.org,9,0.02%,9,0,100.00%
www.wshifen.com,9,0.02%,9,0,100.00%
mail.126.com,9,0.02%,9,0,100.00%
api.mathpix.com,9,0.02%,9,0,100.00%
mirrors.163.com,9,0.02%,9,0,100.00%
alive.github.com,9,0.02%,9,0,100.00%
dashenga.com,9,0.02%,9,0,100.00%
img0yjvjvvuvw.cdn.cache102.xyz,9,0.02%,9,0,100.00%
remind.api.weibo.com,9,0.02%,18,9,50.00%
softbus-device.wps.cn,9,0.02%,9,0,100.00%
client.teamviewer.com,9,0.02%,9,0,100.00%
mubu.com,9,0.02%,9,0,100.00%
t.undefined-site.top,9,0.02%,9,0,100.00%
array606.prod.do.dsp.mp.microsoft.com,9,0.02%,9,0,100.00%
2.cn.pool.ntp.org,9,0.02%,9,0,100.00%
res.ldmnq.com,9,0.02%,9,0,100.00%
aus5.mozilla.org,9,0.02%,9,0,100.00%
us3.edge.boom.skin,9,0.02%,9,0,100.00%
ntemp19.boom.skin,9,0.02%,9,0,100.00%
njc.boom.skin,9,0.02%,9,0,100.00%
nk8.boom.skin,9,0.02%,9,0,100.00%
pop.ie.sogou.com,9,0.02%,9,0,100.00%
clients6.google.com,9,0.02%,10,1,90.00%
pr.x.hub.sandai.net,9,0.02%,9,0,100.00%
imap.163.com,9,0.02%,9,0,100.00%
vpn.oceanum.cn,9,0.02%,9,0,100.00%
registry.npmmirror.com,8,0.01%,8,0,100.00%
firebaselogging-pa.googleapis.com,8,0.01%,11,3,72.73%
bvc.bilivideo.com,8,0.01%,8,0,100.00%
ocsp.entrust.net,8,0.01%,16,8,50.00%
officeclient.microsoft.com,8,0.01%,8,0,100.00%
miao.baidu.com,8,0.01%,8,0,100.00%
rm.api.weibo.com,8,0.01%,13,5,61.54%
emoji.qpic.cn,8,0.01%,8,0,100.00%
api.github.com,8,0.01%,8,0,100.00%
filehouse.zhhainiao.com,8,0.01%,8,0,100.00%
search-operate.cdn.bcebos.com,8,0.01%,8,0,100.00%
tt.browser.360.cn,8,0.01%,8,0,100.00%
position.csdnimg.cn,8,0.01%,8,0,100.00%
partner.googleadservices.com,8,0.01%,8,0,100.00%
papi.funshion.com,8,0.01%,8,0,100.00%
geo.prod.do.dsp.mp.microsoft.com,8,0.01%,9,1,88.89%
evalai.cn,8,0.01%,8,0,100.00%
dtapp-pub.dingtalk.com,8,0.01%,8,0,100.00%
bt2.archive.org,8,0.01%,16,8,50.00%
alpha-cloud-log.cn-hangzhou.log.aliyuncs.com,8,0.01%,8,0,100.00%
geover.prod.do.dsp.mp.microsoft.com,8,0.01%,8,0,100.00%
df.cache.wpscdn.cn,8,0.01%,13,5,61.54%
qdyn.wps.cn,8,0.01%,8,0,100.00%
azwcus1-client-s.gateway.messenger.live.com,8,0.01%,8,0,100.00%
0.pool.ntp.org,8,0.01%,8,0,100.00%
1.pool.ntp.org,8,0.01%,8,0,100.00%
m701.music.126.net,8,0.01%,8,0,100.00%
adashx.m.taobao.com,8,0.01%,8,0,100.00%
beacons.gvt2.com,8,0.01%,16,8,50.00%
docs.google.com,8,0.01%,14,6,57.14%
1-courier.sandbox.push.apple.com,8,0.01%,8,0,100.00%
mm.ilovescholar.xyz,8,0.01%,8,0,100.00%
newsie.2345.com,8,0.01%,8,0,100.00%
upload.fp.measure.office.com,8,0.01%,16,8,50.00%
www.overleaf.com,8,0.01%,8,0,100.00%
update.os.nfschina.com,8,0.01%,8,0,100.00%
tracker.pussytorrents.org,8,0.01%,12,4,66.67%
webquoteklinepic.eastmoney.com,8,0.01%,8,0,100.00%
shavar.prod.mozaws.net,8,0.01%,8,0,100.00%
tm-sdk.platinumai.net,8,0.01%,8,0,100.00%
services.addons.mozilla.org,8,0.01%,8,0,100.00%
versioncheck-bg.addons.mozilla.org,8,0.01%,8,0,100.00%
us4.edge.boom.skin,8,0.01%,8,0,100.00%
n57.boom.skin,8,0.01%,8,0,100.00%
n43.boom.skin,8,0.01%,8,0,100.00%
n37.boom.skin,8,0.01%,8,0,100.00%
n48.boom.skin,8,0.01%,8,0,100.00%
n110.boom.skin,8,0.01%,8,0,100.00%
nk3.boom.skin,8,0.01%,8,0,100.00%
nj1.boom.skin,8,0.01%,8,0,100.00%
nj3.boom.skin,8,0.01%,8,0,100.00%
njb.boom.skin,8,0.01%,8,0,100.00%
nje.boom.skin,8,0.01%,8,0,100.00%
n61.boom.skin,8,0.01%,8,0,100.00%
n05.boom.skin,8,0.01%,8,0,100.00%
us9.edge.boom.skin,8,0.01%,8,0,100.00%
us2.edge.boom.skin,8,0.01%,8,0,100.00%
jp2.boom.skin,8,0.01%,8,0,100.00%
n111.boom.skin,8,0.01%,8,0,100.00%
jp6.boom.skin,8,0.01%,8,0,100.00%
n93.boom.skin,8,0.01%,8,0,100.00%
jp19.boom.skin,8,0.01%,8,0,100.00%
n115.boom.skin,8,0.01%,8,0,100.00%
jp8.boom.skin,8,0.01%,8,0,100.00%
jp12.boom.skin,8,0.01%,8,0,100.00%
jp14.boom.skin,8,0.01%,8,0,100.00%
nn2.boom.skin,8,0.01%,8,0,100.00%
jp9.boom.skin,8,0.01%,8,0,100.00%
jp1.boom.skin,8,0.01%,8,0,100.00%
jp3.boom.skin,8,0.01%,8,0,100.00%
jp5.boom.skin,8,0.01%,8,0,100.00%
nn12.boom.skin,8,0.01%,8,0,100.00%
opt12.boom.skin,8,0.01%,8,0,100.00%
opt17.boom.skin,8,0.01%,8,0,100.00%
app.smartmailcloud.com,8,0.01%,8,0,100.00%
ksn-tcert-geo.kaspersky-labs.com,8,0.01%,8,0,100.00%
mx.cstnet.cn,8,0.01%,8,0,100.00%
s1.url.cn,8,0.01%,8,0,100.00%
datarouter.ol.epicgames.com,8,0.01%,8,0,100.00%
s1.hdslb.com,7,0.01%,7,0,100.00%
t-safe.2345.com,7,0.01%,7,0,100.00%
t.khd.2345.cc,7,0.01%,7,0,100.00%
midinfo.baofeng.com,7,0.01%,7,0,100.00%
dss2.bdstatic.com,7,0.01%,7,0,100.00%
tieba.baidu.com,7,0.01%,9,2,77.78%
ss1.bdstatic.com,7,0.01%,7,0,100.00%
t10.baidu.com,7,0.01%,8,1,87.50%
eclick.baidu.com,7,0.01%,7,0,100.00%
tracker.darmowy-torrent.pl,7,0.01%,7,0,100.00%
www.qq.com,7,0.01%,93,86,7.53%
cn.overleaf.com,7,0.01%,7,0,100.00%
msg.csdn.net,7,0.01%,7,0,100.00%
fp.msedge.net,7,0.01%,7,0,100.00%
array614.prod.do.dsp.mp.microsoft.com,7,0.01%,7,0,100.00%
push.hicloud.com,7,0.01%,7,0,100.00%
msedge.api.cdp.microsoft.com,7,0.01%,13,6,53.85%
hp3.mail.netease.com,7,0.01%,7,0,100.00%
readpaper.com,7,0.01%,7,0,100.00%
1.ubuntu.pool.ntp.org,7,0.01%,7,0,100.00%
router-default.apps.openshift4.gnome.org,7,0.01%,12,5,58.33%
notify.adobe.io,7,0.01%,7,0,100.00%
mask-api.icloud.com,7,0.01%,7,0,100.00%
data.hicloud.com,7,0.01%,7,0,100.00%
notify3.note.youdao.com,7,0.01%,13,6,53.85%
3.asia.pool.ntp.org,7,0.01%,7,0,100.00%
0.asia.pool.ntp.org,7,0.01%,7,0,100.00%
public-cdn.cloud.unitychina.cn,7,0.01%,7,0,100.00%
e6858.e19.s.tl88.net,7,0.01%,7,0,100.00%
exmail.qq.com,7,0.01%,7,0,100.00%
push2.eastmoney.com,7,0.01%,12,5,58.33%
ns3.cstnet.cn,7,0.01%,7,0,100.00%
prod.nexusrules.live.com.akadns.net,7,0.01%,13,6,53.85%
mail.163.com,7,0.01%,7,0,100.00%
services.gfe.nvidia.com,7,0.01%,7,0,100.00%
help.origin-apple.com.akadns.net,7,0.01%,7,0,100.00%
dyn.wps.cn,7,0.01%,7,0,100.00%
pushtrs.push.hicloud.com,7,0.01%,7,0,100.00%
info.lenovo.com.cn,7,0.01%,7,0,100.00%
color.docer.wps.cn,7,0.01%,7,0,100.00%
kv601.prod.do.dsp.mp.microsoft.com,7,0.01%,7,0,100.00%
cn-sh.sasg4e.ccddns.lol,7,0.01%,7,0,100.00%
ts4.cn.mm.bing.net,7,0.01%,7,0,100.00%
tracker4.itzmx.com,7,0.01%,13,6,53.85%
n119.boom.skin,7,0.01%,7,0,100.00%
s100.boom.skin,7,0.01%,7,0,100.00%
ntemp03.boom.skin,7,0.01%,7,0,100.00%
n47.boom.skin,7,0.01%,7,0,100.00%
ntemp17.boom.skin,7,0.01%,7,0,100.00%
ntemp08.boom.skin,7,0.01%,7,0,100.00%
ntemp04.boom.skin,7,0.01%,7,0,100.00%
ntemp05.boom.skin,7,0.01%,7,0,100.00%
n04.boom.skin,7,0.01%,7,0,100.00%
ntemp06.boom.skin,7,0.01%,7,0,100.00%
ntemp07.boom.skin,7,0.01%,7,0,100.00%
n54.boom.skin,7,0.01%,7,0,100.00%
n21.boom.skin,7,0.01%,7,0,100.00%
n23.boom.skin,7,0.01%,7,0,100.00%
n24.boom.skin,7,0.01%,7,0,100.00%
n28.boom.skin,7,0.01%,7,0,100.00%
ntemp20.boom.skin,7,0.01%,7,0,100.00%
ntemp18.boom.skin,7,0.01%,7,0,100.00%
ntemp10.boom.skin,7,0.01%,7,0,100.00%
n32.boom.skin,7,0.01%,7,0,100.00%
ntemp15.boom.skin,7,0.01%,7,0,100.00%
ntemp01.boom.skin,7,0.01%,7,0,100.00%
n62.boom.skin,7,0.01%,7,0,100.00%
n06.boom.skin,7,0.01%,7,0,100.00%
n116.boom.skin,7,0.01%,7,0,100.00%
ntemp16.boom.skin,7,0.01%,7,0,100.00%
ntemp09.boom.skin,7,0.01%,7,0,100.00%
n22.boom.skin,7,0.01%,7,0,100.00%
ntemp02.boom.skin,7,0.01%,7,0,100.00%
s102.boom.skin,7,0.01%,7,0,100.00%
s103.boom.skin,7,0.01%,7,0,100.00%
nm2.boom.skin,7,0.01%,7,0,100.00%
s104.boom.skin,7,0.01%,7,0,100.00%
s105.boom.skin,7,0.01%,7,0,100.00%
s01.boom.skin,7,0.01%,7,0,100.00%
n17.boom.skin,7,0.01%,7,0,100.00%
n30.boom.skin,7,0.01%,7,0,100.00%
n96.boom.skin,7,0.01%,7,0,100.00%
n11.boom.skin,7,0.01%,7,0,100.00%
n09.boom.skin,7,0.01%,7,0,100.00%
n13.boom.skin,7,0.01%,7,0,100.00%
n27.boom.skin,7,0.01%,7,0,100.00%
n63.boom.skin,7,0.01%,7,0,100.00%
n92.boom.skin,7,0.01%,7,0,100.00%
n77.boom.skin,7,0.01%,7,0,100.00%
n60.boom.skin,7,0.01%,7,0,100.00%
ntemp25.boom.skin,7,0.01%,7,0,100.00%
n100.boom.skin,7,0.01%,7,0,100.00%
n114.boom.skin,7,0.01%,7,0,100.00%
nk7.boom.skin,7,0.01%,7,0,100.00%
nf1.boom.skin,7,0.01%,7,0,100.00%
nf2.boom.skin,7,0.01%,7,0,100.00%
nf3.boom.skin,7,0.01%,7,0,100.00%
nk5.boom.skin,7,0.01%,7,0,100.00%
nf4.boom.skin,7,0.01%,7,0,100.00%
nf5.boom.skin,7,0.01%,7,0,100.00%
nf6.boom.skin,7,0.01%,7,0,100.00%
nf7.boom.skin,7,0.01%,7,0,100.00%
nf8.boom.skin,7,0.01%,7,0,100.00%
nf9.boom.skin,7,0.01%,7,0,100.00%
n170.boom.skin,7,0.01%,7,0,100.00%
nf11.boom.skin,7,0.01%,7,0,100.00%
nf10.boom.skin,7,0.01%,7,0,100.00%
nj4.boom.skin,7,0.01%,7,0,100.00%
nj2.boom.skin,7,0.01%,7,0,100.00%
nj5.boom.skin,7,0.01%,7,0,100.00%
nj6.boom.skin,7,0.01%,7,0,100.00%
nj7.boom.skin,7,0.01%,7,0,100.00%
nj8.boom.skin,7,0.01%,7,0,100.00%
nja.boom.skin,7,0.01%,7,0,100.00%
nj9.boom.skin,7,0.01%,7,0,100.00%
njd.boom.skin,7,0.01%,7,0,100.00%
nk9.boom.skin,7,0.01%,7,0,100.00%
nka.boom.skin,7,0.01%,7,0,100.00%
nkb.boom.skin,7,0.01%,7,0,100.00%
nkd.boom.skin,7,0.01%,7,0,100.00%
nkc.boom.skin,7,0.01%,7,0,100.00%
nke.boom.skin,7,0.01%,7,0,100.00%
nl2.boom.skin,7,0.01%,7,0,100.00%
nl1.boom.skin,7,0.01%,7,0,100.00%
nl3.boom.skin,7,0.01%,7,0,100.00%
nl4.boom.skin,7,0.01%,7,0,100.00%
nl5.boom.skin,7,0.01%,7,0,100.00%
nl6.boom.skin,7,0.01%,7,0,100.00%
nl7.boom.skin,7,0.01%,7,0,100.00%
nl9.boom.skin,7,0.01%,7,0,100.00%
nla.boom.skin,7,0.01%,7,0,100.00%
s101.boom.skin,7,0.01%,7,0,100.00%
nl8.boom.skin,7,0.01%,7,0,100.00%
n67.boom.skin,7,0.01%,7,0,100.00%
n74.boom.skin,7,0.01%,7,0,100.00%
us8.edge.boom.skin,7,0.01%,7,0,100.00%
us5.edge.boom.skin,7,0.01%,7,0,100.00%
us6.edge.boom.skin,7,0.01%,7,0,100.00%
us7.edge.boom.skin,7,0.01%,7,0,100.00%
nm1.boom.skin,7,0.01%,7,0,100.00%
us1.edge.boom.skin,7,0.01%,7,0,100.00%
us10.edge.boom.skin,7,0.01%,7,0,100.00%
nm3.boom.skin,7,0.01%,7,0,100.00%
nm4.boom.skin,7,0.01%,7,0,100.00%
nm5.boom.skin,7,0.01%,7,0,100.00%
nm6.boom.skin,7,0.01%,7,0,100.00%
nm7.boom.skin,7,0.01%,7,0,100.00%
nma.boom.skin,7,0.01%,7,0,100.00%
nmb.boom.skin,7,0.01%,7,0,100.00%
nm9.boom.skin,7,0.01%,7,0,100.00%
nmc.boom.skin,7,0.01%,7,0,100.00%
nm8.boom.skin,7,0.01%,7,0,100.00%
nmd.boom.skin,7,0.01%,7,0,100.00%
n117.boom.skin,7,0.01%,7,0,100.00%
jp15.boom.skin,7,0.01%,7,0,100.00%
jp16.boom.skin,7,0.01%,7,0,100.00%
jp17.boom.skin,7,0.01%,7,0,100.00%
jp18.boom.skin,7,0.01%,7,0,100.00%
jp20.boom.skin,7,0.01%,7,0,100.00%
jp7.boom.skin,7,0.01%,7,0,100.00%
jp10.boom.skin,7,0.01%,7,0,100.00%
jp11.boom.skin,7,0.01%,7,0,100.00%
jp13.boom.skin,7,0.01%,7,0,100.00%
nn1.boom.skin,7,0.01%,7,0,100.00%
nn3.boom.skin,7,0.01%,7,0,100.00%
nn4.boom.skin,7,0.01%,7,0,100.00%
nn5.boom.skin,7,0.01%,7,0,100.00%
nn6.boom.skin,7,0.01%,7,0,100.00%
nn7.boom.skin,7,0.01%,7,0,100.00%
opt7.boom.skin,7,0.01%,7,0,100.00%
jp4.boom.skin,7,0.01%,7,0,100.00%
nn14.boom.skin,7,0.01%,7,0,100.00%
nn8.boom.skin,7,0.01%,7,0,100.00%
nn9.boom.skin,7,0.01%,7,0,100.00%
nna.boom.skin,7,0.01%,7,0,100.00%
nn11.boom.skin,7,0.01%,7,0,100.00%
opt6.boom.skin,7,0.01%,7,0,100.00%
opt15.boom.skin,7,0.01%,7,0,100.00%
opt21.boom.skin,7,0.01%,7,0,100.00%
nn13.boom.skin,7,0.01%,7,0,100.00%
opt22.boom.skin,7,0.01%,7,0,100.00%
opt23.boom.skin,7,0.01%,7,0,100.00%
opt24.boom.skin,7,0.01%,7,0,100.00%
opt25.boom.skin,7,0.01%,7,0,100.00%
opt26.boom.skin,7,0.01%,7,0,100.00%
opt8.boom.skin,7,0.01%,7,0,100.00%
opt9.boom.skin,7,0.01%,7,0,100.00%
opt2.boom.skin,7,0.01%,7,0,100.00%
opt11.boom.skin,7,0.01%,7,0,100.00%
opt10.boom.skin,7,0.01%,7,0,100.00%
opt13.boom.skin,7,0.01%,7,0,100.00%
opt1.boom.skin,7,0.01%,7,0,100.00%
opt14.boom.skin,7,0.01%,7,0,100.00%
opt20.boom.skin,7,0.01%,7,0,100.00%
opt4.boom.skin,7,0.01%,7,0,100.00%
opt3.boom.skin,7,0.01%,7,0,100.00%
opt5.boom.skin,7,0.01%,7,0,100.00%
opt16.boom.skin,7,0.01%,7,0,100.00%
opt19.boom.skin,7,0.01%,7,0,100.00%
opt18.boom.skin,7,0.01%,7,0,100.00%
smartscreen-prod.microsoft.com,7,0.01%,7,0,100.00%
50.push2his.eastmoney.com,7,0.01%,7,0,100.00%
pinyin.thunisoft.com,7,0.01%,7,0,100.00%
ssxd.mediav.com,7,0.01%,7,0,100.00%
outlook.gogo66.cloud,7,0.01%,15,8,46.67%
hotfix.lenovo.com.cn,7,0.01%,7,0,100.00%
beacons2.gvt2.com,7,0.01%,7,0,100.00%
array511.prod.do.dsp.mp.microsoft.com,7,0.01%,7,0,100.00%
passport.bilibili.com,6,0.01%,6,0,100.00%
www.bilibili.com,6,0.01%,7,1,85.71%
static.hdslb.com,6,0.01%,6,0,100.00%
upos-sz-mirrorhw.bilivideo.com,6,0.01%,6,0,100.00%
registry.npm.taobao.org,6,0.01%,6,0,100.00%
pgw-tel-cld-sl.alicdn.com,6,0.01%,6,0,100.00%
translate.googleapis.com,6,0.01%,6,0,100.00%
t11.baidu.com,6,0.01%,7,1,85.71%
sp2.baidu.com,6,0.01%,11,5,54.55%
t12.baidu.com,6,0.01%,6,0,100.00%
fc-ccimage.baidu.com,6,0.01%,6,0,100.00%
substrate.office.com,6,0.01%,14,8,42.86%
opencdnbd.jomodns.com,6,0.01%,8,2,75.00%
st.todesk.com,6,0.01%,6,0,100.00%
beacons3.gvt2.com,6,0.01%,6,0,100.00%
www.csdn.net,6,0.01%,6,0,100.00%
c-msn-com-nsatc.trafficmanager.net,6,0.01%,6,0,100.00%
aegis.qq.com,6,0.01%,18,12,33.33%
gateway.icloud.com,6,0.01%,9,3,66.67%
easylist-downloads.adblockplus.org,6,0.01%,11,5,54.55%
onedsblobprdcus16.centralus.cloudapp.azure.com,6,0.01%,6,0,100.00%
cm.bilibili.com,6,0.01%,6,0,100.00%
windows.msn.cn,6,0.01%,8,2,75.00%
browser.events.data.msn.cn,6,0.01%,8,2,75.00%
d3ra9679oeq3gx.cloudfront.net,6,0.01%,6,0,100.00%
array513.prod.do.dsp.mp.microsoft.com,6,0.01%,13,7,46.15%
www.jetbrains.com,6,0.01%,10,4,60.00%
uapi.mp.360.cn,6,0.01%,6,0,100.00%
archive.ubuntukylin.com,6,0.01%,6,0,100.00%
doh.zjurl.cn,6,0.01%,6,0,100.00%
high-frequency-gray-cdn.duba.net,6,0.01%,6,0,100.00%
file.drivergenius.com,6,0.01%,6,0,100.00%
bugreport.huorong.cn,6,0.01%,26,20,23.08%
cdn.cvws.apple-dns.net,6,0.01%,13,7,46.15%
crl.certum.pl,6,0.01%,13,7,46.15%
am.abc.wdpdk.link,6,0.01%,6,0,100.00%
contentsec.ac.cn,6,0.01%,6,0,100.00%
array615.prod.do.dsp.mp.microsoft.com,6,0.01%,6,0,100.00%
ntp.aliyun.com,6,0.01%,6,0,100.00%
visualstudio-devdiv-c2s-msedge-net.e-0009.e-msedge.net,6,0.01%,6,0,100.00%
e11290.dspg.akamaiedge.net,6,0.01%,12,6,50.00%
ssl.gstatic.com,6,0.01%,16,10,37.50%
notifier-configs.airbrake.io,6,0.01%,13,7,46.15%
dpi.networkorder.komect.com,6,0.01%,6,0,100.00%
winatp-gw-cus3.microsoft.com,6,0.01%,6,0,100.00%
tracker.bitsearch.to,6,0.01%,9,3,66.67%
rinkeby.infura.io,6,0.01%,6,0,100.00%
tracker1.myporn.club,6,0.01%,9,3,66.67%
us2-4.nigirocloud.com,6,0.01%,6,0,100.00%
us3-2.nigirocloud.com,6,0.01%,6,0,100.00%
us3-5.nigirocloud.com,6,0.01%,6,0,100.00%
us3-8.nigirocloud.com,6,0.01%,6,0,100.00%
hk1-2.nigirocloud.com,6,0.01%,6,0,100.00%
bugly.qq.com,6,0.01%,6,0,100.00%
e13678.ca2.s.tl88.net,6,0.01%,6,0,100.00%
datacluster2.cipsup.cn,6,0.01%,6,0,100.00%
ocsp2.apple.com,6,0.01%,7,1,85.71%
ocsp.apple.com.download.ks-cdn.com,6,0.01%,6,0,100.00%
location.services.mozilla.com,6,0.01%,6,0,100.00%
api-std.sunlogin.oray.com,6,0.01%,6,0,100.00%
kunpeng.csdn.net,6,0.01%,6,0,100.00%
statistic.csdn.net,6,0.01%,6,0,100.00%
redisdatarecall.csdn.net,6,0.01%,6,0,100.00%
tracking.miui.com,6,0.01%,6,0,100.00%
d.skconf.f.360.cn,6,0.01%,6,0,100.00%
upos-sz-mirrorhwo1.bilivideo.com,6,0.01%,8,2,75.00%
mesu.apple.com,6,0.01%,11,5,54.55%
account.sogou.com,6,0.01%,6,0,100.00%
pc.profile.pinyin.sogou.com,6,0.01%,6,0,100.00%
profile.pinyin.sogou.com,6,0.01%,6,0,100.00%
s.deepl.com,6,0.01%,6,0,100.00%
onedriveclucprodbn20049.blob.core.windows.net,6,0.01%,6,0,100.00%
skydrivesync.policies.live.net,6,0.01%,6,0,100.00%
dc1-pp.ksn.kaspersky-labs.com,6,0.01%,6,0,100.00%
openapp.wpscdn.cn,6,0.01%,12,6,50.00%
wdl1.file.cache.docer.com,6,0.01%,8,2,75.00%
msgcenter.wps.cn,6,0.01%,6,0,100.00%
list.wallpaper.cloud.duba.net,6,0.01%,6,0,100.00%
ups.ksmobile.net,6,0.01%,11,5,54.55%
wss.tim.qq.com,6,0.01%,6,0,100.00%
waconatm.officeapps.live.com,6,0.01%,6,0,100.00%
api.atlassian.com,6,0.01%,6,0,100.00%
dig.feishu.cn,6,0.01%,6,0,100.00%
array510.prod.do.dsp.mp.microsoft.com,6,0.01%,6,0,100.00%
app.jianguoyun.com,6,0.01%,6,0,100.00%
repo.mysql.com,6,0.01%,6,0,100.00%
fs.microsoft.com,6,0.01%,6,0,100.00%
www.nowcoder.com,6,0.01%,6,0,100.00%
tile-service.weather.msn.cn,6,0.01%,6,0,100.00%
beacons-handoff.gcp.gvt2.com,6,0.01%,6,0,100.00%
ocsp.pki.goog,6,0.01%,6,0,100.00%
logs-01.loggly.com,6,0.01%,6,0,100.00%
author.baidu.com,6,0.01%,6,0,100.00%
array508.prod.do.dsp.mp.microsoft.com,6,0.01%,6,0,100.00%
safebrowsing.googleapis-cn.com,6,0.01%,12,6,50.00%
settings-prod-eus2-2.eastus2.cloudapp.azure.com,6,0.01%,6,0,100.00%
dig.bdurl.net,6,0.01%,6,0,100.00%
steamcdn-a.akamaihd.net,6,0.01%,6,0,100.00%
array501.prod.do.dsp.mp.microsoft.com,6,0.01%,6,0,100.00%
yt.droid.ac.cn,6,0.01%,6,0,100.00%
ow1.res.office365.com,6,0.01%,6,0,100.00%
i2.hdslb.com,5,0.01%,12,7,41.67%
i1.hdslb.com,5,0.01%,13,8,38.46%
firebaseinstallations.googleapis.com,5,0.01%,5,0,100.00%
upos-sz-mirrorcos.bilivideo.com,5,0.01%,9,4,55.56%
api.live.bilibili.com,5,0.01%,6,1,83.33%
smarturl.sync.maxthon.cn,5,0.01%,5,0,100.00%
prod.fus.aws.intellij.net,5,0.01%,5,0,100.00%
cronus.ie.sogou.com,5,0.01%,5,0,100.00%
wn.pos.baidu.com,5,0.01%,5,0,100.00%
sdkserver-drcn.op.dbankcloud.cn,5,0.01%,5,0,100.00%
cs.dds.microsoft.com,5,0.01%,5,0,100.00%
roaming.officeapps.live.com,5,0.01%,5,0,100.00%
anv.duba.net,5,0.01%,5,0,100.00%
btrace.video.qq.com,5,0.01%,5,0,100.00%
d2kaokxjvx18eu.cloudfront.net,5,0.01%,5,0,100.00%
opencdnglobalv6.jomodns.com,5,0.01%,6,1,83.33%
cdn.wwads.cn,5,0.01%,5,0,100.00%
time-ios.g.aaplimg.com,5,0.01%,5,0,100.00%
app.huabao.360.cn,5,0.01%,8,3,62.50%
pic4.zhimg.com,5,0.01%,5,0,100.00%
ip1880706122.funshion.com,5,0.01%,5,0,100.00%
profile.accounts.firefox.com,5,0.01%,5,0,100.00%
gameplay.intel.com,5,0.01%,11,6,45.45%
m.qpic.cn,5,0.01%,8,3,62.50%
rs-ny.rustdesk.com,5,0.01%,5,0,100.00%
yuri.app.kdsec.org,5,0.01%,5,0,100.00%
cdn.fwupd.org,5,0.01%,5,0,100.00%
weather.kjjs.360.cn,5,0.01%,5,0,100.00%
kns.duba.net,5,0.01%,5,0,100.00%
dgapi.zhhainiao.com,5,0.01%,5,0,100.00%
pcw-api.iqiyi.com,5,0.01%,10,5,50.00%
microsoftgraph.chinacloudapi.cn,5,0.01%,5,0,100.00%
upd2.sangfor.com.cn,5,0.01%,5,0,100.00%
update-drcn.platform.hicloud.com,5,0.01%,5,0,100.00%
ledger.bt.co,5,0.01%,5,0,100.00%
gateway.fe.apple-dns.cn,5,0.01%,5,0,100.00%
d1ykf07e75w7ss.cloudfront.net,5,0.01%,5,0,100.00%
bgpv4.music.ntes53.netease.com,5,0.01%,5,0,100.00%
ocsp.sca1b.amazontrust.com,5,0.01%,5,0,100.00%
vpn1.bjfu.edu.cn,5,0.01%,5,0,100.00%
cntr.wps.cn,5,0.01%,5,0,100.00%
1.courier-push-apple.com.akadns.net,5,0.01%,5,0,100.00%
long.iwifi.360.cn,5,0.01%,5,0,100.00%
pgyapi.oray.net,5,0.01%,5,0,100.00%
api.openweathermap.org,5,0.01%,5,0,100.00%
os2-7.nigirocloud.com,5,0.01%,5,0,100.00%
nl1-1.nigirocloud.com,5,0.01%,5,0,100.00%
nl1-2.nigirocloud.com,5,0.01%,5,0,100.00%
us2-1.nigirocloud.com,5,0.01%,5,0,100.00%
us3-1.nigirocloud.com,5,0.01%,5,0,100.00%
us3-3.nigirocloud.com,5,0.01%,5,0,100.00%
us3-6.nigirocloud.com,5,0.01%,5,0,100.00%
us3-7.nigirocloud.com,5,0.01%,5,0,100.00%
www.jos.org.cn,5,0.01%,5,0,100.00%
code.eulix.xyz,5,0.01%,5,0,100.00%
mumu.nie.netease.com,5,0.01%,10,5,50.00%
hk1-6.nigirocloud.com,5,0.01%,5,0,100.00%
hk1-5.nigirocloud.com,5,0.01%,5,0,100.00%
hk1-8.nigirocloud.com,5,0.01%,5,0,100.00%
au1-3.nigirocloud.com,5,0.01%,5,0,100.00%
au1-2.nigirocloud.com,5,0.01%,5,0,100.00%
au2-4.nigirocloud.com,5,0.01%,5,0,100.00%
de1-4.nigirocloud.com,5,0.01%,5,0,100.00%
ty2-6.nigirocloud.com,5,0.01%,5,0,100.00%
ty2-7.nigirocloud.com,5,0.01%,5,0,100.00%
os1-2.nigirocloud.com,5,0.01%,5,0,100.00%
os1-7.nigirocloud.com,5,0.01%,5,0,100.00%
os1-8.nigirocloud.com,5,0.01%,5,0,100.00%
os2-2.nigirocloud.com,5,0.01%,5,0,100.00%
os2-3.nigirocloud.com,5,0.01%,5,0,100.00%
nl3-4.nigirocloud.com,5,0.01%,5,0,100.00%
74.push2his.eastmoney.com,5,0.01%,5,0,100.00%
webquotepic.eastmoney.com,5,0.01%,5,0,100.00%
datacluster3.cipsup.cn,5,0.01%,5,0,100.00%
datacluster4.cipsup.cn,5,0.01%,5,0,100.00%
xp.apple.com,5,0.01%,7,2,71.43%
e8218.dscb1.akamaiedge.net,5,0.01%,10,5,50.00%
init.push.apple.com,5,0.01%,10,5,50.00%
e4518.dscapi7.akamaiedge.net.0.1.cn.akamaiedge.net,5,0.01%,10,5,50.00%
migration-geo-filter-prd.stargate.cse.ss-inf.net,5,0.01%,5,0,100.00%
www.tnas.online,5,0.01%,5,0,100.00%
f-log-extension.grammarly.io,5,0.01%,5,0,100.00%
ocsp05.actalis.it,5,0.01%,5,0,100.00%
us-west-las-5.openssl3.com,5,0.01%,5,0,100.00%
video.yidianzixun.com,5,0.01%,5,0,100.00%
discovery-v4-1.verysync.cn,5,0.01%,5,0,100.00%
nl3-5.nigirocloud.com,5,0.01%,5,0,100.00%
nl1-7.nigirocloud.com,5,0.01%,5,0,100.00%
nl3-1.nigirocloud.com,5,0.01%,5,0,100.00%
nl3-2.nigirocloud.com,5,0.01%,5,0,100.00%
nl3-3.nigirocloud.com,5,0.01%,5,0,100.00%
nl3-6.nigirocloud.com,5,0.01%,5,0,100.00%
uk1-2.nigirocloud.com,5,0.01%,5,0,100.00%
th.bing.com,5,0.01%,5,0,100.00%
www.h3c.com.cn,5,0.01%,5,0,100.00%
service.weather.msn.cn,5,0.01%,5,0,100.00%
webquotestaticpic.dfcfw.com,5,0.01%,5,0,100.00%
dl.pop.www.duba.net,5,0.01%,5,0,100.00%
a.w.bilicdn1.com,5,0.01%,6,1,83.33%
software.drivergenius.com,5,0.01%,5,0,100.00%
array509.prod.do.dsp.mp.microsoft.com,5,0.01%,5,0,100.00%
evolwallpaper-api.papegames.cn,5,0.01%,5,0,100.00%
device.sangfor.com.cn,5,0.01%,5,0,100.00%
aka.ms,5,0.01%,5,0,100.00%
discovery.razerapi.com,5,0.01%,5,0,100.00%
manifest.razerapi.com,5,0.01%,5,0,100.00%
onedscolprdweu00.westeurope.cloudapp.azure.com,5,0.01%,5,0,100.00%
www.zhihu.com,5,0.01%,10,5,50.00%
helpdubaservice.ksmobile.com,5,0.01%,5,0,100.00%
ws-keyboard.shouji.sogou.com,5,0.01%,5,0,100.00%
zhihu-web-analytics.zhihu.com,5,0.01%,6,1,83.33%
d31qbv1cthcecs.cloudfront.net,5,0.01%,5,0,100.00%
space.bilibili.com,4,0.01%,4,0,100.00%
security.bilibili.com,4,0.01%,4,0,100.00%
app-measurement.com,4,0.01%,9,5,44.44%
soup.v.qq.com,4,0.01%,4,0,100.00%
opentracker.xyz,4,0.01%,299,295,1.34%
lhpay.gzcl999.com,4,0.01%,4,0,100.00%
i.snssdk.com,4,0.01%,4,0,100.00%
tsearch.snssdk.com,4,0.01%,4,0,100.00%
translate.google.com,4,0.01%,5,1,80.00%
dlswbr.baidu.com,4,0.01%,4,0,100.00%
sfp.safe.baidu.com,4,0.01%,4,0,100.00%
resources.jetbrains.com,4,0.01%,7,3,57.14%
bkssl.bdimg.com,4,0.01%,7,3,57.14%
0.debian.pool.ntp.org,4,0.01%,4,0,100.00%
debug.anuson.com,4,0.01%,4,0,100.00%
api.weibo.cn,4,0.01%,12,8,33.33%
vweixinf.tc.qq.com,4,0.01%,9,5,44.44%
s346.s2022.xyz,4,0.01%,4,0,100.00%
restapi.amap.com,4,0.01%,4,0,100.00%
licensing.mp.microsoft.com,4,0.01%,4,0,100.00%
activity.windows.com,4,0.01%,4,0,100.00%
report.idqqimg.com,4,0.01%,4,0,100.00%
sbeacon.sina.com.cn,4,0.01%,4,0,100.00%
passport.escience.cn,4,0.01%,4,0,100.00%
live.github.com,4,0.01%,4,0,100.00%
arms-retcode.aliyuncs.com,4,0.01%,4,0,100.00%
tpc.googlesyndication.com,4,0.01%,6,2,66.67%
stun.hitv.com,4,0.01%,4,0,100.00%
k-ring.msedge.net,4,0.01%,4,0,100.00%
video-hw-drcn.dbankcdn.cn,4,0.01%,8,4,50.00%
transit1.wslog.chinanetcenter.com,4,0.01%,4,0,100.00%
xpgw-xcdn.youku.com,4,0.01%,4,0,100.00%
su.ff.avast.com,4,0.01%,4,0,100.00%
windows.jingyeqian.com,4,0.01%,4,0,100.00%
blobcollector.events.data.trafficmanager.NET,4,0.01%,4,0,100.00%
bam.nr-data.net.cdn.cloudflare.net,4,0.01%,4,0,100.00%
f7.baidu.com,4,0.01%,5,1,80.00%
stcglobal.beisen.com,4,0.01%,4,0,100.00%
proxy.sogou.com,4,0.01%,4,0,100.00%
tracker.moeblog.cn,4,0.01%,18,14,22.22%
orange-pcsafe.2345.cc,4,0.01%,4,0,100.00%
classify-client.services.mozilla.com,4,0.01%,4,0,100.00%
p2.shared.global.fastly.net,4,0.01%,4,0,100.00%
umwatson.events.data.microsoft.com,4,0.01%,6,2,66.67%
ocsp.verisign.com,4,0.01%,8,4,50.00%
sf.symcd.com,4,0.01%,10,6,40.00%
fsigns.duba.net,4,0.01%,4,0,100.00%
time.ys7.com,4,0.01%,4,0,100.00%
onedriveclucproddm20008.blob.core.windows.net,4,0.01%,4,0,100.00%
imap-mail.outlook.com,4,0.01%,11,7,36.36%
newvip.duba.net,4,0.01%,4,0,100.00%
auth.hiwifi.com,4,0.01%,4,0,100.00%
music.163.com,4,0.01%,11,7,36.36%
cdn.jsdelivr.net,4,0.01%,7,3,57.14%
hao.lenovo.com.cn,4,0.01%,4,0,100.00%
cloud-rest.lenovomm.com,4,0.01%,4,0,100.00%
nsl.lenovo.com.cn,4,0.01%,4,0,100.00%
array601.prod.do.dsp.mp.microsoft.com,4,0.01%,4,0,100.00%
k8s.gcr.io,4,0.01%,9,5,44.44%
array811.prod.do.dsp.mp.microsoft.com,4,0.01%,4,0,100.00%
us-sandbox-courier-4.push-apple.com.akadns.net,4,0.01%,4,0,100.00%
pis-pcdn.youku.com,4,0.01%,4,0,100.00%
ncc.avast.com,4,0.01%,8,4,50.00%
www.mi.com,4,0.01%,8,4,50.00%
1.debian.pool.ntp.org,4,0.01%,4,0,100.00%
flbgpi.meiquankongjian.com,4,0.01%,4,0,100.00%
vscode-sync.trafficmanager.net,4,0.01%,4,0,100.00%
us2-2.nigirocloud.com,4,0.01%,4,0,100.00%
us3-4.nigirocloud.com,4,0.01%,4,0,100.00%
www.asdjkljfjaowjfq.net,4,0.01%,4,0,100.00%
ty1-3.nigirocloud.com,4,0.01%,4,0,100.00%
hk1-3.nigirocloud.com,4,0.01%,4,0,100.00%
au1-1.nigirocloud.com,4,0.01%,4,0,100.00%
au2-1.nigirocloud.com,4,0.01%,4,0,100.00%
de1-1.nigirocloud.com,4,0.01%,4,0,100.00%
de1-3.nigirocloud.com,4,0.01%,4,0,100.00%
de2-1.nigirocloud.com,4,0.01%,4,0,100.00%
de2-3.nigirocloud.com,4,0.01%,4,0,100.00%
ee1-1.nigirocloud.com,4,0.01%,4,0,100.00%
ee1-2.nigirocloud.com,4,0.01%,4,0,100.00%
ee1-4.nigirocloud.com,4,0.01%,4,0,100.00%
ty1-4.nigirocloud.com,4,0.01%,4,0,100.00%
ty2-1.nigirocloud.com,4,0.01%,4,0,100.00%
ty2-2.nigirocloud.com,4,0.01%,4,0,100.00%
ty2-3.nigirocloud.com,4,0.01%,4,0,100.00%
us1-2.nigirocloud.com,4,0.01%,4,0,100.00%
us1-4.nigirocloud.com,4,0.01%,4,0,100.00%
us2-3.nigirocloud.com,4,0.01%,4,0,100.00%
ty2-8.nigirocloud.com,4,0.01%,4,0,100.00%
os1-1.nigirocloud.com,4,0.01%,4,0,100.00%
os1-3.nigirocloud.com,4,0.01%,4,0,100.00%
ty1-2.nigirocloud.com,4,0.01%,4,0,100.00%
os1-6.nigirocloud.com,4,0.01%,4,0,100.00%
os2-5.nigirocloud.com,4,0.01%,4,0,100.00%
os2-4.nigirocloud.com,4,0.01%,4,0,100.00%
os2-1.nigirocloud.com,4,0.01%,4,0,100.00%
nl1-3.nigirocloud.com,4,0.01%,4,0,100.00%
nl1-6.nigirocloud.com,4,0.01%,4,0,100.00%
64.push2his.eastmoney.com,4,0.01%,4,0,100.00%
35.push2his.eastmoney.com,4,0.01%,4,0,100.00%
45.push2his.eastmoney.com,4,0.01%,4,0,100.00%
weather-data.apple.com,4,0.01%,7,3,57.14%
download.jetbrains.com.cn,4,0.01%,7,3,57.14%
xp.itunes-apple.com.akadns.net,4,0.01%,4,0,100.00%
iplc-ji.mielink-dns2.com,4,0.01%,4,0,100.00%
load-balancing-system.cmy-dns.com,4,0.01%,4,0,100.00%
new.weibo.cn,4,0.01%,4,0,100.00%
apple-finance.query.yahoo.com,4,0.01%,4,0,100.00%
o324374.ingest.sentry.io,4,0.01%,4,0,100.00%
api-iam.intercom.io,4,0.01%,4,0,100.00%
gspe1-ssl.ls.apple.com,4,0.01%,4,0,100.00%
emoji.qpic.cn.sched.legopic1.tdnsv6.com,4,0.01%,4,0,100.00%
hcdnv.bili.gslb.c.cdnhwc2.com,4,0.01%,4,0,100.00%
upos-sz-mirrorali.bilivideo.com,4,0.01%,4,0,100.00%
configsvr.msf.3g.qq.com,4,0.01%,4,0,100.00%
kt-prod.ess.apple.com,4,0.01%,4,0,100.00%
pinyin.sogou.com,4,0.01%,4,0,100.00%
input.shouji.sogou.com,4,0.01%,4,0,100.00%
bsg.w.bilicdn1.com,4,0.01%,4,0,100.00%
clientnotification-userprodea1-1.servicebus.windows.net,4,0.01%,4,0,100.00%
www.tm.a.prd.aadg.akadns.NET,4,0.01%,4,0,100.00%
qzonestyle.gtimg.cn,4,0.01%,4,0,100.00%
version.gitlab.com,4,0.01%,4,0,100.00%
dl.vas.wpscdn.cn,4,0.01%,8,4,50.00%
cdnpcwallpaper.zhhainiao.com,4,0.01%,4,0,100.00%
au.download.windowsupdate.com,4,0.01%,4,0,100.00%
pcfg.wps.cn,4,0.01%,4,0,100.00%
pdf-file.pdfxd.com,4,0.01%,4,0,100.00%
d19h5bl8fn71bo.cloudfront.net,4,0.01%,4,0,100.00%
ieonlinews.microsoft.com,4,0.01%,6,2,66.67%
acdc-direct.office.com,4,0.01%,8,4,50.00%
res.u-tools.cn,4,0.01%,4,0,100.00%
update.qnap.com,4,0.01%,4,0,100.00%
open.qurl.f.360.cn,4,0.01%,4,0,100.00%
onedscolprdeus13.eastus.cloudapp.azure.com,4,0.01%,4,0,100.00%
14.tlu.dl.delivery.mp.microsoft.com,4,0.01%,4,0,100.00%
210194c475687be6.jijifun.com,4,0.01%,4,0,100.00%
8d0968d6458e0ad0.jijifun.com,4,0.01%,4,0,100.00%
hk1-4.nigirocloud.com,4,0.01%,4,0,100.00%
au1-4.nigirocloud.com,4,0.01%,4,0,100.00%
au2-3.nigirocloud.com,4,0.01%,4,0,100.00%
ty1-1.nigirocloud.com,4,0.01%,4,0,100.00%
ty2-5.nigirocloud.com,4,0.01%,4,0,100.00%
os1-4.nigirocloud.com,4,0.01%,4,0,100.00%
nl1-4.nigirocloud.com,4,0.01%,4,0,100.00%
nl3-7.nigirocloud.com,4,0.01%,4,0,100.00%
nl3-8.nigirocloud.com,4,0.01%,4,0,100.00%
uk1-1.nigirocloud.com,4,0.01%,4,0,100.00%
uk1-4.nigirocloud.com,4,0.01%,4,0,100.00%
10.push2his.eastmoney.com,4,0.01%,4,0,100.00%
11.push2his.eastmoney.com,4,0.01%,4,0,100.00%
47.push2his.eastmoney.com,4,0.01%,4,0,100.00%
dc1-st.ksn.kaspersky-labs.com,4,0.01%,4,0,100.00%
diskapi.n.shifen.com,4,0.01%,8,4,50.00%
array512.prod.do.dsp.mp.microsoft.com,4,0.01%,4,0,100.00%
package-search.services.jetbrains.com,4,0.01%,8,4,50.00%
sdkapp.uve.weibo.com,4,0.01%,4,0,100.00%
events.gfe.nvidia.com,4,0.01%,4,0,100.00%
msfwifi.3g.qq.com,4,0.01%,4,0,100.00%
inappcheck-lb.itunes-apple.com.akadns.net,4,0.01%,6,2,66.67%
cmshow.gtimg.cn,4,0.01%,4,0,100.00%
path2.xtracloud.net,4,0.01%,4,0,100.00%
3.ubuntu.pool.ntp.org,4,0.01%,4,0,100.00%
0.ubuntu.pool.ntp.org,4,0.01%,4,0,100.00%
mbsug.ssl.so.com,4,0.01%,4,0,100.00%
proxy.whaledata.com,4,0.01%,4,0,100.00%
ts.helper.2345.cc,4,0.01%,4,0,100.00%
update.haozip.2345.com,4,0.01%,4,0,100.00%
s3m7.fenxi.com,4,0.01%,4,0,100.00%
conn2.oppomobile.com,4,0.01%,4,0,100.00%
ex01.ios.ac.cn,4,0.01%,4,0,100.00%
outlook.office.com,4,0.01%,7,3,57.14%
docs.gtimg.com,4,0.01%,10,6,40.00%
api.wondercv.com,4,0.01%,4,0,100.00%
internal-api-lark-api.feishu.cn,4,0.01%,4,0,100.00%
36-courier.push.apple.com,4,0.01%,4,0,100.00%
httpdns.n.netease.com,4,0.01%,4,0,100.00%
ini.update.360safe.com,4,0.01%,4,0,100.00%
www.liebao.cn,4,0.01%,4,0,100.00%
pancake.apple.com,4,0.01%,4,0,100.00%
pool.ntp.org,4,0.01%,4,0,100.00%
dcagent.mecdn.synacast.com,4,0.01%,4,0,100.00%
int.dpool.sina.com.cn,4,0.01%,4,0,100.00%
ocsp.digicert.cn,4,0.01%,4,0,100.00%
bt1.archive.org,4,0.01%,8,4,50.00%
71.push2his.eastmoney.com,4,0.01%,4,0,100.00%
69.push2his.eastmoney.com,4,0.01%,4,0,100.00%
updates.os.nfschina.com,4,0.01%,4,0,100.00%
union.video.qq.com,4,0.01%,4,0,100.00%
nodeyun.video.qq.com,4,0.01%,4,0,100.00%
flux.iqiyi.com,4,0.01%,4,0,100.00%
gaode-jmacs.m.taobao.com,4,0.01%,4,0,100.00%
www.arkcomputing.com.cn,4,0.01%,4,0,100.00%
extie.sogoucdn.com,4,0.01%,4,0,100.00%
baidubox-emoji.cdn.bcebos.com,4,0.01%,4,0,100.00%
gimg4.baidu.com,4,0.01%,4,0,100.00%
baijiahao.baidu.com,4,0.01%,4,0,100.00%
ext.baidu.com,4,0.01%,4,0,100.00%
top.baidu.com,4,0.01%,4,0,100.00%
b0.bdstatic.com,4,0.01%,4,0,100.00%
max-l.mediav.com,4,0.01%,4,0,100.00%
httpdns.kwd.inkuai.com,4,0.01%,4,0,100.00%
s.360.cn,4,0.01%,4,0,100.00%
e11408.d.akamaiedge.net,4,0.01%,4,0,100.00%
xsts.auth.xboxlive.com,4,0.01%,4,0,100.00%
bl3301.storage.live.com,4,0.01%,6,2,66.67%
ftp.ext.hp.com,4,0.01%,4,0,100.00%
miserupdate.aliyun.com,4,0.01%,4,0,100.00%
onedriveclucprodbn20005.blob.core.windows.net,4,0.01%,4,0,100.00%
httpsdns.baidu.com,4,0.01%,4,0,100.00%
dotserver.douyucdn.cn,4,0.01%,4,0,100.00%
gms.razersynapse.com,4,0.01%,4,0,100.00%
chi01pap002.storage.live.com,4,0.01%,7,3,57.14%
onedriveclucprodbn20048.blob.core.windows.net,4,0.01%,4,0,100.00%
appcfg.v.qq.com,4,0.01%,4,0,100.00%
www.update.microsoft.com,4,0.01%,4,0,100.00%
upload-va.synacast.com,4,0.01%,4,0,100.00%
29-courier.push.apple.com,4,0.01%,4,0,100.00%
sp3.sangfor.com.cn,4,0.01%,4,0,100.00%
sp2.sangfor.com.cn,4,0.01%,4,0,100.00%
mesh.if.iqiyi.com,4,0.01%,4,0,100.00%
livenet.video.iqiyi.com,4,0.01%,4,0,100.00%
policy.video.iqiyi.com,4,0.01%,10,6,40.00%
www.zhixi.com,4,0.01%,4,0,100.00%
s.bbm0v.cn,4,0.01%,4,0,100.00%
luas.im.ke.com,4,0.01%,4,0,100.00%
federatedml-pa.googleapis.com,4,0.01%,4,0,100.00%
p211-caldav.icloud.com.cn,4,0.01%,4,0,100.00%
info.52pcfree.com,4,0.01%,4,0,100.00%
api.mousegesturesapi.com,4,0.01%,4,0,100.00%
capi.grammarly.com,4,0.01%,4,0,100.00%
picx.zhimg.com,4,0.01%,6,2,66.67%
pic1.zhimg.com,4,0.01%,6,2,66.67%
pic2.zhimg.com,4,0.01%,4,0,100.00%
pic3.zhimg.com,4,0.01%,6,2,66.67%
ftp.hp.com,4,0.01%,4,0,100.00%
fengling.7654.com,4,0.01%,4,0,100.00%
bnz07pap001.storage.live.com,4,0.01%,4,0,100.00%
data.eastmoney.com,4,0.01%,8,4,50.00%
quote.eastmoney.com,4,0.01%,8,4,50.00%
open.kuaishouzt.com,4,0.01%,4,0,100.00%
data.grammarly.com,4,0.01%,4,0,100.00%
p1-play.edge4k.com,4,0.01%,4,0,100.00%
weather-api.extfans.com,4,0.01%,4,0,100.00%
zhushou.huihui.cn,4,0.01%,4,0,100.00%
update.eset.com,4,0.01%,4,0,100.00%
trakx.herokuapp.com,4,0.01%,4,0,100.00%
r3---sn-2x3elnee.gvt1.com,4,0.01%,4,0,100.00%
onedscolprdcus05.centralus.cloudapp.azure.com,4,0.01%,9,5,44.44%
n.clarity.ms,4,0.01%,4,0,100.00%
stdtime.gov.hk,4,0.01%,4,0,100.00%
at.alicdn.com,3,0.01%,4,1,75.00%
i0.hdslb.com,3,0.01%,8,5,37.50%
sv.symcb.com,3,0.01%,6,3,50.00%
caldav.fe.apple-dns.cn,3,0.01%,3,0,100.00%
weibo.cn,3,0.01%,6,3,50.00%
myip.opendns.com,3,0.01%,5,2,60.00%
www.wenxm.cn,3,0.01%,3,0,100.00%
22-courier.push.apple.com,3,0.01%,3,0,100.00%
nsclick.baidu.com,3,0.01%,3,0,100.00%
hector.baidu.com,3,0.01%,3,0,100.00%
tb5.bdstatic.com,3,0.01%,3,0,100.00%
tb3.bdstatic.com,3,0.01%,3,0,100.00%
tb1.bdstatic.com,3,0.01%,3,0,100.00%
imgsa.baidu.com,3,0.01%,3,0,100.00%
als.baidu.com,3,0.01%,3,0,100.00%
tb2.bdstatic.com,3,0.01%,3,0,100.00%
cpro.baidustatic.com,3,0.01%,6,3,50.00%
sofire.baidu.com,3,0.01%,5,2,60.00%
gomediago.baidu.com,3,0.01%,3,0,100.00%
mediago-static.cdn.bcebos.com,3,0.01%,3,0,100.00%
wan.sogou.com,3,0.01%,3,0,100.00%
t13.baidu.com,3,0.01%,4,1,75.00%
id.google.com,3,0.01%,3,0,100.00%
fe2cr.update.microsoft.com,3,0.01%,10,7,30.00%
d2335eacoaawg9.cloudfront.net,3,0.01%,3,0,100.00%
onedscolprdcus06.centralus.cloudapp.azure.com,3,0.01%,3,0,100.00%
www.gstatic.com,3,0.01%,3,0,100.00%
extshort.weixin.qq.com,3,0.01%,79,76,3.80%
common-us.onedrive.akadns.net,3,0.01%,3,0,100.00%
ip2091219971.funshion.com,3,0.01%,3,0,100.00%
compiles.overleaf.com,3,0.01%,3,0,100.00%
s1.symcb.com,3,0.01%,5,2,60.00%
sslbaiduv6.jomodns.com,3,0.01%,4,1,75.00%
opencdnbdcharon.jomodns.com,3,0.01%,4,1,75.00%
seapp.stat.360safe.com,3,0.01%,3,0,100.00%
a-0001.a-msedge.net,3,0.01%,6,3,50.00%
267.bshl.ieplgia9929.net,3,0.01%,3,0,100.00%
g.live.com,3,0.01%,7,4,42.86%
se.360.cn,3,0.01%,6,3,50.00%
outlook.office365.com,3,0.01%,7,4,42.86%
token.r53-2.services.mozilla.com,3,0.01%,3,0,100.00%
api.accounts.firefox.com,3,0.01%,3,0,100.00%
waws-prod-sg1-057-feea.southeastasia.cloudapp.azure.com,3,0.01%,3,0,100.00%
wx1.sinaimg.cn,3,0.01%,10,7,30.00%
wx3.sinaimg.cn,3,0.01%,7,4,42.86%
rs-sg.rustdesk.com,3,0.01%,3,0,100.00%
dataflow.biliapi.com,3,0.01%,5,2,60.00%
ali-bj-pcdn-30.biliapi.net,3,0.01%,3,0,100.00%
crl3.digicert.com,3,0.01%,5,2,60.00%
szmmsns.qpic.cn,3,0.01%,7,4,42.86%
ssl.google-analytics.com,3,0.01%,6,3,50.00%
vaiwan.com,3,0.01%,3,0,100.00%
dss3.bdstatic.com,3,0.01%,3,0,100.00%
safebrowsing.google.com,3,0.01%,3,0,100.00%
gates.grammarly.com,3,0.01%,3,0,100.00%
array608.prod.do.dsp.mp.microsoft.com,3,0.01%,3,0,100.00%
3.debian.pool.ntp.org,3,0.01%,3,0,100.00%
rs-cn.rustdesk.com,3,0.01%,3,0,100.00%
cdn.onenote.net,3,0.01%,6,3,50.00%
os2-8.nigirocloud.com,3,0.01%,3,0,100.00%
au2-2.nigirocloud.com,3,0.01%,3,0,100.00%
de1-2.nigirocloud.com,3,0.01%,3,0,100.00%
de2-2.nigirocloud.com,3,0.01%,3,0,100.00%
de2-4.nigirocloud.com,3,0.01%,3,0,100.00%
ee1-3.nigirocloud.com,3,0.01%,3,0,100.00%
us1-1.nigirocloud.com,3,0.01%,3,0,100.00%
ty2-4.nigirocloud.com,3,0.01%,3,0,100.00%
us1-3.nigirocloud.com,3,0.01%,3,0,100.00%
os2-6.nigirocloud.com,3,0.01%,3,0,100.00%
nl1-5.nigirocloud.com,3,0.01%,3,0,100.00%
42.push2his.eastmoney.com,3,0.01%,3,0,100.00%
93.push2his.eastmoney.com,3,0.01%,3,0,100.00%
sl-log.oray.net,3,0.01%,3,0,100.00%
aapl-maps.qtlcdn.com,3,0.01%,7,4,42.86%
pancake.cdn-apple.com.akadns.net,3,0.01%,3,0,100.00%
client.dropbox.com,3,0.01%,6,3,50.00%
vconf.f.360.cn,3,0.01%,3,0,100.00%
init.push-apple.com.akadns.net,3,0.01%,6,3,50.00%
api.panfanh.xyz,3,0.01%,3,0,100.00%
desktop.cloud.nfschina.com,3,0.01%,3,0,100.00%
wx4.sinaimg.cn,3,0.01%,12,9,25.00%
api.pcloud.com,3,0.01%,3,0,100.00%
id.rlcdn.com,3,0.01%,3,0,100.00%
us-u.openx.net,3,0.01%,3,0,100.00%
cm.g.doubleclick.net,3,0.01%,3,0,100.00%
onedscolprdcus00.centralus.cloudapp.azure.com,3,0.01%,3,0,100.00%
bv.lnk0.com,3,0.01%,3,0,100.00%
upos-sz-mirrorcoso1.bilivideo.com,3,0.01%,10,7,30.00%
prod.mrodevicemgr.live.com.akadns.NET,3,0.01%,6,3,50.00%
flux.hcdn.qiyi.com,3,0.01%,3,0,100.00%
mirrors.aliyun.com.w.alikunlun.com,3,0.01%,6,3,50.00%
logintcpnv.wps.cn,3,0.01%,3,0,100.00%
weather2db.cmcm.com,3,0.01%,3,0,100.00%
wp.mail.qq.com,3,0.01%,3,0,100.00%
s.url.cn,3,0.01%,6,3,50.00%
glacial-ravine-7295.morning-tundra-7160.herokuspace.com,3,0.01%,3,0,100.00%
upext.chrome.360.cn,3,0.01%,3,0,100.00%
prod.balrog.prod.cloudops.mozgcp.net,3,0.01%,3,0,100.00%
api.kylinos.cn,3,0.01%,3,0,100.00%
pc.ximalaya.com,3,0.01%,3,0,100.00%
cn-shanghai.axt.aliyun.com,3,0.01%,3,0,100.00%
www.m9ynqi6d.com,3,0.01%,3,0,100.00%
os1-5.nigirocloud.com,3,0.01%,3,0,100.00%
nl1-8.nigirocloud.com,3,0.01%,3,0,100.00%
78.push2his.eastmoney.com,3,0.01%,3,0,100.00%
uk1-3.nigirocloud.com,3,0.01%,3,0,100.00%
s.ludashi.com,3,0.01%,3,0,100.00%
crl.thawte.com,3,0.01%,4,1,75.00%
sv.symcd.com,3,0.01%,6,3,50.00%
onedscolprdcus10.centralus.cloudapp.azure.com,3,0.01%,3,0,100.00%
astrategy.beacon.qq.com,3,0.01%,3,0,100.00%
ins-j1yx5oul.ias.tencent-cloud.net,3,0.01%,3,0,100.00%
tracker.opentrackr.org,3,0.01%,3,0,100.00%
doh.360.cn,3,0.01%,3,0,100.00%
mssdk-bu.snssdk.com,3,0.01%,3,0,100.00%
browser5.qhimg.com,3,0.01%,6,3,50.00%
developers.google.cn,3,0.01%,3,0,100.00%
diana.ie.sogou.com,3,0.01%,3,0,100.00%
mam.ntes53.netease.com,3,0.01%,3,0,100.00%
ntes53.mail.163.com,3,0.01%,3,0,100.00%
cc-api-data.adobe.io,3,0.01%,3,0,100.00%
up.ijinshan.com,3,0.01%,3,0,100.00%
mobile.events.data.trafficmanager.net,3,0.01%,4,1,75.00%
cu010.www.duba.net,3,0.01%,3,0,100.00%
linux.teamviewer.com,3,0.01%,5,2,60.00%
appledownload.qtlcdn.com,3,0.01%,3,0,100.00%
public-treatment.prod-experimentation.grammarlyaws.com,3,0.01%,3,0,100.00%
bag.itunes.apple.com,3,0.01%,5,2,60.00%
usage.projectcalico.org,3,0.01%,3,0,100.00%
2.push2his.eastmoney.com,3,0.01%,3,0,100.00%
static-xl.a.88cdn.com,3,0.01%,10,7,30.00%
59.push2his.eastmoney.com,3,0.01%,3,0,100.00%
img-s-msn-com.akamaized.net,3,0.01%,6,3,50.00%
inappcheck.itunes.apple.com,3,0.01%,4,1,75.00%
zhuanlan.zhihu.com,3,0.01%,4,1,75.00%
npay.meituan.com,3,0.01%,3,0,100.00%
push-s.maxthon.com,3,0.01%,3,0,100.00%
http-inputs-notion.splunkcloud.com,3,0.01%,3,0,100.00%
himg.bdimg.com,3,0.01%,7,4,42.86%
web.sdk.qcloud.com,3,0.01%,6,3,50.00%
iris-de-prod-azsc-eas-b.eastasia.cloudapp.azure.com,3,0.01%,3,0,100.00%
cloud.google.com,3,0.01%,3,0,100.00%
wallpaper-redirect-api.cqttech.com,3,0.01%,3,0,100.00%
cdn.content.prod.cms.msn.com,3,0.01%,9,6,33.33%
ping.ie.sogou.com,3,0.01%,3,0,100.00%
s2.hdslb.com,3,0.01%,3,0,100.00%
adservice.google.com.hk,3,0.01%,3,0,100.00%
bingciservice.koreasouth.cloudapp.azure.com,3,0.01%,3,0,100.00%
vweixinthumb.tc.qq.com,3,0.01%,6,3,50.00%
beacons4.gvt2.com,3,0.01%,4,1,75.00%
socket-message.zhixi.com,3,0.01%,3,0,100.00%
dl.static.iqiyi.com,3,0.01%,6,3,50.00%
stun.services.mozilla.com,3,0.01%,3,0,100.00%
message.bilibili.com,3,0.01%,3,0,100.00%
bn1305.storage.live.com,3,0.01%,4,1,75.00%
www.zotero.org,3,0.01%,3,0,100.00%
onedscolprdcus13.centralus.cloudapp.azure.com,3,0.01%,3,0,100.00%
wss.im.qcloud.com,3,0.01%,3,0,100.00%
sconf.f.360.cn,3,0.01%,3,0,100.00%
downloadapi.n.shifen.com,3,0.01%,3,0,100.00%
offlintab.firefoxchina.cn.wscdns.com,3,0.01%,3,0,100.00%
www.sciencenet.cn,3,0.01%,3,0,100.00%
compatm.tplay.qq.com,3,0.01%,3,0,100.00%
oauth.account.jetbrains.com,3,0.01%,3,0,100.00%
passport.biligame.com,2,0.00%,2,0,100.00%
passport.bigfun.cn,2,0.00%,2,0,100.00%
passport.shanghaihuanli.com,2,0.00%,2,0,100.00%
passport.bilibili.cn,2,0.00%,2,0,100.00%
passport.bigfunapp.cn,2,0.00%,2,0,100.00%
config.app.yinxiang.com,2,0.00%,2,0,100.00%
th-a.pinduoduo.com,2,0.00%,2,0,100.00%
downv6.qq.com,2,0.00%,2,0,100.00%
boss.hdslb.com,2,0.00%,2,0,100.00%
tp.m-team.cc,2,0.00%,8,6,25.00%
bj-a.bcebos.com.n.shifen.com,2,0.00%,2,0,100.00%
calendars.fe.apple-dns.net,2,0.00%,3,1,66.67%
team-speed-cdn-vip.xunlei.com,2,0.00%,2,0,100.00%
cdnimg.3g.qq.com,2,0.00%,2,0,100.00%
wemeet-log-1256380422.cos.ap-guangzhou.myqcloud.com,2,0.00%,2,0,100.00%
bjk.163.com,2,0.00%,2,0,100.00%
gorgon.youdao.com,2,0.00%,2,0,100.00%
oimageb7.ydstatic.com,2,0.00%,2,0,100.00%
mcs.zijieapi.com,2,0.00%,6,4,33.33%
tencent-i.work.weixin.qq.com,2,0.00%,2,0,100.00%
www.weather.com.cn,2,0.00%,2,0,100.00%
sofire.bdstatic.com,2,0.00%,5,3,40.00%
mapsp0.bdimg.com,2,0.00%,2,0,100.00%
fc4tn.baidu.com,2,0.00%,2,0,100.00%
pic.rmb.bdstatic.com,2,0.00%,2,0,100.00%
fc5tn.baidu.com,2,0.00%,2,0,100.00%
www.atguigu.com,2,0.00%,2,0,100.00%
tb.53kf.com,2,0.00%,2,0,100.00%
www.gulixueyuan.com,2,0.00%,2,0,100.00%
www.itdachang.com,2,0.00%,2,0,100.00%
www.mobiletrain.org,2,0.00%,2,0,100.00%
s.union.360.cn,2,0.00%,2,0,100.00%
360fenxi.mediav.com,2,0.00%,2,0,100.00%
www13.53kf.com,2,0.00%,2,0,100.00%
accwww13.53kf.com,2,0.00%,2,0,100.00%
cpro.baidu.com,2,0.00%,2,0,100.00%
filesys.53kf.com,2,0.00%,2,0,100.00%
repos.os.nfschina.com,2,0.00%,2,0,100.00%
32-courier.push.apple.com,2,0.00%,2,0,100.00%
scholar.google.com.hk,2,0.00%,2,0,100.00%
storecatalogrevocation.storequality.microsoft.com,2,0.00%,2,0,100.00%
v1-play.log.mgtv.com,2,0.00%,2,0,100.00%
weu011-breeziest-in.cloudapp.net,2,0.00%,2,0,100.00%
minor-api.mihoyo.com,2,0.00%,2,0,100.00%
apis.mosaic.analytics.awscommon.mcafee.com,2,0.00%,2,0,100.00%
devlog.ys7.com,2,0.00%,2,0,100.00%
oss.zhixi.com,2,0.00%,2,0,100.00%
push-rest.zui.com,2,0.00%,2,0,100.00%
roaming.officeapps.partner.office365.cn,2,0.00%,2,0,100.00%
opencdnbdsimage.jomodns.com,2,0.00%,2,0,100.00%
opencdnpicrmb.jomodns.com,2,0.00%,2,0,100.00%
opencdnbdimgtn.jomodns.com,2,0.00%,2,0,100.00%
bcstobos.jomodns.com,2,0.00%,2,0,100.00%
odc.officeapps.partner.office365.cn,2,0.00%,2,0,100.00%
pptpluginppt.keniu.com,2,0.00%,2,0,100.00%
zz.bdstatic.com,2,0.00%,2,0,100.00%
pcvideoaliyun.titan.mgtv.com,2,0.00%,2,0,100.00%
video.weibo.com,2,0.00%,2,0,100.00%
u966.v.bsclink.cn,2,0.00%,2,0,100.00%
wap.n.shifen.com,2,0.00%,2,0,100.00%
uz95.v.bsclink.cn,2,0.00%,2,0,100.00%
hm.e.shifen.com,2,0.00%,4,2,50.00%
data.pendo.io,2,0.00%,2,0,100.00%
a-0019.standard.a-msedge.net,2,0.00%,2,0,100.00%
img.y.qq.com,2,0.00%,2,0,100.00%
sep.ucas.ac.cn,2,0.00%,4,2,50.00%
m.ctrip.com,2,0.00%,2,0,100.00%
cdn.icloud-content.com,2,0.00%,5,3,40.00%
oneclient.sfx.ms,2,0.00%,5,3,40.00%
img.da.mgtv.com,2,0.00%,2,0,100.00%
hunantv.m.cn.miaozhen.com,2,0.00%,2,0,100.00%
ipm.atm.youku.com,2,0.00%,2,0,100.00%
cc.map.qq.com,2,0.00%,2,0,100.00%
agps.location.live.net,2,0.00%,2,0,100.00%
nsp-contentcenter-h5-drcn.obs.cn-north-2.myhwclouds.com,2,0.00%,2,0,100.00%
mobile.yangkeduo.com,2,0.00%,2,0,100.00%
funimg.pddpic.com,2,0.00%,2,0,100.00%
promotion.pddpic.com,2,0.00%,2,0,100.00%
hovv.yilanvaas.com,2,0.00%,4,2,50.00%
pmmtk-a.pinduoduo.com,2,0.00%,2,0,100.00%
edge.ivideo.sina.com.cn,2,0.00%,4,2,50.00%
tne.pinduoduo.com,2,0.00%,2,0,100.00%
api.pinduoduo.com,2,0.00%,2,0,100.00%
titan-ws.pinduoduo.com,2,0.00%,2,0,100.00%
img-1.pddpic.com,2,0.00%,2,0,100.00%
cmtw.pinduoduo.com,2,0.00%,2,0,100.00%
avatar2.pddpic.com,2,0.00%,2,0,100.00%
ip1865976387.funshion.com,2,0.00%,2,0,100.00%
ip1865976393.funshion.com,2,0.00%,2,0,100.00%
sec.sginput.qq.com,2,0.00%,2,0,100.00%
sign.utcsoft.com,2,0.00%,2,0,100.00%
ip1880706120.funshion.com,2,0.00%,2,0,100.00%
jgwdb2.gaox.ml,2,0.00%,2,0,100.00%
dldir1.legao.sched.dcloudstc.com,2,0.00%,2,0,100.00%
gs-loc-cn.apple.com,2,0.00%,2,0,100.00%
www.vod.lxdns.com,2,0.00%,4,2,50.00%
sync-1-us-west1-g.sync.services.mozilla.com,2,0.00%,2,0,100.00%
mime.baidu.com,2,0.00%,2,0,100.00%
addinsinstallation.store.office.com,2,0.00%,2,0,100.00%
wikipedia.firstpartyapps.oaspapps.com,2,0.00%,2,0,100.00%
connect.rom.miui.com,2,0.00%,2,0,100.00%
sqimg.qq.com,2,0.00%,2,0,100.00%
tcbox.baidu.com,2,0.00%,2,0,100.00%
tb-video.bdstatic.com,2,0.00%,2,0,100.00%
clientlogvodp2p.haplat.net,2,0.00%,2,0,100.00%
v.casmooc.cn,2,0.00%,2,0,100.00%
alb-wy5mqfy1o52wprnwel.cn-hangzhou.alb.aliyuncs.com,2,0.00%,2,0,100.00%
restlbs.map.qq.com,2,0.00%,2,0,100.00%
weather-drcn.music.dbankcloud.cn,2,0.00%,2,0,100.00%
citicbank.ceping.com,2,0.00%,2,0,100.00%
catchoice.ceping.com,2,0.00%,2,0,100.00%
ntp.msn.cn,2,0.00%,2,0,100.00%
bl.nbmswl.com,2,0.00%,2,0,100.00%
cos.wtaluo.com,2,0.00%,2,0,100.00%
zhifoukeji.datasink.sensorsdata.cn,2,0.00%,2,0,100.00%
map.baidu.com,2,0.00%,6,4,33.33%
im.tieba.baidu.com,2,0.00%,2,0,100.00%
w.deepl.com,2,0.00%,2,0,100.00%
pop.cstnet.cn,2,0.00%,2,0,100.00%
tracker.internetwarriors.net,2,0.00%,2,0,100.00%
consul-kv.app.kdsec.org,2,0.00%,2,0,100.00%
ww3.mediaclub.tv,2,0.00%,2,0,100.00%
lenovo.archive.canonical.com,2,0.00%,2,0,100.00%
api.naea1.uds.lenovo.com,2,0.00%,2,0,100.00%
uptime.sangfor.net,2,0.00%,2,0,100.00%
fedora.riscv.rocks,2,0.00%,2,0,100.00%
dsm01pap002.storage.live.com,2,0.00%,2,0,100.00%
bubble.ic.ksosoft.com,2,0.00%,2,0,100.00%
onedscolprdcus09.centralus.cloudapp.azure.com,2,0.00%,2,0,100.00%
msg.video.qiyi.com,2,0.00%,2,0,100.00%
bjacshow.kugou.com,2,0.00%,4,2,50.00%
btinstall-artifacts.bittorrent.com,2,0.00%,4,2,50.00%
configserver.hicloud.com,2,0.00%,2,0,100.00%
i-5600.b-2372.helper.bench.utorrent.com,2,0.00%,4,2,50.00%
mail.triinnboc.com,2,0.00%,2,0,100.00%
sec23summer.usenix.hotcrp.com,2,0.00%,2,0,100.00%
crl.pki.goog,2,0.00%,2,0,100.00%
p4.music.126.net.w.alikunlun.com,2,0.00%,4,2,50.00%
public-cdn.cloud.unity3d.com,2,0.00%,2,0,100.00%
license.unity.cn,2,0.00%,2,0,100.00%
mcs.snssdk.com,2,0.00%,5,3,40.00%
saascdn.lenovo.com.cn,2,0.00%,2,0,100.00%
subca.crl.certum.pl,2,0.00%,5,3,40.00%
appdl.lenovo.com.cn,2,0.00%,2,0,100.00%
cdp.cloud.unity3d.com,2,0.00%,2,0,100.00%
f-log-editor.grammarly.io,2,0.00%,2,0,100.00%
internal-api.feishu.cn,2,0.00%,2,0,100.00%
cdn.yinxiang.com,2,0.00%,2,0,100.00%
28.courier-push-apple.com.akadns.net,2,0.00%,2,0,100.00%
onedscolprdcus14.centralus.cloudapp.azure.com,2,0.00%,4,2,50.00%
44-courier.push.apple.com,2,0.00%,2,0,100.00%
updatecollect.wps.cn,2,0.00%,2,0,100.00%
updatepro.wps.cn,2,0.00%,2,0,100.00%
appsso.oh.isrc.ac.cn,2,0.00%,2,0,100.00%
tiantang.mogencloud.com,2,0.00%,2,0,100.00%
dc1-file.ksn.kaspersky-labs.com,2,0.00%,2,0,100.00%
www.freerainbowtables.com,2,0.00%,2,0,100.00%
tracker.kali.org,2,0.00%,2,0,100.00%
linux.kite.com,2,0.00%,4,2,50.00%
kiteweb.b-cdn.net,2,0.00%,4,2,50.00%
ts-helper.2345.cc,2,0.00%,2,0,100.00%
www.as.com,2,0.00%,2,0,100.00%
d2us8jqsezvhge.cloudfront.net,2,0.00%,2,0,100.00%
study.huixiangtiandi.com,2,0.00%,2,0,100.00%
66.push2his.eastmoney.com,2,0.00%,2,0,100.00%
emres.dfcfw.com,2,0.00%,4,2,50.00%
92.push2his.eastmoney.com,2,0.00%,2,0,100.00%
pubsub02.oray.net,2,0.00%,2,0,100.00%
gateway.bitrenren.com,2,0.00%,5,3,40.00%
gdmf.apple.com,2,0.00%,2,0,100.00%
lcdn-locator.apple.com.akadns.net,2,0.00%,2,0,100.00%
ocsp2-cn-lb.apple.com.akadns.net,2,0.00%,2,0,100.00%
m.weibo.cn,2,0.00%,4,2,50.00%
steamstore-a.akamaihd.net,2,0.00%,2,0,100.00%
gtm-sg-6wr2n62gk0f.gtm-i1d1.com,2,0.00%,2,0,100.00%
launches.appsflyer.com,2,0.00%,2,0,100.00%
pconf.f.360.cn,2,0.00%,2,0,100.00%
wp.safe.360.cn,2,0.00%,2,0,100.00%
linux-updatepro.wps.cn,2,0.00%,2,0,100.00%
contentsync.onenote.com,2,0.00%,2,0,100.00%
hierarchyapi.onenote.com,2,0.00%,2,0,100.00%
www.tm.ak.prd.aadg.akadns.net,2,0.00%,2,0,100.00%
web.push.126.net,2,0.00%,2,0,100.00%
wwcdn.weixin.qq.com,2,0.00%,2,0,100.00%
down.qq.com,2,0.00%,2,0,100.00%
e6987.a.akamaiedge.net,2,0.00%,2,0,100.00%
plussvr.wps.cn,2,0.00%,2,0,100.00%
encs.wpsdns.com,2,0.00%,2,0,100.00%
conn.meeting.work.weixin.qq.com,2,0.00%,2,0,100.00%
meeting.tencent.com,2,0.00%,2,0,100.00%
tcloud.tim.qq.com,2,0.00%,2,0,100.00%
kunpeng-sc.csdnimg.cn,2,0.00%,2,0,100.00%
odr.mookie1.com,2,0.00%,4,2,50.00%
image6.pubmatic.com,2,0.00%,2,0,100.00%
token.rubiconproject.com,2,0.00%,2,0,100.00%
googlecm.hit.gemius.pl,2,0.00%,2,0,100.00%
zhannei-dm.csdn.net,2,0.00%,2,0,100.00%
ums.acuityplatform.com,2,0.00%,2,0,100.00%
analysis.leetcode.cn,2,0.00%,2,0,100.00%
mall.jd.com,2,0.00%,2,0,100.00%
passport.jd.com,2,0.00%,2,0,100.00%
p0.ssl.img.360kuai.com,2,0.00%,2,0,100.00%
dsm01pap003.storage.live.com,2,0.00%,4,2,50.00%
onedriveclucproddm20003.blob.core.windows.net,2,0.00%,2,0,100.00%
upos-sz-mirrorali.bilivideo.com.w.kunluncan.com,2,0.00%,2,0,100.00%
picgalb.beisen.com,2,0.00%,2,0,100.00%
snz04pap001.storage.live.com,2,0.00%,2,0,100.00%
onedriveclucprodbn20013.blob.core.windows.net,2,0.00%,2,0,100.00%
ocsp.apple.com,2,0.00%,2,0,100.00%
github.githubassets.com,2,0.00%,2,0,100.00%
settings-prod-sea-2.southeastasia.cloudapp.azure.com,2,0.00%,2,0,100.00%
dsm01pap005.storage.live.com,2,0.00%,4,2,50.00%
bytedance.feishu.cn,2,0.00%,2,0,100.00%
expressapisv2.net,2,0.00%,4,2,50.00%
www.sinfors.com.cn,2,0.00%,2,0,100.00%
configuration-server-lb-1105093370.us-east-1.elb.amazonaws.com,2,0.00%,2,0,100.00%
apigtwb2c.us.dell.com,2,0.00%,2,0,100.00%
cds.apple.com,2,0.00%,2,0,100.00%
wdcp.microsoft.com,2,0.00%,2,0,100.00%
cp501.prod.do.dsp.mp.microsoft.com,2,0.00%,2,0,100.00%
s.f.360.cn,2,0.00%,4,2,50.00%
gateway.kugou.com,2,0.00%,2,0,100.00%
followservice.kugou.com,2,0.00%,2,0,100.00%
pcstat.kugou.com,2,0.00%,2,0,100.00%
271509e17755a70d683b7f40cdb3eec6df604067.u.fdmpkg.org,2,0.00%,2,0,100.00%
array605.prod.do.dsp.mp.microsoft.com,2,0.00%,2,0,100.00%
archive.kylinos.cn,2,0.00%,2,0,100.00%
archive2.kylinos.cn,2,0.00%,2,0,100.00%
e-0009.e-msedge.net,2,0.00%,2,0,100.00%
array803.prod.do.dsp.mp.microsoft.com,2,0.00%,2,0,100.00%
ssl-google-analytics.l.google.com,2,0.00%,2,0,100.00%
onedscolprdeus09.eastus.cloudapp.azure.com,2,0.00%,2,0,100.00%
open.qurl.f.qh-lb.com,2,0.00%,2,0,100.00%
hub5u.wap.sandai.net,2,0.00%,2,0,100.00%
bg1.market.xiaomi.com,2,0.00%,2,0,100.00%
idx.m.hub.sandai.net,2,0.00%,2,0,100.00%
hub5pn.wap.sandai.net,2,0.00%,2,0,100.00%
sr.m.hub.sandai.net,2,0.00%,2,0,100.00%
fgc0.market.xiaomi.com,2,0.00%,2,0,100.00%
pbg0.market.xiaomi.com,2,0.00%,2,0,100.00%
download.get.live.cn,2,0.00%,2,0,100.00%
signalings.verysync.cn,2,0.00%,2,0,100.00%
cp601.prod.do.dsp.mp.microsoft.com,2,0.00%,2,0,100.00%
wap.sogou.com,2,0.00%,2,0,100.00%
fortune.com,2,0.00%,2,0,100.00%
eth-mainnet.alchemyapi.io,2,0.00%,2,0,100.00%
13.push2his.eastmoney.com,2,0.00%,2,0,100.00%
94.push2his.eastmoney.com,2,0.00%,2,0,100.00%
24.push2his.eastmoney.com,2,0.00%,2,0,100.00%
33.push2his.eastmoney.com,2,0.00%,2,0,100.00%
conf-drcn.cloud.dbankcloud.cn,2,0.00%,2,0,100.00%
grs.dbankcloud.com,2,0.00%,2,0,100.00%
conf-drcn-cloud-dbankcloud-cn-drcn.appacc.dbankedge.net,2,0.00%,2,0,100.00%
conf-drcn-cloud-dbankcloud-cn-drcn.edge.dbankedge.cn,2,0.00%,2,0,100.00%
cn-jiangsu001.edge.dbankedge.cn,2,0.00%,2,0,100.00%
cloudres-drcn.dbankcdn.cn,2,0.00%,2,0,100.00%
userk-drcn.cloud.dbankcloud.cn,2,0.00%,2,0,100.00%
cloudres-drcn.dbankcdn.globalsign.c.cdnhwc1.cn,2,0.00%,2,0,100.00%
userk-drcn-cloud-dbankcloud-cn-drcn.appacc.dbankedge.cn,2,0.00%,2,0,100.00%
userk-drcn-cloud-dbankcloud-cn-drcn.edge.dbankedge.cn,2,0.00%,2,0,100.00%
ak.privatelink.msidentity.com,2,0.00%,2,0,100.00%
e12437.d.akamaiedge.net,2,0.00%,2,0,100.00%
pim-drcn.cloud.dbankcloud.cn,2,0.00%,2,0,100.00%
pim-drcn-cloud-dbankcloud-cn-drcn.appacc.dbankedge.net,2,0.00%,2,0,100.00%
pim-drcn-cloud-dbankcloud-cn-drcn.edge.dbankedge.cn,2,0.00%,2,0,100.00%
api.insight.synology.com,2,0.00%,2,0,100.00%
35.courier-push-apple.com.akadns.net,2,0.00%,2,0,100.00%
3-courier.push.apple.com,2,0.00%,2,0,100.00%
3.courier-push-apple.com.akadns.net,2,0.00%,2,0,100.00%
kms.library.hk,2,0.00%,2,0,100.00%
vd2.bdstatic.com,2,0.00%,4,2,50.00%
www.apple.com.edgekey.net,2,0.00%,2,0,100.00%
www.apple.com.edgekey.net.globalredir.akadns.net,2,0.00%,2,0,100.00%
ntp.ntsc.ac.cn,2,0.00%,2,0,100.00%
onedscolprdwus14.westus.cloudapp.azure.com,2,0.00%,2,0,100.00%
ic3.events.data.microsoft.com,2,0.00%,2,0,100.00%
browser-api.2345.cc,2,0.00%,2,0,100.00%
auth-sl.oray.com,2,0.00%,2,0,100.00%
cdn.orayimg.com,2,0.00%,2,0,100.00%
24-courier.push.apple.com,2,0.00%,2,0,100.00%
plugins.jetbrains.com,2,0.00%,2,0,100.00%
i.gtimg.cn.sched.legopic2.tdnsv6.com,2,0.00%,2,0,100.00%
keyrotate.qq.com,2,0.00%,2,0,100.00%
sq.bls.mdt.qq.com,2,0.00%,2,0,100.00%
cdn.xsj.qq.com,2,0.00%,2,0,100.00%
tianshu.gtimg.cn,2,0.00%,3,1,66.67%
sqdd.myapp.com,2,0.00%,3,1,66.67%
cmshow.gtimg.cn.sched.legopic2.tdnsv6.com,2,0.00%,2,0,100.00%
mobi2.hexin.cn,2,0.00%,3,1,66.67%
groupclient.qq.com,2,0.00%,2,0,100.00%
wu-bg-shim.trafficmanager.NET,2,0.00%,2,0,100.00%
www.youtube.com,2,0.00%,4,2,50.00%
xueqiu.com,2,0.00%,2,0,100.00%
oauth-login-drcn.platform.dbankcloud.com,2,0.00%,2,0,100.00%
hwid-drcn.platform.hicloud.com,2,0.00%,2,0,100.00%
tsms-drcn.platform.dbankcloud.com,2,0.00%,2,0,100.00%
im-drcn.platform.dbankcloud.cn,2,0.00%,2,0,100.00%
imlong-sa-p04-drcn.platform.dbankcloud.cn,2,0.00%,2,0,100.00%
sns-drcn.platform.dbankcloud.cn,2,0.00%,2,0,100.00%
aop-pic-drcn.dbankcdn.com,2,0.00%,2,0,100.00%
stock.xueqiu.com,2,0.00%,2,0,100.00%
appdl-11-drcn.dbankcdn.com,2,0.00%,2,0,100.00%
appdl-2-drcn.dbankcdn.com,2,0.00%,2,0,100.00%
appdl-12-drcn.dbankcdn.com,2,0.00%,2,0,100.00%
offlintab.firefoxchina.cn,2,0.00%,2,0,100.00%
se4.360simg.com,2,0.00%,2,0,100.00%
hcfy.app,2,0.00%,4,2,50.00%
mbads.paas.cmbchina.com,2,0.00%,2,0,100.00%
mobile.cmbchina.com,2,0.00%,2,0,100.00%
cmp.zh.cmbchina.com,2,0.00%,2,0,100.00%
s3gw.cmbimg.com,2,0.00%,2,0,100.00%
yl.zh.cmbchina.com,2,0.00%,2,0,100.00%
www.mayiwxw.com,2,0.00%,2,0,100.00%
nav-edge.smartscreen.microsoft.com,2,0.00%,2,0,100.00%
ca-s2.fatvpn.ml,2,0.00%,2,0,100.00%
connectivity.pod1.avatar.ext.hp.com,2,0.00%,2,0,100.00%
atm-fp-direct.office.com,2,0.00%,4,2,50.00%
api.docer.wpscdn.cn,2,0.00%,4,2,50.00%
staging.v2.myteachlink.com,2,0.00%,2,0,100.00%
dm2305.storage.live.com,2,0.00%,4,2,50.00%
static.nvidiagrid.net,2,0.00%,2,0,100.00%
auth2.sangfor.com.cn,2,0.00%,2,0,100.00%
weu07-breeziest-in.cloudapp.net,2,0.00%,2,0,100.00%
update.360safe.com,2,0.00%,2,0,100.00%
cloud.dell.com,2,0.00%,2,0,100.00%
builds.parsecgaming.com,2,0.00%,4,2,50.00%
discussion.evernote.com,2,0.00%,2,0,100.00%
dns.rubyfish.cn,2,0.00%,2,0,100.00%
rp.m.hub.sandai.net,2,0.00%,2,0,100.00%
bl6pap003.storage.live.com,2,0.00%,4,2,50.00%
onedriveclucprodbn20026.blob.core.windows.net,2,0.00%,2,0,100.00%
conf.f.360.cn,2,0.00%,2,0,100.00%
bg6.market.xiaomi.com,2,0.00%,2,0,100.00%
ieonline.microsoft.com,2,0.00%,2,0,100.00%
vscode-update.trafficmanager.net,2,0.00%,2,0,100.00%
vscode-update-sea.azurewebsites.net,2,0.00%,2,0,100.00%
waws-prod-sg1-057.sip.azurewebsites.windows.net,2,0.00%,2,0,100.00%
ds.download.windowsupdate.com,2,0.00%,2,0,100.00%
2.rhel.pool.ntp.org,2,0.00%,2,0,100.00%
d28dx6y1hfq314.cloudfront.net,2,0.00%,3,1,66.67%
gsa.apple.com,2,0.00%,2,0,100.00%
cma.itunes.apple.com,2,0.00%,3,1,66.67%
p218-caldav.icloud.com.cn,2,0.00%,2,0,100.00%
su.itunes.apple.com,2,0.00%,3,1,66.67%
stun.counterpath.net,2,0.00%,2,0,100.00%
discovery-v4-3.verysync.cn,2,0.00%,2,0,100.00%
newmail.guazi.com,2,0.00%,2,0,100.00%
83.push2his.eastmoney.com,2,0.00%,2,0,100.00%
68.push2his.eastmoney.com,2,0.00%,2,0,100.00%
72.push2his.eastmoney.com,2,0.00%,2,0,100.00%
statistic.live.126.net,2,0.00%,2,0,100.00%
all.feishu.cn.w.kunluncan.com,2,0.00%,2,0,100.00%
sadownload-new.mcafee.com.edgekey.net,2,0.00%,2,0,100.00%
e7479.g.akamaiedge.net,2,0.00%,2,0,100.00%
wechat.intelcupid.com,2,0.00%,2,0,100.00%
ext.henzanapp.com,2,0.00%,2,0,100.00%
match.adsrvr.org,2,0.00%,2,0,100.00%
stats.l.doubleclick.net,2,0.00%,2,0,100.00%
a1961.g2.akamai.net,2,0.00%,2,0,100.00%
s0-2mdn-net.l.google.com,2,0.00%,2,0,100.00%
dcldshlupt.alicdn.com.danuoyi.tbcache.com,2,0.00%,2,0,100.00%
wmgp-update.wmupd.com,2,0.00%,2,0,100.00%
pool.admedo.com,2,0.00%,2,0,100.00%
arc.trafficmanager.net,2,0.00%,2,0,100.00%
global.asimov.events.data.trafficmanager.net,2,0.00%,2,0,100.00%
googlehosted.l.googleusercontent.com,2,0.00%,2,0,100.00%
msn-cn.a-0032.a-msedge.net,2,0.00%,2,0,100.00%
e8960.e2.akamaiedge.net,2,0.00%,2,0,100.00%
connectivity.samsung.com.cn,2,0.00%,2,0,100.00%
config.mobile.kugou.com,2,0.00%,2,0,100.00%
self-events-data.trafficmanager.net,2,0.00%,2,0,100.00%
platformcn.maps.glbdns2.microsoft.com,2,0.00%,2,0,100.00%
fe-platformcn-maps-atm.trafficmanager.net,2,0.00%,2,0,100.00%
um.simpli.fi,2,0.00%,2,0,100.00%
match.prod.bidr.io,2,0.00%,2,0,100.00%
fonts.googleapis.com,2,0.00%,2,0,100.00%
signaler-pa.clients6.google.com,2,0.00%,2,0,100.00%
39.courier-push-apple.com.akadns.net,2,0.00%,2,0,100.00%
helpdesktop1.ksmobile.com,2,0.00%,2,0,100.00%
onedscolprdaus00.australiasoutheast.cloudapp.azure.com,2,0.00%,2,0,100.00%
v1-hwllqv.onewsvod.com,2,0.00%,2,0,100.00%
upos-sz-staticcos-cmask.bilivideo.com,2,0.00%,6,4,33.33%
vfiles.gtimg.cn,2,0.00%,2,0,100.00%
mark.l.qq.com,2,0.00%,2,0,100.00%
uri6.com,2,0.00%,2,0,100.00%
ins-qw3q8ofk.ias.tencent-cloud.net,2,0.00%,2,0,100.00%
itunes-cdn.itunes-apple.com.akadns.net,2,0.00%,2,0,100.00%
getip.wps.cn,2,0.00%,2,0,100.00%
kae.wpsdns.com,2,0.00%,2,0,100.00%
news.qhstatic.com,2,0.00%,2,0,100.00%
gsp64-ssl.ls-apple.com.akadns.net,2,0.00%,2,0,100.00%
calendars.icloud.com,2,0.00%,4,2,50.00%
7-courier.push.apple.com,2,0.00%,2,0,100.00%
p208-caldav.icloud.com.cn,2,0.00%,2,0,100.00%
s-adashx.ut.uc.cn,2,0.00%,2,0,100.00%
openjmacs4uc.m.taobao.com,2,0.00%,2,0,100.00%
google.com,2,0.00%,4,2,50.00%
widget.intercom.io,2,0.00%,2,0,100.00%
js.intercomcdn.com,2,0.00%,2,0,100.00%
pics7.baidu.com,2,0.00%,2,0,100.00%
jianyi.baidu.com,2,0.00%,2,0,100.00%
www.beian.gov.cn,2,0.00%,2,0,100.00%
i.baidu.com,2,0.00%,2,0,100.00%
e1723.ca.s.tl88.NET,2,0.00%,2,0,100.00%
configuration.apple.com,2,0.00%,2,0,100.00%
mqtt-internal-public.zhihu.com,2,0.00%,4,2,50.00%
deepl.com,2,0.00%,2,0,100.00%
api.ad.xiaomi.com,2,0.00%,2,0,100.00%
clients2.googleusercontent.com,2,0.00%,2,0,100.00%
v.vaptcha.com,2,0.00%,2,0,100.00%
time.asia.apple.com,2,0.00%,2,0,100.00%
stocks-data-service.lb-apple.com.akadns.net,2,0.00%,4,2,50.00%
help.apple.com,2,0.00%,2,0,100.00%
www.doc88.com,2,0.00%,2,0,100.00%
mini.group.qq.com,2,0.00%,2,0,100.00%
msnzlxxglobal.v.lxcvc.com,2,0.00%,2,0,100.00%
update.helper.2345.cc,2,0.00%,2,0,100.00%
aeventlog.beacon.qq.com,2,0.00%,2,0,100.00%
downloads.upd.kaspersky.com,2,0.00%,2,0,100.00%
s12.upd.kaspersky.com,2,0.00%,2,0,100.00%
httpsdns.n.shifen.com,2,0.00%,2,0,100.00%
oth.str.mdt.qq.com,2,0.00%,2,0,100.00%
login.chinacloudapi.cn,2,0.00%,2,0,100.00%
ue.lenovomm.cn,2,0.00%,2,0,100.00%
appct.jianguoyun.com,2,0.00%,2,0,100.00%
iplc.a.hellossr.com,2,0.00%,2,0,100.00%
iplc.b.hellossr.com,2,0.00%,2,0,100.00%
cdn-cn.nekocloud.cn,2,0.00%,2,0,100.00%
c.urs.microsoft.com,2,0.00%,2,0,100.00%
array805.prod.do.dsp.mp.microsoft.com,2,0.00%,2,0,100.00%
developer.download.nvidia.com,2,0.00%,2,0,100.00%
opentracker.acgnx.se,2,0.00%,4,2,50.00%
venus.douyucdn.cn,2,0.00%,2,0,100.00%
sphapi-pro.oray.net,2,0.00%,2,0,100.00%
tracker.bt4g.com,2,0.00%,7,5,28.57%
d2rb60829qiz9y.cloudfront.net,2,0.00%,4,2,50.00%
99.push2his.eastmoney.com,2,0.00%,2,0,100.00%
22.push2his.eastmoney.com,2,0.00%,2,0,100.00%
75.push2his.eastmoney.com,2,0.00%,2,0,100.00%
97.push2his.eastmoney.com,2,0.00%,2,0,100.00%
46.push2his.eastmoney.com,2,0.00%,2,0,100.00%
p205-fmip.icloud.com.cn,2,0.00%,2,0,100.00%
fmip.fe.apple-dns.cn,2,0.00%,2,0,100.00%
smartdl.lenovo.com.cn,2,0.00%,2,0,100.00%
s-ring.msedge.net,2,0.00%,2,0,100.00%
api1.origin.com,2,0.00%,2,0,100.00%
p209-caldav.icloud.com.cn,2,0.00%,2,0,100.00%
e6603.g.akamaiedge.net,2,0.00%,2,0,100.00%
onedscolprdjpe00.japaneast.cloudapp.azure.com,2,0.00%,2,0,100.00%
mqtt-web.zhihu.com,2,0.00%,2,0,100.00%
array502.prod.do.dsp.mp.microsoft.com,2,0.00%,2,0,100.00%
tracker1.itzmx.com,2,0.00%,2,0,100.00%
stun.chat.bilibili.com,2,0.00%,4,2,50.00%
x2.c.lencr.org,2,0.00%,4,2,50.00%
api.pdfxd.com,2,0.00%,2,0,100.00%
onedscolprdwus05.westus.cloudapp.azure.com,2,0.00%,4,2,50.00%
api-lequ.iqiyi.com,2,0.00%,2,0,100.00%
ca.iadsdk.apple.com,2,0.00%,2,0,100.00%
fanyi.baidu.com,2,0.00%,4,2,50.00%
list3.ppstream.com.iqiyi.com,2,0.00%,4,2,50.00%
disc801.prod.do.dsp.mp.microsoft.com,2,0.00%,2,0,100.00%
pool.nto.org,2,0.00%,2,0,100.00%
open.demonii.si,2,0.00%,2,0,100.00%
dgss0.bdstatic.com,2,0.00%,3,1,66.67%
hk10.virtual-strike.com,2,0.00%,2,0,100.00%
news.baidu.com,2,0.00%,2,0,100.00%
wenku.baidu.com,2,0.00%,2,0,100.00%
baiduzm.37.com,2,0.00%,2,0,100.00%
haokan.baidu.com,2,0.00%,2,0,100.00%
wan.baidu.com,2,0.00%,2,0,100.00%
wvw.4366.com,2,0.00%,2,0,100.00%
www.9377.com,2,0.00%,2,0,100.00%
www.anjuke.com,2,0.00%,2,0,100.00%
www.cpta.com.cn,2,0.00%,2,0,100.00%
www.ctrip.com,2,0.00%,2,0,100.00%
www.gaodun.com,2,0.00%,2,0,100.00%
www.ifeng.com,2,0.00%,2,0,100.00%
www.ximalaya.com,2,0.00%,2,0,100.00%
mail.sina.com.cn,2,0.00%,2,0,100.00%
mos.m.taobao.com,2,0.00%,2,0,100.00%
p4psearch.1688.com,2,0.00%,2,0,100.00%
quanmin.baidu.com,2,0.00%,2,0,100.00%
t.vip.com,2,0.00%,2,0,100.00%
u.jd.com,2,0.00%,2,0,100.00%
union-click.jd.com,2,0.00%,2,0,100.00%
as1.m.hao123.com,2,0.00%,2,0,100.00%
lupic.cdn.bcebos.com,2,0.00%,4,2,50.00%
download.52pcfree.com,2,0.00%,2,0,100.00%
webdemo.myscript.com,2,0.00%,2,0,100.00%
webdemoapi.myscript.com,2,0.00%,2,0,100.00%
qrcode.mse.sogou.com,2,0.00%,2,0,100.00%
theta.sogoucdn.com,2,0.00%,2,0,100.00%
topnews.imtt.qq.com,2,0.00%,2,0,100.00%
us.sogou.com,2,0.00%,2,0,100.00%
hotlist.imtt.qq.com,2,0.00%,2,0,100.00%
pb.sogou.com,2,0.00%,2,0,100.00%
pgdt.gtimg.cn,2,0.00%,2,0,100.00%
latex.codecogs.com,2,0.00%,2,0,100.00%
api.staticj.top,2,0.00%,2,0,100.00%
gss3.bdstatic.com,2,0.00%,2,0,100.00%
bdimg.share.baidu.com,2,0.00%,2,0,100.00%
fex.bdstatic.com,2,0.00%,2,0,100.00%
s1.bdstatic.com,2,0.00%,2,0,100.00%
img.baidu.com,2,0.00%,2,0,100.00%
www.wiris.net,2,0.00%,2,0,100.00%
awdb.nickname-vocals.net,2,0.00%,2,0,100.00%
kuaikan.netmon.360safe.com,2,0.00%,2,0,100.00%
download.amd.com,2,0.00%,2,0,100.00%
client-office365-tas.msedge.net,2,0.00%,2,0,100.00%
1.openwrt.pool.ntp.org,2,0.00%,2,0,100.00%
zqnweb.v.trpcdn.net,2,0.00%,2,0,100.00%
xqimg.imedao.com,2,0.00%,2,0,100.00%
position.dftoutiao.com,2,0.00%,2,0,100.00%
adashx.ut.amap.com,2,0.00%,2,0,100.00%
bkimg.cdn.bcebos.com,2,0.00%,2,0,100.00%
dsm01pap007.storage.live.com,2,0.00%,3,1,66.67%
continuum.dds.microsoft.com,2,0.00%,2,0,100.00%
img-music.heytapimage.com,2,0.00%,2,0,100.00%
appconf-ocs.heytapdownload.com,2,0.00%,2,0,100.00%
news.stcn.com,2,0.00%,2,0,100.00%
www.stcn.com,2,0.00%,2,0,100.00%
epaper.stcn.com,2,0.00%,2,0,100.00%
data.stcn.com,2,0.00%,2,0,100.00%
company.stcn.com,2,0.00%,2,0,100.00%
finance.stcn.com,2,0.00%,2,0,100.00%
kuaixun.stcn.com,2,0.00%,2,0,100.00%
space.stcn.com,2,0.00%,2,0,100.00%
video.stcn.com,2,0.00%,2,0,100.00%
zt.stcn.com,2,0.00%,2,0,100.00%
cms.tanx.com,2,0.00%,2,0,100.00%
cm.fastapi.net,2,0.00%,2,0,100.00%
t.go.sohu.com,2,0.00%,2,0,100.00%
r3---sn-2x3elnez.gvt1.com,2,0.00%,2,0,100.00%
r3.sn-2x3elnez.gvt1.com,2,0.00%,2,0,100.00%
ec.walkme.com,2,0.00%,2,0,100.00%
open.kwaizt.com,2,0.00%,2,0,100.00%
mqtt.zhihu.com,2,0.00%,2,0,100.00%
datahub.zhihu.com,2,0.00%,2,0,100.00%
atm-settingsfe-prod-geo2.trafficmanager.net,2,0.00%,2,0,100.00%
settings-prod-uks-1.uksouth.cloudapp.azure.com,2,0.00%,2,0,100.00%
assets.imedao.com,2,0.00%,2,0,100.00%
wifibbs.ggsafe.com,2,0.00%,2,0,100.00%
s.search.bilibili.com,2,0.00%,2,0,100.00%
76.push2his.eastmoney.com,2,0.00%,2,0,100.00%
search.bilibili.com,2,0.00%,2,0,100.00%
amsfile.5i5j.com,2,0.00%,2,0,100.00%
hwxypic.5i5j.com,2,0.00%,2,0,100.00%
image.5i5j.com,2,0.00%,2,0,100.00%
xycitys.5i5j.com,2,0.00%,2,0,100.00%
news.duote.com,2,0.00%,2,0,100.00%
img1.runjiapp.com,2,0.00%,2,0,100.00%
img2.runjiapp.com,2,0.00%,2,0,100.00%
img4.runjiapp.com,2,0.00%,2,0,100.00%
img3.runjiapp.com,2,0.00%,2,0,100.00%
static.mediav.com,2,0.00%,2,0,100.00%
img5.runjiapp.com,2,0.00%,2,0,100.00%
s5.cnzz.com,2,0.00%,2,0,100.00%
oss.kazhifu.com,2,0.00%,2,0,100.00%
www.duote.com,2,0.00%,2,0,100.00%
www.2345.com,2,0.00%,2,0,100.00%
push.zhanzhang.baidu.com,2,0.00%,2,0,100.00%
url.pc120.com,2,0.00%,2,0,100.00%
www.tuidc.com,2,0.00%,2,0,100.00%
bd-js1.2345.com,2,0.00%,2,0,100.00%
finance.eastmoney.com,2,0.00%,4,2,50.00%
data.unistream.io,2,0.00%,2,0,100.00%
tangram-config.gdt.qq.com,2,0.00%,2,0,100.00%
g.ceipmsn.com,2,0.00%,2,0,100.00%
dhupdateprod.blob.core.windows.net,2,0.00%,2,0,100.00%
realsense-hw-public.s3.amazonaws.com,2,0.00%,2,0,100.00%
ovv.alllook.tv,2,0.00%,2,0,100.00%
edge.skype.com,2,0.00%,4,2,50.00%
ipv4.neubt.com,2,0.00%,2,0,100.00%
consumerapps.mcafee.com,2,0.00%,2,0,100.00%
download.mcafee.com,2,0.00%,2,0,100.00%
CliENTLOgVODp2P.HaPLAt.Net,2,0.00%,2,0,100.00%
transIt1.WsLog.ChiNANEtCeNtEr.com,2,0.00%,2,0,100.00%
MAmbaP2pvoDh5.8686c.COm,2,0.00%,2,0,100.00%
dellupdater.dell.com,2,0.00%,2,0,100.00%
path3.xtracloud.net,2,0.00%,2,0,100.00%
simpledesktops.azurewebsites.net,2,0.00%,2,0,100.00%
show.3.mediav.com,2,0.00%,2,0,100.00%
www.bangkokbank.com,2,0.00%,2,0,100.00%
3.push2his.eastmoney.com,2,0.00%,2,0,100.00%
61.push2his.eastmoney.com,2,0.00%,2,0,100.00%
6.push2his.eastmoney.com,2,0.00%,2,0,100.00%
52.push2his.eastmoney.com,2,0.00%,2,0,100.00%
79.push2his.eastmoney.com,2,0.00%,2,0,100.00%
88.push2his.eastmoney.com,2,0.00%,2,0,100.00%
32.push2his.eastmoney.com,2,0.00%,2,0,100.00%
stock2.finance.sina.com.cn,2,0.00%,2,0,100.00%
29.courier-push-apple.com.akadns.net,2,0.00%,2,0,100.00%
wu-bg-shim.trafficmanager.net,2,0.00%,2,0,100.00%
ws.mmstat.com,2,0.00%,2,0,100.00%
download.windowsupdate.com.a.bdydns.com,2,0.00%,2,0,100.00%
tlu.dl.delivery.mp.microsoft.com.w.alikunlun.com,2,0.00%,2,0,100.00%
cl.vd.f.360.cn,2,0.00%,2,0,100.00%
comet.jianguoyun.com,2,0.00%,2,0,100.00%
login.im.qcloud.com,2,0.00%,2,0,100.00%
www.infoq.cn,2,0.00%,2,0,100.00%
zntlqjq2sysuepfiwbyuvlvuog9tprst.aliyundunwaf.com,2,0.00%,2,0,100.00%
outlookmobile-office365-tas.msedge.net,2,0.00%,2,0,100.00%
down.anticheatexpert.com,2,0.00%,2,0,100.00%
gsp64-ssl.ls.apple.com,2,0.00%,2,0,100.00%
auth.split.io,2,0.00%,2,0,100.00%
onedriveclucproddm20037.blob.core.windows.net,2,0.00%,2,0,100.00%
tools.google.com,2,0.00%,2,0,100.00%
res.servicewechat.com,2,0.00%,2,0,100.00%
s3m5.nzwgs.com,2,0.00%,2,0,100.00%
miwifi.com,2,0.00%,2,0,100.00%
i-lq.snssdk.com,2,0.00%,2,0,100.00%
kstj.baidu.com,2,0.00%,2,0,100.00%
gsp1.baidu.com,2,0.00%,2,0,100.00%
mon.snssdk.com,2,0.00%,2,0,100.00%
www2.bing.com,2,0.00%,2,0,100.00%
browser.pipe.aria.microsoft.com,2,0.00%,2,0,100.00%
whoami.akamai.net,2,0.00%,2,0,100.00%
wss.rest.gti.mcafee.com,2,0.00%,2,0,100.00%
cloud.acrobat.com,2,0.00%,2,0,100.00%
sb-ssl.google.com,2,0.00%,2,0,100.00%
d1ucxc6xi3jabg.cloudfront.net,2,0.00%,2,0,100.00%
ins-59d1h3tv.ias.tencent-cloud.net,2,0.00%,4,2,50.00%
dav.jianguoyun.com,2,0.00%,2,0,100.00%
cu005.www.duba.net,2,0.00%,2,0,100.00%
gstaticadssl.l.google.com,2,0.00%,2,0,100.00%
shuc-other.ksord.com,2,0.00%,2,0,100.00%
sb.firefox.com.cn,2,0.00%,4,2,50.00%
r.bing.com,2,0.00%,2,0,100.00%
api.equinox.io,2,0.00%,2,0,100.00%
weatherapi.market.xiaomi.com,2,0.00%,2,0,100.00%
conn1.oppomobile.com,2,0.00%,2,0,100.00%
zybuluo.com,2,0.00%,2,0,100.00%
ips-gw.gbd.hp10.us,2,0.00%,2,0,100.00%
clients.l.google.com,2,0.00%,2,0,100.00%
tsbrowser.xiangtatech.com,2,0.00%,2,0,100.00%
pc-store.lenovomm.cn,2,0.00%,2,0,100.00%
down.xinshuru.com,2,0.00%,2,0,100.00%
cdi-pe-app.letras.ulisboa.pt,2,0.00%,2,0,100.00%
cdn.ap.bittorrent.com,2,0.00%,4,2,50.00%
onedriveclucprodbn20004.blob.core.windows.net,2,0.00%,2,0,100.00%
cb10bdfbd90f88db560d0ad1e8f78722.dlied1.cdntips.net,1,0.00%,1,0,100.00%
mapp.3g.qq.com,1,0.00%,1,0,100.00%
bimp.hdslb.com,1,0.00%,2,1,50.00%
tp-b.pinduoduo.com,1,0.00%,1,0,100.00%
mesu-china.apple.com.akadns.net,1,0.00%,3,2,33.33%
wbapp.uve.weibo.com,1,0.00%,1,0,100.00%
dcs.foxitreader.cn,1,0.00%,1,0,100.00%
i.guancha.cn,1,0.00%,2,1,50.00%
r.avlab.qq.com,1,0.00%,1,0,100.00%
events-drcn.op.dbankcloud.cn,1,0.00%,1,0,100.00%
dsum.casalemedia.com,1,0.00%,1,0,100.00%
in1-gw2-02-ce7dd027.eastus2.cloudapp.azure.com,1,0.00%,1,0,100.00%
i.tq121.com.cn,1,0.00%,1,0,100.00%
pic.weather.com.cn,1,0.00%,1,0,100.00%
i.weather.com.cn,1,0.00%,1,0,100.00%
wgeo.weather.com.cn,1,0.00%,1,0,100.00%
d1.weather.com.cn,1,0.00%,1,0,100.00%
wxapp.tc.qq.com,1,0.00%,9,8,11.11%
unionsug.baidu.com,1,0.00%,1,0,100.00%
addonlist.sync.maxthon.cn,1,0.00%,1,0,100.00%
mmbiz.qlogo.cn,1,0.00%,1,0,100.00%
tbmsg.baidu.com,1,0.00%,1,0,100.00%
ecma.bdimg.com,1,0.00%,1,0,100.00%
tieba-ares.cdn.bcebos.com,1,0.00%,1,0,100.00%
tiebapic.baidu.com,1,0.00%,1,0,100.00%
ns-strategy.cdn.bcebos.com,1,0.00%,1,0,100.00%
gss0.bdstatic.com,1,0.00%,1,0,100.00%
ada.baidu.com,1,0.00%,1,0,100.00%
show-3.mediav.com,1,0.00%,1,0,100.00%
wappass.baidu.com,1,0.00%,1,0,100.00%
ppui-static-pc.cdn.bcebos.com,1,0.00%,1,0,100.00%
s3m4.fenxi.com,1,0.00%,1,0,100.00%
client.uu.me,1,0.00%,1,0,100.00%
s3.amazonaws.com,1,0.00%,1,0,100.00%
smad.ms.zhangyue.net,1,0.00%,1,0,100.00%
dss3.baidu.com,1,0.00%,1,0,100.00%
cambrian-images.cdn.bcebos.com,1,0.00%,4,3,25.00%
e.so.com,1,0.00%,1,0,100.00%
online.user.maxthon.cn,1,0.00%,1,0,100.00%
api-drcn.theme.dbankcloud.cn,1,0.00%,1,0,100.00%
dnkeeper.hicloud.com,1,0.00%,1,0,100.00%
contentcenter-drcn.dbankcdn.com,1,0.00%,2,1,50.00%
logbak.hicloud.com,1,0.00%,1,0,100.00%
h5hosting-drcn.dbankcdn.cn,1,0.00%,2,1,50.00%
edge.microsoft.com,1,0.00%,199,198,0.50%
hwid.platform.hicloud.com,1,0.00%,1,0,100.00%
web-seminare.beton-webakademie.36chambers.de,1,0.00%,1,0,100.00%
in1-gw2-01-ce7dd027.eastus2.cloudapp.azure.com,1,0.00%,2,1,50.00%
log.ys7.com,1,0.00%,1,0,100.00%
fclick.e.shifen.com,1,0.00%,1,0,100.00%
ecomcbjs.jomodns.com,1,0.00%,1,0,100.00%
opencdnssl.jomodns.com,1,0.00%,1,0,100.00%
eopa.n.shifen.com,1,0.00%,2,1,50.00%
hpd.a.shifen.com,1,0.00%,1,0,100.00%
api.777ppt.com,1,0.00%,1,0,100.00%
s3a.pstatp.com,1,0.00%,4,3,25.00%
app2.myzaker.com.w.cdngslb.com,1,0.00%,1,0,100.00%
app.myzaker.com.w.kunlungr.com,1,0.00%,1,0,100.00%
zkres.myzaker.com.w.kunlunhuf.com,1,0.00%,1,0,100.00%
webb.jomodns.com,1,0.00%,1,0,100.00%
ggs.myzaker.com,1,0.00%,1,0,100.00%
stat.myzaker.com.w.kunlungr.com,1,0.00%,1,0,100.00%
aefd.nelreports.net,1,0.00%,5,4,20.00%
syz.phic.org.cn,1,0.00%,1,0,100.00%
r.img.cctvpic.com,1,0.00%,2,1,50.00%
p3.img.cctvpic.com,1,0.00%,2,1,50.00%
p.data.cctv.com,1,0.00%,1,0,100.00%
py.ucas.ac.cn,1,0.00%,1,0,100.00%
oneocsp.microsoft.com,1,0.00%,2,1,50.00%
i-chi01p-cor001.api.p001.1drv.com,1,0.00%,1,0,100.00%
fa000000105.resources.office.net,1,0.00%,5,4,20.00%
web.da.mgtv.com,1,0.00%,1,0,100.00%
v2.da.mgtv.com,1,0.00%,1,0,100.00%
ys.da.mgtv.com,1,0.00%,1,0,100.00%
vt.ipinyou.com,1,0.00%,1,0,100.00%
vectormap0.bdimg.com,1,0.00%,2,1,50.00%
worldwide.sogou.com,1,0.00%,1,0,100.00%
uci.edog.cdn.office.net,1,0.00%,2,1,50.00%
static.pddpic.com,1,0.00%,2,1,50.00%
img.pddpic.com,1,0.00%,2,1,50.00%
th.yangkeduo.com,1,0.00%,1,0,100.00%
video3.pddpic.com,1,0.00%,2,1,50.00%
avatar2-1.pddpic.com,1,0.00%,2,1,50.00%
video-snapshot.pddpic.com,1,0.00%,2,1,50.00%
ip1880706121.funshion.com,1,0.00%,1,0,100.00%
ip3746756449.funshion.com,1,0.00%,1,0,100.00%
dldir1v6.qq.com,1,0.00%,3,2,33.33%
jp_62.antchatxj.com,1,0.00%,1,0,100.00%
onedsblobprdeus15.eastus.cloudapp.azure.com,1,0.00%,1,0,100.00%
transfer.ceping.com,1,0.00%,1,0,100.00%
35-courier.push.apple.com,1,0.00%,1,0,100.00%
liangcang-material.alicdn.com,1,0.00%,2,1,50.00%
api.weathercn.com,1,0.00%,2,1,50.00%
stcms.beisen.com,1,0.00%,1,0,100.00%
onedscolprdeus05.eastus.cloudapp.azure.com,1,0.00%,2,1,50.00%
app.yinxiang.com,1,0.00%,1,0,100.00%
image.dayi.org.cn,1,0.00%,1,0,100.00%
tracker.torrentyorg.pl,1,0.00%,1,0,100.00%
torrentzilla.org,1,0.00%,1,0,100.00%
announce.partis.si,1,0.00%,2,1,50.00%
9.rarbg.com,1,0.00%,1,0,100.00%
stun.counterpath.com,1,0.00%,1,0,100.00%
torrents.linuxmint.com,1,0.00%,1,0,100.00%
open.touki.ru,1,0.00%,1,0,100.00%
torrent.arjlover.net,1,0.00%,1,0,100.00%
sh-download.weiyun.com,1,0.00%,2,1,50.00%
proaudiotorrents.org,1,0.00%,1,0,100.00%
torrents.hikarinokiseki.com,1,0.00%,1,0,100.00%
tracker.files.fm,1,0.00%,1,0,100.00%
torrent-team.net,1,0.00%,2,1,50.00%
dashboard.snapcraft.io,1,0.00%,1,0,100.00%
odrs.gnome.org,1,0.00%,2,1,50.00%
forum.qt.io,1,0.00%,1,0,100.00%
eo.dbpedia.org,1,0.00%,1,0,100.00%
deff.nelreports.net,1,0.00%,1,0,100.00%
dl.fedoraproject.org,1,0.00%,1,0,100.00%
cr.file.cloud.duba.net,1,0.00%,1,0,100.00%
c-uaa.if.iqiyi.com,1,0.00%,1,0,100.00%
bleisure.ba.com,1,0.00%,1,0,100.00%
upd2.sangfor.com.cn.localdomain,1,0.00%,1,0,100.00%
rgmb.classic.kicksite.net,1,0.00%,1,0,100.00%
ecs.office.com,1,0.00%,57,56,1.75%
g.msn.com,1,0.00%,2,1,50.00%
ts.qq.com,1,0.00%,17,16,5.88%
www.catererglobal.com,1,0.00%,1,0,100.00%
images-eu.ssl-images-amazon.com,1,0.00%,1,0,100.00%
u.jia.mn,1,0.00%,1,0,100.00%
cbwh5s4.i3zmbs.com,1,0.00%,1,0,100.00%
activation.unity.cn,1,0.00%,1,0,100.00%
23-92-30-53.3f5ffcbecff340969874c9eb90a37eeb.plex.direct,1,0.00%,1,0,100.00%
wd-prod-ss-as-southeast-2-fe.southeastasia.cloudapp.azure.com,1,0.00%,1,0,100.00%
5.rlb.router.teamviewer.cn,1,0.00%,1,0,100.00%
1610057041.D4EE073C2A20.device.hiwifi.com,1,0.00%,1,0,100.00%
cdn-9f456ph4.slt.sched.tdnsv8.com,1,0.00%,1,0,100.00%
1610057067.D4EE073C2A20.device.hiwifi.com,1,0.00%,1,0,100.00%
mail.foodbeauty.ga,1,0.00%,1,0,100.00%
architectsnearme.co.uk,1,0.00%,1,0,100.00%
1610057093.D4EE073C2A20.device.hiwifi.com,1,0.00%,1,0,100.00%
saludloprado.xpyri-staging.com,1,0.00%,1,0,100.00%
www.weibo.com,1,0.00%,15,14,6.67%
ilofeudo.com.ar,1,0.00%,1,0,100.00%
pgyapi-adv.oray.net,1,0.00%,1,0,100.00%
pgy-prm02.oray.net,1,0.00%,1,0,100.00%
pgysle-client-adv02.oray.net,1,0.00%,1,0,100.00%
pgy-pubsub01.oray.net,1,0.00%,1,0,100.00%
google.cn,1,0.00%,2,1,50.00%
cryptoworld.co.uk,1,0.00%,1,0,100.00%
tr.doogh.club,1,0.00%,2,1,50.00%
itera.bz,1,0.00%,1,0,100.00%
app.axure.cloud,1,0.00%,1,0,100.00%
www.2600.com,1,0.00%,1,0,100.00%
www.xwt-classics.net,1,0.00%,1,0,100.00%
torr.ws,1,0.00%,1,0,100.00%
www.skeimg.com,1,0.00%,1,0,100.00%
tokyo3.link.ac.cn,1,0.00%,1,0,100.00%
tracker.skyts.cn,1,0.00%,1,0,100.00%
ac.dun.163.com,1,0.00%,2,1,50.00%
torrents-nn.cn,1,0.00%,1,0,100.00%
tracker.iamhansen.xyz,1,0.00%,1,0,100.00%
mail.ios.ac.cn,1,0.00%,1,0,100.00%
ehs.cas.cn,1,0.00%,1,0,100.00%
objects.githubusercontent.com,1,0.00%,1,0,100.00%
arcane-stream-1752.herokuapp.com,1,0.00%,1,0,100.00%
ins-mfa9hirw.ias.tencent-cloud.net,1,0.00%,1,0,100.00%
43.push2his.eastmoney.com,1,0.00%,1,0,100.00%
20.push2his.eastmoney.com,1,0.00%,1,0,100.00%
56.push2his.eastmoney.com,1,0.00%,1,0,100.00%
85.push2his.eastmoney.com,1,0.00%,1,0,100.00%
38.push2his.eastmoney.com,1,0.00%,1,0,100.00%
89.push2his.eastmoney.com,1,0.00%,1,0,100.00%
73.push2his.eastmoney.com,1,0.00%,1,0,100.00%
65.push2his.eastmoney.com,1,0.00%,1,0,100.00%
29.push2his.eastmoney.com,1,0.00%,1,0,100.00%
14.push2his.eastmoney.com,1,0.00%,1,0,100.00%
8.push2his.eastmoney.com,1,0.00%,1,0,100.00%
rc09-fc01.oray.com,1,0.00%,1,0,100.00%
download.comodo.com,1,0.00%,1,0,100.00%
cdn.download.comodo.com,1,0.00%,1,0,100.00%
d2lfklupjnai2b.cloudfront.cn,1,0.00%,2,1,50.00%
pancake-cn.cdn-apple.com.akadns.net,1,0.00%,1,0,100.00%
gdmf.v.aaplimg.com,1,0.00%,1,0,100.00%
lcdn-locator-usms11.apple.com.akadns.net,1,0.00%,1,0,100.00%
swcdn.apple.com,1,0.00%,2,1,50.00%
fe2cr.update.msft.com.trafficmanager.net,1,0.00%,2,1,50.00%
swcdn.apple.com.w.alikunlun.com,1,0.00%,1,0,100.00%
e6913.dscx.akamaiedge.net,1,0.00%,2,1,50.00%
6fe97759aa27a0c9.jijifun.com,1,0.00%,1,0,100.00%
e4578.dscb.akamaiedge.net,1,0.00%,2,1,50.00%
conversions.appsflyer.com,1,0.00%,1,0,100.00%
mcs-bd.feishu.cn.w.cdngslb.com,1,0.00%,1,0,100.00%
havfw69955.lithium.com,1,0.00%,2,1,50.00%
k128-inapp.gslb.ksyuncdn.com,1,0.00%,3,2,33.33%
osiprod-krc-blush-azsc-004.koreacentral.cloudapp.azure.com,1,0.00%,1,0,100.00%
osiprod-krc-vulpecula-001.cloudapp.net,1,0.00%,1,0,100.00%
stocks-sparkline.apple.com,1,0.00%,3,2,33.33%
a5ad128f94f1fd400.awsglobalaccelerator.com,1,0.00%,1,0,100.00%
bluedot.is.autonavi.com.gds.alibabadns.com,1,0.00%,1,0,100.00%
thetravelvine.picfair.com,1,0.00%,1,0,100.00%
dmp.brand-display.com,1,0.00%,1,0,100.00%
p13n.adobe.io,1,0.00%,1,0,100.00%
kunyu.csdn.net,1,0.00%,1,0,100.00%
jtrn.is.autonavi.com.gds.alibabadns.com,1,0.00%,1,0,100.00%
down-30005.sz.gfp.tencent-cloud.com,1,0.00%,2,1,50.00%
c0678bbfbefc124a8e4a9f3106efdb05.dlied1.cdntips.net,1,0.00%,1,0,100.00%
ade.googlesyndication.com,1,0.00%,1,0,100.00%
api.meeting.work.weixin.qq.com,1,0.00%,1,0,100.00%
wemeet-da2.qq.com,1,0.00%,1,0,100.00%
wx2.sinaimg.cn,1,0.00%,2,1,50.00%
stinmmtn.vivo.com.cn,1,0.00%,1,0,100.00%
upos-sz-mirrorcosb.bilivideo.com,1,0.00%,2,1,50.00%
fundingchoicesmessages.google.com,1,0.00%,1,0,100.00%
dsum-sec.casalemedia.com,1,0.00%,1,0,100.00%
pica.zhimg.com,1,0.00%,5,4,20.00%
o1013tn36u32026o.aliyunddos1010.com,1,0.00%,1,0,100.00%
picasso-static.xiaohongshu.com,1,0.00%,2,1,50.00%
cstm.baidu.com,1,0.00%,1,0,100.00%
lbs.mail.163.com,1,0.00%,1,0,100.00%
dk3.ache.pdf.officeoncloud.cn,1,0.00%,2,1,50.00%
init-china.itunes-apple.com.akadns.net,1,0.00%,2,1,50.00%
apps.mzstatic.com,1,0.00%,2,1,50.00%
play-china.itunes-apple.com.akadns.net,1,0.00%,2,1,50.00%
sf-api-token-service.itunes.apple.com,1,0.00%,2,1,50.00%
settings-prod-wus2-2.westus2.cloudapp.azure.com,1,0.00%,1,0,100.00%
sns-video-bd.xhscdn.com,1,0.00%,2,1,50.00%
jwxk.ucas.ac.cn,1,0.00%,1,0,100.00%
jw.ucas.ac.cn,1,0.00%,1,0,100.00%
assistant.ceping.com,1,0.00%,1,0,100.00%
transfer-hw.ceping.com,1,0.00%,1,0,100.00%
195.sammentik.cf,1,0.00%,1,0,100.00%
assessmonitor.ceping.com,1,0.00%,1,0,100.00%
pheecws.foxitsoftware.cn,1,0.00%,1,0,100.00%
asia.configsvc1.live.com.akadns.NET,1,0.00%,1,0,100.00%
mrodevicemgr.officeapps.live.com,1,0.00%,2,1,50.00%
task.ac.cn,1,0.00%,1,0,100.00%
conf.wsm.360.cn,1,0.00%,2,1,50.00%
d3g.qq.com,1,0.00%,2,1,50.00%
store-037-lb.blobstore-apple.com.akadns.net,1,0.00%,1,0,100.00%
app-support.blackmagicdesign.com,1,0.00%,1,0,100.00%
de4.videofile.me,1,0.00%,1,0,100.00%
dev.livebeaches.com,1,0.00%,1,0,100.00%
ingest.perchsecurity.com,1,0.00%,1,0,100.00%
staging.app.bloomfarming.com,1,0.00%,1,0,100.00%
scootersoftware.com,1,0.00%,1,0,100.00%
e191.b.akamaiedge.net,1,0.00%,1,0,100.00%
mx25.xmvmess.com,1,0.00%,1,0,100.00%
fcmtoken.googleapis.com,1,0.00%,2,1,50.00%
outlook.ha.office365.com,1,0.00%,2,1,50.00%
ns3.dfn.de,1,0.00%,1,0,100.00%
deneb.dfn.de,1,0.00%,1,0,100.00%
tencent-doc.cdn-go.cn,1,0.00%,2,1,50.00%
tamasi.pizzakaravan.hu,1,0.00%,1,0,100.00%
collect.kugou.com,1,0.00%,2,1,50.00%
mail.checkthewarehouze.ml,1,0.00%,1,0,100.00%
array611.prod.do.dsp.mp.microsoft.com,1,0.00%,1,0,100.00%
iceoiw.ni56es2qy.gq,1,0.00%,1,0,100.00%
creator.zoho.com,1,0.00%,1,0,100.00%
array612.prod.do.dsp.mp.microsoft.com,1,0.00%,3,2,33.33%
new.em-acplumbing.com,1,0.00%,1,0,100.00%
onedscolprdeus04.eastus.cloudapp.azure.com,1,0.00%,1,0,100.00%
staging.app.trackgo.com,1,0.00%,1,0,100.00%
master.wap.dphub.sandai.net,1,0.00%,1,0,100.00%
pr.m.hub.sandai.net,1,0.00%,1,0,100.00%
yr.easyfly.tk,1,0.00%,1,0,100.00%
sla-bac.nutrislice.com,1,0.00%,1,0,100.00%
dl.delivery.mp.microsoft.com,1,0.00%,1,0,100.00%
bt.3dmgame.com,1,0.00%,1,0,100.00%
themaninashed.com,1,0.00%,1,0,100.00%
beertracker.ml,1,0.00%,1,0,100.00%
tracker.openbittorrent.com,1,0.00%,1,0,100.00%
tracker.loadbt.com,1,0.00%,2,1,50.00%
www.worldboxingvideoarchive.com,1,0.00%,1,0,100.00%
denis.stalker.upeer.me,1,0.00%,1,0,100.00%
retracker.joxnet.ru,1,0.00%,1,0,100.00%
bt.firebit.org,1,0.00%,1,0,100.00%
tr.highstar.shop,1,0.00%,2,1,50.00%
stun.freeswitch.org,1,0.00%,1,0,100.00%
tracker3.itzmx.com,1,0.00%,1,0,100.00%
download.pinyin.sogou.com,1,0.00%,1,0,100.00%
eulixos.com,1,0.00%,1,0,100.00%
erigon-mainnet--rpc.datahub.figment.io,1,0.00%,1,0,100.00%
gitea.com,1,0.00%,1,0,100.00%
ee15ba61-wschat-wschatalb-6fcf-2062696737.us-east-1.elb.amazonaws.com,1,0.00%,1,0,100.00%
sf.symcb.com,1,0.00%,2,1,50.00%
csc3-2010-crl.verisign.com,1,0.00%,2,1,50.00%
ocsp.thawte.com,1,0.00%,4,3,25.00%
ts-ocsp.ws.symantec.com,1,0.00%,2,1,50.00%
gracieunitedhancock.classic.kicksite.net,1,0.00%,1,0,100.00%
ts-crl.ws.symantec.com,1,0.00%,2,1,50.00%
vip.asus.com,1,0.00%,1,0,100.00%
s2.symcb.com,1,0.00%,2,1,50.00%
31-courier.push.apple.com,1,0.00%,1,0,100.00%
obs.lz02-br-inet.cn-east-3.myhuaweicloud.cn,1,0.00%,1,0,100.00%
hcdnd101.gslb.c.cdnhwc2.com,1,0.00%,1,0,100.00%
www.tm.ak.prd.aadg.trafficmanager.net,1,0.00%,1,0,100.00%
ubacollect-drcn.cloud.dbankcloud.cn,1,0.00%,1,0,100.00%
explorer.sharemyworks.com,1,0.00%,1,0,100.00%
onedscolprdneu04.northeurope.cloudapp.azure.com,1,0.00%,1,0,100.00%
vd4.bdstatic.com,1,0.00%,2,1,50.00%
netmon-control.dropbox.com,1,0.00%,1,0,100.00%
learn.derose.app,1,0.00%,1,0,100.00%
staging.globusjourneys.in,1,0.00%,1,0,100.00%
subscribe.rss-node.com,1,0.00%,1,0,100.00%
m.o4aac.ga,1,0.00%,1,0,100.00%
k1.gslb.ksyuncdn.com,1,0.00%,2,1,50.00%
onedscolprdneu01.northeurope.cloudapp.azure.com,1,0.00%,1,0,100.00%
auth-v2.oray.com,1,0.00%,1,0,100.00%
ddns.oray.com,1,0.00%,1,0,100.00%
slp2p-east-std1054.oray.net,1,0.00%,1,0,100.00%
license.chinauos.com,1,0.00%,1,0,100.00%
appstore.uniontech.com,1,0.00%,1,0,100.00%
data.uniontech.com,1,0.00%,1,0,100.00%
imap.mail-aipo.apple-dns.cn,1,0.00%,1,0,100.00%
kt-prod.v.aaplimg.com,1,0.00%,1,0,100.00%
gspe35-ssl.ls.apple.com.w.alikunlun.com,1,0.00%,1,0,100.00%
dp.im.weibo.cn,1,0.00%,1,0,100.00%
gateway.im.weibo.cn,1,0.00%,1,0,100.00%
img.alicdn.com,1,0.00%,2,1,50.00%
upload_data.qq.com,1,0.00%,1,0,100.00%
i.gtimg.cn,1,0.00%,1,0,100.00%
ins-5fdz0eh7.ias.tencent-cloud.net,1,0.00%,1,0,100.00%
ipv4.gdt.qq.com,1,0.00%,1,0,100.00%
qzonestyle.gtimg.cn.sched.legopic2.tdnsv6.com.tpic.vwnti.yrzhcloud.cn,1,0.00%,1,0,100.00%
ins-giuzhgwa.ias.tencent-cloud.net,1,0.00%,1,0,100.00%
sdkconfig.video.qq.com,1,0.00%,1,0,100.00%
ins-tgrfs7t3.ias.tencent-cloud.net,1,0.00%,1,0,100.00%
ipv6test.photo.store.qq.com,1,0.00%,2,1,50.00%
juhacqev.sched.sma.tdnsstic1.cn,1,0.00%,1,0,100.00%
tianshu.gtimg.cn.legodlied1-dk.sched.dcloudstc.com,1,0.00%,2,1,50.00%
sqdd.myapp.com.legodlied1-dk.sched.dcloudstc.com,1,0.00%,2,1,50.00%
htdata3.qq.com,1,0.00%,1,0,100.00%
htdata4.qq.com,1,0.00%,1,0,100.00%
circlepic.upqzfile.com,1,0.00%,1,0,100.00%
circlevideo.upqzfile.com,1,0.00%,1,0,100.00%
qqshow2-ufs.qq.com,1,0.00%,1,0,100.00%
qring-tms.qq.com,1,0.00%,1,0,100.00%
tr.gingersoftware.com,1,0.00%,1,0,100.00%
go.microsoft.com.edgekey.NET,1,0.00%,2,1,50.00%
9.rarbg.me,1,0.00%,1,0,100.00%
rc10-linux.oray.com,1,0.00%,1,0,100.00%
jgw-drcn.jos.dbankcloud.cn,1,0.00%,1,0,100.00%
h5hosting.dbankcdn.com,1,0.00%,2,1,50.00%
newvpn.arp.cn,1,0.00%,1,0,100.00%
im1.hicloud.com,1,0.00%,1,0,100.00%
upfile-drcn.platform.hicloud.com,1,0.00%,1,0,100.00%
dps-drcn.jos.dbankcloud.cn,1,0.00%,1,0,100.00%
t.91tianlu.pw,1,0.00%,1,0,100.00%
appdl-3-drcn.dbankcdn.com,1,0.00%,1,0,100.00%
rr.office.microsoft.com,1,0.00%,1,0,100.00%
open.work.weixin.qq.com,1,0.00%,2,1,50.00%
ai.cmbchina.com,1,0.00%,1,0,100.00%
mbmodule-openapi.paas.cmbchina.com,1,0.00%,1,0,100.00%
netpay.cmbchina.com,1,0.00%,1,0,100.00%
acp.zh.cmbchina.com,1,0.00%,1,0,100.00%
pub-api-gateway.paas.cmbchina.com,1,0.00%,1,0,100.00%
img.biquge-app.com,1,0.00%,1,0,100.00%
p1.ssl.qhimg.com,1,0.00%,2,1,50.00%
upos-sz-mirrorhwb.bilivideo.com,1,0.00%,2,1,50.00%
static.m.cmbchina.com,1,0.00%,1,0,100.00%
1099ddb.vfra.dscew.ml,1,0.00%,1,0,100.00%
download.proxmox.com,1,0.00%,2,1,50.00%
sa-update.spamassassin.org,1,0.00%,1,0,100.00%
reflections.repeatmd.com,1,0.00%,1,0,100.00%
onedscolprdgwc01.germanywestcentral.cloudapp.azure.com,1,0.00%,1,0,100.00%
a2-65.akam.net,1,0.00%,1,0,100.00%
a24-66.akam.net,1,0.00%,1,0,100.00%
eyktkpzypweq.exitlist.co,1,0.00%,1,0,100.00%
d0.awsstatic.com,1,0.00%,1,0,100.00%
c.jia.mn,1,0.00%,1,0,100.00%
d.xfinfr.com,1,0.00%,1,0,100.00%
cpanel.magnasoftbim.com,1,0.00%,1,0,100.00%
zgrefgd03.standurl.xyz,1,0.00%,1,0,100.00%
api.lsplayer.com,1,0.00%,1,0,100.00%
img.qwps.cn,1,0.00%,2,1,50.00%
cs.weishi.ijinshan.com,1,0.00%,1,0,100.00%
any.edge.bing.com,1,0.00%,1,0,100.00%
paris.trial.paladinsoftware.com,1,0.00%,1,0,100.00%
rttf.citrix.com,1,0.00%,1,0,100.00%
onedscolprdcus01.centralus.cloudapp.azure.com,1,0.00%,1,0,100.00%
fe2.update.microsoft.com,1,0.00%,2,1,50.00%
onedscolprdwus02.westus.cloudapp.azure.com,1,0.00%,1,0,100.00%
gce-beacons.gcp.gvt2.com,1,0.00%,1,0,100.00%
p218-contacts.icloud.com.cn,1,0.00%,1,0,100.00%
contacts.fe.apple-dns.cn,1,0.00%,1,0,100.00%
guzzoni-apple-com.v.aaplimg.com,1,0.00%,1,0,100.00%
gz3.520vpn.us,1,0.00%,1,0,100.00%
setup.icloud.com,1,0.00%,2,1,50.00%
ipcdn.apple.com,1,0.00%,2,1,50.00%
gsa.idms-apple.com.akadns.net,1,0.00%,1,0,100.00%
onedscolprdfrc02.francecentral.cloudapp.azure.com,1,0.00%,1,0,100.00%
e2c26.gcp.gvt2.com,1,0.00%,1,0,100.00%
e2c53.gcp.gvt2.com,1,0.00%,1,0,100.00%
onedscolprdcus04.centralus.cloudapp.azure.com,1,0.00%,1,0,100.00%
ocsp.digicert.cn.w.cdngslb.com,1,0.00%,1,0,100.00%
api.ipify.org,1,0.00%,1,0,100.00%
passport.weibo.com,1,0.00%,1,0,100.00%
typora.io,1,0.00%,2,1,50.00%
vps02.net.orel.ru,1,0.00%,1,0,100.00%
tracker.supertracker.net,1,0.00%,1,0,100.00%
retracker.telecom.by,1,0.00%,1,0,100.00%
music-torrent.net,1,0.00%,1,0,100.00%
nibba.trade,1,0.00%,1,0,100.00%
lowes.com,1,0.00%,1,0,100.00%
17.push2his.eastmoney.com,1,0.00%,1,0,100.00%
15.push2his.eastmoney.com,1,0.00%,1,0,100.00%
19.push2his.eastmoney.com,1,0.00%,1,0,100.00%
84.push2his.eastmoney.com,1,0.00%,1,0,100.00%
shavar.services.mozilla.com,1,0.00%,1,0,100.00%
23.push2his.eastmoney.com,1,0.00%,1,0,100.00%
87.push2his.eastmoney.com,1,0.00%,1,0,100.00%
yunxin-data-live-126-net-yq.ntes53.netease.com,1,0.00%,1,0,100.00%
openmsf.msf.tencent-cloud.com,1,0.00%,1,0,100.00%
d28139t0r7hg1k.cloudfront.net,1,0.00%,1,0,100.00%
alb-krmaiwe3bwhbkec015.cn-beijing.alb.aliyuncs.com,1,0.00%,1,0,100.00%
user-data-apac-jp.bidswitch.net,1,0.00%,1,0,100.00%
a1887.dscq.akamai.net.0.1.cn.akamaitech.net,1,0.00%,2,1,50.00%
pixel-origin.mathtag.com,1,0.00%,1,0,100.00%
ced.sascdn.com,1,0.00%,1,0,100.00%
s.amazon-adsystem.com,1,0.00%,1,0,100.00%
test.quantcast.mgr.consensu.org,1,0.00%,2,1,50.00%
www.google-analytics.com,1,0.00%,2,1,50.00%
id5-sync.com,1,0.00%,1,0,100.00%
kvt.sddan.com,1,0.00%,1,0,100.00%
s.cpx.to,1,0.00%,1,0,100.00%
www.googletagservices.com,1,0.00%,1,0,100.00%
ssp.ads.betweendigital.com,1,0.00%,1,0,100.00%
prebid.smilewanted.com,1,0.00%,1,0,100.00%
shb.richaudience.com,1,0.00%,1,0,100.00%
pbjs.e-planning.net,1,0.00%,1,0,100.00%
bidder.sg1.vip.prod.criteo.com,1,0.00%,1,0,100.00%
pixel.rubiconproject.net.akadns.net,1,0.00%,1,0,100.00%
1266287590.rsc.cdn77.org,1,0.00%,2,1,50.00%
wmgp-update.wmupd.com.w.alikunlun.com,1,0.00%,1,0,100.00%
httplogserver-lb.global.unified-prod.sharethis.net,1,0.00%,1,0,100.00%
px-eu.adhigh.net,1,0.00%,1,0,100.00%
creativecdn.com,1,0.00%,1,0,100.00%
widget.sg1.vip.prod.criteo.com,1,0.00%,1,0,100.00%
globalsign.com.w.kunlunar.com,1,0.00%,1,0,100.00%
rtb-csync-apac1.smartadserver.com,1,0.00%,1,0,100.00%
ssum-sec.casalemedia.com.cdn.cloudflare.net,1,0.00%,1,0,100.00%
elb-aws-jp-adizio-1511153879.ap-northeast-1.elb.amazonaws.com,1,0.00%,1,0,100.00%
spug-sgc.pubmnet.com,1,0.00%,1,0,100.00%
x01.aidata.io,1,0.00%,1,0,100.00%
imap.cstnet.cn,1,0.00%,1,0,100.00%
msn-china.bing123.com,1,0.00%,1,0,100.00%
d1jm6n7utzqv3r.cloudfront.cn,1,0.00%,1,0,100.00%
o.andfx.cn,1,0.00%,1,0,100.00%
e8960.b.akamaiedge.net,1,0.00%,1,0,100.00%
e7695.dscg.akamaiedge.net,1,0.00%,2,1,50.00%
onedscolprdeus01.eastus.cloudapp.azure.com,1,0.00%,2,1,50.00%
be01mr9s.sched.d2.tdnsdp1.cn.cjt.vwnti.yrzhcloud.cn,1,0.00%,1,0,100.00%
ssp-sync.sg1.vip.prod.criteo.com,1,0.00%,1,0,100.00%
c.tmyzer.com,1,0.00%,1,0,100.00%
sync.ipredictive.com,1,0.00%,1,0,100.00%
drive.google.com,1,0.00%,2,1,50.00%
1.cpm.ak-is2.net,1,0.00%,1,0,100.00%
csm.sg1.vip.prod.criteo.net,1,0.00%,1,0,100.00%
g-msn-com-nsatc.trafficmanager.net,1,0.00%,2,1,50.00%
android.l.google.com,1,0.00%,1,0,100.00%
report.im.qcloud.com,1,0.00%,1,0,100.00%
reswx.tc.qq.com,1,0.00%,2,1,50.00%
reswx.mid.tdnsv6.com,1,0.00%,2,1,50.00%
res.wx.qq.com.sched.legopic1-dk.tdnsv6.com,1,0.00%,2,1,50.00%
sz-qiniu-all.volcgtm.com,1,0.00%,2,1,50.00%
jddriving.theorytestpro.co.uk,1,0.00%,1,0,100.00%
www.soupm25.com,1,0.00%,1,0,100.00%
discovery-v4-4.syncthing.net,1,0.00%,1,0,100.00%
logservice.hicloud.com,1,0.00%,1,0,100.00%
logservice1.hicloud.com,1,0.00%,1,0,100.00%
nsp-logservice-hiview-p41-drcn.obs.cn-north-2.myhuaweicloud.com,1,0.00%,1,0,100.00%
m.npdfr1.ga,1,0.00%,1,0,100.00%
log-reyun-com-for-redirect-1246077432.cn-north-1.elb.amazonaws.com.cn,1,0.00%,1,0,100.00%
app.getsentry.com,1,0.00%,1,0,100.00%
meeting.kdocs.cn,1,0.00%,1,0,100.00%
wenk.ios.wpscdn.cn,1,0.00%,2,1,50.00%
l5.gslb.ksyuncdn.com,1,0.00%,2,1,50.00%
8uof.herokuapp.com,1,0.00%,1,0,100.00%
cdn1.ime.sogou.com,1,0.00%,1,0,100.00%
xdzyfw.10jqka.com.cn,1,0.00%,1,0,100.00%
perfops-3-v4.stackpath.com,1,0.00%,1,0,100.00%
ip2026469127.funshion.com,1,0.00%,1,0,100.00%
vodstreaming.video.globo.com,1,0.00%,1,0,100.00%
encrypted-tbn0.gstatic.com,1,0.00%,3,2,33.33%
id.google.com.hk,1,0.00%,2,1,50.00%
2022.acmmm.org,1,0.00%,1,0,100.00%
tw14.virtual-strike.com,1,0.00%,1,0,100.00%
event.xiaohongshu.com,1,0.00%,1,0,100.00%
m.igame.163.com,1,0.00%,1,0,100.00%
j1hqc7ee.sched.d0-dk.tdnsdp1.cn,1,0.00%,2,1,50.00%
pay-payment.vip.meituan.com,1,0.00%,1,0,100.00%
qqshow-ufs.tencent.com,1,0.00%,1,0,100.00%
e6858.dscx.akamaiedge.net,1,0.00%,2,1,50.00%
mesu.g.aaplimg.com,1,0.00%,2,1,50.00%
metrics.icloud.com,1,0.00%,2,1,50.00%
e2cs17.gcp.gvt2.com,1,0.00%,1,0,100.00%
s3gw.cmbchina.com,1,0.00%,1,0,100.00%
h5.vedamobi.com,1,0.00%,1,0,100.00%
vdn6.vzuu.com,1,0.00%,2,1,50.00%
cdn.exp.xiaomi.com,1,0.00%,1,0,100.00%
beacon-api.aliyuncs.com,1,0.00%,2,1,50.00%
centertime.ksyun.com,1,0.00%,1,0,100.00%
api.kingdata.ksyun.com,1,0.00%,1,0,100.00%
www.bohuitalent.com,1,0.00%,1,0,100.00%
bohuiws.tywangcai.com,1,0.00%,1,0,100.00%
unpkg.zhimg.com,1,0.00%,4,3,25.00%
y.qq.com,1,0.00%,1,0,100.00%
y.qq.com.sched.legopic1.tdnsv6.com,1,0.00%,1,0,100.00%
tmead.y.qq.com,1,0.00%,1,0,100.00%
stat.y.qq.com,1,0.00%,1,0,100.00%
adstats.tencentmusic.com,1,0.00%,2,1,50.00%
c.apple.news,1,0.00%,3,2,33.33%
api.account.xiaomi.com,1,0.00%,1,0,100.00%
api.g.micloud.xiaomi.net,1,0.00%,1,0,100.00%
tz.sec.xiaomi.com,1,0.00%,1,0,100.00%
sdkconfig.ad.xiaomi.com,1,0.00%,1,0,100.00%
glb.api.prod.dcat.dsp.trafficmanager.NET,1,0.00%,1,0,100.00%
bnz05pap001.storage.live.com,1,0.00%,2,1,50.00%
p3.music.126.net,1,0.00%,2,1,50.00%
stats.credly.com,1,0.00%,1,0,100.00%
circlevideo2.photo.qq.com,1,0.00%,2,1,50.00%
bn02pap001.storage.live.com,1,0.00%,2,1,50.00%
watson.telemetry.microsoft.com,1,0.00%,2,1,50.00%
onedsblobprdwus16.westus.cloudapp.azure.com,1,0.00%,1,0,100.00%
vl.dt-autoopt.ru,1,0.00%,1,0,100.00%
0.openwrt.pool.ntp.org,1,0.00%,1,0,100.00%
mirrors163.ntes53.netease.com,1,0.00%,1,0,100.00%
hoots.co.uk,1,0.00%,1,0,100.00%
gfe.nvidia.com,1,0.00%,4,3,25.00%
annemills.foxbyte.uk,1,0.00%,1,0,100.00%
ns3.gdnsec.com,1,0.00%,1,0,100.00%
ns9.gdnsec.com,1,0.00%,1,0,100.00%
i-bn2b-cor003.api.p001.1drv.com,1,0.00%,1,0,100.00%
p43-contacts.icloud.com,1,0.00%,2,1,50.00%
jp-ntt-2.nodeok.icu,1,0.00%,1,0,100.00%
2018.hackthefuture.be,1,0.00%,1,0,100.00%
mail.inpuracithu.ga,1,0.00%,1,0,100.00%
contracts.canonical.com,1,0.00%,1,0,100.00%
inf.ldmnq.com,1,0.00%,1,0,100.00%
array809.prod.do.dsp.mp.microsoft.com,1,0.00%,2,1,50.00%
vip.foxitreader.cn,1,0.00%,1,0,100.00%
genuine.adobe.com,1,0.00%,2,1,50.00%
agsupdate.adobe.com,1,0.00%,2,1,50.00%
edge.api.myqnapcloud.cn,1,0.00%,2,1,50.00%
www36oo.com,1,0.00%,1,0,100.00%
code.osssc.ac.cn,1,0.00%,1,0,100.00%
web-drcn.hispace.dbankcloud.cn,1,0.00%,1,0,100.00%
tracker.swarm3.network,1,0.00%,1,0,100.00%
stun.internetcalls.com,1,0.00%,1,0,100.00%
tracker.tallpenguin.org,1,0.00%,1,0,100.00%
kssv-w-yz01.kuaipandata.com,1,0.00%,1,0,100.00%
torrentclub.tech,1,0.00%,2,1,50.00%
home.penza.com.ru,1,0.00%,1,0,100.00%
retracker.akado-ural.ru,1,0.00%,1,0,100.00%
gwp2-v19.rinet.ru,1,0.00%,1,0,100.00%
array613.prod.do.dsp.mp.microsoft.com,1,0.00%,1,0,100.00%
tracker.nyaa.uk,1,0.00%,1,0,100.00%
sphapi.oray.net,1,0.00%,1,0,100.00%
zephir.monocul.us,1,0.00%,1,0,100.00%
win-crashdump-upload-1255554080.cos.ap-beijing.myqcloud.com,1,0.00%,1,0,100.00%
www.annualcreditreport.com,1,0.00%,1,0,100.00%
tim.qq.com,1,0.00%,1,0,100.00%
account.jetbrains.com,1,0.00%,1,0,100.00%
yeet4iel.nodedata.net,1,0.00%,1,0,100.00%
configuration.ls.apple.com,1,0.00%,2,1,50.00%
onedscolprdwus10.westus.cloudapp.azure.com,1,0.00%,2,1,50.00%
logintcp.wps.cn,1,0.00%,1,0,100.00%
api.segment.io,1,0.00%,1,0,100.00%
settings-prod-wus2-1.westus2.cloudapp.azure.com,1,0.00%,1,0,100.00%
eecs-haproxy-vip.eecs.berkeley.edu,1,0.00%,1,0,100.00%
lbdata.tj.ijinshan.com,1,0.00%,1,0,100.00%
valisimofashions.com,1,0.00%,1,0,100.00%
f7yzbgp.a.sohu.com,1,0.00%,1,0,100.00%
16fpjqhi.sched.d0.tdnsdp1.cn,1,0.00%,1,0,100.00%
32x7bcvl.sched.d0.tdnsdp1.cn,1,0.00%,1,0,100.00%
nd4gdvse.sched.d0.tdnsdp1.cn,1,0.00%,1,0,100.00%
onedriveclucprodbn20043.blob.core.windows.net,1,0.00%,1,0,100.00%
www.iie.ac.cn,1,0.00%,1,0,100.00%
www.iie.cas.cn,1,0.00%,1,0,100.00%
ali-bj-pcdn-14.biliapi.net,1,0.00%,1,0,100.00%
tracker2.itzmx.com,1,0.00%,1,0,100.00%
wps-file.obs.cn-north-4.myhuaweicloud.com,1,0.00%,1,0,100.00%
d1tcio87buo4yy.cloudfront.net,1,0.00%,1,0,100.00%
live.bilibili.com,1,0.00%,1,0,100.00%
hw-sh-live-p2p-3.chat.bilibili.com,1,0.00%,1,0,100.00%
hcdnw.nozj.bili.c.cdnhwc2.com,1,0.00%,1,0,100.00%
s1.hdslb.com.w.kunlunar.com,1,0.00%,1,0,100.00%
sp.sangfor.com.cn,1,0.00%,1,0,100.00%
iadsdk.qtlcdn.com,1,0.00%,1,0,100.00%
hl2rcv.adobe.com,1,0.00%,1,0,100.00%
sb.scorecardresearch.com,1,0.00%,1,0,100.00%
js1.pcfg.cache.wpscdn.cn,1,0.00%,3,2,33.33%
d3uniwo7xqjvhe.cloudfront.net,1,0.00%,1,0,100.00%
ime.sogou.com,1,0.00%,1,0,100.00%
p.qiao.baidu.com,1,0.00%,1,0,100.00%
skin.se.360.cn,1,0.00%,1,0,100.00%
pcs.baidu.com,1,0.00%,1,0,100.00%
webpush.pan.baidu.com,1,0.00%,1,0,100.00%
pcsdata.baidu.com,1,0.00%,1,0,100.00%
yun.baidu.com,1,0.00%,1,0,100.00%
nd-static.bdstatic.com,1,0.00%,1,0,100.00%
code.bdstatic.com,1,0.00%,1,0,100.00%
pannss.bdstatic.com,1,0.00%,1,0,100.00%
sdk-open-phone.getui.com,1,0.00%,1,0,100.00%
xlab.baidu.com,1,0.00%,1,0,100.00%
wwads.cn,1,0.00%,1,0,100.00%
nsp-hicloud-cloudphotonorth4-p02-drcn.obs.cn-north-4.myhuaweicloud.cn,1,0.00%,1,0,100.00%
fund.cingta.com,1,0.00%,1,0,100.00%
static.cingta.com,1,0.00%,1,0,100.00%
c.cnzz.com,1,0.00%,1,0,100.00%
imap.mail.me.com,1,0.00%,1,0,100.00%
onedriveclucprodbn20025.blob.core.windows.net,1,0.00%,1,0,100.00%
www.baidupcs.com,1,0.00%,1,0,100.00%
qd.baidupcs.com,1,0.00%,1,0,100.00%
bj.baidupcs.com,1,0.00%,1,0,100.00%
bjbgp01.baidupcs.com,1,0.00%,1,0,100.00%
www.xboxab.com,1,0.00%,1,0,100.00%
lfghub-anonymous.xboxlive.com,1,0.00%,1,0,100.00%
v20.vortex-win.data.microsoft.com,1,0.00%,1,0,100.00%
www.ict.cas.cn,1,0.00%,1,0,100.00%
dgss3.bdstatic.com,1,0.00%,2,1,50.00%
sc1.hao123img.com,1,0.00%,2,1,50.00%
hao123-static.cdn.bcebos.com,1,0.00%,2,1,50.00%
sc0.hao123img.com,1,0.00%,2,1,50.00%
cn.chinadaily.com.cn,1,0.00%,2,1,50.00%
img1.hao123.com,1,0.00%,2,1,50.00%
img2.hao123.com,1,0.00%,2,1,50.00%
dgss2.bdstatic.com,1,0.00%,2,1,50.00%
www.cctv.com,1,0.00%,2,1,50.00%
code.51.com,1,0.00%,1,0,100.00%
focus.tianya.cn,1,0.00%,1,0,100.00%
gad.netease.com,1,0.00%,1,0,100.00%
www.12306.cn,1,0.00%,2,1,50.00%
www.chsi.com.cn,1,0.00%,1,0,100.00%
www.eastmoney.com,1,0.00%,2,1,50.00%
www.huya.com,1,0.00%,2,1,50.00%
www.icbc.com.cn,1,0.00%,2,1,50.00%
www.iqiyi.com,1,0.00%,2,1,50.00%
www.mgtv.com,1,0.00%,2,1,50.00%
xueshu.baidu.com,1,0.00%,2,1,50.00%
fenwan.cdn.bcebos.com,1,0.00%,2,1,50.00%
shark-tracer.netease.com,1,0.00%,1,0,100.00%
v.6.cn,1,0.00%,1,0,100.00%
v.qq.com,1,0.00%,2,1,50.00%
www.ce.cn,1,0.00%,2,1,50.00%
www.china.com.cn,1,0.00%,2,1,50.00%
www.gmw.cn,1,0.00%,2,1,50.00%
www.people.com.cn,1,0.00%,2,1,50.00%
www.xinhuanet.com,1,0.00%,2,1,50.00%
dgss0.baidu.com,1,0.00%,2,1,50.00%
dgss2.baidu.com,1,0.00%,2,1,50.00%
dgss1.baidu.com,1,0.00%,2,1,50.00%
caldav.icloud.com,1,0.00%,2,1,50.00%
helpinfockeniu1.ksmobile.com,1,0.00%,1,0,100.00%
weu08-breeziest-in.cloudapp.net,1,0.00%,1,0,100.00%
puncher.dcdn.n.shifen.com,1,0.00%,1,0,100.00%
agd.p.360.cn,1,0.00%,1,0,100.00%
static.zhihu.com,1,0.00%,4,3,25.00%
channel-account-ssl.xunlei.com,1,0.00%,1,0,100.00%
o1069899.ingest.sentry.io,1,0.00%,1,0,100.00%
tracking.firefox.com.cn.wswebpic.com,1,0.00%,1,0,100.00%
3wabxy9b.sched.sma.tdnsstic1.cn,1,0.00%,1,0,100.00%
0i4k7t9l.sched.sma-dk.tdnsstic1.cn,1,0.00%,2,1,50.00%
gspe79-cn-ssl.ls.apple.com,1,0.00%,1,0,100.00%
passport.n.shifen.com,1,0.00%,2,1,50.00%
sslbaidu.jomodns.com,1,0.00%,1,0,100.00%
www.mysmth.net,1,0.00%,1,0,100.00%
static.mysmth.net,1,0.00%,2,1,50.00%
manifest.googlevideo.com,1,0.00%,2,1,50.00%
phx02pap001.storage.live.com,1,0.00%,2,1,50.00%
sz-qiniu-v4.volcgtm.com,1,0.00%,1,0,100.00%
wns.notify.trafficmanager.net,1,0.00%,2,1,50.00%
iv6.gtimg.cn,1,0.00%,2,1,50.00%
baike.baidu.com,1,0.00%,2,1,50.00%
finder.video.qq.com,1,0.00%,2,1,50.00%
api.mixpanel.com,1,0.00%,1,0,100.00%
sourcegraph.com,1,0.00%,2,1,50.00%
dragate.dc.oppomobile.com,1,0.00%,1,0,100.00%
vdposter.bdstatic.com,1,0.00%,2,1,50.00%
api.zhihu.com,1,0.00%,2,1,50.00%
wapepaper.stcn.com,1,0.00%,1,0,100.00%
ta.trs.cn,1,0.00%,1,0,100.00%
static.bshare.cn,1,0.00%,1,0,100.00%
info.stcn.com,1,0.00%,1,0,100.00%
wap.stcn.com,1,0.00%,1,0,100.00%
rs.stcn.com,1,0.00%,1,0,100.00%
xinpi.stcn.com,1,0.00%,1,0,100.00%
bshare.optimix.cn,1,0.00%,1,0,100.00%
onedscolprdeus14.eastus.cloudapp.azure.com,1,0.00%,1,0,100.00%
www.bshare.cn,1,0.00%,1,0,100.00%
its.fugetech.com,1,0.00%,1,0,100.00%
m.reachmax.cn,1,0.00%,1,0,100.00%
cm-udmp.gridsumdissector.com,1,0.00%,1,0,100.00%
bx01.optimix.cn,1,0.00%,1,0,100.00%
img.ljcdn.com,1,0.00%,2,1,50.00%
sugar.zhihu.com,1,0.00%,2,1,50.00%
m-cloud.zhihu.com,1,0.00%,2,1,50.00%
crash2.zhihu.com,1,0.00%,2,1,50.00%
aidatatest.zhihu.com,1,0.00%,2,1,50.00%
appcloud2.zhihu.com,1,0.00%,2,1,50.00%
lens.zhihu.com,1,0.00%,2,1,50.00%
assets.imedao.com.w.alikunlun.com,1,0.00%,1,0,100.00%
open.xueqiu.com,1,0.00%,1,0,100.00%
dsp.ads.umeng.com,1,0.00%,2,1,50.00%
csdn.log-global.aliyuncs.com.w.cdngslb.com,1,0.00%,2,1,50.00%
auth.grammarly.com,1,0.00%,1,0,100.00%
stat.tiara.kakao.com,1,0.00%,2,1,50.00%
play.kakao.com,1,0.00%,2,1,50.00%
t1.daumcdn.net,1,0.00%,2,1,50.00%
static.geetest.com,1,0.00%,2,1,50.00%
web.50bangzh.com,1,0.00%,1,0,100.00%
api.steambig.com,1,0.00%,1,0,100.00%
mbook.duote.com,1,0.00%,1,0,100.00%
police.cnool.net,1,0.00%,1,0,100.00%
submit.duote.com,1,0.00%,1,0,100.00%
union.rising.com.cn,1,0.00%,1,0,100.00%
www.avira.com,1,0.00%,2,1,50.00%
www.jiangmin.com,1,0.00%,1,0,100.00%
www.zx110.org,1,0.00%,1,0,100.00%
front.steambig.com,1,0.00%,1,0,100.00%
media.vuess.net,1,0.00%,1,0,100.00%
d.url.cn,1,0.00%,2,1,50.00%
public.gdtimg.com,1,0.00%,2,1,50.00%
1610067831.D4EE073C2A20.device.hiwifi.com,1,0.00%,1,0,100.00%
asf-ris-prod-easia-azsc.eastasia.cloudapp.azure.com,1,0.00%,1,0,100.00%
s.symcb.com,1,0.00%,2,1,50.00%
dl-debug.dropbox.com,1,0.00%,2,1,50.00%
1610067893.D4EE073C2A20.device.hiwifi.com,1,0.00%,1,0,100.00%
prdwss-prod-nlb-wss-b8099ab1e72f69ce.elb.us-west-2.amazonaws.com,1,0.00%,1,0,100.00%
www.gstatic.cn,1,0.00%,1,0,100.00%
efjxmwi.amo.dseoe.ga,1,0.00%,1,0,100.00%
abc.rudywoo.ml,1,0.00%,1,0,100.00%
vkk49ekoc3luxt0d.b.requestbin.net,1,0.00%,1,0,100.00%
update-windows.grammarly.com,1,0.00%,1,0,100.00%
update.inter.iqiyi.com,1,0.00%,1,0,100.00%
ovv4.alllook.tv,1,0.00%,1,0,100.00%
50-courier.push.apple.com,1,0.00%,1,0,100.00%
videoepg.hicloud.com,1,0.00%,2,1,50.00%
weu06-breeziest-in.cloudapp.net,1,0.00%,1,0,100.00%
test.friends.getambassador.com,1,0.00%,1,0,100.00%
v10.vortex-win.data.microsoft.com,1,0.00%,1,0,100.00%
ac.dun.163yun.com,1,0.00%,2,1,50.00%
www.voD.lxdns.CoM,1,0.00%,2,1,50.00%
e2cs03.gcp.gvt2.com,1,0.00%,1,0,100.00%
array503.prod.do.dsp.mp.microsoft.com,1,0.00%,2,1,50.00%
array812.prod.do.dsp.mp.microsoft.com,1,0.00%,1,0,100.00%
array804.prod.do.dsp.mp.microsoft.com,1,0.00%,1,0,100.00%
bxjbqj09.e0.sched.ovscdns.com,1,0.00%,2,1,50.00%
is.iscas.ac.cn,1,0.00%,1,0,100.00%
msg-push.duba.net,1,0.00%,1,0,100.00%
tracker.mywaifu.best,1,0.00%,1,0,100.00%
tracker.msm8916.com,1,0.00%,2,1,50.00%
qup.b.360wscdn.com,1,0.00%,1,0,100.00%
openbittorrent.com,1,0.00%,1,0,100.00%
track.plop.pm,1,0.00%,1,0,100.00%
pow7.com,1,0.00%,2,1,50.00%
p4p.arenabg.com,1,0.00%,1,0,100.00%
tracker.zerobytes.xyz,1,0.00%,1,0,100.00%
ns11.zonecybersite.com,1,0.00%,1,0,100.00%
ns76.cybersitezone.com,1,0.00%,1,0,100.00%
ns10.zonecybersite.com,1,0.00%,1,0,100.00%
ns77.cybersitezone.com,1,0.00%,1,0,100.00%
sn.webrootcloudav.com,1,0.00%,1,0,100.00%
pdns196.ultradns.biz,1,0.00%,2,1,50.00%
pdns124.ultradns.biz,1,0.00%,2,1,50.00%
intf-pc.ludashi.com,1,0.00%,1,0,100.00%
44.push2his.eastmoney.com,1,0.00%,1,0,100.00%
96.push2his.eastmoney.com,1,0.00%,1,0,100.00%
21.push2his.eastmoney.com,1,0.00%,1,0,100.00%
tracker.hdsky.me,1,0.00%,2,1,50.00%
deb.nodesource.com,1,0.00%,2,1,50.00%
ws.mmstat.com.gds.alibabadns.com,1,0.00%,1,0,100.00%
hsk-api.oray.com,1,0.00%,1,0,100.00%
phfwba-std-g1.oray.net,1,0.00%,1,0,100.00%
phsle5-std05.oray.net,1,0.00%,1,0,100.00%
appvolcanoedc.jianguoyun.com,1,0.00%,1,0,100.00%
caldav.fe.apple-dns.net,1,0.00%,2,1,50.00%
find.api.micloud.xiaomi.net,1,0.00%,1,0,100.00%
weu09-breeziest-in.cloudapp.net,1,0.00%,1,0,100.00%
musicps.p2p.qq.com,1,0.00%,1,0,100.00%
onedscolprdneu03.northeurope.cloudapp.azure.com,1,0.00%,1,0,100.00%
xiyou.cloud,1,0.00%,1,0,100.00%
SIN-efz.ms-acdc.office.com,1,0.00%,2,1,50.00%
findermp.video.qq.com,1,0.00%,2,1,50.00%
login.qfarm.qq.com,1,0.00%,1,0,100.00%
sensors.ibreader.com,1,0.00%,1,0,100.00%
jingyan.baidu.com,1,0.00%,2,1,50.00%
v26.bdxiguavod.com,1,0.00%,2,1,50.00%
edgeservices.bing.com,1,0.00%,2,1,50.00%
time1.bytedance.com,1,0.00%,1,0,100.00%
bit.jjyy.ml,1,0.00%,1,0,100.00%
graph.facebook.com,1,0.00%,2,1,50.00%
init.ess.apple.com,1,0.00%,1,0,100.00%
pcwallpaper.zhhainiao.com,1,0.00%,1,0,100.00%
www.iscas.ac.cn,1,0.00%,1,0,100.00%
pudn-static.oss-cn-beijing.aliyuncs.com,1,0.00%,1,0,100.00%
m.onegreen.net.cdn30.com,1,0.00%,1,0,100.00%
sslzz.jomodns.com,1,0.00%,1,0,100.00%
aoufnebg.dayugslb.com,1,0.00%,1,0,100.00%
index-cdn.jetbrains.com,1,0.00%,2,1,50.00%
vulnerability-search.europe-north1-gke.intellij.net,1,0.00%,1,0,100.00%
cn-zjk-ali-r001.router.teamviewer.cn,1,0.00%,1,0,100.00%
parrot-pc-1251479438.cos.ap-beijing.myqcloud.com,1,0.00%,1,0,100.00%
onedscolprdwus01.westus.cloudapp.azure.com,1,0.00%,2,1,50.00%
georeferencer.outerspatial.com,1,0.00%,1,0,100.00%
stock.eastmoney.com,1,0.00%,2,1,50.00%
www.google.cn,1,0.00%,1,0,100.00%
57afda59-ed10-407a-a920-26b0b1695d40.assets.booqable.com,1,0.00%,1,0,100.00%
pdns196.ultradns.info,1,0.00%,2,1,50.00%
extensions.gnome.org,1,0.00%,1,0,100.00%
www.zybuluo.com,1,0.00%,1,0,100.00%
img1.pcfg.cache.wpscdn.cn,1,0.00%,2,1,50.00%
img-prod-cms-rt-microsoft-com.akamaized.net,1,0.00%,2,1,50.00%
2csvr-basic.wpsdns.com,1,0.00%,1,0,100.00%
tlu.dl.delivery.mp.microsoft.com,1,0.00%,1,0,100.00%
ieonlinews.trafficmanager.NET,1,0.00%,2,1,50.00%
jx.cdn.qhstatic.com,1,0.00%,2,1,50.00%
onedriveclucprodbn20036.blob.core.windows.net,1,0.00%,1,0,100.00%
hwvipkid.vipkidcdn.com,1,0.00%,1,0,100.00%
onedriveclucproddm20023.blob.core.windows.net,1,0.00%,1,0,100.00%
skl.la1.mclqp.link,1,0.00%,1,0,100.00%
d3my7gygxlhw3x.cloudfront.net,1,0.00%,1,0,100.00%
e-0014.e-msedge.NET,1,0.00%,1,0,100.00%
shrouded-wave-5410.morning-tundra-7160.herokuspace.com,1,0.00%,1,0,100.00%
plugin.browser.qq.com,1,0.00%,1,0,100.00%
ntp.ubuntu.com,0,0.00%,13583,13583,0.00%
hub.upyun.com,0,0.00%,290,290,0.00%
log.tailscale.io,0,0.00%,378,378,0.00%
smtp.qq.com,0,0.00%,288,288,0.00%
controlplane.tailscale.com,0,0.00%,24,24,0.00%
grafana.com,0,0.00%,168,168,0.00%
raw.githubusercontent.com,0,0.00%,91,91,0.00%
fedoraproject.org,0,0.00%,35,35,0.00%
api.8864029a8b01d50a95d558b5792ce2d6.com,0,0.00%,4,4,0.00%
tracker.lilithraws.cf,0,0.00%,6,6,0.00%
dns.google,0,0.00%,200,200,0.00%
client.mail.163.com,0,0.00%,16,16,0.00%
education-certification.youdao.com,0,0.00%,1,1,0.00%
ulogs.umeng.com,0,0.00%,6,6,0.00%
ydpushserver.youdao.com,0,0.00%,1,1,0.00%
cidian.youdao.com,0,0.00%,6,6,0.00%
wow.youdao.com,0,0.00%,2,2,0.00%
wow-activity.youdao.com,0,0.00%,2,2,0.00%
time.g.aaplimg.com,0,0.00%,16,16,0.00%
www.toutiao.com,0,0.00%,3,3,0.00%
imgcache.qq.com,0,0.00%,1,1,0.00%
wx.qlogo.cn,0,0.00%,72,72,0.00%
v2.shyonghui.xyz,0,0.00%,1,1,0.00%
i.work.weixin.qq.com,0,0.00%,23,23,0.00%
gap.work.weixin.qq.com,0,0.00%,3,3,0.00%
badjs.weixinbridge.com,0,0.00%,11,11,0.00%
www.notion.so,0,0.00%,18,18,0.00%
mp.weixin.qq.com,0,0.00%,16,16,0.00%
music.91q.com,0,0.00%,1,1,0.00%
passport.bdimg.com,0,0.00%,1,1,0.00%
fanyi.youdao.com,0,0.00%,12,12,0.00%
fanyi.ntes53.netease.com,0,0.00%,9,9,0.00%
dns.msftncsi.com,0,0.00%,994,994,0.00%
g.alicdn.com,0,0.00%,1,1,0.00%
aqyzmedia.yunaq.com,0,0.00%,2,2,0.00%
v.yunaq.com,0,0.00%,2,2,0.00%
tjs.sjs.sinajs.cn,0,0.00%,2,2,0.00%
mozilla.cloudflare-dns.com,0,0.00%,29,29,0.00%
db.local.clamav.net,0,0.00%,402,402,0.00%
database.clamav.net,0,0.00%,258,258,0.00%
h5.qzone.qq.com,0,0.00%,160,160,0.00%
docs.qq.com,0,0.00%,52,52,0.00%
quay.io,0,0.00%,74,74,0.00%
wup.imtt.qq.com,0,0.00%,19,19,0.00%
maps.windows.com,0,0.00%,2,2,0.00%
fe3cr.delivery.mp.microsoft.com,0,0.00%,27,27,0.00%
wx1.qq.com,0,0.00%,70,70,0.00%
weibo.com,0,0.00%,71,71,0.00%
slscr.update.microsoft.com,0,0.00%,49,49,0.00%
glb.sls.prod.dcat.dsp.trafficmanager.net,0,0.00%,34,34,0.00%
set.gosts.gq,0,0.00%,1,1,0.00%
tvax4.sinaimg.cn,0,0.00%,14,14,0.00%
tvax2.sinaimg.cn,0,0.00%,6,6,0.00%
h.trace.qq.com,0,0.00%,29,29,0.00%
loggw.alipay.com.cn,0,0.00%,4,4,0.00%
dns.weixin.qq.com.cn,0,0.00%,111,111,0.00%
access.toggle.qq.com,0,0.00%,43,43,0.00%
f.video.weibocdn.com,0,0.00%,2,2,0.00%
tva2.sinaimg.cn,0,0.00%,4,4,0.00%
short.weixin.qq.com,0,0.00%,12,12,0.00%
zerossl.ocsp.sectigo.com,0,0.00%,52,52,0.00%
E.ROOT-SERVERS.NET,0,0.00%,3,3,0.00%
G.ROOT-SERVERS.NET,0,0.00%,3,3,0.00%
brxt-research.mendeley.com,0,0.00%,2,2,0.00%
tracker.ipv6tracker.ru,0,0.00%,2,2,0.00%
s.c-ctrip.com,0,0.00%,2,2,0.00%
tpstelemetry.tencent.com,0,0.00%,13,13,0.00%
spo-ring.msedge.net,0,0.00%,2,2,0.00%
static-ecst.licdn.com,0,0.00%,2,2,0.00%
hc.tdm.qq.com,0,0.00%,2,2,0.00%
natdetection.onethingpcs.com,0,0.00%,2,2,0.00%
event.csdn.net,0,0.00%,4,4,0.00%
szextshort.weixin.qq.com,0,0.00%,18,18,0.00%
newclient.map.baidu.com,0,0.00%,2,2,0.00%
client.map.baidu.com,0,0.00%,2,2,0.00%
pay.weixin.qq.com,0,0.00%,2,2,0.00%
wx.tenpay.com,0,0.00%,2,2,0.00%
game.weixin.qq.com,0,0.00%,2,2,0.00%
api.ivideo.sina.com.cn,0,0.00%,4,4,0.00%
gchat.qpic.cn,0,0.00%,20,20,0.00%
yun-hl.3g.qq.com,0,0.00%,4,4,0.00%
p2pstuntest.haplat.net,0,0.00%,4,4,0.00%
stup7.appmeasurements.com,0,0.00%,4,4,0.00%
bae.appmeasurements.com,0,0.00%,4,4,0.00%
t1.appmeasurements.com,0,0.00%,3,3,0.00%
ipv6.msftconnecttest.com,0,0.00%,18,18,0.00%
appconf.mail.163.com,0,0.00%,26,26,0.00%
config.edge.skype.com,0,0.00%,50,50,0.00%
mx3.qq.com,0,0.00%,2,2,0.00%
mx2.qq.com,0,0.00%,2,2,0.00%
mx1.qq.com,0,0.00%,2,2,0.00%
rmonitor.qq.com,0,0.00%,4,4,0.00%
tva1.sinaimg.cn,0,0.00%,2,2,0.00%
web.qun.qq.com,0,0.00%,4,4,0.00%
c.bing.com,0,0.00%,3,3,0.00%
bdbus-turbonet.baidu.com,0,0.00%,2,2,0.00%
tools.3g.qq.com,0,0.00%,2,2,0.00%
android.bugly.qq.com,0,0.00%,2,2,0.00%
aps.amap.com,0,0.00%,5,5,0.00%
data.ab.qq.com,0,0.00%,4,4,0.00%
p.qlogo.cn,0,0.00%,6,6,0.00%
s.1688.com,0,0.00%,2,2,0.00%
gitlab.com,0,0.00%,42,42,0.00%
lookup.nextcloud.com,0,0.00%,274,274,0.00%
ping.dgraph.io,0,0.00%,200,200,0.00%
tracker.1337x.org,0,0.00%,140,140,0.00%
60-fps.org,0,0.00%,6,6,0.00%
www.all4nothin.net,0,0.00%,4,4,0.00%
btracker.top,0,0.00%,6,6,0.00%
kubernetes-charts.storage.googleapis.com,0,0.00%,12,12,0.00%
siambit.com,0,0.00%,184,184,0.00%
ping3.teamviewer.com,0,0.00%,25,25,0.00%
tracker.gbitt.info,0,0.00%,6,6,0.00%
filehelper.weixin.qq.com,0,0.00%,344,344,0.00%
nvidia.github.io,0,0.00%,5,5,0.00%
ppa.launchpad.net,0,0.00%,17,17,0.00%
bttracker.debian.org,0,0.00%,3,3,0.00%
tracker.anirena.com,0,0.00%,4,4,0.00%
gzc-download.weiyun.com,0,0.00%,2,2,0.00%
open.trackerlist.xyz,0,0.00%,6,6,0.00%
tracker.openzim.org,0,0.00%,6,6,0.00%
tracker.foreverpirates.co,0,0.00%,4,4,0.00%
cqc-download.weiyun.com,0,0.00%,2,2,0.00%
potuk.com,0,0.00%,19,19,0.00%
0d.kebhana.mx,0,0.00%,6,6,0.00%
all4nothin.net,0,0.00%,6,6,0.00%
tracker.nanoha.org,0,0.00%,8,8,0.00%
tracker.moeking.me,0,0.00%,6,6,0.00%
hub5pn.v6.sandai.net,0,0.00%,18,18,0.00%
cn.archive.ubuntu.com,0,0.00%,21,21,0.00%
security.ubuntu.com,0,0.00%,18,18,0.00%
map.n.shifen.com,0,0.00%,12,12,0.00%
report.url.cn,0,0.00%,28,28,0.00%
crl.usertrust.com,0,0.00%,8,8,0.00%
crl.comodoca.com,0,0.00%,5,5,0.00%
inversine.elseway.tk,0,0.00%,61,61,0.00%
vcityteam.github.io,0,0.00%,1,1,0.00%
public.dns.iij.jp,0,0.00%,18,18,0.00%
t.nyaatracker.com,0,0.00%,10,10,0.00%
localhost.localdomain,0,0.00%,2,2,0.00%
hello-sherlock.github.io,0,0.00%,1,1,0.00%
autoupdate.geo.opera.com,0,0.00%,2,2,0.00%
discuss.pytorch.org,0,0.00%,2,2,0.00%
mailhz.qiye.163.com,0,0.00%,3,3,0.00%
mirrors.bfsu.edu.cn,0,0.00%,12,12,0.00%
localhost,0,0.00%,453,453,0.00%
mirrors.tuna.tsinghua.edu.cn,0,0.00%,16,16,0.00%
mirrorz.org,0,0.00%,8,8,0.00%
ntd-asus-2014b-en.fbs20.trendmicro.com,0,0.00%,6,6,0.00%
gslb6.fbs.trendmicro.com.akadns.net,0,0.00%,6,6,0.00%
aws-prod.fbs25.trendmicro.com,0,0.00%,6,6,0.00%
fbs.prod.spn.a1q7.net,0,0.00%,6,6,0.00%
ping.manjaro.org,0,0.00%,28,28,0.00%
osint.bambenekconsulting.com,0,0.00%,10,10,0.00%
swh.app,0,0.00%,2,2,0.00%
www.kdocs.cn,0,0.00%,20,20,0.00%
msgacs.youku.com,0,0.00%,6,6,0.00%
musa-550-fall-2021.github.io,0,0.00%,1,1,0.00%
minorshort.weixin.qq.com,0,0.00%,19,19,0.00%
pypi.org,0,0.00%,11234,11234,0.00%
masters-tb.com,0,0.00%,4,4,0.00%
peersteers.org,0,0.00%,18,18,0.00%
data-bg.net,0,0.00%,4,4,0.00%
www.meituan.com,0,0.00%,26,26,0.00%
tracker.nucozer-tracker.ml,0,0.00%,2,2,0.00%
tracker.xn--vzyr4p.top,0,0.00%,4,4,0.00%
grouptalk.c2c.qq.com,0,0.00%,4,4,0.00%
torrent.fedoraproject.org,0,0.00%,6,6,0.00%
tr.fuckbitcoin.xyz,0,0.00%,4,4,0.00%
datascene.net,0,0.00%,4,4,0.00%
s2.xoimg.com,0,0.00%,2,2,0.00%
tracker.vectahosting.eu,0,0.00%,12,12,0.00%
open.nyap2p.com,0,0.00%,2,2,0.00%
trackme.theom.nz,0,0.00%,4,4,0.00%
1337.abcvg.info,0,0.00%,4,4,0.00%
torrent.ubuntu.com,0,0.00%,4,4,0.00%
tr.abiir.top,0,0.00%,4,4,0.00%
torrenttracker.nwc.acsalaska.net,0,0.00%,2,2,0.00%
tr.burnabyhighstar.com,0,0.00%,4,4,0.00%
login.tailscale.com,0,0.00%,166,166,0.00%
jjm2473.github.io,0,0.00%,1,1,0.00%
time.nist.gov,0,0.00%,27,27,0.00%
vcsa.vmware.com,0,0.00%,4,4,0.00%
graph.microsoft.com,0,0.00%,3,3,0.00%
v6-4.nigirocloud.com,0,0.00%,8,8,0.00%
api.blockcypher.com,0,0.00%,10,10,0.00%
time.apple.com,0,0.00%,14,14,0.00%
cgi.ark.qq.com,0,0.00%,5,5,0.00%
detectportal.prod.mozaws.net,0,0.00%,51,51,0.00%
qb-extension.firebaseio.com,0,0.00%,2,2,0.00%
bk.n.shifen.com,0,0.00%,20,20,0.00%
files.pfsense.org,0,0.00%,8,8,0.00%
astat.bugly.qq.com,0,0.00%,3,3,0.00%
dstore-metadata.deepin.cn,0,0.00%,26,26,0.00%
im.dingtalk.com,0,0.00%,2,2,0.00%
ios.bugly.qq.com,0,0.00%,8,8,0.00%
ulogs.umeng.com.gds.alibabadns.com,0,0.00%,2,2,0.00%
alog-default.umeng.com,0,0.00%,1,1,0.00%
messaging.contact-module.ibm.com,0,0.00%,6,6,0.00%
www.bt.cn,0,0.00%,13,13,0.00%
example.org,0,0.00%,26,26,0.00%
hdwebv6.mail.split.netease.com,0,0.00%,2,2,0.00%
repos.fedorapeople.org,0,0.00%,2,2,0.00%
ten.sngapm.qq.com,0,0.00%,6,6,0.00%
jubao.qq.com,0,0.00%,2,2,0.00%
otheve.beacon.qq.com,0,0.00%,10,10,0.00%
h5.sinaimg.cn,0,0.00%,4,4,0.00%
tvax3.sinaimg.cn,0,0.00%,4,4,0.00%
tva4.sinaimg.cn,0,0.00%,2,2,0.00%
tvax1.sinaimg.cn,0,0.00%,7,7,0.00%
adsp.xunlei.com,0,0.00%,3,3,0.00%
mirrors.ustc.edu.cn,0,0.00%,8,8,0.00%
archive.canonical.com,0,0.00%,2,2,0.00%
sa-update-asf.snb.it,0,0.00%,4,4,0.00%
wap.cmpassport.com,0,0.00%,2,2,0.00%
voice.baidu.com,0,0.00%,2,2,0.00%
countly.mail.163.com,0,0.00%,2,2,0.00%
szminorshort.weixin.qq.com,0,0.00%,8,8,0.00%
7et2ri.qqscml.ml,0,0.00%,2,2,0.00%
yiyun.n.shifen.com,0,0.00%,4,4,0.00%
rmm233.github.io,0,0.00%,61,61,0.00%
dict.youdao.com,0,0.00%,12,12,0.00%
www.hotjob.cn,0,0.00%,2,2,0.00%
hztp.hotjob.cn,0,0.00%,2,2,0.00%
d2f1a68rmuokoa.cloudfront.net,0,0.00%,1,1,0.00%
bitbucket.org,0,0.00%,2,2,0.00%
kdocs.cn,0,0.00%,9,9,0.00%
static-asm.secure.skypeassets.com,0,0.00%,27,27,0.00%
vowel.egsesisurgires.tk,0,0.00%,1,1,0.00%
metrics.raptr.com,0,0.00%,4,4,0.00%
data6.video.iqiyi.com,0,0.00%,8,8,0.00%
dashi.163.com,0,0.00%,2,2,0.00%
dns.twnic.tw,0,0.00%,15,15,0.00%
motd.ubuntu.com,0,0.00%,3,3,0.00%
speeddials.opera.com,0,0.00%,2,2,0.00%
time-macos.apple.com,0,0.00%,2,2,0.00%
tracker.byr.pt,0,0.00%,4,4,0.00%
platform.bing.com,0,0.00%,5,5,0.00%
d15po2y6qe9yxr.cloudfront.net,0,0.00%,1,1,0.00%
imap.qq.com,0,0.00%,4,4,0.00%
az667904.vo.msecnd.net,0,0.00%,29,29,0.00%
22082c5dc02e4643bb2c4417b346f0fb.fp.measure.office.com,0,0.00%,1,1,0.00%
ssl.ptlogin2.graph.qq.com,0,0.00%,19,19,0.00%
xui.ptlogin2.qq.com,0,0.00%,19,19,0.00%
graph.qq.com,0,0.00%,18,18,0.00%
node.video.qq.com,0,0.00%,13,13,0.00%
dns.weixin.qq.com,0,0.00%,8,8,0.00%
packages.gitlab.com,0,0.00%,42,42,0.00%
clientlog.music.163.com,0,0.00%,2,2,0.00%
az700632.vo.msecnd.net,0,0.00%,14,14,0.00%
update.client.163.com,0,0.00%,24,24,0.00%
dav.qq.com,0,0.00%,4,4,0.00%
analysis-acc-ssl.xunlei.com,0,0.00%,2,2,0.00%
torrent.mp3quran.net,0,0.00%,4,4,0.00%
baibako.tv,0,0.00%,4,4,0.00%
drive.weixin.qq.com,0,0.00%,2,2,0.00%
theodoric.fr,0,0.00%,2,2,0.00%
tracker.parrotsec.org,0,0.00%,4,4,0.00%
prod.detectportal.prod.cloudops.mozgcp.net,0,0.00%,56,56,0.00%
btx.anifilm.tv,0,0.00%,4,4,0.00%
tracker.torrentleech.org,0,0.00%,4,4,0.00%
tracker.lilithraws.org,0,0.00%,4,4,0.00%
www.thegeeks.bz,0,0.00%,2,2,0.00%
t.btcland.xyz,0,0.00%,2,2,0.00%
fireworks.eu.org,0,0.00%,2,2,0.00%
v6-2.nigirocloud.com,0,0.00%,10,10,0.00%
v6-1.nigirocloud.com,0,0.00%,8,8,0.00%
v6-3.nigirocloud.com,0,0.00%,9,9,0.00%
t.hdhome.org,0,0.00%,6,6,0.00%
www.usps.com,0,0.00%,3,3,0.00%
hub.docker.com,0,0.00%,3,3,0.00%
ocsp.usertrust.com,0,0.00%,2,2,0.00%
ocsp.comodoca.com.cdn.cloudflare.net,0,0.00%,6,6,0.00%
crl.comodoca.com.cdn.cloudflare.net,0,0.00%,2,2,0.00%
crl.sectigo.com,0,0.00%,2,2,0.00%
ocsp.sectigo.com,0,0.00%,2,2,0.00%
sa5.tuisong.baidu.com,0,0.00%,6,6,0.00%
www.dropbox.com,0,0.00%,1,1,0.00%
ui.ptlogin2.qq.com,0,0.00%,3,3,0.00%
soft.hitun.io,0,0.00%,2,2,0.00%
cgicol.amap.com,0,0.00%,7,7,0.00%
ins-r23tsuuf.ias.tencent-cloud.net,0,0.00%,2,2,0.00%
disp-dataabqqv6tmp.ias.tencent-cloud.net,0,0.00%,3,3,0.00%
ins-2ybret5v.ias.tencent-cloud.net,0,0.00%,2,2,0.00%
snowflake.qq.com,0,0.00%,2,2,0.00%
ins-y499hqad.ias.tencent-cloud.net,0,0.00%,2,2,0.00%
gatherer.m.qq.com,0,0.00%,2,2,0.00%
mazu.m.qq.com,0,0.00%,2,2,0.00%
ins-isqjvxa9.ias.tencent-cloud.net,0,0.00%,2,2,0.00%
ins-gzw2jbpv.ias.tencent-cloud.net,0,0.00%,2,2,0.00%
p.qpic.cn,0,0.00%,2,2,0.00%
static.deepl.com,0,0.00%,13,13,0.00%
secclientgw.alipay.com,0,0.00%,3,3,0.00%
tsms-drcn.security.dbankcloud.cn,0,0.00%,2,2,0.00%
rms-drcn.platform.dbankcloud.cn,0,0.00%,2,2,0.00%
connectivitycheck.cbg-app.huawei.com.cn,0,0.00%,2,2,0.00%
t5.appmeasurements.com,0,0.00%,2,2,0.00%
408662a206f24e79bbdf0810d6ce694f.fp.measure.office.com,0,0.00%,2,2,0.00%
e4a8257b91944813a5e1336358c98a20.fp.measure.office.com,0,0.00%,1,1,0.00%
a7-64.akam.net,0,0.00%,2,2,0.00%
a1-127.akam.net,0,0.00%,2,2,0.00%
san3ar.github.io,0,0.00%,1,1,0.00%
huangzhun05.github.io,0,0.00%,1,1,0.00%
mail.qq.com,0,0.00%,6,6,0.00%
as.com,0,0.00%,1,1,0.00%
az667904-pme.azureedge.net,0,0.00%,2,2,0.00%
edgedl.me.gvt1.com,0,0.00%,33,33,0.00%
cs9.wpc.v0cdn.net,0,0.00%,4,4,0.00%
esm.ubuntu.com,0,0.00%,4,4,0.00%
packagecloud.io,0,0.00%,6,6,0.00%
steamusercontent-a.akamaihd.net,0,0.00%,1,1,0.00%
login.weixin.qq.com,0,0.00%,3,3,0.00%
tracker.kuroy.me,0,0.00%,4,4,0.00%
opentracker.cc,0,0.00%,4,4,0.00%
inferno.demonoid.is,0,0.00%,2,2,0.00%
tracker.corpscorp.online,0,0.00%,2,2,0.00%
tracker.loligirl.cn,0,0.00%,2,2,0.00%
tracker.electro-torrent.pl,0,0.00%,2,2,0.00%
s1.nsatu.com,0,0.00%,2,2,0.00%
buny.uk,0,0.00%,2,2,0.00%
h3o2.me,0,0.00%,2,2,0.00%
hub5pr.v6.phub.sandai.net,0,0.00%,16,16,0.00%
hostupdate.vmware.com,0,0.00%,1,1,0.00%
aws.vbnm.cf,0,0.00%,1,1,0.00%
login2.dingtalk.com,0,0.00%,2,2,0.00%
space.dingtalk.com,0,0.00%,2,2,0.00%
gslb.xcloud.sandai.net,0,0.00%,8,8,0.00%
event.toggle.qq.com,0,0.00%,6,6,0.00%
gum.sg1.vip.prod.criteo.com,0,0.00%,2,2,0.00%
global.px.quantserve.com,0,0.00%,2,2,0.00%
mp.4dex.io,0,0.00%,2,2,0.00%
dual-a-0001.a-msedge.net,0,0.00%,2,2,0.00%
cdn.connectad.io,0,0.00%,2,2,0.00%
api.opensubtitles.com,0,0.00%,2,2,0.00%
an.yandex.ru,0,0.00%,2,2,0.00%
ad.turn.com.akadns.net,0,0.00%,2,2,0.00%
speedtest.snape3058.info,0,0.00%,2,2,0.00%
www.tns-counter.ru,0,0.00%,1,1,0.00%
edge-microsoft-com.dual-a-0036.a-msedge.net,0,0.00%,2,2,0.00%
dual-a-0036.a-msedge.net,0,0.00%,2,2,0.00%
cname.dict.ntes53.netease.com,0,0.00%,2,2,0.00%
dict.ntes53.netease.com,0,0.00%,2,2,0.00%
open.weixin.qq.com,0,0.00%,4,4,0.00%
mpv6.weixin.qq.com,0,0.00%,2,2,0.00%
sz.mp.weixin.qq.com,0,0.00%,2,2,0.00%
cfw9ceoxz.uyoo.gq,0,0.00%,1,1,0.00%
vd6.l.qq.com,0,0.00%,4,4,0.00%
c7b8e2a2072947f68801c5f7a2687135.fp.measure.office.com,0,0.00%,1,1,0.00%
vip.video.qq.com,0,0.00%,4,4,0.00%
pbaccess.video.qq.com,0,0.00%,4,4,0.00%
apd-609c8727e337428bb2edbec922460b5501bdd8f5529987f8.v.smtcdns.com,0,0.00%,2,2,0.00%
coral520.github.io,0,0.00%,1,1,0.00%
moapi.wps.cn,0,0.00%,2,2,0.00%
cgi.connect.qq.com,0,0.00%,2,2,0.00%
6-c-0003.c-msedge.net,0,0.00%,2,2,0.00%
long.weixin.qq.com,0,0.00%,3,3,0.00%
meishi.meituan.com,0,0.00%,2,2,0.00%
desktop-release.notion-static.com,0,0.00%,4,4,0.00%
msgstore.www.notion.so,0,0.00%,4,4,0.00%
api.adguard.com,0,0.00%,4,4,0.00%
sa4.tuisong.baidu.com,0,0.00%,2,2,0.00%
kgb-ifs.tanx.com,0,0.00%,4,4,0.00%
c.tile.openstreetmap.org,0,0.00%,2,2,0.00%
vdn3.vzuu.com,0,0.00%,1,1,0.00%
i.y.qq.com,0,0.00%,10,10,0.00%
pingfore.qq.com,0,0.00%,2,2,0.00%
stat6.y.qq.com,0,0.00%,2,2,0.00%
mpush-api.aliyun.com,0,0.00%,1,1,0.00%
oss.hpconnected.com,0,0.00%,4,4,0.00%
apphub.qzone.qq.com,0,0.00%,2,2,0.00%
ii.gdt.qq.com,0,0.00%,2,2,0.00%
cbs-i.sports.cctv.com,0,0.00%,12,12,0.00%
stun-h5.qvb.qcloud.com,0,0.00%,8,8,0.00%
tracker-public.tjupt.org,0,0.00%,6,6,0.00%
aks.jdpay.com,0,0.00%,2,2,0.00%
us.archive.ubuntu.com,0,0.00%,4,4,0.00%
mirrors.fedoraproject.org,0,0.00%,7,7,0.00%
jiu.linyeming.pub,0,0.00%,2,2,0.00%
config.teams.microsoft.com,0,0.00%,2,2,0.00%
discovery-v6-4.syncthing.net,0,0.00%,6,6,0.00%
caldavhz.qiye.163.com,0,0.00%,2,2,0.00%
1e7d137c4429484db195b5d3e5f3fa61.fp.measure.office.com,0,0.00%,1,1,0.00%
waconafd.officeapps.live.com,0,0.00%,2,2,0.00%
maoruimas.github.io,0,0.00%,1,1,0.00%
az700632-pme.azureedge.net,0,0.00%,2,2,0.00%
az700632-pme.ec.azureedge.net,0,0.00%,2,2,0.00%
iecvlist.microsoft.com,0,0.00%,4,4,0.00%
hk-proxy.isrc.ac.cn,0,0.00%,4,4,0.00%
tr.bangumi.moe,0,0.00%,2,2,0.00%
xbtrutor.com,0,0.00%,2,2,0.00%
lloria.fr,0,0.00%,2,2,0.00%
tracker.kamigami.org,0,0.00%,2,2,0.00%
tracker.exorditech.com.tr,0,0.00%,2,2,0.00%
mirrorlist.centos.org,0,0.00%,8,8,0.00%
ftp.sjtu.edu.cn,0,0.00%,1,1,0.00%
dl.yarnpkg.com,0,0.00%,1,1,0.00%
ns-365.awsdns-45.com,0,0.00%,1,1,0.00%
pdns124.ultradns.net,0,0.00%,1,1,0.00%
pdns124.ultradns.org,0,0.00%,2,2,0.00%
a-ring-fallback.msedge.net,0,0.00%,2,2,0.00%
barcamp.eusib.de,0,0.00%,61,61,0.00%
www.hao123.com,0,0.00%,4,4,0.00%
03e1181bba1cf.cdn.sohucs.com,0,0.00%,1,1,0.00%
p1.itc.cn,0,0.00%,1,1,0.00%
p4.itc.cn,0,0.00%,1,1,0.00%
p0.itc.cn,0,0.00%,1,1,0.00%
c1494161c414f.cdn.sohucs.com,0,0.00%,1,1,0.00%
p5.itc.cn,0,0.00%,1,1,0.00%
c1--cn-gotcha208.bilivideo.com,0,0.00%,1,1,0.00%
p6.itc.cn,0,0.00%,1,1,0.00%
www.researchgate.net,0,0.00%,1,1,0.00%
apd-01fe2cea10604cc0d5743de4947f01b13dccda98d5b74beb.v.smtcdns.com,0,0.00%,2,2,0.00%
rpt.gdt.qq.com,0,0.00%,4,4,0.00%
wwfile.work.weixin.qq.com,0,0.00%,11,11,0.00%
factors.sofire.baidu.com,0,0.00%,2,2,0.00%
z9.cnzz.com,0,0.00%,2,2,0.00%
staticwx.cdn.bcebos.com,0,0.00%,1,1,0.00%
staticiot.cdn.bcebos.com,0,0.00%,1,1,0.00%
staticsns.cdn.bcebos.com,0,0.00%,1,1,0.00%
p1.img.cctvpic.com,0,0.00%,1,1,0.00%
wxsnsdythumb.wxs.qq.com,0,0.00%,1,1,0.00%
dldir1v6.qq.com.legodlied1-dk.sched.dcloudstc.com,0,0.00%,2,2,0.00%
slb-p2p.vcloud.ks-live.com,0,0.00%,1,1,0.00%
z13.cnzz.com,0,0.00%,1,1,0.00%
image.baidu.com,0,0.00%,2,2,0.00%
s0.hao123img.com,0,0.00%,2,2,0.00%
s1.hao123img.com,0,0.00%,2,2,0.00%
tuijian.hao123.com,0,0.00%,2,2,0.00%
game.hao123.com,0,0.00%,2,2,0.00%
www.abchina.com,0,0.00%,2,2,0.00%
www.boc.cn,0,0.00%,1,1,0.00%
www.ccb.com,0,0.00%,1,1,0.00%
www.youku.com,0,0.00%,2,2,0.00%
jump.luna.58.com,0,0.00%,2,2,0.00%
live.baidu.com,0,0.00%,2,2,0.00%
mail.10086.cn,0,0.00%,2,2,0.00%
s.click.taobao.com,0,0.00%,2,2,0.00%
tejia.hao123.com,0,0.00%,2,2,0.00%
tv.sohu.com,0,0.00%,2,2,0.00%
v.baidu.com,0,0.00%,2,2,0.00%
v.hao123.baidu.com,0,0.00%,2,2,0.00%
www.cnr.cn,0,0.00%,2,2,0.00%
www.cri.cn,0,0.00%,2,2,0.00%
www.qstheory.cn,0,0.00%,2,2,0.00%
www.youth.cn,0,0.00%,2,2,0.00%
www.yy.com,0,0.00%,1,1,0.00%
shield.hao123.com,0,0.00%,2,2,0.00%
mid.hao123.com,0,0.00%,2,2,0.00%
www.myscript.com,0,0.00%,2,2,0.00%
sa.gdt.qq.com,0,0.00%,2,2,0.00%
v.gdt.qq.com,0,0.00%,2,2,0.00%
gsp-ssl.ls.apple.com,0,0.00%,1,1,0.00%
k128-gspe.gslb.ksyuncdn.com,0,0.00%,1,1,0.00%
t.captcha.qq.com,0,0.00%,2,2,0.00%
exp.notion.so,0,0.00%,4,4,0.00%
amap-aos-info-nogw.amap.com,0,0.00%,2,2,0.00%
acs.m.taobao.com,0,0.00%,2,2,0.00%
win10-trt.msedge.net,0,0.00%,3,3,0.00%
channels.weixin.qq.com,0,0.00%,2,2,0.00%
ca6aa2d1d49d42dea77f8c6fa341a271.fp.measure.office.com,0,0.00%,1,1,0.00%
cm.e.qq.com,0,0.00%,2,2,0.00%
c.yes.youku.com,0,0.00%,2,2,0.00%
cm.l.qq.com,0,0.00%,2,2,0.00%
interface3.music.163.com.163jiasu.com,0,0.00%,2,2,0.00%
clientlog3.music.163.com,0,0.00%,2,2,0.00%
adimg.uve.weibo.com,0,0.00%,2,2,0.00%
iwx.mail.qq.com,0,0.00%,3,3,0.00%
www.weiyun.com,0,0.00%,1,1,0.00%
qqdata.ab.qq.com,0,0.00%,2,2,0.00%
qappcenterv6.3g.qq.com,0,0.00%,2,2,0.00%
tracker.open.cd,0,0.00%,1,1,0.00%
dp3.qq.com,0,0.00%,2,2,0.00%
rsync.releases.ubuntu.com,0,0.00%,2,2,0.00%
archive.ubuntu.com,0,0.00%,72,72,0.00%
packages.ros.org,0,0.00%,6,6,0.00%
ports.ubuntu.com,0,0.00%,58,58,0.00%
marketplace.visualstudio.com,0,0.00%,1,1,0.00%
ipv6.neubt.com,0,0.00%,2,2,0.00%
p2PStUntEST.haPlAT.NET,0,0.00%,2,2,0.00%
oapi.dingtalk.com,0,0.00%,2,2,0.00%
bt.edwardk.info,0,0.00%,2,2,0.00%
tracker.tamersunion.org,0,0.00%,2,2,0.00%
www.zone-torrent.net,0,0.00%,2,2,0.00%
blackz.ro,0,0.00%,2,2,0.00%
conf.wifi.360.cn,0,0.00%,2,2,0.00%
6226380651dc4c02a903778c7ae0bc23.fp.measure.office.com,0,0.00%,1,1,0.00%
debuginfo.centos.org,0,0.00%,2,2,0.00%
mirrors.nju.edu.cn,0,0.00%,2,2,0.00%
mirrors.rpmfusion.org,0,0.00%,2,2,0.00%
hd.mmstat.com,0,0.00%,2,2,0.00%
hd.mmstat.com.gds.alibabadns.com,0,0.00%,2,2,0.00%
hd-v6.mmstat.com.gds.alibabadns.com,0,0.00%,2,2,0.00%
edu.ntp.org.cn,0,0.00%,2,2,0.00%
apd-5d4143548f592cbd7c969842bbae847d61c112a2a99b6bcb.v.smtcdns.com,0,0.00%,2,2,0.00%
ip6.ssl.msdk.qq.com,0,0.00%,4,4,0.00%
download.jetbrains.com,0,0.00%,7,7,0.00%
nj.cschannel.anticheatexpert.com,0,0.00%,4,4,0.00%
www.icloud.com,0,0.00%,2,2,0.00%
css-ui.github.io,0,0.00%,1,1,0.00%
msg.umengcloud.com,0,0.00%,2,2,0.00%
thirdqq.qlogo.cn,0,0.00%,2,2,0.00%
wiki.samat.org,0,0.00%,61,61,0.00%
liwx2000.github.io,0,0.00%,1,1,0.00%
static.hao86.com,0,0.00%,2,2,0.00%
shijieditu.hao86.com,0,0.00%,1,1,0.00%
registry.npmjs.org,0,0.00%,2,2,0.00%
emweb.securities.eastmoney.com,0,0.00%,2,2,0.00%
m.sohu.com,0,0.00%,1,1,0.00%
glb.cws.prod.dcat.dsp.trafficmanager.net,0,0.00%,2,2,0.00%
7998da2750f4458888cc30c86d7f8a79.fp.measure.office.com,0,0.00%,2,2,0.00%
4a2b7c481f2c41bca2d74a67a35aa5fc.fp.measure.office.com,0,0.00%,1,1,0.00%
android.rqd.qq.com,0,0.00%,2,2,0.00%
changelogs.ubuntu.com,0,0.00%,2,2,0.00%
api.languagetoolplus.com,0,0.00%,4,4,0.00%
