domain,num_a_fail,rate_all,num_a_all,num_a_success,rate_a_fail
rq.r9t1.com,2726,10.43%,5246,2520,51.96%
asia.pool.ntp.org,1491,5.70%,3083,1592,48.36%
optimizationguide-pa.googleapis.com,1479,5.66%,2771,1292,53.37%
cn.pool.ntp.org,1436,5.49%,3121,1685,46.01%
big1.f5.lenovo.com.cn,847,3.24%,847,0,100.00%
big2.f5.lenovo.com.cn,822,3.15%,822,0,100.00%
safebrowsing.googleapis.com,517,1.98%,985,468,52.49%
update.googleapis.com,378,1.45%,546,168,69.23%
liveupdate5.f5.lenovo.com.cn,360,1.38%,360,0,100.00%
clientservices.googleapis.com,351,1.34%,688,337,51.02%
www.chinauos.com,289,1.11%,9455,9166,3.06%
registry-1.docker.io,289,1.11%,377,88,76.66%
clients1.google.com,265,1.01%,611,346,43.37%
femetrics.grammarly.io,251,0.96%,538,287,46.65%
mirrors.aliyun.com,233,0.89%,249,16,93.57%
0.ubuntu.pool.ntp.org,224,0.86%,240,16,93.33%
android.clients.google.com,222,0.85%,489,267,45.40%
d27xxe7juh1us6.cloudfront.net,200,0.77%,404,204,49.50%
browser.360.cn,194,0.74%,448,254,43.30%
s3-alpha-sig.figma.com,194,0.74%,388,194,50.00%
2.ubuntu.pool.ntp.org,187,0.72%,188,1,99.47%
1.ubuntu.pool.ntp.org,185,0.71%,192,7,96.35%
1hkclu.pronetworklink.net,184,0.70%,479,295,38.41%
3.ubuntu.pool.ntp.org,183,0.70%,193,10,94.82%
storage.googleapis.com,180,0.69%,438,258,41.10%
ipv6.msftconnecttest.com,179,0.68%,315,136,56.83%
zyx.qq.com,176,0.67%,448,272,39.29%
www.taobao.com,169,0.65%,345,176,48.99%
us2.ethermine.org,160,0.61%,160,0,100.00%
data.bilibili.com,157,0.60%,355,198,44.23%
eu1.ethermine.org,154,0.59%,154,0,100.00%
eth.2miners.com,144,0.55%,158,14,91.14%
asia1.ethermine.org,142,0.54%,160,18,88.75%
us1.ethermine.org,140,0.54%,160,20,87.50%
content-signature-2.cdn.mozilla.net,125,0.48%,249,124,50.20%
vconf.f.360.cn,111,0.42%,223,112,49.78%
3.centos.pool.ntp.org,107,0.41%,107,0,100.00%
1.centos.pool.ntp.org,97,0.37%,97,0,100.00%
2.centos.pool.ntp.org,97,0.37%,97,0,100.00%
hub5pn.v6.sandai.net,97,0.37%,97,0,100.00%
0.centos.pool.ntp.org,96,0.37%,96,0,100.00%
gecko-bd.feishu.cn,86,0.33%,191,105,45.03%
ntp.sjtu.edu.cn,78,0.30%,78,0,100.00%
firefox.settings.services.mozilla.com,77,0.29%,183,106,42.08%
pool.ntp.org,72,0.28%,98,26,73.47%
newtab.firefoxchina.cn,71,0.27%,101,30,70.30%
api2.firefoxchina.cn,70,0.27%,92,22,76.09%
cache.tv.qq.com,68,0.26%,158,90,43.04%
clients4.google.com,66,0.25%,159,93,41.51%
treatment.grammarly.com,64,0.24%,131,67,48.85%
update1.sangfor.net,60,0.23%,180,120,33.33%
go.microsoft.com,59,0.23%,139,80,42.45%
translate.google.cn,55,0.21%,119,64,46.22%
honeycomb.wpscdn.cn,53,0.20%,124,71,42.74%
dcldshlupt.alicdn.com,53,0.20%,115,62,46.09%
update.todesk.com,52,0.20%,119,67,43.70%
ntp1.tummy.com,51,0.20%,51,0,100.00%
n-devs-sgw.tplinkcloud.com.cn,50,0.19%,102,52,49.02%
mimg.127.net,48,0.18%,48,0,100.00%
checkip.amazonaws.com,46,0.18%,50,4,92.00%
s.safe.360.cn,45,0.17%,97,52,46.39%
www.cntv.cn,44,0.17%,121,77,36.36%
content-autofill.googleapis.com,44,0.17%,99,55,44.44%
gateway.fe.apple-dns.net,44,0.17%,102,58,43.14%
mcs-bd.feishu.cn,43,0.16%,87,44,49.43%
www.apple.com,41,0.16%,88,47,46.59%
beacons.gcp.gvt2.com,41,0.16%,84,43,48.81%
1.openwrt.pool.ntp.org,41,0.16%,47,6,87.23%
www.google.com.hk,40,0.15%,86,46,46.51%
api.mathpix.com,39,0.15%,83,44,46.99%
cdn-file.ludashi.com,39,0.15%,83,44,46.99%
datarouter.ol.epicgames.com,38,0.15%,83,45,45.78%
f-log-win-extension.grammarly.io,38,0.15%,97,59,39.18%
cv.duba.net,36,0.14%,78,42,46.15%
mathpix.com,35,0.13%,72,37,48.61%
service.fanxing.kugou.com,35,0.13%,83,48,42.17%
gateway.icloud.com,35,0.13%,75,40,46.67%
www.qq.com,35,0.13%,892,857,3.92%
gateway.icloud.com.cn,35,0.13%,76,41,46.05%
3.openwrt.pool.ntp.org,35,0.13%,41,6,85.37%
2.openwrt.pool.ntp.org,35,0.13%,35,0,100.00%
fs.microsoft.com,35,0.13%,40,5,87.50%
mainnet.infura.io,34,0.13%,100,66,34.00%
slardar-bd.feishu.cn,34,0.13%,72,38,47.22%
0.openwrt.pool.ntp.org,34,0.13%,37,3,91.89%
qmzgh5-1251003022.file.myqcloud.com,34,0.13%,70,36,48.57%
toblog.snssdk.com,33,0.13%,66,33,50.00%
ipv6.l.google.com,32,0.12%,32,0,100.00%
ini.update.360safe.com,32,0.12%,73,41,43.84%
tlu.dl.delivery.mp.microsoft.com,32,0.12%,40,8,80.00%
0.cn.pool.ntp.org,32,0.12%,57,25,56.14%
df.cache.wpscdn.cn,31,0.12%,62,31,50.00%
api.segment.io,31,0.12%,57,26,54.39%
mesu.apple.com,30,0.11%,66,36,45.45%
agt.p.qianxin.com,30,0.11%,30,0,100.00%
internal-api-lark-api.feishu.cn,30,0.11%,61,31,49.18%
r4.res.office365.com,29,0.11%,59,30,49.15%
api.docer.wpscdn.cn,29,0.11%,62,33,46.77%
assets.msn.com,28,0.11%,67,39,41.79%
imap.gmail.com,28,0.11%,63,35,44.44%
v-fixedinpt1001.71edge.xyz,28,0.11%,53,25,52.83%
h.trace.qq.com,27,0.10%,70,43,38.57%
redirector.gvt1.com,27,0.10%,61,34,44.26%
auth.docker.io,27,0.10%,72,45,37.50%
c.apple.news,27,0.10%,54,27,50.00%
docs2.gtimg.com,26,0.10%,55,29,47.27%
docs.gtimg.com,25,0.10%,55,30,45.45%
beacons.gvt2.com,25,0.10%,51,26,49.02%
detectportal.firefox.com,24,0.09%,359,335,6.69%
tracker.cyberia.is,24,0.09%,24,0,100.00%
easylist-downloads.adblockplus.org,24,0.09%,48,24,50.00%
www.zhihu.com,23,0.09%,49,26,46.94%
hotfix.lenovo.com.cn,23,0.09%,47,24,48.94%
down3.huorong.cn,23,0.09%,52,29,44.23%
software-down.keniu.com,23,0.09%,51,28,45.10%
6-c-0003.c-msedge.net,23,0.09%,23,0,100.00%
rhc.sonatype.com,23,0.09%,23,0,100.00%
i2.hdslb.com,22,0.08%,47,25,46.81%
t7.baidu.com,22,0.08%,47,25,46.81%
config.i.duba.net,22,0.08%,44,22,50.00%
tracker.doko.moe,22,0.08%,33,11,66.67%
grifon.info,22,0.08%,33,11,66.67%
broadcast.chat.bilibili.com,21,0.08%,42,21,50.00%
play.google.com,21,0.08%,46,25,45.65%
ioshost.qtlcdn.com,21,0.08%,42,21,50.00%
r3.o.lencr.org,21,0.08%,44,23,47.73%
zlxx.v.lxcvc.com,21,0.08%,49,28,42.86%
1.cn.pool.ntp.org,21,0.08%,32,11,65.62%
dss1.bdstatic.com,20,0.08%,47,27,42.55%
ts2.cn.mm.bing.net,20,0.08%,45,25,44.44%
init.push.apple.com,20,0.08%,42,22,47.62%
img.alicdn.com,20,0.08%,41,21,48.78%
d2nxq2uap88usk.cloudfront.net,20,0.08%,48,28,41.67%
download.windowsupdate.com,20,0.08%,43,23,46.51%
gateway.fe.apple-dns.cn,20,0.08%,49,29,40.82%
docs.google.com,20,0.08%,51,31,39.22%
apk.cdn.bleachcarnival.com,20,0.08%,40,20,50.00%
ichannel.snssdk.com,20,0.08%,40,20,50.00%
bds.snssdk.com,20,0.08%,40,20,50.00%
ts1.cn.mm.bing.net,19,0.07%,49,30,38.78%
sjy6.stream.qqmusic.qq.com,19,0.07%,47,28,40.43%
notifier-configs.airbrake.io,19,0.07%,39,20,48.72%
img-xlppc-zhan.xunlei.com,19,0.07%,41,22,46.34%
us.pool.ntp.org,19,0.07%,28,9,67.86%
s.conf.wsm.360.cn,19,0.07%,21,2,90.48%
dtl.update.updrv.com,18,0.07%,44,26,40.91%
ss1.baidu.com,18,0.07%,39,21,46.15%
t8.baidu.com,18,0.07%,41,23,43.90%
bt.neu6.edu.cn,18,0.07%,18,0,100.00%
kv601.prod.do.dsp.mp.microsoft.com,18,0.07%,34,16,52.94%
bifrost-v4.getpostman.com,18,0.07%,37,19,48.65%
events.launchdarkly.com,18,0.07%,37,19,48.65%
dldir2.qq.com,18,0.07%,21,3,85.71%
v1.go2yd.com,18,0.07%,42,24,42.86%
s1.hdslb.com,17,0.07%,37,20,45.95%
pss.bdstatic.com,17,0.07%,44,27,38.64%
dss0.bdstatic.com,17,0.07%,42,25,40.48%
cdn.jsdelivr.net,17,0.07%,33,16,51.52%
qurl.f.360.cn,17,0.07%,41,24,41.46%
ipv6.neubt.com,17,0.07%,17,0,100.00%
play.googleapis.com,17,0.07%,40,23,42.50%
update2.sangfor.net,17,0.07%,35,18,48.57%
file.drivergenius.com,17,0.07%,37,20,45.95%
webrd02.is.autonavi.com,17,0.07%,43,26,39.53%
ssl.gstatic.com,17,0.07%,36,19,47.22%
steamcdn-a.akamaihd.net,17,0.07%,25,8,68.00%
darwin.b.qianxin.com,17,0.07%,37,20,45.95%
versioncheck-bg.addons.mozilla.org,17,0.07%,17,0,100.00%
bjacshow.kugou.com,16,0.06%,44,28,36.36%
wxapp.tc.qq.com,16,0.06%,43,27,37.21%
accounts.google.com,16,0.06%,41,25,39.02%
upos-sz-mirrorali.bilivideo.com,16,0.06%,36,20,44.44%
tsbrowser.xiangtatech.com,16,0.06%,30,14,53.33%
assets.yiban.io,16,0.06%,32,16,50.00%
hicloud.hiwifi.com,16,0.06%,26,10,61.54%
0.pool.ntp.org,16,0.06%,31,15,51.61%
p0.qhimg.com,16,0.06%,37,21,43.24%
webrd01.is.autonavi.com,16,0.06%,39,23,41.03%
tracker.bittor.xyz,16,0.06%,33,17,48.48%
emoji.qpic.cn,15,0.06%,32,17,46.88%
gimg3.baidu.com,15,0.06%,35,20,42.86%
e6858.e19.s.tl88.net,15,0.06%,30,15,50.00%
ocsp.sca1b.amazontrust.com,15,0.06%,29,14,51.72%
firebaselogging-pa.googleapis.com,15,0.06%,32,17,46.88%
cdn.cvws.apple-dns.net,15,0.06%,33,18,45.45%
webrd04.is.autonavi.com,15,0.06%,39,24,38.46%
liveupdate2.drivergenius.com,15,0.06%,38,23,39.47%
optimize.duba.net,15,0.06%,30,15,50.00%
2.debian.pool.ntp.org,15,0.06%,24,9,62.50%
uk.pool.ntp.org,15,0.06%,22,7,68.18%
offlintab.firefoxchina.cn,15,0.06%,20,5,75.00%
googleads.g.doubleclick.net,14,0.05%,33,19,42.42%
e4518.dscapi7.akamaiedge.net,14,0.05%,29,15,48.28%
mubu.com,14,0.05%,30,16,46.67%
fa000000105.resources.office.net,14,0.05%,32,18,43.75%
smartdl.lenovo.com.cn,14,0.05%,29,15,48.28%
stream.zotero.org,14,0.05%,29,15,48.28%
api2.firefoxchina.cn.wswebpic.com,14,0.05%,33,19,42.42%
safebrowsing.googleapis-cn.com,14,0.05%,34,20,41.18%
3.pool.ntp.org,14,0.05%,27,13,51.85%
webrd03.is.autonavi.com,14,0.05%,37,23,37.84%
discovery-v6.syncthing.net,14,0.05%,14,0,100.00%
3.cn.pool.ntp.org,14,0.05%,23,9,60.87%
2.android.pool.ntp.org,13,0.05%,28,15,46.43%
dtapp-pub.dingtalk.com,13,0.05%,27,14,48.15%
api.weathercn.com,13,0.05%,31,18,41.94%
ss0.baidu.com,13,0.05%,35,22,37.14%
www.sohu.com,13,0.05%,30,17,43.33%
profile-avatar.csdnimg.cn,13,0.05%,26,13,50.00%
slardar-bd.feishu.cn.w.cdngslb.com,13,0.05%,27,14,48.15%
e673.dsce9.akamaiedge.net,13,0.05%,26,13,50.00%
cu003.www.duba.net,13,0.05%,28,15,46.43%
2.pool.ntp.org,13,0.05%,27,14,48.15%
0.asia.pool.ntp.org,13,0.05%,26,13,50.00%
ns1.namebrightdns.com,13,0.05%,268,255,4.85%
ocsp.pki.goog,13,0.05%,30,17,43.33%
b.bdstatic.com,12,0.05%,29,17,41.38%
pic3.zhimg.com,12,0.05%,25,13,48.00%
clients2.google.com,12,0.05%,327,315,3.67%
16.au.download.windowsupdate.com,12,0.05%,27,15,44.44%
img-s-msn-com.akamaized.net,12,0.05%,29,17,41.38%
cdn.content.prod.cms.msn.com,12,0.05%,28,16,42.86%
dss2.bdstatic.com,12,0.05%,25,13,48.00%
csdnimg.cn,12,0.05%,28,16,42.86%
beacons3.gvt2.com,12,0.05%,26,14,46.15%
14.tlu.dl.delivery.mp.microsoft.com,12,0.05%,26,14,46.15%
fsigns.duba.net,12,0.05%,34,22,35.29%
dl.google.com,12,0.05%,20,8,60.00%
google.com,12,0.05%,28,16,42.86%
l2.hiwifi.com,12,0.05%,23,11,52.17%
1.pool.ntp.org,12,0.05%,24,12,50.00%
3.asia.pool.ntp.org,12,0.05%,24,12,50.00%
kinesis.us-east-1.amazonaws.com,12,0.05%,29,17,41.38%
beacons2.gvt2.com,12,0.05%,22,10,54.55%
mcs-bd.feishu.cn.w.cdngslb.com,12,0.05%,26,14,46.15%
2.cn.pool.ntp.org,12,0.05%,23,11,52.17%
g.api.mega.co.nz,12,0.05%,51,39,23.53%
dk3.ache.pdf.officeoncloud.cn,12,0.05%,16,4,75.00%
d1ykf07e75w7ss.cloudfront.net,12,0.05%,14,2,85.71%
dataflow.biliapi.com,11,0.04%,24,13,45.83%
ss3.baidu.com,11,0.04%,32,21,34.38%
gw.alipayobjects.com,11,0.04%,23,12,47.83%
img-blog.csdnimg.cn,11,0.04%,25,14,44.00%
api.m.jd.com,11,0.04%,23,12,47.83%
upos-sz-staticcos-cmask.bilivideo.com,11,0.04%,23,12,47.83%
img.alicdn.com.danuoyi.alicdn.com,11,0.04%,22,11,50.00%
crl.certum.pl,11,0.04%,25,14,44.00%
a2p-s01-drcn.xcm.xyx-xylo.com,11,0.04%,68,57,16.18%
pc.ximalaya.com,11,0.04%,21,10,52.38%
d11.baidupcs.com,11,0.04%,22,11,50.00%
f-log-extension.grammarly.io,11,0.04%,29,18,37.93%
s3-downtime.figma.com,11,0.04%,22,11,50.00%
smp-device-content.apple.com,11,0.04%,27,16,40.74%
tracker.bluefrog.pw,11,0.04%,22,11,50.00%
pt.lax.mx,11,0.04%,22,11,50.00%
tracker.vanitycore.co,11,0.04%,22,11,50.00%
ulfbrueggemann.no-ip.org,11,0.04%,11,0,100.00%
tracker.xfsub.com,11,0.04%,11,0,100.00%
static.hdslb.com,10,0.04%,17,7,58.82%
m.qpic.cn,10,0.04%,22,12,45.45%
pagead2.googlesyndication.com,10,0.04%,23,13,43.48%
ss2.baidu.com,10,0.04%,28,18,35.71%
static-xl.a.88cdn.com,10,0.04%,26,16,38.46%
tconf.f.360.cn,10,0.04%,334,324,2.99%
img-home.csdnimg.cn,10,0.04%,21,11,47.62%
www.bytedance.com,10,0.04%,20,10,50.00%
gchat.qpic.cn,10,0.04%,21,11,47.62%
upos-sz-mirrorcoso1.bilivideo.com,10,0.04%,26,16,38.46%
clients6.google.com,10,0.04%,18,8,55.56%
facebook.com,10,0.04%,31,21,32.26%
res.ldmnq.com,10,0.04%,25,15,40.00%
api.appcues.net,10,0.04%,22,12,45.45%
ocsp.apple.com,10,0.04%,20,10,50.00%
httpdns.alicdn.com,10,0.04%,22,12,45.45%
www.xilinx.com,10,0.04%,20,10,50.00%
download.microsoft.com,10,0.04%,20,10,50.00%
download.docker.com,10,0.04%,14,4,71.43%
hub5pr.v6.phub.sandai.net,10,0.04%,18,8,55.56%
gecko-bd.feishu.cn.w.cdngslb.com,9,0.03%,20,11,45.00%
upos-sz-mirrorcos.bilivideo.com,9,0.03%,25,16,36.00%
g.alicdn.com,9,0.03%,25,16,36.00%
img-prod-cms-rt-microsoft-com.akamaized.net,9,0.03%,19,10,47.37%
normandy-cdn.services.mozilla.com,9,0.03%,29,20,31.03%
res.u-tools.cn,9,0.03%,18,9,50.00%
1.debian.pool.ntp.org,9,0.03%,15,6,60.00%
partner.googleadservices.com,9,0.03%,18,9,50.00%
filedownload.lenovo.com,9,0.03%,18,9,50.00%
vweixinthumb.tc.qq.com,9,0.03%,22,13,40.91%
oneclient.sfx.ms,9,0.03%,20,11,45.00%
szmmsns.qpic.cn,9,0.03%,18,9,50.00%
nat.emule.org.cn,9,0.03%,9,0,100.00%
drive.google.com,9,0.03%,26,17,34.62%
a1887.dscq.akamai.net,9,0.03%,17,8,52.94%
mask-api.icloud.com,9,0.03%,12,3,75.00%
ksn-file-geo.kaspersky-labs.com,9,0.03%,27,18,33.33%
client.dropbox.com,9,0.03%,19,10,47.37%
clientconfig.akamai.steamstatic.com,9,0.03%,16,7,56.25%
1595096.sched.d0-dk.tdnsdp1.cn,9,0.03%,18,9,50.00%
hub5u.v6.phub.sandai.net,9,0.03%,9,0,100.00%
stocks-data-service.apple.com,9,0.03%,17,8,52.94%
img0yjvjvvuvw.cdn.cache102.xyz,9,0.03%,17,8,52.94%
es.f.360.cn,9,0.03%,18,9,50.00%
ow1.res.office365.com,9,0.03%,18,9,50.00%
package-search.services.jetbrains.com,9,0.03%,18,9,50.00%
i.hhrspb7.top,9,0.03%,18,9,50.00%
download.windowsupdate.com.a.bdydns.com,9,0.03%,11,2,81.82%
pki-goog.l.google.com,9,0.03%,18,9,50.00%
opencdnmsdl1.jomodns.com,9,0.03%,18,9,50.00%
cwxlive.qlogo.cn,9,0.03%,18,9,50.00%
registry.npmmirror.com,8,0.03%,8,0,100.00%
at.alicdn.com,8,0.03%,16,8,50.00%
pic1.zhimg.com,8,0.03%,16,8,50.00%
kv501.prod.do.dsp.mp.microsoft.com,8,0.03%,29,21,27.59%
boss.hdslb.com,8,0.03%,19,11,42.11%
bimp.hdslb.com,8,0.03%,18,10,44.44%
jtypkz2w.sched.d2.tdnsdp1.cn,8,0.03%,11,3,72.73%
findermp.video.qq.com,8,0.03%,18,10,44.44%
dldir1v6.qq.com,8,0.03%,16,8,50.00%
inappcheck.itunes.apple.com,8,0.03%,39,31,20.51%
updatem.360safe.com,8,0.03%,247,239,3.24%
vweixinf.tc.qq.com,8,0.03%,20,12,40.00%
adservice.google.com,8,0.03%,15,7,53.33%
pull-lls-spe-l3.douyincdn.com,8,0.03%,16,8,50.00%
pull-f5-hot.flive.douyincdn.com,8,0.03%,16,8,50.00%
whoami.akamai.net,8,0.03%,16,8,50.00%
14.au.download.windowsupdate.com,8,0.03%,19,11,42.11%
dl.delivery.mp.microsoft.com,8,0.03%,16,8,50.00%
hangouts.google.com,8,0.03%,16,8,50.00%
streamdot.douyucdn.cn,8,0.03%,19,11,42.11%
gspe1-ssl.ls.apple.com,8,0.03%,16,8,50.00%
api2.gettoby.com,8,0.03%,20,12,40.00%
repo.huaweicloud.com,8,0.03%,16,8,50.00%
gates.grammarly.com,8,0.03%,24,16,33.33%
download.visualstudio.microsoft.com,8,0.03%,17,9,47.06%
plugins.jetbrains.com,8,0.03%,15,7,53.33%
sdkoptedge.chinanetcenter.com,8,0.03%,21,13,38.10%
inappcheck-lb.itunes-apple.com.akadns.net,8,0.03%,37,29,21.62%
y.gtimg.cn.tc.qq.com,8,0.03%,8,0,100.00%
www.liebao.cn,8,0.03%,15,7,53.33%
luckyvideo.peopletech.cn,8,0.03%,27,19,29.63%
ns4.netim.net,8,0.03%,8,0,100.00%
ns5.netim.net,8,0.03%,8,0,100.00%
services.addons.mozilla.org,8,0.03%,12,4,66.67%
pic2.zhimg.com,7,0.03%,16,9,43.75%
self.events.data.microsoft.com,7,0.03%,814,807,0.86%
static.geetest.com,7,0.03%,14,7,50.00%
e10499.dsce9.akamaiedge.net,7,0.03%,16,9,43.75%
zhanzhang.toutiao.com,7,0.03%,17,10,41.18%
lupic.cdn.bcebos.com,7,0.03%,15,8,46.67%
t11.baidu.com,7,0.03%,18,11,38.89%
t12.baidu.com,7,0.03%,19,12,36.84%
himg.bdimg.com,7,0.03%,16,9,43.75%
img1.pcfg.cache.wpscdn.cn,7,0.03%,12,5,58.33%
img-blog.csdn.net,7,0.03%,14,7,50.00%
pull-rtmp-l1-cny.douyincdn.com,7,0.03%,15,8,46.67%
groups.google.com,7,0.03%,18,11,38.89%
p4.music.126.net.163jiasu.com,7,0.03%,16,9,43.75%
steampipe.akamaized.net,7,0.03%,14,7,50.00%
netty.yunduoketang.com,7,0.03%,16,9,43.75%
subca.crl.certum.pl,7,0.03%,15,8,46.67%
a1961.g2.akamai.net,7,0.03%,15,8,46.67%
s.url.cn,7,0.03%,14,7,50.00%
setup.icloud.com,7,0.03%,18,11,38.89%
img.qwps.cn,7,0.03%,14,7,50.00%
www.googletagmanager.com,7,0.03%,12,5,58.33%
init-china.itunes-apple.com.akadns.net,7,0.03%,14,7,50.00%
inappcheck.itunes.apple.com.w.alikunlun.com,7,0.03%,13,6,53.85%
static.nvidiagrid.net,7,0.03%,7,0,100.00%
sdup.qihucdn.com,7,0.03%,14,7,50.00%
ldc-fast.lenovo.com.cn,7,0.03%,13,6,53.85%
disc801.prod.do.dsp.mp.microsoft.com,7,0.03%,14,7,50.00%
pancake.apple.com,7,0.03%,14,7,50.00%
d31qbv1cthcecs.cloudfront.net,7,0.03%,8,1,87.50%
cc.adingo.jp,7,0.03%,13,6,53.85%
autopush.prod.mozaws.net,7,0.03%,15,8,46.67%
search3-search-hl.toutiaoapi.com,7,0.03%,7,0,100.00%
api3-normal-lf.toutiaoapi.com,7,0.03%,8,1,87.50%
pic4.zhimg.com,6,0.02%,14,8,42.86%
upos-sz-mirrorhw.bilivideo.com,6,0.02%,13,7,46.15%
x1.c.lencr.org,6,0.02%,312,306,1.92%
registry.npm.taobao.org,6,0.02%,6,0,100.00%
storecatalogrevocation.storequality.microsoft.com,6,0.02%,16,10,37.50%
ocsp.dcocsp.cn,6,0.02%,14,8,42.86%
smarthome-drcn.dbankcdn.com,6,0.02%,14,8,42.86%
res.servicewechat.com,6,0.02%,14,8,42.86%
resources.jetbrains.com,6,0.02%,13,7,46.15%
msedge.b.tlu.dl.delivery.mp.microsoft.com,6,0.02%,15,9,40.00%
bkssl.bdimg.com,6,0.02%,17,11,35.29%
tracker.darmowy-torrent.pl,6,0.02%,6,0,100.00%
0.debian.pool.ntp.org,6,0.02%,9,3,66.67%
y.qq.com,6,0.02%,13,7,46.15%
i.glzip.com,6,0.02%,6,0,100.00%
cdn.ynuf.aliapp.org,6,0.02%,14,8,42.86%
mini.360.cn,6,0.02%,16,10,37.50%
cm.g.doubleclick.net,6,0.02%,14,8,42.86%
ws-keyboard.shouji.sogou.com,6,0.02%,14,8,42.86%
pull-rtmp-l6-source.douyincdn.com,6,0.02%,13,7,46.15%
pull-tsl-vr-l3.douyincdn.com,6,0.02%,14,8,42.86%
pull-tsl-vr-l11.douyincdn.com,6,0.02%,14,8,42.86%
pull-tsl-spe-l11.douyincdn.com,6,0.02%,13,7,46.15%
pull-hls-spe-l26.douyincdn.com,6,0.02%,13,7,46.15%
pull-rtmp-f13.douyincdn.com,6,0.02%,12,6,50.00%
pull-f5-vs.flive.douyincdn.com,6,0.02%,14,8,42.86%
pull-flv-l11-source.douyincdn.com,6,0.02%,12,6,50.00%
pull-lls-spe-l6.douyincdn.com,6,0.02%,12,6,50.00%
pull-lls-l3.douyincdn.com,6,0.02%,12,6,50.00%
pull-hs-spe-f5.douyincdn.com,6,0.02%,12,6,50.00%
guide-acs.m.taobao.com,6,0.02%,12,6,50.00%
gw.alicdn.com,6,0.02%,13,7,46.15%
help.apple.com,6,0.02%,14,8,42.86%
signaler-pa.clients6.google.com,6,0.02%,15,9,40.00%
aeu.alicdn.com,6,0.02%,11,5,54.55%
s1.cn.bing.net,6,0.02%,12,6,50.00%
sf-api.com,6,0.02%,6,0,100.00%
metrics.icloud.com,6,0.02%,13,7,46.15%
static.dataservices.hp.com,6,0.02%,13,7,46.15%
wspeed.qq.com,6,0.02%,18,12,33.33%
discovery-v6-4.syncthing.net,6,0.02%,6,0,100.00%
m701.music.126.net,6,0.02%,14,8,42.86%
e11290.dspg.akamaiedge.net,6,0.02%,12,6,50.00%
broker.mina.mi.com,6,0.02%,12,6,50.00%
df.cache.wpscdn.cn.qiniudns.com,6,0.02%,6,0,100.00%
config.i.duba.net.w.kunlunar.com,6,0.02%,12,6,50.00%
aka.ms,6,0.02%,11,5,54.55%
pc001.download.wh.cmcm.com,6,0.02%,9,3,66.67%
picx.zhimg.com,6,0.02%,20,14,30.00%
so-so.facebook.com,6,0.02%,21,15,28.57%
mg-mg.facebook.com,6,0.02%,21,15,28.57%
sw-ke.facebook.com,6,0.02%,21,15,28.57%
prod.ingestion-edge.prod.dataops.mozgcp.NET,6,0.02%,11,5,54.55%
xp.apple.com,6,0.02%,13,7,46.15%
updateleak.qihucdn.com,6,0.02%,16,10,37.50%
pull-lls-f5.flive.douyincdn.com,6,0.02%,12,6,50.00%
ocsp.globalsign.com,6,0.02%,10,4,60.00%
api1.origin.com,6,0.02%,14,8,42.86%
dotplayer.coldlake1.com,6,0.02%,9,3,66.67%
u.qurl.f.360.cn,6,0.02%,15,9,40.00%
api.kz.naruto.red,6,0.02%,12,6,50.00%
www.xunlei.com,6,0.02%,6,0,100.00%
wxsnsdythumb.wxs.qq.com,6,0.02%,11,5,54.55%
lz4hlmtcf5.feishu.cn,6,0.02%,12,6,50.00%
dev,5,0.02%,5,0,100.00%
mesu-china.apple.com.akadns.net,5,0.02%,9,4,55.56%
iduxzj9.qiniudns.com,5,0.02%,8,3,62.50%
finder.video.qq.com,5,0.02%,12,7,41.67%
fc1tn.baidu.com,5,0.02%,17,12,29.41%
t10.baidu.com,5,0.02%,16,11,31.25%
ts4.cn.mm.bing.net,5,0.02%,21,16,23.81%
cd.huoying666.com,5,0.02%,10,5,50.00%
appoptimize-drcn.dbankcdn.com,5,0.02%,5,0,100.00%
contentcenter-drcn.dbankcdn.com,5,0.02%,11,6,45.45%
play.itunes.apple.com,5,0.02%,11,6,45.45%
search-operate.cdn.bcebos.com,5,0.02%,10,5,50.00%
www.runoob.com,5,0.02%,9,4,55.56%
pull-hls-f96.douyincdn.com,5,0.02%,10,5,50.00%
pull-flv-l29.douyincdn.com,5,0.02%,10,5,50.00%
push-rtmp-f5-enc.douyincdn.com,5,0.02%,10,5,50.00%
pull-hls-vr-l11.douyincdn.com,5,0.02%,10,5,50.00%
pull-flv-f13.douyincdn.com,5,0.02%,12,7,41.67%
pull-flv-l13.douyincdn.com,5,0.02%,12,7,41.67%
pull-hls-hs-f5-tsl.douyincdn.com,5,0.02%,11,6,45.45%
pull-rtmp-l13.douyincdn.com,5,0.02%,12,7,41.67%
pull-tsl-spe-l26.douyincdn.com,5,0.02%,10,5,50.00%
push-rtmp-l3.douyincdn.com,5,0.02%,10,5,50.00%
pull-l3-cny.douyincdn.com,5,0.02%,11,6,45.45%
pull-lls-spe-l11.douyincdn.com,5,0.02%,11,6,45.45%
pull-flv-f1-hs.pstatp.com,5,0.02%,10,5,50.00%
push-rtmp-l29.douyincdn.com,5,0.02%,11,6,45.45%
pull-flv-vr-l11.douyincdn.com,5,0.02%,10,5,50.00%
pull-l3-source.douyincdn.com,5,0.02%,10,5,50.00%
pull-flv-spe-l26.douyincdn.com,5,0.02%,10,5,50.00%
push-rtmp-l1-hs.pstatp.com,5,0.02%,10,5,50.00%
aapl-maps.qtlcdn.com,5,0.02%,8,3,62.50%
tconf2.f.360.cn,5,0.02%,200,195,2.50%
SIN-efz.ms-acdc.office.com,5,0.02%,14,9,35.71%
code.bdstatic.com,5,0.02%,11,6,45.45%
www.google.co.bw,5,0.02%,14,9,35.71%
www.google.com.bz,5,0.02%,16,11,31.25%
www.google.co.cr,5,0.02%,14,9,35.71%
calendar.google.com,5,0.02%,11,6,45.45%
www.google.com.co,5,0.02%,14,9,35.71%
www.google.co.ck,5,0.02%,16,11,31.25%
www.google.com.cu,5,0.02%,16,11,31.25%
www.google.com.cy,5,0.02%,14,9,35.71%
valipl10.cp31.ott.cibntv.net,5,0.02%,10,5,50.00%
bt2.archive.org,5,0.02%,20,15,25.00%
ocsp.rootg2.amazontrust.com,5,0.02%,10,5,50.00%
p4.music.126.net,5,0.02%,10,5,50.00%
safebrowsing.google.com,5,0.02%,12,7,41.67%
dotplayer.coldlake1.com.w.cdngslb.com,5,0.02%,13,8,38.46%
atm-fp-direct.office.com,5,0.02%,10,5,50.00%
uz95.v.trpcdn.NET,5,0.02%,14,9,35.71%
mixv4-2.194610.xyz,5,0.02%,18,13,27.78%
down-30005.sz.gfp.tencent-cloud.com,5,0.02%,10,5,50.00%
mqtt-web.zhihu.com,5,0.02%,8,3,62.50%
3.debian.pool.ntp.org,5,0.02%,8,3,62.50%
googlehosted.l.googleusercontent.com,5,0.02%,10,5,50.00%
stocks-sparkline.apple.com,5,0.02%,12,7,41.67%
valid.apple.com,5,0.02%,10,5,50.00%
tj.wifi.liebao.cn,5,0.02%,10,5,50.00%
prod.detectportal.prod.cloudops.mozgcp.net,5,0.02%,62,57,8.06%
upos-sz-mirrorhwo1.bilivideo.com,5,0.02%,14,9,35.71%
cu004.www.duba.net,5,0.02%,10,5,50.00%
e4518.dscapi7.akamaiedge.net.0.1.cn.akamaiedge.net,5,0.02%,10,5,50.00%
dellupdater.dell.com,5,0.02%,12,7,41.67%
pull-lls-spe-l1.douyincdn.com,5,0.02%,11,6,45.45%
pull-flv-l1.ixigua.com,5,0.02%,11,6,45.45%
pull-f3.douyincdn.com,5,0.02%,10,5,50.00%
pull-rtmp-f11.douyincdn.com,5,0.02%,11,6,45.45%
pull-flv-l6-source.douyincdn.com,5,0.02%,10,5,50.00%
pull-tsl-hs-spe-f5.douyincdn.com,5,0.02%,10,5,50.00%
pull-tsl-spe-l1.douyincdn.com,5,0.02%,10,5,50.00%
pull-tsl-vr-l1.douyincdn.com,5,0.02%,10,5,50.00%
pull-flv-spe-l1.douyincdn.com,5,0.02%,10,5,50.00%
www.evernote.com,5,0.02%,11,6,45.45%
pull-hls-f5-enc.flive.douyincdn.com,5,0.02%,10,5,50.00%
k128-inapp.gslb.ksyuncdn.com,5,0.02%,9,4,55.56%
ocsp-lb.apple.com.akadns.net,5,0.02%,9,4,55.56%
pull-flv-f1-proxy.douyincdn.com,5,0.02%,10,5,50.00%
cmshow.gtimg.cn,5,0.02%,9,4,55.56%
appoptimize-drcn.dbankcdn.cn,5,0.02%,10,5,50.00%
public-treatment.prod-experimentation.grammarlyaws.com,5,0.02%,8,3,62.50%
qzone.qq.com,5,0.02%,10,5,50.00%
ja-ks.facebook.com,5,0.02%,16,11,31.25%
tr.skype.trafficmanager.net,5,0.02%,5,0,100.00%
appdl-1-drcn.dbankcdn.com,5,0.02%,12,7,41.67%
k128-mzstatic.gslb.ksyuncdn.com,5,0.02%,11,6,45.45%
clients2.googleusercontent.com,5,0.02%,10,5,50.00%
ali.pull.yximgs.com,5,0.02%,9,4,55.56%
download-installer.cdn.mozilla.net,5,0.02%,9,4,55.56%
eqdwjv3myb.feishu.cn,5,0.02%,6,1,83.33%
wpad.www.tendawifi.com,5,0.02%,34,29,14.71%
api3-eeft-gateway-lf.feishu.cn,5,0.02%,10,5,50.00%
v6-2.nigirocloud.com,5,0.02%,5,0,100.00%
v6-3.nigirocloud.com,5,0.02%,8,3,62.50%
p06-caldav.icloud.com,5,0.02%,10,5,50.00%
init.push-apple.com.akadns.net,5,0.02%,10,5,50.00%
stocks-data-service.lb-apple.com.akadns.net,5,0.02%,10,5,50.00%
t2.xiaohongshu.com,5,0.02%,9,4,55.56%
console.cloud.google.com,5,0.02%,10,5,50.00%
iduy64c.qiniudns.com,4,0.02%,4,0,100.00%
pc.ximalaya.com.dsa.dnsv1.com.cn,4,0.02%,4,0,100.00%
s.f.360.cn,4,0.02%,1465,1461,0.27%
app-measurement.com,4,0.02%,9,5,44.44%
fonts.gstatic.com,4,0.02%,12,8,33.33%
y.gtimg.cn,4,0.02%,12,8,33.33%
wwcdn.weixin.qq.com,4,0.02%,12,8,33.33%
fc-ccimage.baidu.com,4,0.02%,11,7,36.36%
qzonestyle.gtimg.cn,4,0.02%,10,6,40.00%
pic.rmb.bdstatic.com,4,0.02%,12,8,33.33%
s1.url.cn,4,0.02%,12,8,33.33%
sqimg.qq.com,4,0.02%,7,3,57.14%
h5hosting.dbankcdn.com,4,0.02%,9,5,44.44%
tangram-config.gdt.qq.com,4,0.02%,9,5,44.44%
e19240.ca.s.tl88.NET,4,0.02%,8,4,50.00%
cdn.orayimg.com,4,0.02%,8,4,50.00%
tnc3-bjlgy.zijieapi.com,4,0.02%,8,4,50.00%
unpkg.zhimg.com,4,0.02%,9,5,44.44%
login.msa.msidentity.com,4,0.02%,12,8,33.33%
cma-china.itunes-apple.com.akadns.net,4,0.02%,8,4,50.00%
push-rtmp-l11-encryption.douyincdn.com,4,0.02%,11,7,36.36%
push-rtmp-l1-cny.douyincdn.com,4,0.02%,10,6,40.00%
push-rtmp-hs-f5.douyincdn.com,4,0.02%,10,6,40.00%
pull-hs-f5.flive.ihuoshanlive.com,4,0.02%,11,7,36.36%
pull-hs-f5.flive.huoshanlive.com,4,0.02%,10,6,40.00%
push-rtmp-hs-spe-f5.douyincdn.com,4,0.02%,9,5,44.44%
push-rtmp-spe-l1.douyincdn.com,4,0.02%,10,6,40.00%
push-rtmp-hs-vr-f5.douyincdn.com,4,0.02%,9,5,44.44%
pull-rtmp-f6-hs.pstatp.com,4,0.02%,10,6,40.00%
pull-flv-l1-hs.pstatp.com,4,0.02%,8,4,50.00%
pull-rtmp-l1.douyincdn.com,4,0.02%,8,4,50.00%
pull-rtmp-f1-hs.pstatp.com,4,0.02%,8,4,50.00%
video-hw-drcn.dbankcdn.cn,4,0.02%,8,4,50.00%
pull-flv-f29.douyincdn.com,4,0.02%,8,4,50.00%
e12919.dscd.akamaiedge.net,4,0.02%,6,2,66.67%
f7.baidu.com,4,0.02%,9,5,44.44%
qpic.y.qq.com,4,0.02%,8,4,50.00%
internal-api-lark-api.feishu.cn.w.cdngslb.com,4,0.02%,8,4,50.00%
youtubei.googleapis.com,4,0.02%,8,4,50.00%
upload.youtube.com,4,0.02%,12,8,33.33%
sites.google.com,4,0.02%,12,8,33.33%
www.google.com.ag,4,0.02%,14,10,28.57%
www.google.com.au,4,0.02%,12,8,33.33%
onedrive.live.com,4,0.02%,12,8,33.33%
www.google.com.bo,4,0.02%,12,8,33.33%
upload-oss.vzuu.com,4,0.02%,8,4,50.00%
zhihu-pics-upload.zhimg.com,4,0.02%,8,4,50.00%
youtube.com,4,0.02%,12,8,33.33%
m.youtube.com,4,0.02%,12,8,33.33%
www.google.com.ai,4,0.02%,14,10,28.57%
showcase.dropbox.com,4,0.02%,12,8,33.33%
www.google.com.ar,4,0.02%,14,10,28.57%
upload.docs.google.com,4,0.02%,12,8,33.33%
www.google.com.bd,4,0.02%,14,10,28.57%
plus.google.com,4,0.02%,12,8,33.33%
www.google.com.do,4,0.02%,14,10,28.57%
www.google.com.af,4,0.02%,14,10,28.57%
www.google.com.br,4,0.02%,12,8,33.33%
onenote.com,4,0.02%,8,4,50.00%
dropbox.com,4,0.02%,12,8,33.33%
contacts.google.com,4,0.02%,8,4,50.00%
www.google.com.bh,4,0.02%,12,8,33.33%
www.google.com.bn,4,0.02%,12,8,33.33%
search.yahoo.com,4,0.02%,12,8,33.33%
paper.dropbox.com,4,0.02%,12,8,33.33%
rc10-g4.oray.com,4,0.02%,8,4,50.00%
static.youku.com,4,0.02%,8,4,50.00%
upload.jianshu.io,4,0.02%,9,5,44.44%
vthumb.ykimg.com,4,0.02%,8,4,50.00%
www.yisu.com,4,0.02%,8,4,50.00%
download.zotero.org,4,0.02%,7,3,57.14%
discovery-v6.verysync.cn,4,0.02%,4,0,100.00%
login.feishu.cn,4,0.02%,8,4,50.00%
fanyiapp.cdn.bcebos.com,4,0.02%,9,5,44.44%
p3.music.126.net.w.alikunlun.com,4,0.02%,9,5,44.44%
cdn.ap.bittorrent.com,4,0.02%,8,4,50.00%
exo.nel.measure.office.net,4,0.02%,8,4,50.00%
helpx.adobe.com,4,0.02%,8,4,50.00%
ux70.v.trpcdn.NET,4,0.02%,15,11,26.67%
help.origin-apple.com.akadns.net,4,0.02%,11,7,36.36%
assets.msn.cn-c.edgekey.net.globalredir.akadns.NET,4,0.02%,4,0,100.00%
down.qq.com,4,0.02%,9,5,44.44%
iscas-itechs-kg.feishu.cn,4,0.02%,9,5,44.44%
internal-api.feishu.cn,4,0.02%,8,4,50.00%
www.ieee.org,4,0.02%,8,4,50.00%
www.webofknowledge.com,4,0.02%,8,4,50.00%
init-p01st.push.apple.com,4,0.02%,10,6,40.00%
ocsp.digicert.cn,4,0.02%,10,6,40.00%
s.cn.bing.net,4,0.02%,7,3,57.14%
fa000000043.resources.office.net,4,0.02%,8,4,50.00%
settings-bd.feishu.cn,4,0.02%,8,4,50.00%
pic.cnblogs.com,4,0.02%,8,4,50.00%
release-75570.gzc.vod.tencent-cloud.com,4,0.02%,8,4,50.00%
fa000000005.resources.office.net,4,0.02%,8,4,50.00%
www.inoreader.com,4,0.02%,9,5,44.44%
www.download.windowsupdate.com,4,0.02%,8,4,50.00%
v6-4.nigirocloud.com,4,0.02%,4,0,100.00%
conf.f.360.cn,4,0.02%,47,43,8.51%
steamstore-a.akamaihd.net,4,0.02%,8,4,50.00%
static-api.infinitynewtab.com,4,0.02%,8,4,50.00%
conn1.oppomobile.com,4,0.02%,8,4,50.00%
wppkg.baidupcs.com,4,0.02%,10,6,40.00%
content.hpgamestream.com,4,0.02%,8,4,50.00%
aladin.wxqcloud.qq.com,4,0.02%,7,3,57.14%
push-rtmp-vr-l1.douyincdn.com,4,0.02%,8,4,50.00%
pull-flv-l6-encryption.douyincdn.com,4,0.02%,9,5,44.44%
pull-rtmp-l11.douyincdn.com,4,0.02%,9,5,44.44%
cdn.staticfile.org,4,0.02%,6,2,66.67%
pull-rtmp-l6-hs.pstatp.com,4,0.02%,9,5,44.44%
pull-flv-l6.ixigua.com,4,0.02%,8,4,50.00%
pull-flv-vr-l1.douyincdn.com,4,0.02%,9,5,44.44%
pull-tsl-vr-l26.douyincdn.com,4,0.02%,8,4,50.00%
pull-flv-vr-l26.douyincdn.com,4,0.02%,9,5,44.44%
pull-flv-l1.douyincdn.com,4,0.02%,8,4,50.00%
pull-hls-f1.douyincdn.com,4,0.02%,8,4,50.00%
pull-flv-l11.douyincdn.com,4,0.02%,8,4,50.00%
pull-rtmp-f1.douyincdn.com,4,0.02%,9,5,44.44%
pull-flv-l11-encryption.douyincdn.com,4,0.02%,9,5,44.44%
pull-l3.douyincdn.com,4,0.02%,8,4,50.00%
pull-hs-f5-encryption.flive.douyincdn.com,4,0.02%,8,4,50.00%
pull-f3-proxy.douyincdn.com,4,0.02%,8,4,50.00%
pull-rtmp-l29.douyincdn.com,4,0.02%,8,4,50.00%
pull-rtmp-l1.ixigua.com,4,0.02%,8,4,50.00%
pull-rtmp-l6.douyincdn.com,4,0.02%,8,4,50.00%
pull-flv-l26.douyincdn.com,4,0.02%,8,4,50.00%
pull-flv-f1.douyincdn.com,4,0.02%,8,4,50.00%
pull-flv-f96.douyincdn.com,4,0.02%,9,5,44.44%
pull-f5-mptcp.flive.douyincdn.com,4,0.02%,8,4,50.00%
pull-rtmp-f26.douyincdn.com,4,0.02%,9,5,44.44%
pull-hls-spe-l1.douyincdn.com,4,0.02%,8,4,50.00%
pull-rtmp-f6.douyincdn.com,4,0.02%,8,4,50.00%
pull-flv-vr-l6.douyincdn.com,4,0.02%,8,4,50.00%
pull-tsl-spe-l6.douyincdn.com,4,0.02%,9,5,44.44%
pull-flv-l6.douyincdn.com,4,0.02%,9,5,44.44%
pull-flv-l3-enc.douyincdn.com,4,0.02%,9,5,44.44%
pull-flv-f11-proxy.douyincdn.com,4,0.02%,8,4,50.00%
pull-hls-f6.douyincdn.com,4,0.02%,8,4,50.00%
pull-rtmp-l11-source.douyincdn.com,4,0.02%,8,4,50.00%
pull-hls-f5-vs-tsl.douyincdn.com,4,0.02%,8,4,50.00%
pull-f5-io.flive.douyincdn.com,4,0.02%,9,5,44.44%
cma.itunes.apple.com,4,0.02%,10,6,40.00%
appdl6-drcn.dbankcdn.cn,4,0.02%,10,6,40.00%
appdl-drcn.dbankcdn.com,4,0.02%,9,5,44.44%
aop-pic-drcn.dbankcdn.com,4,0.02%,9,5,44.44%
apidata.googleusercontent.com,4,0.02%,8,4,50.00%
2076077.sched.d0.tdnsdp1.cn,4,0.02%,6,2,66.67%
hy-am.facebook.com,4,0.02%,8,4,50.00%
tz-ma.facebook.com,4,0.02%,8,4,50.00%
zh-cn.facebook.com,4,0.02%,8,4,50.00%
tt-ru.facebook.com,4,0.02%,8,4,50.00%
he-il.facebook.com,4,0.02%,8,4,50.00%
am-et.facebook.com,4,0.02%,8,4,50.00%
zh-hk.facebook.com,4,0.02%,8,4,50.00%
tumblr.com,4,0.02%,10,6,40.00%
ws.pull.yximgs.com,4,0.02%,7,3,57.14%
bd.pull.yximgs.com,4,0.02%,7,3,57.14%
download.mozilla.org,4,0.02%,8,4,50.00%
dl.kkdownload.com,4,0.02%,8,4,50.00%
update-windows.grammarly.com,4,0.02%,8,4,50.00%
tracker.bt4g.com,4,0.02%,15,11,26.67%
vod-all.qiniu.com.volcgslb.com,4,0.02%,4,0,100.00%
img.infinitynewtab.com,4,0.02%,8,4,50.00%
ncsi.6-c-0003.c-msedge.net,4,0.02%,4,0,100.00%
msfwifi.3g.qq.com,4,0.02%,19,15,21.05%
ctlogin4.qq.com,4,0.02%,8,4,50.00%
ctlogin2.qq.com,4,0.02%,8,4,50.00%
e6858.dscx.akamaiedge.net,4,0.02%,8,4,50.00%
connectivity.samsung.com.cn,4,0.02%,8,4,50.00%
dl.ijinshan.com,4,0.02%,8,4,50.00%
inz5jaqbqg.feishu.cn,4,0.02%,8,4,50.00%
ads.stickyadstv.com,4,0.02%,4,0,100.00%
userlink.alicdn.com,4,0.02%,7,3,57.14%
e13678.ca2.s.tl88.net,4,0.02%,8,4,50.00%
x.research.qq.com,3,0.01%,1505,1502,0.20%
config.pinyin.sogou.com,3,0.01%,755,752,0.40%
v10.events.data.microsoft.com,3,0.01%,1135,1132,0.26%
h-adashx.ut.taobao.com,3,0.01%,425,422,0.71%
crl.verisign.com,3,0.01%,82,79,3.66%
assets.msn.cn,3,0.01%,181,178,1.66%
tp.m-team.cc,3,0.01%,11,8,27.27%
v20.events.data.microsoft.com,3,0.01%,164,161,1.83%
wdl1.file.cache.docer.com,3,0.01%,46,43,6.52%
post.ksosoft.com,3,0.01%,54,51,5.56%
img.www.duba.net,3,0.01%,9,6,33.33%
d.skconf.f.360.cn,3,0.01%,318,315,0.94%
acroipm2.adobe.com,3,0.01%,6,3,50.00%
mcs.zijieapi.com,3,0.01%,9,6,33.33%
s0.meituan.net,3,0.01%,7,4,42.86%
sb.scorecardresearch.com,3,0.01%,17,14,17.65%
ms.bdimg.com,3,0.01%,11,8,27.27%
lf1-cdn-tos.bytegoofy.com,3,0.01%,7,4,42.86%
sofire.bdstatic.com,3,0.01%,9,6,33.33%
prod.fus.aws.intellij.net,3,0.01%,7,4,42.86%
dl.360safe.com,3,0.01%,21,18,14.29%
helpdubaclient.ksmobile.com,3,0.01%,100,97,3.00%
se.360.cn,3,0.01%,11,8,27.27%
s1.vip.wpscdn.cn,3,0.01%,7,4,42.86%
upload-cdn.orayimg.com,3,0.01%,8,5,37.50%
cbjs.baidu.com,3,0.01%,6,3,50.00%
cdn.exp.xiaomi.com,3,0.01%,7,4,42.86%
d.docs.live.net,3,0.01%,23,20,13.04%
s3a.pstatp.com,3,0.01%,5,2,60.00%
mssdk-bu.bytedance.com,3,0.01%,6,3,50.00%
tpc.googlesyndication.com,3,0.01%,10,7,30.00%
cdn.icloud-content.com,3,0.01%,7,4,42.86%
uci.edog.cdn.office.net,3,0.01%,7,4,42.86%
h-adashx-internal.ut.taobao.com,3,0.01%,6,3,50.00%
fullscreen-detail.alicdn.com,3,0.01%,6,3,50.00%
weread-1258476243.file.myqcloud.com,3,0.01%,6,3,50.00%
www.cctv.com,3,0.01%,7,4,42.86%
liangcang-material.alicdn.com,3,0.01%,6,3,50.00%
v5-i.douyinvod.com,3,0.01%,6,3,50.00%
music.163.com,3,0.01%,64,61,4.69%
s4.cn.bing.net,3,0.01%,6,3,50.00%
upload.twitter.com,3,0.01%,8,5,37.50%
twitter.com,3,0.01%,8,5,37.50%
m7.music.126.net,3,0.01%,7,4,42.86%
s3plus.meituan.net,3,0.01%,6,3,50.00%
fanyi-cdn.cdn.bcebos.com,3,0.01%,7,4,42.86%
m801.music.126.net,3,0.01%,10,7,30.00%
g3.ykimg.com,3,0.01%,6,3,50.00%
onedriveclucproddm20007.blob.core.windows.net,3,0.01%,7,4,42.86%
download.jetbrains.com.cn,3,0.01%,10,7,30.00%
www.tm.a.prd.aadg.akadns.net,3,0.01%,6,3,50.00%
cdn-ali-file-shc.shanhutech.cn,3,0.01%,8,5,37.50%
high-frequency-gray-cdn.duba.net,3,0.01%,6,3,50.00%
auth.hiwifi.com,3,0.01%,6,3,50.00%
cloud.hiwifi.com,3,0.01%,5,2,60.00%
crl.pki.goog,3,0.01%,6,3,50.00%
download.game.yy.com,3,0.01%,7,4,42.86%
clientlog.wanmei.com,3,0.01%,9,6,33.33%
public-cdn.cloud.unitychina.cn,3,0.01%,7,4,42.86%
1039909-9.chat.api.drift.com,3,0.01%,10,7,30.00%
dl.pop.www.duba.net,3,0.01%,7,4,42.86%
onedriveclucprodbn20002.blob.core.windows.net,3,0.01%,16,13,18.75%
i-lq.snssdk.com,3,0.01%,6,3,50.00%
f-log-editor.grammarly.io,3,0.01%,8,5,37.50%
www.emerald.com,3,0.01%,5,2,60.00%
ieeexplore.ieee.org,3,0.01%,6,3,50.00%
journal.hep.com.cn,3,0.01%,6,3,50.00%
clients.l.google.com,3,0.01%,6,3,50.00%
library-service.live.use1a.on.epicgames.com,3,0.01%,6,3,50.00%
acs.youku.com,3,0.01%,6,3,50.00%
cdn2.jianshu.io,3,0.01%,6,3,50.00%
css.ykimg.com,3,0.01%,6,3,50.00%
g2.ykimg.com,3,0.01%,6,3,50.00%
g4.ykimg.com,3,0.01%,6,3,50.00%
hudong.alicdn.com,3,0.01%,6,3,50.00%
dl.pinyin.sogou.com,3,0.01%,8,5,37.50%
g1.ykimg.com,3,0.01%,6,3,50.00%
adi6u4riy2.feishu.cn,3,0.01%,7,4,42.86%
cstaticdun.126.net,3,0.01%,7,4,42.86%
se2.itunes.apple.com,3,0.01%,4,1,75.00%
m.ykimg.com,3,0.01%,6,3,50.00%
rinkeby.infura.io,3,0.01%,6,3,50.00%
agsupdate.adobe.com,3,0.01%,6,3,50.00%
hdns.ksyun.com,3,0.01%,8,5,37.50%
ocsp.apple.com.download.ks-cdn.com,3,0.01%,7,4,42.86%
xp.itunes-apple.com.akadns.net,3,0.01%,6,3,50.00%
cn.gme.qcloud.com,3,0.01%,9,6,33.33%
cl3.apple.com,3,0.01%,6,3,50.00%
rtbapi.douyucdn.cn,3,0.01%,6,3,50.00%
res.njxzwh.com,3,0.01%,6,3,50.00%
dotserver.douyucdn.cn,3,0.01%,6,3,50.00%
16.tlu.dl.delivery.mp.microsoft.com,3,0.01%,5,2,60.00%
wwc.alicdn.com,3,0.01%,6,3,50.00%
ipcdn.apple.com,3,0.01%,8,5,37.50%
pull-flv-f6-hs.pstatp.com,3,0.01%,8,5,37.50%
static.runoob.com,3,0.01%,5,2,60.00%
push-rtmp-l13.douyincdn.com,3,0.01%,6,3,50.00%
pull-rtmp-l1-hs.pstatp.com,3,0.01%,6,3,50.00%
push-rtmp-l6-hs.pstatp.com,3,0.01%,6,3,50.00%
push-rtmp-l1.douyincdn.com,3,0.01%,7,4,42.86%
ca.iadsdk.apple.com,3,0.01%,6,3,50.00%
pull-f5-hs.flive.pstatp.com,3,0.01%,6,3,50.00%
pull-hs-f5.flive.douyincdn.com,3,0.01%,7,4,42.86%
push-rtmp-f5.douyincdn.com,3,0.01%,6,3,50.00%
push-rtmp-l3-cny.douyincdn.com,3,0.01%,6,3,50.00%
pull-tsl-spe-l3.douyincdn.com,3,0.01%,6,3,50.00%
push-rtmp-spe-l11.douyincdn.com,3,0.01%,6,3,50.00%
pull-flv-f11.douyincdn.com,3,0.01%,6,3,50.00%
pull-flv-f26-proxy.douyincdn.com,3,0.01%,7,4,42.86%
pull-spe-l3.douyincdn.com,3,0.01%,6,3,50.00%
pull-hls-f26.douyincdn.com,3,0.01%,7,4,42.86%
pull-flv-l1-source.douyincdn.com,3,0.01%,6,3,50.00%
pull-hls-f11.douyincdn.com,3,0.01%,7,4,42.86%
push-rtmp-spe-l6.douyincdn.com,3,0.01%,6,3,50.00%
pull-rtmp-f96.douyincdn.com,3,0.01%,6,3,50.00%
pull-rtmp-l1-source.douyincdn.com,3,0.01%,6,3,50.00%
pull-tsl-l3.douyincdn.com,3,0.01%,7,4,42.86%
push-rtmp-l1.ixigua.com,3,0.01%,6,3,50.00%
pull-rtmp-l26-cny.douyincdn.com,3,0.01%,7,4,42.86%
pull-lls-l11.douyincdn.com,3,0.01%,6,3,50.00%
push-rtmp-f5-hs.pstatp.com,3,0.01%,6,3,50.00%
pull-flv-l6-enc.douyincdn.com,3,0.01%,6,3,50.00%
pull-flv-l6-cny.douyincdn.com,3,0.01%,6,3,50.00%
pull-vr-l3.douyincdn.com,3,0.01%,6,3,50.00%
pull-hls-spe-l11.douyincdn.com,3,0.01%,7,4,42.86%
pull-flv-f6.douyincdn.com,3,0.01%,6,3,50.00%
pull-hls-f5-tsl.douyincdn.com,3,0.01%,6,3,50.00%
pull-hls-spe-l6.douyincdn.com,3,0.01%,7,4,42.86%
pull-f3-hs.pstatp.com,3,0.01%,6,3,50.00%
pull-rtmp-l11-cny.douyincdn.com,3,0.01%,7,4,42.86%
pull-tsl-l11.douyincdn.com,3,0.01%,6,3,50.00%
pull-flv-spe-l6.douyincdn.com,3,0.01%,6,3,50.00%
pull-tsl-vr-l6.douyincdn.com,3,0.01%,6,3,50.00%
pull-flv-l26-cny.douyincdn.com,3,0.01%,6,3,50.00%
pull-flv-spe-l11.douyincdn.com,3,0.01%,6,3,50.00%
pull-flv-l1-cny.douyincdn.com,3,0.01%,6,3,50.00%
pull-l3-hs.pstatp.com,3,0.01%,7,4,42.86%
pull-hls-vr-l26.douyincdn.com,3,0.01%,7,4,42.86%
pull-hls-vr-l1.douyincdn.com,3,0.01%,7,4,42.86%
push-rtmp-f5.ihuoshanlive.com,3,0.01%,6,3,50.00%
pull-flv-l3-encryption.douyincdn.com,3,0.01%,7,4,42.86%
pull-f5.douyincdn.com,3,0.01%,7,4,42.86%
v1-hwllqv.onewsvod.com,3,0.01%,6,3,50.00%
v11-x.douyinvod.com,3,0.01%,6,3,50.00%
globalsign.com.w.kunlunar.com,3,0.01%,5,2,60.00%
ossgw.alicdn.com,3,0.01%,5,2,60.00%
ib.snssdk.com,3,0.01%,8,5,37.50%
d3g.qq.com,3,0.01%,6,3,50.00%
cp801.prod.do.dsp.mp.microsoft.com,3,0.01%,7,4,42.86%
k128-iosapps-all.gslb.ksyuncdn.com,3,0.01%,6,3,50.00%
cdnpcwallpaper.zhhainiao.com,3,0.01%,5,2,60.00%
pdf-file.pdfxd.com,3,0.01%,7,4,42.86%
hcfy.app,3,0.01%,8,5,37.50%
gamea.haydaygame.com,3,0.01%,6,3,50.00%
es-la.facebook.com,3,0.01%,6,3,50.00%
ff-ng.facebook.com,3,0.01%,6,3,50.00%
mt-mt.facebook.com,3,0.01%,6,3,50.00%
zz-tr.facebook.com,3,0.01%,6,3,50.00%
bg-bg.facebook.com,3,0.01%,6,3,50.00%
tg-tj.facebook.com,3,0.01%,6,3,50.00%
ur-pk.facebook.com,3,0.01%,6,3,50.00%
cb-iq.facebook.com,3,0.01%,6,3,50.00%
hi-in.facebook.com,3,0.01%,6,3,50.00%
gu-in.facebook.com,3,0.01%,6,3,50.00%
te-in.facebook.com,3,0.01%,6,3,50.00%
th-th.facebook.com,3,0.01%,6,3,50.00%
my-mm.facebook.com,3,0.01%,6,3,50.00%
km-kh.facebook.com,3,0.01%,6,3,50.00%
et-ee.facebook.com,3,0.01%,6,3,50.00%
ha-ng.facebook.com,3,0.01%,6,3,50.00%
uz-uz.facebook.com,3,0.01%,6,3,50.00%
sv-se.facebook.com,3,0.01%,6,3,50.00%
ky-kg.facebook.com,3,0.01%,6,3,50.00%
ru-ru.facebook.com,3,0.01%,6,3,50.00%
uk-ua.facebook.com,3,0.01%,6,3,50.00%
fa-ir.facebook.com,3,0.01%,6,3,50.00%
sy-sy.facebook.com,3,0.01%,6,3,50.00%
ne-np.facebook.com,3,0.01%,6,3,50.00%
kn-in.facebook.com,3,0.01%,6,3,50.00%
si-lk.facebook.com,3,0.01%,6,3,50.00%
lo-la.facebook.com,3,0.01%,6,3,50.00%
ko-kr.facebook.com,3,0.01%,6,3,50.00%
web.sdk.qcloud.com,3,0.01%,6,3,50.00%
filedownload.csw.lenovo.com,3,0.01%,6,3,50.00%
ks.pull.yximgs.com,3,0.01%,5,2,60.00%
tx.pull.yximgs.com,3,0.01%,5,2,60.00%
ks-origin.pull.yximgs.com,3,0.01%,5,2,60.00%
accounts.logi.com,3,0.01%,6,3,50.00%
cfg.pcfg.cache.wpscdn.cn,3,0.01%,6,3,50.00%
cu010.www.duba.net,3,0.01%,9,6,33.33%
x8jlx54zyx.feishu.cn,3,0.01%,5,2,60.00%
d20rj4el6vkp4c.cloudfront.net,3,0.01%,42,39,7.14%
cdn.cnbj1.fds.api.mi-img.com,3,0.01%,7,4,42.86%
api3-eeft-imfile-lf.feishu.cn,3,0.01%,6,3,50.00%
repo.mysql.com,3,0.01%,6,3,50.00%
bt1.archive.org,3,0.01%,12,9,25.00%
tracker1.myporn.club,3,0.01%,9,6,33.33%
v6-1.nigirocloud.com,3,0.01%,3,0,100.00%
hcdnd101.gslb.c.cdnhwc2.com,3,0.01%,6,3,50.00%
wappass.bdimg.com,3,0.01%,8,5,37.50%
probe.icloud.com,3,0.01%,7,4,42.86%
down.anticheatexpert.com,3,0.01%,6,3,50.00%
embedded.kongzhong.com,3,0.01%,3,0,100.00%
appdl-2-drcn.dbankcdn.com,3,0.01%,8,5,37.50%
dmpstatic.cdn.bcebos.com,3,0.01%,6,3,50.00%
play-fe.googleapis.com,3,0.01%,8,5,37.50%
tracker.byr.pt,3,0.01%,3,0,100.00%
linux.teamviewer.com,3,0.01%,6,3,50.00%
apd-vodp2plogin.teg.tencent-cloud.net,3,0.01%,7,4,42.86%
dl-debug.dropbox.com,3,0.01%,6,3,50.00%
be01mr9s.sched.d2.tdnsdp1.cn,3,0.01%,4,1,75.00%
conn2.oppomobile.com,3,0.01%,6,3,50.00%
grs.dbankcloud.asia,3,0.01%,6,3,50.00%
live.github.com,3,0.01%,7,4,42.86%
itunes-cdn.itunes-apple.com.akadns.net,3,0.01%,5,2,60.00%
cdn.cnblogs.com,3,0.01%,6,3,50.00%
baidubox-emoji.cdn.bcebos.com,3,0.01%,6,3,50.00%
play-lh.googleusercontent.com,3,0.01%,8,5,37.50%
e7641.b.akamaiedge.net,3,0.01%,6,3,50.00%
desktop.docker.com,3,0.01%,6,3,50.00%
miserupdate.aliyun.com,3,0.01%,6,3,50.00%
33aef1e.ng.gladns.com,3,0.01%,6,3,50.00%
mails.ucas.ac.cn,3,0.01%,3,0,100.00%
jx.cdn.qhstatic.com,3,0.01%,8,5,37.50%
cwx.qlogo.cn,3,0.01%,6,3,50.00%
data.eastmoney.com,3,0.01%,6,3,50.00%
3.tlu.dl.delivery.mp.microsoft.com,3,0.01%,5,2,60.00%
offlintab.firefoxchina.cn.wscdns.com,3,0.01%,6,3,50.00%
incoming.telemetry.mozilla.org,2,0.01%,318,316,0.63%
mobile.events.data.microsoft.com,2,0.01%,480,478,0.42%
msedge.api.cdp.microsoft.com,2,0.01%,86,84,2.33%
wx.qlogo.cn,2,0.01%,284,282,0.70%
downv6.qq.com,2,0.01%,7,5,28.57%
ping.pinyin.sogou.com,2,0.01%,528,526,0.38%
info.pinyin.sogou.com,2,0.01%,407,405,0.49%
duba-defend.zhhainiao.com,2,0.01%,388,386,0.52%
vortex.data.microsoft.com,2,0.01%,202,200,0.99%
wdl1.file.cache.wpscdn.cn,2,0.01%,4,2,50.00%
get.sogou.com,2,0.01%,554,552,0.36%
api.msn.com,2,0.01%,115,113,1.74%
login.live.com,2,0.01%,328,326,0.61%
config.edge.skype.com,2,0.01%,234,232,0.85%
ims-na1.adobelogin.com,2,0.01%,5,3,40.00%
drive.wps.cn,2,0.01%,153,151,1.31%
m8.music.126.net.w.kunlungr.com,2,0.01%,4,2,50.00%
www.wenxm.cn,2,0.01%,4,2,50.00%
cdnimg.3g.qq.com,2,0.01%,4,2,50.00%
client.mail.163.com,2,0.01%,87,85,2.30%
ocsp2-lb.apple.com.akadns.net,2,0.01%,35,33,5.71%
substrate.office.com,2,0.01%,70,68,2.86%
cdn.ark.qq.com,2,0.01%,6,4,33.33%
assets2.msn.com,2,0.01%,9,7,22.22%
5b0988e595225.cdn.sohucs.com,2,0.01%,5,3,40.00%
mmbiz.qpic.cn.sched.legopic1.tdnsv6.com,2,0.01%,6,4,33.33%
img-s.msn.cn,2,0.01%,6,4,33.33%
p0.meituan.net,2,0.01%,5,3,40.00%
p1.meituan.net,2,0.01%,5,3,40.00%
tb5.bdstatic.com,2,0.01%,7,5,28.57%
tb3.bdstatic.com,2,0.01%,6,4,33.33%
tiebapic.baidu.com,2,0.01%,4,2,50.00%
ppui-static-pc.cdn.bcebos.com,2,0.01%,5,3,40.00%
cl.vd.f.360.cn,2,0.01%,214,212,0.93%
wework.qpic.cn,2,0.01%,6,4,33.33%
avatar.qwps.cn,2,0.01%,44,42,4.55%
p8.itc.cn,2,0.01%,6,4,33.33%
t14.baidu.com,2,0.01%,24,22,8.33%
edu-wenku.bdimg.com,2,0.01%,5,3,40.00%
api.flash.cn,2,0.01%,7,5,28.57%
tongji.flash.cn,2,0.01%,7,5,28.57%
midas.gtimg.cn,2,0.01%,4,2,50.00%
scholar.google.com.hk,2,0.01%,4,2,50.00%
id.google.com,2,0.01%,3,1,66.67%
3gimg.qq.com,2,0.01%,5,3,40.00%
pgdt.tc.qq.com,2,0.01%,5,3,40.00%
pgdt.gtimg.cn.sched.legopic2.tdnsv6.com.tpic.vwnti.yrzhcloud.cn,2,0.01%,4,2,50.00%
h5hosting-drcn.dbankcdn.cn,2,0.01%,4,2,50.00%
itunes.apple.com,2,0.01%,5,3,40.00%
pc001.update.lbmini.cmcm.com,2,0.01%,4,2,50.00%
firebaseinstallations.googleapis.com,2,0.01%,4,2,50.00%
fundingchoicesmessages.google.com,2,0.01%,6,4,33.33%
zhanzhang.toutiao.com.w.cdngslb.com,2,0.01%,4,2,50.00%
tracker.ipv6tracker.ru,2,0.01%,2,0,100.00%
static.nowcoder.com,2,0.01%,4,2,50.00%
uploadfiles.nowcoder.com,2,0.01%,4,2,50.00%
gimg1.baidu.com,2,0.01%,5,3,40.00%
api.amemv.com,2,0.01%,5,3,40.00%
b0.bdstatic.com,2,0.01%,4,2,50.00%
vd3.bdstatic.com,2,0.01%,5,3,40.00%
graph.facebook.com,2,0.01%,4,2,50.00%
static.pddpic.com,2,0.01%,4,2,50.00%
promotion.pddpic.com,2,0.01%,4,2,50.00%
funimg.pddpic.com,2,0.01%,4,2,50.00%
api5-normal-dsa-hl.amemv.com,2,0.01%,4,2,50.00%
avatar2-1.pddpic.com,2,0.01%,5,3,40.00%
avatar2.pddpic.com,2,0.01%,4,2,50.00%
v11.sched.v4lego-dk.tdnsvod1.cn,2,0.01%,4,2,50.00%
push-resources-1258344701.file.myqcloud.com,2,0.01%,3,1,66.67%
push-resources.sched.dma.tdnsdl1.cn.cdl.cdncloud.idc400.com,2,0.01%,3,1,66.67%
www.vod.lxdns.com,2,0.01%,4,2,50.00%
gametools.bs2dl.yy.com,2,0.01%,4,2,50.00%
puui.qpic.cn,2,0.01%,4,2,50.00%
ipv6.google.com,2,0.01%,58,56,3.45%
cfg-1.pddpic.com,2,0.01%,4,2,50.00%
v5-e.douyinvod.com,2,0.01%,4,2,50.00%
stcglobal.beisen.com,2,0.01%,4,2,50.00%
v1.douyinvod.com,2,0.01%,4,2,50.00%
v27-a.douyinvod.com,2,0.01%,4,2,50.00%
digitalassetlinks.googleapis.com,2,0.01%,4,2,50.00%
v11.douyinvod.com,2,0.01%,4,2,50.00%
cp501.prod.do.dsp.mp.microsoft.com,2,0.01%,9,7,22.22%
cp601.prod.do.dsp.mp.microsoft.com,2,0.01%,5,3,40.00%
g.y.qq.com,2,0.01%,4,2,50.00%
onedriveclucprodbn20036.blob.core.windows.net,2,0.01%,6,4,33.33%
d.dropbox.com,2,0.01%,4,2,50.00%
lf3-cdn-tos.bytegecko.com,2,0.01%,4,2,50.00%
upload-images.jianshu.io,2,0.01%,5,3,40.00%
qcloud.dpfile.com,2,0.01%,4,2,50.00%
p3.music.126.net.163jiasu.com,2,0.01%,14,12,14.29%
codown.youdao.com,2,0.01%,4,2,50.00%
kv801.prod.do.dsp.mp.microsoft.com,2,0.01%,15,13,13.33%
p3.music.126.net,2,0.01%,11,9,18.18%
msg.qy.net,2,0.01%,49,47,4.08%
dy.xiajunhuagong.cn,2,0.01%,3,1,66.67%
btinstall-artifacts.bittorrent.com,2,0.01%,4,2,50.00%
i-5600.b-2372.helper.bench.utorrent.com,2,0.01%,4,2,50.00%
instantmessaging-pa.googleapis.com,2,0.01%,4,2,50.00%
pgpstatic.games.wanmei.com,2,0.01%,5,3,40.00%
public-cdn.cloud.unity3d.com,2,0.01%,4,2,50.00%
dynamic.t0.tiles.ditu.live.com,2,0.01%,6,4,33.33%
s2.go-mpulse.net,2,0.01%,4,2,50.00%
trial-eum-clientnsv4-s.akamaihd.net,2,0.01%,4,2,50.00%
trial-eum-clienttons-s.akamaihd.net,2,0.01%,4,2,50.00%
assets.adobedtm.com,2,0.01%,4,2,50.00%
684d0d44.akstat.io,2,0.01%,4,2,50.00%
consent.trustarc.com,2,0.01%,4,2,50.00%
hilton.demdex.net,2,0.01%,4,2,50.00%
cipv6gn.v.trpcdn.NET,2,0.01%,6,4,33.33%
appdl.lenovo.com.cn,2,0.01%,4,2,50.00%
api.epicgames.dev,2,0.01%,5,3,40.00%
jp04-vm0.entry.srthdw.art,2,0.01%,4,2,50.00%
odc-bl6pap004-meta-geo.onedrive.akadns.NET,2,0.01%,4,2,50.00%
odc-bl6pap004-meta-brs.onedrive.akadns.NET,2,0.01%,5,3,40.00%
o3cf2jk38u.feishu.cn,2,0.01%,4,2,50.00%
slb-p2p.vcloud.ks-live.com,2,0.01%,11,9,18.18%
ux70.v.trpcdn.net,2,0.01%,4,2,50.00%
mt.lenovo.com.cn,2,0.01%,5,3,40.00%
api3-eeft-imfile-hl.feishu.cn,2,0.01%,4,2,50.00%
cmmsns.qpic.cn,2,0.01%,4,2,50.00%
wdl1.file.cache.docer.com.qiniudns.com,2,0.01%,2,0,100.00%
dl.pinyin.sogou.com.cdn.dnsv1.com,2,0.01%,2,0,100.00%
356297.sched.dma.tdnsdl1.cn,2,0.01%,2,0,100.00%
dsp.mbgcdn.lenovo.com.cn,2,0.01%,6,4,33.33%
mt.mbgcdn.lenovo.com.cn,2,0.01%,2,0,100.00%
tracker.bitsearch.to,2,0.01%,6,4,33.33%
a5.behance.net,2,0.01%,4,2,50.00%
adx-static.ksosoft.com,2,0.01%,4,2,50.00%
api.feelgood.cn,2,0.01%,4,2,50.00%
images.cnblogs.com,2,0.01%,4,2,50.00%
js.ykimg.com,2,0.01%,4,2,50.00%
lf3-cdn-tos.bytecdntp.com,2,0.01%,4,2,50.00%
p9.qhimg.com,2,0.01%,5,3,40.00%
dscache.tencent-cloud.cn,2,0.01%,4,2,50.00%
acm-prod.disqus.com,2,0.01%,4,2,50.00%
images2015.cnblogs.com,2,0.01%,4,2,50.00%
r1.ykimg.com,2,0.01%,4,2,50.00%
imgconvert.csdnimg.cn,2,0.01%,5,3,40.00%
s2.cn.bing.net,2,0.01%,4,2,50.00%
hub5u.sandai.net,2,0.01%,8,6,25.00%
d2us8jqsezvhge.cloudfront.net,2,0.01%,2,0,100.00%
updates.ghub.logitechg.com,2,0.01%,4,2,50.00%
emres.dfcfw.com,2,0.01%,4,2,50.00%
ns2.namebrightdns.com,2,0.01%,258,256,0.78%
ns02.000webhost.com,2,0.01%,8,6,25.00%
monorepo-production-edge-alb-985829473.us-east-1.elb.amazonaws.com,2,0.01%,4,2,50.00%
gateway.bitrenren.com,2,0.01%,5,3,40.00%
skconf.f.360.cn,2,0.01%,6,4,33.33%
pancake.cdn-apple.com.akadns.net,2,0.01%,5,3,40.00%
appledownload.qtlcdn.com,2,0.01%,4,2,50.00%
infinity-basic.infinitynewtab.com,2,0.01%,4,2,50.00%
beacons5.gvt3.com,2,0.01%,3,1,66.67%
su.itunes.apple.com,2,0.01%,5,3,40.00%
outlook.ha.office365.com,2,0.01%,2,0,100.00%
mqtt-web.zhihu.com.dsa.dnsv1.com,2,0.01%,2,0,100.00%
dlied6.qq.com.tcdn.qq.com,2,0.01%,3,1,66.67%
edge.skype.com,2,0.01%,8,6,25.00%
a1449.dscg2.akamai.net,2,0.01%,6,4,33.33%
a1851.dscg2.akamai.net,2,0.01%,4,2,50.00%
apic.douyucdn.cn,2,0.01%,4,2,50.00%
webconf.douyucdn.cn,2,0.01%,4,2,50.00%
dotbeats.douyucdn.cn,2,0.01%,4,2,50.00%
sta-op.douyucdn.cn,2,0.01%,4,2,50.00%
www.onlinedown.net,2,0.01%,4,2,50.00%
static.mediav.com,2,0.01%,4,2,50.00%
stats.g.doubleclick.net,2,0.01%,4,2,50.00%
ade.googlesyndication.com,2,0.01%,3,1,66.67%
tencent-doc.cdn-go.cn,2,0.01%,4,2,50.00%
cdn-go.cn,2,0.01%,4,2,50.00%
m7.music.126.net.w.alikunlun.com,2,0.01%,6,4,33.33%
img04.sogoucdn.com,2,0.01%,4,2,50.00%
img01.sogoucdn.com,2,0.01%,4,2,50.00%
img.shouji.sogou.com,2,0.01%,4,2,50.00%
acstatic-dun.126.net,2,0.01%,7,5,28.57%
fonts.googleapis.com,2,0.01%,4,2,50.00%
download.cntv.cn,2,0.01%,6,4,33.33%
pics7.baidu.com,2,0.01%,4,2,50.00%
nmtest.bdstatic.com,2,0.01%,4,2,50.00%
cu005.www.duba.net,2,0.01%,6,4,33.33%
www.taobao.com.danuoyi.tbcache.com,2,0.01%,4,2,50.00%
media8.smartstudy.com,2,0.01%,4,2,50.00%
push-rtmp-vr-l6.douyincdn.com,2,0.01%,4,2,50.00%
pull-f5-hs.pstatp.com,2,0.01%,5,3,40.00%
push-rtmp-l6.ixigua.com,2,0.01%,4,2,50.00%
push-rtmp-l3-enc.douyincdn.com,2,0.01%,4,2,50.00%
push-rtmp-spe-l26.douyincdn.com,2,0.01%,4,2,50.00%
pull-rtmp-l6.ixigua.com,2,0.01%,4,2,50.00%
push-rtmp-l6-encryption.douyincdn.com,2,0.01%,4,2,50.00%
push-rtmp-l3-hs.pstatp.com,2,0.01%,4,2,50.00%
push-rtmp-vr-l26.douyincdn.com,2,0.01%,4,2,50.00%
push-rtmp-l6-enc.douyincdn.com,2,0.01%,5,3,40.00%
push-rtmp-l6-cny.douyincdn.com,2,0.01%,5,3,40.00%
push-rtmp-l3-encryption.douyincdn.com,2,0.01%,5,3,40.00%
push-rtmp-hs-f5.huoshanlive.com,2,0.01%,4,2,50.00%
push-rtmp-l6.douyincdn.com,2,0.01%,5,3,40.00%
push-rtmp-vr-l11.douyincdn.com,2,0.01%,4,2,50.00%
push-rtmp-l26.douyincdn.com,2,0.01%,5,3,40.00%
push-rtmp-l11.douyincdn.com,2,0.01%,4,2,50.00%
sns-video-bd.xhscdn.com,2,0.01%,4,2,50.00%
list3.ppstream.com.iqiyi.com,2,0.01%,6,4,33.33%
m.baoshuu.com,2,0.01%,4,2,50.00%
sf6-cdn-tos.douyinstatic.com,2,0.01%,4,2,50.00%
images.uc.cn,2,0.01%,3,1,66.67%
pdds-cdn.uc.cn,2,0.01%,3,1,66.67%
api3-core-c-lq.amemv.com,2,0.01%,4,2,50.00%
image.uc.cn,2,0.01%,3,1,66.67%
lf3-article.toutiaostatic.com,2,0.01%,4,2,50.00%
v9-default.365yg.com,2,0.01%,4,2,50.00%
toblog.ctobsnssdk.com,2,0.01%,6,4,33.33%
sf3-fe-tos.pglstatp-toutiao.com,2,0.01%,4,2,50.00%
www.lenovo.com,2,0.01%,3,1,66.67%
public.gdtimg.com,2,0.01%,4,2,50.00%
iosapps-cn-lb.dl-apple.com.akadns.net,2,0.01%,4,2,50.00%
1year.pcfg.cache.wpscdn.cn,2,0.01%,4,2,50.00%
dldir1.qq.com.tcdn.qq.com,2,0.01%,4,2,50.00%
bl6pcor004-meta.fe.1drv.com,2,0.01%,3,1,66.67%
fi-fi.facebook.com,2,0.01%,4,2,50.00%
kk-kz.facebook.com,2,0.01%,4,2,50.00%
sr-rs.facebook.com,2,0.01%,4,2,50.00%
ps-af.facebook.com,2,0.01%,4,2,50.00%
ml-in.facebook.com,2,0.01%,4,2,50.00%
zh-tw.facebook.com,2,0.01%,4,2,50.00%
ja-jp.facebook.com,2,0.01%,4,2,50.00%
d0.baidupcs.com,2,0.01%,4,2,50.00%
pl-pl.facebook.com,2,0.01%,4,2,50.00%
vi-vn.facebook.com,2,0.01%,4,2,50.00%
be-by.facebook.com,2,0.01%,4,2,50.00%
ar-ar.facebook.com,2,0.01%,4,2,50.00%
pa-in.facebook.com,2,0.01%,4,2,50.00%
or-in.facebook.com,2,0.01%,4,2,50.00%
appdl-3-drcn.dbankcdn.com,2,0.01%,5,3,40.00%
m10.music.126.net,2,0.01%,4,2,50.00%
zmptxy.v.trpcdn.NET,2,0.01%,10,8,20.00%
bd-origin.pull.yximgs.com,2,0.01%,3,1,66.67%
ws-origin.pull.yximgs.com,2,0.01%,3,1,66.67%
settings-prod-cin-1.centralindia.cloudapp.azure.com,2,0.01%,10,8,20.00%
v26.bdxiguavod.com,2,0.01%,4,2,50.00%
update.qnap.com,2,0.01%,4,2,50.00%
0.rhel.pool.ntp.org,2,0.01%,2,0,100.00%
1.rhel.pool.ntp.org,2,0.01%,2,0,100.00%
mon.zijieapi.com.dsa.dnsv1.com.cn,2,0.01%,2,0,100.00%
www.appleiphonecell.com,2,0.01%,4,2,50.00%
gtd.alicdn.com,2,0.01%,4,2,50.00%
tracker.pussytorrents.org,2,0.01%,6,4,33.33%
down.xinshuru.com,2,0.01%,4,2,50.00%
eth-mainnet.alchemyapi.io,2,0.01%,4,2,50.00%
smartdl.mbgcdn.lenovo.com.cn,2,0.01%,4,2,50.00%
www.tm.ak.prd.aadg.akadns.net,2,0.01%,4,2,50.00%
v6ncsi.msedge.net,2,0.01%,4,2,50.00%
mesu-cdn.apple.com.akadns.net,2,0.01%,4,2,50.00%
pics0.baidu.com,2,0.01%,4,2,50.00%
feed-image.baidu.com,2,0.01%,4,2,50.00%
vd2.bdstatic.com,2,0.01%,4,2,50.00%
e1553.dspg.akamaiedge.NET,2,0.01%,2,0,100.00%
rsg461l4.sched.d0.tdnsdp1.cn,2,0.01%,2,0,100.00%
dl2.360safe.com,2,0.01%,9,7,22.22%
tnc3-alisc1.zijieapi.com.w.kunluncan.com,2,0.01%,4,2,50.00%
unpkg.byted-static.com,2,0.01%,2,0,100.00%
p26-passport.byteacctimg.com,2,0.01%,2,0,100.00%
q-ring.msedge.net,2,0.01%,4,2,50.00%
cdn2.ime.sogou.com,2,0.01%,4,2,50.00%
mam6.netease.com,2,0.01%,2,0,100.00%
d3.music.126.net,2,0.01%,4,2,50.00%
st.music.163.com,2,0.01%,4,2,50.00%
s6.music.126.net,2,0.01%,4,2,50.00%
iduxlmx.qiniudns.com,2,0.01%,2,0,100.00%
upos-sz-mirrorcoso1.bilivideo.com.cdn.dnsv1.com,2,0.01%,2,0,100.00%
gspe79-ssl.ls.apple.com,2,0.01%,6,4,33.33%
www.iqiyi.com,2,0.01%,4,2,50.00%
sqdd.myapp.com,2,0.01%,4,2,50.00%
market.m.taobao.com,2,0.01%,4,2,50.00%
ipv6.shuzilm.cn,2,0.01%,2,0,100.00%
mqtt.zhihu.com,2,0.01%,4,2,50.00%
vdn6.vzuu.com,2,0.01%,4,2,50.00%
path2.xtracloud.net,2,0.01%,4,2,50.00%
mqtt-internal-public.zhihu.com,2,0.01%,4,2,50.00%
f.c2r.ts.cdn.office.net,2,0.01%,8,6,25.00%
baikebcs.bdimg.com,2,0.01%,4,2,50.00%
static.dingtalk.com,2,0.01%,6,4,33.33%
dlassets-ssl.xboxlive.com,2,0.01%,5,3,40.00%
debian.map.fastlydns.NET,2,0.01%,4,2,50.00%
up.f.360.cn,2,0.01%,3,1,66.67%
hw.zuimeitianqi.com,2,0.01%,4,2,50.00%
bn2bcor002-meta.fe.1drv.com,2,0.01%,3,1,66.67%
e7695.dscg.akamaiedge.NET,2,0.01%,4,2,50.00%
software-down.keniu.com.0ba44e8c.c.cdnhwc1.com,2,0.01%,4,2,50.00%
2.rhel.pool.ntp.org,2,0.01%,2,0,100.00%
d28dx6y1hfq314.cloudfront.net,2,0.01%,3,1,66.67%
onedriveclucprodbn20011.blob.core.windows.net,2,0.01%,6,4,33.33%
download.mcafee.com,2,0.01%,3,1,66.67%
www.apple.com.edgekey.net.globalredir.akadns.net,2,0.01%,4,2,50.00%
p3-zeus.byteimg.com,2,0.01%,4,2,50.00%
ykimg.alicdn.com,2,0.01%,4,2,50.00%
wildcard.feishu.cn.bytedns1.com,2,0.01%,4,2,50.00%
scrootca2.ocsp.secomtrust.net,2,0.01%,4,2,50.00%
update.reasonsecurity.com,2,0.01%,4,2,50.00%
s0.2mdn.net,2,0.01%,4,2,50.00%
e6603.g.akamaiedge.net,2,0.01%,3,1,66.67%
opencdnglobalv6.jomodns.com,2,0.01%,4,2,50.00%
match.prod.bidr.io,2,0.01%,4,2,50.00%
l5.gslb.ksyuncdn.com,2,0.01%,4,2,50.00%
tlu.dl.delivery.mp.microsoft.com.w.alikunlun.com,2,0.01%,4,2,50.00%
kv501.prod.do.dsp.mp.microsoft.com.edgekey.NET,2,0.01%,2,0,100.00%
m.sohu.com,2,0.01%,5,3,40.00%
apd-609c8727e337428bb2edbec922460b5501bdd8f5529987f8.v.smtcdns.com,2,0.01%,2,0,100.00%
license.vod2.myqcloud.com,2,0.01%,4,2,50.00%
cdn1.ime.sogou.com,2,0.01%,7,5,28.57%
tplogin.cn,2,0.01%,2,0,100.00%
img30.360buyimg.com,2,0.01%,4,2,50.00%
static.cnblogs.com,2,0.01%,4,2,50.00%
p3-be-pack-sign.pglstatp-toutiao.com,2,0.01%,4,2,50.00%
mail-online.nosdn.127.net,2,0.01%,4,2,50.00%
widget.intercom.io,2,0.01%,4,2,50.00%
js.intercomcdn.com,2,0.01%,4,2,50.00%
sns-img-bd.xhscdn.com,2,0.01%,4,2,50.00%
v26.douyinvod.com.c.cdnhwc1.com,2,0.01%,4,2,50.00%
pull-rtmp-l1.douyincdn.com.wsdvs.com,2,0.01%,4,2,50.00%
pull-flv-f29.douyincdn.com.ucloud.com.cn,2,0.01%,4,2,50.00%
manifest.googlevideo.com,2,0.01%,4,2,50.00%
sslzz.jomodns.com,2,0.01%,4,2,50.00%
tce.alicdn.com,2,0.01%,4,2,50.00%
ase.autodesk.com,2,0.01%,4,2,50.00%
stocks-sparkline-lb.apple.com.akadns.net,2,0.01%,4,2,50.00%
ali2.a.yximgs.com,2,0.01%,4,2,50.00%
alimov2.a.yximgs.com,2,0.01%,4,2,50.00%
aliimg.a.yximgs.com,2,0.01%,4,2,50.00%
ali-livemate.pull.yximgs.com,2,0.01%,4,2,50.00%
bd-adaptive.pull.yximgs.com,2,0.01%,4,2,50.00%
ali-adaptive.pull.yximgs.com,2,0.01%,4,2,50.00%
ali-kmpaudio.pull.yximgs.com,2,0.01%,4,2,50.00%
gms.razersynapse.com,2,0.01%,3,1,66.67%
updates.cdn-apple.com,2,0.01%,4,2,50.00%
3.rhel.pool.ntp.org,2,0.01%,2,0,100.00%
1min.pcfg.cache.wpscdn.cn.qiniudns.com,2,0.01%,2,0,100.00%
search.ximalaya.com,2,0.01%,2,0,100.00%
search.ximalaya.com.dsa.dnsv1.com,2,0.01%,2,0,100.00%
d2rb60829qiz9y.cloudfront.net,2,0.01%,4,2,50.00%
onedriveclucprodbn20016.blob.core.windows.net,2,0.01%,6,4,33.33%
r4.res.office365.com.edgekey.NET,2,0.01%,2,0,100.00%
3071995.dsp-dk.sched.dcloudstc.com,2,0.01%,4,2,50.00%
apd-01fe2cea10604cc0d5743de4947f01b13dccda98d5b74beb.v.smtcdns.com,2,0.01%,2,0,100.00%
cstat.apple.com,2,0.01%,4,2,50.00%
hblg.media.net,2,0.01%,3,1,66.67%
contextual.media.net,2,0.01%,4,2,50.00%
lg3.media.net,2,0.01%,3,1,66.67%
dgss0.bdstatic.com,2,0.01%,5,3,40.00%
hao123-static.cdn.bcebos.com,2,0.01%,4,2,50.00%
dgss3.bdstatic.com,2,0.01%,4,2,50.00%
dl.static.iqiyi.com,2,0.01%,6,4,33.33%
fenwan.cdn.bcebos.com,2,0.01%,4,2,50.00%
wapcdn.thecover.cn,2,0.01%,4,2,50.00%
dcdn.thecover.cn,2,0.01%,3,1,66.67%
imgcdn.thecover.cn,2,0.01%,4,2,50.00%
dfzximg02.dftoutiao.com,2,0.01%,3,1,66.67%
fivvx5tzyr.feishu.cn,2,0.01%,5,3,40.00%
remotedesktop-pa.googleapis.com,2,0.01%,4,2,50.00%
download.amd.com,2,0.01%,4,2,50.00%
www.pinterest.com,2,0.01%,4,2,50.00%
iv6.gtimg.cn,2,0.01%,4,2,50.00%
cm-cn-central-00001.albatross.10086.cn,2,0.01%,4,2,50.00%
translate.googleapis.com,2,0.01%,6,4,33.33%
ndstatic.cdn.bcebos.com,2,0.01%,4,2,50.00%
tianquan.gtimg.cn,2,0.01%,4,2,50.00%
jsqmt.qq.com,2,0.01%,2,0,100.00%
crl.apple.com,2,0.01%,3,1,66.67%
www.tmall.com,2,0.01%,4,2,50.00%
crl-lb.apple.com.akadns.net,2,0.01%,2,0,100.00%
2.asia.pool.ntp.org,2,0.01%,4,2,50.00%
nj.cschannel.anticheatexpert.com,2,0.01%,4,2,50.00%
apps.bdimg.com,2,0.01%,4,2,50.00%
mapsnap0.bdimg.com,2,0.01%,4,2,50.00%
android.googleapis.com,2,0.01%,4,2,50.00%
news.china.com,2,0.01%,4,2,50.00%
www.china.com,2,0.01%,3,1,66.67%
dvsend.china.com,2,0.01%,4,2,50.00%
img04-utuku.china.com,2,0.01%,4,2,50.00%
img3.utuku.imgcdc.com,2,0.01%,4,2,50.00%
img2.utuku.imgcdc.com,2,0.01%,3,1,66.67%
img0.utuku.imgcdc.com,2,0.01%,3,1,66.67%
img1.utuku.imgcdc.com,2,0.01%,3,1,66.67%
ipv6.www.so.com,2,0.01%,2,0,100.00%
nimg.ws.126.net,2,0.01%,4,2,50.00%
tracker2.wasabii.com.tw,2,0.01%,2,0,100.00%
sbc.firefox.com.cn,2,0.01%,4,2,50.00%
shared.ydstatic.com,2,0.01%,4,2,50.00%
pushmo.hac.lp1.eshop.nintendo.net,2,0.01%,3,1,66.67%
atum.hac.lp1.d4c.nintendo.net,2,0.01%,4,2,50.00%
publicsuffix.org,2,0.01%,4,2,50.00%
xapi.dida365.com,2,0.01%,4,2,50.00%
cdn.ark.qq.com.cloud.tc.qq.com,2,0.01%,2,0,100.00%
teredo.ipv6.microsoft.com,1,0.00%,4956,4955,0.02%
api.vc.bilibili.com,1,0.00%,670,669,0.15%
mv.music.tc.qq.com,1,0.00%,85,84,1.18%
skydrivesync.policies.live.net,1,0.00%,27,26,3.70%
c.skconf.f.360.cn,1,0.00%,59,58,1.69%
ldc.lenovo.com.cn,1,0.00%,181,180,0.55%
github.com,1,0.00%,45,44,2.22%
security.bilibili.com,1,0.00%,14,13,7.14%
i0.hdslb.com,1,0.00%,38,37,2.63%
passport.biligame.com,1,0.00%,2,1,50.00%
passport.bigfun.cn,1,0.00%,2,1,50.00%
passport.bigfunapp.cn,1,0.00%,2,1,50.00%
passport.shanghaihuanli.com,1,0.00%,2,1,50.00%
passport.bilibili.cn,1,0.00%,2,1,50.00%
sp1.baidu.com,1,0.00%,67,66,1.49%
www.icloud.com,1,0.00%,31,30,3.23%
data.bilicdn2.com,1,0.00%,2,1,50.00%
tile-service.weather.microsoft.com,1,0.00%,305,304,0.33%
zhihu-web-analytics.zhihu.com,1,0.00%,17,16,5.88%
wp.safe.360.cn,1,0.00%,589,588,0.17%
checkappexec.microsoft.com,1,0.00%,157,156,0.64%
appconf.mail.163.com,1,0.00%,70,69,1.43%
nexusrules.officeapps.live.com,1,0.00%,328,327,0.30%
time.apple.com,1,0.00%,136,135,0.74%
api.live.bilibili.com,1,0.00%,37,36,2.70%
pcs-sdk-server.alibaba.com,1,0.00%,434,433,0.23%
zhidao.baidu.com,1,0.00%,149,148,0.67%
notice.wps.cn,1,0.00%,49,48,2.04%
le.wps.cn,1,0.00%,38,37,2.63%
qr.wps.cn,1,0.00%,38,37,2.63%
zj-roaming.wps.cn,1,0.00%,43,42,2.33%
dl.vas.wpscdn.cn,1,0.00%,41,40,2.44%
www.google-analytics.com,1,0.00%,17,16,5.88%
ctldl.windowsupdate.com,1,0.00%,902,901,0.11%
cn.bing.com,1,0.00%,185,184,0.54%
pc-plugin-plg.wpscdn.cn,1,0.00%,202,201,0.50%
res.wx.qq.com,1,0.00%,47,46,2.13%
switch.pcfg.cache.wpscdn.cn,1,0.00%,397,396,0.25%
www.msftncsi.com,1,0.00%,1271,1270,0.08%
oth.eve.mdt.qq.com,1,0.00%,213,212,0.47%
crl3.digicert.com,1,0.00%,16,15,6.25%
ecs.office.com,1,0.00%,177,176,0.56%
account.wps.cn,1,0.00%,69,68,1.45%
home.wps.cn,1,0.00%,42,41,2.38%
wdl1.cache.wps.cn,1,0.00%,136,135,0.74%
roaming.wps.cn,1,0.00%,36,35,2.78%
dyn.wps.cn,1,0.00%,47,46,2.13%
ic.wps.cn,1,0.00%,77,76,1.30%
update.wps.cn,1,0.00%,149,148,0.67%
wx3.sinaimg.cn,1,0.00%,22,21,4.55%
d23iz4esrwkib6.cloudfront.net,1,0.00%,4,3,25.00%
q-ring.q-9999.q-msedge.NET,1,0.00%,2,1,50.00%
aqqmusic.tc.qq.com,1,0.00%,53,52,1.89%
maponline3.bdimg.com,1,0.00%,4,3,25.00%
maponline0.bdimg.com,1,0.00%,4,3,25.00%
maponline1.bdimg.com,1,0.00%,4,3,25.00%
px.moatads.com,1,0.00%,2,1,50.00%
tool.chinaz.com,1,0.00%,2,1,50.00%
csstools.chinaz.com,1,0.00%,2,1,50.00%
a2put.chinaz.com,1,0.00%,2,1,50.00%
oimageb7.ydstatic.com,1,0.00%,2,1,50.00%
tsearch.snssdk.com,1,0.00%,3,2,33.33%
s1.ljcdn.com,1,0.00%,4,3,25.00%
btrace.qq.com,1,0.00%,255,254,0.39%
amp-api-edge-lb-cn.itunes-apple.com.akadns.net,1,0.00%,3,2,33.33%
pconf.f.360.cn,1,0.00%,159,158,0.63%
waconafd.officeapps.live.com,1,0.00%,17,16,5.88%
api.apple-cloudkit.com,1,0.00%,26,25,3.85%
wm.xiajunhuagong.cn,1,0.00%,4,3,25.00%
qqadapt.qpic.cn,1,0.00%,4,3,25.00%
update.360safe.com,1,0.00%,71,70,1.41%
functional.events.data.microsoft.com,1,0.00%,30,29,3.33%
push.zhanzhang.baidu.com,1,0.00%,3,2,33.33%
mmbiz.qlogo.cn,1,0.00%,10,9,10.00%
tb1.bdstatic.com,1,0.00%,6,5,16.67%
passport.bdimg.com,1,0.00%,3,2,33.33%
mediago-static.cdn.bcebos.com,1,0.00%,5,4,20.00%
sconf.f.360.cn,1,0.00%,157,156,0.64%
aistudio.baidu.com,1,0.00%,1,0,100.00%
update.pan.baidu.com,1,0.00%,155,154,0.65%
proxy.safebrowsing.apple,1,0.00%,1,0,100.00%
safebrowsing-re.aaplimg.com,1,0.00%,1,0,100.00%
cambrian-images.cdn.bcebos.com,1,0.00%,4,3,25.00%
zt.wps.cn,1,0.00%,40,39,2.50%
login.microsoftonline.com,1,0.00%,40,39,2.50%
wkstatic.bdimg.com,1,0.00%,3,2,33.33%
wkretype.bdimg.com,1,0.00%,3,2,33.33%
wkbjcloudbos.bdimg.com,1,0.00%,3,2,33.33%
pc-plugin.wpscdn.cn,1,0.00%,44,43,2.27%
recv-wd.gridsumdissector.com,1,0.00%,1,0,100.00%
normandy.cdn.mozilla.net,1,0.00%,54,53,1.85%
dldir1.qq.com,1,0.00%,175,174,0.57%
db.local.clamav.net,1,0.00%,411,410,0.24%
gameplay.intel.com,1,0.00%,26,25,3.85%
bcp.crwdcntrl.net,1,0.00%,2,1,50.00%
api.onedrive.com,1,0.00%,52,51,1.92%
www.gravatar.com,1,0.00%,12,11,8.33%
mdn.alipay.com,1,0.00%,3,2,33.33%
mdn.alicdn.com,1,0.00%,2,1,50.00%
img.cdn.mvideo.xiaomi.com,1,0.00%,2,1,50.00%
fe3cr.delivery.mp.microsoft.com,1,0.00%,119,118,0.84%
client-api-cdn-cn.itunes-apple.com.akadns.net,1,0.00%,2,1,50.00%
is5-ssl.mzstatic.com,1,0.00%,2,1,50.00%
is4-ssl.mzstatic.com,1,0.00%,2,1,50.00%
is1-ssl.mzstatic.com,1,0.00%,2,1,50.00%
www.belkin.com,1,0.00%,2,1,50.00%
tysdk.95516.com,1,0.00%,2,1,50.00%
adsmind.gdtimg.com.svideolego-dk.sched.dcloudstc.com,1,0.00%,2,1,50.00%
dc.applicationinsights.microsoft.com,1,0.00%,2,1,50.00%
sadownload.mcafee.com,1,0.00%,48,47,2.08%
img2.baidu.com,1,0.00%,2,1,50.00%
img0.baidu.com,1,0.00%,2,1,50.00%
img1.baidu.com,1,0.00%,2,1,50.00%
pptpluginppt.keniu.com,1,0.00%,2,1,50.00%
verdaccio.org,1,0.00%,2,1,50.00%
settings-prod-uks-1.uksouth.cloudapp.azure.com,1,0.00%,16,15,6.25%
kjjs.360.cn,1,0.00%,2,1,50.00%
emoji.qpic.cn.sched.legopic1.tdnsv6.com,1,0.00%,2,1,50.00%
pcvideoaliyun.titan.mgtv.com,1,0.00%,2,1,50.00%
pub.idqqimg.com.tc.qq.com,1,0.00%,2,1,50.00%
app2.myzaker.com,1,0.00%,2,1,50.00%
app.myzaker.com,1,0.00%,2,1,50.00%
zkres.myzaker.com,1,0.00%,2,1,50.00%
zkres1.myzaker.com,1,0.00%,2,1,50.00%
dm.toutiao.com,1,0.00%,2,1,50.00%
s.fhtre.com,1,0.00%,2,1,50.00%
qzs.gdtimg.com,1,0.00%,2,1,50.00%
img.y.qq.com,1,0.00%,2,1,50.00%
images.nowcoder.com,1,0.00%,2,1,50.00%
api3-normal-c-lf.amemv.com,1,0.00%,2,1,50.00%
settings-ssl.xboxlive.com,1,0.00%,3,2,33.33%
img.da.mgtv.com,1,0.00%,2,1,50.00%
pub.idqqimg.com.sched.legopic1.tdnsv6.com,1,0.00%,2,1,50.00%
odc-bnz07pap001-meta-geo.onedrive.akadns.NET,1,0.00%,2,1,50.00%
odc-bnz07pap001-meta-brs.onedrive.akadns.NET,1,0.00%,2,1,50.00%
vectormap0.bdimg.com,1,0.00%,2,1,50.00%
x2.c.lencr.org,1,0.00%,29,28,3.45%
v5-httpdns.douyinvod.com,1,0.00%,2,1,50.00%
v96.douyinvod.com,1,0.00%,2,1,50.00%
apilocate.amap.com,1,0.00%,6,5,16.67%
v9.toutiaovod.com,1,0.00%,2,1,50.00%
video3.pddpic.com,1,0.00%,2,1,50.00%
img-1.pddpic.com,1,0.00%,2,1,50.00%
video-snapshot.pddpic.com,1,0.00%,2,1,50.00%
wos.anjukestatic.com,1,0.00%,2,1,50.00%
pic7.ajkimg.com,1,0.00%,2,1,50.00%
outlook.office365.com,1,0.00%,36,35,2.78%
xcxcdn.yangkeduo.com,1,0.00%,2,1,50.00%
t16img.yangkeduo.com,1,0.00%,2,1,50.00%
t12img.yangkeduo.com,1,0.00%,2,1,50.00%
pinduoduoimg.yangkeduo.com,1,0.00%,2,1,50.00%
t13img.yangkeduo.com,1,0.00%,2,1,50.00%
v3-default.365yg.com,1,0.00%,2,1,50.00%
v5-h.douyinvod.com,1,0.00%,2,1,50.00%
scc.bytedance.com,1,0.00%,2,1,50.00%
p4-live.a.yximgs.com,1,0.00%,2,1,50.00%
p4.a.yximgs.com,1,0.00%,2,1,50.00%
dorangesource.alicdn.com,1,0.00%,2,1,50.00%
mdike.alicdn.com,1,0.00%,2,1,50.00%
web.m.taobao.com,1,0.00%,2,1,50.00%
zconfig.alibabausercontent.com,1,0.00%,2,1,50.00%
heic.alicdn.com,1,0.00%,2,1,50.00%
zres.alicdn.com,1,0.00%,2,1,50.00%
h5.m.taobao.com,1,0.00%,2,1,50.00%
miniapp-package-zcache.taobao.com,1,0.00%,2,1,50.00%
frontier-aweme-lf-ipainner.amemv.com,1,0.00%,2,1,50.00%
applog.snssdk.com,1,0.00%,2,1,50.00%
huiji-thumb.huijistatic.com,1,0.00%,1,0,100.00%
gw2.huijiwiki.com,1,0.00%,1,0,100.00%
static-calendar-drcn.dbankcdn.cn,1,0.00%,2,1,50.00%
img-2.pddpic.com,1,0.00%,2,1,50.00%
pkg.biligame.com,1,0.00%,2,1,50.00%
www.qidian.com,1,0.00%,2,1,50.00%
magev6.if.qidian.com,1,0.00%,2,1,50.00%
v5-g.douyinvod.com,1,0.00%,2,1,50.00%
news.baidu.com,1,0.00%,4,3,25.00%
bag.itunes.apple.com,1,0.00%,53,52,1.89%
main.appstore.vivo.com.cn,1,0.00%,2,1,50.00%
contentcenter-drcn.dbankcdn.cn,1,0.00%,1,0,100.00%
prod-streaming-video-msn-com.akamaized.net,1,0.00%,2,1,50.00%
pushmis.bj.bcebos.com,1,0.00%,4,3,25.00%
e11408.d.akamaiedge.net,1,0.00%,2,1,50.00%
onedscolprdcus04.centralus.cloudapp.azure.com,1,0.00%,3,2,33.33%
router2.teamviewer.com,1,0.00%,67,66,1.49%
jmy-pic.baidu.com,1,0.00%,2,1,50.00%
m.hotmail.com,1,0.00%,14,13,7.14%
iris-de-prod-azsc-eas-b.eastasia.cloudapp.azure.com,1,0.00%,4,3,25.00%
d7kac1jd1i.feishu.cn,1,0.00%,2,1,50.00%
pub.idqqimg.com,1,0.00%,196,195,0.51%
mvgforumtracker.mvgroup.org,1,0.00%,90,89,1.11%
www.tribalmixes.com,1,0.00%,76,75,1.32%
t8.dropbox.com,1,0.00%,2,1,50.00%
i.meituan.com,1,0.00%,6,5,16.67%
thunderx.rcv.sandai.net,1,0.00%,28,27,3.57%
dss3.bdstatic.com,1,0.00%,3,2,33.33%
googlecn-lopri.l.google.com,1,0.00%,2,1,50.00%
onedriveclucproddm20008.blob.core.windows.net,1,0.00%,16,15,6.25%
api.stellarplayer.com.w.cdngslb.com,1,0.00%,4,3,25.00%
www.catererglobal.com,1,0.00%,1,0,100.00%
images-eu.ssl-images-amazon.com,1,0.00%,1,0,100.00%
www.gsd92gov.com,1,0.00%,10,9,10.00%
saascdn.lenovo.com.cn,1,0.00%,2,1,50.00%
fa000000064.resources.office.net,1,0.00%,2,1,50.00%
gtm-dyn-direct.office365.com,1,0.00%,2,1,50.00%
onedriveclucprodbn20024.blob.core.windows.net,1,0.00%,14,13,7.14%
catalog-public-service-prod.ak.epicgames.com,1,0.00%,2,1,50.00%
priceengine-public-service-prod.ak.epicgames.com,1,0.00%,2,1,50.00%
onedriveclucproddm20027.blob.core.windows.net,1,0.00%,9,8,11.11%
wd-prod-ss-as-southeast-3-fe.southeastasia.cloudapp.azure.com,1,0.00%,20,19,5.00%
download.iciba.com,1,0.00%,2,1,50.00%
cmts.iqiyi.com,1,0.00%,2,1,50.00%
ccdn.pddpic.com,1,0.00%,2,1,50.00%
video4.pddpic.com,1,0.00%,2,1,50.00%
www.hao123.com,1,0.00%,17,16,5.88%
1610057041.D4EE073C2A20.device.hiwifi.com,1,0.00%,1,0,100.00%
1610057067.D4EE073C2A20.device.hiwifi.com,1,0.00%,1,0,100.00%
1610057093.D4EE073C2A20.device.hiwifi.com,1,0.00%,1,0,100.00%
edu.hk,1,0.00%,1,0,100.00%
www.weibo.com,1,0.00%,19,18,5.26%
onedriveclucprodbn20045.blob.core.windows.net,1,0.00%,2,1,50.00%
ra.gtimg.com,1,0.00%,2,1,50.00%
www.liebao.cn.w.kunlunar.com,1,0.00%,2,1,50.00%
onedriveclucprodbn20049.blob.core.windows.net,1,0.00%,8,7,12.50%
api3-eeft-mixed-hl.feishu.cn,1,0.00%,2,1,50.00%
msg3-frontier-lf.feishu.cn,1,0.00%,2,1,50.00%
api3-eeft-security.feishu.cn,1,0.00%,2,1,50.00%
onedriveclucprodbn20030.blob.core.windows.net,1,0.00%,2,1,50.00%
socwxsns.video.qq.com,1,0.00%,2,1,50.00%
iduxi4y.qiniudns.com,1,0.00%,2,1,50.00%
a1834.dscg2.akamai.NET,1,0.00%,2,1,50.00%
onedriveclucproddm20044.blob.core.windows.net,1,0.00%,11,10,9.09%
onedriveclucprodbn20013.blob.core.windows.net,1,0.00%,5,4,20.00%
info.wps.cn,1,0.00%,33,32,3.03%
awsdns-00.co.uk,1,0.00%,1,0,100.00%
api.kylinos.cn,1,0.00%,13,12,7.69%
e6987.a.akamaiedge.net,1,0.00%,2,1,50.00%
onedriveclucprodbn20027.blob.core.windows.net,1,0.00%,2,1,50.00%
onedriveclucproddm20023.blob.core.windows.net,1,0.00%,14,13,7.14%
app.axure.cloud,1,0.00%,2,1,50.00%
emdl.ws.microsoft.com,1,0.00%,2,1,50.00%
kessel-ws.parsec.app,1,0.00%,2,1,50.00%
p59-caldav.icloud.com,1,0.00%,2,1,50.00%
gf9xlqa6wd.feishu.cn,1,0.00%,2,1,50.00%
2398.35go.net,1,0.00%,2,1,50.00%
softm.update.360safe.com,1,0.00%,26,25,3.85%
o.ss2.us,1,0.00%,2,1,50.00%
poonling.com,1,0.00%,1,0,100.00%
warcraftmagic.com,1,0.00%,1,0,100.00%
helpdubaservice.ksmobile.com,1,0.00%,10,9,10.00%
onesyamatome.site,1,0.00%,1,0,100.00%
www.nvidia.cn,1,0.00%,4,3,25.00%
res.dpsc.2387yx.com,1,0.00%,3,2,33.33%
joint.vivo.com.cn,1,0.00%,2,1,50.00%
storecatalogrevocation.storequality.microsoft.com.edgekey.NET,1,0.00%,1,0,100.00%
wd-prod-ss-as-southeast-1-fe.southeastasia.cloudapp.azure.com,1,0.00%,16,15,6.25%
ocsp2-cn-lb.apple.com.akadns.net,1,0.00%,2,1,50.00%
swcdn-china-lb.dl-apple.com.akadns.net,1,0.00%,2,1,50.00%
swcdn.apple.com.w.alikunlun.com,1,0.00%,2,1,50.00%
e6913.dscx.akamaiedge.net,1,0.00%,2,1,50.00%
conversions.appsflyer.com,1,0.00%,2,1,50.00%
a1961.g2.akamai.net.0.1.cn.akamaitech.net,1,0.00%,2,1,50.00%
onedscolprdeus11.eastus.cloudapp.azure.com,1,0.00%,6,5,16.67%
spoc.norton.com,1,0.00%,10,9,10.00%
onedscolprdwus14.westus.cloudapp.azure.com,1,0.00%,6,5,16.67%
sls.update.microsoft.com,1,0.00%,8,7,12.50%
jkbxcx-static.yqgz.beijing.gov.cn,1,0.00%,3,2,33.33%
xcx-static.yqgz.beijing.gov.cn,1,0.00%,3,2,33.33%
prod.detectportal.prod.cloudops.mozgcp.NET,1,0.00%,1,0,100.00%
ue.lenovomm.cn,1,0.00%,41,40,2.44%
image.ziroom.com,1,0.00%,2,1,50.00%
img.ziroom.com,1,0.00%,2,1,50.00%
nppbase.95516.com,1,0.00%,2,1,50.00%
antifraud.95516.com,1,0.00%,2,1,50.00%
hotpatch.95516.com,1,0.00%,2,1,50.00%
tech.c.citic,1,0.00%,2,1,50.00%
device.95516.com,1,0.00%,2,1,50.00%
imcs.citicbank.com,1,0.00%,2,1,50.00%
input.shouji.sogou.com,1,0.00%,21,20,4.76%
apis.map.qq.com,1,0.00%,6,5,16.67%
autoload.bank.ecitic.com,1,0.00%,2,1,50.00%
issuepcdn.baidupcs.com,1,0.00%,2,1,50.00%
alloyreport.cdn-go.cn,1,0.00%,2,1,50.00%
yccdn3.douyucdn2.cn,1,0.00%,2,1,50.00%
tc-tct.douyucdn2.cn,1,0.00%,2,1,50.00%
playweb.douyu.com,1,0.00%,2,1,50.00%
mobilep1.douyucdn2.cn,1,0.00%,2,1,50.00%
apmconfig.douyucdn.cn,1,0.00%,2,1,50.00%
yuba.douyu.com,1,0.00%,2,1,50.00%
dotcounter.douyucdn.cn,1,0.00%,2,1,50.00%
gift.douyucdn.cn,1,0.00%,2,1,50.00%
shark.douyucdn.cn,1,0.00%,2,1,50.00%
pslice.douyucdn.cn,1,0.00%,2,1,50.00%
a2047.dscb.akamai.net,1,0.00%,2,1,50.00%
uact.douyucdn.cn,1,0.00%,2,1,50.00%
dotab.douyucdn.cn,1,0.00%,2,1,50.00%
src.onlinedown.net,1,0.00%,2,1,50.00%
img.onlinedown.net,1,0.00%,2,1,50.00%
www.douyu.com,1,0.00%,2,1,50.00%
apm.douyucdn.cn,1,0.00%,2,1,50.00%
msg.douyu.com,1,0.00%,2,1,50.00%
img.douyucdn.cn,1,0.00%,2,1,50.00%
unpkg.com,1,0.00%,2,1,50.00%
weblog.cdn-go.cn,1,0.00%,2,1,50.00%
stun-h5.qvb.qcloud.com,1,0.00%,4,3,25.00%
docs.idqqimg.com,1,0.00%,2,1,50.00%
sg.pool.ntp.org,1,0.00%,2,1,50.00%
ns3.us.bitnames.com,1,0.00%,2,1,50.00%
gspe19-cn-ssl.ls-apple.com.akadns.net,1,0.00%,2,1,50.00%
internal-api-space.feishu.cn,1,0.00%,2,1,50.00%
dm.video.weibocdn.com,1,0.00%,3,2,33.33%
locallimit.us.sinaimg.cn,1,0.00%,2,1,50.00%
mapm.douyucdn.cn,1,0.00%,2,1,50.00%
i3.hoopchina.com.cn,1,0.00%,2,1,50.00%
img02.sogoucdn.com,1,0.00%,2,1,50.00%
g.alicdn.com.danuoyi.alicdn.com,1,0.00%,2,1,50.00%
fundin.douban.com,1,0.00%,2,1,50.00%
lf3-data.volccdn.com,1,0.00%,2,1,50.00%
opencdnbd.jomodns.com,1,0.00%,4,3,25.00%
s.symcb.com,1,0.00%,20,19,5.00%
pics1.baidu.com,1,0.00%,2,1,50.00%
pics4.baidu.com,1,0.00%,2,1,50.00%
pics6.baidu.com,1,0.00%,2,1,50.00%
ipcdn-lb.apple.com.akadns.net,1,0.00%,2,1,50.00%
registry.npmjs.org,1,0.00%,4,3,25.00%
cf.iadsdk.apple.com,1,0.00%,2,1,50.00%
partiality.itunes.apple.com,1,0.00%,2,1,50.00%
pc-store.lenovomm.cn,1,0.00%,20,19,5.00%
apps.mzstatic.com,1,0.00%,2,1,50.00%
play-china.itunes-apple.com.akadns.net,1,0.00%,2,1,50.00%
sf-api-token-service.itunes.apple.com,1,0.00%,2,1,50.00%
v3-x.douyinvod.com,1,0.00%,2,1,50.00%
onedriveclucproddm20003.blob.core.windows.net,1,0.00%,5,4,20.00%
update.evernote.com,1,0.00%,2,1,50.00%
picgalb.beisen.com,1,0.00%,2,1,50.00%
nv00.cdn.bcebos.com,1,0.00%,1,0,100.00%
tnc3-bjlgy.snssdk.com,1,0.00%,1,0,100.00%
downloads.hpanalytics.net,1,0.00%,2,1,50.00%
do.gw2.kongzhong.com,1,0.00%,1,0,100.00%
i1.go2yd.com,1,0.00%,1,0,100.00%
appimg.dbankcdn.com,1,0.00%,3,2,33.33%
feeds-drcn.dbankcdn.cn,1,0.00%,2,1,50.00%
hisearch-static-drcn.dbankcdn.com,1,0.00%,1,0,100.00%
stun1.qvb.qcloud.com,1,0.00%,2,1,50.00%
bytedance.feishu.cn,1,0.00%,2,1,50.00%
sub0btw.v4672.top,1,0.00%,2,1,50.00%
blob.dsz08prdstr08a.store.core.windows.NET,1,0.00%,4,3,25.00%
onedscolprdeus02.eastus.cloudapp.azure.com,1,0.00%,3,2,33.33%
init.ess.apple.com,1,0.00%,3,2,33.33%
init-p01md.apple.com,1,0.00%,2,1,50.00%
iosapps-tp.g.aaplimg.com,1,0.00%,2,1,50.00%
certs.apple.com,1,0.00%,2,1,50.00%
data.grammarly.com,1,0.00%,15,14,6.67%
p4.music.126.net.w.alikunlun.com,1,0.00%,2,1,50.00%
res.qhsetup.com,1,0.00%,2,1,50.00%
status.geotrust.com,1,0.00%,2,1,50.00%
cds.apple.com,1,0.00%,2,1,50.00%
common-geo.ha.1drv.com,1,0.00%,12,11,8.33%
wd-prod-ss-as-southeast-4-fe.southeastasia.cloudapp.azure.com,1,0.00%,26,25,3.85%
o4175vz27.qnssl.com,1,0.00%,2,1,50.00%
uci.cdn.office.net,1,0.00%,2,1,50.00%
preimage0.iqiyipic.com,1,0.00%,2,1,50.00%
archive.kylinos.cn,1,0.00%,2,1,50.00%
archive2.kylinos.cn,1,0.00%,2,1,50.00%
v6-default.365yg.com,1,0.00%,2,1,50.00%
ssl-google-analytics.l.google.com,1,0.00%,2,1,50.00%
services.googleapis.cn,1,0.00%,2,1,50.00%
ws2.cootekservice.com,1,0.00%,2,1,50.00%
gmscompliance-pa.googleapis.com,1,0.00%,2,1,50.00%
fgc0.market.xiaomi.com,1,0.00%,2,1,50.00%
soft2020.17rd.com,1,0.00%,2,1,50.00%
onedriveclucproddm20042.blob.core.windows.net,1,0.00%,8,7,12.50%
onedriveclucproddm20048.blob.core.windows.net,1,0.00%,4,3,25.00%
weread.qq.com,1,0.00%,3,2,33.33%
wfqqreader-1252317822.image.myqcloud.com,1,0.00%,1,0,100.00%
s.pc.qq.com,1,0.00%,1,0,100.00%
dynsrv.wps.cn,1,0.00%,33,32,3.03%
onedriveclucproddm20050.blob.core.windows.net,1,0.00%,2,1,50.00%
crl-symcprod.digicert.com,1,0.00%,2,1,50.00%
onedriveclucprodbn20044.blob.core.windows.net,1,0.00%,7,6,14.29%
tracker.loadbt.com,1,0.00%,2,1,50.00%
sf1-dycdn-tos.pstatp.com,1,0.00%,2,1,50.00%
onedriveclucprodbn20021.blob.core.windows.net,1,0.00%,8,7,12.50%
static-xl.a.88cdn.com.w.kunlungr.com,1,0.00%,2,1,50.00%
sitaspellrentals.com,1,0.00%,1,0,100.00%
sdup.qihucdn.com.qh-cdn.com,1,0.00%,2,1,50.00%
sdup.qihucdn.com.dl.360qhcdn.com,1,0.00%,2,1,50.00%
rainbowuganda.com,1,0.00%,1,0,100.00%
hub.docker.com,1,0.00%,3,2,33.33%
lostmxrider156.sexy,1,0.00%,1,0,100.00%
e12437.d.akamaiedge.net,1,0.00%,2,1,50.00%
android.l.google.com,1,0.00%,2,1,50.00%
steam-chat.com,1,0.00%,2,1,50.00%
sslhotpcs.jomodns.com,1,0.00%,2,1,50.00%
star.c10r.facebook.com,1,0.00%,2,1,50.00%
game.haydaygame.com,1,0.00%,2,1,50.00%
qzs.tc.qq.com,1,0.00%,2,1,50.00%
qzs.qq.com.sched.legopic2-dk.tdnsv6.com,1,0.00%,2,1,50.00%
qzs.qq.com.sched.legopic2-dk.tdnsv6.com.tpic.vwnti.yrzhcloud.cn,1,0.00%,2,1,50.00%
vd4.bdstatic.com,1,0.00%,2,1,50.00%
paimgcdn-feed.baidu.com,1,0.00%,2,1,50.00%
netmon-control.dropbox.com,1,0.00%,1,0,100.00%
assets.nvidiagrid.net,1,0.00%,1,0,100.00%
www.rhhz.net,1,0.00%,2,1,50.00%
minipkg.dingtalk.com,1,0.00%,4,3,25.00%
softwareupdate.vmware.com,1,0.00%,2,1,50.00%
p3-passport.byteacctimg.com,1,0.00%,1,0,100.00%
p9-passport.byteacctimg.com,1,0.00%,1,0,100.00%
ocsp2.globalsign.com,1,0.00%,2,1,50.00%
client-api.itunes.apple.com,1,0.00%,3,2,33.33%
repo.zotero.org,1,0.00%,2,1,50.00%
gameplayapi.intel.com,1,0.00%,2,1,50.00%
scholar.google.com,1,0.00%,4,3,25.00%
img.ljcdn.com,1,0.00%,3,2,33.33%
gw.alicdn.com.danuoyi.tbcache.com,1,0.00%,2,1,50.00%
488928.sched.skalego-dk.tdnsstic1.cn,1,0.00%,2,1,50.00%
qimg.xiaohongshu.com,1,0.00%,2,1,50.00%
mam6.ntes53.netease.com,1,0.00%,1,0,100.00%
d4.music.126.net,1,0.00%,2,1,50.00%
api2.music.163.com,1,0.00%,2,1,50.00%
mp.music.163.com,1,0.00%,2,1,50.00%
s7.music.126.net,1,0.00%,2,1,50.00%
img7.file.cache.docer.com,1,0.00%,3,2,33.33%
img8.file.cache.docer.com,1,0.00%,2,1,50.00%
vodkgeyttp8.vod.126.net,1,0.00%,2,1,50.00%
pingma.qq.com,1,0.00%,4,3,25.00%
augmentation.osi.officeppe.net,1,0.00%,2,1,50.00%
e6987.dsce9.akamaiedge.net,1,0.00%,2,1,50.00%
minisite.zhhainiao.com,1,0.00%,1,0,100.00%
v6.toutiaovod.com,1,0.00%,2,1,50.00%
v26-ipv6.toutiaovod.com.c.cdnhwc1.com,1,0.00%,2,1,50.00%
down-cdn.dingtalk.com,1,0.00%,2,1,50.00%
tianshu.gtimg.cn,1,0.00%,3,2,33.33%
ins-59d1h3tv.ias.tencent-cloud.net,1,0.00%,2,1,50.00%
cdn.wetest.qq.com,1,0.00%,2,1,50.00%
i.thsi.cn,1,0.00%,2,1,50.00%
map-mobile-opnimg.cdn.bcebos.com,1,0.00%,2,1,50.00%
y.gtimg.cn.sched.ssd.tdnsv6.com,1,0.00%,2,1,50.00%
v6-x.douyinvod.com,1,0.00%,3,2,33.33%
go.microsoft.com.edgekey.NET,1,0.00%,2,1,50.00%
wegame.gtimg.com,1,0.00%,2,1,50.00%
vdn5-1.vzuu.com,1,0.00%,2,1,50.00%
vdn.vzuu.com,1,0.00%,2,1,50.00%
vdn6-1.vzuu.com,1,0.00%,2,1,50.00%
vdn5.vzuu.com,1,0.00%,2,1,50.00%
capi.samsungcloud.com,1,0.00%,2,1,50.00%
tracker.birkenwald.de,1,0.00%,1,0,100.00%
appdl-11-drcn.dbankcdn.com,1,0.00%,4,3,25.00%
appdl-12-drcn.dbankcdn.com,1,0.00%,4,3,25.00%
cdn.experiment.xiaomi.com,1,0.00%,6,5,16.67%
file.dingtalk.com,1,0.00%,2,1,50.00%
mdp-appconf-cn.heytapdownload.com,1,0.00%,11,10,9.09%
gss0.baidu.com,1,0.00%,2,1,50.00%
cfg-2.pddpic.com,1,0.00%,2,1,50.00%
v26-cold.douyinvod.com,1,0.00%,4,3,25.00%
mssdk-bu.snssdk.com,1,0.00%,3,2,33.33%
xmaterial.tu.qq.com,1,0.00%,2,1,50.00%
s3gw.cmbimg.com,1,0.00%,2,1,50.00%
webst03.is.autonavi.com,1,0.00%,1,0,100.00%
webst02.is.autonavi.com,1,0.00%,1,0,100.00%
webst01.is.autonavi.com,1,0.00%,1,0,100.00%
webst04.is.autonavi.com,1,0.00%,1,0,100.00%
pz.w7q.net,1,0.00%,2,1,50.00%
upos-sz-mirrorhwb.bilivideo.com,1,0.00%,2,1,50.00%
download.proxmox.com,1,0.00%,2,1,50.00%
6.npupt.com,1,0.00%,1,0,100.00%
4.npupt.com,1,0.00%,1,0,100.00%
awsdns-42.org,1,0.00%,1,0,100.00%
ap1-ipv6.agora.io,1,0.00%,1,0,100.00%
onedscolprdeus10.eastus.cloudapp.azure.com,1,0.00%,3,2,33.33%
settings-prod-wus2-2.westus2.cloudapp.azure.com,1,0.00%,2,1,50.00%
liveupdate7.drivergenius.com,1,0.00%,1,0,100.00%
down4.7654.com,1,0.00%,2,1,50.00%
m701.music.126.net.w.alikunlun.com,1,0.00%,2,1,50.00%
dsp.lenovo.com.cn.trpcdn.NET,1,0.00%,2,1,50.00%
hotfix.lenovo.com.cn.trpcdn.NET,1,0.00%,2,1,50.00%
fa000000054.resources.office.net,1,0.00%,2,1,50.00%
entitlement-public-service-prod.ak.epicgames.com,1,0.00%,2,1,50.00%
wifi.www.duba.net,1,0.00%,2,1,50.00%
rc10-g5.oray.com,1,0.00%,2,1,50.00%
15min.pcfg.cache.wpscdn.cn,1,0.00%,1,0,100.00%
wallpaperm.cmcm.com.c.cdnhwc1.com,1,0.00%,2,1,50.00%
hcdnd101.gslb.v6.c.cdnhwc2.com,1,0.00%,2,1,50.00%
ib-lq.snssdk.com,1,0.00%,2,1,50.00%
0bfc822c.islide.cc.0bfc822c.c.cdnhwc1.com,1,0.00%,2,1,50.00%
hcdnwsad.gslb.c.cdnhwc2.com,1,0.00%,2,1,50.00%
v13-a.bdxiguavod.com,1,0.00%,2,1,50.00%
lf6-vccdn.ndcpp.com,1,0.00%,2,1,50.00%
v9.bdxiguavod.com,1,0.00%,2,1,50.00%
lf9-vccdn.ndcpp.com,1,0.00%,2,1,50.00%
v3.bdxiguavod.com,1,0.00%,2,1,50.00%
down3.huorong.cn.c.cdnhwc1.com,1,0.00%,2,1,50.00%
statres.quickapp.cn,1,0.00%,2,1,50.00%
onedriveclucprodbn20026.blob.core.windows.net,1,0.00%,4,3,25.00%
bg6.market.xiaomi.com,1,0.00%,2,1,50.00%
oauthaccountmanager.googleapis.com,1,0.00%,2,1,50.00%
s19.upd.kaspersky.com,1,0.00%,2,1,50.00%
onedriveclucprodbn20046.blob.core.windows.net,1,0.00%,2,1,50.00%
dl.pop.www.duba.net.w.kunlunar.com,1,0.00%,2,1,50.00%
2535-ipv4e.clump.dprodmgd106.aa-rt.sharepoint.com,1,0.00%,43,42,2.33%
gce-beacons.gcp.gvt2.com,1,0.00%,2,1,50.00%
onedriveclucprodbn20037.blob.core.windows.net,1,0.00%,2,1,50.00%
onedriveclucproddm20011.blob.core.windows.net,1,0.00%,2,1,50.00%
typora.io,1,0.00%,2,1,50.00%
w278o2k77x.feishu.cn,1,0.00%,2,1,50.00%
open.xxtor.com,1,0.00%,2,1,50.00%
cds-temp.apple.com.akadns.net,1,0.00%,2,1,50.00%
nibba.trade,1,0.00%,1,0,100.00%
usage.projectcalico.org,1,0.00%,3,2,33.33%
newmail.guazi-corp.com,1,0.00%,1,0,100.00%
ks.push.yximgs.com,1,0.00%,2,1,50.00%
prod.balrog.prod.cloudops.mozgcp.NET,1,0.00%,3,2,33.33%
bt8mhsny.eia0.net,1,0.00%,2,1,50.00%
pqv834mb.eia0.net,1,0.00%,2,1,50.00%
g9rs8azf.eia0.net,1,0.00%,2,1,50.00%
mocafactory.shop,1,0.00%,1,0,100.00%
shop,1,0.00%,1,0,100.00%
all.feishu.cn.w.kunluncan.com,1,0.00%,2,1,50.00%
e7479.g.akamaiedge.net,1,0.00%,2,1,50.00%
win-crashdump-upload-1255554080.cos.ap-beijing.myqcloud.com,1,0.00%,3,2,33.33%
intel11.cn.edgekey.NET,1,0.00%,2,1,50.00%
scrootca1.ocsp.secomtrust.net,1,0.00%,2,1,50.00%
a1184.b.akamai.net,1,0.00%,2,1,50.00%
d2fashanjl7d9f.cloudfront.net,1,0.00%,1,0,100.00%
crls.pki.goog,1,0.00%,2,1,50.00%
stats.l.doubleclick.net,1,0.00%,2,1,50.00%
smartdl.lenovo.com.cn.trpcdn.net,1,0.00%,2,1,50.00%
zmptxy.v.trpcdn.net,1,0.00%,2,1,50.00%
dsp.lenovo.com.cn.trpcdn.net,1,0.00%,2,1,50.00%
s0-2mdn-net.l.google.com,1,0.00%,2,1,50.00%
sync.sharethis.com,1,0.00%,2,1,50.00%
dcldshlupt.alicdn.com.danuoyi.tbcache.com,1,0.00%,2,1,50.00%
httplogserver-lb.global.unified-prod.sharethis.net,1,0.00%,2,1,50.00%
wmgp-update.wmupd.com,1,0.00%,2,1,50.00%
wmgp-update.wmupd.com.w.alikunlun.com,1,0.00%,2,1,50.00%
ip1.ads.stickyadstv.com.akadns.net,1,0.00%,2,1,50.00%
ip2.ads.stickyadstv.com.akadns.net,1,0.00%,2,1,50.00%
hectorstatic.baidu.com.a.bdydns.com,1,0.00%,2,1,50.00%
t7.baidu.com.a.bdydns.com,1,0.00%,2,1,50.00%
t9.baidu.com.a.bdydns.com,1,0.00%,2,1,50.00%
opencdnbdcharon.jomodns.com,1,0.00%,2,1,50.00%
cache.betweendigital.com,1,0.00%,2,1,50.00%
global.prd.cdn.globalsign.com,1,0.00%,2,1,50.00%
cn-ice.360yield.com,1,0.00%,1,0,100.00%
sz-qiniu-all.volcgtm.com,1,0.00%,2,1,50.00%
pss.bdstatic.com.a.bdydns.com,1,0.00%,2,1,50.00%
e8960.e2.akamaiedge.net,1,0.00%,2,1,50.00%
d1jm6n7utzqv3r.cloudfront.cn,1,0.00%,2,1,50.00%
eus.rubiconproject.com.edgekey.net,1,0.00%,2,1,50.00%
e8960.b.akamaiedge.net,1,0.00%,2,1,50.00%
e7695.dscg.akamaiedge.net,1,0.00%,2,1,50.00%
beacons-handoff.gcp.gvt2.com,1,0.00%,2,1,50.00%
dbe610da.feishu.cn.dsa.dnsv1.com,1,0.00%,2,1,50.00%
be01mr9s.sched.d2.tdnsdp1.cn.cjt.vwnti.yrzhcloud.cn,1,0.00%,2,1,50.00%
sync.ipredictive.com,1,0.00%,2,1,50.00%
a1768.g1.akamai.net,1,0.00%,2,1,50.00%
a1843.g1.akamai.net,1,0.00%,2,1,50.00%
browser.360.cn.qh-cdn.com,1,0.00%,2,1,50.00%
browser.360.cn.download.ks-cdn.com,1,0.00%,2,1,50.00%
skconf.f.qh-lb.com,1,0.00%,2,1,50.00%
reswx.mid.tdnsv6.com,1,0.00%,2,1,50.00%
res.wx.qq.com.sched.legopic1-dk.tdnsv6.com,1,0.00%,2,1,50.00%
pc-plugin-plg-wpscdn-cn-idvh11c.qiniudns.com,1,0.00%,2,1,50.00%
chinaweb292.china.line.qiniudns.com,1,0.00%,2,1,50.00%
s.safe.360.cn.qh-cdn.com,1,0.00%,2,1,50.00%
img-all.qiniu.com.volcgslb.com,1,0.00%,2,1,50.00%
s.safe.360.cn.s.galileo.jcloud-cdn.com,1,0.00%,4,3,25.00%
twd.f.360.cn,1,0.00%,2,1,50.00%
cc.f.360.cn,1,0.00%,2,1,50.00%
v26-litea.douyinvod.com,1,0.00%,2,1,50.00%
grs.platform.dbankcloud.ru,1,0.00%,2,1,50.00%
s-0005-office.config.skype.com,1,0.00%,2,1,50.00%
ns-122.awsdns-15.com,1,0.00%,2,1,50.00%
public.qn.ivybaby.me,1,0.00%,2,1,50.00%
dl1.gj.qq.com,1,0.00%,2,1,50.00%
ags.privatelink.msidentity.com,1,0.00%,2,1,50.00%
img2.360buyimg.com,1,0.00%,2,1,50.00%
vfiles.gtimg.cn,1,0.00%,2,1,50.00%
dsm01pcor004-com.be.1drv.com,1,0.00%,2,1,50.00%
valid.origin-apple.com.akadns.net,1,0.00%,2,1,50.00%
download.dmallcdn.com,1,0.00%,2,1,50.00%
fast-static.dmallcdn.com,1,0.00%,2,1,50.00%
p2.img.360kuai.com,1,0.00%,2,1,50.00%
p1.img.360kuai.com,1,0.00%,2,1,50.00%
p5.img.360kuai.com,1,0.00%,2,1,50.00%
p0.img.360kuai.com,1,0.00%,2,1,50.00%
img.dmallcdn.com,1,0.00%,2,1,50.00%
access.clarivate.com,1,0.00%,2,1,50.00%
aapl-edge0.qtlcdn.com,1,0.00%,2,1,50.00%
apps.apple.com.cdn30.com,1,0.00%,2,1,50.00%
render.alipay.com,1,0.00%,2,1,50.00%
www.downza.cn,1,0.00%,2,1,50.00%
img3.downza.cn,1,0.00%,2,1,50.00%
downza1.zz314.njxzwh.com,1,0.00%,2,1,50.00%
webpage.qidian.qq.com,1,0.00%,2,1,50.00%
bqq.gtimg.com,1,0.00%,2,1,50.00%
show.bilibili.com,1,0.00%,2,1,50.00%
s3.pstatp.com,1,0.00%,2,1,50.00%
v6.douyinvod.com,1,0.00%,2,1,50.00%
v6-cold.douyinvod.com,1,0.00%,2,1,50.00%
wenk.ios.wpscdn.cn,1,0.00%,2,1,50.00%
static.cninfo.com.cn,1,0.00%,2,1,50.00%
e105182.a.akamaiedge.net,1,0.00%,4,3,25.00%
m15.360buyimg.com,1,0.00%,3,2,33.33%
metadata.templates.cdn.office.net,1,0.00%,4,3,25.00%
csdn.log-global.aliyuncs.com.w.cdngslb.com,1,0.00%,2,1,50.00%
gspe79-cn-ssl.ls.apple.com,1,0.00%,3,2,33.33%
googleads4.g.doubleclick.net,1,0.00%,2,1,50.00%
id.google.com.hk,1,0.00%,1,0,100.00%
all.cnzz.com.danuoyi.tbcache.com,1,0.00%,2,1,50.00%
www-cdn.icloud.com.akadns.net,1,0.00%,9,8,11.11%
offlinebeijing-bj.st.vip.sankuai.com,1,0.00%,1,0,100.00%
vod.300hu.com,1,0.00%,2,1,50.00%
stable.pay.st.sankuai.com,1,0.00%,1,0,100.00%
iadsdk.apple.com,1,0.00%,2,1,50.00%
s2.zimgs.cn,1,0.00%,2,1,50.00%
cdn.sm.cn,1,0.00%,2,1,50.00%
huichuan-mc.sm.cn,1,0.00%,2,1,50.00%
magpie.xhscdn.com,1,0.00%,2,1,50.00%
log-api.pangolin-sdk-toutiao-b.com,1,0.00%,2,1,50.00%
editor.sm.cn,1,0.00%,2,1,50.00%
nbsdk-baichuan.alicdn.com,1,0.00%,2,1,50.00%
hcadv.video.ums.uc.cn,1,0.00%,2,1,50.00%
vali.cp31.ott.cibntv.net,1,0.00%,2,1,50.00%
kkimgs.yisou.com,1,0.00%,2,1,50.00%
souti-ims.sm.cn,1,0.00%,2,1,50.00%
sm01.alicdn.com,1,0.00%,2,1,50.00%
mipstatic.sm-tc.cn,1,0.00%,2,1,50.00%
d.alicdn.com,1,0.00%,2,1,50.00%
resource.chunyu.mobi,1,0.00%,2,1,50.00%
page.sm.cn,1,0.00%,2,1,50.00%
file.bohe.cn,1,0.00%,2,1,50.00%
static.shezhan88.com,1,0.00%,2,1,50.00%
static.bohe.cn,1,0.00%,2,1,50.00%
extie.sogoucdn.com,1,0.00%,2,1,50.00%
t2-xhs-new-vpc-ipv6-2022140793.cn-north-1.elb.amazonaws.com.cn,1,0.00%,2,1,50.00%
dca-policy-service.us-west-1.elasticbeanstalk.com,1,0.00%,2,1,50.00%
www.apple.com.edgekey.net,1,0.00%,2,1,50.00%
pull-flv-l3-encryption.douyincdn.com.w.alikunlun.net,1,0.00%,2,1,50.00%
push-rtmp-vr-l6.douyincdn.com.upvcloud.ks-cdn.com,1,0.00%,3,2,33.33%
pull-hls-f26.douyincdn.com.c.cdnhwc1.com,1,0.00%,2,1,50.00%
pull-rtmp-f96.douyincdn.com.d.live.cdn.chinamobile.com,1,0.00%,3,2,33.33%
pull-rtmp-f13.douyincdn.com.a.bcelive.com,1,0.00%,3,2,33.33%
pull-hls-f11.douyincdn.com.tcdnlive.com,1,0.00%,2,1,50.00%
pull-flv-vr-l1.douyincdn.com.wsdvs.com,1,0.00%,2,1,50.00%
pull-f5-hs.pstatp.com.c.bytefcdn.com,1,0.00%,2,1,50.00%
push-rtmp-hs-spe-f5.douyincdn.com.c.volcfcdndvs.com,1,0.00%,3,2,33.33%
push-rtmp-l6-enc.douyincdn.com.upvcloud.ks-cdn.com,1,0.00%,2,1,50.00%
push-rtmp-f5.ihuoshanlive.com.c.volcfcdndvs.com,1,0.00%,2,1,50.00%
pull-rtmp-l1-hs.pstatp.com.wsdvs.com,1,0.00%,3,2,33.33%
pull-hs-f5.flive.huoshanlive.com.c.volcfcdndvs.com,1,0.00%,2,1,50.00%
pull-hs-f5.flive.ihuoshanlive.com.c.volcfcdndvs.com,1,0.00%,2,1,50.00%
pull-hls-vr-l1.douyincdn.com.wsdvs.com,1,0.00%,2,1,50.00%
pull-hls-vr-l26.douyincdn.com.c.cdnhwc3.com,1,0.00%,2,1,50.00%
pull-hls-spe-l6.douyincdn.com.hlsvcloud.ks-cdn.com,1,0.00%,2,1,50.00%
u01-ml.gslb.ksyuncdn.com,1,0.00%,2,1,50.00%
pull-flv-spe-l6.douyincdn.com.hdlvcloud.ks-cdn.com,1,0.00%,2,1,50.00%
pull-flv-vr-l26.douyincdn.com.c.cdnhwc3.com,1,0.00%,2,1,50.00%
u104-ml.gslb.ksyuncdn.com,1,0.00%,2,1,50.00%
pull-f5.douyincdn.com.c.bytefcdn.com,1,0.00%,2,1,50.00%
pull-rtmp-f1.douyincdn.com.wsdvs.com,1,0.00%,2,1,50.00%
pull-rtmp-l1.ixigua.com.wsdvs.com,1,0.00%,2,1,50.00%
pull-hls-spe-l11.douyincdn.com.sched.l9.tdnsv5.com,1,0.00%,2,1,50.00%
pull-flv-l13.douyincdn.com.a.bcelive.com,1,0.00%,2,1,50.00%
pull-rtmp-l26-cny.douyincdn.com.c.cdnhwc3.com,1,0.00%,2,1,50.00%
pull-rtmp-l11-cny.douyincdn.com.tcdnlive.com,1,0.00%,2,1,50.00%
push-rtmp-l1.douyincdn.com.wsdvs.com,1,0.00%,2,1,50.00%
pull-rtmp-l11.douyincdn.com.livecdn.liveplay.myqcloud.com,1,0.00%,2,1,50.00%
pull-f3-proxy.douyincdn.com.w.alikunlun.net,1,0.00%,2,1,50.00%
pull-rtmp-l1-source.douyincdn.com.wsdvs.com,1,0.00%,2,1,50.00%
pull-hls-hs-f5-tsl.douyincdn.com.bytedns1.com,1,0.00%,2,1,50.00%
s6130-ml.gslb.ksyuncdn.com,1,0.00%,2,1,50.00%
pull-flv-l11-encryption.douyincdn.com.tcdnlive.com,1,0.00%,2,1,50.00%
pull-tsl-vr-l26.douyincdn.com.51296c5e.c.cdnhwc1.com,1,0.00%,3,2,33.33%
s03-ml.gslb.ksyuncdn.com,1,0.00%,2,1,50.00%
pull-flv-f13.douyincdn.com.a.bcelive.com,1,0.00%,2,1,50.00%
pull-rtmp-l13.douyincdn.com.a.bcelive.com,1,0.00%,2,1,50.00%
pull-hls-spe-l26.douyincdn.com.c.cdnhwc3.com,1,0.00%,2,1,50.00%
push-rtmp-hs-f5.huoshanlive.com.c.volcfcdndvs.com,1,0.00%,3,2,33.33%
push-rtmp-l26.douyincdn.com.c.cdnhwc3.com,1,0.00%,2,1,50.00%
pull-flv-f26-proxy.douyincdn.com.c.cdnhwc3.com,1,0.00%,2,1,50.00%
pull-tsl-vr-l6.douyincdn.com.hlsvcloud.ks-cdn.com,1,0.00%,2,1,50.00%
push-rtmp-l1-cny.douyincdn.com.wsdvs.com,1,0.00%,2,1,50.00%
pull-tsl-l3.douyincdn.com.w.alikunlun.net,1,0.00%,2,1,50.00%
push-rtmp-l3-encryption.douyincdn.com.w.kunlunso.com,1,0.00%,2,1,50.00%
pull-flv-l6-enc.douyincdn.com.hdlvcloud.ks-cdn.com,1,0.00%,2,1,50.00%
webrtc.liveplay.myqcloud.com,1,0.00%,2,1,50.00%
pull-flv-f6.douyincdn.com.hdlvcloud.ks-cdn.com,1,0.00%,2,1,50.00%
v6-x.douyinvod.com.download.ks-cdn.com,1,0.00%,2,1,50.00%
push-rtmp-l3-cny.douyincdn.com.w.kunlunso.com,1,0.00%,2,1,50.00%
pull-flv-l11.douyincdn.com.sched.l10.tdnsv5.com,1,0.00%,2,1,50.00%
pull-l3.douyincdn.com.w.alikunlun.net,1,0.00%,2,1,50.00%
pull-hs-f5-encryption.flive.douyincdn.com.c.volcfcdndvs.com,1,0.00%,2,1,50.00%
pull-flv-l1-cny.douyincdn.com.wsdvs.com,1,0.00%,2,1,50.00%
push-rtmp-l11.douyincdn.com.livepush.myqcloud.com,1,0.00%,2,1,50.00%
pull-flv-l6-encryption.douyincdn.com.hdlvcloud.ks-cdn.com,1,0.00%,2,1,50.00%
pull-flv-f11.douyincdn.com.sched.l8.tdnsv5.com,1,0.00%,2,1,50.00%
pull-flv-l1-source.douyincdn.com.wsdvs.com,1,0.00%,2,1,50.00%
pull-hls-f6.douyincdn.com.hlsvcloud.ks-cdn.com,1,0.00%,2,1,50.00%
pull-flv-spe-l11.douyincdn.com.sched.l9.tdnsv5.com,1,0.00%,2,1,50.00%
pull-l3-cny.douyincdn.com.w.alikunlun.com,1,0.00%,2,1,50.00%
pull-lls-spe-l1.douyincdn.com.wsdvs.com,1,0.00%,2,1,50.00%
push-rtmp-l13.douyincdn.com.b.bcelive.com,1,0.00%,2,1,50.00%
push-rtmp-hs-f5.douyincdn.com.c.volcfcdndvs.com,1,0.00%,2,1,50.00%
push-rtmp-vr-l26.douyincdn.com.c.cdnhwc3.com,1,0.00%,2,1,50.00%
pull-hls-f1.douyincdn.com.wsdvs.com,1,0.00%,2,1,50.00%
pull-hs-f5.flive.douyincdn.com.c.volcfcdndvs.com,1,0.00%,2,1,50.00%
pull-rtmp-l29.douyincdn.com.ucloud.com.cn,1,0.00%,2,1,50.00%
2852517.sched.v1lego.tdnsvod1.cn,1,0.00%,2,1,50.00%
pull-tsl-spe-l3.douyincdn.com.bytedns1.com,1,0.00%,2,1,50.00%
pull-rtmp-f11.douyincdn.com.tcdnlive.com,1,0.00%,2,1,50.00%
pull-spe-l3.douyincdn.com.230b2a2545cfa773.queniucf.com,1,0.00%,2,1,50.00%
push-rtmp-vr-l1.douyincdn.com.wsdvs.com,1,0.00%,2,1,50.00%
push-rtmp-l3.douyincdn.com.w.kunlunso.com,1,0.00%,2,1,50.00%
pull-vr-l3.douyincdn.com.230b2a2545cfa773.queniucf.com,1,0.00%,2,1,50.00%
push-rtmp-spe-l26.douyincdn.com.c.cdnhwc3.com,1,0.00%,2,1,50.00%
pull-flv-l1.douyincdn.com.gccdn.net,1,0.00%,2,1,50.00%
push-rtmp-hs-vr-f5.douyincdn.com.c.volcfcdndvs.com,1,0.00%,2,1,50.00%
push-rtmp-l3-enc.douyincdn.com.w.kunlunso.com,1,0.00%,2,1,50.00%
pull-flv-f1-hs.pstatp.com.wsdvs.com,1,0.00%,2,1,50.00%
push-rtmp-l6-encryption.douyincdn.com.upvcloud.ks-cdn.com,1,0.00%,2,1,50.00%
pull-f3.douyincdn.com.m.alikunlun.net,1,0.00%,2,1,50.00%
pull-flv-l26-cny.douyincdn.com.c.cdnhwc3.com,1,0.00%,2,1,50.00%
push-rtmp-spe-l1.douyincdn.com.wsdvs.com,1,0.00%,2,1,50.00%
push-rtmp-l3-hs.pstatp.com.w.kunlunso.com,1,0.00%,2,1,50.00%
pull-hls-f5-tsl.douyincdn.com.w.cdngslb.com,1,0.00%,2,1,50.00%
s6120-ml.gslb.ksyuncdn.com,1,0.00%,2,1,50.00%
push-rtmp-l11-encryption.douyincdn.com.tlivepush.com,1,0.00%,2,1,50.00%
pull-hls-f5-vs-tsl.douyincdn.com.w.kunluncan.com,1,0.00%,2,1,50.00%
pull-rtmp-f26.douyincdn.com.c.cdnhwc3.com,1,0.00%,2,1,50.00%
pull-hls-f96.douyincdn.com.d.live.cdn.chinamobile.com,1,0.00%,2,1,50.00%
pull-lls-spe-l3.douyincdn.com.230b2a2545cfa773.queniucf.com,1,0.00%,2,1,50.00%
push-rtmp-f5-enc.douyincdn.com.c.bytefcdn.com,1,0.00%,2,1,50.00%
pull-hls-vr-l11.douyincdn.com.tlivecdn.com,1,0.00%,2,1,50.00%
pull-flv-l1-hs.pstatp.com.wsdvs.com,1,0.00%,2,1,50.00%
pull-flv-vr-l11.douyincdn.com.tlivecdn.com,1,0.00%,2,1,50.00%
pull-lls-spe-l6.douyincdn.com.hdlvcloud.ks-cdn.com,1,0.00%,2,1,50.00%
pull-tsl-spe-l26.douyincdn.com.51296c5e.c.cdnhwc1.com,1,0.00%,2,1,50.00%
pull-rtmp-f1-hs.pstatp.com.wsdvs.com,1,0.00%,2,1,50.00%
pull-l3-source.douyincdn.com.w.cdngslb.com,1,0.00%,2,1,50.00%
pull-flv-spe-l26.douyincdn.com.c.cdnhwc3.com,1,0.00%,2,1,50.00%
pull-lls-l3.douyincdn.com.w.cdngslb.com,1,0.00%,2,1,50.00%
pull-rtmp-l1-cny.douyincdn.com.wsdvs.com,1,0.00%,2,1,50.00%
pull-hs-spe-f5.douyincdn.com.c.volcfcdndvs.com,1,0.00%,2,1,50.00%
fgb0.market.xiaomi.com,1,0.00%,2,1,50.00%
ims.windy.com,1,0.00%,2,1,50.00%
pc-index-skin.cdn.bcebos.com,1,0.00%,2,1,50.00%
cu-cn-north00002.gala.convection.cn,1,0.00%,2,1,50.00%
06u-u492b3ee0-c48-a1d49-s1661320863-i9fe25f48-0.ap.dotnxdomain.net,1,0.00%,1,0,100.00%
26u-u492b3ee0-c48-a1d49-s1661320863-i9fe25f48-0.ap.dotnxdomain.net,1,0.00%,1,0,100.00%
prod.configsvc1.live.com.akadns.NET,1,0.00%,2,1,50.00%
v3-z.douyinvod.com.w.cdngslb.com,1,0.00%,2,1,50.00%
bossaudioandcomic-1252317822.image.myqcloud.com,1,0.00%,2,1,50.00%
bookcover.yuewen.com,1,0.00%,2,1,50.00%
qidian.qpic.cn,1,0.00%,2,1,50.00%
graphql.sketch.cloud,1,0.00%,2,1,50.00%
lastpass.com,1,0.00%,2,1,50.00%
webdoc.lenovo.com.cn,1,0.00%,2,1,50.00%
www.wikiwand.com,1,0.00%,2,1,50.00%
ffconf.ecbsn.com,1,0.00%,2,1,50.00%
cdn.optimizely.com,1,0.00%,1,0,100.00%
circlevideo2.photo.qq.com,1,0.00%,2,1,50.00%
onedriveclucprodbn20005.blob.core.windows.net,1,0.00%,3,2,33.33%
mirrors.aliyun.com.w.alikunlun.com,1,0.00%,2,1,50.00%
downloads.upd.kaspersky.com,1,0.00%,2,1,50.00%
wvcfg.alicdn.com,1,0.00%,2,1,50.00%
image.mybank.icbc.com.cn,1,0.00%,2,1,50.00%
tx-livemate.pull.yximgs.com,1,0.00%,2,1,50.00%
tx-dwk.pull.yximgs.com,1,0.00%,2,1,50.00%
tx-kmpaudio.pull.yximgs.com,1,0.00%,2,1,50.00%
tx2.a.yximgs.com,1,0.00%,2,1,50.00%
tx-game.pull.yximgs.com,1,0.00%,2,1,50.00%
tx-adaptive.pull.yximgs.com,1,0.00%,2,1,50.00%
baidu.cansz.com,1,0.00%,4,3,25.00%
estudy.cnki.net,1,0.00%,2,1,50.00%
dsm01pcor007-meta.fe.1drv.com,1,0.00%,2,1,50.00%
discovery.razerapi.com,1,0.00%,2,1,50.00%
manifest.razerapi.com,1,0.00%,2,1,50.00%
jiu.linyeming.pub,1,0.00%,1,0,100.00%
ns3.gdnsec.com,1,0.00%,2,1,50.00%
ns9.gdnsec.com,1,0.00%,2,1,50.00%
use-2.config.skype.com,1,0.00%,2,1,50.00%
a2pssl-drcn.dbankcdn.cn,1,0.00%,3,2,33.33%
cn-bing-com.cn.a-0001.a-msedge.NET,1,0.00%,2,1,50.00%
infoc2.duba.NET,1,0.00%,2,1,50.00%
launcher-public-service-prod.ak.epicgames.com,1,0.00%,2,1,50.00%
autoupdate.geo.opera.com,1,0.00%,2,1,50.00%
wallpaper-redirect-api.cqttech.com,1,0.00%,3,2,33.33%
ldc-fast.lenovo.com.cn.trpcdn.NET,1,0.00%,2,1,50.00%
v3-l.bdxiguavod.com,1,0.00%,2,1,50.00%
na61-na62.wagbridge.alibaba.alibaba.com,1,0.00%,2,1,50.00%
odc-commonafdrk-brs.onedrive.akadns.NET,1,0.00%,2,1,50.00%
cdn-cn.nekocloud.cn,1,0.00%,6,5,16.67%
lf3-config.bytetcc.com,1,0.00%,2,1,50.00%
api5-normal-quic-lq.ixigua.com,1,0.00%,2,1,50.00%
drugulf.ae,1,0.00%,2,1,50.00%
mofa.gov.ae,1,0.00%,2,1,50.00%
edge.api.myqnapcloud.cn,1,0.00%,2,1,50.00%
drydocks.gov.ae,1,0.00%,2,1,50.00%
onedriveclucproddm20030.blob.core.windows.net,1,0.00%,6,5,16.67%
onedriveclucproddm20004.blob.core.windows.net,1,0.00%,2,1,50.00%
onedriveclucproddm20001.blob.core.windows.net,1,0.00%,2,1,50.00%
ipv6.onevpshk.10242018.xyz,1,0.00%,1,0,100.00%
onedriveclucproddm20037.blob.core.windows.net,1,0.00%,4,3,25.00%
opentracker.acgnx.se,1,0.00%,4,3,25.00%
tracker.swarm3.network,1,0.00%,1,0,100.00%
image.lixiangdao.vip,1,0.00%,2,1,50.00%
venus.douyucdn.cn,1,0.00%,2,1,50.00%
shipinkexue.com,1,0.00%,1,0,100.00%
shishanluo.com,1,0.00%,1,0,100.00%
yx85hqme.eia0.net,1,0.00%,2,1,50.00%
bks5t78q.eia0.net,1,0.00%,2,1,50.00%
oxonhh.com,1,0.00%,1,0,100.00%
t3bxzjs9.eia0.net,1,0.00%,2,1,50.00%
vxynad5s.eia0.net,1,0.00%,2,1,50.00%
gjqueca8.eia0.net,1,0.00%,2,1,50.00%
x4ajhwmd.eia0.net,1,0.00%,2,1,50.00%
x6n2bphy.eia0.net,1,0.00%,2,1,50.00%
ns01.000webhost.com,1,0.00%,4,3,25.00%
a.a.a.ooooops.space,1,0.00%,2,1,50.00%
sadownload-new.mcafee.com.edgekey.NET,1,0.00%,2,1,50.00%
onedscolprdeus08.eastus.cloudapp.azure.com,1,0.00%,4,3,25.00%
settings-prod-eus2-2.eastus2.cloudapp.azure.com,1,0.00%,2,1,50.00%
onedscolprdfrc05.francecentral.cloudapp.azure.com,1,0.00%,2,1,50.00%
onedscolprdcus13.centralus.cloudapp.azure.com,1,0.00%,2,1,50.00%
v3-cold.douyinvod.com,1,0.00%,2,1,50.00%
v5-j.douyinvod.com,1,0.00%,2,1,50.00%
v5-colde.douyinvod.com,1,0.00%,2,1,50.00%
s1.hdslb.com.w.kunlunar.com,1,0.00%,2,1,50.00%
v1.douyinvod.com.wsdvs.com,1,0.00%,2,1,50.00%
adservice.google.com.hk,1,0.00%,1,0,100.00%
h5api.m.taobao.com,1,0.00%,2,1,50.00%
staticiot.cdn.bcebos.com,1,0.00%,3,2,33.33%
nd-static.bdstatic.com,1,0.00%,3,2,33.33%
staticsns.cdn.bcebos.com,1,0.00%,3,2,33.33%
common-afdrk.fe.1drv.com,1,0.00%,1,0,100.00%
schemastore.org,1,0.00%,1,0,100.00%
onedriveclucprodbn20025.blob.core.windows.net,1,0.00%,4,3,25.00%
chi01pcor001-meta.fe.1drv.com,1,0.00%,1,0,100.00%
bfe8f76088f8a2c9.vip.jiasule.org,1,0.00%,1,0,100.00%
s.ssl.qhimg.com,1,0.00%,5,4,20.00%
sc1.hao123img.com,1,0.00%,2,1,50.00%
sc0.hao123img.com,1,0.00%,2,1,50.00%
img1.hao123.com,1,0.00%,2,1,50.00%
cn.chinadaily.com.cn,1,0.00%,2,1,50.00%
img2.hao123.com,1,0.00%,2,1,50.00%
dgss2.bdstatic.com,1,0.00%,2,1,50.00%
s1.hao123img.com,1,0.00%,2,1,50.00%
s0.hao123img.com,1,0.00%,2,1,50.00%
www.9377.com,1,0.00%,2,1,50.00%
www.cpta.com.cn,1,0.00%,2,1,50.00%
www.huya.com,1,0.00%,2,1,50.00%
www.icbc.com.cn,1,0.00%,2,1,50.00%
www.ifeng.com,1,0.00%,2,1,50.00%
mos.m.taobao.com,1,0.00%,2,1,50.00%
v.qq.com,1,0.00%,2,1,50.00%
www.ce.cn,1,0.00%,2,1,50.00%
www.china.com.cn,1,0.00%,2,1,50.00%
www.gmw.cn,1,0.00%,2,1,50.00%
www.xinhuanet.com,1,0.00%,2,1,50.00%
dgss0.baidu.com,1,0.00%,2,1,50.00%
dgss2.baidu.com,1,0.00%,2,1,50.00%
dgss1.baidu.com,1,0.00%,2,1,50.00%
picasso-qiniu.xiaohongshu.com,1,0.00%,2,1,50.00%
img3.doubanio.com,1,0.00%,2,1,50.00%
caldav.icloud.com,1,0.00%,2,1,50.00%
storage.360buyimg.com,1,0.00%,2,1,50.00%
download.52pcfree.com,1,0.00%,2,1,50.00%
sf3-fe-tos.pglstatp-toutiao.com.w.cdngslb.com,1,0.00%,2,1,50.00%
iadsdk.qtlcdn.com,1,0.00%,2,1,50.00%
p26-be-pack-sign.pglstatp-toutiao.com,1,0.00%,2,1,50.00%
mssdk-bu.bytedance.com.w.cdngslb.com,1,0.00%,2,1,50.00%
tb3.bdstatic.com.a.bdydns.com,1,0.00%,2,1,50.00%
wappass.bdimg.com.a.bdydns.com,1,0.00%,2,1,50.00%
mv.bdstatic.com.a.bdydns.com,1,0.00%,2,1,50.00%
ssltieba.jomodns.com,1,0.00%,2,1,50.00%
azsc-usc.config.skype.com,1,0.00%,2,1,50.00%
img12.360buyimg.com,1,0.00%,2,1,50.00%
tnc3-aliec2.zijieapi.com,1,0.00%,2,1,50.00%
opencdntbvideo.jomodns.com,1,0.00%,2,1,50.00%
v26.douyinvod.com,1,0.00%,2,1,50.00%
feed-image.baidu.com.a.bdydns.com,1,0.00%,2,1,50.00%
fc-video.cdn.bcebos.com,1,0.00%,2,1,50.00%
sns-img-hw.xhscdn.com.mwyzhcdn.com,1,0.00%,2,1,50.00%
dgss1.bdstatic.com,1,0.00%,2,1,50.00%
ardownload3.adobe.com,1,0.00%,2,1,50.00%
res.cdn.office.net,1,0.00%,2,1,50.00%
res-1.cdn.office.net,1,0.00%,2,1,50.00%
fe-resource-cors.cdn.bcebos.com,1,0.00%,3,2,33.33%
sd.p.qianxin.com,1,0.00%,1,0,100.00%
jvod.300hu.com.vod.galileo.jcloud-cdn.com,1,0.00%,1,0,100.00%
profile.blzstatic.cn,1,0.00%,3,2,33.33%
a1858.dscd.akamai.net,1,0.00%,2,1,50.00%
alogs.umeng.com,1,0.00%,4,3,25.00%
3wabxy9b.sched.sma.tdnsstic1.cn,1,0.00%,2,1,50.00%
sslbaiduv6.jomodns.com,1,0.00%,2,1,50.00%
bbs.mobileapi.hupu.com,1,0.00%,2,1,50.00%
offline-download.hupu.com,1,0.00%,2,1,50.00%
i1.hoopchina.com.cn,1,0.00%,2,1,50.00%
static.mysmth.net,1,0.00%,2,1,50.00%
v11-cold.sched.v4lego-dk.tdnsvod1.cn,1,0.00%,2,1,50.00%
v5-f.douyinvod.com,1,0.00%,2,1,50.00%
www.tm.a.prd.aadg.akadns.NET,1,0.00%,2,1,50.00%
static.institution.grammarly.com,1,0.00%,2,1,50.00%
denali-static.grammarly.com,1,0.00%,2,1,50.00%
dox.grammarly.com,1,0.00%,2,1,50.00%
f-log-editor-debug.grammarly.io,1,0.00%,2,1,50.00%
xqimg.imedao.com,1,0.00%,2,1,50.00%
su.ff.avast.com,1,0.00%,2,1,50.00%
xz.pphimalayanrt.com,1,0.00%,1,0,100.00%
activity.hdslb.com,1,0.00%,2,1,50.00%
qqvip-web.cdn-go.cn,1,0.00%,2,1,50.00%
jsonschema.qpic.cn,1,0.00%,2,1,50.00%
imgcache.gtimg.cn,1,0.00%,2,1,50.00%
nv00.cdn.bcebos.com.a.bdydns.com,1,0.00%,3,2,33.33%
www.pconline.com.cn.ctdns.cn,1,0.00%,2,1,50.00%
geo2.adobe.com,1,0.00%,2,1,50.00%
fpdownload.macromedia.com,1,0.00%,2,1,50.00%
st.music.163.com.w.kunluncan.com,1,0.00%,2,1,50.00%
pics0.baidu.com.a.bdydns.com,1,0.00%,2,1,50.00%
mbdcdn.bdstatic.com.a.bdydns.com,1,0.00%,2,1,50.00%
img-music.heytapimage.com,1,0.00%,2,1,50.00%
capi.grammarly.com,1,0.00%,4,3,25.00%
news.stcn.com,1,0.00%,2,1,50.00%
static.bshare.cn,1,0.00%,2,1,50.00%
browseraps-drcn.dbankcdn.cn,1,0.00%,2,1,50.00%
cs02-pps-drcn.dbankcdn.com,1,0.00%,2,1,50.00%
security-web.cdn-go.cn,1,0.00%,2,1,50.00%
q-ui.cdn-go.cn,1,0.00%,2,1,50.00%
npm.cdn-go.cn,1,0.00%,2,1,50.00%
channels-aladin.wxqcloud.qq.com.cdn.dnsv1.com,1,0.00%,2,1,50.00%
multiapp-cache-weboffice.wpscdn.cn,1,0.00%,2,1,50.00%
msg.csw.lenovo.com,1,0.00%,2,1,50.00%
qn.cache.wpscdn.com,1,0.00%,2,1,50.00%
pn.baidu.com,1,0.00%,2,1,50.00%
tnc3-aliec2.snssdk.com,1,0.00%,2,1,50.00%
l7-online-self-max.s.dsa.cdnbuild.net,1,0.00%,2,1,50.00%
hcdnw.qtfm.c.cdnhwc1.com,1,0.00%,2,1,50.00%
portrait.jomodns.com,1,0.00%,2,1,50.00%
opencdnbdwappass.jomodns.com,1,0.00%,2,1,50.00%
static.cdn.xiaomazhixing.com,1,0.00%,1,0,100.00%
assets.imedao.com,1,0.00%,2,1,50.00%
wifiupdate.ggsafe.com,1,0.00%,2,1,50.00%
bcstobos.jomodns.com,1,0.00%,2,1,50.00%
stat.tiara.kakao.com,1,0.00%,2,1,50.00%
staticplat.cdn.bcebos.com,1,0.00%,2,1,50.00%
play.kakao.com,1,0.00%,2,1,50.00%
t1.daumcdn.net,1,0.00%,2,1,50.00%
inews.gtimg.com,1,0.00%,2,1,50.00%
qqi18n.qq.com,1,0.00%,2,1,50.00%
pic200.weishi.qq.com,1,0.00%,2,1,50.00%
weishicdn.gtimg.cn,1,0.00%,2,1,50.00%
avatar2.weishi.qq.com,1,0.00%,2,1,50.00%
avatar1.weishi.qq.com,1,0.00%,2,1,50.00%
avatar3.weishi.qq.com,1,0.00%,2,1,50.00%
qqgzh.weishi.qq.com,1,0.00%,2,1,50.00%
xp.qpic.cn,1,0.00%,2,1,50.00%
pic100.weishi.qq.com,1,0.00%,2,1,50.00%
avatar0.weishi.qq.com,1,0.00%,2,1,50.00%
pic640.weishi.qq.com,1,0.00%,2,1,50.00%
issuecdn.baidupcs.com,1,0.00%,2,1,50.00%
img2.runjiapp.com,1,0.00%,2,1,50.00%
img3.runjiapp.com,1,0.00%,2,1,50.00%
oss.kazhifu.com,1,0.00%,2,1,50.00%
www.2345.com,1,0.00%,2,1,50.00%
www.avira.com,1,0.00%,2,1,50.00%
www.tuidc.com,1,0.00%,2,1,50.00%
finance.eastmoney.com,1,0.00%,2,1,50.00%
tx-pclivemate.pull.yximgs.com,1,0.00%,2,1,50.00%
gspe19-cn-ssl.ls.apple.com,1,0.00%,2,1,50.00%
opencdnqiniustaticv6.jomodns.com,1,0.00%,2,1,50.00%
setup.fe.apple-dns.net,1,0.00%,2,1,50.00%
fmipalservice.fe.apple-dns.net,1,0.00%,2,1,50.00%
sqdd.myapptc.qq.com,1,0.00%,2,1,50.00%
i.gtimg.cn.sched.legopic2.tdnsv6.com.tpic.vwnti.yrzhcloud.cn,1,0.00%,2,1,50.00%
cmshow.gtimg.cn.sched.legopic2.tdnsv6.com.tpic.vwnti.yrzhcloud.cn,1,0.00%,2,1,50.00%
d.url.cn,1,0.00%,2,1,50.00%
1610067831.D4EE073C2A20.device.hiwifi.com,1,0.00%,1,0,100.00%
1610067852.D4EE073C2A20.device.hiwifi.com,1,0.00%,1,0,100.00%
1610067893.D4EE073C2A20.device.hiwifi.com,1,0.00%,1,0,100.00%
ws-adaptive.pull.yximgs.com,1,0.00%,2,1,50.00%
js-rwk.pull.etoote.com,1,0.00%,2,1,50.00%
ks-adaptive.pull.yximgs.com,1,0.00%,2,1,50.00%
ks-livemate.pull.yximgs.com,1,0.00%,2,1,50.00%
ks-proxy.pull.yximgs.com,1,0.00%,2,1,50.00%
ks-pclivemate.pull.yximgs.com,1,0.00%,2,1,50.00%
ali-proxy.pull.yximgs.com,1,0.00%,2,1,50.00%
ali-origin.pull.yximgs.com,1,0.00%,2,1,50.00%
bd-pclivemate.pull.yximgs.com,1,0.00%,2,1,50.00%
bd-livemate.pull.yximgs.com,1,0.00%,2,1,50.00%
bd-proxy.pull.yximgs.com,1,0.00%,2,1,50.00%
api.islide.cc,1,0.00%,2,1,50.00%
cdn-api-verify.mob.com,1,0.00%,2,1,50.00%
sns-video-hw.xhscdn.com,1,0.00%,2,1,50.00%
pages.xiaohongshu.com,1,0.00%,2,1,50.00%
baichuan-sdk.alicdn.com,1,0.00%,2,1,50.00%
fe-video-qc.xhscdn.com,1,0.00%,2,1,50.00%
zip-qc.xhscdn.com,1,0.00%,2,1,50.00%
fe-img-qc.xhscdn.com,1,0.00%,2,1,50.00%
sns-music.xhscdn.com,1,0.00%,2,1,50.00%
vkk49ekoc3luxt0d.b.requestbin.net,1,0.00%,1,0,100.00%
browserr-drcn.dbankcdn.cn,1,0.00%,2,1,50.00%
telemetry-incoming.r53-2.services.mozilla.com,1,0.00%,2,1,50.00%
realsense-hw-public.s3.amazonaws.com,1,0.00%,2,1,50.00%
omgmta1.qq.com,1,0.00%,2,1,50.00%
omgid.qq.com,1,0.00%,2,1,50.00%
omgmta.qq.com,1,0.00%,2,1,50.00%
db.auto.sohu.com,1,0.00%,2,1,50.00%
api.tui.qq.com,1,0.00%,2,1,50.00%
i.match.qq.com,1,0.00%,2,1,50.00%
aq.qq.com,1,0.00%,2,1,50.00%
ovv.alllook.tv,1,0.00%,2,1,50.00%
officecdnmac.microsoft.com,1,0.00%,2,1,50.00%
prod-gateway.wdckeystone.com,1,0.00%,2,1,50.00%
33aef1e.nb.gladns.com,1,0.00%,2,1,50.00%
33aef1e.nh.gladns.com,1,0.00%,2,1,50.00%
33aef1e.nc.gladns.com,1,0.00%,2,1,50.00%
33aef1e.na.gladns.com,1,0.00%,2,1,50.00%
33aef1e.nd.gladns.com,1,0.00%,2,1,50.00%
preimage3.iqiyipic.com,1,0.00%,2,1,50.00%
oauth.intservices.aws.intellij.NET,1,0.00%,2,1,50.00%
api.gitkraken.com,1,0.00%,2,1,50.00%
wwW.VOd.LXDns.Com,1,0.00%,2,1,50.00%
path1.xtracloud.net,1,0.00%,2,1,50.00%
path3.xtracloud.net,1,0.00%,2,1,50.00%
ebad288.na.gladns.com,1,0.00%,2,1,50.00%
onedriveclucprodbn20050.blob.core.windows.net,1,0.00%,2,1,50.00%
onedriveclucprodbn20003.blob.core.windows.net,1,0.00%,2,1,50.00%
onedriveclucproddm20012.blob.core.windows.net,1,0.00%,1,0,100.00%
bolt.dropbox.com,1,0.00%,2,1,50.00%
tracker.msm8916.com,1,0.00%,2,1,50.00%
viva.vipstatic.com,1,0.00%,2,1,50.00%
newtab.firefoxchina.cn.lxcvc.com,1,0.00%,2,1,50.00%
msnzlxxglobal.v.lxcvc.com,1,0.00%,2,1,50.00%
ns77.cybersitezone.com,1,0.00%,2,1,50.00%
ns11.zonecybersite.com,1,0.00%,2,1,50.00%
ns76.cybersitezone.com,1,0.00%,2,1,50.00%
seeknkeepclub.com,1,0.00%,1,0,100.00%
sdtlaon.com,1,0.00%,1,0,100.00%
dl.360safe.com.qh-cdn.com,1,0.00%,2,1,50.00%
dl.360safe.com.dl.360qhcdn.com,1,0.00%,2,1,50.00%
k-ring.k-9999.k-msedge.NET,1,0.00%,2,1,50.00%
pdns124.ultradns.biz,1,0.00%,2,1,50.00%
pdns196.ultradns.biz,1,0.00%,1,0,100.00%
deb.nodesource.com,1,0.00%,2,1,50.00%
p60-escrowproxy.icloud.com,1,0.00%,2,1,50.00%
escrowproxy.fe.apple-dns.net,1,0.00%,2,1,50.00%
sjy.stream.qqmusic.qq.com.vdncache.com,1,0.00%,4,3,25.00%
8744550.pack.tcdn.qq.com,1,0.00%,4,3,25.00%
waws-prod-sg1-051.sip.azurewebsites.windows.NET,1,0.00%,2,1,50.00%
wprd03.is.autonavi.com,1,0.00%,2,1,50.00%
vdata.amap.com,1,0.00%,2,1,50.00%
wprd02.is.autonavi.com,1,0.00%,2,1,50.00%
wprd01.is.autonavi.com,1,0.00%,2,1,50.00%
1.asia.pool.ntp.org,1,0.00%,2,1,50.00%
crl.microsoft.com,1,0.00%,2,1,50.00%
caldav.fe.apple-dns.net,1,0.00%,2,1,50.00%
mirrorcoso1.acglego-dk.sched.tdnsv2.com,1,0.00%,2,1,50.00%
apd-5d4143548f592cbd7c969842bbae847d61c112a2a99b6bcb.v.smtcdns.com,1,0.00%,1,0,100.00%
www.bytedance.com.w.cdngslb.com,1,0.00%,2,1,50.00%
st2-v3-dc.splashtop.com,1,0.00%,2,1,50.00%
voipfinderliveplay.wxqcloud.qq.com,1,0.00%,2,1,50.00%
wa.qq.com,1,0.00%,2,1,50.00%
api5-normal-lf.toutiaoapi.com,1,0.00%,2,1,50.00%
i.snssdk.com.bytedns1.com,1,0.00%,2,1,50.00%
p3.toutiaoimg.com,1,0.00%,2,1,50.00%
v11-cold.douyinvod.com,1,0.00%,2,1,50.00%
ib.snssdk.com.w.kunluncan.com,1,0.00%,2,1,50.00%
GOogle.cOm,1,0.00%,2,1,50.00%
appcashier256.95516.com,1,0.00%,2,1,50.00%
s2.ssl.qhres2.com,1,0.00%,6,5,16.67%
sb-ssl.google.com,1,0.00%,2,1,50.00%
v3-cold1.douyinvod.com,1,0.00%,2,1,50.00%
juejin.cn.w.cdngslb.com,1,0.00%,2,1,50.00%
api.juejin.cn.w.cdngslb.com,1,0.00%,2,1,50.00%
p3-juejin.byteimg.com.w.cdngslb.com,1,0.00%,2,1,50.00%
xxbg.snssdk.com.w.cdngslb.com,1,0.00%,2,1,50.00%
abtestvm.bytedance.com.w.cdngslb.com,1,0.00%,2,1,50.00%
urswebzj.nosdn.127.net,1,0.00%,2,1,50.00%
ww1.sinaimg.cn.w.alikunlun.com,1,0.00%,2,1,50.00%
us.sinaimg.cn.w.alikunlun.net,1,0.00%,2,1,50.00%
lf3-config.bytetcc.com.w.cdngslb.com,1,0.00%,2,1,50.00%
f.us.sinaimg.cn,1,0.00%,2,1,50.00%
gstaticadssl.l.google.com,1,0.00%,2,1,50.00%
midpf-material.cdn.bcebos.com,1,0.00%,2,1,50.00%
e3.whatsapp.net,1,0.00%,2,1,50.00%
index-cdn.jetbrains.com,1,0.00%,2,1,50.00%
lyrics.kugou.com,1,0.00%,2,1,50.00%
fsvippc.hw.kugou.com,1,0.00%,2,1,50.00%
app.mokahr.com,1,0.00%,2,1,50.00%
toqgxvdtraddpal3f5qniz8cmki1jrgs.yundunwaf.com,1,0.00%,2,1,50.00%
e6156.dscf.akamaiedge.net,1,0.00%,2,1,50.00%
a1931.dscgi3.akamai.net,1,0.00%,2,1,50.00%
webcast5-normal-c-lf.amemv.com,1,0.00%,2,1,50.00%
webcast3-normal-c-lf.amemv.com,1,0.00%,2,1,50.00%
gfwsl.geforce.cn,1,0.00%,1,0,100.00%
parrot-pc-1251479438.cos.ap-beijing.myqcloud.com,1,0.00%,1,0,100.00%
api.fanyi.baidu.com,1,0.00%,2,1,50.00%
e17437.dsct.akamaiedge.net,1,0.00%,2,1,50.00%
pdns196.ultradns.info,1,0.00%,2,1,50.00%
ips-gw.gbd.hp10.us,1,0.00%,2,1,50.00%
tx-origin.pull.yximgs.com,1,0.00%,2,1,50.00%
s.mzstatic.com,1,0.00%,2,1,50.00%
tx-proxy.pull.yximgs.com,1,0.00%,2,1,50.00%
tx-rwk.pull.etoote.com,1,0.00%,2,1,50.00%
live.xhscdn.com,1,0.00%,2,1,50.00%
live-ali.xhscdn.com,1,0.00%,2,1,50.00%
prda.aadg.msidentity.com,1,0.00%,1,0,100.00%
sjy6.stream.qqmusic.qq.com.vdncache.com,1,0.00%,1,0,100.00%
settings-bd.feishu.cn.w.cdngslb.com,1,0.00%,2,1,50.00%
www.163.com,0,0.00%,11033,11033,0.00%
ntp.ubuntu.com,0,0.00%,13254,13254,0.00%
www.baidu.com,0,0.00%,13568,13568,0.00%
teredo-debian.remlab.net,0,0.00%,95,95,0.00%
dl.min.io,0,0.00%,695,695,0.00%
hub.upyun.com,0,0.00%,290,290,0.00%
connectivity-check.ubuntu.com,0,0.00%,1975,1975,0.00%
prod.ingestion-edge.prod.dataops.mozgcp.net,0,0.00%,12,12,0.00%
ocsp.digicert.com,0,0.00%,88,88,0.00%
cs9.wac.phicdn.net,0,0.00%,7,7,0.00%
osfsr.lenovomm.com,0,0.00%,472,472,0.00%
dsp.lenovo.com.cn,0,0.00%,140,140,0.00%
rm-bp151dcc75aycqd80to.mysql.rds.aliyuncs.com,0,0.00%,5,5,0.00%
clock.isc.org,0,0.00%,23,23,0.00%
edragent.sangfor.com.cn,0,0.00%,1624,1624,0.00%
query.hicloud.com,0,0.00%,3055,3055,0.00%
roaming.officeapps.live.com,0,0.00%,39,39,0.00%
bash.givemexyz.in,0,0.00%,557,557,0.00%
up-hl.3g.qq.com,0,0.00%,9,9,0.00%
hsk-embed.oray.com,0,0.00%,498,498,0.00%
space.bilibili.com,0,0.00%,7,7,0.00%
i1.hdslb.com,0,0.00%,40,40,0.00%
analytics.yinxiang.com,0,0.00%,133,133,0.00%
api.bilibili.com,0,0.00%,51,51,0.00%
passport.bilibili.com,0,0.00%,22,22,0.00%
pan.baidu.com,0,0.00%,884,884,0.00%
diskapi.baidu.com,0,0.00%,243,243,0.00%
nav-edge.smartscreen.microsoft.com,0,0.00%,36,36,0.00%
sp0.baidu.com,0,0.00%,48,48,0.00%
ss1.bdstatic.com,0,0.00%,24,24,0.00%
39-courier.push.apple.com,0,0.00%,29,29,0.00%
t13.baidu.com,0,0.00%,17,17,0.00%
t9.baidu.com,0,0.00%,38,38,0.00%
hectorstatic.baidu.com,0,0.00%,61,61,0.00%
10-courier.push.apple.com,0,0.00%,36,36,0.00%
cn.ntp.org.cn,0,0.00%,45,45,0.00%
hpd.baidu.com,0,0.00%,46,46,0.00%
ug.baidu.com,0,0.00%,49,49,0.00%
azwus1-client-s.gateway.messenger.live.com,0,0.00%,6,6,0.00%
sl-tk.oray.com,0,0.00%,687,687,0.00%
log.tailscale.io,0,0.00%,409,409,0.00%
api.miwifi.com,0,0.00%,1174,1174,0.00%
smtp.qq.com,0,0.00%,306,306,0.00%
pcrec.baidu.com,0,0.00%,32,32,0.00%
zhuanlan.zhihu.com,0,0.00%,20,20,0.00%
bili-dyn-sched.jcloud-cdn.com,0,0.00%,8,8,0.00%
static.zhihu.com,0,0.00%,14,14,0.00%
pica.zhimg.com,0,0.00%,20,20,0.00%
zz.bdstatic.com,0,0.00%,13,13,0.00%
client.wns.windows.com,0,0.00%,284,284,0.00%
time.pool.aliyun.com,0,0.00%,27,27,0.00%
sugar.zhihu.com,0,0.00%,18,18,0.00%
alpha-cloud-log.cn-hangzhou.log.aliyuncs.com,0,0.00%,85,85,0.00%
rq.wh.cmcm.com,0,0.00%,439,439,0.00%
config.app.yinxiang.com,0,0.00%,4,4,0.00%
szextshort.weixin.qq.com,0,0.00%,110,110,0.00%
yiyun.n.shifen.com,0,0.00%,20,20,0.00%
rq.drcct.cloud.duba.net,0,0.00%,212,212,0.00%
lp.open.weixin.qq.com,0,0.00%,25,25,0.00%
soup.v.qq.com,0,0.00%,34,34,0.00%
daisy.ubuntu.com,0,0.00%,1664,1664,0.00%
cb10bdfbd90f88db560d0ad1e8f78722.dlied1.cdntips.net,0,0.00%,1,1,0.00%
packages.deepin.com,0,0.00%,281,281,0.00%
cgi.ark.qq.com,0,0.00%,14,14,0.00%
settings-win.data.microsoft.com,0,0.00%,1695,1695,0.00%
flbgpi.yixuedianzishu.com,0,0.00%,32,32,0.00%
cloud.acrobat.com,0,0.00%,5,5,0.00%
static.asm.skype.com,0,0.00%,48,48,0.00%
static-asm.secure.skypeassets.com,0,0.00%,51,51,0.00%
ce571486-i.andns.co,0,0.00%,46,46,0.00%
cdn.lever.co,0,0.00%,2,2,0.00%
jobs.lever.co,0,0.00%,2,2,0.00%
autoupdater.updrv.com,0,0.00%,73,73,0.00%
usercount.dockernb.com,0,0.00%,142,142,0.00%
dns.cloudflare.com,0,0.00%,49,49,0.00%
s1a.time.edu.cn,0,0.00%,27,27,0.00%
public.dns.iij.jp,0,0.00%,217,217,0.00%
telemetry-in.battlenet.com.cn,0,0.00%,62,62,0.00%
www.bilibili.com,0,0.00%,56,56,0.00%
controlplane.tailscale.com,0,0.00%,23,23,0.00%
zh.us.to,0,0.00%,16,16,0.00%
cm.bilibili.com,0,0.00%,36,36,0.00%
grafana.com,0,0.00%,150,150,0.00%
raw.githubusercontent.com,0,0.00%,86,86,0.00%
default.exp-tas.com,0,0.00%,389,389,0.00%
bvc.bilivideo.com,0,0.00%,35,35,0.00%
rq.upgrade.drivergenius.com,0,0.00%,155,155,0.00%
update.code.visualstudio.com,0,0.00%,45,45,0.00%
c.go-mpulse.net,0,0.00%,117,117,0.00%
grnh.se,0,0.00%,2,2,0.00%
broker.miwifi.com,0,0.00%,324,324,0.00%
rq.upgrade.cmpc.cmcm.com,0,0.00%,131,131,0.00%
dns.msftncsi.com,0,0.00%,3058,3058,0.00%
geo.prod.do.dsp.mp.microsoft.com,0,0.00%,42,42,0.00%
windows.policies.live.net,0,0.00%,11,11,0.00%
licensing.mp.microsoft.com,0,0.00%,47,47,0.00%
h5.qzone.qq.com,0,0.00%,510,510,0.00%
weboffice.wpsdns.com,0,0.00%,2,2,0.00%
vasapi.wpsdns.com,0,0.00%,2,2,0.00%
proxy.client.163.com,0,0.00%,40,40,0.00%
geoip.elastic.co,0,0.00%,2,2,0.00%
lbs.mail.163.com,0,0.00%,20,20,0.00%
time.windows.com,0,0.00%,80,80,0.00%
smartscreen-prod.microsoft.com,0,0.00%,365,365,0.00%
array811.prod.do.dsp.mp.microsoft.com,0,0.00%,28,28,0.00%
update.huorong.cn,0,0.00%,72,72,0.00%
dns.google,0,0.00%,817,817,0.00%
api.zotero.org,0,0.00%,39,39,0.00%
bugreport.huorong.cn,0,0.00%,65,65,0.00%
gstatic.loli.net,0,0.00%,1,1,0.00%
time.nist.gov,0,0.00%,60,60,0.00%
high-frequency-gray.zhhainiao.com,0,0.00%,107,107,0.00%
edge-http.microsoft.com,0,0.00%,2,2,0.00%
authds.todesk.com,0,0.00%,147,147,0.00%
st.todesk.com,0,0.00%,77,77,0.00%
map.baidu.com,0,0.00%,45,45,0.00%
wechat.todesk.com,0,0.00%,9,9,0.00%
www.ximalaya.com,0,0.00%,14,14,0.00%
rubyfish.cn,0,0.00%,37,37,0.00%
8ehcb38y1u-dsn.algolia.net,0,0.00%,2,2,0.00%
fm.dl.126.net,0,0.00%,21,21,0.00%
crl.comodoca.com,0,0.00%,48,48,0.00%
cn-zjcm2.testfaj.top,0,0.00%,14,14,0.00%
im.dingtalk.com,0,0.00%,16,16,0.00%
rs1.qq.com,0,0.00%,149,149,0.00%
ts1.qq.com,0,0.00%,158,158,0.00%
rs2.qq.com,0,0.00%,145,145,0.00%
ts2.qq.com,0,0.00%,154,154,0.00%
dl-ovh01.amna.shop,0,0.00%,66,66,0.00%
doh.pub,0,0.00%,160,160,0.00%
az700632.vo.msecnd.net,0,0.00%,38,38,0.00%
boards.eu.greenhouse.io,0,0.00%,1,1,0.00%
edge.microsoft.com,0,0.00%,803,803,0.00%
sum.comment.service.kugou.com,0,0.00%,7,7,0.00%
kmrcdn.service.kugou.com,0,0.00%,5,5,0.00%
pc.service.kugou.com,0,0.00%,6,6,0.00%
entitlement-public-service-prod08.ol.epicgames.com,0,0.00%,6,6,0.00%
boards.cdn.greenhouse.io,0,0.00%,2,2,0.00%
s101-recruiting.cdn.greenhouse.io,0,0.00%,1,1,0.00%
www.bing.com,0,0.00%,269,269,0.00%
content.googleapis.com,0,0.00%,2,2,0.00%
www.telecommandsvc.microsoft.com,0,0.00%,7,7,0.00%
crl.sectigo.com,0,0.00%,8,8,0.00%
crl.usertrust.com,0,0.00%,22,22,0.00%
sv.symcb.com,0,0.00%,16,16,0.00%
ocsp.entrust.net,0,0.00%,123,123,0.00%
imap.qq.com,0,0.00%,154,154,0.00%
p3p.sogou.com,0,0.00%,267,267,0.00%
hotlist.imtt.qq.com,0,0.00%,4,4,0.00%
qingcenter.wps.cn,0,0.00%,252,252,0.00%
account-public-service-prod03.ol.epicgames.com,0,0.00%,24,24,0.00%
i.163.com,0,0.00%,28,28,0.00%
catalog.gamepass.com,0,0.00%,53,53,0.00%
stock.adobe.io,0,0.00%,12,12,0.00%
open.weixin.qq.com,0,0.00%,16,16,0.00%
tim.qq.com,0,0.00%,13,13,0.00%
shuc-pc-hunt.ksord.com,0,0.00%,341,341,0.00%
1min.pcfg.cache.wpscdn.cn,0,0.00%,108,108,0.00%
mmbiz.qpic.cn,0,0.00%,152,152,0.00%
t-safe.2345.com,0,0.00%,18,18,0.00%
wbapp.uve.weibo.com,0,0.00%,3,3,0.00%
gateway.im.weibo.cn,0,0.00%,7,7,0.00%
dp.im.weibo.cn,0,0.00%,7,7,0.00%
aps.amap.com,0,0.00%,62,62,0.00%
conn4.coloros.com,0,0.00%,11,11,0.00%
apd-pcdnwxlogin.teg.tencent-cloud.net,0,0.00%,4567,4567,0.00%
data.bilivideo.com,0,0.00%,6,6,0.00%
apd-pcdnwxstat.teg.tencent-cloud.net,0,0.00%,45,45,0.00%
conn3.coloros.com,0,0.00%,8,8,0.00%
android.bugly.qq.com,0,0.00%,13,13,0.00%
adashx.ut.dingtalk.com,0,0.00%,26,26,0.00%
ns01.freenom.com,0,0.00%,3,3,0.00%
am.abc.wdpdk.link,0,0.00%,30,30,0.00%
p.qlogo.cn,0,0.00%,9,9,0.00%
bkvv.video.qq.com,0,0.00%,16,16,0.00%
info.zb.qq.com,0,0.00%,10,10,0.00%
bk.info.zb.qq.com,0,0.00%,10,10,0.00%
rq.upgrade.cloud.duba.net,0,0.00%,90,90,0.00%
wx.mail.qq.com,0,0.00%,20,20,0.00%
sdk.e.qq.com,0,0.00%,11,11,0.00%
sdkapp.uve.weibo.com,0,0.00%,6,6,0.00%
wx4.sinaimg.cn,0,0.00%,23,23,0.00%
az764295.vo.msecnd.net,0,0.00%,384,384,0.00%
fedoraproject.org,0,0.00%,56,56,0.00%
myip.opendns.com,0,0.00%,4,4,0.00%
f.video.weibocdn.com,0,0.00%,7,7,0.00%
array606.prod.do.dsp.mp.microsoft.com,0,0.00%,20,20,0.00%
f5-ck.zhhainiao.com,0,0.00%,85,85,0.00%
ipv4only.arpa,0,0.00%,84,84,0.00%
mpv6.weixin.qq.com,0,0.00%,7,7,0.00%
badjs.weixinbridge.com,0,0.00%,22,22,0.00%
arc.msn.com,0,0.00%,178,178,0.00%
ris.api.iris.microsoft.com,0,0.00%,113,113,0.00%
m8.music.126.net,0,0.00%,6,6,0.00%
crl4.digicert.com,0,0.00%,34,34,0.00%
123.sogou.com,0,0.00%,35,35,0.00%
docerad.wps.cn,0,0.00%,4,4,0.00%
doc.wps.cn,0,0.00%,4,4,0.00%
docs.wps.cn,0,0.00%,5,5,0.00%
docer.wps.cn,0,0.00%,43,43,0.00%
qing.wps.cn,0,0.00%,233,233,0.00%
pan.wps.cn,0,0.00%,2,2,0.00%
vip.wps.cn,0,0.00%,41,41,0.00%
vasapi.wps.cn,0,0.00%,44,44,0.00%
vipapi.wps.cn,0,0.00%,152,152,0.00%
app.wpscdn.cn,0,0.00%,7,7,0.00%
zw-roaming.wps.cn,0,0.00%,40,40,0.00%
tracker.wps.cn,0,0.00%,1,1,0.00%
ip.sb,0,0.00%,52,52,0.00%
dr.cs3.duba.net,0,0.00%,51,51,0.00%
api.geetest.com,0,0.00%,17,17,0.00%
api.weibo.cn,0,0.00%,16,16,0.00%
api.atlassian.com,0,0.00%,10,10,0.00%
bam.nr-data.net.cdn.cloudflare.net,0,0.00%,8,8,0.00%
resolver.msg.xiaomi.net,0,0.00%,4,4,0.00%
dw-online.ksosoft.com,0,0.00%,32,32,0.00%
contile.services.mozilla.com,0,0.00%,466,466,0.00%
tracker.foreverpirates.co,0,0.00%,6,6,0.00%
tracker.lilithraws.cf,0,0.00%,5,5,0.00%
array609.prod.do.dsp.mp.microsoft.com,0,0.00%,11,11,0.00%
outlookmobile-office365-tas.msedge.net,0,0.00%,8,8,0.00%
tva4.sinaimg.cn,0,0.00%,4,4,0.00%
v2.get.sogou.com,0,0.00%,84,84,0.00%
wx1.sinaimg.cn,0,0.00%,18,18,0.00%
mail.google.com,0,0.00%,68,68,0.00%
mini.browser.360.cn,0,0.00%,158,158,0.00%
bam.nr-data.net,0,0.00%,77,77,0.00%
mail.cstnet.cn,0,0.00%,512,512,0.00%
dns.weixin.qq.com.cn,0,0.00%,428,428,0.00%
www.msftconnecttest.com,0,0.00%,152,152,0.00%
sat02pap002.storage.live.com,0,0.00%,1,1,0.00%
short.weixin.qq.com,0,0.00%,35,35,0.00%
updates.logitech.com,0,0.00%,1,1,0.00%
smarthome.hicloud.com,0,0.00%,11,11,0.00%
metrics1.data.hicloud.com,0,0.00%,86,86,0.00%
mp.weixin.qq.com,0,0.00%,50,50,0.00%
example.org,0,0.00%,58,58,0.00%
bitbucket.org,0,0.00%,5,5,0.00%
m.comment.service.kugou.com,0,0.00%,1,1,0.00%
ip.kugou.com,0,0.00%,5,5,0.00%
imge.kugou.com,0,0.00%,1,1,0.00%
p13n.adobe.io,0,0.00%,13,13,0.00%
i.guancha.cn,0,0.00%,2,2,0.00%
nodestore.logitech.io,0,0.00%,3,3,0.00%
win1910.ipv6.microsoft.com,0,0.00%,13,13,0.00%
upext.chrome.360.cn,0,0.00%,20,20,0.00%
ex.qq.com,0,0.00%,35,35,0.00%
www.google.com,0,0.00%,216,216,0.00%
armmf.adobe.com,0,0.00%,6,6,0.00%
lhpay.gzcl999.com,0,0.00%,4,4,0.00%
sns-img-hw.xhscdn.com,0,0.00%,8,8,0.00%
wemeet-log-1256380422.cos.ap-guangzhou.myqcloud.com,0,0.00%,2,2,0.00%
t.khd.2345.cc,0,0.00%,200,200,0.00%
www.expressapisv2.net,0,0.00%,75,75,0.00%
data.ie.sogou.com,0,0.00%,2,2,0.00%
isure.stream.qqmusic.qq.com,0,0.00%,55,55,0.00%
sjy.stream.qqmusic.qq.com,0,0.00%,51,51,0.00%
yun.tim.qq.com,0,0.00%,17,17,0.00%
r.avlab.qq.com,0,0.00%,2,2,0.00%
isure6.stream.qqmusic.qq.com,0,0.00%,52,52,0.00%
dig.lianjia.com,0,0.00%,48,48,0.00%
map.ke.com,0,0.00%,5,5,0.00%
dns01.bj.chinamobile.com,0,0.00%,2,2,0.00%
wup.imtt.qq.com,0,0.00%,39,39,0.00%
caldav.163.com,0,0.00%,79,79,0.00%
foundation.youdao.com,0,0.00%,2,2,0.00%
education-certification.youdao.com,0,0.00%,2,2,0.00%
gorgon.youdao.com,0,0.00%,4,4,0.00%
ulogs.umeng.com,0,0.00%,13,13,0.00%
ydpushserver.youdao.com,0,0.00%,2,2,0.00%
events-drcn.op.dbankcloud.cn,0,0.00%,12,12,0.00%
22-courier.push.apple.com,0,0.00%,35,35,0.00%
cidian.youdao.com,0,0.00%,16,16,0.00%
wow.youdao.com,0,0.00%,2,2,0.00%
metrics1-drcn.dt.dbankcloud.cn,0,0.00%,24,24,0.00%
wow-activity.youdao.com,0,0.00%,2,2,0.00%
apple.com,0,0.00%,107,107,0.00%
time.g.aaplimg.com,0,0.00%,88,88,0.00%
mon.zijieapi.com,0,0.00%,220,220,0.00%
i.snssdk.com,0,0.00%,4,4,0.00%
imgcache.qq.com,0,0.00%,8,8,0.00%
cloud.browser.360.cn,0,0.00%,142,142,0.00%
galaxy.safe.360.cn,0,0.00%,17,17,0.00%
officeclient.microsoft.com,0,0.00%,33,33,0.00%
puv.tt.browser.360.cn,0,0.00%,85,85,0.00%
udpcache.gnvip.net,0,0.00%,1,1,0.00%
www.toutiao.com,0,0.00%,2,2,0.00%
nexus.officeapps.live.com,0,0.00%,60,60,0.00%
qdun-data.qq.com,0,0.00%,56,56,0.00%
qd-update.qq.com,0,0.00%,54,54,0.00%
www.csdn.net,0,0.00%,508,508,0.00%
cd001.www.duba.net,0,0.00%,2,2,0.00%
passport.escience.cn,0,0.00%,19,19,0.00%
bj.lianjia.com,0,0.00%,4,4,0.00%
dlswbr.baidu.com,0,0.00%,27,27,0.00%
api.safe.360.cn,0,0.00%,169,169,0.00%
p14.d.meituan.net,0,0.00%,4,4,0.00%
o3.d.meituan.net,0,0.00%,3,3,0.00%
ajax.api.lianjia.com,0,0.00%,2,2,0.00%
image1.ljcdn.com,0,0.00%,1,1,0.00%
dsum.casalemedia.com,0,0.00%,1,1,0.00%
ex.lianjia.com,0,0.00%,4,4,0.00%
szlong.weixin.qq.com,0,0.00%,28,28,0.00%
sync.readcube.com.herokudns.com,0,0.00%,7,7,0.00%
services.readcube.com.herokudns.com,0,0.00%,6,6,0.00%
software.drivergenius.com,0,0.00%,47,47,0.00%
wx.gtimg.com,0,0.00%,2,2,0.00%
mobile.pipe.aria.microsoft.com,0,0.00%,43,43,0.00%
u6.y.qq.com,0,0.00%,2,2,0.00%
guzzoni.apple.com,0,0.00%,20,20,0.00%
ocsp2.apple.com,0,0.00%,48,48,0.00%
mesu.g.aaplimg.com,0,0.00%,8,8,0.00%
message-center-statis.chuxingyouhui.com,0,0.00%,1,1,0.00%
wxpaylogo.qpic.cn,0,0.00%,1,1,0.00%
dpmtpush.dianping.com,0,0.00%,2,2,0.00%
acdc-direct.office.com,0,0.00%,16,16,0.00%
npay.meituan.com,0,0.00%,5,5,0.00%
upload.fp.measure.office.com,0,0.00%,47,47,0.00%
alert-cn.battlenet.com.cn,0,0.00%,59,59,0.00%
gsp0.baidu.com,0,0.00%,20,20,0.00%
weather-drcn.music.dbankcloud.cn,0,0.00%,33,33,0.00%
szminorshort.weixin.qq.com,0,0.00%,35,35,0.00%
market-fin.meituan.com,0,0.00%,1,1,0.00%
a2p-s01-drcn.cloud.dbankcloud.cn,0,0.00%,9,9,0.00%
mgm.meituan.com,0,0.00%,1,1,0.00%
1126359.sched.skalego-dk.tdnsstic1.cn,0,0.00%,2,2,0.00%
mlminorshort.weixin.qq.com,0,0.00%,1,1,0.00%
hm.baidu.com,0,0.00%,104,104,0.00%
ipv4-ipv6-phase4.wpt-portm.vip.meituan.com,0,0.00%,2,2,0.00%
dispatcher.is.autonavi.com,0,0.00%,23,23,0.00%
gspe35-ssl.ls.apple.com,0,0.00%,18,18,0.00%
gspe19-cn-ssl.ls.apple.com.download.ks-cdn.com,0,0.00%,1,1,0.00%
vip.foxitreader.cn,0,0.00%,28,28,0.00%
ping-edge.smartscreen.microsoft.com,0,0.00%,23,23,0.00%
metrics-picture.dreport.meituan.net,0,0.00%,5,5,0.00%
4e3fbc91775832759f33b21e514bb29c.dlied1.cdntips.net,0,0.00%,7,7,0.00%
mlextshort.weixin.qq.com,0,0.00%,13,13,0.00%
imapi.lianjia.com,0,0.00%,10,10,0.00%
api.apple-cloudkit.fe.apple-dns.net,0,0.00%,30,30,0.00%
in1-gw2-02-ce7dd027.eastus2.cloudapp.azure.com,0,0.00%,2,2,0.00%
a.sh.vip.dianping.com,0,0.00%,2,2,0.00%
gitee.com,0,0.00%,86,86,0.00%
exmail.qq.com,0,0.00%,31,31,0.00%
in.appcenter.ms,0,0.00%,57,57,0.00%
c.gsc.qq.com,0,0.00%,2,2,0.00%
f8ed5d21a44b0e58.jijifun.com,0,0.00%,12,12,0.00%
ugc.qpic.cn,0,0.00%,2,2,0.00%
midinfo.baofeng.com,0,0.00%,41,41,0.00%
agd2.p.360.cn,0,0.00%,77,77,0.00%
v2.shyonghui.xyz,0,0.00%,2,2,0.00%
gap.work.weixin.qq.com,0,0.00%,7,7,0.00%
ossimg.hitv.com,0,0.00%,1,1,0.00%
softcenter-all.os.nfschina.com,0,0.00%,61,61,0.00%
tencent-i.work.weixin.qq.com,0,0.00%,3,3,0.00%
srtb.msn.com,0,0.00%,15,15,0.00%
c.msn.cn,0,0.00%,16,16,0.00%
browser.events.data.msn.cn,0,0.00%,16,16,0.00%
i.work.weixin.qq.com,0,0.00%,22,22,0.00%
c.bing.com,0,0.00%,20,20,0.00%
locini.gslb.360safe.com,0,0.00%,1,1,0.00%
www.weather.com.cn,0,0.00%,1,1,0.00%
deff.nelreports.net,0,0.00%,5,5,0.00%
fclick.baidu.com,0,0.00%,32,32,0.00%
i.tq121.com.cn,0,0.00%,1,1,0.00%
hector.baidu.com,0,0.00%,21,21,0.00%
pic.weather.com.cn,0,0.00%,1,1,0.00%
i.weather.com.cn,0,0.00%,1,1,0.00%
translate.google.com,0,0.00%,18,18,0.00%
wgeo.weather.com.cn,0,0.00%,1,1,0.00%
d1.weather.com.cn,0,0.00%,1,1,0.00%
ntp.msn.cn,0,0.00%,10,10,0.00%
c.msn.com,0,0.00%,5,5,0.00%
h-adashx-internal.ut.taobao.com.gds.alibabadns.com,0,0.00%,1,1,0.00%
apd-pcdnwxnat.teg.tencent-cloud.net,0,0.00%,52,52,0.00%
time-ios.g.aaplimg.com,0,0.00%,36,36,0.00%
cgicol.amap.com,0,0.00%,53,53,0.00%
news.sohu.com,0,0.00%,1,1,0.00%
statics.itc.cn,0,0.00%,1,1,0.00%
sucimg.itc.cn,0,0.00%,3,3,0.00%
39d0825d09f05.cdn.sohucs.com,0,0.00%,5,5,0.00%
txt.go.sohu.com,0,0.00%,1,1,0.00%
images.sohu.com,0,0.00%,3,3,0.00%
js.sohu.com,0,0.00%,5,5,0.00%
cpro.baidustatic.com,0,0.00%,19,19,0.00%
acg.sohu.com,0,0.00%,1,1,0.00%
astro.sohu.com,0,0.00%,1,1,0.00%
auto.sohu.com,0,0.00%,1,1,0.00%
p10.d.meituan.net,0,0.00%,3,3,0.00%
baobao.sohu.com,0,0.00%,1,1,0.00%
business.sohu.com,0,0.00%,1,1,0.00%
chihe.sohu.com,0,0.00%,1,1,0.00%
cul.sohu.com,0,0.00%,1,1,0.00%
fashion.sohu.com,0,0.00%,1,1,0.00%
fun.sohu.com,0,0.00%,1,1,0.00%
dc.services.visualstudio.com,0,0.00%,35,35,0.00%
game.sohu.com,0,0.00%,1,1,0.00%
healthnews.sohu.com,0,0.00%,1,1,0.00%
history.sohu.com,0,0.00%,1,1,0.00%
it.sohu.com,0,0.00%,5,5,0.00%
learning.sohu.com,0,0.00%,1,1,0.00%
track.sohu.com,0,0.00%,4,4,0.00%
mil.sohu.com,0,0.00%,1,1,0.00%
mp.sohu.com,0,0.00%,1,1,0.00%
sports.sohu.com,0,0.00%,1,1,0.00%
pets.sohu.com,0,0.00%,1,1,0.00%
travel.sohu.com,0,0.00%,1,1,0.00%
buy.itunes-apple.com.akadns.net,0,0.00%,10,10,0.00%
yule.sohu.com,0,0.00%,1,1,0.00%
shang.qq.com,0,0.00%,1,1,0.00%
p6.itc.cn,0,0.00%,5,5,0.00%
pv.sohu.com,0,0.00%,19,19,0.00%
www.focus.cn,0,0.00%,1,1,0.00%
v2.sohu.com,0,0.00%,4,4,0.00%
www.microsoft.com,0,0.00%,109,109,0.00%
cis.sohu.com,0,0.00%,3,3,0.00%
search.sohu.com,0,0.00%,3,3,0.00%
api.interaction.sohu.com,0,0.00%,3,3,0.00%
p3.itc.cn,0,0.00%,7,7,0.00%
p2.itc.cn,0,0.00%,5,5,0.00%
fbp.sohu.com,0,0.00%,1,1,0.00%
service.weibo.com,0,0.00%,1,1,0.00%
sns.qzone.qq.com,0,0.00%,1,1,0.00%
imp.optaim.com,0,0.00%,1,1,0.00%
v4.passport.sohu.com,0,0.00%,5,5,0.00%
qpb0.sohu.com,0,0.00%,5,5,0.00%
apiv2.sohu.com,0,0.00%,3,3,0.00%
s.go.sohu.com,0,0.00%,5,5,0.00%
p5.itc.cn,0,0.00%,6,6,0.00%
03e1181bba1cf.cdn.sohucs.com,0,0.00%,1,1,0.00%
p9.itc.cn,0,0.00%,2,2,0.00%
p1.itc.cn,0,0.00%,4,4,0.00%
h5-ol.sns.sohu.com,0,0.00%,1,1,0.00%
p0.itc.cn,0,0.00%,1,1,0.00%
p4.itc.cn,0,0.00%,3,3,0.00%
passport.sohu.com,0,0.00%,1,1,0.00%
zt.pinglun.sohu.com,0,0.00%,1,1,0.00%
imp.go.sohu.com,0,0.00%,5,5,0.00%
i.go.sohu.com,0,0.00%,4,4,0.00%
t.go.sohu.com,0,0.00%,5,5,0.00%
w.irs03.com,0,0.00%,5,5,0.00%
643108e7617ef.cdn.sohucs.com,0,0.00%,3,3,0.00%
sem.17zhuangxiu.cn,0,0.00%,1,1,0.00%
pos.baidu.com,0,0.00%,24,24,0.00%
api.share.baidu.com,0,0.00%,3,3,0.00%
ssl.ptlogin2.graph.qq.com,0,0.00%,162,162,0.00%
wn.pos.baidu.com,0,0.00%,15,15,0.00%
user.qzone.qq.com,0,0.00%,2,2,0.00%
ptlogin2.qzone.qq.com,0,0.00%,2,2,0.00%
ssl.ptlogin2.qq.com,0,0.00%,4,4,0.00%
i.gdt.qq.com,0,0.00%,4,4,0.00%
stdl.qq.com,0,0.00%,4,4,0.00%
eclick.baidu.com,0,0.00%,19,19,0.00%
ssl.ptlogin2.mail.qq.com,0,0.00%,2,2,0.00%
mail.qq.com,0,0.00%,22,22,0.00%
connectivitycheck.platform.hicloud.com,0,0.00%,785,785,0.00%
m.black-unique.com,0,0.00%,1,1,0.00%
rescdn.qqmail.com,0,0.00%,2,2,0.00%
rl.mail.qq.com,0,0.00%,2,2,0.00%
js.aq.qq.com,0,0.00%,2,2,0.00%
sv.aq.qq.com,0,0.00%,2,2,0.00%
connectivitycheck.cbg-app.huawei.com,0,0.00%,13,13,0.00%
th.bing.com,0,0.00%,26,26,0.00%
wp.mail.qq.com,0,0.00%,16,16,0.00%
unionsug.baidu.com,0,0.00%,7,7,0.00%
www.notion.so,0,0.00%,52,52,0.00%
itunes.apple.com.edgekey.net,0,0.00%,1,1,0.00%
musicstatus.edge-itunes-apple.com.akadns.net,0,0.00%,3,3,0.00%
xp.apple.com.edgekey.net,0,0.00%,1,1,0.00%
ecn.dev.ditu.live.com,0,0.00%,30,30,0.00%
www.meituan.com,0,0.00%,35,35,0.00%
o1.d.meituan.net,0,0.00%,3,3,0.00%
imap.exmail.qq.com,0,0.00%,16,16,0.00%
addonlist.sync.maxthon.cn,0,0.00%,1,1,0.00%
tieba.baidu.com,0,0.00%,16,16,0.00%
passport.baidu.com,0,0.00%,45,45,0.00%
nsclick.baidu.com,0,0.00%,27,27,0.00%
imgsa.baidu.com,0,0.00%,9,9,0.00%
tbmsg.baidu.com,0,0.00%,3,3,0.00%
ecma.bdimg.com,0,0.00%,1,1,0.00%
tieba-ares.cdn.bcebos.com,0,0.00%,3,3,0.00%
als.baidu.com,0,0.00%,13,13,0.00%
sfp.safe.baidu.com,0,0.00%,10,10,0.00%
tb2.bdstatic.com,0,0.00%,4,4,0.00%
k5-v6-meituan.gslb.ksyuncdn.com,0,0.00%,1,1,0.00%
ns-strategy.cdn.bcebos.com,0,0.00%,1,1,0.00%
gss0.bdstatic.com,0,0.00%,1,1,0.00%
miao.baidu.com,0,0.00%,24,24,0.00%
sofire.baidu.com,0,0.00%,17,17,0.00%
ada.baidu.com,0,0.00%,1,1,0.00%
music.91q.com,0,0.00%,1,1,0.00%
task.browser.360.cn,0,0.00%,52,52,0.00%
apiexp.open.kingdee.com,0,0.00%,1,1,0.00%
darkreader.github.io,0,0.00%,9,9,0.00%
darkreader.org,0,0.00%,7,7,0.00%
update100.sangfor.com.cn,0,0.00%,83,83,0.00%
cloud.huawei.com,0,0.00%,2,2,0.00%
anv.duba.net,0,0.00%,15,15,0.00%
gomediago.baidu.com,0,0.00%,7,7,0.00%
rm.api.weibo.com,0,0.00%,57,57,0.00%
show-3.mediav.com,0,0.00%,3,3,0.00%
wappass.baidu.com,0,0.00%,11,11,0.00%
api.aliyundrive.com,0,0.00%,50,50,0.00%
s3m4.fenxi.com,0,0.00%,5,5,0.00%
channels.weixin.qq.com,0,0.00%,11,11,0.00%
client.uu.me,0,0.00%,1,1,0.00%
vm.gtimg.cn,0,0.00%,164,164,0.00%
asimov.vortex.data.trafficmanager.net,0,0.00%,5,5,0.00%
bsg.w.bilicdn1.com,0,0.00%,13,13,0.00%
xui.ptlogin2.qq.com,0,0.00%,163,163,0.00%
socket.pan.n.shifen.com,0,0.00%,6,6,0.00%
graph.qq.com,0,0.00%,159,159,0.00%
fanyi.youdao.com,0,0.00%,20,20,0.00%
rq.cct.cloud.duba.net,0,0.00%,143,143,0.00%
node.video.qq.com,0,0.00%,133,133,0.00%
s3.amazonaws.com,0,0.00%,2,2,0.00%
access.video.qq.com,0,0.00%,153,153,0.00%
hp3.mail.netease.com,0,0.00%,50,50,0.00%
cr.file.cloud.duba.net,0,0.00%,8,8,0.00%
stat.sd.360.cn,0,0.00%,80,80,0.00%
iaas.wps.cn,0,0.00%,39,39,0.00%
docer-api.kdocs.cn,0,0.00%,41,41,0.00%
docer.kdocs.cn,0,0.00%,37,37,0.00%
lucky.wps.cn,0,0.00%,36,36,0.00%
sms.wps.cn,0,0.00%,41,41,0.00%
kdocs.cn,0,0.00%,42,42,0.00%
geo.wps.cn,0,0.00%,43,43,0.00%
pay.wps.cn,0,0.00%,48,48,0.00%
common.docer.wps.cn,0,0.00%,5,5,0.00%
33.courier-push-apple.com.akadns.net,0,0.00%,1,1,0.00%
p7.itc.cn,0,0.00%,3,3,0.00%
assp.sohu.com,0,0.00%,1,1,0.00%
win10.ipv6.microsoft.com,0,0.00%,421,421,0.00%
vinci.ie.sogou.com,0,0.00%,7,7,0.00%
sp2.baidu.com,0,0.00%,20,20,0.00%
wan.sogou.com,0,0.00%,4,4,0.00%
mbd.baidu.com,0,0.00%,21,21,0.00%
pushtrs.push.hicloud.com,0,0.00%,42,42,0.00%
package.dingtalk.com,0,0.00%,2,2,0.00%
www.jos.org.cn,0,0.00%,8,8,0.00%
ovo.cn2.llsmall.com,0,0.00%,59,59,0.00%
ex.exmail.qq.com,0,0.00%,10,10,0.00%
mapsp0.bdimg.com,0,0.00%,2,2,0.00%
fc4tn.baidu.com,0,0.00%,2,2,0.00%
dss3.baidu.com,0,0.00%,2,2,0.00%
t15.baidu.com,0,0.00%,14,14,0.00%
fc5tn.baidu.com,0,0.00%,2,2,0.00%
www.kdocs.cn,0,0.00%,52,52,0.00%
softbus-device.wps.cn,0,0.00%,39,39,0.00%
aflow.dingtalk.com,0,0.00%,2,2,0.00%
www.atguigu.com,0,0.00%,2,2,0.00%
pcmgrmonitor.3g.qq.com,0,0.00%,4,4,0.00%
cronus.ie.sogou.com,0,0.00%,4,4,0.00%
aqyzmedia.yunaq.com,0,0.00%,2,2,0.00%
tb.53kf.com,0,0.00%,2,2,0.00%
www.gulixueyuan.com,0,0.00%,2,2,0.00%
www.itdachang.com,0,0.00%,2,2,0.00%
www.mobiletrain.org,0,0.00%,2,2,0.00%
s.union.360.cn,0,0.00%,6,6,0.00%
v.yunaq.com,0,0.00%,2,2,0.00%
360fenxi.mediav.com,0,0.00%,6,6,0.00%
e.so.com,0,0.00%,9,9,0.00%
www13.53kf.com,0,0.00%,2,2,0.00%
accwww13.53kf.com,0,0.00%,2,2,0.00%
tjs.sjs.sinajs.cn,0,0.00%,2,2,0.00%
pti.store.microsoft.com,0,0.00%,6,6,0.00%
cpro.baidu.com,0,0.00%,2,2,0.00%
online.user.maxthon.cn,0,0.00%,1,1,0.00%
js1.pcfg.cache.wpscdn.cn,0,0.00%,26,26,0.00%
retcode.alicdn.com,0,0.00%,2,2,0.00%
arms-retcode.aliyuncs.com,0,0.00%,7,7,0.00%
ts3.cn.mm.bing.net,0,0.00%,10,10,0.00%
bingciservice.koreasouth.cloudapp.azure.com,0,0.00%,8,8,0.00%
gm.mmstat.com,0,0.00%,18,18,0.00%
filesys.53kf.com,0,0.00%,2,2,0.00%
www2.bing.com,0,0.00%,8,8,0.00%
retcode.taobao.com,0,0.00%,9,9,0.00%
wenku.baidu.com,0,0.00%,13,13,0.00%
newvip.duba.net,0,0.00%,31,31,0.00%
startpage.ic.ksosoft.com,0,0.00%,1,1,0.00%
wk-journal.cdn.bcebos.com,0,0.00%,1,1,0.00%
wkctj.baidu.com,0,0.00%,3,3,0.00%
wkdsp.baidu.com,0,0.00%,3,3,0.00%
bj.bcebos.com,0,0.00%,4,4,0.00%
aefd.nelreports.net,0,0.00%,14,14,0.00%
openapp.wpscdn.cn,0,0.00%,31,31,0.00%
flow.wps.cn,0,0.00%,5,5,0.00%
site.browser.360.cn,0,0.00%,10,10,0.00%
learning.u.wpscdn.cn,0,0.00%,5,5,0.00%
infoc0.duba.net,0,0.00%,10,10,0.00%
tconf.b.qianxin.com,0,0.00%,16,16,0.00%
vip-rec.ksord.com,0,0.00%,9,9,0.00%
configsvr.msf.3g.qq.com,0,0.00%,28,28,0.00%
loc.map.baidu.com,0,0.00%,52,52,0.00%
openlocation-drcn.platform.dbankcloud.com,0,0.00%,38,38,0.00%
umini.shujupie.com,0,0.00%,3,3,0.00%
iphone-ld.apple.com,0,0.00%,27,27,0.00%
migration-geo-filter-prd.stargate.cse.ss-inf.net,0,0.00%,14,14,0.00%
classify-client.services.mozilla.com,0,0.00%,29,29,0.00%
prod-classifyclient.normandy.prod.cloudops.mozgcp.net,0,0.00%,18,18,0.00%
repos.os.nfschina.com,0,0.00%,5,5,0.00%
api.snapcraft.io,0,0.00%,223,223,0.00%
xlbrowsersdk.rcv.sandai.net,0,0.00%,2,2,0.00%
vscode-sync.trafficmanager.net,0,0.00%,68,68,0.00%
www.dadiyouhui01.cn,0,0.00%,96,96,0.00%
eeth9boh.nodedata.net,0,0.00%,54,54,0.00%
finance.services.appex.cn.bing.com,0,0.00%,4,4,0.00%
weatherredirectionweu01.cloudapp.net,0,0.00%,2,2,0.00%
gateway.lianjia.com,0,0.00%,31,31,0.00%
mail.iie.ac.cn,0,0.00%,64,64,0.00%
www.tnas.online,0,0.00%,12,12,0.00%
32-courier.push.apple.com,0,0.00%,33,33,0.00%
api.live.net,0,0.00%,2,2,0.00%
g.live.com,0,0.00%,24,24,0.00%
secure.wlxrs.com,0,0.00%,1,1,0.00%
bay405-m.hotmail.com,0,0.00%,2,2,0.00%
hub5pnc.sandai.net,0,0.00%,37,37,0.00%
www.overleaf.com,0,0.00%,27,27,0.00%
edu.ntp.org.cn,0,0.00%,14,14,0.00%
ntp1.aliyun.com,0,0.00%,16,16,0.00%
time1.cloud.tencent.com,0,0.00%,24,24,0.00%
database.clamav.net,0,0.00%,267,267,0.00%
feelchat2.virbox.com,0,0.00%,20,20,0.00%
rcv4.xldw.n0808.com,0,0.00%,4,4,0.00%
mtalk.google.com,0,0.00%,103,103,0.00%
speed.live.360.cn,0,0.00%,2,2,0.00%
q3.jia.360.cn,0,0.00%,10,10,0.00%
configserver.hicloud.com,0,0.00%,26,26,0.00%
dp.push.dc.360.cn,0,0.00%,2,2,0.00%
p.s.360.cn,0,0.00%,2,2,0.00%
dnkeeper.platform.dbankcloud.cn,0,0.00%,37,37,0.00%
store-drcn.hispace.dbankcloud.cn,0,0.00%,30,30,0.00%
tsms-drcn.platform.dbankcloud.com,0,0.00%,7,7,0.00%
tsms-drcn.security.dbankcloud.cn,0,0.00%,8,8,0.00%
rms-drcn.platform.dbankcloud.cn,0,0.00%,8,8,0.00%
mozilla.cloudflare-dns.com,0,0.00%,50,50,0.00%
alt5-mtalk.google.com,0,0.00%,5,5,0.00%
log.caxa.com,0,0.00%,2,2,0.00%
48afe871-i.andns.co,0,0.00%,12,12,0.00%
ipcmaster-sh-7days.shanghai.xstore.qihu.com,0,0.00%,2,2,0.00%
api-drcn.theme.dbankcloud.cn,0,0.00%,3,3,0.00%
yungw.taobao.com,0,0.00%,21,21,0.00%
th-a.pinduoduo.com,0,0.00%,10,10,0.00%
hiboardng.hicloud.com,0,0.00%,5,5,0.00%
dnkeeper.hicloud.com,0,0.00%,4,4,0.00%
app.biliapi.net,0,0.00%,1,1,0.00%
api.biliapi.net,0,0.00%,2,2,0.00%
debug.anuson.com,0,0.00%,8,8,0.00%
ins-j3fgveac.ias.tencent-cloud.net,0,0.00%,2,2,0.00%
sp.sangfor.com.cn,0,0.00%,470,470,0.00%
clientnotification-userprodea1-6.servicebus.windows.net,0,0.00%,4,4,0.00%
applog.uc.cn,0,0.00%,15,15,0.00%
trc.taboola.com,0,0.00%,2,2,0.00%
goldengate.grammarly.com,0,0.00%,82,82,0.00%
dlgzith499dss.cloudfront.net,0,0.00%,1,1,0.00%
images.taboola.com,0,0.00%,2,2,0.00%
boot-01.net.anydesk.com,0,0.00%,136,136,0.00%
policy.ccs.mcafee.com,0,0.00%,13,13,0.00%
www.scumall.com,0,0.00%,128,128,0.00%
www.oray.com,0,0.00%,212,212,0.00%
tkysenwhezsrteagubzihkhhxcbhhsyc.yundunwaf1.com,0,0.00%,193,193,0.00%
skydrive.wns.windows.com,0,0.00%,46,46,0.00%
c2.pcs.baidu.com,0,0.00%,39,39,0.00%
auth.sangfor.com.cn,0,0.00%,804,804,0.00%
a.root-servers.net,0,0.00%,956,956,0.00%
dsm01pap004.storage.live.com,0,0.00%,6,6,0.00%
sdk-open-phone.getui.com,0,0.00%,21,21,0.00%
dns1.registrar-servers.com,0,0.00%,1932,1932,0.00%
ali-bj-pcdn-10.biliapi.net,0,0.00%,2,2,0.00%
d.pcs.baidu.com,0,0.00%,50,50,0.00%
p.f.360.cn,0,0.00%,161,161,0.00%
agdist-api.cloud.huawei.com,0,0.00%,6,6,0.00%
activity.windows.com,0,0.00%,26,26,0.00%
entphz.alipay.com,0,0.00%,2,2,0.00%
router9.teamviewer.com,0,0.00%,96,96,0.00%
www.doc88.com,0,0.00%,13,13,0.00%
mv6.music.tc.qq.com,0,0.00%,2,2,0.00%
policyorchestration.ccs.mcafee.com,0,0.00%,7,7,0.00%
pcoma.qq.com,0,0.00%,84,84,0.00%
win8.ipv6.microsoft.com,0,0.00%,346,346,0.00%
webpush.wx.qq.com,0,0.00%,6,6,0.00%
connectivity.pod1.avatar.ext.hp.com,0,0.00%,5,5,0.00%
connc.gj.qq.com,0,0.00%,126,126,0.00%
oth.str.mdt.qq.com,0,0.00%,20,20,0.00%
sdkapp.mobile.sina.cn,0,0.00%,8,8,0.00%
weibo.cn,0,0.00%,17,17,0.00%
yun-hl.3g.qq.com,0,0.00%,34,34,0.00%
docs.qq.com,0,0.00%,112,112,0.00%
quay.io,0,0.00%,74,74,0.00%
login.sina.com.cn,0,0.00%,6,6,0.00%
amdc.alipay.com,0,0.00%,7,7,0.00%
sdkaction.biz.weibo.com,0,0.00%,5,5,0.00%
sdkmonitor.biz.weibo.com,0,0.00%,7,7,0.00%
adstrategy.biz.weibo.com,0,0.00%,8,8,0.00%
context-enroll.ccs.mcafee.com,0,0.00%,4,4,0.00%
report.nfa.qq.com,0,0.00%,5,5,0.00%
mtt.eve.mdt.qq.com,0,0.00%,4,4,0.00%
messaging.ccs.mcafee.com,0,0.00%,6,6,0.00%
sdkclick.biz.weibo.com,0,0.00%,3,3,0.00%
qqdata.ab.qq.com,0,0.00%,36,36,0.00%
wbapp.mobile.sina.cn,0,0.00%,7,7,0.00%
rmonitor.qq.com,0,0.00%,22,22,0.00%
aeventlog.beacon.qq.com,0,0.00%,21,21,0.00%
extshort.weixin.qq.com,0,0.00%,226,226,0.00%
socm.dmp.360.cn,0,0.00%,72,72,0.00%
ipv4.tracker.harry.lu,0,0.00%,2,2,0.00%
tracker.leechers-paradise.org,0,0.00%,2,2,0.00%
retracker.nts.su,0,0.00%,2,2,0.00%
ssl.look.360.cn,0,0.00%,30,30,0.00%
www.gstatic.com,0,0.00%,15,15,0.00%
pubsub02.oray.net,0,0.00%,267,267,0.00%
fe2cr.update.microsoft.com,0,0.00%,39,39,0.00%
restapi.amap.com,0,0.00%,13,13,0.00%
hkb.cloudnnnn.com,0,0.00%,247,247,0.00%
logbak.hicloud.com,0,0.00%,2,2,0.00%
p204-contacts.icloud.com.cn,0,0.00%,4,4,0.00%
long.weixin.qq.com,0,0.00%,38,38,0.00%
sdkserver-drcn.op.dbankcloud.cn,0,0.00%,15,15,0.00%
pop.qq.com,0,0.00%,32,32,0.00%
softcenter.os3.win.nfschina.com,0,0.00%,100,100,0.00%
api.wandb.ai,0,0.00%,485,485,0.00%
tiebacchunwan.n.shifen.com,0,0.00%,4,4,0.00%
aaid.umeng.com,0,0.00%,12,12,0.00%
maps.windows.com,0,0.00%,9,9,0.00%
28-courier.push.apple.com,0,0.00%,28,28,0.00%
alsg-new.linyeming.pub,0,0.00%,9,9,0.00%
edgedl.me.gvt1.com,0,0.00%,84,84,0.00%
apigate.10jqka.com.cn,0,0.00%,11,11,0.00%
cs.dds.microsoft.com,0,0.00%,14,14,0.00%
isrc.iscas.ac.cn,0,0.00%,72,72,0.00%
d2335eacoaawg9.cloudfront.net,0,0.00%,3,3,0.00%
note.youdao.com,0,0.00%,481,481,0.00%
www.sangfor.com,0,0.00%,185,185,0.00%
ssl.mail.163.com,0,0.00%,28,28,0.00%
router4.teamviewer.com,0,0.00%,71,71,0.00%
slapi.oray.net,0,0.00%,385,385,0.00%
analytics.95516.com,0,0.00%,4,4,0.00%
grs.dbankcloud.com,0,0.00%,26,26,0.00%
weibo.com,0,0.00%,106,106,0.00%
time-ios.apple.com,0,0.00%,4,4,0.00%
42-courier.push.apple.com,0,0.00%,27,27,0.00%
tracking.miui.com,0,0.00%,39,39,0.00%
www.m9ynqi6d.com,0,0.00%,100,100,0.00%
client-api.oray.com,0,0.00%,79,79,0.00%
m.baidu.com,0,0.00%,2,2,0.00%
hwid.platform.hicloud.com,0,0.00%,4,4,0.00%
apis.live.net,0,0.00%,11,11,0.00%
upd2.sangfor.com.cn,0,0.00%,27,27,0.00%
auth2.sangfor.com.cn,0,0.00%,46,46,0.00%
snowplow.trx.gitlab.net,0,0.00%,2,2,0.00%
user-api-v2.oray.com,0,0.00%,2,2,0.00%
dns.twnic.tw,0,0.00%,81,81,0.00%
rq.upgrade.lbmini.cmcm.com,0,0.00%,66,66,0.00%
auth-sl.oray.com,0,0.00%,10,10,0.00%
skl.la1.mclqp.link,0,0.00%,19,19,0.00%
router3.teamviewer.com,0,0.00%,108,108,0.00%
cn.overleaf.com,0,0.00%,5,5,0.00%
report.idqqimg.com,0,0.00%,42,42,0.00%
r1---sn-2x3elnel.gvt1.com,0,0.00%,2,2,0.00%
inference.location.live.net,0,0.00%,29,29,0.00%
v1-play.log.mgtv.com,0,0.00%,8,8,0.00%
log.tbs.qq.com,0,0.00%,42,42,0.00%
web-seminare.beton-webakademie.36chambers.de,0,0.00%,1,1,0.00%
31-courier.push.apple.com,0,0.00%,34,34,0.00%
onetag-sys.com,0,0.00%,4,4,0.00%
log.iflytek.com,0,0.00%,2,2,0.00%
dig.bdurl.net,0,0.00%,29,29,0.00%
dcdn-tracker.n.shifen.com,0,0.00%,4,4,0.00%
34-courier.push.apple.com,0,0.00%,27,27,0.00%
sbeacon.sina.com.cn,0,0.00%,12,12,0.00%
vcl-brain.snssdk.com,0,0.00%,10,10,0.00%
set.gosts.gq,0,0.00%,1,1,0.00%
tvax4.sinaimg.cn,0,0.00%,19,19,0.00%
tvax2.sinaimg.cn,0,0.00%,10,10,0.00%
sns-avatar-qc.xhscdn.com,0,0.00%,8,8,0.00%
s1.symcb.com,0,0.00%,26,26,0.00%
disp-reportnfav6tmp.ias.tencent-cloud.net,0,0.00%,4,4,0.00%
conf.wsm.360.cn,0,0.00%,70,70,0.00%
dnsscan.shadowserver.org,0,0.00%,52,52,0.00%
webrtcpunch.video.qq.com,0,0.00%,14,14,0.00%
btrace.video.qq.com,0,0.00%,6,6,0.00%
pc-store-lb.lenovomm.cn,0,0.00%,5,5,0.00%
errlog.umeng.com,0,0.00%,7,7,0.00%
traffic-v1.souche.com,0,0.00%,2,2,0.00%
cfg.imtt.qq.com,0,0.00%,4,4,0.00%
devlog.ys7.com,0,0.00%,2,2,0.00%
supl.platform.hicloud.com,0,0.00%,7,7,0.00%
r2---sn-2x3elnez.gvt1.com,0,0.00%,6,6,0.00%
wx.qq.com,0,0.00%,10,10,0.00%
geo-drcn.platform.hicloud.com,0,0.00%,6,6,0.00%
api3.gifshow.com,0,0.00%,6,6,0.00%
audid-api.taobao.com,0,0.00%,11,11,0.00%
gsp85-cn-ssl.ls.apple.com,0,0.00%,33,33,0.00%
s-gm.mmstat.com,0,0.00%,8,8,0.00%
dualstack-a.apilocate.amap.com,0,0.00%,13,13,0.00%
dualstack-logs.amap.com,0,0.00%,11,11,0.00%
init.itunes.apple.com,0,0.00%,28,28,0.00%
cloudflare-dns.com,0,0.00%,66,66,0.00%
api.github.com,0,0.00%,37,37,0.00%
data.pendo.io,0,0.00%,2,2,0.00%
push-rest.zui.com,0,0.00%,7,7,0.00%
roaming.officeapps.partner.office365.cn,0,0.00%,2,2,0.00%
d2kaokxjvx18eu.cloudfront.net,0,0.00%,5,5,0.00%
access.toggle.qq.com,0,0.00%,94,94,0.00%
gimg4.baidu.com,0,0.00%,10,10,0.00%
mp.4dex.io,0,0.00%,6,6,0.00%
loggw.alipay.com.cn,0,0.00%,8,8,0.00%
odc.officeapps.partner.office365.cn,0,0.00%,2,2,0.00%
beacon-api.aliyuncs.com,0,0.00%,12,12,0.00%
centertime.ksyun.com,0,0.00%,7,7,0.00%
infoc2.duba.net,0,0.00%,66,66,0.00%
api.kingdata.ksyun.com,0,0.00%,7,7,0.00%
filehouse.zhhainiao.com,0,0.00%,29,29,0.00%
tz.sec.xiaomi.com,0,0.00%,4,4,0.00%
api.777ppt.com,0,0.00%,2,2,0.00%
relay-b8d08ecc.net.anydesk.com,0,0.00%,65,65,0.00%
mpush-api.aliyun.com,0,0.00%,5,5,0.00%
collabrtc.officeapps.live.com,0,0.00%,4,4,0.00%
router16.teamviewer.com,0,0.00%,92,92,0.00%
psg1-collabhubrtc.officeapps.live.com,0,0.00%,2,2,0.00%
api.ad.xiaomi.com,0,0.00%,18,18,0.00%
sdkconfig.ad.xiaomi.com,0,0.00%,8,8,0.00%
d2gatte9o95jao.cloudfront.net,0,0.00%,13,13,0.00%
secclientgw.alipay.com,0,0.00%,21,21,0.00%
dsm01pap003.storage.live.com,0,0.00%,10,10,0.00%
wq.cloud.duba.net,0,0.00%,5,5,0.00%
g.csdnimg.cn,0,0.00%,33,33,0.00%
profile.csdnimg.cn,0,0.00%,18,18,0.00%
silkroad.csdn.net,0,0.00%,17,17,0.00%
alive.github.com,0,0.00%,59,59,0.00%
v.graphics.ac.cn,0,0.00%,5,5,0.00%
minor-api.mihoyo.com,0,0.00%,4,4,0.00%
c.pcs.baidu.com,0,0.00%,32,32,0.00%
ifs.tanx.com,0,0.00%,15,15,0.00%
cloud.dell.com,0,0.00%,8,8,0.00%
edge-268.hkhkg.icloud-content.com,0,0.00%,2,2,0.00%
weather-edge.news.apple-dns.net,0,0.00%,2,2,0.00%
edge-268.hkhkg.ce.apple-dns.net,0,0.00%,2,2,0.00%
ib.adnxs.com,0,0.00%,8,8,0.00%
b1h.zemanta.com,0,0.00%,3,3,0.00%
search.apps.ubuntu.com,0,0.00%,27,27,0.00%
nj.t.bcsp2p.baidu.com,0,0.00%,106,106,0.00%
ww1097.smartadserver.com,0,0.00%,4,4,0.00%
lbs.map.qq.com,0,0.00%,14,14,0.00%
metok.sys.miui.com,0,0.00%,14,14,0.00%
sync.1rx.io,0,0.00%,6,6,0.00%
video.weibo.com,0,0.00%,6,6,0.00%
edge-035.hktko1.ce.apple-dns.net,0,0.00%,10,10,0.00%
msite.baidu.com,0,0.00%,2,2,0.00%
zkres3.myzaker.com,0,0.00%,2,2,0.00%
ae.bdstatic.com,0,0.00%,2,2,0.00%
ggs.myzaker.com,0,0.00%,2,2,0.00%
stat.myzaker.com,0,0.00%,2,2,0.00%
tt.browser.360.cn,0,0.00%,27,27,0.00%
tva2.sinaimg.cn,0,0.00%,4,4,0.00%
healthdata.hicloud.com,0,0.00%,16,16,0.00%
array507.prod.do.dsp.mp.microsoft.com,0,0.00%,15,15,0.00%
95aaa353434f41dba950dc4aea6b8df9.fp.measure.office.com,0,0.00%,2,2,0.00%
grow.nowcoder.com,0,0.00%,2,2,0.00%
wd-prod-ss-as-southeast-2-fe.southeastasia.cloudapp.azure.com,0,0.00%,22,22,0.00%
dd.browser.360.cn,0,0.00%,112,112,0.00%
cm-10-19.getui.com,0,0.00%,2,2,0.00%
c-gtc.getui.net,0,0.00%,2,2,0.00%
agt.p.360.cn,0,0.00%,58,58,0.00%
tr.p.360.cn,0,0.00%,53,53,0.00%
akn.safe.360.cn,0,0.00%,87,87,0.00%
ulog-sdk.gifshow.com,0,0.00%,2,2,0.00%
open.e.kuaishou.cn,0,0.00%,2,2,0.00%
wap.ylxdtww.com,0,0.00%,2,2,0.00%
mobads.baidu.com,0,0.00%,2,2,0.00%
zerossl.ocsp.sectigo.com,0,0.00%,52,52,0.00%
zt.gifshow.com,0,0.00%,2,2,0.00%
newvpn.arp.cn,0,0.00%,8,8,0.00%
cloud-rest.lenovomm.com,0,0.00%,50,50,0.00%
stun.hitv.com,0,0.00%,10,10,0.00%
dns.weixin.qq.com,0,0.00%,65,65,0.00%
hag-drcn.op.hicloud.com,0,0.00%,10,10,0.00%
seupdate.360safe.com,0,0.00%,12,12,0.00%
bizapi.csdn.net,0,0.00%,14,14,0.00%
b-gtc.gepush.com,0,0.00%,6,6,0.00%
syz.phic.org.cn,0,0.00%,2,2,0.00%
kunyu.csdn.net,0,0.00%,6,6,0.00%
beacon.tingyun.com,0,0.00%,19,19,0.00%
seapp.stat.360safe.com,0,0.00%,10,10,0.00%
ap5.agora.io,0,0.00%,4,4,0.00%
hik-alicloud.oss-cn-hangzhou.aliyuncs.com,0,0.00%,4,4,0.00%
olapi7.bizport.cn,0,0.00%,2,2,0.00%
crteam.cn,0,0.00%,16,16,0.00%
gdfp.gifshow.com,0,0.00%,8,8,0.00%
www.googletagservices.com,0,0.00%,12,12,0.00%
odr.mookie1.com,0,0.00%,12,12,0.00%
id.rlcdn.com,0,0.00%,14,14,0.00%
us-u.openx.net,0,0.00%,10,10,0.00%
router5.teamviewer.com,0,0.00%,87,87,0.00%
brxt-research.mendeley.com,0,0.00%,2,2,0.00%
support.weixin.qq.com,0,0.00%,30,30,0.00%
fp.msedge.net,0,0.00%,26,26,0.00%
a-0001.a-msedge.net,0,0.00%,6,6,0.00%
cloudrom-global.emui.dbankcloud.com,0,0.00%,2,2,0.00%
metrics.dt.hicloud.com,0,0.00%,2,2,0.00%
r.img.cctvpic.com,0,0.00%,2,2,0.00%
imap.163.com,0,0.00%,34,34,0.00%
p3.img.cctvpic.com,0,0.00%,2,2,0.00%
p.data.cctv.com,0,0.00%,2,2,0.00%
apm.hexin.cn,0,0.00%,20,20,0.00%
waws-prod-sg1-057-feea.southeastasia.cloudapp.azure.com,0,0.00%,6,6,0.00%
nowcoder.cn-hangzhou.log.aliyuncs.com,0,0.00%,2,2,0.00%
pbjs.e-planning.net,0,0.00%,5,5,0.00%
blog.csdn.net,0,0.00%,26,26,0.00%
py.ucas.ac.cn,0,0.00%,2,2,0.00%
sep.ucas.ac.cn,0,0.00%,6,6,0.00%
c.tmyzer.com,0,0.00%,4,4,0.00%
dns.pub,0,0.00%,91,91,0.00%
s.c-ctrip.com,0,0.00%,2,2,0.00%
m.ctrip.com,0,0.00%,2,2,0.00%
spo-ring.msedge.net,0,0.00%,6,6,0.00%
q.qlogo.cn,0,0.00%,4,4,0.00%
oneocsp.microsoft.com,0,0.00%,14,14,0.00%
smtp.nfschina.com,0,0.00%,13,13,0.00%
k-ring.msedge.net,0,0.00%,4,4,0.00%
static-ecst.licdn.com,0,0.00%,5,5,0.00%
cloud.tgpa.qq.com,0,0.00%,4,4,0.00%
hc.tdm.qq.com,0,0.00%,6,6,0.00%
onedscolprdaus02.australiasoutheast.cloudapp.azure.com,0,0.00%,2,2,0.00%
safebrowsing.urlsec.qq.com,0,0.00%,57,57,0.00%
natdetection.onethingpcs.com,0,0.00%,2,2,0.00%
conf-darwin.xycdn.com,0,0.00%,18,18,0.00%
settings-prod-eus2-1.eastus2.cloudapp.azure.com,0,0.00%,3,3,0.00%
author.baidu.com,0,0.00%,3,3,0.00%
mbdp02.bdstatic.com,0,0.00%,1,1,0.00%
compiles.overleaf.com,0,0.00%,4,4,0.00%
home.baidu.com,0,0.00%,2,2,0.00%
i.baidu.com,0,0.00%,1,1,0.00%
help.baidu.com,0,0.00%,2,2,0.00%
isite.baidu.com,0,0.00%,2,2,0.00%
www.beian.gov.cn,0,0.00%,6,6,0.00%
stun.services.mozilla.com,0,0.00%,19,19,0.00%
router11.teamviewer.com,0,0.00%,84,84,0.00%
event-drcn.push.dbankcloud.com,0,0.00%,2,2,0.00%
tp-b.pinduoduo.com,0,0.00%,15,15,0.00%
captive-cidr.origin-apple.com.akadns.net,0,0.00%,12,12,0.00%
35-courier.push.apple.com,0,0.00%,30,30,0.00%
www.googleapis.com,0,0.00%,54,54,0.00%
v.gdt.qq.com,0,0.00%,6,6,0.00%
otheve.beacon.qq.com,0,0.00%,61,61,0.00%
ios.rqd.qq.com,0,0.00%,16,16,0.00%
checkin.gstatic.com,0,0.00%,1,1,0.00%
web.da.mgtv.com,0,0.00%,2,2,0.00%
v2.da.mgtv.com,0,0.00%,2,2,0.00%
ys.da.mgtv.com,0,0.00%,1,1,0.00%
hunantv.m.cn.miaozhen.com,0,0.00%,2,2,0.00%
vt.ipinyou.com,0,0.00%,2,2,0.00%
bv.lnk0.com,0,0.00%,4,4,0.00%
event.csdn.net,0,0.00%,21,21,0.00%
alfred.ixiacom.com,0,0.00%,55,55,0.00%
router7.teamviewer.com,0,0.00%,99,99,0.00%
a.sox.si,0,0.00%,191,191,0.00%
mail.163.com,0,0.00%,93,93,0.00%
pull-lls-spe-l26.douyincdn.com,0,0.00%,11,11,0.00%
drive.wpsdns.com,0,0.00%,22,22,0.00%
whsmarthome.hwcloudtest.cn,0,0.00%,232,232,0.00%
info.lenovo.com.cn,0,0.00%,42,42,0.00%
newclient.map.baidu.com,0,0.00%,4,4,0.00%
client.map.baidu.com,0,0.00%,2,2,0.00%
resolver.dingtalk.com,0,0.00%,5,5,0.00%
ipm.atm.youku.com,0,0.00%,4,4,0.00%
alt8-mtalk.google.com,0,0.00%,2,2,0.00%
router14.teamviewer.com,0,0.00%,124,124,0.00%
mon.snssdk.com,0,0.00%,6,6,0.00%
push-rtmp-spe-l3.douyincdn.com,0,0.00%,8,8,0.00%
worldwide.sogou.com,0,0.00%,4,4,0.00%
vv.video.qq.com,0,0.00%,53,53,0.00%
icns.zui.lenovomm.com,0,0.00%,2,2,0.00%
o1098464.ingest.sentry.io,0,0.00%,6,6,0.00%
pull-flv-l27.douyincdn.com,0,0.00%,11,11,0.00%
pull-flv-f5-enc.flive.douyincdn.com,0,0.00%,12,12,0.00%
push-rtmp-f5-cny.douyincdn.com,0,0.00%,9,9,0.00%
push-rtmp-l27.douyincdn.com,0,0.00%,15,15,0.00%
can-01.t7n4vxsm.dxs5.xyz,0,0.00%,18,18,0.00%
cc.map.qq.com,0,0.00%,7,7,0.00%
wq.jd.com,0,0.00%,2,2,0.00%
devs-data.dutils.com,0,0.00%,2,2,0.00%
www.msn.cn,0,0.00%,54,54,0.00%
api.share.mob.com,0,0.00%,8,8,0.00%
api-fc.dutils.com,0,0.00%,2,2,0.00%
dfe.mic.mob.com,0,0.00%,2,2,0.00%
api-exc.dutils.com,0,0.00%,2,2,0.00%
api.df.mob.com,0,0.00%,2,2,0.00%
ts.qq.com,0,0.00%,82,82,0.00%
api-fd.dutils.com,0,0.00%,2,2,0.00%
api2.openinstall.io,0,0.00%,2,2,0.00%
cgi.connect.qq.com,0,0.00%,6,6,0.00%
bookcommon.reader.qq.com,0,0.00%,2,2,0.00%
api.walsea.com,0,0.00%,4,4,0.00%
ali-stats.jpush.cn,0,0.00%,10,10,0.00%
sis.jpush.io,0,0.00%,6,6,0.00%
m.mpl.dutils.com,0,0.00%,2,2,0.00%
tsis.jpush.cn,0,0.00%,4,4,0.00%
h.m.mpl.dutils.com,0,0.00%,2,2,0.00%
a.qchannel03.cn,0,0.00%,2,2,0.00%
wanproxy-hz.127.net,0,0.00%,2,2,0.00%
c.sayhi.360.cn,0,0.00%,4,4,0.00%
interface3.music.163.com,0,0.00%,14,14,0.00%
b.qchannel03.cn,0,0.00%,2,2,0.00%
d.qchannel03.cn,0,0.00%,2,2,0.00%
loggw.alipay.com,0,0.00%,2,2,0.00%
nsp-contentcenter-h5-drcn.obs.cn-north-2.myhwclouds.com,0,0.00%,2,2,0.00%
yqy2356.melissauvc.com,0,0.00%,12,12,0.00%
pay.weixin.qq.com,0,0.00%,8,8,0.00%
wx.tenpay.com,0,0.00%,4,4,0.00%
vpn.maskvpn.cc,0,0.00%,62,62,0.00%
mobile.yangkeduo.com,0,0.00%,4,4,0.00%
lbs-qiyu.netease.im,0,0.00%,2,2,0.00%
qlbs.map.qq.com,0,0.00%,2,2,0.00%
info.3g.qq.com,0,0.00%,2,2,0.00%
img.pddpic.com,0,0.00%,4,4,0.00%
s.jpush.cn,0,0.00%,8,8,0.00%
easytomessage.com,0,0.00%,2,2,0.00%
hovv.yilanvaas.com,0,0.00%,4,4,0.00%
pmmtk-a.pinduoduo.com,0,0.00%,14,14,0.00%
6zhg.cn.rongnav.com,0,0.00%,2,2,0.00%
pull-rtmp-f29.douyincdn.com,0,0.00%,8,8,0.00%
edge.ivideo.sina.com.cn,0,0.00%,4,4,0.00%
modao.cc,0,0.00%,16,16,0.00%
th.yangkeduo.com,0,0.00%,4,4,0.00%
tne.pinduoduo.com,0,0.00%,2,2,0.00%
api.ivideo.sina.com.cn,0,0.00%,4,4,0.00%
api.pinduoduo.com,0,0.00%,18,18,0.00%
static.walsea.com,0,0.00%,4,4,0.00%
push-rtmp-vr-l3.douyincdn.com,0,0.00%,8,8,0.00%
gd-stats.jpush.cn,0,0.00%,6,6,0.00%
papi.funshion.com,0,0.00%,8,8,0.00%
titan-ws.pinduoduo.com,0,0.00%,4,4,0.00%
ip1880706121.funshion.com,0,0.00%,2,2,0.00%
static.vnpt.vn,0,0.00%,6,6,0.00%
ip1865976387.funshion.com,0,0.00%,2,2,0.00%
windows.msn.cn,0,0.00%,31,31,0.00%
9-courier.push.apple.com,0,0.00%,29,29,0.00%
array503.prod.do.dsp.mp.microsoft.com,0,0.00%,11,11,0.00%
15-courier.push.apple.com,0,0.00%,27,27,0.00%
array513.prod.do.dsp.mp.microsoft.com,0,0.00%,5,5,0.00%
ip1880706122.funshion.com,0,0.00%,4,4,0.00%
pic6.ajkimg.com,0,0.00%,2,2,0.00%
api.map.baidu.com,0,0.00%,16,16,0.00%
ip1865976393.funshion.com,0,0.00%,2,2,0.00%
www.b4p22.com,0,0.00%,1,1,0.00%
reportwpush.58.com,0,0.00%,2,2,0.00%
sec.sginput.qq.com,0,0.00%,6,6,0.00%
nvh6bk7t.mirror.aliyuncs.com,0,0.00%,35,35,0.00%
ip3746756449.funshion.com,0,0.00%,2,2,0.00%
sign.utcsoft.com,0,0.00%,2,2,0.00%
upmobile.v.qq.com,0,0.00%,13,13,0.00%
ip1880706120.funshion.com,0,0.00%,2,2,0.00%
mstat.tpns.tencent.com,0,0.00%,3,3,0.00%
router13.teamviewer.com,0,0.00%,92,92,0.00%
t.dtscout.com,0,0.00%,1,1,0.00%
qdyn.wps.cn,0,0.00%,58,58,0.00%
dualstack-restsdk.amap.com,0,0.00%,7,7,0.00%
xcxt.pinduoduo.com,0,0.00%,2,2,0.00%
xcxapp.pinduoduo.com,0,0.00%,2,2,0.00%
push.hicloud.com,0,0.00%,14,14,0.00%
jgwdb2.gaox.ml,0,0.00%,2,2,0.00%
pss.alicdn.com,0,0.00%,14,14,0.00%
xg.pinduoduo.com,0,0.00%,6,6,0.00%
home.hicloud.com,0,0.00%,190,190,0.00%
profile.accounts.firefox.com,0,0.00%,13,13,0.00%
token.services.mozilla.com,0,0.00%,8,8,0.00%
gs-loc-cn.apple.com,0,0.00%,18,18,0.00%
shortconn.im.qcloud.com,0,0.00%,84,84,0.00%
commimg.pddpic.com,0,0.00%,2,2,0.00%
messaging.engagement.office.com,0,0.00%,9,9,0.00%
vpn.maskvpn.org,0,0.00%,64,64,0.00%
clientlogvodp2p.haplat.net,0,0.00%,4,4,0.00%
ocws.officeapps.live.com,0,0.00%,6,6,0.00%
transit1.wslog.chinanetcenter.com,0,0.00%,4,4,0.00%
sync-1-us-west1-g.sync.services.mozilla.com,0,0.00%,9,9,0.00%
mmsns.c2c.wechat.com,0,0.00%,8,8,0.00%
api.accounts.firefox.com,0,0.00%,5,5,0.00%
p2pstuntest.haplat.net,0,0.00%,4,4,0.00%
xpgw-xcdn.youku.com,0,0.00%,4,4,0.00%
mambap2pvodh5.8686c.com,0,0.00%,4,4,0.00%
captive.apple.com,0,0.00%,11,11,0.00%
kindleshare.cn,0,0.00%,2,2,0.00%
37-courier.push.apple.com,0,0.00%,29,29,0.00%
ldapi.ldmnq.com,0,0.00%,23,23,0.00%
api.zhihu.com,0,0.00%,11,11,0.00%
jp_62.antchatxj.com,0,0.00%,8,8,0.00%
stup7.appmeasurements.com,0,0.00%,4,4,0.00%
bae.appmeasurements.com,0,0.00%,4,4,0.00%
shmmsns.qpic.cn,0,0.00%,70,70,0.00%
array506.prod.do.dsp.mp.microsoft.com,0,0.00%,16,16,0.00%
aedns.weixin.qq.com,0,0.00%,4,4,0.00%
game.weixin.qq.com,0,0.00%,2,2,0.00%
t1.appmeasurements.com,0,0.00%,2,2,0.00%
acs.m.taobao.com,0,0.00%,18,18,0.00%
msgacs.m.taobao.com,0,0.00%,8,8,0.00%
atoken.m.taobao.com,0,0.00%,8,8,0.00%
eco.taobao.com,0,0.00%,8,8,0.00%
interface.bilibili.com,0,0.00%,11,11,0.00%
app-site-association.cdn-apple.com,0,0.00%,4,4,0.00%
apoll.m.taobao.com,0,0.00%,9,9,0.00%
trade-acs.m.taobao.com,0,0.00%,2,2,0.00%
u.y.qq.com,0,0.00%,82,82,0.00%
www.ai-start.com,0,0.00%,2,2,0.00%
apiwmda.58.com.cn,0,0.00%,2,2,0.00%
amdc.m.taobao.com,0,0.00%,4,4,0.00%
rhdc-acs.m.taobao.com,0,0.00%,2,2,0.00%
rc.kite.com,0,0.00%,12,12,0.00%
b4bf120.pd.gladns.com,0,0.00%,6,6,0.00%
b4bf120.pc.gladns.com,0,0.00%,12,12,0.00%
b4bf120.pb.gladns.com,0,0.00%,8,8,0.00%
b4bf120.pa.gladns.com,0,0.00%,10,10,0.00%
b4bf120.cw.glados-config.net,0,0.00%,3,3,0.00%
b4bf120.wz.glados-config.net,0,0.00%,3,3,0.00%
b4bf120.pf.gladns.com,0,0.00%,10,10,0.00%
b4bf120.wx.glados-config.net,0,0.00%,6,6,0.00%
b4bf120.nx.glados-config.net,0,0.00%,4,4,0.00%
b4bf120.td.glados-config.net,0,0.00%,4,4,0.00%
b4bf120.wy.glados-config.net,0,0.00%,3,3,0.00%
b4bf120.ts.glados-config.net,0,0.00%,3,3,0.00%
b4bf120.pg.gladns.com,0,0.00%,11,11,0.00%
b4bf120.pe.gladns.com,0,0.00%,11,11,0.00%
b4bf120.ph.gladns.com,0,0.00%,8,8,0.00%
b4bf120.th.glados-config.net,0,0.00%,3,3,0.00%
b4bf120.tt.glados-config.net,0,0.00%,4,4,0.00%
px.ucweb.com,0,0.00%,9,9,0.00%
12qln2t9.g132d6.cq11344.app-http-dns.ictun.com,0,0.00%,2,2,0.00%
ccpce-cn.consumer.huawei.com,0,0.00%,2,2,0.00%
api.account.xiaomi.com,0,0.00%,6,6,0.00%
12qln2t9.g132d6.cq11344.app-rootca.ictun.com,0,0.00%,2,2,0.00%
pecker-app-v1.ictun.com,0,0.00%,2,2,0.00%
logservice.hicloud.com,0,0.00%,12,12,0.00%
logservice1.hicloud.com,0,0.00%,12,12,0.00%
store.hispace.hicloud.com,0,0.00%,2,2,0.00%
nsp-logservice-hiview-p41-drcn.obs.cn-north-2.myhuaweicloud.com,0,0.00%,5,5,0.00%
cq11344-app-https-api-1.ictun.com,0,0.00%,2,2,0.00%
hwid-drcn.platform.hicloud.com,0,0.00%,19,19,0.00%
oauth-login-drcn.platform.dbankcloud.com,0,0.00%,15,15,0.00%
speaker-drcn.things.hicloud.com,0,0.00%,2,2,0.00%
terms1.hicloud.com,0,0.00%,2,2,0.00%
pmmtk.pinduoduo.com,0,0.00%,6,6,0.00%
cmtw.pinduoduo.com,0,0.00%,10,10,0.00%
adashx.m.taobao.com,0,0.00%,15,15,0.00%
loggw-ex.alipay.com,0,0.00%,9,9,0.00%
tracker.iriseden.eu,0,0.00%,4,4,0.00%
www.letpub.com.cn,0,0.00%,4,4,0.00%
sg.bls.mdt.qq.com,0,0.00%,6,6,0.00%
iupdateplf.yy.com,0,0.00%,4,4,0.00%
livebook.manning.com,0,0.00%,2,2,0.00%
www.manning.com,0,0.00%,2,2,0.00%
config.inmobi.com,0,0.00%,2,2,0.00%
web-drcn.hispace.dbankcloud.cn,0,0.00%,14,14,0.00%
readpaper.com,0,0.00%,14,14,0.00%
sdkgw.map.qq.com,0,0.00%,21,21,0.00%
mx3.qq.com,0,0.00%,2,2,0.00%
mx2.qq.com,0,0.00%,2,2,0.00%
mx1.qq.com,0,0.00%,2,2,0.00%
mime.baidu.com,0,0.00%,9,9,0.00%
h5vv6.video.qq.com,0,0.00%,2,2,0.00%
windows.jingyeqian.com,0,0.00%,8,8,0.00%
api-calendar-drcn.music.dbankcloud.cn,0,0.00%,2,2,0.00%
bluedot.is.autonavi.com.gds.alibabadns.com,0,0.00%,47,47,0.00%
mpvideo.qpic.cn,0,0.00%,8,8,0.00%
1-courier.push.apple.com,0,0.00%,65,65,0.00%
1-courier.sandbox.push.apple.com,0,0.00%,22,22,0.00%
ins-8y4ghcjp.ias.tencent-cloud.net,0,0.00%,4,4,0.00%
graph.microsoft.com,0,0.00%,15,15,0.00%
smarthome.dbankcloud.cn,0,0.00%,2,2,0.00%
bjbgp01.baidupcs.com,0,0.00%,33,33,0.00%
scenario-drcn.things.dbankcloud.cn,0,0.00%,2,2,0.00%
login.wpscdn.cn,0,0.00%,14,14,0.00%
logintcp.wps.cn,0,0.00%,20,20,0.00%
statuse.digitalcertvalidation.com,0,0.00%,4,4,0.00%
mail.nfschina.com,0,0.00%,81,81,0.00%
commimg-1.pddpic.com,0,0.00%,2,2,0.00%
ta.pinduoduo.com,0,0.00%,2,2,0.00%
xfr-ss.getui.com,0,0.00%,7,7,0.00%
jgw-drcn.jos.dbankcloud.cn,0,0.00%,4,4,0.00%
c-ss.getui.com,0,0.00%,4,4,0.00%
th-b.pinduoduo.com,0,0.00%,9,9,0.00%
www.beijing.gov.cn,0,0.00%,2,2,0.00%
grs.hihonorcloud.com,0,0.00%,2,2,0.00%
router8.teamviewer.com,0,0.00%,94,94,0.00%
bugly.qq.com,0,0.00%,23,23,0.00%
unitelogreport.reader.qq.com,0,0.00%,2,2,0.00%
game.eve.mdt.qq.com,0,0.00%,2,2,0.00%
id6.me,0,0.00%,4,4,0.00%
mywap2.icbc.com.cn,0,0.00%,4,4,0.00%
pageviewp.icbc.com.cn,0,0.00%,4,4,0.00%
epass.icbc.com.cn,0,0.00%,4,4,0.00%
blobcollector.events.data.trafficmanager.NET,0,0.00%,4,4,0.00%
gw5.push.mcp.weibo.cn,0,0.00%,4,4,0.00%
mimscmp.icbc.com.cn,0,0.00%,6,6,0.00%
devreaf.icbc.com.cn,0,0.00%,2,2,0.00%
gs-loc-new.ls-apple.com.akadns.net,0,0.00%,6,6,0.00%
addinsinstallation.store.office.com,0,0.00%,2,2,0.00%
wikipedia.firstpartyapps.oaspapps.com,0,0.00%,2,2,0.00%
router6.teamviewer.com,0,0.00%,81,81,0.00%
router15.teamviewer.com,0,0.00%,115,115,0.00%
catchoice.ceping.com,0,0.00%,5,5,0.00%
web.qun.qq.com,0,0.00%,8,8,0.00%
tcbox.baidu.com,0,0.00%,12,12,0.00%
warranty.vivo.com.cn,0,0.00%,2,2,0.00%
servicesupport1.hicloud.com,0,0.00%,2,2,0.00%
abtest.openspeech.cn,0,0.00%,2,2,0.00%
rs-sg.rustdesk.com,0,0.00%,6,6,0.00%
rs-ny.rustdesk.com,0,0.00%,6,6,0.00%
tvax3.sinaimg.cn,0,0.00%,14,14,0.00%
tva1.sinaimg.cn,0,0.00%,4,4,0.00%
v.casmooc.cn,0,0.00%,2,2,0.00%
fsso.cnki.net,0,0.00%,2,2,0.00%
t.kite.com,0,0.00%,21,21,0.00%
seal.websecurity.norton.com,0,0.00%,1,1,0.00%
ins-r23tsuuf.ias.tencent-cloud.net,0,0.00%,34,34,0.00%
pc-api.300624.com,0,0.00%,15,15,0.00%
tva3.sinaimg.cn,0,0.00%,3,3,0.00%
24-courier.push.apple.com,0,0.00%,30,30,0.00%
iphone-ld.origin-apple.com.akadns.net,0,0.00%,8,8,0.00%
xiaodu.baidu.com,0,0.00%,17,17,0.00%
ali-bj-pcdn-30.biliapi.net,0,0.00%,2,2,0.00%
restlbs.map.qq.com,0,0.00%,4,4,0.00%
md.openapi.360.cn,0,0.00%,17,17,0.00%
versioncheck.graylog.com,0,0.00%,2,2,0.00%
q3.qlogo.cn,0,0.00%,2,2,0.00%
stat.y.qq.com,0,0.00%,55,55,0.00%
agoo-report.m.taobao.com,0,0.00%,4,4,0.00%
report.url.cn,0,0.00%,134,134,0.00%
q4.qlogo.cn,0,0.00%,2,2,0.00%
array504.prod.do.dsp.mp.microsoft.com,0,0.00%,49,49,0.00%
array501.prod.do.dsp.mp.microsoft.com,0,0.00%,11,11,0.00%
meta.pinduoduo.com,0,0.00%,6,6,0.00%
sysupgrade.vivo.com.cn,0,0.00%,2,2,0.00%
tsfe.trafficshaping.dsp.mp.microsoft.com,0,0.00%,52,52,0.00%
vcode-od.vivo.com.cn,0,0.00%,4,4,0.00%
ixav-cse.avlyun.com,0,0.00%,2,2,0.00%
weather-community-drcn.weather.dbankcloud.cn,0,0.00%,2,2,0.00%
msch.f.360.cn,0,0.00%,4,4,0.00%
countly.mail.163.com,0,0.00%,7,7,0.00%
data.ab.qq.com,0,0.00%,28,28,0.00%
www.bigbigwork.com,0,0.00%,2,2,0.00%
transfer.ceping.com,0,0.00%,3,3,0.00%
citicbank.ceping.com,0,0.00%,4,4,0.00%
stcms.beisen.com,0,0.00%,2,2,0.00%
message.bilibili.com,0,0.00%,26,26,0.00%
mobilegw.alipay.com,0,0.00%,24,24,0.00%
hao.lenovo.com.cn,0,0.00%,35,35,0.00%
s.1688.com,0,0.00%,2,2,0.00%
nsl.lenovo.com.cn,0,0.00%,32,32,0.00%
www.cnki.net,0,0.00%,8,8,0.00%
t.cnki.net,0,0.00%,2,2,0.00%
kns.cnki.net,0,0.00%,2,2,0.00%
track.cnki.net,0,0.00%,2,2,0.00%
proxy.sogou.com,0,0.00%,2,2,0.00%
app.yinxiang.com,0,0.00%,12,12,0.00%
online.ts.api.xiangtatech.com,0,0.00%,18,18,0.00%
ssl.google-analytics.com,0,0.00%,16,16,0.00%
tpstelemetry.tencent.com,0,0.00%,36,36,0.00%
titan.pinduoduo.com,0,0.00%,4,4,0.00%
tmfsdktcpv4.m.qq.com,0,0.00%,3,3,0.00%
obus-dc20123-cn.heytapmobi.com,0,0.00%,4,4,0.00%
ns1-04.azure-dns.com,0,0.00%,2,2,0.00%
bl.nbmswl.com,0,0.00%,2,2,0.00%
cos.wtaluo.com,0,0.00%,2,2,0.00%
appsec.hicloud.com,0,0.00%,4,4,0.00%
navi.cnki.net,0,0.00%,2,2,0.00%
piccache.cnki.net,0,0.00%,2,2,0.00%
login.cnki.net,0,0.00%,2,2,0.00%
zhifoukeji.datasink.sensorsdata.cn,0,0.00%,2,2,0.00%
flux.iqiyi.com,0,0.00%,34,34,0.00%
httpdns.n.netease.com,0,0.00%,32,32,0.00%
cf.duba.net,0,0.00%,8,8,0.00%
26-courier.push.apple.com,0,0.00%,26,26,0.00%
passport.aliyundrive.com,0,0.00%,5,5,0.00%
log.mmstat.com,0,0.00%,12,12,0.00%
3n.1513ke.ga,0,0.00%,61,61,0.00%
weather.kjjs.360.cn,0,0.00%,63,63,0.00%
dispatch.s.xzdesktop.cqttech.com,0,0.00%,45,45,0.00%
sl-collection.oray.net,0,0.00%,47,47,0.00%
docs.nicehash.com,0,0.00%,160,160,0.00%
ca.minexmr.com,0,0.00%,145,145,0.00%
pool.hashvault.pro,0,0.00%,156,156,0.00%
turtlecoin.herominers.com,0,0.00%,158,158,0.00%
ar.hpool.com,0,0.00%,141,141,0.00%
us1.ethpool.org,0,0.00%,122,122,0.00%
www.fullskystar.top,0,0.00%,156,156,0.00%
ckb.antpool.com,0,0.00%,151,151,0.00%
du.testjj.com,0,0.00%,136,136,0.00%
btm.f2pool.com,0,0.00%,160,160,0.00%
jp.sparkpool.com,0,0.00%,162,162,0.00%
api.nicehash.com,0,0.00%,156,156,0.00%
rx.thegov.win,0,0.00%,142,142,0.00%
mail.nicehash.com,0,0.00%,136,136,0.00%
pool.supportxmr.com,0,0.00%,162,162,0.00%
etc.f2pool.com,0,0.00%,146,146,0.00%
pool.flooder.org,0,0.00%,138,138,0.00%
eth.ss.poolin.com,0,0.00%,126,126,0.00%
asia1.ethpool.org,0,0.00%,156,156,0.00%
eth.antpool.com,0,0.00%,144,144,0.00%
miner.nicehash.com,0,0.00%,140,140,0.00%
monerohash.com,0,0.00%,132,132,0.00%
blog.nicehash.com,0,0.00%,160,160,0.00%
www.jvmonline.com,0,0.00%,154,154,0.00%
smtp.nicehash.com,0,0.00%,158,158,0.00%
penef6f8f734.slushpool.com,0,0.00%,152,152,0.00%
dcr.uupool.cn,0,0.00%,156,156,0.00%
eth.uupool.cn,0,0.00%,158,158,0.00%
git.rancher.io,0,0.00%,313,313,0.00%
api.im.qcloud.com,0,0.00%,81,81,0.00%
w.deepl.com,0,0.00%,9,9,0.00%
uapi.mp.360.cn,0,0.00%,56,56,0.00%
juiceside.net,0,0.00%,2,2,0.00%
events.gfe.nvidia.com,0,0.00%,505,505,0.00%
7jmrbtrvkgcqkldzyob4kotpyvsgz546yvik2xv4rpnfmrhe4imxthqd.tor2web.in,0,0.00%,2,2,0.00%
ustc-edu-cn.mirror.aliyuncs.com,0,0.00%,81,81,0.00%
ant.if.iqiyi.com,0,0.00%,2,2,0.00%
api.mymonero.com,0,0.00%,146,146,0.00%
toa.mygametoa.com,0,0.00%,123,123,0.00%
donate.v2.xmrig.com,0,0.00%,140,140,0.00%
fr.minexmr.com,0,0.00%,160,160,0.00%
ns41.hashvault.pro,0,0.00%,129,129,0.00%
nhmws.nicehash.com,0,0.00%,149,149,0.00%
zec.uupool.cn,0,0.00%,149,149,0.00%
sea.wafflepool.com,0,0.00%,120,120,0.00%
de.minexmr.com,0,0.00%,160,160,0.00%
kmd.antpool.com,0,0.00%,145,145,0.00%
pool-fr.supportxmr.com,0,0.00%,154,154,0.00%
k8s.entrypoint.ops.sparkpool.com,0,0.00%,152,152,0.00%
sg.minexmr.com,0,0.00%,156,156,0.00%
verushash.mine.zergpool.com,0,0.00%,129,129,0.00%
sbtc.uupool.cn,0,0.00%,128,128,0.00%
pool.minexmr.com,0,0.00%,158,158,0.00%
donate.ssl.xmrig.com,0,0.00%,150,150,0.00%
awsmx.f2pool.com,0,0.00%,156,156,0.00%
asia2.ethermine.org,0,0.00%,146,146,0.00%
xmr.flooder.org,0,0.00%,148,148,0.00%
eth.f2pool.com,0,0.00%,151,151,0.00%
btc.f2pool.com,0,0.00%,158,158,0.00%
test.nicehash.com,0,0.00%,154,154,0.00%
dcr.f2pool.com,0,0.00%,156,156,0.00%
b4c.f2pool.com,0,0.00%,154,154,0.00%
ss.antpool.com,0,0.00%,137,137,0.00%
cn.sparkpool.com,0,0.00%,156,156,0.00%
ns11.hashvault.pro,0,0.00%,158,158,0.00%
btw.uupool.cn,0,0.00%,156,156,0.00%
raven.f2pool.com,0,0.00%,148,148,0.00%
pool.minergate.com,0,0.00%,154,154,0.00%
tracker.opentrackr.org,0,0.00%,24,24,0.00%
image.dayi.org.cn,0,0.00%,1,1,0.00%
api.pdfxd.com,0,0.00%,10,10,0.00%
dc1.ksn.kaspersky-labs.com,0,0.00%,31,31,0.00%
2-courier.push.apple.com,0,0.00%,27,27,0.00%
connipv6.tencent.com,0,0.00%,10,10,0.00%
sz2.connipv6.qq.com,0,0.00%,11,11,0.00%
sz.connipv6.qq.com,0,0.00%,11,11,0.00%
sh.connipv6.qq.com,0,0.00%,13,13,0.00%
sh2.connipv6.qq.com,0,0.00%,13,13,0.00%
tj.connipv6.qq.com,0,0.00%,12,12,0.00%
tj2.connipv6.qq.com,0,0.00%,14,14,0.00%
www.wodaywo100001.com,0,0.00%,158,158,0.00%
stratum.okpool.me,0,0.00%,154,154,0.00%
i.y.qq.com,0,0.00%,16,16,0.00%
pingfore.qq.com,0,0.00%,12,12,0.00%
c.y.qq.com,0,0.00%,39,39,0.00%
tmead.y.qq.com,0,0.00%,8,8,0.00%
stat6.y.qq.com,0,0.00%,12,12,0.00%
fliplc.getxlx.com,0,0.00%,162,162,0.00%
adstats.tencentmusic.com,0,0.00%,18,18,0.00%
wup.browser.qq.com,0,0.00%,82,82,0.00%
pop.cstnet.cn,0,0.00%,6,6,0.00%
dav.qq.com,0,0.00%,38,38,0.00%
mail.ios.ac.cn,0,0.00%,3,3,0.00%
snz04pap002.storage.live.com,0,0.00%,6,6,0.00%
mailer.nicehash.com,0,0.00%,150,150,0.00%
conna.gj.qq.com,0,0.00%,28,28,0.00%
connb.gj.qq.com,0,0.00%,31,31,0.00%
connect.unity.cn,0,0.00%,39,39,0.00%
developer.unity.cn,0,0.00%,9,9,0.00%
weather2db.cmcm.com,0,0.00%,25,25,0.00%
gitlab.com,0,0.00%,47,47,0.00%
rt-p.kugou.com,0,0.00%,2,2,0.00%
client.teamviewer.com,0,0.00%,21,21,0.00%
cdp.cloud.unity3d.com,0,0.00%,19,19,0.00%
cerebrum.emotivcloud.com,0,0.00%,15,15,0.00%
doh-jp.blahdns.com,0,0.00%,2,2,0.00%
hub5p.sandai.net,0,0.00%,1280,1280,0.00%
lookup.nextcloud.com,0,0.00%,280,280,0.00%
ping3.teamviewer.com,0,0.00%,71,71,0.00%
ping.dgraph.io,0,0.00%,199,199,0.00%
tracker.1337x.org,0,0.00%,135,135,0.00%
pan.cstcloud.cn,0,0.00%,6,6,0.00%
correctxt.baidu.com,0,0.00%,4,4,0.00%
retracker.lanta-net.ru,0,0.00%,144,144,0.00%
tracker.etree.org,0,0.00%,6,6,0.00%
im.eulix.xyz,0,0.00%,50,50,0.00%
admin.kdsec.org,0,0.00%,22,22,0.00%
cdn.digicertcdn.com,0,0.00%,4,4,0.00%
nseed.minigame.qq.com,0,0.00%,2,2,0.00%
master6.teamviewer.com,0,0.00%,8,8,0.00%
iguvmbs.roygxe.xyz,0,0.00%,18,18,0.00%
60-fps.org,0,0.00%,6,6,0.00%
www.all4nothin.net,0,0.00%,4,4,0.00%
lens.zhihu.com,0,0.00%,15,15,0.00%
t.overflow.biz,0,0.00%,64,64,0.00%
stun.miwifi.com,0,0.00%,3,3,0.00%
qbwup.imtt.qq.com,0,0.00%,30,30,0.00%
tmall.com,0,0.00%,6,6,0.00%
weather-api.extfans.com,0,0.00%,28,28,0.00%
kubernetes-charts.storage.googleapis.com,0,0.00%,12,12,0.00%
6ahddutb1ucc3cp.ru,0,0.00%,72,72,0.00%
go.minigame.qq.com,0,0.00%,2,2,0.00%
ptlogin2.qq.com,0,0.00%,6,6,0.00%
www.bitseduce.com,0,0.00%,10,10,0.00%
tracker.fixr.pro,0,0.00%,24,24,0.00%
stun1.douyucdn.cn,0,0.00%,36,36,0.00%
tracker.pow7.com,0,0.00%,33,33,0.00%
seed.minigame.qq.com,0,0.00%,2,2,0.00%
www.yuwabits.net,0,0.00%,48,48,0.00%
t2.pow7.com,0,0.00%,36,36,0.00%
www.biztorrents.com,0,0.00%,10,10,0.00%
torrents.hikarinokiseki.com,0,0.00%,10,10,0.00%
t.sina.com.cn,0,0.00%,6,6,0.00%
fileplatform.api.weibo.com,0,0.00%,8,8,0.00%
picupload.weibo.com,0,0.00%,10,10,0.00%
mail.sina.com.cn,0,0.00%,16,16,0.00%
t.showone.com.cn,0,0.00%,6,6,0.00%
tianya.cn,0,0.00%,6,6,0.00%
my.tianya.cn,0,0.00%,6,6,0.00%
sohu.com,0,0.00%,8,8,0.00%
3g.tianya.cn,0,0.00%,8,8,0.00%
bbs.tianya.cn,0,0.00%,8,8,0.00%
msg.baidu.com,0,0.00%,8,8,0.00%
upload.tieba.baidu.com,0,0.00%,8,8,0.00%
clubajax.autohome.com.cn,0,0.00%,8,8,0.00%
www.youtube.com,0,0.00%,36,36,0.00%
www.youtube-nocookie.com,0,0.00%,12,12,0.00%
icloud.com,0,0.00%,8,8,0.00%
p45-contentws.icloud.com,0,0.00%,9,9,0.00%
dns.baidu.com,0,0.00%,8,8,0.00%
pcsdata.baidu.com,0,0.00%,9,9,0.00%
weiyun.com,0,0.00%,8,8,0.00%
yinxiang.com,0,0.00%,8,8,0.00%
docin.com,0,0.00%,8,8,0.00%
outlook.live.com,0,0.00%,11,11,0.00%
login.yahoo.com,0,0.00%,8,8,0.00%
yeah.net,0,0.00%,8,8,0.00%
sina.com.cn,0,0.00%,8,8,0.00%
m0.mail.sina.cn,0,0.00%,8,8,0.00%
qiye.163.com,0,0.00%,8,8,0.00%
mail.10086.cn,0,0.00%,10,10,0.00%
appmail.mail.10086.cn,0,0.00%,8,8,0.00%
chat.google.com,0,0.00%,12,12,0.00%
news.google.com,0,0.00%,8,8,0.00%
www.google.ae,0,0.00%,12,12,0.00%
www.google.al,0,0.00%,8,8,0.00%
www.google.co.ao,0,0.00%,10,10,0.00%
www.google.as,0,0.00%,14,14,0.00%
www.google.ba,0,0.00%,12,12,0.00%
www.google.be,0,0.00%,12,12,0.00%
www.google.bg,0,0.00%,12,12,0.00%
video.weibocdn.com,0,0.00%,10,10,0.00%
picupload.service.weibo.com,0,0.00%,12,12,0.00%
upload.video.sina.com.cn,0,0.00%,10,10,0.00%
api.t.sina.com.cn,0,0.00%,6,6,0.00%
www.google.bi,0,0.00%,14,14,0.00%
www.google.bj,0,0.00%,10,10,0.00%
www.google.bs,0,0.00%,16,16,0.00%
www.google.cd,0,0.00%,16,16,0.00%
sinaapp.com,0,0.00%,6,6,0.00%
t.p4p.sina.com.cn,0,0.00%,6,6,0.00%
www.tianya.cn,0,0.00%,6,6,0.00%
wireless.tianya.cn,0,0.00%,6,6,0.00%
www.google.cg,0,0.00%,16,16,0.00%
www.google.ci,0,0.00%,16,16,0.00%
www.google.cl,0,0.00%,14,14,0.00%
www.google.cn,0,0.00%,20,20,0.00%
www.google.cv,0,0.00%,12,12,0.00%
www.google.cz,0,0.00%,10,10,0.00%
www.google.dj,0,0.00%,16,16,0.00%
www.google.dm,0,0.00%,16,16,0.00%
baidu.com,0,0.00%,12,12,0.00%
skype.com,0,0.00%,8,8,0.00%
photo.tianya.cn,0,0.00%,6,6,0.00%
blog.tianya.cn,0,0.00%,8,8,0.00%
m.tianya.cn,0,0.00%,8,8,0.00%
wapp.baidu.com,0,0.00%,8,8,0.00%
uploadphotos.baidu.com,0,0.00%,8,8,0.00%
autohome.com.cn,0,0.00%,8,8,0.00%
youtube.googleapis.com,0,0.00%,8,8,0.00%
youtu.be,0,0.00%,8,8,0.00%
sharepoint.com,0,0.00%,16,16,0.00%
web.wechat.com,0,0.00%,8,8,0.00%
file2.wx.qq.com,0,0.00%,10,10,0.00%
office.com,0,0.00%,8,8,0.00%
login.microsoft.com,0,0.00%,10,10,0.00%
bing.com,0,0.00%,18,18,0.00%
fanyi.baidu.com,0,0.00%,15,15,0.00%
www.dropbox.com,0,0.00%,16,16,0.00%
p45-mailws.icloud.com,0,0.00%,10,10,0.00%
sharefile.com,0,0.00%,8,8,0.00%
c3.pcs.baidu.com,0,0.00%,8,8,0.00%
www.google.cf,0,0.00%,12,12,0.00%
www.google.cm,0,0.00%,12,12,0.00%
www.google.am,0,0.00%,12,12,0.00%
www.google.at,0,0.00%,12,12,0.00%
www.google.az,0,0.00%,12,12,0.00%
www.google.ca,0,0.00%,14,14,0.00%
pcs.baidu.com,0,0.00%,9,9,0.00%
wiz.cn,0,0.00%,8,8,0.00%
doc88.com,0,0.00%,8,8,0.00%
gmail.com,0,0.00%,8,8,0.00%
outlook.office.com,0,0.00%,32,32,0.00%
mail.126.com,0,0.00%,17,17,0.00%
up.sinastorage.com,0,0.00%,8,8,0.00%
mail.263.net,0,0.00%,8,8,0.00%
www.google.de,0,0.00%,14,14,0.00%
jamboard.google.com,0,0.00%,8,8,0.00%
meet.google.com,0,0.00%,8,8,0.00%
photos.google.com,0,0.00%,8,8,0.00%
www.google.ad,0,0.00%,8,8,0.00%
www.google.bf,0,0.00%,10,10,0.00%
www.google.bt,0,0.00%,12,12,0.00%
www.google.by,0,0.00%,12,12,0.00%
www.google.ch,0,0.00%,14,14,0.00%
comm.weixinbridge.com,0,0.00%,4,4,0.00%
login.windows.net,0,0.00%,10,10,0.00%
www.getdropbox.com,0,0.00%,13,13,0.00%
www.google.dk,0,0.00%,14,14,0.00%
wx2.qq.com,0,0.00%,8,8,0.00%
file.wx.qq.com,0,0.00%,8,8,0.00%
live.com,0,0.00%,8,8,0.00%
t1.pow7.com,0,0.00%,50,50,0.00%
retracker.mgts.by,0,0.00%,156,156,0.00%
www.mvgroup.org,0,0.00%,34,34,0.00%
onedriveclucprodbn20014.blob.core.windows.net,0,0.00%,10,10,0.00%
paint.ludashi.com,0,0.00%,4,4,0.00%
report.meituan.com,0,0.00%,8,8,0.00%
s.w.org,0,0.00%,9,9,0.00%
s2.symcb.com,0,0.00%,13,13,0.00%
sat02pap005.storage.live.com,0,0.00%,11,11,0.00%
sealine.youku.com,0,0.00%,8,8,0.00%
sf.symcd.com,0,0.00%,9,9,0.00%
sharkwsbj.sankuai.com,0,0.00%,8,8,0.00%
sl-log.oray.net,0,0.00%,46,46,0.00%
slp2p-east-std1033.oray.net,0,0.00%,6,6,0.00%
slp2p-east-std61.oray.net,0,0.00%,7,7,0.00%
slp2px-east-std31.oray.net,0,0.00%,12,12,0.00%
spinfo.wps.cn,0,0.00%,6,6,0.00%
tip.soku.com,0,0.00%,8,8,0.00%
umwatson.events.data.microsoft.com,0,0.00%,42,42,0.00%
user.youku.com,0,0.00%,8,8,0.00%
v.youku.com,0,0.00%,8,8,0.00%
v2.reachmax.cn,0,0.00%,10,10,0.00%
vip.youku.com,0,0.00%,8,8,0.00%
web.meituan.com,0,0.00%,10,10,0.00%
www.sogou.com,0,0.00%,22,22,0.00%
www.urbandictionary.com,0,0.00%,8,8,0.00%
www.youku.com,0,0.00%,14,14,0.00%
share.camoe.cn,0,0.00%,12,12,0.00%
frp.zwlin.top,0,0.00%,38,38,0.00%
open.acgtracker.com,0,0.00%,4,4,0.00%
online.s.xzdesktop.cqttech.com,0,0.00%,39,39,0.00%
i.gridsumdissector.com,0,0.00%,3,3,0.00%
mediaclub.tv,0,0.00%,4,4,0.00%
sdk1xyajs.data.kuiniuca.com,0,0.00%,11,11,0.00%
tracker.files.fm,0,0.00%,6,6,0.00%
nodestore-kiros-prod-lb-132549143.us-east-1.elb.amazonaws.com,0,0.00%,14,14,0.00%
tracker.frozen-layer.net,0,0.00%,6,6,0.00%
api.network.apm.miwifi.com,0,0.00%,1,1,0.00%
configsvr.openmsf.3g.qq.com,0,0.00%,2,2,0.00%
onedriveclucprodbn20010.blob.core.windows.net,0,0.00%,9,9,0.00%
skyapi.live.net,0,0.00%,9,9,0.00%
sv.symcd.com,0,0.00%,15,15,0.00%
yk-ssp.ad.youku.com,0,0.00%,8,8,0.00%
ynuf.aliapp.org,0,0.00%,15,15,0.00%
ynuf.alipay.com,0,0.00%,12,12,0.00%
youku.com,0,0.00%,8,8,0.00%
api-kos.wps.cn,0,0.00%,8,8,0.00%
wsgo.minigame.qq.com,0,0.00%,2,2,0.00%
12-courier.push.apple.com,0,0.00%,27,27,0.00%
secure.pow7.com,0,0.00%,46,46,0.00%
denis.stalker.upeer.me,0,0.00%,20,20,0.00%
www.tvnihon.com,0,0.00%,70,70,0.00%
tracker.gbitt.info,0,0.00%,6,6,0.00%
filehelper.weixin.qq.com,0,0.00%,344,344,0.00%
tracker.tfile.co,0,0.00%,2,2,0.00%
tracker.publicbt.com,0,0.00%,1,1,0.00%
shiyd.cn,0,0.00%,6,6,0.00%
www.zotero.org,0,0.00%,16,16,0.00%
r4---sn-2x3elnez.gvt1.com,0,0.00%,15,15,0.00%
d3ra9679oeq3gx.cloudfront.net,0,0.00%,2,2,0.00%
tracker.minglong.org,0,0.00%,6,6,0.00%
www.tg5tj2cu.com,0,0.00%,6,6,0.00%
h4.trakx.nibba.trade,0,0.00%,13,13,0.00%
nvidia.github.io,0,0.00%,4,4,0.00%
warehouse.leapmotion.com,0,0.00%,2,2,0.00%
apphub.aliyuncs.com,0,0.00%,20,20,0.00%
www.bit-hdtv.com,0,0.00%,62,62,0.00%
www.jetbrains.com,0,0.00%,26,26,0.00%
tracker.anirena.com,0,0.00%,2,2,0.00%
tracker.nucozer-tracker.ml,0,0.00%,2,2,0.00%
ccm-frontier.feishu.cn,0,0.00%,5,5,0.00%
r4---sn-2x3elnel.gvt1.com,0,0.00%,3,3,0.00%
onedriveclucproddm20018.blob.core.windows.net,0,0.00%,12,12,0.00%
gzc-download.weiyun.com,0,0.00%,2,2,0.00%
odoooacnz-my.sharepoint.com,0,0.00%,19,19,0.00%
tr.abirxo.cf,0,0.00%,50,50,0.00%
app-b04.lp1.npns.srv.nintendo.net,0,0.00%,4,4,0.00%
tracker.tasvideos.org,0,0.00%,64,64,0.00%
yapi.kdsec.org,0,0.00%,1118,1118,0.00%
array611.prod.do.dsp.mp.microsoft.com,0,0.00%,16,16,0.00%
saladict.crimx.com,0,0.00%,10,10,0.00%
www.legittorrents.info,0,0.00%,4,4,0.00%
www.blackcats-games.net,0,0.00%,2,2,0.00%
atrack.pow7.com,0,0.00%,48,48,0.00%
tunnel.cfw.trustedsource.org,0,0.00%,12,12,0.00%
seeds-darwin.xycdn.com,0,0.00%,13,13,0.00%
dx.doi.org,0,0.00%,8,8,0.00%
gaea.meituan.com,0,0.00%,10,10,0.00%
ic-business.ks3-cn-beijing.ksyun.com,0,0.00%,10,10,0.00%
bt.firebit.org,0,0.00%,6,6,0.00%
iframe.videodelivery.net,0,0.00%,12,12,0.00%
www.lixiangdao.vip,0,0.00%,6,6,0.00%
tracker.trancetraffic.com,0,0.00%,6,6,0.00%
rq.lbcct.cloud.duba.net,0,0.00%,55,55,0.00%
www.freerainbowtables.com,0,0.00%,6,6,0.00%
tracker.openzim.org,0,0.00%,8,8,0.00%
home.yxgz.vip,0,0.00%,4,4,0.00%
sh-download.weiyun.com,0,0.00%,2,2,0.00%
tracker.internetwarriors.net,0,0.00%,8,8,0.00%
cqc-download.weiyun.com,0,0.00%,2,2,0.00%
ww3.mediaclub.tv,0,0.00%,2,2,0.00%
pc-diffpack.wps.cn,0,0.00%,6,6,0.00%
push.thanos.ams.eulix.xyz,0,0.00%,20,20,0.00%
api.ultimaker.com,0,0.00%,26,26,0.00%
tracker.filepit.to,0,0.00%,4,4,0.00%
tr.cili001.com,0,0.00%,6,6,0.00%
0d.kebhana.mx,0,0.00%,6,6,0.00%
a.tampermonkey.net,0,0.00%,10,10,0.00%
cloudflarestream.com,0,0.00%,9,9,0.00%
mq.dataservices.hp.com,0,0.00%,12,12,0.00%
onedriveclucproddm20040.blob.core.windows.net,0,0.00%,10,10,0.00%
beertracker.ml,0,0.00%,4,4,0.00%
bluebird-hd.org,0,0.00%,18,18,0.00%
push.zhihu.com,0,0.00%,4,4,0.00%
aegis.qq.com,0,0.00%,42,42,0.00%
irrenhaus.dyndns.dk,0,0.00%,4,4,0.00%
all4nothin.net,0,0.00%,6,6,0.00%
cache.yisu.com,0,0.00%,6,6,0.00%
tracker.nanoha.org,0,0.00%,6,6,0.00%
openbittorrent.com,0,0.00%,4,4,0.00%
tracker.frozen-layer.com,0,0.00%,8,8,0.00%
xtremewrestlingtorrents.net,0,0.00%,6,6,0.00%
dmd.metaservices.microsoft.com,0,0.00%,19,19,0.00%
embed.cloudflarestream.com,0,0.00%,8,8,0.00%
filters.adtidy.org,0,0.00%,9,9,0.00%
tracker.moeking.me,0,0.00%,6,6,0.00%
q.soft.360.cn,0,0.00%,16,16,0.00%
q.cnblogs.com,0,0.00%,60,60,0.00%
recycle.i5.cn,0,0.00%,22,22,0.00%
update-drcn.platform.hicloud.com,0,0.00%,16,16,0.00%
hub5u.hz.sandai.net,0,0.00%,19,19,0.00%
app4.i4.cn,0,0.00%,21,21,0.00%
custom-cursor.com,0,0.00%,4,4,0.00%
api.dida365.com,0,0.00%,59,59,0.00%
serviceplus.phytium.com.cn,0,0.00%,43,43,0.00%
bgpv4.music.ntes53.netease.com,0,0.00%,4,4,0.00%
api.yiban.io,0,0.00%,34,34,0.00%
hub5pnc.hz.sandai.net,0,0.00%,19,19,0.00%
app.huabao.360.cn,0,0.00%,50,50,0.00%
download.jetbrains.com,0,0.00%,8,8,0.00%
domainask.weibanio.cn,0,0.00%,48,48,0.00%
color.docer.wps.cn,0,0.00%,27,27,0.00%
onedscolprdcus02.centralus.cloudapp.azure.com,0,0.00%,2,2,0.00%
rm-2zelg248g7y2034w7do.mysql.rds.aliyuncs.com,0,0.00%,46,46,0.00%
feedback.youdao.com,0,0.00%,4,4,0.00%
url.i4.cn,0,0.00%,6,6,0.00%
d-updater.i4.cn,0,0.00%,4,4,0.00%
ios.pclog.i4.cn,0,0.00%,22,22,0.00%
mam.netease.com,0,0.00%,29,29,0.00%
array801.prod.do.dsp.mp.microsoft.com,0,0.00%,18,18,0.00%
array812.prod.do.dsp.mp.microsoft.com,0,0.00%,8,8,0.00%
hxhvnih.nyjvbs.xyz,0,0.00%,12,12,0.00%
www.tm.lg.prod.aadmsa.akadns.net,0,0.00%,6,6,0.00%
api.shoptoit.net,0,0.00%,12,12,0.00%
cdn.onenote.net,0,0.00%,38,38,0.00%
minorshort.weixin.qq.com,0,0.00%,65,65,0.00%
array810.prod.do.dsp.mp.microsoft.com,0,0.00%,10,10,0.00%
array809.prod.do.dsp.mp.microsoft.com,0,0.00%,16,16,0.00%
array806.prod.do.dsp.mp.microsoft.com,0,0.00%,20,20,0.00%
1582937130534912.mqrest.cn-qingdao-public.aliyuncs.com,0,0.00%,6,6,0.00%
v2.cs3.duba.net,0,0.00%,38,38,0.00%
appleimap.163.com,0,0.00%,17,17,0.00%
pds.ess.apple.com,0,0.00%,2,2,0.00%
imhub5pr.hz.sandai.net,0,0.00%,2,2,0.00%
hub5pr.hz.sandai.net,0,0.00%,2,2,0.00%
onedscolprdeus01.eastus.cloudapp.azure.com,0,0.00%,2,2,0.00%
www.microvirt.com,0,0.00%,4,4,0.00%
nstool.netease.com,0,0.00%,19,19,0.00%
only-982678-124-16-140-6.nstool.netease.com,0,0.00%,1,1,0.00%
yiban.io,0,0.00%,21,21,0.00%
configuration.apple.com,0,0.00%,23,23,0.00%
ac.dun.163.com,0,0.00%,23,23,0.00%
update.client.163.com,0,0.00%,41,41,0.00%
www.update.microsoft.com,0,0.00%,8,8,0.00%
watson.microsoft.com,0,0.00%,4,4,0.00%
orcid.org,0,0.00%,8,8,0.00%
web.push.126.net,0,0.00%,10,10,0.00%
notify.adobe.io,0,0.00%,28,28,0.00%
ac.dun.163yun.com,0,0.00%,10,10,0.00%
cdn.fwupd.org,0,0.00%,9,9,0.00%
ppa.launchpad.net,0,0.00%,12,12,0.00%
archive.ubuntukylin.com,0,0.00%,6,6,0.00%
packages.microsoft.com,0,0.00%,11,11,0.00%
teams.events.data.microsoft.com,0,0.00%,19,19,0.00%
security.ubuntu.com,0,0.00%,16,16,0.00%
cn.archive.ubuntu.com,0,0.00%,19,19,0.00%
lenovo.archive.canonical.com,0,0.00%,2,2,0.00%
dashboard.snapcraft.io,0,0.00%,5,5,0.00%
odrs.gnome.org,0,0.00%,4,4,0.00%
array813.prod.do.dsp.mp.microsoft.com,0,0.00%,5,5,0.00%
tools.google.com,0,0.00%,6,6,0.00%
account.jetbrains.com,0,0.00%,24,24,0.00%
forum.qt.io,0,0.00%,43,43,0.00%
ditu.baidu.com,0,0.00%,10,10,0.00%
api.naea1.uds.lenovo.com,0,0.00%,9,9,0.00%
sourcegraph.com,0,0.00%,32,32,0.00%
eo.dbpedia.org,0,0.00%,1,1,0.00%
d21wlyhffxxqkt.cloudfront.net,0,0.00%,4,4,0.00%
doh.zjurl.cn,0,0.00%,18,18,0.00%
slack.com,0,0.00%,35,35,0.00%
kns.duba.net,0,0.00%,24,24,0.00%
boot-02.net.anydesk.com,0,0.00%,127,127,0.00%
uptime.sangfor.net,0,0.00%,2,2,0.00%
dev.ditu.live.com,0,0.00%,83,83,0.00%
d15wdfb2rw9n2y.cloudfront.net,0,0.00%,7,7,0.00%
api.distill.io,0,0.00%,38,38,0.00%
ocsp.verisign.com,0,0.00%,18,18,0.00%
dl.fedoraproject.org,0,0.00%,2,2,0.00%
fedora.riscv.rocks,0,0.00%,2,2,0.00%
pc-api.wondershare.cc,0,0.00%,15,15,0.00%
dgapi.zhhainiao.com,0,0.00%,49,49,0.00%
udp.cloud.duba.net,0,0.00%,7,7,0.00%
consumerapps.mcafee.com,0,0.00%,5,5,0.00%
dsm01pap002.storage.live.com,0,0.00%,4,4,0.00%
pcw-api.iqiyi.com,0,0.00%,10,10,0.00%
bubble.ic.ksosoft.com,0,0.00%,22,22,0.00%
servicediscovery.ccs.mcafee.com,0,0.00%,12,12,0.00%
basic-enroll.ccs.mcafee.com,0,0.00%,6,6,0.00%
microsoftgraph.chinacloudapi.cn,0,0.00%,5,5,0.00%
p3n9w31.cloud,0,0.00%,36,36,0.00%
c-uaa.if.iqiyi.com,0,0.00%,2,2,0.00%
msg.video.qiyi.com,0,0.00%,2,2,0.00%
bleisure.ba.com,0,0.00%,1,1,0.00%
api-std.sunlogin.oray.com,0,0.00%,74,74,0.00%
rgmb.classic.kicksite.net,0,0.00%,1,1,0.00%
router12.teamviewer.com,0,0.00%,54,54,0.00%
hsk-api.oray.com,0,0.00%,10,10,0.00%
wm.xiajunhuagong.cn.w.cdngslb.com,0,0.00%,4,4,0.00%
dy.xiajunhuagong.cn.w.cdngslb.com,0,0.00%,2,2,0.00%
t-safe.2345.cc,0,0.00%,2,2,0.00%
app.smartmailcloud.com,0,0.00%,12,12,0.00%
imap.mail.me.com.akadns.net,0,0.00%,12,12,0.00%
imap-mail.outlook.com,0,0.00%,19,19,0.00%
broadcast2.distill.io,0,0.00%,37,37,0.00%
array612.prod.do.dsp.mp.microsoft.com,0,0.00%,9,9,0.00%
ledger.bt.co,0,0.00%,4,4,0.00%
acc.qq.com,0,0.00%,75,75,0.00%
data.hicloud.com,0,0.00%,8,8,0.00%
g.msn.com,0,0.00%,2,2,0.00%
open.u-tools.cn,0,0.00%,32,32,0.00%
o137163.ingest.sentry.io,0,0.00%,10,10,0.00%
azwcus1-client-s.gateway.messenger.live.com,0,0.00%,6,6,0.00%
imap.sina.com,0,0.00%,61,61,0.00%
go.ie.sogou.com,0,0.00%,47,47,0.00%
mail.triinnboc.com,0,0.00%,2,2,0.00%
notify3.note.youdao.com,0,0.00%,30,30,0.00%
s00.upd.kaspersky.com,0,0.00%,4,4,0.00%
visualstudio-devdiv-c2s.msedge.net,0,0.00%,33,33,0.00%
litedev.ys7.com,0,0.00%,10,10,0.00%
inversine.elseway.tk,0,0.00%,61,61,0.00%
vcityteam.github.io,0,0.00%,1,1,0.00%
ct.duba.net,0,0.00%,28,28,0.00%
www.ztb.im,0,0.00%,6,6,0.00%
jrebel.npegeek.com,0,0.00%,7,7,0.00%
dlied6.qq.com,0,0.00%,59,59,0.00%
stun.qqlive.qq.com,0,0.00%,40,40,0.00%
d3e5zkjv0mw5t1.cloudfront.net,0,0.00%,4,4,0.00%
onedscolprduks00.uksouth.cloudapp.azure.com,0,0.00%,6,6,0.00%
wsus.f.360.cn,0,0.00%,18,18,0.00%
jtwlgl.nm.chinamobile.com,0,0.00%,4,4,0.00%
www.a.shifen.com,0,0.00%,44,44,0.00%
tracker4.itzmx.com,0,0.00%,6,6,0.00%
watson.telemetry.microsoft.com,0,0.00%,7,7,0.00%
ntemp01.boom.skin,0,0.00%,11,11,0.00%
jp17.boom.skin,0,0.00%,9,9,0.00%
edge-microsoft-com.dual-a-0036.a-msedge.NET,0,0.00%,12,12,0.00%
hq.sinajs.cn,0,0.00%,49,49,0.00%
sec23summer.usenix.hotcrp.com,0,0.00%,5,5,0.00%
dsm01pap008.storage.live.com,0,0.00%,6,6,0.00%
onedriveclucproddm20021.blob.core.windows.net,0,0.00%,4,4,0.00%
deault-exp-tas-com.e-0014.e-msedge.NET,0,0.00%,6,6,0.00%
doh-fi.blahdns.com,0,0.00%,6,6,0.00%
www.w3.org,0,0.00%,3288,3288,0.00%
435749f6f4f748a5821bee8bcb13087c.fp.measure.office.com,0,0.00%,1,1,0.00%
ataprod.remarqable.com,0,0.00%,10,10,0.00%
tuna05.mcddns01.com,0,0.00%,52,52,0.00%
dict.youdao.com,0,0.00%,42,42,0.00%
news.qhstatic.com,0,0.00%,15,15,0.00%
mcafee-sustainability.azurewebsites.net,0,0.00%,98,98,0.00%
clientstream.launchdarkly.com,0,0.00%,12,12,0.00%
dr.ime.baidu.com,0,0.00%,47,47,0.00%
config.mobile.kugou.com,0,0.00%,14,14,0.00%
router10.teamviewer.com,0,0.00%,92,92,0.00%
shdf01-iopq.cgroads.com,0,0.00%,14,14,0.00%
api.weixin.qq.com,0,0.00%,6,6,0.00%
817beb9c-rh6hs0-rrfsly-dmr0.pccw.alrihla.net,0,0.00%,7,7,0.00%
update.drivergenius.com,0,0.00%,20,20,0.00%
report.meeting.tencent.com,0,0.00%,3,3,0.00%
userweatherapi-xzdesktop.cqttech.com,0,0.00%,3,3,0.00%
conn.wemeet.tencent.com,0,0.00%,3,3,0.00%
onedriveclucprodbn20040.blob.core.windows.net,0,0.00%,9,9,0.00%
hello-sherlock.github.io,0,0.00%,1,1,0.00%
contentsec.ac.cn,0,0.00%,5,5,0.00%
todolist.redirect.xzdesktop.cqttech.com,0,0.00%,19,19,0.00%
marketplace.visualstudio.com,0,0.00%,14,14,0.00%
learn.unity.com,0,0.00%,4,4,0.00%
report.51nwt.com,0,0.00%,12,12,0.00%
clients.config.office.net,0,0.00%,9,9,0.00%
config.push.sogou.com,0,0.00%,2,2,0.00%
slscr.update.microsoft.com,0,0.00%,78,78,0.00%
update.khd.2345.cc,0,0.00%,7,7,0.00%
push.khd.2345.cc,0,0.00%,20,20,0.00%
mhxzxhd.wmupd.com,0,0.00%,5,5,0.00%
browser.events.data.msn.com,0,0.00%,10,10,0.00%
max-l.mediav.com,0,0.00%,21,21,0.00%
gtm-sg-6wr2u201t05.gtm-i2d4.com,0,0.00%,33,33,0.00%
api.300624.com,0,0.00%,2,2,0.00%
ts.helper.2345.cc,0,0.00%,12,12,0.00%
yj.52pcfree.com,0,0.00%,2,2,0.00%
searchrecommend.kugou.com,0,0.00%,28,28,0.00%
www.codota.com,0,0.00%,8,8,0.00%
cloudconfig.jetbrains.com,0,0.00%,11,11,0.00%
trans.hiido.com,0,0.00%,8,8,0.00%
yeconfig.game.yy.com,0,0.00%,6,6,0.00%
config.hiido.com,0,0.00%,4,4,0.00%
ylog.hiido.com,0,0.00%,6,6,0.00%
u.jia.mn,0,0.00%,2,2,0.00%
presence.api.drift.com,0,0.00%,8,8,0.00%
apis-mix-pub.maxhub.vip,0,0.00%,9,9,0.00%
stat.game.yy.com,0,0.00%,7,7,0.00%
dsm01pap005.storage.live.com,0,0.00%,8,8,0.00%
onedriveclucprodbn20007.blob.core.windows.net,0,0.00%,2,2,0.00%
identify.zhhainiao.com,0,0.00%,2,2,0.00%
edgeassetservice.azureedge.net,0,0.00%,12,12,0.00%
onedriveclucprodbn20020.blob.core.windows.net,0,0.00%,9,9,0.00%
be59399.pd.gladns.com,0,0.00%,4,4,0.00%
be59399.pf.gladns.com,0,0.00%,4,4,0.00%
be59399.pb.gladns.com,0,0.00%,8,8,0.00%
be59399.pc.gladns.com,0,0.00%,4,4,0.00%
be59399.ph.gladns.com,0,0.00%,8,8,0.00%
be59399.pa.gladns.com,0,0.00%,4,4,0.00%
be59399.pg.gladns.com,0,0.00%,4,4,0.00%
be59399.pe.gladns.com,0,0.00%,4,4,0.00%
interface.music.163.com,0,0.00%,13,13,0.00%
huggingface.co,0,0.00%,15,15,0.00%
article.cnjournals.com,0,0.00%,5,5,0.00%
dns.rubyfish.cn,0,0.00%,142,142,0.00%
dns.alidns.com,0,0.00%,43,43,0.00%
array615.prod.do.dsp.mp.microsoft.com,0,0.00%,10,10,0.00%
disc601.prod.do.dsp.mp.microsoft.com,0,0.00%,17,17,0.00%
www.cloudflare.com,0,0.00%,14,14,0.00%
ide.liuyingyong.cn,0,0.00%,6,6,0.00%
syzs.qq.com,0,0.00%,3,3,0.00%
service-cn.hwccpc.com,0,0.00%,4,4,0.00%
yybadaccess.3g.qq.com,0,0.00%,6,6,0.00%
license.unity.cn,0,0.00%,2,2,0.00%
list.wallpaper.cloud.duba.net,0,0.00%,8,8,0.00%
wh.vipguanjia.net,0,0.00%,7,7,0.00%
ss-prod-an1-notif-19.aws.adobess.com,0,0.00%,2,2,0.00%
pop3.nfschina.com,0,0.00%,4,4,0.00%
update-khd.2345.cc,0,0.00%,41,41,0.00%
mcs.snssdk.com,0,0.00%,10,10,0.00%
discuss.pytorch.org,0,0.00%,3,3,0.00%
stat.lianmeng.360.cn,0,0.00%,9,9,0.00%
sfstat.lianmeng.360.cn,0,0.00%,6,6,0.00%
sp4.tf.360.cn,0,0.00%,7,7,0.00%
o1224273.ingest.sentry.io,0,0.00%,6,6,0.00%
repo.hortonworks.com,0,0.00%,8,8,0.00%
wns2-sg2p.wns.windows.com,0,0.00%,2,2,0.00%
array604.prod.do.dsp.mp.microsoft.com,0,0.00%,3,3,0.00%
tips.ime.baidu.com,0,0.00%,7,7,0.00%
www.hilton.com,0,0.00%,4,4,0.00%
fast.fonts.net,0,0.00%,4,4,0.00%
hilton.cdn-v3.conductrics.net,0,0.00%,2,2,0.00%
www.figma.com,0,0.00%,100,100,0.00%
91920a6655024c3bbbad50d3958e724c.nrb.footprintdns.com,0,0.00%,1,1,0.00%
szcloud.baidu.com,0,0.00%,5,5,0.00%
pop.ym.163.com,0,0.00%,6,6,0.00%
mobilelog.kugou.com,0,0.00%,2,2,0.00%
cbwh5s4.i3zmbs.com,0,0.00%,1,1,0.00%
fpc.msedge.net,0,0.00%,3,3,0.00%
bf08412nhq.bf.dynatrace.com,0,0.00%,4,4,0.00%
mailhz.qiye.163.com,0,0.00%,3,3,0.00%
f10.baidu.com,0,0.00%,2,2,0.00%
159-226-5-174_s-23-32-236-243_ts-1661277004-clienttons-s.akamaihd.net,0,0.00%,1,1,0.00%
t7rallqxzodvuyyfcnga-pttdjv-2ec39af8f-clientnsv4-s.akamaihd.net,0,0.00%,1,1,0.00%
dpm.demdex.net,0,0.00%,4,4,0.00%
4dc2aa82bc5e.cdn4.forter.com,0,0.00%,4,4,0.00%
smetric.hilton.com,0,0.00%,4,4,0.00%
cm.everesttech.net,0,0.00%,4,4,0.00%
cdnjs.cloudflare.com,0,0.00%,6,6,0.00%
prt.jss.com.cn,0,0.00%,6,6,0.00%
time.asia.apple.com,0,0.00%,32,32,0.00%
xfer.10jqka.com.cn,0,0.00%,5,5,0.00%
s.thsi.cn,0,0.00%,30,30,0.00%
help-tower.2345.cc,0,0.00%,47,47,0.00%
array605.prod.do.dsp.mp.microsoft.com,0,0.00%,21,21,0.00%
onedriveclucproddm20046.blob.core.windows.net,0,0.00%,8,8,0.00%
analytics.getpostman.com,0,0.00%,19,19,0.00%
activation.unity.cn,0,0.00%,2,2,0.00%
11-courier.push.apple.com,0,0.00%,30,30,0.00%
pop.exmail.qq.com,0,0.00%,8,8,0.00%
e10370.d.akamaiedge.NET,0,0.00%,4,4,0.00%
nexus-websocket-a.intercom.io,0,0.00%,32,32,0.00%
newxmp.rcv.sandai.net,0,0.00%,5,5,0.00%
paradromic.info,0,0.00%,4,4,0.00%
p2pupgrade.gamedl.qq.com,0,0.00%,31,31,0.00%
stat.gamedl.qq.com,0,0.00%,33,33,0.00%
ps2.gamedl.qq.com,0,0.00%,33,33,0.00%
config.gamedl.qq.com,0,0.00%,32,32,0.00%
p2pupdate.gamedl.qq.com,0,0.00%,29,29,0.00%
data.vipguanjia.net,0,0.00%,6,6,0.00%
router1.teamviewer.com,0,0.00%,49,49,0.00%
array601.prod.do.dsp.mp.microsoft.com,0,0.00%,15,15,0.00%
jp05-vm0.entry.srthdw.art,0,0.00%,4,4,0.00%
jp01-vm0.entry.srthdw.art,0,0.00%,5,5,0.00%
localhost,0,0.00%,472,472,0.00%
server.reverse.ac.cn,0,0.00%,136,136,0.00%
wspri.coinall.ltd,0,0.00%,34,34,0.00%
gzyd.lanyunshi.cc,0,0.00%,9,9,0.00%
rsync.deepin.com,0,0.00%,2,2,0.00%
musicps.p2p.qq.com,0,0.00%,34,34,0.00%
23-92-30-53.3f5ffcbecff340969874c9eb90a37eeb.plex.direct,0,0.00%,1,1,0.00%
ntp.aliyun.com,0,0.00%,71,71,0.00%
g.ceipmsn.com,0,0.00%,6,6,0.00%
mirror.iscas.ac.cn,0,0.00%,76,76,0.00%
weather-data.apple.com.akadns.net,0,0.00%,26,26,0.00%
downloads.yoctoproject.org,0,0.00%,388,388,0.00%
az575602.vo.msecnd.net,0,0.00%,4,4,0.00%
dhupdateprod.blob.core.windows.net,0,0.00%,6,6,0.00%
chat.api.autohome.com.cn,0,0.00%,6,6,0.00%
33aef1e.ne.gladns.com,0,0.00%,8,8,0.00%
beacons4.gvt2.com,0,0.00%,13,13,0.00%
mirrors.163.com,0,0.00%,9,9,0.00%
update.cs2c.com.cn,0,0.00%,6,6,0.00%
7195c67.ph.gladns.com,0,0.00%,4,4,0.00%
mirrors.rit.edu,0,0.00%,2,2,0.00%
array505.prod.do.dsp.mp.microsoft.com,0,0.00%,2,2,0.00%
onedscolprdwus09.westus.cloudapp.azure.com,0,0.00%,2,2,0.00%
rsync.repo.almalinux.org,0,0.00%,2,2,0.00%
static-api.monknow.com,0,0.00%,2,2,0.00%
socc2022.hotcrp.com,0,0.00%,8,8,0.00%
mirror.us.leaseweb.net,0,0.00%,2,2,0.00%
baoku-safe.2345.cc,0,0.00%,2,2,0.00%
update-ruanjian.2345.cc,0,0.00%,2,2,0.00%
rj-ts.2345.cc,0,0.00%,2,2,0.00%
api.raese.top,0,0.00%,16,16,0.00%
meeting.tencent.com,0,0.00%,12,12,0.00%
localhost.localdomain,0,0.00%,10,10,0.00%
mirrors.tuna.tsinghua.edu.cn,0,0.00%,14,14,0.00%
mirrorz.org,0,0.00%,8,8,0.00%
windows.kite.com,0,0.00%,18,18,0.00%
zhushou.huihui.cn,0,0.00%,12,12,0.00%
a.w.bilicdn1.com,0,0.00%,16,16,0.00%
r2---sn-ni5eln7l.gvt1.com,0,0.00%,4,4,0.00%
k8s.gcr.io,0,0.00%,10,10,0.00%
comet.jianguoyun.com,0,0.00%,18,18,0.00%
settings-prod-sea-2.southeastasia.cloudapp.azure.com,0,0.00%,13,13,0.00%
88dsf5l.003.1.mclqp.link,0,0.00%,6,6,0.00%
t-ruanjian.2345.cc,0,0.00%,2,2,0.00%
msg.video.dns.iqiyi.com,0,0.00%,10,10,0.00%
cmonitor.iqiyi.com,0,0.00%,4,4,0.00%
is.snssdk.com,0,0.00%,8,8,0.00%
cpan-rsync.perl.org,0,0.00%,2,2,0.00%
ixin.itrus.com.cn,0,0.00%,4,4,0.00%
iknow.baidu.com,0,0.00%,4,4,0.00%
iepl03.nnooddee.cyou,0,0.00%,8,8,0.00%
pop.sina.com,0,0.00%,6,6,0.00%
www.macpaw.com,0,0.00%,10,10,0.00%
software.macpaw.com,0,0.00%,6,6,0.00%
rsync.alpinelinux.org,0,0.00%,2,2,0.00%
api.cloud.tenda.com.cn,0,0.00%,119,119,0.00%
xgpolardb.mysql.polardb.rds.aliyuncs.com,0,0.00%,1746,1746,0.00%
ntd-asus-2014b-en.fbs20.trendmicro.com,0,0.00%,6,6,0.00%
poll.exmail.qq.com,0,0.00%,40,40,0.00%
qup.b.qianxin.com,0,0.00%,78,78,0.00%
ip.42.pl,0,0.00%,298,298,0.00%
es.proj217.app.kdsec.org,0,0.00%,118,118,0.00%
assets.contentstack.io,0,0.00%,360,360,0.00%
r3---sn-2x3elnee.gvt1.com,0,0.00%,6,6,0.00%
cloud.videojj.com,0,0.00%,6,6,0.00%
pgw-tel-cld-sl.alicdn.com,0,0.00%,10,10,0.00%
cn-hangzhou.axt.aliyun.com,0,0.00%,30,30,0.00%
cn-qingdao.axt.aliyun.com,0,0.00%,30,30,0.00%
submit.iacr.org,0,0.00%,4,4,0.00%
cntr.wps.cn,0,0.00%,32,32,0.00%
c.hljzfkyy.com,0,0.00%,556,556,0.00%
tw-gx-1.dnspro.icu,0,0.00%,4,4,0.00%
visualstudio-devdiv-c2s-msedge-net.e-0009.e-msedge.net,0,0.00%,6,6,0.00%
cn-beijing.axt.aliyun.com,0,0.00%,24,24,0.00%
pcapp-update.youku.com,0,0.00%,6,6,0.00%
prod.nexusrules.live.com.akadns.net,0,0.00%,8,8,0.00%
n23.boom.skin,0,0.00%,13,13,0.00%
lcznqafr.nodelist.xyz,0,0.00%,30,30,0.00%
cn-zhangjiakou.axt.aliyun.com,0,0.00%,24,24,0.00%
doh.opendns.com,0,0.00%,22,22,0.00%
a.passcloud.xyz,0,0.00%,9,9,0.00%
doh.buzz,0,0.00%,18,18,0.00%
pcapp-push.youku.com,0,0.00%,4,4,0.00%
www.nowcoder.com,0,0.00%,14,14,0.00%
ping.manjaro.org,0,0.00%,28,28,0.00%
www.deepl.com,0,0.00%,2,2,0.00%
appdownload.deepl.com,0,0.00%,2,2,0.00%
nowpick.nowcoder.com,0,0.00%,12,12,0.00%
ntemp20.boom.skin,0,0.00%,31,31,0.00%
cn-hongkong.axt.aliyun.com,0,0.00%,24,24,0.00%
j.v4.2.kiki789.com,0,0.00%,24,24,0.00%
eu-west-1.axt.aliyun.com,0,0.00%,6,6,0.00%
www.jd.com,0,0.00%,707,707,0.00%
deault-exp-tas-com.e-0014.e-msedge.net,0,0.00%,46,46,0.00%
osint.bambenekconsulting.com,0,0.00%,10,10,0.00%
szshort.weixin.qq.com,0,0.00%,16,16,0.00%
hb-b.services.vnc.com,0,0.00%,71,71,0.00%
i1.c.eset.com,0,0.00%,2,2,0.00%
update2.wps.cn,0,0.00%,4,4,0.00%
updatepro.wps.cn,0,0.00%,6,6,0.00%
acfsnui7geismdxwansql59rlcjkhc34syupzetume.k2h4.com,0,0.00%,44,44,0.00%
au.download.windowsupdate.com,0,0.00%,35,35,0.00%
hb-a.services.vnc.com,0,0.00%,71,71,0.00%
kt-prod.ess.apple.com,0,0.00%,16,16,0.00%
eas.outlook.com,0,0.00%,4,4,0.00%
www.aliyun.com,0,0.00%,8,8,0.00%
hb-c.services.vnc.com,0,0.00%,72,72,0.00%
center.bleachcarnival.com,0,0.00%,84,84,0.00%
data.bleachcarnival.com,0,0.00%,46,46,0.00%
user.cn.union.longu.xyz,0,0.00%,42,42,0.00%
devpay.cn.sy.longu.xyz,0,0.00%,40,40,0.00%
locprod2-elb-us-west-2.prod.mozaws.net,0,0.00%,20,20,0.00%
qmzgh5gm.gameserver.youxigu.com,0,0.00%,42,42,0.00%
qmzgh5s2301.gameserver.youxigu.com,0,0.00%,36,36,0.00%
www.sina.com,0,0.00%,10,10,0.00%
gitter.im,0,0.00%,8,8,0.00%
sdl.360safe.com,0,0.00%,130,130,0.00%
geo-applefinance-cache.internal.query.g03.yahoodns.net,0,0.00%,4,4,0.00%
748049e45d87b8c7.jijifun.com,0,0.00%,2,2,0.00%
cdn.yinxiang.com,0,0.00%,2,2,0.00%
1.courier-sandbox-push-apple.com.akadns.net,0,0.00%,19,19,0.00%
28.courier-push-apple.com.akadns.net,0,0.00%,2,2,0.00%
1.courier-push-apple.com.akadns.net,0,0.00%,10,10,0.00%
cdn-9f456ph4.slt.sched.tdnsv8.com,0,0.00%,2,2,0.00%
us-sandbox-courier-4.push-apple.com.akadns.net,0,0.00%,16,16,0.00%
weather-data.apple.com,0,0.00%,54,54,0.00%
swh.app,0,0.00%,20,20,0.00%
sdk.api.bjshcw.com,0,0.00%,8,8,0.00%
kikyo-rest.app.kdsec.org,0,0.00%,14,14,0.00%
cx.soft.360.cn,0,0.00%,51,51,0.00%
i3.c.eset.com,0,0.00%,2,2,0.00%
link.springer.com,0,0.00%,5,5,0.00%
www.sciencedirect.com,0,0.00%,6,6,0.00%
www.engineeringvillage.com,0,0.00%,6,6,0.00%
dl.acm.org,0,0.00%,9,9,0.00%
apabi.las.ac.cn,0,0.00%,6,6,0.00%
bjvip.las.ac.cn,0,0.00%,6,6,0.00%
www.las.ac.cn,0,0.00%,6,6,0.00%
gpd.las.ac.cn,0,0.00%,6,6,0.00%
pis-pcdn.youku.com,0,0.00%,8,8,0.00%
cdnus.copydesign.net,0,0.00%,6,6,0.00%
long.iwifi.360.cn,0,0.00%,10,10,0.00%
healthsession.things.dbankcloud.com,0,0.00%,4,4,0.00%
ws2.leetcode.cn,0,0.00%,2,2,0.00%
array608.prod.do.dsp.mp.microsoft.com,0,0.00%,14,14,0.00%
mail.foodbeauty.ga,0,0.00%,1,1,0.00%
architectsnearme.co.uk,0,0.00%,1,1,0.00%
44-courier.push.apple.com,0,0.00%,25,25,0.00%
p215-contacts.icloud.com.cn,0,0.00%,2,2,0.00%
msgacs.youku.com,0,0.00%,6,6,0.00%
fanyi.qq.com,0,0.00%,3,3,0.00%
doh.dns.sb,0,0.00%,6,6,0.00%
dashenga.com,0,0.00%,4,4,0.00%
qmzgh5s5286.gameserver.youxigu.com,0,0.00%,4,4,0.00%
updatecollect.wps.cn,0,0.00%,2,2,0.00%
4-courier.push.apple.com,0,0.00%,26,26,0.00%
musa-550-fall-2021.github.io,0,0.00%,1,1,0.00%
pypi.org,0,0.00%,11240,11240,0.00%
bggts547gukhvmf4cgandlgxxphengxovoyo6ewhns5qmmb2b5oi43yd.tor2web.in,0,0.00%,14,14,0.00%
us-v20.events.data.microsoft.com,0,0.00%,110,110,0.00%
sh.madagent.tm,0,0.00%,5,5,0.00%
ncc.avast.com,0,0.00%,20,20,0.00%
usa1v2.jsssline.top,0,0.00%,24,24,0.00%
dpi.networkorder.komect.com,0,0.00%,3,3,0.00%
appexorch.bestsdwan.com,0,0.00%,14,14,0.00%
winatp-gw-cus3.microsoft.com,0,0.00%,6,6,0.00%
pr3.getnjnd.com,0,0.00%,8,8,0.00%
sh.0xbadc0de.stream,0,0.00%,3,3,0.00%
t1.dxqjy.top,0,0.00%,2,2,0.00%
saludloprado.xpyri-staging.com,0,0.00%,1,1,0.00%
tiantang.mogencloud.com,0,0.00%,6,6,0.00%
relay-6810dbc0.net.anydesk.com.cn,0,0.00%,29,29,0.00%
dc1-file.ksn.kaspersky-labs.com,0,0.00%,2,2,0.00%
apc.antiy.net.cn,0,0.00%,117,117,0.00%
iepupdate.antiy.cn,0,0.00%,118,118,0.00%
s.360.cn,0,0.00%,129,129,0.00%
clk.lenovo.com.cn,0,0.00%,9,9,0.00%
c26s2.jamjams3.net,0,0.00%,8,8,0.00%
fmt2.link.ac.cn,0,0.00%,54,54,0.00%
allall01.baidupcs.com,0,0.00%,43,43,0.00%
l.qq.com,0,0.00%,2,2,0.00%
p.l.qq.com,0,0.00%,2,2,0.00%
ilofeudo.com.ar,0,0.00%,1,1,0.00%
dp3.qq.com,0,0.00%,6,6,0.00%
cm.l.qq.com,0,0.00%,4,4,0.00%
f1604a02-cdb8-457a-8369-6a64e4922e70.zj.node.touhou.earth,0,0.00%,14,14,0.00%
98d033b8-6928-4e27-99ab-142ed34f9491.zj.node.touhou.earth,0,0.00%,18,18,0.00%
dcd0a341-43f5-4258-97ec-a1ed2ba50173.gz.node.touhou.earth,0,0.00%,11,11,0.00%
83041227-55a7-4080-b7e1-9dfc7478ddb0.gz.node.touhou.earth,0,0.00%,20,20,0.00%
48712c51-0c8a-458a-b53f-cbc3e1c93e20.hk.node.touhou.earth,0,0.00%,8,8,0.00%
33837ddc-243b-4f60-91c1-11bd9b602eed.hk.node.touhou.earth,0,0.00%,7,7,0.00%
ba911c47-b38f-4d0b-af5b-3bfc71980995.hk.node.touhou.earth,0,0.00%,6,6,0.00%
4f38f6b4-bed0-40e9-aad8-72a2bc218407.zj.node.touhou.earth,0,0.00%,6,6,0.00%
49e89cc2-696a-4683-ba3e-60304878a4ff.jp.node.touhou.earth,0,0.00%,8,8,0.00%
0b32cd5b-e021-4031-81f6-98a411d66ca1.jp.node.touhou.earth,0,0.00%,8,8,0.00%
3ba0c177-1b23-42a6-be9d-a8bdf1c2bb22.hk.node.touhou.earth,0,0.00%,42,42,0.00%
wpad.com,0,0.00%,10,10,0.00%
p218-caldav.icloud.com.cn,0,0.00%,4,4,0.00%
pgyapi-adv.oray.net,0,0.00%,2,2,0.00%
d3pi17oyma2pxs.cloudfront.net,0,0.00%,12,12,0.00%
oaagent.baidu.com,0,0.00%,16,16,0.00%
agd.p.360.cn,0,0.00%,18,18,0.00%
pgy-prm02.oray.net,0,0.00%,2,2,0.00%
pgysle-client-adv02.oray.net,0,0.00%,2,2,0.00%
pgy-pubsub01.oray.net,0,0.00%,2,2,0.00%
api100-eeft-gateway-quic-hl.feishu.cn,0,0.00%,2,2,0.00%
tnc3-bjlgy.feishu.cn,0,0.00%,2,2,0.00%
pgyp2p-east-prm01.oray.net,0,0.00%,2,2,0.00%
qing.wpsdns.com,0,0.00%,2,2,0.00%
d9caa6e02c990b0a.jijifun.com,0,0.00%,16,16,0.00%
119.t.keepitpumpin.io,0,0.00%,2,2,0.00%
dispatch.ts.api.xiangtatech.com,0,0.00%,18,18,0.00%
launcher-public-service-prod06.ol.epicgames.com,0,0.00%,10,10,0.00%
ntp.ntsc.ac.cn,0,0.00%,64,64,0.00%
api.openweathermap.org,0,0.00%,6,6,0.00%
google.cn,0,0.00%,4,4,0.00%
wx1.qq.com,0,0.00%,12,12,0.00%
az667904.vo.msecnd.net,0,0.00%,58,58,0.00%
targetednotifications-tm.trafficmanager.net,0,0.00%,17,17,0.00%
oss.hpconnected.com,0,0.00%,9,9,0.00%
ns1.stc1.tdnsdl1.cn,0,0.00%,2,2,0.00%
stun-a1.qq.com,0,0.00%,2,2,0.00%
cryptoworld.co.uk,0,0.00%,1,1,0.00%
api.basedata.union.longu.xyz,0,0.00%,194,194,0.00%
0-courier.push.apple.com,0,0.00%,2,2,0.00%
p211-imap.mail.icloud.com.cn,0,0.00%,2,2,0.00%
msgstore.www.notion.so,0,0.00%,8,8,0.00%
exp.notion.so,0,0.00%,8,8,0.00%
33-courier.push.apple.com,0,0.00%,29,29,0.00%
intf-pc.iquicksee.com,0,0.00%,4,4,0.00%
bk.ps2.gamedl.qq.com,0,0.00%,19,19,0.00%
sdup.360.cn,0,0.00%,36,36,0.00%
play-with.instana.io,0,0.00%,2,2,0.00%
www2.public-trust.com,0,0.00%,10,10,0.00%
blacklist.tampermonkey.net,0,0.00%,9,9,0.00%
pcfg.wps.cn,0,0.00%,57,57,0.00%
access-tel-i.alicdn.com,0,0.00%,6,6,0.00%
account.youku.com,0,0.00%,6,6,0.00%
apimobile.meituan.com,0,0.00%,8,8,0.00%
c.dun.163.com,0,0.00%,10,10,0.00%
cyes.youku.com,0,0.00%,6,6,0.00%
fourier.alibaba.com,0,0.00%,8,8,0.00%
tracker.gigatorrents.ws,0,0.00%,4,4,0.00%
zgrefgd03.standurl.xyz,0,0.00%,4,4,0.00%
masters-tb.com,0,0.00%,4,4,0.00%
rs-cn.rustdesk.com,0,0.00%,4,4,0.00%
vps02.net.orel.ru,0,0.00%,2,2,0.00%
bt.okmp3.ru,0,0.00%,24,24,0.00%
www.datastudy.cc,0,0.00%,4,4,0.00%
hydra.plan9-ns1.com,0,0.00%,8,8,0.00%
erickson514-my.sharepoint.com,0,0.00%,30,30,0.00%
torrent.fedoraproject.org,0,0.00%,6,6,0.00%
data-bg.net,0,0.00%,4,4,0.00%
api.i-meto.com,0,0.00%,6,6,0.00%
appct.jianguoyun.com,0,0.00%,6,6,0.00%
appsec-mobile.meituan.com,0,0.00%,10,10,0.00%
cad.youku.com,0,0.00%,6,6,0.00%
common.cnblogs.com,0,0.00%,10,10,0.00%
crash2.zhihu.com,0,0.00%,10,10,0.00%
dav.jianguoyun.com,0,0.00%,12,12,0.00%
dd.meituan.com,0,0.00%,8,8,0.00%
download.pinyin.sogou.com,0,0.00%,31,31,0.00%
dup.baidustatic.com,0,0.00%,32,32,0.00%
userinfo.docer.wps.cn,0,0.00%,4,4,0.00%
www.onlinedo.cn,0,0.00%,2,2,0.00%
xbtrutor.com,0,0.00%,4,4,0.00%
cu1pehnswss01.servicebus.windows.net,0,0.00%,6,6,0.00%
p01330820392.huyacdn.xyz,0,0.00%,61,61,0.00%
tracker.aeerso.space,0,0.00%,1,1,0.00%
title.mgt.xboxlive.com,0,0.00%,4,4,0.00%
uf-api6-client.ksord.com,0,0.00%,4,4,0.00%
bttracker.debian.org,0,0.00%,4,4,0.00%
qq.com,0,0.00%,4,4,0.00%
open.trackerlist.xyz,0,0.00%,12,12,0.00%
tracker.xn--vzyr4p.top,0,0.00%,4,4,0.00%
btracker.top,0,0.00%,4,4,0.00%
tracker.corpscorp.online,0,0.00%,6,6,0.00%
acctcdnvzeuno.azureedge.net,0,0.00%,4,4,0.00%
torrent.unix-ag.uni-kl.de,0,0.00%,6,6,0.00%
dr.f.360.cn,0,0.00%,6,6,0.00%
tracker.open-internet.nl,0,0.00%,12,12,0.00%
apib.stapi.me,0,0.00%,3,3,0.00%
kunpeng.csdn.net,0,0.00%,18,18,0.00%
plus.wps.cn,0,0.00%,5,5,0.00%
link.csdn.net,0,0.00%,4,4,0.00%
drive.kdocs.cn,0,0.00%,8,8,0.00%
flbgpi.meiquankongjian.com,0,0.00%,4,4,0.00%
tracker.moeblog.cn,0,0.00%,16,16,0.00%
ocsp.quovadisoffshore.com,0,0.00%,6,6,0.00%
tr.fuckbitcoin.xyz,0,0.00%,4,4,0.00%
cc-api-data.adobe.io,0,0.00%,14,14,0.00%
master13.teamviewer.com,0,0.00%,6,6,0.00%
retracker.sevstar.net,0,0.00%,12,12,0.00%
datascene.net,0,0.00%,4,4,0.00%
ztxdjj-my.sharepoint.com,0,0.00%,18,18,0.00%
inf-faas.meituan.com,0,0.00%,4,4,0.00%
int.dpool.sina.com.cn,0,0.00%,12,12,0.00%
iyes.youku.com,0,0.00%,4,4,0.00%
mapi.dianping.com,0,0.00%,4,4,0.00%
mlog.meituan.com,0,0.00%,4,4,0.00%
mmhead.c2c.wechat.com,0,0.00%,4,4,0.00%
onedriveclucprodbn20004.blob.core.windows.net,0,0.00%,9,9,0.00%
mrodevicemgr.officeapps.live.com,0,0.00%,31,31,0.00%
14-courier.push.apple.com,0,0.00%,27,27,0.00%
odobagg-my.sharepoint.com,0,0.00%,10,10,0.00%
bt.zlofenix.org,0,0.00%,4,4,0.00%
b23.tv,0,0.00%,5,5,0.00%
captcha.zhihu.com,0,0.00%,6,6,0.00%
n.guanjia.qq.com,0,0.00%,6,6,0.00%
weby.aaas.org,0,0.00%,6,6,0.00%
www.skeimg.com,0,0.00%,1,1,0.00%
s2.xoimg.com,0,0.00%,2,2,0.00%
www.kanjiantu.com,0,0.00%,6,6,0.00%
legittorrents.info,0,0.00%,2,2,0.00%
tr.highstar.shop,0,0.00%,4,4,0.00%
tracker.iamhansen.xyz,0,0.00%,4,4,0.00%
p0.ssl.qhimg.com,0,0.00%,4,4,0.00%
pc.pay.youku.com,0,0.00%,4,4,0.00%
pgw-cld-s.alicdn.com,0,0.00%,4,4,0.00%
ping.cloud.tencent.com,0,0.00%,4,4,0.00%
pss-s.alicdn.com,0,0.00%,4,4,0.00%
pu-kos.ks3-cn-beijing.ksyun.com,0,0.00%,4,4,0.00%
qinfo.wps.cn,0,0.00%,9,9,0.00%
plussvr.wps.cn,0,0.00%,4,4,0.00%
tracker.vectahosting.eu,0,0.00%,12,12,0.00%
asst-stat.ksord.com,0,0.00%,4,4,0.00%
miaowu.baidu.com,0,0.00%,4,4,0.00%
21.telegream.online,0,0.00%,2,2,0.00%
open.nyap2p.com,0,0.00%,2,2,0.00%
ieonlinews.microsoft.com,0,0.00%,21,21,0.00%
t.acg.rip,0,0.00%,6,6,0.00%
onedriveclucproddm20038.blob.core.windows.net,0,0.00%,8,8,0.00%
www.jianshu.com,0,0.00%,3,3,0.00%
i.csdn.net,0,0.00%,4,4,0.00%
px.ads.linkedin.cn,0,0.00%,4,4,0.00%
px.ads.linkedin.com,0,0.00%,7,7,0.00%
ww62.uatracker.net,0,0.00%,28,28,0.00%
trackme.theom.nz,0,0.00%,4,4,0.00%
count.cnblogs.com,0,0.00%,6,6,0.00%
time-macos.apple.com,0,0.00%,8,8,0.00%
49-courier.push.apple.com,0,0.00%,28,28,0.00%
1337.abcvg.info,0,0.00%,4,4,0.00%
tracker.lelux.fi,0,0.00%,3,3,0.00%
torrent.ubuntu.com,0,0.00%,4,4,0.00%
tr.abiir.top,0,0.00%,4,4,0.00%
tracker.yarr.pt,0,0.00%,1,1,0.00%
yisuapi.yisu.com,0,0.00%,4,4,0.00%
service.dg.wps.cn,0,0.00%,4,4,0.00%
in.hceok.com,0,0.00%,4,4,0.00%
chihaya-heroku.120181311.xyz,0,0.00%,4,4,0.00%
download.api.bsb.baidu.com,0,0.00%,9,9,0.00%
honeycomb.wps.cn,0,0.00%,26,26,0.00%
r1---sn-2x3elnee.gvt1.com,0,0.00%,8,8,0.00%
data-vef.xboxlive.com,0,0.00%,6,6,0.00%
torrenttracker.nwc.acsalaska.net,0,0.00%,6,6,0.00%
tr.burnabyhighstar.com,0,0.00%,4,4,0.00%
os2-7.nigirocloud.com,0,0.00%,10,10,0.00%
os2-8.nigirocloud.com,0,0.00%,12,12,0.00%
nl1-1.nigirocloud.com,0,0.00%,10,10,0.00%
dyncli.ping-ipv6.com,0,0.00%,1151,1151,0.00%
nl1-2.nigirocloud.com,0,0.00%,10,10,0.00%
nl1-3.nigirocloud.com,0,0.00%,10,10,0.00%
us2-1.nigirocloud.com,0,0.00%,8,8,0.00%
us2-2.nigirocloud.com,0,0.00%,9,9,0.00%
us2-3.nigirocloud.com,0,0.00%,11,11,0.00%
us2-4.nigirocloud.com,0,0.00%,10,10,0.00%
us3-1.nigirocloud.com,0,0.00%,11,11,0.00%
us3-2.nigirocloud.com,0,0.00%,11,11,0.00%
us3-3.nigirocloud.com,0,0.00%,11,11,0.00%
us3-4.nigirocloud.com,0,0.00%,11,11,0.00%
us3-5.nigirocloud.com,0,0.00%,11,11,0.00%
us3-6.nigirocloud.com,0,0.00%,11,11,0.00%
us3-7.nigirocloud.com,0,0.00%,11,11,0.00%
us3-8.nigirocloud.com,0,0.00%,9,9,0.00%
ap15ad.cdn.node.a.ddns-ounk.xyz,0,0.00%,67,67,0.00%
ehs.cas.cn,0,0.00%,2,2,0.00%
pcstat.kugou.com,0,0.00%,18,18,0.00%
upd.sangfor.com.cn,0,0.00%,148,148,0.00%
gateway.kugou.com,0,0.00%,19,19,0.00%
apidns.kwd.inkuai.com,0,0.00%,21,21,0.00%
cloudinfo.rising.com.cn,0,0.00%,111,111,0.00%
mesh.if.iqiyi.com,0,0.00%,11,11,0.00%
login.tailscale.com,0,0.00%,144,144,0.00%
linux.kite.com,0,0.00%,4,4,0.00%
kiteweb.b-cdn.net,0,0.00%,4,4,0.00%
objects.githubusercontent.com,0,0.00%,2,2,0.00%
jjm2473.github.io,0,0.00%,1,1,0.00%
logintcpnv.wps.cn,0,0.00%,8,8,0.00%
msgcenter.wps.cn,0,0.00%,20,20,0.00%
gfe.nvidia.com,0,0.00%,23,23,0.00%
array808.prod.do.dsp.mp.microsoft.com,0,0.00%,11,11,0.00%
cloud.streamsets.com,0,0.00%,10,10,0.00%
vpn.ios.ac.cn,0,0.00%,12,12,0.00%
push.services.mozilla.com,0,0.00%,27,27,0.00%
s.xinshuru.com,0,0.00%,26,26,0.00%
code.eulix.xyz,0,0.00%,13,13,0.00%
api.tabnine.com,0,0.00%,21,21,0.00%
ncphn.live.baofeng.net,0,0.00%,2,2,0.00%
zjvpn.zhejianglab.com,0,0.00%,12,12,0.00%
mumu.nie.netease.com,0,0.00%,16,16,0.00%
v2-mg02.kwaicdn.com,0,0.00%,4,4,0.00%
httpdns.bcelive.com,0,0.00%,11,11,0.00%
time2.google.com,0,0.00%,2,2,0.00%
hk1-1.nigirocloud.com,0,0.00%,11,11,0.00%
shuc-js.ksord.com,0,0.00%,6,6,0.00%
ts-helper.2345.cc,0,0.00%,14,14,0.00%
t.helper.2345.cc,0,0.00%,28,28,0.00%
time3.google.com,0,0.00%,2,2,0.00%
www.asdjkljfjaowjfq.net,0,0.00%,4,4,0.00%
www.as.com,0,0.00%,2,2,0.00%
www.n1ui5fms.net,0,0.00%,12,12,0.00%
time4.google.com,0,0.00%,2,2,0.00%
kuaishou.httpdns.pro,0,0.00%,4,4,0.00%
static-pcs-sdk-server.alibaba.com,0,0.00%,12,12,0.00%
rq.optimize.cloud.duba.net,0,0.00%,16,16,0.00%
accscdn.m.taobao.com,0,0.00%,16,16,0.00%
sdxl.wanmeilink.com,0,0.00%,8,8,0.00%
uulogin01.com,0,0.00%,6,6,0.00%
garenaconnect.com,0,0.00%,9,9,0.00%
opera-mini.net,0,0.00%,8,8,0.00%
yl.qq.com,0,0.00%,12,12,0.00%
www.letou8.com,0,0.00%,8,8,0.00%
uulogin02.com,0,0.00%,6,6,0.00%
webex.com,0,0.00%,8,8,0.00%
via.cnode.xyz,0,0.00%,43,43,0.00%
jmfree.maikrappss.xyz,0,0.00%,3,3,0.00%
imap.cstnet.cn,0,0.00%,6,6,0.00%
hw-web-player-tracker.biliapi.net,0,0.00%,17,17,0.00%
aistudio.n.shifen.com,0,0.00%,4,4,0.00%
dns083.a.register.com,0,0.00%,1,1,0.00%
a.gtld-servers.net,0,0.00%,2358,2358,0.00%
ns1.dns-parking.com,0,0.00%,344,344,0.00%
ns2.dns-parking.com,0,0.00%,421,421,0.00%
dns1.p05.nsone.net,0,0.00%,34,34,0.00%
dns2.p05.nsone.net,0,0.00%,32,32,0.00%
dns3.p05.nsone.net,0,0.00%,33,33,0.00%
dns4.p05.nsone.net,0,0.00%,35,35,0.00%
dns2.namecheaphosting.com,0,0.00%,259,259,0.00%
ns03.domaincontrol.com,0,0.00%,265,265,0.00%
ns04.domaincontrol.com,0,0.00%,273,273,0.00%
ns1.bodis.com,0,0.00%,245,245,0.00%
dns2.bitconecta.net.br,0,0.00%,2,2,0.00%
ns65.domaincontrol.com,0,0.00%,6,6,0.00%
sourcefirms.com,0,0.00%,2,2,0.00%
ns0.wixdns.net,0,0.00%,66,66,0.00%
monovm.venus.orderbox-dns.com,0,0.00%,18,18,0.00%
ns27.domaincontrol.com,0,0.00%,140,140,0.00%
dns3.sered.net,0,0.00%,16,16,0.00%
ns16.domaincontrol.com,0,0.00%,168,168,0.00%
ns43.domaincontrol.com,0,0.00%,272,272,0.00%
ns11.wixdns.net,0,0.00%,82,82,0.00%
dora.dnspod.net,0,0.00%,2,2,0.00%
dns1.hichina.com,0,0.00%,38,38,0.00%
ns19.domaincontrol.com,0,0.00%,257,257,0.00%
ns-cloud-c3.googledomains.com,0,0.00%,258,258,0.00%
ns-cloud-a1.googledomains.com,0,0.00%,266,266,0.00%
dns1.cscdns.net,0,0.00%,4,4,0.00%
ns-cloud-e4.googledomains.com,0,0.00%,246,246,0.00%
ns05.domaincontrol.com,0,0.00%,174,174,0.00%
ns44.domaincontrol.com,0,0.00%,280,280,0.00%
wally.ns.cloudflare.com,0,0.00%,6,6,0.00%
ns20.domaincontrol.com,0,0.00%,249,249,0.00%
ns73.domaincontrol.com,0,0.00%,248,248,0.00%
dns101.registrar-servers.com,0,0.00%,116,116,0.00%
paper.dnspod.net,0,0.00%,2,2,0.00%
ns-cloud-c2.googledomains.com,0,0.00%,261,261,0.00%
ns-cloud-a4.googledomains.com,0,0.00%,269,269,0.00%
dns2.cscdns.net,0,0.00%,8,8,0.00%
ns06.domaincontrol.com,0,0.00%,178,178,0.00%
dns2.hichina.com,0,0.00%,31,31,0.00%
ns-cloud-c1.googledomains.com,0,0.00%,252,252,0.00%
ns-158.awsdns-19.com,0,0.00%,2,2,0.00%
ns1.namehero.com,0,0.00%,2,2,0.00%
ns-cloud-c4.googledomains.com,0,0.00%,245,245,0.00%
ns-cloud-d3.googledomains.com,0,0.00%,243,243,0.00%
southaugustastroll.com,0,0.00%,2,2,0.00%
ns1ksz.name.com,0,0.00%,3,3,0.00%
dns2.registrar-servers.com,0,0.00%,1665,1665,0.00%
ns-cloud-a3.googledomains.com,0,0.00%,259,259,0.00%
ns14.wixdns.net,0,0.00%,85,85,0.00%
ns1.dreamhost.com,0,0.00%,75,75,0.00%
ns-2023.awsdns-60.co.uk,0,0.00%,2,2,0.00%
ns2.namehero.com,0,0.00%,2,2,0.00%
ns2.p17.dynect.net,0,0.00%,6,6,0.00%
dns1.p08.nsone.net,0,0.00%,28,28,0.00%
ns-cloud-a2.googledomains.com,0,0.00%,284,284,0.00%
ns1.sedoparking.com,0,0.00%,59,59,0.00%
ns1.ynsjg.com,0,0.00%,2,2,0.00%
ns1.panamans.com,0,0.00%,199,199,0.00%
ns-962.awsdns-56.net,0,0.00%,2,2,0.00%
gerald.ns.cloudflare.com,0,0.00%,4,4,0.00%
ns2.systemdns.com,0,0.00%,42,42,0.00%
ns2.dreamhost.com,0,0.00%,87,87,0.00%
ns1.wordpress.com,0,0.00%,107,107,0.00%
ns3.dreamhost.com,0,0.00%,89,89,0.00%
ns2.wordpress.com,0,0.00%,119,119,0.00%
ns3.systemdns.com,0,0.00%,34,34,0.00%
ns1073.ui-dns.de,0,0.00%,6,6,0.00%
ns.inertinc.com,0,0.00%,8,8,0.00%
dns102.registrar-servers.com,0,0.00%,85,85,0.00%
ns15.wixdns.net,0,0.00%,86,86,0.00%
ns3ghw.name.com,0,0.00%,6,6,0.00%
loukos2.wanacorp.com,0,0.00%,2,2,0.00%
tom.ns.cloudflare.com,0,0.00%,10,10,0.00%
ns1.systemdns.com,0,0.00%,36,36,0.00%
ns1.o2switch.net,0,0.00%,13,13,0.00%
ns1.bh-ht-11.webhostbox.net,0,0.00%,2,2,0.00%
ns3.wordpress.com,0,0.00%,106,106,0.00%
john.ns.cloudflare.com,0,0.00%,10,10,0.00%
ns-cloud-b2.googledomains.com,0,0.00%,297,297,0.00%
ns1123.ui-dns.de,0,0.00%,2,2,0.00%
ns2.bodis.com,0,0.00%,268,268,0.00%
ns1.siteground.net,0,0.00%,94,94,0.00%
ns28.domaincontrol.com,0,0.00%,148,148,0.00%
dns198.a.register.com,0,0.00%,2,2,0.00%
ns9.hemensayfa.com,0,0.00%,2,2,0.00%
dns4.bitconecta.net.br,0,0.00%,2,2,0.00%
ns4jnz.name.com,0,0.00%,6,6,0.00%
ns2.o2switch.net,0,0.00%,15,15,0.00%
ns-cloud-b4.googledomains.com,0,0.00%,268,268,0.00%
dns210.b.register.com,0,0.00%,16,16,0.00%
ns1.openprovider.nl,0,0.00%,24,24,0.00%
ns74.domaincontrol.com,0,0.00%,236,236,0.00%
khloe.ns.cloudflare.com,0,0.00%,4,4,0.00%
ns1117.ui-dns.org,0,0.00%,2,2,0.00%
ns-cloud-b1.googledomains.com,0,0.00%,263,263,0.00%
ns-cloud-b3.googledomains.com,0,0.00%,286,286,0.00%
dns036.c.register.com,0,0.00%,30,30,0.00%
ns3.openprovider.eu,0,0.00%,25,25,0.00%
ns-cloud-d1.googledomains.com,0,0.00%,262,262,0.00%
ns-cloud-d4.googledomains.com,0,0.00%,270,270,0.00%
dns083.d.register.com,0,0.00%,26,26,0.00%
ns2.openprovider.be,0,0.00%,26,26,0.00%
ns3.wixdns.net,0,0.00%,69,69,0.00%
ns-cloud-d2.googledomains.com,0,0.00%,250,250,0.00%
dns1.bitconecta.net.br,0,0.00%,2,2,0.00%
ns2.wixdns.net,0,0.00%,64,64,0.00%
ns1044.ui-dns.com,0,0.00%,2,2,0.00%
ns2.nic53.de,0,0.00%,122,122,0.00%
ns63.domaincontrol.com,0,0.00%,142,142,0.00%
ns1.ekmdomains.net,0,0.00%,2,2,0.00%
ns2.bluehost.com,0,0.00%,200,200,0.00%
ns2.panamans.com,0,0.00%,207,207,0.00%
ns21055.ztomy.com,0,0.00%,9,9,0.00%
ns411.banahosting.com,0,0.00%,2,2,0.00%
ns1.netregistry.net,0,0.00%,18,18,0.00%
dns21.hichina.com,0,0.00%,54,54,0.00%
ns1.amenworld.com,0,0.00%,16,16,0.00%
dns175.a.register.com,0,0.00%,2,2,0.00%
ns410.banahosting.com,0,0.00%,2,2,0.00%
dns3.p01.nsone.net,0,0.00%,30,30,0.00%
ns42.domaincontrol.com,0,0.00%,132,132,0.00%
ns256.sellvir.com,0,0.00%,2,2,0.00%
ns3.wanamaroc.com,0,0.00%,2,2,0.00%
ns2.amenworld.com,0,0.00%,19,19,0.00%
ns13.wixdns.net,0,0.00%,85,85,0.00%
ns1.host7x24.com,0,0.00%,2,2,0.00%
ns1.huaweicloud-dns.com,0,0.00%,14,14,0.00%
brenda.ns.cloudflare.com,0,0.00%,2,2,0.00%
ns3.netregistry.net,0,0.00%,20,20,0.00%
ns15.domaincontrol.com,0,0.00%,178,178,0.00%
dns1.p03.nsone.net,0,0.00%,30,30,0.00%
ns2.ekmdomains.net,0,0.00%,2,2,0.00%
ns12.wixdns.net,0,0.00%,78,78,0.00%
ns-cloud-e1.googledomains.com,0,0.00%,254,254,0.00%
ns2.host-h.net,0,0.00%,6,6,0.00%
dns200.anycast.me,0,0.00%,16,16,0.00%
ns2.sedopark.net,0,0.00%,8,8,0.00%
dns2.p03.nsone.net,0,0.00%,30,30,0.00%
dns1.namecheaphosting.com,0,0.00%,228,228,0.00%
ns64.domaincontrol.com,0,0.00%,148,148,0.00%
spanglish360academy.com,0,0.00%,2,2,0.00%
ns1.huaweicloud-dns.cn,0,0.00%,14,14,0.00%
jola.ns.jdm.pl,0,0.00%,4,4,0.00%
ns1.sedopark.net,0,0.00%,8,8,0.00%
ns1.huaweicloud-dns.net,0,0.00%,12,12,0.00%
ns8161.hostgator.com,0,0.00%,2,2,0.00%
ns4.nic.ru,0,0.00%,93,93,0.00%
ns2.netregistry.net,0,0.00%,18,18,0.00%
dns4.p03.nsone.net,0,0.00%,24,24,0.00%
ns.gestiondecuenta.com,0,0.00%,4,4,0.00%
ns1.huaweicloud-dns.org,0,0.00%,14,14,0.00%
ns2.host7x24.com,0,0.00%,2,2,0.00%
ns11055.ztomy.com,0,0.00%,10,10,0.00%
dns7.hichina.com,0,0.00%,48,48,0.00%
ns3.colombiahosting.com,0,0.00%,6,6,0.00%
ns2.dan.com,0,0.00%,205,205,0.00%
dns1.123hjemmeside.dk,0,0.00%,20,20,0.00%
joei289672.venus.orderbox-dns.com,0,0.00%,2,2,0.00%
dns3.bitconecta.net.br,0,0.00%,2,2,0.00%
yahir.ns.cloudflare.com,0,0.00%,4,4,0.00%
ns1088.ui-dns.de,0,0.00%,4,4,0.00%
dns2.123hjemmeside.dk,0,0.00%,20,20,0.00%
ns33.creativeon.net,0,0.00%,2,2,0.00%
toby.ns.cloudflare.com,0,0.00%,6,6,0.00%
ns3.ekmdomains.net,0,0.00%,2,2,0.00%
joei289672.mars.orderbox-dns.com,0,0.00%,2,2,0.00%
jerome.ns.cloudflare.com,0,0.00%,2,2,0.00%
ns1.natrohost.com,0,0.00%,41,41,0.00%
ns1020.ui-dns.org,0,0.00%,4,4,0.00%
dns3.123hjemmeside.dk,0,0.00%,19,19,0.00%
ns36.domaincontrol.com,0,0.00%,394,394,0.00%
ns1.host-h.net,0,0.00%,6,6,0.00%
ns1.realhost.pro,0,0.00%,2,2,0.00%
moura.ns.cloudflare.com,0,0.00%,6,6,0.00%
ns1.dnsowl.com,0,0.00%,210,210,0.00%
joei289672.mercury.orderbox-dns.com,0,0.00%,2,2,0.00%
ns3.gestiondecuenta.com,0,0.00%,4,4,0.00%
liberty.ns.cloudflare.com,0,0.00%,14,14,0.00%
ns2.dnsimple.com,0,0.00%,17,17,0.00%
ns1.colombiahosting.com,0,0.00%,4,4,0.00%
ns2.dns-h.com,0,0.00%,4,4,0.00%
ns3.dnsimple.com,0,0.00%,19,19,0.00%
ns4.colombiahosting.com,0,0.00%,4,4,0.00%
ns-cloud-e2.googledomains.com,0,0.00%,246,246,0.00%
amy.ns.cloudflare.com,0,0.00%,4,4,0.00%
ns4.dnsimple.com,0,0.00%,19,19,0.00%
ns1066.ui-dns.com,0,0.00%,4,4,0.00%
ns10.wixdns.net,0,0.00%,81,81,0.00%
todd.ns.cloudflare.com,0,0.00%,10,10,0.00%
ns2.dnsowl.com,0,0.00%,227,227,0.00%
ns1069.ui-dns.biz,0,0.00%,4,4,0.00%
ns17.domaincontrol.com,0,0.00%,56,56,0.00%
ns3.wpx.ne.jp,0,0.00%,8,8,0.00%
ns2.colombiahosting.com,0,0.00%,4,4,0.00%
ns2.gestiondecuenta.com,0,0.00%,4,4,0.00%
verification2.plaindns.net,0,0.00%,12,12,0.00%
dns3.home.pl,0,0.00%,10,10,0.00%
ns1.confirmhost.com,0,0.00%,2,2,0.00%
ns4.gestiondecuenta.com,0,0.00%,8,8,0.00%
ns1.hover.com,0,0.00%,41,41,0.00%
ns1066.ui-dns.de,0,0.00%,2,2,0.00%
ns2.siteground.net,0,0.00%,80,80,0.00%
ns2.hover.com,0,0.00%,44,44,0.00%
ns2.confirmhost.com,0,0.00%,2,2,0.00%
ns2.inmotionhosting.com,0,0.00%,32,32,0.00%
ns23.domaincontrol.com,0,0.00%,201,201,0.00%
ns1079.ui-dns.com,0,0.00%,2,2,0.00%
ns7.wixdns.net,0,0.00%,76,76,0.00%
ns24.domaincontrol.com,0,0.00%,229,229,0.00%
ns3.dnsowl.com,0,0.00%,240,240,0.00%
ns6.wixdns.net,0,0.00%,89,89,0.00%
ns2.realhost.pro,0,0.00%,2,2,0.00%
sparkmanmarketing.com,0,0.00%,2,2,0.00%
ns1026.ui-dns.org,0,0.00%,2,2,0.00%
795.dns3.managedns.org,0,0.00%,2,2,0.00%
ns11.jimdo.com,0,0.00%,4,4,0.00%
ns4.alexhost.md,0,0.00%,2,2,0.00%
ns1068.ui-dns.biz,0,0.00%,2,2,0.00%
ns2.md-in-51.webhostbox.net,0,0.00%,2,2,0.00%
795.dns4.managedns.org,0,0.00%,2,2,0.00%
ns3.contabo.net,0,0.00%,8,8,0.00%
ns3.alexhost.md,0,0.00%,2,2,0.00%
ns2.contabo.net,0,0.00%,8,8,0.00%
ns1042.ui-dns.org,0,0.00%,4,4,0.00%
ns3.realhost.pro,0,0.00%,2,2,0.00%
ns2.a2hosting.com,0,0.00%,14,14,0.00%
ns3.a2hosting.com,0,0.00%,12,12,0.00%
ns1040.ui-dns.com,0,0.00%,4,4,0.00%
ns4.a2hosting.com,0,0.00%,12,12,0.00%
ns1033.ui-dns.biz,0,0.00%,4,4,0.00%
ns1.a2hosting.com,0,0.00%,11,11,0.00%
ns1.lemarit.net,0,0.00%,2,2,0.00%
ns2.lemarit.de,0,0.00%,2,2,0.00%
ns1.lemarit.de,0,0.00%,2,2,0.00%
ns2.lemarit.net,0,0.00%,2,2,0.00%
ns3.lemarit.de,0,0.00%,2,2,0.00%
ns-cloud-e3.googledomains.com,0,0.00%,245,245,0.00%
gzcm.ttcloud.club,0,0.00%,4,4,0.00%
scott.ns.cloudflare.com,0,0.00%,10,10,0.00%
dns8.hichina.com,0,0.00%,46,46,0.00%
ns5.wixdns.net,0,0.00%,71,71,0.00%
ns4.hostmultitecno.net,0,0.00%,2,2,0.00%
dns2.p06.nsone.net,0,0.00%,24,24,0.00%
kirk.ns.cloudflare.com,0,0.00%,4,4,0.00%
flowers.dnspod.net,0,0.00%,2,2,0.00%
dns17.hichina.com,0,0.00%,56,56,0.00%
dns14.hichina.com,0,0.00%,56,56,0.00%
serena.ns.cloudflare.com,0,0.00%,2,2,0.00%
ns2fln.name.com,0,0.00%,11,11,0.00%
ns-1168.awsdns-18.org,0,0.00%,2,2,0.00%
dns20.hichina.com,0,0.00%,56,56,0.00%
roman.ns.cloudflare.com,0,0.00%,6,6,0.00%
ns3.xserver.jp,0,0.00%,84,84,0.00%
dns18.hichina.com,0,0.00%,44,44,0.00%
ns3bfm.name.com,0,0.00%,16,16,0.00%
dns32.hichina.com,0,0.00%,47,47,0.00%
dns1.p06.nsone.net,0,0.00%,22,22,0.00%
dns13.hichina.com,0,0.00%,58,58,0.00%
ns7.veridyen.com,0,0.00%,2,2,0.00%
ns2.thepowerhost.in,0,0.00%,2,2,0.00%
ns1.bluehost.com,0,0.00%,206,206,0.00%
dns4.hichina.com,0,0.00%,51,51,0.00%
ns.udag.org,0,0.00%,12,12,0.00%
ns2.host2vps.com,0,0.00%,3,3,0.00%
ns4lpv.name.com,0,0.00%,9,9,0.00%
ns8940.banahosting.com,0,0.00%,2,2,0.00%
ns-380.awsdns-47.com,0,0.00%,2,2,0.00%
ns1.brightervisionsites300.com,0,0.00%,2,2,0.00%
dns01.muumuu-domain.com,0,0.00%,31,31,0.00%
donald.ns.cloudflare.com,0,0.00%,22,22,0.00%
ns1049.ui-dns.org,0,0.00%,4,4,0.00%
ns1.ikoula.nl,0,0.00%,3,3,0.00%
dns19.hichina.com,0,0.00%,58,58,0.00%
dns02.muumuu-domain.com,0,0.00%,30,30,0.00%
dns31.hichina.com,0,0.00%,61,61,0.00%
dns3.p06.nsone.net,0,0.00%,22,22,0.00%
kate.ns.cloudflare.com,0,0.00%,12,12,0.00%
ns-604.awsdns-11.net,0,0.00%,2,2,0.00%
ns4.wixdns.net,0,0.00%,77,77,0.00%
ns3.netim.net,0,0.00%,14,14,0.00%
dns3.hichina.com,0,0.00%,72,72,0.00%
ns2.mysitehosted.com,0,0.00%,2,2,0.00%
dns4.p06.nsone.net,0,0.00%,24,24,0.00%
ns8941.banahosting.com,0,0.00%,2,2,0.00%
anuj.ns.cloudflare.com,0,0.00%,4,4,0.00%
ns4233.hostgator.com,0,0.00%,8,8,0.00%
ns2.youcan.shop,0,0.00%,70,70,0.00%
ns1118.ui-dns.org,0,0.00%,4,4,0.00%
sarah.ns.cloudflare.com,0,0.00%,4,4,0.00%
ns1031.ui-dns.de,0,0.00%,4,4,0.00%
ns2.brightervisionsites300.com,0,0.00%,2,2,0.00%
ns4234.hostgator.com,0,0.00%,7,7,0.00%
yns2.yahoo.com,0,0.00%,12,12,0.00%
ns1078.ui-dns.biz,0,0.00%,4,4,0.00%
ns1108.ui-dns.biz,0,0.00%,4,4,0.00%
ns72.hostgator.mx,0,0.00%,4,4,0.00%
yns1.yahoo.com,0,0.00%,18,18,0.00%
ns1065.ui-dns.com,0,0.00%,4,4,0.00%
dns1.p01.nsone.net,0,0.00%,30,30,0.00%
dns2.p01.nsone.net,0,0.00%,30,30,0.00%
ns-1522.awsdns-62.org,0,0.00%,2,2,0.00%
ns10.hemensayfa.com,0,0.00%,2,2,0.00%
shades18.rzone.de,0,0.00%,8,8,0.00%
dns10.hichina.com,0,0.00%,42,42,0.00%
aron.ns.cloudflare.com,0,0.00%,12,12,0.00%
mail.pku.edu.cn,0,0.00%,2,2,0.00%
ns1093.ui-dns.com,0,0.00%,4,4,0.00%
ns12.jimdo.com,0,0.00%,4,4,0.00%
docks04.rzone.de,0,0.00%,8,8,0.00%
ns1.matbao.com,0,0.00%,12,12,0.00%
ns1093.ui-dns.de,0,0.00%,4,4,0.00%
jason.ns.cloudflare.com,0,0.00%,10,10,0.00%
dns9.hichina.com,0,0.00%,44,44,0.00%
ns2.bh-41.webhostbox.net,0,0.00%,2,2,0.00%
dns26.hichina.com,0,0.00%,50,50,0.00%
sandra.ns.cloudflare.com,0,0.00%,6,6,0.00%
ns-a2.conoha.io,0,0.00%,54,54,0.00%
ns1.bh-41.webhostbox.net,0,0.00%,2,2,0.00%
ns999.hostgator.com.br,0,0.00%,2,2,0.00%
dns25.hichina.com,0,0.00%,50,50,0.00%
ns01.hostnet.nl,0,0.00%,19,19,0.00%
fortaleza.porkbun.com,0,0.00%,77,77,0.00%
ns-a3.conoha.io,0,0.00%,59,59,0.00%
ns35.domaincontrol.com,0,0.00%,409,409,0.00%
josh.ns.cloudflare.com,0,0.00%,5,5,0.00%
ns998.hostgator.com.br,0,0.00%,2,2,0.00%
ns-a1.conoha.io,0,0.00%,57,57,0.00%
ns2.netim.net,0,0.00%,16,16,0.00%
dns1.kinghost.com.br,0,0.00%,4,4,0.00%
mckenzie.ns.cloudflare.com,0,0.00%,4,4,0.00%
dns2.kinghost.com.br,0,0.00%,4,4,0.00%
ns98.worldnic.com,0,0.00%,26,26,0.00%
ns.udag.de,0,0.00%,8,8,0.00%
ns1.dan.com,0,0.00%,198,198,0.00%
adns1.mynet.at,0,0.00%,2,2,0.00%
ns2.dynadot.com,0,0.00%,129,129,0.00%
ns41.domaincontrol.com,0,0.00%,125,125,0.00%
dns047.b.register.com,0,0.00%,8,8,0.00%
ns1098.ui-dns.org,0,0.00%,4,4,0.00%
verification-e4d900f2.ns3.dan.hosting,0,0.00%,52,52,0.00%
howard.ns.cloudflare.com,0,0.00%,2,2,0.00%
dns176.d.register.com,0,0.00%,14,14,0.00%
cns1.hostcocoa.com,0,0.00%,6,6,0.00%
ns8.alidns.com,0,0.00%,10,10,0.00%
us1.hoststock.net,0,0.00%,2,2,0.00%
summer.ns.cloudflare.com,0,0.00%,6,6,0.00%
dns043.a.register.com,0,0.00%,2,2,0.00%
cns2.hostcocoa.com,0,0.00%,4,4,0.00%
ns2.rumahweb.com,0,0.00%,34,34,0.00%
ns73.worldnic.com,0,0.00%,20,20,0.00%
dns223.c.register.com,0,0.00%,12,12,0.00%
cns3.hostcocoa.com,0,0.00%,4,4,0.00%
dns1.p04.nsone.net,0,0.00%,19,19,0.00%
adns3.mynet.at,0,0.00%,2,2,0.00%
ns1.p17.dynect.net,0,0.00%,6,6,0.00%
ns7.alidns.com,0,0.00%,10,10,0.00%
ns1087.ui-dns.de,0,0.00%,4,4,0.00%
ns2.mytrafficmanagement.com,0,0.00%,28,28,0.00%
ns74.worldnic.com,0,0.00%,11,11,0.00%
ns4.rumahweb.net,0,0.00%,31,31,0.00%
cns4.hostcocoa.com,0,0.00%,4,4,0.00%
ns45.latinoamericahosting.com,0,0.00%,2,2,0.00%
ns10.hawkhost.com,0,0.00%,18,18,0.00%
ns1.rumahweb.com,0,0.00%,36,36,0.00%
failed-whois-verification.namecheap.com,0,0.00%,98,98,0.00%
audrey.ns.cloudflare.com,0,0.00%,2,2,0.00%
ns492.hostgator.com.br,0,0.00%,2,2,0.00%
ns3.rumahweb.net,0,0.00%,28,28,0.00%
pdns2.registrar-servers.com,0,0.00%,39,39,0.00%
ns1.nic53.net,0,0.00%,122,122,0.00%
verify-contact-details.namecheap.com,0,0.00%,78,78,0.00%
braden.ns.cloudflare.com,0,0.00%,4,4,0.00%
souldaenergiasolar.com,0,0.00%,2,2,0.00%
dns27.hichina.com,0,0.00%,62,62,0.00%
iris.ns.cloudflare.com,0,0.00%,21,21,0.00%
ns493.hostgator.com.br,0,0.00%,2,2,0.00%
ns1.dynadot.com,0,0.00%,130,130,0.00%
ns1087.ui-dns.com,0,0.00%,5,5,0.00%
dns28.hichina.com,0,0.00%,44,44,0.00%
us2.hoststock.net,0,0.00%,2,2,0.00%
adns2.mynet.at,0,0.00%,2,2,0.00%
ns1113.ui-dns.de,0,0.00%,3,3,0.00%
03.dnsv.jp,0,0.00%,44,44,0.00%
ns-53-b.gandi.net,0,0.00%,3,3,0.00%
ns653.hostgator.com.br,0,0.00%,2,2,0.00%
ns5.kasserver.com,0,0.00%,32,32,0.00%
ns0.transip.net,0,0.00%,25,25,0.00%
ns6.kasserver.com,0,0.00%,30,30,0.00%
b.dns.hostway.net,0,0.00%,6,6,0.00%
cpns2.turdns.com,0,0.00%,9,9,0.00%
ns2.transip.eu,0,0.00%,23,23,0.00%
evangeline.ns.cloudflare.com,0,0.00%,8,8,0.00%
ns2.domain.com,0,0.00%,55,55,0.00%
ns1.transip.nl,0,0.00%,30,30,0.00%
guss.ns.cloudflare.com,0,0.00%,104,104,0.00%
ns1.domain.com,0,0.00%,57,57,0.00%
ns5.cdmondns-01.com,0,0.00%,3,3,0.00%
ns2.alidns.com,0,0.00%,21,21,0.00%
ns1030.ui-dns.de,0,0.00%,6,6,0.00%
ns-93-c.gandi.net,0,0.00%,2,2,0.00%
eloise.ns.cloudflare.com,0,0.00%,6,6,0.00%
ns1.alidns.com,0,0.00%,25,25,0.00%
hal.ns.cloudflare.com,0,0.00%,2,2,0.00%
dns3.p08.nsone.net,0,0.00%,30,30,0.00%
ns1.wixdns.net,0,0.00%,61,61,0.00%
ns-1912.awsdns-47.co.uk,0,0.00%,2,2,0.00%
ns8162.hostgator.com,0,0.00%,2,2,0.00%
ns1020.ui-dns.biz,0,0.00%,8,8,0.00%
frank.ns.cloudflare.com,0,0.00%,12,12,0.00%
ns2.crazydomains.com,0,0.00%,15,15,0.00%
dns23.hichina.com,0,0.00%,66,66,0.00%
ignat.ns.cloudflare.com,0,0.00%,4,4,0.00%
ns1.domainhasexpired.com,0,0.00%,22,22,0.00%
ns1.crazydomains.com,0,0.00%,22,22,0.00%
ns-277.awsdns-34.com,0,0.00%,2,2,0.00%
droppybrands.venus.orderbox-dns.com,0,0.00%,2,2,0.00%
01.dnsv.jp,0,0.00%,61,61,0.00%
ns2.domainhasexpired.com,0,0.00%,18,18,0.00%
ruth.ns.cloudflare.com,0,0.00%,4,4,0.00%
ns2.cdmon.net,0,0.00%,3,3,0.00%
ns-31-a.gandi.net,0,0.00%,2,2,0.00%
ns-765.awsdns-31.net,0,0.00%,2,2,0.00%
ns-937.awsdns-53.net,0,0.00%,2,2,0.00%
ns59.domaincontrol.com,0,0.00%,6,6,0.00%
02.dnsv.jp,0,0.00%,41,41,0.00%
ns3.cdmon.net,0,0.00%,4,4,0.00%
softcaresalon.com,0,0.00%,2,2,0.00%
droppybrands.mars.orderbox-dns.com,0,0.00%,2,2,0.00%
ns4.xserver.jp,0,0.00%,96,96,0.00%
ns.udag.net,0,0.00%,8,8,0.00%
droppybrands.mercury.orderbox-dns.com,0,0.00%,2,2,0.00%
ns-913.awsdns-50.net,0,0.00%,2,2,0.00%
dns1.p07.nsone.net,0,0.00%,22,22,0.00%
ns-118.awsdns-14.com,0,0.00%,3,3,0.00%
droppybrands.earth.orderbox-dns.com,0,0.00%,2,2,0.00%
bdix2.whitednszone.com,0,0.00%,2,2,0.00%
chip.ns.cloudflare.com,0,0.00%,8,8,0.00%
dns2.p07.nsone.net,0,0.00%,18,18,0.00%
ns-1307.awsdns-35.org,0,0.00%,2,2,0.00%
rosalyn.ns.cloudflare.com,0,0.00%,6,6,0.00%
dns3.p07.nsone.net,0,0.00%,18,18,0.00%
ns2.cyberfolks.pl,0,0.00%,4,4,0.00%
ns-2002.awsdns-58.co.uk,0,0.00%,2,2,0.00%
dns4.p07.nsone.net,0,0.00%,15,15,0.00%
david.ns.cloudflare.com,0,0.00%,12,12,0.00%
art.ns.cloudflare.com,0,0.00%,2,2,0.00%
nola.ns.cloudflare.com,0,0.00%,8,8,0.00%
dns22.hichina.com,0,0.00%,52,52,0.00%
catta.dnspod.net,0,0.00%,2,2,0.00%
dorthy.ns.cloudflare.com,0,0.00%,6,6,0.00%
ns2.thaischool1.in.th,0,0.00%,2,2,0.00%
dns1.p02.nsone.net,0,0.00%,22,22,0.00%
ntp4.aliyun.com,0,0.00%,11,11,0.00%
carl.ns.cloudflare.com,0,0.00%,7,7,0.00%
bdix1.whitednszone.com,0,0.00%,2,2,0.00%
aldo.ns.cloudflare.com,0,0.00%,2,2,0.00%
ns2.value-domain.com,0,0.00%,23,23,0.00%
ns3.cyberfolks.pl,0,0.00%,4,4,0.00%
fish.ns.cloudflare.com,0,0.00%,6,6,0.00%
ns1.value-domain.com,0,0.00%,34,34,0.00%
curitiba.porkbun.com,0,0.00%,87,87,0.00%
ns2.domaindiscount24.net,0,0.00%,4,4,0.00%
george.ns.cloudflare.com,0,0.00%,20,20,0.00%
aspen.ns.cloudflare.com,0,0.00%,9,9,0.00%
dns3.name-services.com,0,0.00%,30,30,0.00%
chin.ns.cloudflare.com,0,0.00%,9,9,0.00%
ns2.host-ww.net,0,0.00%,4,4,0.00%
gina.ns.cloudflare.com,0,0.00%,9,9,0.00%
ns1.eftydns.com,0,0.00%,5,5,0.00%
ns3.p17.dynect.net,0,0.00%,4,4,0.00%
dean.ns.cloudflare.com,0,0.00%,6,6,0.00%
ns1.host-ww.net,0,0.00%,4,4,0.00%
opal.ns.cloudflare.com,0,0.00%,2,2,0.00%
ns2.eftydns.com,0,0.00%,7,7,0.00%
ns2.reg.ru,0,0.00%,523,523,0.00%
ns614.hostgator.com.br,0,0.00%,2,2,0.00%
aria.ns.cloudflare.com,0,0.00%,4,4,0.00%
ns1.cyberfolks.pl,0,0.00%,4,4,0.00%
ns9.wixdns.net,0,0.00%,68,68,0.00%
dns3.cosmotown.com,0,0.00%,2,2,0.00%
ns3.domaindiscount24.net,0,0.00%,5,5,0.00%
dns4.p08.nsone.net,0,0.00%,24,24,0.00%
ns8.wixdns.net,0,0.00%,72,72,0.00%
ns1.fornex.com,0,0.00%,12,12,0.00%
ns1.domaindiscount24.net,0,0.00%,6,6,0.00%
dns88.lankahost.net,0,0.00%,2,2,0.00%
ns3183.ispapi.net,0,0.00%,2,2,0.00%
ns2.fornex.com,0,0.00%,11,11,0.00%
ns10.ovh.net,0,0.00%,25,25,0.00%
dodo.ezoicns.com,0,0.00%,2,2,0.00%
ns1210.ispapi.net,0,0.00%,2,2,0.00%
monovm.earth.orderbox-dns.com,0,0.00%,18,18,0.00%
dns1.sered.net,0,0.00%,13,13,0.00%
ns1.mutakhir.co.id,0,0.00%,2,2,0.00%
dns10.ovh.net,0,0.00%,25,25,0.00%
ns3.fornex.com,0,0.00%,8,8,0.00%
ns2161.ispapi.net,0,0.00%,2,2,0.00%
bob.ns.cloudflare.com,0,0.00%,14,14,0.00%
kiwi.ezoicns.com,0,0.00%,2,2,0.00%
dns2.sered.net,0,0.00%,13,13,0.00%
ns3.stackdns.com,0,0.00%,13,13,0.00%
dns89.lankahost.net,0,0.00%,2,2,0.00%
ns6439.hostgator.com,0,0.00%,2,2,0.00%
albert.ns.cloudflare.com,0,0.00%,4,4,0.00%
wolf.ezoicns.com,0,0.00%,2,2,0.00%
betty.ns.cloudflare.com,0,0.00%,7,7,0.00%
ns2.mutakhir.co.id,0,0.00%,2,2,0.00%
ns2.velozhosting.com,0,0.00%,2,2,0.00%
ns1.mytrafficmanagement.com,0,0.00%,26,26,0.00%
zebu.ezoicns.com,0,0.00%,2,2,0.00%
ns2.solidrockuser.com,0,0.00%,2,2,0.00%
a.dns.hostway.net,0,0.00%,6,6,0.00%
ken.ns.cloudflare.com,0,0.00%,6,6,0.00%
alla.ns.cloudflare.com,0,0.00%,15,15,0.00%
cns1.alfahosting.info,0,0.00%,2,2,0.00%
ns1.maff.com,0,0.00%,42,42,0.00%
sergi.ns.cloudflare.com,0,0.00%,2,2,0.00%
aleena.ns.cloudflare.com,0,0.00%,8,8,0.00%
pdns1.registrar-servers.com,0,0.00%,32,32,0.00%
nick.ns.cloudflare.com,0,0.00%,8,8,0.00%
ns1.solislogistix.com,0,0.00%,1,1,0.00%
ns-a3.cloud.z.com,0,0.00%,6,6,0.00%
ns66.domaincontrol.com,0,0.00%,6,6,0.00%
bella.ns.cloudflare.com,0,0.00%,2,2,0.00%
ns1.velozhosting.com,0,0.00%,2,2,0.00%
shades05.rzone.de,0,0.00%,6,6,0.00%
ns-a4.cloud.z.com,0,0.00%,4,4,0.00%
ns794.hostgator.com.br,0,0.00%,2,2,0.00%
ns18.domaincontrol.com,0,0.00%,102,102,0.00%
theo.ns.cloudflare.com,0,0.00%,18,18,0.00%
dns4.cosmotown.com,0,0.00%,2,2,0.00%
ns-a1.cloud.z.com,0,0.00%,6,6,0.00%
docks03.rzone.de,0,0.00%,2,2,0.00%
cns2.alfahosting.info,0,0.00%,2,2,0.00%
ns2.maff.com,0,0.00%,40,40,0.00%
ns1.solidrockuser.com,0,0.00%,2,2,0.00%
ns3.active-dns.com,0,0.00%,2,2,0.00%
ns2.solislogistix.com,0,0.00%,1,1,0.00%
ns7.lwsdns.com,0,0.00%,35,35,0.00%
ns4.active-dns.com,0,0.00%,2,2,0.00%
ns245.neubox.net,0,0.00%,10,10,0.00%
ns615.hostgator.com.br,0,0.00%,2,2,0.00%
ns8.lwsdns.com,0,0.00%,28,28,0.00%
ns143.neubox.net,0,0.00%,10,10,0.00%
cns3.alfahosting.info,0,0.00%,2,2,0.00%
ns.zxcs.eu,0,0.00%,10,10,0.00%
ns2.active-dns.com,0,0.00%,2,2,0.00%
monovm.mercury.orderbox-dns.com,0,0.00%,16,16,0.00%
ns1.tinyurl.com,0,0.00%,2,2,0.00%
ns.zxcs.be,0,0.00%,16,16,0.00%
ns1.netim.net,0,0.00%,16,16,0.00%
asa.ns.cloudflare.com,0,0.00%,10,10,0.00%
dns3.p03.nsone.net,0,0.00%,26,26,0.00%
ns1.active-dns.com,0,0.00%,2,2,0.00%
ns3.tinyurl.com,0,0.00%,2,2,0.00%
ns4.tinyurl.com,0,0.00%,2,2,0.00%
ns6.lwsdns.com,0,0.00%,29,29,0.00%
cdns2.main-hosting.eu,0,0.00%,10,10,0.00%
ns2.ipage.com,0,0.00%,16,16,0.00%
ns-70.awsdns-08.com,0,0.00%,4,4,0.00%
ns5.lwsdns.com,0,0.00%,25,25,0.00%
ns11.worldnic.com,0,0.00%,10,10,0.00%
ns3.afternic.com,0,0.00%,23,23,0.00%
sg.solidhosting.pro,0,0.00%,2,2,0.00%
ns4.afternic.com,0,0.00%,30,30,0.00%
in.solidhosting.pro,0,0.00%,2,2,0.00%
finley.ns.cloudflare.com,0,0.00%,5,5,0.00%
ns2.xserver.jp,0,0.00%,98,98,0.00%
skolania.com,0,0.00%,2,2,0.00%
dns1.hostgator.com.br,0,0.00%,27,27,0.00%
ns-1318.awsdns-36.org,0,0.00%,2,2,0.00%
ns1.xserver.jp,0,0.00%,83,83,0.00%
dns2.hostgator.com.br,0,0.00%,32,32,0.00%
hans.ns.cloudflare.com,0,0.00%,8,8,0.00%
a.ezdnscenter.com,0,0.00%,6,6,0.00%
us.solidhosting.pro,0,0.00%,2,2,0.00%
dns2.p02.nsone.net,0,0.00%,20,20,0.00%
dns.technorail.com,0,0.00%,40,40,0.00%
ns-1948.awsdns-51.co.uk,0,0.00%,2,2,0.00%
26569.mars.orderbox-dns.com,0,0.00%,2,2,0.00%
ns5.xserver.jp,0,0.00%,98,98,0.00%
ns1.emailverification.info,0,0.00%,10,10,0.00%
dns3.p02.nsone.net,0,0.00%,22,22,0.00%
dns2.technorail.com,0,0.00%,31,31,0.00%
ns.tradeindia.com,0,0.00%,10,10,0.00%
nsmpro2.nordnet.com,0,0.00%,2,2,0.00%
ns107.latinoamericahosting.com,0,0.00%,2,2,0.00%
dns4.p02.nsone.net,0,0.00%,23,23,0.00%
nsid1.rumahweb.com,0,0.00%,10,10,0.00%
dns4.arubadns.cz,0,0.00%,36,36,0.00%
eu.solidhosting.pro,0,0.00%,2,2,0.00%
ns-705.awsdns-24.net,0,0.00%,4,4,0.00%
ns12.xincache.com,0,0.00%,47,47,0.00%
ns-1435.awsdns-51.org,0,0.00%,2,2,0.00%
ns-1422.awsdns-49.org,0,0.00%,2,2,0.00%
dns3.arubadns.net,0,0.00%,38,38,0.00%
ns-1944.awsdns-51.co.uk,0,0.00%,2,2,0.00%
ns6527.hostgator.com,0,0.00%,2,2,0.00%
ns-1558.awsdns-02.co.uk,0,0.00%,2,2,0.00%
dexter.ns.cloudflare.com,0,0.00%,18,18,0.00%
austin.ns.cloudflare.com,0,0.00%,11,11,0.00%
ns108.latinoamericahosting.com,0,0.00%,2,2,0.00%
ns-278.awsdns-34.com,0,0.00%,2,2,0.00%
ns6528.hostgator.com,0,0.00%,2,2,0.00%
ns1.hoster.co.id,0,0.00%,2,2,0.00%
ns-621.awsdns-13.net,0,0.00%,2,2,0.00%
jeremy.ns.cloudflare.com,0,0.00%,10,10,0.00%
kira.ns.cloudflare.com,0,0.00%,2,2,0.00%
virginia.ns.cloudflare.com,0,0.00%,6,6,0.00%
vth399.ruk-com.in.th,0,0.00%,4,4,0.00%
ns-784.awsdns-34.net,0,0.00%,4,4,0.00%
ns4.monovm.com,0,0.00%,2,2,0.00%
th399.ruk-com.in.th,0,0.00%,4,4,0.00%
ns2.perfectdns.com,0,0.00%,2,2,0.00%
betty.dnspod.net,0,0.00%,2,2,0.00%
ns1.hostmonster.com,0,0.00%,6,6,0.00%
ns1.proaktif.org,0,0.00%,2,2,0.00%
ns60.domaincontrol.com,0,0.00%,5,5,0.00%
ns1.perfectdns.com,0,0.00%,2,2,0.00%
66.push2his.eastmoney.com,0,0.00%,2,2,0.00%
ns1.world4you.at,0,0.00%,4,4,0.00%
ns65.d9hosting.com,0,0.00%,16,16,0.00%
ns-1302.awsdns-34.org,0,0.00%,2,2,0.00%
cpns1.turdns.com,0,0.00%,10,10,0.00%
ns2.world4you.at,0,0.00%,6,6,0.00%
ns-1910.awsdns-46.co.uk,0,0.00%,2,2,0.00%
ns-236.awsdns-29.com,0,0.00%,4,4,0.00%
ns-925.awsdns-51.net,0,0.00%,2,2,0.00%
sean.ns.cloudflare.com,0,0.00%,6,6,0.00%
zelda.ns.cloudflare.com,0,0.00%,6,6,0.00%
ns12.servicio-online.net,0,0.00%,10,10,0.00%
extdns001.ford.com,0,0.00%,2,2,0.00%
salvador.ns.porkbun.com,0,0.00%,6,6,0.00%
ns2.hostpro.ua,0,0.00%,2,2,0.00%
dns111.ovh.net,0,0.00%,84,84,0.00%
ns54.domaincontrol.com,0,0.00%,107,107,0.00%
ns2.parkingcrew.net,0,0.00%,532,532,0.00%
ns1.parkingcrew.net,0,0.00%,553,553,0.00%
ns131.mschosting.com,0,0.00%,2,2,0.00%
ns1.webnames.ca,0,0.00%,6,6,0.00%
ns3.vodien.com,0,0.00%,2,2,0.00%
raphaela.ns.cloudflare.com,0,0.00%,3,3,0.00%
ns13.domaincontrol.com,0,0.00%,201,201,0.00%
ns119.inhostedns.com,0,0.00%,4,4,0.00%
ns1.bdm.microsoftonline.com,0,0.00%,36,36,0.00%
melina.ns.cloudflare.com,0,0.00%,4,4,0.00%
ns14.domaincontrol.com,0,0.00%,180,180,0.00%
ns2.vultr.com,0,0.00%,14,14,0.00%
ns2.bdm.microsoftonline.com,0,0.00%,38,38,0.00%
ns3.digitalocean.com,0,0.00%,30,30,0.00%
perla.ns.cloudflare.com,0,0.00%,102,102,0.00%
ns.otherdns.com,0,0.00%,2,2,0.00%
ns8918.banahosting.com,0,0.00%,4,4,0.00%
ns1.iukanet.com,0,0.00%,2,2,0.00%
ns1.livedns.co.uk,0,0.00%,6,6,0.00%
ns8919.banahosting.com,0,0.00%,2,2,0.00%
ns3.bdm.microsoftonline.com,0,0.00%,38,38,0.00%
ns48.domaincontrol.com,0,0.00%,188,188,0.00%
dns20.angoweb.biz,0,0.00%,2,2,0.00%
ns-1464.awsdns-55.org,0,0.00%,2,2,0.00%
ns111.ovh.net,0,0.00%,84,84,0.00%
ns1.nakroteck.net,0,0.00%,2,2,0.00%
ns1.teemill.com,0,0.00%,2,2,0.00%
ns4.linode.com,0,0.00%,2,2,0.00%
tanner.ns.cloudflare.com,0,0.00%,24,24,0.00%
ns47.domaincontrol.com,0,0.00%,147,147,0.00%
ns2.livedns.co.uk,0,0.00%,6,6,0.00%
ns3.hostpro.ua,0,0.00%,2,2,0.00%
ns.dns2.co.za,0,0.00%,2,2,0.00%
projetoxingu.com,0,0.00%,2,2,0.00%
ns1.stackdns.com,0,0.00%,13,13,0.00%
ns3.linode.com,0,0.00%,2,2,0.00%
carter.ns.cloudflare.com,0,0.00%,16,16,0.00%
ns219.inhostedns.net,0,0.00%,6,6,0.00%
dns11.hichina.com,0,0.00%,48,48,0.00%
ns4.bdm.microsoftonline.com,0,0.00%,34,34,0.00%
ns-1034.awsdns-01.org,0,0.00%,2,2,0.00%
ns3.livedns.co.uk,0,0.00%,6,6,0.00%
ns-270.awsdns-33.com,0,0.00%,2,2,0.00%
eagle.ezoicns.com,0,0.00%,2,2,0.00%
zara.ns.cloudflare.com,0,0.00%,8,8,0.00%
ns2.linode.com,0,0.00%,2,2,0.00%
ns.dns1.co.za,0,0.00%,2,2,0.00%
monovm.mars.orderbox-dns.com,0,0.00%,20,20,0.00%
ns-1571.awsdns-04.co.uk,0,0.00%,2,2,0.00%
ns-725.awsdns-26.net,0,0.00%,2,2,0.00%
ns5.linode.com,0,0.00%,2,2,0.00%
ns4.teemill.com,0,0.00%,2,2,0.00%
dns3.p04.nsone.net,0,0.00%,18,18,0.00%
pdns08.domaincontrol.com,0,0.00%,30,30,0.00%
ns.otherdns.net,0,0.00%,2,2,0.00%
ns1.linode.com,0,0.00%,2,2,0.00%
ns2.liqu.id,0,0.00%,4,4,0.00%
ns-884.awsdns-46.net,0,0.00%,2,2,0.00%
atwood.dnspod.net,0,0.00%,6,6,0.00%
ns5.worldnic.com,0,0.00%,11,11,0.00%
ns1018.ui-dns.org,0,0.00%,2,2,0.00%
ns1.arminahost.com,0,0.00%,2,2,0.00%
ns1.liqu.id,0,0.00%,4,4,0.00%
verification-9canuckj.ns3.dan.hosting,0,0.00%,2,2,0.00%
bill.ns.cloudflare.com,0,0.00%,6,6,0.00%
ns319.inhostedns.org,0,0.00%,6,6,0.00%
ira.dnspod.net,0,0.00%,4,4,0.00%
ns2.niagahoster.com,0,0.00%,58,58,0.00%
ns-uk.topdns.com,0,0.00%,10,10,0.00%
ns97.worldnic.com,0,0.00%,13,13,0.00%
ns1.anureeth.com,0,0.00%,2,2,0.00%
ns2.jimdo.com,0,0.00%,6,6,0.00%
surina.ns.cloudflare.com,0,0.00%,2,2,0.00%
maceio.porkbun.com,0,0.00%,81,81,0.00%
ns1.niagahoster.com,0,0.00%,54,54,0.00%
ns11.servicio-online.net,0,0.00%,10,10,0.00%
annabel.ns.cloudflare.com,0,0.00%,4,4,0.00%
ns-124.awsdns-15.com,0,0.00%,2,2,0.00%
ns7071.webempresa.eu,0,0.00%,2,2,0.00%
push2.eastmoney.com,0,0.00%,16,16,0.00%
ns4.protondns.net,0,0.00%,2,2,0.00%
ns2.anureeth.com,0,0.00%,2,2,0.00%
ns-1676.awsdns-17.co.uk,0,0.00%,2,2,0.00%
ns1123.ui-dns.biz,0,0.00%,4,4,0.00%
ns3.protondns.net,0,0.00%,2,2,0.00%
ns-620.awsdns-13.net,0,0.00%,4,4,0.00%
ns1.protondns.net,0,0.00%,2,2,0.00%
ns1013.hostgator.com.br,0,0.00%,2,2,0.00%
ns2.protondns.net,0,0.00%,2,2,0.00%
ns1050.ui-dns.com,0,0.00%,8,8,0.00%
ullis.ns.cloudflare.com,0,0.00%,4,4,0.00%
ns1121.ui-dns.org,0,0.00%,2,2,0.00%
ns1104.ui-dns.de,0,0.00%,2,2,0.00%
nikon.ns.cloudflare.com,0,0.00%,2,2,0.00%
salvador.porkbun.com,0,0.00%,86,86,0.00%
ns71.domaincontrol.com,0,0.00%,181,181,0.00%
ns72.domaincontrol.com,0,0.00%,193,193,0.00%
dns1.markum.net,0,0.00%,4,4,0.00%
dns.home.pl,0,0.00%,8,8,0.00%
ns4.dinahosting.com,0,0.00%,4,4,0.00%
ns5.byet.org,0,0.00%,6,6,0.00%
ns2.bluehost.in,0,0.00%,16,16,0.00%
dns.dns4.de,0,0.00%,2,2,0.00%
grannbo.ns.cloudflare.com,0,0.00%,6,6,0.00%
ns2.dinahosting.com,0,0.00%,2,2,0.00%
ns3.dinahosting.com,0,0.00%,2,2,0.00%
ns.dinahosting.com,0,0.00%,6,6,0.00%
ns1.byet.org,0,0.00%,6,6,0.00%
dns.dns3.de,0,0.00%,2,2,0.00%
dns.dns1.de,0,0.00%,2,2,0.00%
ns-1518.awsdns-61.org,0,0.00%,2,2,0.00%
hk1-6.nigirocloud.com,0,0.00%,9,9,0.00%
ty1-3.nigirocloud.com,0,0.00%,9,9,0.00%
hk1-5.nigirocloud.com,0,0.00%,8,8,0.00%
hk1-7.nigirocloud.com,0,0.00%,15,15,0.00%
hk1-3.nigirocloud.com,0,0.00%,8,8,0.00%
hk1-2.nigirocloud.com,0,0.00%,14,14,0.00%
ns-1991.awsdns-56.co.uk,0,0.00%,2,2,0.00%
ns-210.awsdns-26.com,0,0.00%,2,2,0.00%
hk1-8.nigirocloud.com,0,0.00%,11,11,0.00%
au1-1.nigirocloud.com,0,0.00%,9,9,0.00%
au1-3.nigirocloud.com,0,0.00%,9,9,0.00%
au1-2.nigirocloud.com,0,0.00%,8,8,0.00%
au1-4.nigirocloud.com,0,0.00%,9,9,0.00%
au2-2.nigirocloud.com,0,0.00%,9,9,0.00%
au2-1.nigirocloud.com,0,0.00%,9,9,0.00%
dns.dns2.de,0,0.00%,2,2,0.00%
ina3.registrar.eu,0,0.00%,7,7,0.00%
au2-3.nigirocloud.com,0,0.00%,8,8,0.00%
au2-4.nigirocloud.com,0,0.00%,9,9,0.00%
de1-1.nigirocloud.com,0,0.00%,9,9,0.00%
ns1.domainesia.net,0,0.00%,25,25,0.00%
ns-a2.tenten.vn,0,0.00%,47,47,0.00%
bijoymedia.venus.orderbox-dns.com,0,0.00%,2,2,0.00%
ns07.domaincontrol.com,0,0.00%,162,162,0.00%
ns1.vercel-dns.com,0,0.00%,10,10,0.00%
ns3.byet.org,0,0.00%,5,5,0.00%
ns08.domaincontrol.com,0,0.00%,184,184,0.00%
brit.ns.cloudflare.com,0,0.00%,4,4,0.00%
irma.ns.cloudflare.com,0,0.00%,26,26,0.00%
ray.ns.cloudflare.com,0,0.00%,12,12,0.00%
dns24.hichina.com,0,0.00%,66,66,0.00%
ivy.ns.cloudflare.com,0,0.00%,16,16,0.00%
ns6364.hostgator.com,0,0.00%,2,2,0.00%
de1-2.nigirocloud.com,0,0.00%,9,9,0.00%
de1-3.nigirocloud.com,0,0.00%,9,9,0.00%
de1-4.nigirocloud.com,0,0.00%,7,7,0.00%
ns2.namecity.com,0,0.00%,4,4,0.00%
cp1.privatesystems.net,0,0.00%,3,3,0.00%
de2-1.nigirocloud.com,0,0.00%,9,9,0.00%
jermaine.ns.cloudflare.com,0,0.00%,24,24,0.00%
ns1.gname.net,0,0.00%,1852,1852,0.00%
de2-2.nigirocloud.com,0,0.00%,8,8,0.00%
de2-3.nigirocloud.com,0,0.00%,8,8,0.00%
ns3.regery.net,0,0.00%,4,4,0.00%
ns1.youcan.shop,0,0.00%,70,70,0.00%
jim.ns.cloudflare.com,0,0.00%,6,6,0.00%
ns1.namecity.com,0,0.00%,4,4,0.00%
ns6363.hostgator.com,0,0.00%,2,2,0.00%
ppbqkentangan.com,0,0.00%,2,2,0.00%
de2-4.nigirocloud.com,0,0.00%,9,9,0.00%
cp3.privatesystems.net,0,0.00%,3,3,0.00%
ian.ns.cloudflare.com,0,0.00%,2,2,0.00%
dns1.nominalia.com,0,0.00%,13,13,0.00%
ee1-1.nigirocloud.com,0,0.00%,9,9,0.00%
alec.ns.cloudflare.com,0,0.00%,8,8,0.00%
brian.ns.cloudflare.com,0,0.00%,6,6,0.00%
ns2.regery.net,0,0.00%,4,4,0.00%
cloud-linux108.thaidata.net,0,0.00%,2,2,0.00%
ee1-2.nigirocloud.com,0,0.00%,8,8,0.00%
ns2.gname.net,0,0.00%,2421,2421,0.00%
ns2.araddatacenter.com,0,0.00%,2,2,0.00%
kara.ns.cloudflare.com,0,0.00%,24,24,0.00%
ns1.dns-h.com,0,0.00%,4,4,0.00%
shubhi.ns.cloudflare.com,0,0.00%,14,14,0.00%
meg.ns.cloudflare.com,0,0.00%,6,6,0.00%
ns116.inhostedns.com,0,0.00%,3,3,0.00%
cloud-linux108.thaidatahosting.com,0,0.00%,2,2,0.00%
vs3.gluee.jp,0,0.00%,2,2,0.00%
barbara.ns.cloudflare.com,0,0.00%,2,2,0.00%
rocky.ns.cloudflare.com,0,0.00%,24,24,0.00%
ns96.hostgator.com.br,0,0.00%,2,2,0.00%
damon.ns.cloudflare.com,0,0.00%,4,4,0.00%
ben.ns.cloudflare.com,0,0.00%,8,8,0.00%
ns-1201.awsdns-22.org,0,0.00%,2,2,0.00%
ns5262.webempresa.eu,0,0.00%,2,2,0.00%
rosa.ns.cloudflare.com,0,0.00%,6,6,0.00%
ns2.andifiwebstudio.com,0,0.00%,2,2,0.00%
ns-1675.awsdns-17.co.uk,0,0.00%,2,2,0.00%
pqcevc.com,0,0.00%,2,2,0.00%
ns-1222.awsdns-24.org,0,0.00%,2,2,0.00%
3-get.njalla.fo,0,0.00%,16,16,0.00%
ee1-3.nigirocloud.com,0,0.00%,9,9,0.00%
ee1-4.nigirocloud.com,0,0.00%,9,9,0.00%
ns1.powdershaky.com,0,0.00%,2,2,0.00%
ns1221.deepafrica.com,0,0.00%,2,2,0.00%
us1-1.nigirocloud.com,0,0.00%,9,9,0.00%
ns13.inhostedns.com,0,0.00%,2,2,0.00%
ns-322.awsdns-40.com,0,0.00%,2,2,0.00%
ns1.araddatacenter.com,0,0.00%,2,2,0.00%
nsn2.mijndomein.nl,0,0.00%,22,22,0.00%
ns-707.awsdns-24.net,0,0.00%,2,2,0.00%
nsn3.mijndomein.nl,0,0.00%,17,17,0.00%
ns1.liquidweb.com,0,0.00%,6,6,0.00%
ns112.herosite.pro,0,0.00%,2,2,0.00%
ns316.inhostedns.org,0,0.00%,4,4,0.00%
ns1220.deepafrica.com,0,0.00%,2,2,0.00%
ns1.andifiwebstudio.com,0,0.00%,2,2,0.00%
ns113.herosite.pro,0,0.00%,2,2,0.00%
ns1.vultr.com,0,0.00%,12,12,0.00%
ns-558.awsdns-05.net,0,0.00%,2,2,0.00%
lola.ns.cloudflare.com,0,0.00%,10,10,0.00%
ty1-4.nigirocloud.com,0,0.00%,9,9,0.00%
ns1cvw.name.com,0,0.00%,16,16,0.00%
ty2-1.nigirocloud.com,0,0.00%,8,8,0.00%
ns2.sedoparking.com,0,0.00%,70,70,0.00%
ns1.thinkcentre.in,0,0.00%,2,2,0.00%
nsd3.srv53.org,0,0.00%,2,2,0.00%
ns23.inhostedns.net,0,0.00%,2,2,0.00%
mario.ns.cloudflare.com,0,0.00%,12,12,0.00%
ns2dfg.name.com,0,0.00%,6,6,0.00%
ty2-2.nigirocloud.com,0,0.00%,9,9,0.00%
dns1.dwhost.net,0,0.00%,2,2,0.00%
ty2-3.nigirocloud.com,0,0.00%,9,9,0.00%
ns1.whitednszone.com,0,0.00%,2,2,0.00%
ns2.locaweb.com.br,0,0.00%,2,2,0.00%
ty2-4.nigirocloud.com,0,0.00%,9,9,0.00%
dns2.p08.nsone.net,0,0.00%,24,24,0.00%
ns3ckl.name.com,0,0.00%,7,7,0.00%
eu.dnsenable.com,0,0.00%,14,14,0.00%
ty2-5.nigirocloud.com,0,0.00%,9,9,0.00%
dns2.namesecure.com,0,0.00%,4,4,0.00%
ns2.thinkcentre.in,0,0.00%,2,2,0.00%
ns4kpx.name.com,0,0.00%,2,2,0.00%
tr.dnsenable.com,0,0.00%,14,14,0.00%
ns1036.ui-dns.org,0,0.00%,7,7,0.00%
ns2.ascendits.net,0,0.00%,2,2,0.00%
us1-2.nigirocloud.com,0,0.00%,8,8,0.00%
dns1.namesecure.com,0,0.00%,4,4,0.00%
us1-3.nigirocloud.com,0,0.00%,8,8,0.00%
ns4237.hostgator.com,0,0.00%,5,5,0.00%
us.dnsenable.com,0,0.00%,12,12,0.00%
ns1024.ui-dns.com,0,0.00%,6,6,0.00%
us1-4.nigirocloud.com,0,0.00%,9,9,0.00%
ns16221213226.a2dns.com,0,0.00%,2,2,0.00%
ns5.hawkhost.com,0,0.00%,12,12,0.00%
ns4238.hostgator.com,0,0.00%,5,5,0.00%
ns1053.ui-dns.biz,0,0.00%,6,6,0.00%
ns2.serverscientist.com,0,0.00%,2,2,0.00%
dns1.name-services.com,0,0.00%,35,35,0.00%
etta.ns.cloudflare.com,0,0.00%,14,14,0.00%
rachel.ns.cloudflare.com,0,0.00%,2,2,0.00%
ns1052.ui-dns.de,0,0.00%,6,6,0.00%
nsd2.srv53.net,0,0.00%,2,2,0.00%
ns2.redvisionglobal.com,0,0.00%,2,2,0.00%
ns1.webgo.de,0,0.00%,6,6,0.00%
thaddeus.ns.cloudflare.com,0,0.00%,10,10,0.00%
ty2-6.nigirocloud.com,0,0.00%,9,9,0.00%
ns7072.webempresa.eu,0,0.00%,2,2,0.00%
ns1djs.name.com,0,0.00%,4,4,0.00%
ns2.phase8.net,0,0.00%,10,10,0.00%
ashley.ns.cloudflare.com,0,0.00%,6,6,0.00%
ns02.hostnet.nl,0,0.00%,17,17,0.00%
ns16221213221.a2dns.com,0,0.00%,2,2,0.00%
ns2hjl.name.com,0,0.00%,4,4,0.00%
ns1dnx.name.com,0,0.00%,6,6,0.00%
ns1glr.name.com,0,0.00%,6,6,0.00%
9wu652mg-u.funnull01.vip,0,0.00%,2,2,0.00%
max.ns.cloudflare.com,0,0.00%,4,4,0.00%
ns2.digitalocean.com,0,0.00%,25,25,0.00%
ns1.phase8.net,0,0.00%,8,8,0.00%
2-can.njalla.in,0,0.00%,16,16,0.00%
prayerandselfwork.com,0,0.00%,2,2,0.00%
ns2ckr.name.com,0,0.00%,8,8,0.00%
f6qya49d.n.funnull31.com,0,0.00%,2,2,0.00%
ns1.redvisionglobal.com,0,0.00%,2,2,0.00%
ns4dmx.name.com,0,0.00%,2,2,0.00%
ns3qty.name.com,0,0.00%,4,4,0.00%
rodney.ns.cloudflare.com,0,0.00%,6,6,0.00%
ns4bht.name.com,0,0.00%,14,14,0.00%
ns2.jp2.fcomet.com,0,0.00%,2,2,0.00%
ty2-7.nigirocloud.com,0,0.00%,8,8,0.00%
ns4.webgo.de,0,0.00%,8,8,0.00%
nsa2.srv53.net,0,0.00%,2,2,0.00%
ty2-8.nigirocloud.com,0,0.00%,9,9,0.00%
ns1cnb.name.com,0,0.00%,65,65,0.00%
1-you.njalla.no,0,0.00%,16,16,0.00%
os1-1.nigirocloud.com,0,0.00%,8,8,0.00%
ns27.netkl.com,0,0.00%,6,6,0.00%
ns1.beget.com,0,0.00%,143,143,0.00%
os1-2.nigirocloud.com,0,0.00%,9,9,0.00%
os1-3.nigirocloud.com,0,0.00%,9,9,0.00%
ns69.worldnic.com,0,0.00%,13,13,0.00%
os1-4.nigirocloud.com,0,0.00%,10,10,0.00%
ns2.ihswin.com,0,0.00%,2,2,0.00%
ns70.worldnic.com,0,0.00%,13,13,0.00%
ns1094.ui-dns.com,0,0.00%,6,6,0.00%
ns91.cloudracked.com,0,0.00%,2,2,0.00%
ns3.webgo.de,0,0.00%,6,6,0.00%
ns-a3.tenten.vn,0,0.00%,90,90,0.00%
julio.ns.cloudflare.com,0,0.00%,2,2,0.00%
uns02.lolipop.jp,0,0.00%,26,26,0.00%
os1-5.nigirocloud.com,0,0.00%,8,8,0.00%
ns-2043.awsdns-63.co.uk,0,0.00%,2,2,0.00%
nsc3.srv53.com,0,0.00%,2,2,0.00%
ns2.beget.com,0,0.00%,136,136,0.00%
hope.ns.cloudflare.com,0,0.00%,6,6,0.00%
uns01.lolipop.jp,0,0.00%,25,25,0.00%
cpanel4.lws-hosting.com,0,0.00%,4,4,0.00%
ns-449.awsdns-56.com,0,0.00%,2,2,0.00%
graham.ns.cloudflare.com,0,0.00%,6,6,0.00%
dns4.p01.nsone.net,0,0.00%,30,30,0.00%
ns1.ihswin.com,0,0.00%,2,2,0.00%
roan.ns.cloudflare.com,0,0.00%,6,6,0.00%
ns4243.hostgator.com,0,0.00%,6,6,0.00%
ns3.stilx.ro,0,0.00%,2,2,0.00%
leah.ns.cloudflare.com,0,0.00%,8,8,0.00%
paige.ns.cloudflare.com,0,0.00%,4,4,0.00%
ns2.emailverification.info,0,0.00%,7,7,0.00%
cpanel3.lws-hosting.com,0,0.00%,4,4,0.00%
ns5.afternic.com,0,0.00%,27,27,0.00%
ns-801.awsdns-36.net,0,0.00%,4,4,0.00%
ns4244.hostgator.com,0,0.00%,6,6,0.00%
ns2.webgo.de,0,0.00%,6,6,0.00%
vida.ns.cloudflare.com,0,0.00%,6,6,0.00%
johnathan.ns.cloudflare.com,0,0.00%,6,6,0.00%
dns1.talahost.com,0,0.00%,2,2,0.00%
ns3.argewebhosting.nl,0,0.00%,2,2,0.00%
ns1.regery.net,0,0.00%,2,2,0.00%
selah.ns.cloudflare.com,0,0.00%,4,4,0.00%
nsc3.srv53.net,0,0.00%,4,4,0.00%
ns1.shopco.com,0,0.00%,2,2,0.00%
porter.ns.cloudflare.com,0,0.00%,6,6,0.00%
ns-1699.awsdns-20.co.uk,0,0.00%,2,2,0.00%
byron.ns.cloudflare.com,0,0.00%,8,8,0.00%
ns2.argewebhosting.com,0,0.00%,2,2,0.00%
ns90.worldnic.com,0,0.00%,10,10,0.00%
ns1.beget.pro,0,0.00%,129,129,0.00%
becky.ns.cloudflare.com,0,0.00%,6,6,0.00%
ns-224.awsdns-28.com,0,0.00%,2,2,0.00%
reza.ns.cloudflare.com,0,0.00%,6,6,0.00%
elinore.ns.cloudflare.com,0,0.00%,8,8,0.00%
ns4.stilx.ro,0,0.00%,2,2,0.00%
ns2.beget.pro,0,0.00%,144,144,0.00%
ns-222-c.gandi.net,0,0.00%,2,2,0.00%
may.ns.cloudflare.com,0,0.00%,4,4,0.00%
ns146.hostgator.com.br,0,0.00%,2,2,0.00%
kai.ns.cloudflare.com,0,0.00%,4,4,0.00%
gail.ns.cloudflare.com,0,0.00%,4,4,0.00%
1-ceci.njalla.do,0,0.00%,4,4,0.00%
ns-1906.awsdns-46.co.uk,0,0.00%,2,2,0.00%
ns1.stwtx.com,0,0.00%,2,2,0.00%
felicity.ns.cloudflare.com,0,0.00%,6,6,0.00%
ns1.domainpeople.com,0,0.00%,2,2,0.00%
christian.ns.cloudflare.com,0,0.00%,7,7,0.00%
galilea.ns.cloudflare.com,0,0.00%,44,44,0.00%
nsb4.srv53.net,0,0.00%,2,2,0.00%
ns1.argewebhosting.eu,0,0.00%,2,2,0.00%
docks10.rzone.de,0,0.00%,2,2,0.00%
2-nest.njalla.ma,0,0.00%,1,1,0.00%
isabel.ns.cloudflare.com,0,0.00%,8,8,0.00%
ns147.hostgator.com.br,0,0.00%,2,2,0.00%
3-pas.njalla.in,0,0.00%,4,4,0.00%
ns3.shopco.com,0,0.00%,2,2,0.00%
ns5.ddoshosting.ro,0,0.00%,2,2,0.00%
shades19.rzone.de,0,0.00%,4,4,0.00%
ns-253-b.gandi.net,0,0.00%,2,2,0.00%
ns34.hostnownow.com,0,0.00%,2,2,0.00%
ns35.hostnownow.com,0,0.00%,2,2,0.00%
ns2.ekkhost.com,0,0.00%,2,2,0.00%
ns1103.ui-dns.com,0,0.00%,8,8,0.00%
ns3.asynet.ro,0,0.00%,2,2,0.00%
docks02.rzone.de,0,0.00%,4,4,0.00%
ns85.worldnic.com,0,0.00%,7,7,0.00%
pablo.ns.cloudflare.com,0,0.00%,8,8,0.00%
ns86.worldnic.com,0,0.00%,6,6,0.00%
ns1092.ui-dns.org,0,0.00%,6,6,0.00%
ns1064.ui-dns.org,0,0.00%,11,11,0.00%
kami.ns.cloudflare.com,0,0.00%,10,10,0.00%
venus.ns.cloudflare.com,0,0.00%,2,2,0.00%
ns1091.ui-dns.de,0,0.00%,6,6,0.00%
ns1049.ui-dns.de,0,0.00%,6,6,0.00%
nsb4.srv53.com,0,0.00%,2,2,0.00%
ns1126.ui-dns.biz,0,0.00%,7,7,0.00%
nsc2.srv53.org,0,0.00%,2,2,0.00%
ns6.ddoshosting.ro,0,0.00%,2,2,0.00%
ns1028.ui-dns.biz,0,0.00%,6,6,0.00%
ns-193-a.gandi.net,0,0.00%,2,2,0.00%
ns1116.ui-dns.com,0,0.00%,6,6,0.00%
ns1511.banahosting.com,0,0.00%,2,2,0.00%
ns25.domaincontrol.com,0,0.00%,70,70,0.00%
dns2.dapurhosting.net,0,0.00%,4,4,0.00%
ns1510.banahosting.com,0,0.00%,2,2,0.00%
ns26.domaincontrol.com,0,0.00%,73,73,0.00%
ns.asynet.ro,0,0.00%,2,2,0.00%
journey.ns.cloudflare.com,0,0.00%,6,6,0.00%
verification-9b79072f.ns3.dan.hosting,0,0.00%,4,4,0.00%
leonard.ns.cloudflare.com,0,0.00%,6,6,0.00%
dns150.a.register.com,0,0.00%,2,2,0.00%
ns28.netkl.com,0,0.00%,6,6,0.00%
nsc4.srv53.org,0,0.00%,2,2,0.00%
brenna.ns.cloudflare.com,0,0.00%,9,9,0.00%
ns2.domainpeople.com,0,0.00%,2,2,0.00%
bruce.ns.cloudflare.com,0,0.00%,4,4,0.00%
ns2.myhostadmin.net,0,0.00%,72,72,0.00%
ns02.one.com,0,0.00%,148,148,0.00%
ns2.asynet.ro,0,0.00%,2,2,0.00%
ns01.one.com,0,0.00%,87,87,0.00%
rodrigo.ns.cloudflare.com,0,0.00%,2,2,0.00%
ns144.neubox.net,0,0.00%,6,6,0.00%
ns-1167.awsdns-17.org,0,0.00%,2,2,0.00%
nsa2.srv53.com,0,0.00%,4,4,0.00%
ns-2021.awsdns-60.co.uk,0,0.00%,2,2,0.00%
ina1.registrar.eu,0,0.00%,8,8,0.00%
ns-451.awsdns-56.com,0,0.00%,2,2,0.00%
ns11.net,0,0.00%,2,2,0.00%
ns-956.awsdns-55.net,0,0.00%,2,2,0.00%
ns1073.ui-dns.com,0,0.00%,2,2,0.00%
dns4.kinghost.com.br,0,0.00%,2,2,0.00%
arcane-stream-1752.herokuapp.com,0,0.00%,1,1,0.00%
nsb3.srv53.org,0,0.00%,2,2,0.00%
ina2.registrar.eu,0,0.00%,8,8,0.00%
ns1067.ui-dns.de,0,0.00%,6,6,0.00%
ns2fgv.name.com,0,0.00%,2,2,0.00%
junade.ns.cloudflare.com,0,0.00%,10,10,0.00%
peaches.ns.cloudflare.com,0,0.00%,6,6,0.00%
phil.ns.cloudflare.com,0,0.00%,6,6,0.00%
violet.ns.cloudflare.com,0,0.00%,14,14,0.00%
ns-102.awsdns-12.com,0,0.00%,2,2,0.00%
ns-1984.awsdns-56.co.uk,0,0.00%,2,2,0.00%
dns6.kinghost.com.br,0,0.00%,2,2,0.00%
dns5.kinghost.com.br,0,0.00%,2,2,0.00%
dns4.dapurhosting.net,0,0.00%,4,4,0.00%
ns39.domaincontrol.com,0,0.00%,6,6,0.00%
mariah.ns.cloudflare.com,0,0.00%,16,16,0.00%
ty1-1.nigirocloud.com,0,0.00%,9,9,0.00%
ns2.gocheapweb.com,0,0.00%,4,4,0.00%
ty1-2.nigirocloud.com,0,0.00%,8,8,0.00%
kayleigh.ns.cloudflare.com,0,0.00%,3,3,0.00%
ns-973.awsdns-57.net,0,0.00%,4,4,0.00%
dns1.host-redirect.com,0,0.00%,4,4,0.00%
ns1.dns.ne.jp,0,0.00%,18,18,0.00%
ns-1466.awsdns-55.org,0,0.00%,2,2,0.00%
os1-6.nigirocloud.com,0,0.00%,9,9,0.00%
ns268.cretaforce.gr,0,0.00%,2,2,0.00%
ns-1793.awsdns-32.co.uk,0,0.00%,2,2,0.00%
os2-5.nigirocloud.com,0,0.00%,8,8,0.00%
elias.ns.cloudflare.com,0,0.00%,5,5,0.00%
jm1.dns.com,0,0.00%,627,627,0.00%
angelina.ns.cloudflare.com,0,0.00%,6,6,0.00%
ns2.dns.ne.jp,0,0.00%,18,18,0.00%
ns1.dns.com,0,0.00%,59,59,0.00%
ns11.bahiaservers.com,0,0.00%,2,2,0.00%
grace.ns.cloudflare.com,0,0.00%,38,38,0.00%
ns3cna.name.com,0,0.00%,71,71,0.00%
jm2.dns.com,0,0.00%,1236,1236,0.00%
ns2.veridyen.com,0,0.00%,6,6,0.00%
ns-367.awsdns-45.com,0,0.00%,2,2,0.00%
pdns07.domaincontrol.com,0,0.00%,26,26,0.00%
mdns3.hostwindsdns.com,0,0.00%,2,2,0.00%
os2-6.nigirocloud.com,0,0.00%,9,9,0.00%
ns3.niagahoster.com,0,0.00%,21,21,0.00%
steven.ns.cloudflare.com,0,0.00%,23,23,0.00%
ns2.dns.com,0,0.00%,61,61,0.00%
pjslot724.com,0,0.00%,2,2,0.00%
ns4fmw.name.com,0,0.00%,42,42,0.00%
os2-4.nigirocloud.com,0,0.00%,9,9,0.00%
noel.ns.cloudflare.com,0,0.00%,4,4,0.00%
pjvip724.com,0,0.00%,2,2,0.00%
os1-7.nigirocloud.com,0,0.00%,9,9,0.00%
rafe.ns.cloudflare.com,0,0.00%,20,20,0.00%
ns1.hostns.io,0,0.00%,2,2,0.00%
damien.ns.cloudflare.com,0,0.00%,4,4,0.00%
mdns4.hostwindsdns.com,0,0.00%,2,2,0.00%
cora.ns.cloudflare.com,0,0.00%,2,2,0.00%
os1-8.nigirocloud.com,0,0.00%,9,9,0.00%
ns6.hawkhost.com,0,0.00%,12,12,0.00%
ns-a1.tenten.vn,0,0.00%,48,48,0.00%
ns1.veridyen.com,0,0.00%,5,5,0.00%
ns4.niagahoster.com,0,0.00%,22,22,0.00%
dns4.talahost.com,0,0.00%,2,2,0.00%
ns-513.awsdns-00.net,0,0.00%,2,2,0.00%
os2-1.nigirocloud.com,0,0.00%,9,9,0.00%
ns6210.hostgator.com,0,0.00%,2,2,0.00%
ns-canada.topdns.com,0,0.00%,9,9,0.00%
venus.paginesi.it,0,0.00%,2,2,0.00%
ns1.ps.kz,0,0.00%,2,2,0.00%
martin.ns.cloudflare.com,0,0.00%,15,15,0.00%
nina.ns.cloudflare.com,0,0.00%,6,6,0.00%
os2-2.nigirocloud.com,0,0.00%,9,9,0.00%
os2-3.nigirocloud.com,0,0.00%,9,9,0.00%
ns1.accountsupport.com,0,0.00%,2,2,0.00%
nl3-4.nigirocloud.com,0,0.00%,9,9,0.00%
ns10.bahiaservers.com,0,0.00%,2,2,0.00%
ns2.madrakpro.com,0,0.00%,2,2,0.00%
ns6.speedyconnect.net,0,0.00%,2,2,0.00%
ns-74-b.gandi.net,0,0.00%,2,2,0.00%
dns5.name-services.com,0,0.00%,33,33,0.00%
ns-usa.topdns.com,0,0.00%,10,10,0.00%
athena.paginesi.it,0,0.00%,2,2,0.00%
ns2.natrohost.com,0,0.00%,38,38,0.00%
ns1.speedydns.net,0,0.00%,2,2,0.00%
ns2.cafe24.co.kr,0,0.00%,20,20,0.00%
ezra.ns.cloudflare.com,0,0.00%,6,6,0.00%
dns2.onamae.com,0,0.00%,28,28,0.00%
ns1.servidordosangolanos.com,0,0.00%,2,2,0.00%
ns1079.ui-dns.biz,0,0.00%,6,6,0.00%
ns0.nl,0,0.00%,2,2,0.00%
ns1.vodien.com,0,0.00%,2,2,0.00%
nl1-4.nigirocloud.com,0,0.00%,9,9,0.00%
pnmbah.com,0,0.00%,2,2,0.00%
tim.ns.cloudflare.com,0,0.00%,6,6,0.00%
nl1-5.nigirocloud.com,0,0.00%,9,9,0.00%
ns1.everleap.com,0,0.00%,2,2,0.00%
ns2.domainesia.net,0,0.00%,42,42,0.00%
dns1.onamae.com,0,0.00%,34,34,0.00%
ns1.cafe24.com,0,0.00%,19,19,0.00%
ns2kqz.name.com,0,0.00%,12,12,0.00%
ns1035.ui-dns.de,0,0.00%,6,6,0.00%
sue.ns.cloudflare.com,0,0.00%,2,2,0.00%
ns1.podkryshey.com,0,0.00%,2,2,0.00%
ns2.ps.kz,0,0.00%,2,2,0.00%
ns1.cafe24.co.kr,0,0.00%,20,20,0.00%
cdns3.interserver.net,0,0.00%,2,2,0.00%
ns1055.ui-dns.biz,0,0.00%,5,5,0.00%
ns1094.ui-dns.de,0,0.00%,2,2,0.00%
chi-ns2.websitehostserver.net,0,0.00%,8,8,0.00%
ns-985.awsdns-59.net,0,0.00%,2,2,0.00%
nl1-6.nigirocloud.com,0,0.00%,9,9,0.00%
ns2.cafe24.com,0,0.00%,21,21,0.00%
ns1.atthost.pl,0,0.00%,2,2,0.00%
olga.ns.cloudflare.com,0,0.00%,4,4,0.00%
ns4910.banahosting.com,0,0.00%,2,2,0.00%
ns2.99midns.com,0,0.00%,47,47,0.00%
v1s1.xundns.com,0,0.00%,23,23,0.00%
ns14.xincache.com,0,0.00%,7,7,0.00%
jm1.alidns.com,0,0.00%,42,42,0.00%
ns11.xincache.com,0,0.00%,44,44,0.00%
ns2.above.com,0,0.00%,246,246,0.00%
v1s2.xundns.com,0,0.00%,41,41,0.00%
ns2.mtavdns.com,0,0.00%,22,22,0.00%
ns1.above.com,0,0.00%,161,161,0.00%
ns13.xincache.com,0,0.00%,8,8,0.00%
ns1.register.it,0,0.00%,36,36,0.00%
now1.dns.com,0,0.00%,16,16,0.00%
ns1.99midns.com,0,0.00%,84,84,0.00%
ns1.mtavdns.com,0,0.00%,25,25,0.00%
ns17.xincache.com,0,0.00%,5,5,0.00%
ns53.domaincontrol.com,0,0.00%,110,110,0.00%
now2.dns.com,0,0.00%,14,14,0.00%
ns59.sudoly.com,0,0.00%,6,6,0.00%
sportsbettingskills.com,0,0.00%,1,1,0.00%
ns58.sudoly.com,0,0.00%,5,5,0.00%
verification-sjmtjn07.ns3.dan.hosting,0,0.00%,1,1,0.00%
ns55.domaincontrol.com,0,0.00%,4,4,0.00%
ns18.xincache.com,0,0.00%,6,6,0.00%
ns56.domaincontrol.com,0,0.00%,4,4,0.00%
verification-4r7jfx5n.ns3.dan.hosting,0,0.00%,1,1,0.00%
ns2.yeyehaidns.com,0,0.00%,16,16,0.00%
dm1.dns.com,0,0.00%,97,97,0.00%
ns2.renewyourname.net,0,0.00%,6,6,0.00%
ns1.yeyehaidns.com,0,0.00%,32,32,0.00%
devin.ns.cloudflare.com,0,0.00%,3,3,0.00%
dm2.dns.com,0,0.00%,83,83,0.00%
dns2.namebay.com,0,0.00%,20,20,0.00%
ns-251-b.gandi.net,0,0.00%,1,1,0.00%
ns364.dnsever.com,0,0.00%,17,17,0.00%
coleman.ns.cloudflare.com,0,0.00%,4,4,0.00%
ns91.worldnic.com,0,0.00%,11,11,0.00%
harleigh.ns.cloudflare.com,0,0.00%,2,2,0.00%
ns2.mediatemple.net,0,0.00%,1,1,0.00%
ns1.renewyourname.net,0,0.00%,3,3,0.00%
ns391.dnsever.com,0,0.00%,33,33,0.00%
ns2.c008jp5381.info,0,0.00%,4,4,0.00%
dns1.namebay.com,0,0.00%,11,11,0.00%
ns1626.ztomy.com,0,0.00%,23,23,0.00%
ns92.worldnic.com,0,0.00%,11,11,0.00%
marjory.ns.cloudflare.com,0,0.00%,10,10,0.00%
ns01.domaincontrol.com,0,0.00%,88,88,0.00%
ns1.servconfig.com,0,0.00%,1,1,0.00%
ns2.aftermarket.pl,0,0.00%,2,2,0.00%
ns7-2.cvtdns.com,0,0.00%,2,2,0.00%
ns-486.awsdns-60.com,0,0.00%,3,3,0.00%
ns2.yongldns.com,0,0.00%,25,25,0.00%
ns02.domaincontrol.com,0,0.00%,88,88,0.00%
ns2.servconfig.com,0,0.00%,1,1,0.00%
ns7-3.cvtdns.com,0,0.00%,2,2,0.00%
naomi.ns.cloudflare.com,0,0.00%,7,7,0.00%
ns9.hawkhost.com,0,0.00%,9,9,0.00%
ns330.dnsever.com,0,0.00%,17,17,0.00%
ns7-4.cvtdns.com,0,0.00%,1,1,0.00%
west.ns.cloudflare.com,0,0.00%,21,21,0.00%
wanda.ns.cloudflare.com,0,0.00%,3,3,0.00%
ns1.inmotionhosting.com,0,0.00%,29,29,0.00%
ns1045.ui-dns.biz,0,0.00%,7,7,0.00%
ns2.wpx.ne.jp,0,0.00%,8,8,0.00%
ns1.hosting.co.kr,0,0.00%,5,5,0.00%
ns311.dnsever.com,0,0.00%,36,36,0.00%
ns1045.ui-dns.com,0,0.00%,6,6,0.00%
ns41.infomaniak.com,0,0.00%,14,14,0.00%
aisha.ns.cloudflare.com,0,0.00%,20,20,0.00%
ns1.wpx.ne.jp,0,0.00%,8,8,0.00%
ns1.catch.club,0,0.00%,6,6,0.00%
ns42.infomaniak.com,0,0.00%,12,12,0.00%
salvador.ns.cloudflare.com,0,0.00%,58,58,0.00%
cnhantong.com,0,0.00%,2,2,0.00%
ns1.34web.com,0,0.00%,1,1,0.00%
ns1045.ui-dns.de,0,0.00%,12,12,0.00%
ns1.aftermarket.pl,0,0.00%,1,1,0.00%
ns6.afternic.com,0,0.00%,17,17,0.00%
ns1045.ui-dns.org,0,0.00%,13,13,0.00%
ns2.theoprofil-coldrooms.com,0,0.00%,1,1,0.00%
ns2hkt.name.com,0,0.00%,20,20,0.00%
tate.ns.cloudflare.com,0,0.00%,4,4,0.00%
64.push2his.eastmoney.com,0,0.00%,4,4,0.00%
blob.bn6prdstr04a.store.core.windows.NET,0,0.00%,2,2,0.00%
43.push2his.eastmoney.com,0,0.00%,1,1,0.00%
20.push2his.eastmoney.com,0,0.00%,1,1,0.00%
42.push2his.eastmoney.com,0,0.00%,3,3,0.00%
92.push2his.eastmoney.com,0,0.00%,2,2,0.00%
56.push2his.eastmoney.com,0,0.00%,1,1,0.00%
93.push2his.eastmoney.com,0,0.00%,3,3,0.00%
85.push2his.eastmoney.com,0,0.00%,1,1,0.00%
38.push2his.eastmoney.com,0,0.00%,1,1,0.00%
89.push2his.eastmoney.com,0,0.00%,1,1,0.00%
marty.ns.cloudflare.com,0,0.00%,12,12,0.00%
margot.ns.cloudflare.com,0,0.00%,6,6,0.00%
sandy.ns.cloudflare.com,0,0.00%,20,20,0.00%
00000000000000000000000000000000000000000000000000000000000015a.rui77.com,0,0.00%,11,11,0.00%
connie.ns.cloudflare.com,0,0.00%,5,5,0.00%
zac.ns.cloudflare.com,0,0.00%,8,8,0.00%
ns1.dne.com,0,0.00%,15,15,0.00%
a.ns.yavapairegionalcapital.com,0,0.00%,2,2,0.00%
ns1.squadhelp.com,0,0.00%,7,7,0.00%
ns2.dne.com,0,0.00%,23,23,0.00%
noah.ns.cloudflare.com,0,0.00%,8,8,0.00%
ns2.squadhelp.com,0,0.00%,7,7,0.00%
ns2.controlplatform.com,0,0.00%,1,1,0.00%
evoke-windowsservices-tas.msedge.net,0,0.00%,14,14,0.00%
b.ns.yavapairegionalcapital.com,0,0.00%,1,1,0.00%
verification-1815a6e5.ns3.dan.hosting,0,0.00%,10,10,0.00%
ns1.intellectualreserveinc.org,0,0.00%,1,1,0.00%
ns2626.ztomy.com,0,0.00%,12,12,0.00%
maxspeed142.rayanegarco.com,0,0.00%,1,1,0.00%
ns.inmotionhosting.com,0,0.00%,3,3,0.00%
verification-7qd5kkbg.ns3.dan.hosting,0,0.00%,1,1,0.00%
verification-nputkrls.ns3.dan.hosting,0,0.00%,6,6,0.00%
ns1.controlplatform.com,0,0.00%,1,1,0.00%
ns31.intellectualreserveinc.org,0,0.00%,1,1,0.00%
ns-1071.awsdns-05.org,0,0.00%,1,1,0.00%
apexspstore.com,0,0.00%,2,2,0.00%
arch.ns.cloudflare.com,0,0.00%,4,4,0.00%
ns-1773.awsdns-29.co.uk,0,0.00%,1,1,0.00%
cris.ns.cloudflare.com,0,0.00%,19,19,0.00%
ns-335.awsdns-41.com,0,0.00%,1,1,0.00%
ns-922.awsdns-51.net,0,0.00%,3,3,0.00%
ns36.worldnic.com,0,0.00%,13,13,0.00%
ns32.intellectualreserveinc.org,0,0.00%,1,1,0.00%
jm2.alidns.com,0,0.00%,22,22,0.00%
ns33.intellectualreserveinc.org,0,0.00%,1,1,0.00%
ns1.zhaimandns.com,0,0.00%,70,70,0.00%
kellen.ns.cloudflare.com,0,0.00%,24,24,0.00%
ns2.zhaimandns.com,0,0.00%,63,63,0.00%
mike.ns.cloudflare.com,0,0.00%,4,4,0.00%
ns1.c015jp6701.info,0,0.00%,1,1,0.00%
nucum.ns.cloudflare.com,0,0.00%,3,3,0.00%
ns34.intellectualreserveinc.org,0,0.00%,2,2,0.00%
dns1.dnshostnetwork.com,0,0.00%,1,1,0.00%
ns2.c015jp6701.info,0,0.00%,1,1,0.00%
dns2.dnshostnetwork.com,0,0.00%,1,1,0.00%
ns1.site4now.net,0,0.00%,3,3,0.00%
ns3.epik.com,0,0.00%,20,20,0.00%
ashinlokapala.com,0,0.00%,1,1,0.00%
ns4.epik.com,0,0.00%,16,16,0.00%
ns1.c008jp5381.info,0,0.00%,2,2,0.00%
ns41.worldnic.com,0,0.00%,19,19,0.00%
kelly.ns.cloudflare.com,0,0.00%,7,7,0.00%
cash.ns.cloudflare.com,0,0.00%,2,2,0.00%
macy.ns.cloudflare.com,0,0.00%,4,4,0.00%
ns489.websitewelcome.com,0,0.00%,1,1,0.00%
amalia.ns.cloudflare.com,0,0.00%,20,20,0.00%
ns6.csof.net,0,0.00%,2,2,0.00%
frida.ns.cloudflare.com,0,0.00%,2,2,0.00%
ns2.dondominio.com,0,0.00%,6,6,0.00%
ns490.websitewelcome.com,0,0.00%,1,1,0.00%
ns1.uniregistrymarket.link,0,0.00%,9,9,0.00%
rick.ns.cloudflare.com,0,0.00%,3,3,0.00%
ns2.uniregistrymarket.link,0,0.00%,12,12,0.00%
ns1.dondominio.com,0,0.00%,5,5,0.00%
verification-91ow1i3.ns3.dan.hosting,0,0.00%,1,1,0.00%
ns03.domaincntrol.com,0,0.00%,9,9,0.00%
ns04.domaincntrol.com,0,0.00%,13,13,0.00%
dns.wnsr12h5cdn.com,0,0.00%,2,2,0.00%
pltraffic7.com,0,0.00%,3,3,0.00%
ns2.parklogic.com,0,0.00%,16,16,0.00%
ns69.domaincontrol.com,0,0.00%,2,2,0.00%
ns1.parklogic.com,0,0.00%,15,15,0.00%
ns70.domaincontrol.com,0,0.00%,2,2,0.00%
ns01.i-mecca.net,0,0.00%,1,1,0.00%
verification1.plaindns.net,0,0.00%,14,14,0.00%
prod-sav-park-lb01-1919960993.us-east-2.elb.amazonaws.com,0,0.00%,64,64,0.00%
ns1.yongldns.com,0,0.00%,26,26,0.00%
oaklyn.ns.cloudflare.com,0,0.00%,6,6,0.00%
NORA.NS.CLOUDFLARE.com,0,0.00%,2,2,0.00%
sullivan.ns.cloudflare.com,0,0.00%,4,4,0.00%
annalise.ns.cloudflare.com,0,0.00%,4,4,0.00%
ns0.i-mecca.net,0,0.00%,2,2,0.00%
ns349.dnsever.com,0,0.00%,25,25,0.00%
y.ns.joker.com,0,0.00%,2,2,0.00%
z.ns.joker.com,0,0.00%,4,4,0.00%
x.ns.joker.com,0,0.00%,3,3,0.00%
hostmaster.topdns.com,0,0.00%,1,1,0.00%
www.youngzsoft.com,0,0.00%,1,1,0.00%
anderson.ns.cloudflare.com,0,0.00%,4,4,0.00%
ns1055.ui-dns.de,0,0.00%,1,1,0.00%
detectportal.prod.mozaws.net,0,0.00%,51,51,0.00%
henry.ns.cloudflare.com,0,0.00%,2,2,0.00%
meadow.ns.cloudflare.com,0,0.00%,5,5,0.00%
ns-1083.awsdns-07.org,0,0.00%,1,1,0.00%
liz.ns.cloudflare.com,0,0.00%,9,9,0.00%
olof.ns.cloudflare.com,0,0.00%,2,2,0.00%
ns-1757.awsdns-27.co.uk,0,0.00%,2,2,0.00%
czwxdsw.com,0,0.00%,1,1,0.00%
ns-743.awsdns-28.net,0,0.00%,3,3,0.00%
ns1.in1.indibiz.com,0,0.00%,2,2,0.00%
lingdongled.com,0,0.00%,1,1,0.00%
cloe.ns.cloudflare.com,0,0.00%,2,2,0.00%
ns2clp.name.com,0,0.00%,1,1,0.00%
ns2.in1.indibiz.com,0,0.00%,1,1,0.00%
ns4fmx.name.com,0,0.00%,8,8,0.00%
dan.ns.cloudflare.com,0,0.00%,10,10,0.00%
dns3003b.trouble-free.net,0,0.00%,3,3,0.00%
pdns03.domaincontrol.com,0,0.00%,2,2,0.00%
ara.ns.cloudflare.com,0,0.00%,1,1,0.00%
carioca.ns.cloudflare.com,0,0.00%,25,25,0.00%
pdns04.domaincontrol.com,0,0.00%,2,2,0.00%
guy.ns.cloudflare.com,0,0.00%,2,2,0.00%
neil.ns.cloudflare.com,0,0.00%,5,5,0.00%
ns2.my-logos.com,0,0.00%,1,1,0.00%
ns1cwy.name.com,0,0.00%,7,7,0.00%
ns-214-c.gandi.net,0,0.00%,1,1,0.00%
ns1.my-logos.com,0,0.00%,1,1,0.00%
ns3jkl.name.com,0,0.00%,3,3,0.00%
ns4dls.name.com,0,0.00%,1,1,0.00%
ns-127-a.gandi.net,0,0.00%,2,2,0.00%
ns2.289945.cloudns.net,0,0.00%,1,1,0.00%
t.17986.net,0,0.00%,2,2,0.00%
dns2.name-services.com,0,0.00%,38,38,0.00%
ns1.289945.cloudns.net,0,0.00%,1,1,0.00%
dns4.name-services.com,0,0.00%,42,42,0.00%
tia.ns.cloudflare.com,0,0.00%,8,8,0.00%
ollie.ns.cloudflare.com,0,0.00%,4,4,0.00%
melissa.ns.cloudflare.com,0,0.00%,3,3,0.00%
ns65.hostgator.mx,0,0.00%,1,1,0.00%
hank.ns.cloudflare.com,0,0.00%,8,8,0.00%
ns64.hostgator.mx,0,0.00%,1,1,0.00%
pns11.cloudns.net,0,0.00%,2,2,0.00%
ns12.cloudns.net,0,0.00%,2,2,0.00%
pdns13.domaincontrol.com,0,0.00%,12,12,0.00%
pns13.cloudns.net,0,0.00%,1,1,0.00%
pdns14.domaincontrol.com,0,0.00%,10,10,0.00%
ns11.cloudns.net,0,0.00%,2,2,0.00%
dns1.netsons.net,0,0.00%,1,1,0.00%
ns4.fornex.com,0,0.00%,8,8,0.00%
emma.ns.cloudflare.com,0,0.00%,40,40,0.00%
pns12.cloudns.net,0,0.00%,1,1,0.00%
career2college.com,0,0.00%,2,2,0.00%
ns13.cloudns.net,0,0.00%,1,1,0.00%
ns30.worldnic.com,0,0.00%,18,18,0.00%
doug.ns.cloudflare.com,0,0.00%,6,6,0.00%
christina.ns.cloudflare.com,0,0.00%,1,1,0.00%
ns27.worldnic.com,0,0.00%,8,8,0.00%
ns0.centralnic.net,0,0.00%,135,135,0.00%
leanna.ns.cloudflare.com,0,0.00%,4,4,0.00%
ns11.domaincontrol.com,0,0.00%,128,128,0.00%
everton.ns.cloudflare.com,0,0.00%,2,2,0.00%
ns45.worldnic.com,0,0.00%,20,20,0.00%
ns2.inet.vn,0,0.00%,20,20,0.00%
ns12.domaincontrol.com,0,0.00%,127,127,0.00%
ns1.iwebhostph.com,0,0.00%,6,6,0.00%
ns46.worldnic.com,0,0.00%,12,12,0.00%
ns39.worldnic.com,0,0.00%,6,6,0.00%
ns4.myhostadmin.net,0,0.00%,47,47,0.00%
ns6.myhostadmin.net,0,0.00%,72,72,0.00%
ns2.cprapid.com,0,0.00%,1,1,0.00%
ns22.worldnic.com,0,0.00%,12,12,0.00%
quiz-proxy.marquiz.ru,0,0.00%,2,2,0.00%
ns40.worldnic.com,0,0.00%,6,6,0.00%
ns5.myhostadmin.net,0,0.00%,70,70,0.00%
ns32.worldnic.com,0,0.00%,4,4,0.00%
ns1.inet.vn,0,0.00%,15,15,0.00%
ns3.myhostadmin.net,0,0.00%,49,49,0.00%
ns94.worldnic.com,0,0.00%,19,19,0.00%
ns2kry.name.com,0,0.00%,4,4,0.00%
ns62.worldnic.com,0,0.00%,13,13,0.00%
ns23.worldnic.com,0,0.00%,4,4,0.00%
ns12.worldnic.com,0,0.00%,16,16,0.00%
ns4jpz.name.com,0,0.00%,8,8,0.00%
ns61.worldnic.com,0,0.00%,11,11,0.00%
ns24.worldnic.com,0,0.00%,4,4,0.00%
ns3.inet.vn,0,0.00%,14,14,0.00%
ns51.worldnic.com,0,0.00%,10,10,0.00%
ns1.gabia.co.kr,0,0.00%,48,48,0.00%
ns42.worldnic.com,0,0.00%,11,11,0.00%
imani.ns.cloudflare.com,0,0.00%,4,4,0.00%
ns2.iwebhostph.com,0,0.00%,3,3,0.00%
ns17.worldnic.com,0,0.00%,7,7,0.00%
ns.gabia.net,0,0.00%,52,52,0.00%
ns52.worldnic.com,0,0.00%,9,9,0.00%
ruben.ns.cloudflare.com,0,0.00%,8,8,0.00%
joyce.ns.cloudflare.com,0,0.00%,18,18,0.00%
ns4.timeweb.org,0,0.00%,82,82,0.00%
rory.ns.cloudflare.com,0,0.00%,18,18,0.00%
dns02.valehostph.com,0,0.00%,2,2,0.00%
ns2.timeweb.ru,0,0.00%,76,76,0.00%
ns1.myhostadmin.net,0,0.00%,68,68,0.00%
ns15.bestla.net,0,0.00%,2,2,0.00%
ns49.worldnic.com,0,0.00%,12,12,0.00%
ns1.timeweb.ru,0,0.00%,70,70,0.00%
ns16.worldnic.com,0,0.00%,15,15,0.00%
ns28.worldnic.com,0,0.00%,16,16,0.00%
ns1.reg.ru,0,0.00%,554,554,0.00%
dns01.valehostph.com,0,0.00%,2,2,0.00%
ns50.worldnic.com,0,0.00%,20,20,0.00%
73.push2his.eastmoney.com,0,0.00%,1,1,0.00%
ns3.timeweb.org,0,0.00%,75,75,0.00%
ns15.worldnic.com,0,0.00%,13,13,0.00%
65.push2his.eastmoney.com,0,0.00%,1,1,0.00%
ns2.vercel-dns.com,0,0.00%,8,8,0.00%
ns55.worldnic.com,0,0.00%,26,26,0.00%
35.push2his.eastmoney.com,0,0.00%,4,4,0.00%
74.push2his.eastmoney.com,0,0.00%,5,5,0.00%
nitin.ns.cloudflare.com,0,0.00%,6,6,0.00%
ns56.worldnic.com,0,0.00%,13,13,0.00%
ns16.bestla.net,0,0.00%,1,1,0.00%
sima.ns.cloudflare.com,0,0.00%,7,7,0.00%
ns35.worldnic.com,0,0.00%,26,26,0.00%
ns12.inhostedns.com,0,0.00%,1,1,0.00%
adi.ns.cloudflare.com,0,0.00%,14,14,0.00%
kurt.ns.cloudflare.com,0,0.00%,12,12,0.00%
dns30.hichina.com,0,0.00%,52,52,0.00%
ns26.worldnic.com,0,0.00%,8,8,0.00%
ns54.worldnic.com,0,0.00%,5,5,0.00%
ns56.hostgator.mx,0,0.00%,1,1,0.00%
dns29.hichina.com,0,0.00%,52,52,0.00%
ns25.worldnic.com,0,0.00%,4,4,0.00%
ns53.worldnic.com,0,0.00%,8,8,0.00%
maeve.ns.cloudflare.com,0,0.00%,3,3,0.00%
yew.ns.cloudflare.com,0,0.00%,1,1,0.00%
ns22.inhostedns.net,0,0.00%,1,1,0.00%
ns1.atomicat.pro,0,0.00%,6,6,0.00%
ns2.atomicat.pro,0,0.00%,6,6,0.00%
ns57.worldnic.com,0,0.00%,16,16,0.00%
jessica.ns.cloudflare.com,0,0.00%,31,31,0.00%
ns58.worldnic.com,0,0.00%,14,14,0.00%
ns99.worldnic.com,0,0.00%,15,15,0.00%
dns2.nominalia.com,0,0.00%,18,18,0.00%
eva.ns.cloudflare.com,0,0.00%,8,8,0.00%
ns100.worldnic.com,0,0.00%,9,9,0.00%
renan.ns.cloudflare.com,0,0.00%,4,4,0.00%
ns71.worldnic.com,0,0.00%,8,8,0.00%
29.push2his.eastmoney.com,0,0.00%,1,1,0.00%
14.push2his.eastmoney.com,0,0.00%,1,1,0.00%
45.push2his.eastmoney.com,0,0.00%,4,4,0.00%
ns32.inhostedns.org,0,0.00%,2,2,0.00%
8.push2his.eastmoney.com,0,0.00%,1,1,0.00%
ns38.worldnic.com,0,0.00%,14,14,0.00%
ns6.worldnic.com,0,0.00%,10,10,0.00%
natasha.ns.cloudflare.com,0,0.00%,2,2,0.00%
vasilii.ns.cloudflare.com,0,0.00%,3,3,0.00%
ns18.inhostedns.com,0,0.00%,4,4,0.00%
ns2.loopia.se,0,0.00%,62,62,0.00%
lucy.ns.cloudflare.com,0,0.00%,8,8,0.00%
v0n0.nic.show,0,0.00%,5,5,0.00%
tadeo.ns.cloudflare.com,0,0.00%,6,6,0.00%
nico.ns.cloudflare.com,0,0.00%,22,22,0.00%
penny.ns.cloudflare.com,0,0.00%,1,1,0.00%
ns-a5.cloudnetvn.com,0,0.00%,1,1,0.00%
ns1.worldnic.com,0,0.00%,12,12,0.00%
ns2.worldnic.com,0,0.00%,12,12,0.00%
ns78.worldnic.com,0,0.00%,7,7,0.00%
ns-a3.cloudnetvn.com,0,0.00%,1,1,0.00%
ns47.worldnic.com,0,0.00%,7,7,0.00%
ns77.worldnic.com,0,0.00%,14,14,0.00%
ns43.worldnic.com,0,0.00%,12,12,0.00%
ns93.worldnic.com,0,0.00%,14,14,0.00%
ns29.worldnic.com,0,0.00%,8,8,0.00%
ns75.worldnic.com,0,0.00%,10,10,0.00%
ns4.worldnic.com,0,0.00%,12,12,0.00%
ns.zxcs.nl,0,0.00%,7,7,0.00%
ns87.worldnic.com,0,0.00%,10,10,0.00%
ns18.worldnic.com,0,0.00%,6,6,0.00%
ns48.worldnic.com,0,0.00%,7,7,0.00%
ns1074.ui-dns.com,0,0.00%,2,2,0.00%
ns-a1.cloudnetvn.com,0,0.00%,1,1,0.00%
ns3.worldnic.com,0,0.00%,11,11,0.00%
ns88.worldnic.com,0,0.00%,6,6,0.00%
ns76.worldnic.com,0,0.00%,10,10,0.00%
ns37.worldnic.com,0,0.00%,26,26,0.00%
ns38.inhostedns.org,0,0.00%,4,4,0.00%
ns10.worldnic.com,0,0.00%,7,7,0.00%
ns21.worldnic.com,0,0.00%,5,5,0.00%
ns96.worldnic.com,0,0.00%,13,13,0.00%
kinsley.ns.cloudflare.com,0,0.00%,3,3,0.00%
ns2.h71.hvosting.ua,0,0.00%,2,2,0.00%
ns1089.ui-dns.biz,0,0.00%,6,6,0.00%
ns2.freehosting.com,0,0.00%,8,8,0.00%
ns95.worldnic.com,0,0.00%,12,12,0.00%
leonidas.ns.cloudflare.com,0,0.00%,8,8,0.00%
ns80.worldnic.com,0,0.00%,6,6,0.00%
ns2.firstbytedns.ru,0,0.00%,1,1,0.00%
ns65.worldnic.com,0,0.00%,9,9,0.00%
ns79.worldnic.com,0,0.00%,6,6,0.00%
ns66.worldnic.com,0,0.00%,9,9,0.00%
ns9.worldnic.com,0,0.00%,10,10,0.00%
ns32.domaincontrol.com,0,0.00%,104,104,0.00%
ns2.paola9.site,0,0.00%,1,1,0.00%
ns1.h71.hvosting.ua,0,0.00%,1,1,0.00%
socks.dnspod.net,0,0.00%,1,1,0.00%
ns44.worldnic.com,0,0.00%,10,10,0.00%
rc09-fc01.oray.com,0,0.00%,2,2,0.00%
ns7.worldnic.com,0,0.00%,6,6,0.00%
glen.ns.cloudflare.com,0,0.00%,34,34,0.00%
ns11.netafrooz.com,0,0.00%,1,1,0.00%
mercury.dnspod.net,0,0.00%,2,2,0.00%
ns64.worldnic.com,0,0.00%,7,7,0.00%
ns8.worldnic.com,0,0.00%,12,12,0.00%
ns63.worldnic.com,0,0.00%,14,14,0.00%
ns14.worldnic.com,0,0.00%,18,18,0.00%
dns15.hichina.com,0,0.00%,56,56,0.00%
ns-9-b.gandi.net,0,0.00%,1,1,0.00%
ishaan.ns.cloudflare.com,0,0.00%,1,1,0.00%
ns13.worldnic.com,0,0.00%,9,9,0.00%
dns16.hichina.com,0,0.00%,38,38,0.00%
ns81.worldnic.com,0,0.00%,12,12,0.00%
ns33.domaincontrol.com,0,0.00%,1,1,0.00%
ns4205.hostgator.com,0,0.00%,1,1,0.00%
ns2gtx.name.com,0,0.00%,14,14,0.00%
ns-177-c.gandi.net,0,0.00%,2,2,0.00%
ns4206.hostgator.com,0,0.00%,2,2,0.00%
ns89.worldnic.com,0,0.00%,8,8,0.00%
11776.BODIS.com,0,0.00%,1,1,0.00%
irns2.onhost.in,0,0.00%,1,1,0.00%
ns68.worldnic.com,0,0.00%,5,5,0.00%
ns75.domaincontrol.com,0,0.00%,136,136,0.00%
ns4.byet.org,0,0.00%,3,3,0.00%
ns67.worldnic.com,0,0.00%,5,5,0.00%
dns3.tld.pl,0,0.00%,1,1,0.00%
rihdiizudin.site,0,0.00%,2,2,0.00%
ns72.worldnic.com,0,0.00%,8,8,0.00%
ns76.domaincontrol.com,0,0.00%,130,130,0.00%
suspension2.mydomainprovider.com,0,0.00%,18,18,0.00%
ns1.ihscp.com,0,0.00%,1,1,0.00%
ns4.stratoserver.net,0,0.00%,1,1,0.00%
ns1.sara7.site,0,0.00%,1,1,0.00%
pdns09.domaincontrol.com,0,0.00%,28,28,0.00%
ns2.byet.org,0,0.00%,3,3,0.00%
ns59.worldnic.com,0,0.00%,9,9,0.00%
ns2.epizy.com,0,0.00%,3,3,0.00%
nsr3.domeny.com,0,0.00%,10,10,0.00%
ns60.worldnic.com,0,0.00%,9,9,0.00%
ns-114-b.gandi.net,0,0.00%,1,1,0.00%
ns-178-c.gandi.net,0,0.00%,1,1,0.00%
ns1.sara6.site,0,0.00%,1,1,0.00%
ns2.sara7.site,0,0.00%,1,1,0.00%
ns2.ihscp.com,0,0.00%,2,2,0.00%
ns-3-a.gandi.net,0,0.00%,3,3,0.00%
ns2.sara10.site,0,0.00%,1,1,0.00%
ns-187-c.gandi.net,0,0.00%,1,1,0.00%
ns2.sara6.site,0,0.00%,1,1,0.00%
ns28.inhostedns.net,0,0.00%,5,5,0.00%
ns20.worldnic.com,0,0.00%,4,4,0.00%
ns19.worldnic.com,0,0.00%,10,10,0.00%
ns1.sara10.site,0,0.00%,1,1,0.00%
ns1.sara5.site,0,0.00%,1,1,0.00%
ns31.domaincontrol.com,0,0.00%,52,52,0.00%
dns2.p04.nsone.net,0,0.00%,21,21,0.00%
dns4.p04.nsone.net,0,0.00%,25,25,0.00%
ns2.sara5.site,0,0.00%,1,1,0.00%
ns2.sara9.site,0,0.00%,1,1,0.00%
builds.parsecgaming.com,0,0.00%,6,6,0.00%
ns1.sara9.site,0,0.00%,1,1,0.00%
elly.ns.cloudflare.com,0,0.00%,8,8,0.00%
pxe1.host-food.ru,0,0.00%,7,7,0.00%
monkey.dnspod.net,0,0.00%,2,2,0.00%
ns-819.awsdns-38.net,0,0.00%,2,2,0.00%
leo.ns.cloudflare.com,0,0.00%,1,1,0.00%
bingo.ns.cloudflare.com,0,0.00%,4,4,0.00%
raegan.ns.cloudflare.com,0,0.00%,7,7,0.00%
lpsppp.site,0,0.00%,1,1,0.00%
edna.ns.cloudflare.com,0,0.00%,2,2,0.00%
pdns10.domaincontrol.com,0,0.00%,14,14,0.00%
ns-143.awsdns-17.com,0,0.00%,3,3,0.00%
ns2jrt.name.com,0,0.00%,9,9,0.00%
rscloud.rising.net.cn,0,0.00%,41,41,0.00%
ns2.register.it,0,0.00%,38,38,0.00%
ns-1081.awsdns-07.org,0,0.00%,1,1,0.00%
tricia.ns.cloudflare.com,0,0.00%,8,8,0.00%
maxwellmarketing.site,0,0.00%,1,1,0.00%
ns-1734.awsdns-24.co.uk,0,0.00%,2,2,0.00%
ns3.jagoankodecloud.com,0,0.00%,1,1,0.00%
ns-557.awsdns-05.net,0,0.00%,3,3,0.00%
abdullah.ns.cloudflare.com,0,0.00%,13,13,0.00%
ns1.hosting.reg.ru,0,0.00%,98,98,0.00%
webquotepic.eastmoney.com,0,0.00%,5,5,0.00%
lilyana.ns.cloudflare.com,0,0.00%,4,4,0.00%
ns8910.banahosting.com,0,0.00%,1,1,0.00%
ns2.hosting.reg.ru,0,0.00%,95,95,0.00%
ns8911.banahosting.com,0,0.00%,2,2,0.00%
ns6.fozzy.com,0,0.00%,1,1,0.00%
rc10-fc01.oray.com,0,0.00%,2,2,0.00%
ns77.hostdownload.net,0,0.00%,1,1,0.00%
a.pizzacorporation.com,0,0.00%,4,4,0.00%
dunn.dnspod.net,0,0.00%,2,2,0.00%
nsid2.rumahweb.net,0,0.00%,9,9,0.00%
vor1680527707.cdn.xiaodutvcdn.com,0,0.00%,1,1,0.00%
ns4.selectel.org,0,0.00%,3,3,0.00%
ns-1407.awsdns-47.org,0,0.00%,1,1,0.00%
ns2.selectel.org,0,0.00%,4,4,0.00%
ns4fqz.name.com,0,0.00%,6,6,0.00%
spinach.dnspod.net,0,0.00%,2,2,0.00%
palmtlun.site,0,0.00%,2,2,0.00%
ns78.hostdownload.net,0,0.00%,2,2,0.00%
louis.ns.cloudflare.com,0,0.00%,6,6,0.00%
ns3.firstbytedns.net,0,0.00%,2,2,0.00%
ns4.tld-ns.com,0,0.00%,1,1,0.00%
ns5.fozzy.com,0,0.00%,1,1,0.00%
ns1.tld-ns.net,0,0.00%,1,1,0.00%
baritone.dnspod.net,0,0.00%,2,2,0.00%
ns67.domaincontrol.com,0,0.00%,71,71,0.00%
ns3.tld-ns.net,0,0.00%,1,1,0.00%
ns1.mixhost.jp,0,0.00%,4,4,0.00%
ns2.tld-ns.com,0,0.00%,1,1,0.00%
ns3.jino.ru,0,0.00%,11,11,0.00%
dina.ns.cloudflare.com,0,0.00%,8,8,0.00%
04.dnsv.jp,0,0.00%,58,58,0.00%
ns1.selectel.org,0,0.00%,4,4,0.00%
ns84.worldnic.com,0,0.00%,9,9,0.00%
ns2.mixhost.jp,0,0.00%,4,4,0.00%
ns1.paola4.site,0,0.00%,1,1,0.00%
elliot.ns.cloudflare.com,0,0.00%,4,4,0.00%
ns2.tildadns.com,0,0.00%,15,15,0.00%
nszero2.axc.nl,0,0.00%,3,3,0.00%
ns3.selectel.org,0,0.00%,3,3,0.00%
ns34.worldnic.com,0,0.00%,8,8,0.00%
baklulu.site,0,0.00%,1,1,0.00%
ns33.worldnic.com,0,0.00%,11,11,0.00%
ns1.paola10.site,0,0.00%,1,1,0.00%
karsyn.ns.cloudflare.com,0,0.00%,4,4,0.00%
ns2.paola4.site,0,0.00%,1,1,0.00%
ns2.paola5.site,0,0.00%,1,1,0.00%
nszero1.axc.nl,0,0.00%,2,2,0.00%
ns1.paola8.site,0,0.00%,1,1,0.00%
ns3.firstbytedns.ru,0,0.00%,1,1,0.00%
ns2.paola10.site,0,0.00%,1,1,0.00%
nsr1.domeny.com,0,0.00%,5,5,0.00%
beta.hostlife.net,0,0.00%,1,1,0.00%
ns1.lpmtr.net,0,0.00%,4,4,0.00%
nsid4.rumahweb.org,0,0.00%,10,10,0.00%
ns2.paola6.site,0,0.00%,1,1,0.00%
ns1.paola5.site,0,0.00%,1,1,0.00%
ns1.firstbytedns.ru,0,0.00%,1,1,0.00%
alpha.hostlife.net,0,0.00%,1,1,0.00%
ns1.paola6.site,0,0.00%,1,1,0.00%
ns1.firstbytedns.net,0,0.00%,2,2,0.00%
ns2.firstbytedns.net,0,0.00%,1,1,0.00%
pippcandy.site,0,0.00%,1,1,0.00%
ns1.paola7.site,0,0.00%,1,1,0.00%
nsid3.rumahweb.biz,0,0.00%,8,8,0.00%
ns68.domaincontrol.com,0,0.00%,70,70,0.00%
ns2.paola7.site,0,0.00%,1,1,0.00%
ns1.paola3.site,0,0.00%,1,1,0.00%
ns1.paola9.site,0,0.00%,1,1,0.00%
ns2.paola3.site,0,0.00%,1,1,0.00%
physicianj.site,0,0.00%,1,1,0.00%
gy2.brnt.fun,0,0.00%,18,18,0.00%
download.comodo.com,0,0.00%,2,2,0.00%
cdn.download.comodo.com,0,0.00%,1,1,0.00%
walt.ns.cloudflare.com,0,0.00%,1,1,0.00%
ns.gabia.co.kr,0,0.00%,73,73,0.00%
ns4clq.name.com,0,0.00%,3,3,0.00%
clara.ns.cloudflare.com,0,0.00%,12,12,0.00%
ns4.mysecurecloudhost.com,0,0.00%,10,10,0.00%
sharon.ns.cloudflare.com,0,0.00%,5,5,0.00%
joaquin.ns.cloudflare.com,0,0.00%,14,14,0.00%
ns83.worldnic.com,0,0.00%,8,8,0.00%
irns1.onhost.in,0,0.00%,1,1,0.00%
ns1.rootdns.xyz,0,0.00%,1,1,0.00%
ns50.hostgator.mx,0,0.00%,2,2,0.00%
dns2.cafe24.co.kr,0,0.00%,4,4,0.00%
www.test-hf.ru,0,0.00%,7,7,0.00%
ns51.hostgator.mx,0,0.00%,1,1,0.00%
paul.ns.cloudflare.com,0,0.00%,3,3,0.00%
ns-139-a.gandi.net,0,0.00%,1,1,0.00%
ns12.guzelhosting.com,0,0.00%,22,22,0.00%
ns11.guzelhosting.com,0,0.00%,22,22,0.00%
ns3.mysecurecloudhost.com,0,0.00%,9,9,0.00%
ns1.digitalocean.com,0,0.00%,24,24,0.00%
ns-5-c.gandi.net,0,0.00%,1,1,0.00%
ns2.guzelhosting.com,0,0.00%,21,21,0.00%
journal-of-physicians.site,0,0.00%,1,1,0.00%
clark.ns.cloudflare.com,0,0.00%,1,1,0.00%
collins.ns.cloudflare.com,0,0.00%,4,4,0.00%
ns-1048.awsdns-03.org,0,0.00%,1,1,0.00%
ns-1555.awsdns-02.co.uk,0,0.00%,1,1,0.00%
ns2.je-teste-mon.site,0,0.00%,2,2,0.00%
margin.dnspod.net,0,0.00%,2,2,0.00%
ignacio.ns.cloudflare.com,0,0.00%,3,3,0.00%
ns-308.awsdns-38.com,0,0.00%,1,1,0.00%
ns1.guzelhosting.com,0,0.00%,20,20,0.00%
alfa.ns.active24.cz,0,0.00%,2,2,0.00%
mitch.ns.cloudflare.com,0,0.00%,4,4,0.00%
ns1.getcourse.ru,0,0.00%,7,7,0.00%
dns2.tld.pl,0,0.00%,1,1,0.00%
beta.ns.active24.cz,0,0.00%,1,1,0.00%
ns-754.awsdns-30.net,0,0.00%,2,2,0.00%
ns6352.hostgator.com,0,0.00%,2,2,0.00%
ns3.getcourse.ru,0,0.00%,5,5,0.00%
ns-1026.awsdns-00.org,0,0.00%,3,3,0.00%
beth.ns.cloudflare.com,0,0.00%,4,4,0.00%
gama.ns.active24.sk,0,0.00%,1,1,0.00%
a.gmoregistry.net,0,0.00%,406,406,0.00%
ns-156.awsdns-19.com,0,0.00%,1,1,0.00%
jade.ns.cloudflare.com,0,0.00%,12,12,0.00%
ns1.je-teste-mon.site,0,0.00%,2,2,0.00%
cheryl.ns.cloudflare.com,0,0.00%,3,3,0.00%
jaime.ns.cloudflare.com,0,0.00%,4,4,0.00%
itsnuqtah.site,0,0.00%,1,1,0.00%
ns2.justhost.ru,0,0.00%,3,3,0.00%
karl.ns.cloudflare.com,0,0.00%,3,3,0.00%
ns-1920.awsdns-48.co.uk,0,0.00%,1,1,0.00%
ns-783.awsdns-33.net,0,0.00%,1,1,0.00%
dns12.hichina.com,0,0.00%,58,58,0.00%
ns2.nofear.fun,0,0.00%,1,1,0.00%
ns2.gcloudns.com,0,0.00%,10,10,0.00%
sheep.dnspod.net,0,0.00%,1,1,0.00%
rustam.ns.cloudflare.com,0,0.00%,15,15,0.00%
ecliptic.dnspod.net,0,0.00%,2,2,0.00%
ns1.justhost.ru,0,0.00%,6,6,0.00%
lkp-prestasi.site,0,0.00%,1,1,0.00%
ns1.nofear.fun,0,0.00%,1,1,0.00%
guava.dnspod.net,0,0.00%,2,2,0.00%
darcy.dnspod.net,0,0.00%,1,1,0.00%
alexandra.ns.cloudflare.com,0,0.00%,2,2,0.00%
lila.ns.cloudflare.com,0,0.00%,8,8,0.00%
brianna.ns.cloudflare.com,0,0.00%,10,10,0.00%
peyton.ns.cloudflare.com,0,0.00%,6,6,0.00%
ns3.azdigi.com,0,0.00%,2,2,0.00%
skip.ns.cloudflare.com,0,0.00%,4,4,0.00%
cameron.ns.cloudflare.com,0,0.00%,1,1,0.00%
jake.ns.cloudflare.com,0,0.00%,14,14,0.00%
ns82.worldnic.com,0,0.00%,10,10,0.00%
ns4.azdigi.com,0,0.00%,2,2,0.00%
ada.ns.cloudflare.com,0,0.00%,6,6,0.00%
carla.ns.cloudflare.com,0,0.00%,6,6,0.00%
dns0.host-food.ru,0,0.00%,2,2,0.00%
ns3.cibergenios.com,0,0.00%,1,1,0.00%
piotr.ns.cloudflare.com,0,0.00%,8,8,0.00%
tori.ns.cloudflare.com,0,0.00%,1,1,0.00%
christ.dnspod.net,0,0.00%,2,2,0.00%
unue.mars.orderbox-dns.com,0,0.00%,1,1,0.00%
ns1.seoadword.com,0,0.00%,2,2,0.00%
unue.earth.orderbox-dns.com,0,0.00%,2,2,0.00%
will.ns.cloudflare.com,0,0.00%,18,18,0.00%
ns99.kebirhost.com,0,0.00%,2,2,0.00%
ns1019.ui-dns.biz,0,0.00%,3,3,0.00%
unue.mercury.orderbox-dns.com,0,0.00%,1,1,0.00%
program.dnspod.net,0,0.00%,2,2,0.00%
unue.venus.orderbox-dns.com,0,0.00%,2,2,0.00%
ns1.taplink.cc,0,0.00%,3,3,0.00%
kyle.ns.cloudflare.com,0,0.00%,4,4,0.00%
ns2.taplink.cc,0,0.00%,6,6,0.00%
ns-1339.awsdns-39.org,0,0.00%,2,2,0.00%
ekantinz.site,0,0.00%,1,1,0.00%
dns1.host-food.ru,0,0.00%,2,2,0.00%
ns-1678.awsdns-17.co.uk,0,0.00%,2,2,0.00%
ns11.snetdns.com,0,0.00%,1,1,0.00%
ns-54.awsdns-06.com,0,0.00%,2,2,0.00%
ns98.kebirhost.com,0,0.00%,1,1,0.00%
ns1049.ui-dns.biz,0,0.00%,6,6,0.00%
ns10.snetdns.com,0,0.00%,2,2,0.00%
dns1.papaki.gr,0,0.00%,1,1,0.00%
cass.ns.cloudflare.com,0,0.00%,1,1,0.00%
celeste.ns.cloudflare.com,0,0.00%,2,2,0.00%
ns3.hyp.net,0,0.00%,9,9,0.00%
ns-840.awsdns-41.net,0,0.00%,2,2,0.00%
ns1.dn-s.nl,0,0.00%,2,2,0.00%
vita.ns.cloudflare.com,0,0.00%,8,8,0.00%
notify.tabnine.com,0,0.00%,5,5,0.00%
ns4.stackdns.com,0,0.00%,13,13,0.00%
ns2.stackdns.com,0,0.00%,13,13,0.00%
ns2.dn-s.nl,0,0.00%,1,1,0.00%
ns31.worldnic.com,0,0.00%,3,3,0.00%
sreeni.ns.cloudflare.com,0,0.00%,3,3,0.00%
maya.ns.cloudflare.com,0,0.00%,6,6,0.00%
ns4.dn-s.nl,0,0.00%,1,1,0.00%
scutum.dnspod.net,0,0.00%,2,2,0.00%
great.jagoanhosting.com,0,0.00%,2,2,0.00%
best.jagoanhosting.com,0,0.00%,1,1,0.00%
dns1.tld.pl,0,0.00%,1,1,0.00%
ns3.dn-s.nl,0,0.00%,1,1,0.00%
pat.ns.cloudflare.com,0,0.00%,20,20,0.00%
ns-459.awsdns-57.com,0,0.00%,2,2,0.00%
ns1.mchost.ru,0,0.00%,2,2,0.00%
ns2.mchost.ru,0,0.00%,3,3,0.00%
ariadne.ns.cloudflare.com,0,0.00%,4,4,0.00%
nena.ns.cloudflare.com,0,0.00%,2,2,0.00%
harley.ns.cloudflare.com,0,0.00%,4,4,0.00%
chase.ns.cloudflare.com,0,0.00%,4,4,0.00%
archer.ns.cloudflare.com,0,0.00%,26,26,0.00%
kip.ns.cloudflare.com,0,0.00%,5,5,0.00%
angela.ns.cloudflare.com,0,0.00%,12,12,0.00%
camilo.ns.cloudflare.com,0,0.00%,6,6,0.00%
ns-239-a.gandi.net,0,0.00%,2,2,0.00%
formacao-online.site,0,0.00%,1,1,0.00%
aunkere.site,0,0.00%,2,2,0.00%
fish.aquatis.host,0,0.00%,2,2,0.00%
ns1bqx.name.com,0,0.00%,6,6,0.00%
adelaide.ns.cloudflare.com,0,0.00%,10,10,0.00%
ns4246.hostgator.com,0,0.00%,3,3,0.00%
ns2dqx.name.com,0,0.00%,1,1,0.00%
ns4245.hostgator.com,0,0.00%,3,3,0.00%
beau.ns.cloudflare.com,0,0.00%,8,8,0.00%
ns3dkz.name.com,0,0.00%,5,5,0.00%
tina.ns.cloudflare.com,0,0.00%,2,2,0.00%
jerky.dnspod.net,0,0.00%,1,1,0.00%
38-courier.push.apple.com,0,0.00%,26,26,0.00%
cdn.packages.deepin.com,0,0.00%,28,28,0.00%
3.rlb.router.teamviewer.cn,0,0.00%,482,482,0.00%
21-courier.push.apple.com,0,0.00%,26,26,0.00%
www.tp-link.com,0,0.00%,84,84,0.00%
community-store-packages.deepin.com,0,0.00%,56,56,0.00%
ios.ac.cn,0,0.00%,53,53,0.00%
baike.baidu.com,0,0.00%,7,7,0.00%
40-courier.push.apple.com,0,0.00%,29,29,0.00%
50-courier.push.apple.com,0,0.00%,28,28,0.00%
113344391.home.news.cn,0,0.00%,2,2,0.00%
freebse.home.news.cn,0,0.00%,1,1,0.00%
ha.xinhuanet.com,0,0.00%,1,1,0.00%
7-courier.push.apple.com,0,0.00%,25,25,0.00%
www.hb.news.cn,0,0.00%,2,2,0.00%
13-courier.push.apple.com,0,0.00%,20,20,0.00%
www.hb.xinhuanet.com,0,0.00%,1,1,0.00%
c.pc.qq.com,0,0.00%,3,3,0.00%
masterconn.qq.com,0,0.00%,11,11,0.00%
masterconn2.qq.com,0,0.00%,32,32,0.00%
avcloud.e5.sk,0,0.00%,1,1,0.00%
30-courier.push.apple.com,0,0.00%,29,29,0.00%
api.appstore.deepin.org,0,0.00%,56,56,0.00%
43-courier.push.apple.com,0,0.00%,28,28,0.00%
18339918801.home.news.cn,0,0.00%,2,2,0.00%
46-courier.push.apple.com,0,0.00%,25,25,0.00%
6-courier.push.apple.com,0,0.00%,30,30,0.00%
19-courier.push.apple.com,0,0.00%,27,27,0.00%
tracker.hdsky.me,0,0.00%,19,19,0.00%
25-courier.push.apple.com,0,0.00%,25,25,0.00%
29-courier.push.apple.com,0,0.00%,31,31,0.00%
45-courier.push.apple.com,0,0.00%,26,26,0.00%
api.cloudfs.info,0,0.00%,12,12,0.00%
48-courier.push.apple.com,0,0.00%,25,25,0.00%
guojiadayuan.home.news.cn,0,0.00%,2,2,0.00%
5-courier.push.apple.com,0,0.00%,30,30,0.00%
8-courier.push.apple.com,0,0.00%,30,30,0.00%
18-courier.push.apple.com,0,0.00%,22,22,0.00%
cip.cc,0,0.00%,68,68,0.00%
prom-monitorproxy1.fastsdwan.com,0,0.00%,67,67,0.00%
27-courier.push.apple.com,0,0.00%,30,30,0.00%
41-courier.push.apple.com,0,0.00%,23,23,0.00%
datacluster4.cipsup.cn,0,0.00%,9,9,0.00%
17-courier.push.apple.com,0,0.00%,26,26,0.00%
20-courier.push.apple.com,0,0.00%,28,28,0.00%
23-courier.push.apple.com,0,0.00%,23,23,0.00%
nist1-nj2.ustiming.org,0,0.00%,8,8,0.00%
36-courier.push.apple.com,0,0.00%,32,32,0.00%
3-courier.push.apple.com,0,0.00%,27,27,0.00%
media.xinhuanet.com,0,0.00%,2,2,0.00%
16-courier.push.apple.com,0,0.00%,26,26,0.00%
www.h3c.com.cn,0,0.00%,11,11,0.00%
d2lfklupjnai2b.cloudfront.cn,0,0.00%,2,2,0.00%
pancake-cn.cdn-apple.com.akadns.net,0,0.00%,1,1,0.00%
e-0014.e-msedge.net,0,0.00%,26,26,0.00%
gdmf.apple.com,0,0.00%,2,2,0.00%
gdmf.v.aaplimg.com,0,0.00%,2,2,0.00%
lcdn-locator.apple.com.akadns.net,0,0.00%,2,2,0.00%
lcdn-locator-usms11.apple.com.akadns.net,0,0.00%,2,2,0.00%
vscode-sync-ase-01.azurewebsites.net,0,0.00%,1,1,0.00%
waws-prod-sg1-051.sip.azurewebsites.windows.net,0,0.00%,1,1,0.00%
waws-prod-sg1-051.cloudapp.net,0,0.00%,1,1,0.00%
swcdn.apple.com,0,0.00%,2,2,0.00%
swcdn.g.aaplimg.com,0,0.00%,2,2,0.00%
fe2cr.update.msft.com.trafficmanager.net,0,0.00%,2,2,0.00%
ocsp.entrust.net.edgekey.net,0,0.00%,2,2,0.00%
ins-qw3q8ofk.ias.tencent-cloud.net,0,0.00%,8,8,0.00%
6fe97759aa27a0c9.jijifun.com,0,0.00%,13,13,0.00%
47-courier.push.apple.com,0,0.00%,25,25,0.00%
imap.126.com,0,0.00%,14,14,0.00%
dstore-metadata.deepin.cn,0,0.00%,26,26,0.00%
clock.fmt.he.net,0,0.00%,55,55,0.00%
m.weibo.cn,0,0.00%,16,16,0.00%
mail.bjtu.edu.cn,0,0.00%,15,15,0.00%
danlin97.home.news.cn,0,0.00%,2,2,0.00%
clock.sjc.he.net,0,0.00%,54,54,0.00%
www.he.news.cn,0,0.00%,2,2,0.00%
www.he.xinhuanet.com,0,0.00%,2,2,0.00%
time-nw.nist.gov,0,0.00%,8,8,0.00%
mm.ilovescholar.xyz,0,0.00%,8,8,0.00%
ddns.gnway.com,0,0.00%,8,8,0.00%
app.jianguoyun.com,0,0.00%,16,16,0.00%
bnz05pap002.storage.live.com,0,0.00%,5,5,0.00%
clock.nyc.he.net,0,0.00%,52,52,0.00%
iplc-ji.mielink-dns2.com,0,0.00%,4,4,0.00%
load-balancing-system.cmy-dns.com,0,0.00%,4,4,0.00%
gtm-sg-6wr2n62gk0f.gtm-i1d1.com,0,0.00%,4,4,0.00%
bi-track.hypergryph.com,0,0.00%,2,2,0.00%
ftp.cn.debian.cdnet.in,0,0.00%,2,2,0.00%
log.trackingio.com,0,0.00%,2,2,0.00%
log-trackingio-com-1877036888.cn-north-1.elb.amazonaws.com.cn,0,0.00%,2,2,0.00%
pdns1.ultradns.net,0,0.00%,2,2,0.00%
pdns5.ultradns.info,0,0.00%,2,2,0.00%
pdns196.ultradns.org,0,0.00%,2,2,0.00%
keyvalueservice.fe.apple-dns.cn,0,0.00%,8,8,0.00%
launches.appsflyer.com,0,0.00%,2,2,0.00%
ios.bugly.qq.com,0,0.00%,20,20,0.00%
ulogs.umeng.com.gds.alibabadns.com,0,0.00%,2,2,0.00%
alog-default.umeng.com,0,0.00%,4,4,0.00%
www.msftncsi.com.edgesuite.net,0,0.00%,4,4,0.00%
havfw69955.lithium.com,0,0.00%,2,2,0.00%
shuc-pc-snow.ksord.com,0,0.00%,6,6,0.00%
bk.n.shifen.com,0,0.00%,14,14,0.00%
clock.via.net,0,0.00%,51,51,0.00%
api.infinitynewtab.com,0,0.00%,2,2,0.00%
api.speed.miwifi.com,0,0.00%,3,3,0.00%
www.hlj.news.cn,0,0.00%,2,2,0.00%
files.pfsense.org,0,0.00%,8,8,0.00%
www.hlj.xinhuanet.com,0,0.00%,2,2,0.00%
www.hn.news.cn,0,0.00%,2,2,0.00%
www.hn.xinhuanet.com,0,0.00%,2,2,0.00%
remind.api.weibo.com,0,0.00%,18,18,0.00%
messaging.contact-module.ibm.com,0,0.00%,6,6,0.00%
check.bt.cn,0,0.00%,6,6,0.00%
jp.tiarap.org,0,0.00%,14,14,0.00%
up.vipguanjia.net,0,0.00%,8,8,0.00%
tapi.dbappsecurity.com.cn,0,0.00%,4,4,0.00%
linux-updatepro.wps.cn,0,0.00%,4,4,0.00%
sharedstreams.fe.apple-dns.cn,0,0.00%,12,12,0.00%
gux.glodon.com,0,0.00%,6,6,0.00%
avengers.glodon.com,0,0.00%,2,2,0.00%
apicdn.app.gtja.com,0,0.00%,8,8,0.00%
dcagent.mecdn.synacast.com,0,0.00%,7,7,0.00%
gn.symcb.com,0,0.00%,1,1,0.00%
se.symcb.com,0,0.00%,1,1,0.00%
groupclient.qq.com,0,0.00%,4,4,0.00%
location.services.mozilla.com,0,0.00%,6,6,0.00%
www.bt.cn,0,0.00%,13,13,0.00%
655aa810-rh7400-rilj3b-iz5k.pccw.alrihla.net,0,0.00%,8,8,0.00%
v112.v2dns.bar,0,0.00%,16,16,0.00%
developers.google.cn,0,0.00%,8,8,0.00%
access1.tpns.tencent.com,0,0.00%,4,4,0.00%
rum.h5.weibo.cn,0,0.00%,38,38,0.00%
new.weibo.cn,0,0.00%,8,8,0.00%
up.ijinshan.com,0,0.00%,3,3,0.00%
fb98ab9159f51fd0.jijifun.com,0,0.00%,26,26,0.00%
sa.kaixinyf.cn,0,0.00%,6,6,0.00%
xcx.yqgz.beijing.gov.cn,0,0.00%,3,3,0.00%
update0.aiclk.com,0,0.00%,2,2,0.00%
smart.lenovo.com.cn,0,0.00%,6,6,0.00%
2csvr-basic.wpsdns.com,0,0.00%,2,2,0.00%
pc-update-2.wpscdn.cn,0,0.00%,1,1,0.00%
wwfile.work.weixin.qq.com,0,0.00%,27,27,0.00%
a-ring.msedge.net,0,0.00%,2,2,0.00%
b-ring.msedge.net,0,0.00%,5,5,0.00%
fanyi.ntes53.netease.com,0,0.00%,8,8,0.00%
api-skytone-4-drcn.cloud.dbankcloud.cn,0,0.00%,6,6,0.00%
mlshort.weixin.qq.com,0,0.00%,2,2,0.00%
fls.jetbrains-agent.com,0,0.00%,6,6,0.00%
update-ie.2345.cc,0,0.00%,4,4,0.00%
t-ie.2345.com,0,0.00%,4,4,0.00%
phapi.wps.cn,0,0.00%,4,4,0.00%
rs.sinajs.cn,0,0.00%,2,2,0.00%
ww2.sinaimg.cn,0,0.00%,8,8,0.00%
wx2.sinaimg.cn,0,0.00%,12,12,0.00%
qr.weibo.cn,0,0.00%,2,2,0.00%
img1.miaopai.com,0,0.00%,1,1,0.00%
live-trace.bilibili.com,0,0.00%,4,4,0.00%
gsp64-ssl.ls.apple.com,0,0.00%,32,32,0.00%
fi.doh.dns.snopyta.org,0,0.00%,8,8,0.00%
contentsync.onenote.com,0,0.00%,2,2,0.00%
hierarchyapi.onenote.com,0,0.00%,2,2,0.00%
osiprod-krc-blush-azsc-004.koreacentral.cloudapp.azure.com,0,0.00%,2,2,0.00%
osiprod-krc-vulpecula-001.cloudapp.net,0,0.00%,2,2,0.00%
apple-finance.query.yahoo.com,0,0.00%,6,6,0.00%
rc10-fc05.oray.com,0,0.00%,2,2,0.00%
t-kehuduan.2345.cc,0,0.00%,1,1,0.00%
api.panfanh.xyz,0,0.00%,2,2,0.00%
cn.patch.battlenet.com.cn,0,0.00%,6,6,0.00%
apms.citicbank.com,0,0.00%,6,6,0.00%
bcrs1.intsig.net,0,0.00%,2,2,0.00%
ocr.ai.qq.com,0,0.00%,2,2,0.00%
edata.bank.ecitic.com,0,0.00%,2,2,0.00%
wagbridge.amap.com,0,0.00%,2,2,0.00%
config.jpush.cn,0,0.00%,2,2,0.00%
user.jpush.cn,0,0.00%,4,4,0.00%
report-stats.ad.jiguang.cn,0,0.00%,2,2,0.00%
dualstack-restapi.amap.com.gds.alibabadns.com,0,0.00%,4,4,0.00%
wap.bank.ecitic.com,0,0.00%,6,6,0.00%
APAC02.azure-devices.net,0,0.00%,6,6,0.00%
bggts547gukhvmf4cgandlgxxphengxovoyo6ewhns5qmmb2b5oi43yd.tor2web.it,0,0.00%,16,16,0.00%
repos.fedorapeople.org,0,0.00%,2,2,0.00%
o324374.ingest.sentry.io,0,0.00%,8,8,0.00%
api-iam.intercom.io,0,0.00%,8,8,0.00%
mccontacts.mail.163.com,0,0.00%,26,26,0.00%
dashi.163.com,0,0.00%,15,15,0.00%
a04d69449410474aab1aa6fa02606b66.fp.measure.office.com,0,0.00%,1,1,0.00%
newsie.2345.com,0,0.00%,13,13,0.00%
uq.file.cloud.duba.net,0,0.00%,10,10,0.00%
cacerts.digicert.com,0,0.00%,6,6,0.00%
pcdiffpack.psvr.wps.cn,0,0.00%,6,6,0.00%
download.tenorshare.com,0,0.00%,4,4,0.00%
p2psdk.wscdns.com,0,0.00%,2,2,0.00%
conf.qvb.qcloud.com,0,0.00%,6,6,0.00%
p2pchunk-ws.douyucdn.cn,0,0.00%,4,4,0.00%
mobilep2.douyucdn2.cn,0,0.00%,2,2,0.00%
hlsh5p2.douyucdn2.cn,0,0.00%,2,2,0.00%
work.exmail.qq.com,0,0.00%,2,2,0.00%
log.qvb.qcloud.com,0,0.00%,8,8,0.00%
c399e1eba3cafdcf71c1b49fbbabaf96.v.smtcdns.net,0,0.00%,4,4,0.00%
signal.qvb.qcloud.com,0,0.00%,2,2,0.00%
www.douban.com,0,0.00%,2,2,0.00%
push.douban.com,0,0.00%,6,6,0.00%
wsproxy.douyu.com,0,0.00%,2,2,0.00%
e2c14.gcp.gvt2.com,0,0.00%,2,2,0.00%
config.qqpy.sogou.com,0,0.00%,4,4,0.00%
danmuproxy.douyu.com,0,0.00%,2,2,0.00%
thetravelvine.picfair.com,0,0.00%,1,1,0.00%
position.csdnimg.cn,0,0.00%,15,15,0.00%
bigdata.downza.com,0,0.00%,4,4,0.00%
76ed2j.yzhy20.cn,0,0.00%,2,2,0.00%
d.onlinedown.net,0,0.00%,2,2,0.00%
g.wan.douyu.com,0,0.00%,2,2,0.00%
desktop.cloud.nfschina.com,0,0.00%,6,6,0.00%
stat.10jqka.com.cn,0,0.00%,29,29,0.00%
wss.im.qcloud.com,0,0.00%,5,5,0.00%
ten.sngapm.qq.com,0,0.00%,6,6,0.00%
c0678bbfbefc124a8e4a9f3106efdb05.dlied1.cdntips.net,0,0.00%,2,2,0.00%
www.office-cn.net,0,0.00%,2,2,0.00%
open.office-cn.net,0,0.00%,4,4,0.00%
p52-quota.icloud.com.cn,0,0.00%,2,2,0.00%
alidocs-body.oss-accelerate.aliyuncs.com,0,0.00%,2,2,0.00%
wpad,0,0.00%,2,2,0.00%
conn.meeting.work.weixin.qq.com,0,0.00%,2,2,0.00%
tracker-00.qvb.qcloud.com,0,0.00%,2,2,0.00%
api.meeting.work.weixin.qq.com,0,0.00%,2,2,0.00%
jubao.qq.com,0,0.00%,4,4,0.00%
wsapi.xfyun.cn,0,0.00%,2,2,0.00%
metrics1.data.dbankcloud.cn,0,0.00%,4,4,0.00%
array603.prod.do.dsp.mp.microsoft.com,0,0.00%,12,12,0.00%
flowvip.wps.cn,0,0.00%,2,2,0.00%
ke-image.ljcdn.com,0,0.00%,2,2,0.00%
down.dingtalk.com,0,0.00%,12,12,0.00%
tw.pool.ntp.org,0,0.00%,2,2,0.00%
hk.pool.ntp.org,0,0.00%,2,2,0.00%
jp.pool.ntp.org,0,0.00%,2,2,0.00%
p.meituan.com,0,0.00%,2,2,0.00%
shark.dianping.com,0,0.00%,2,2,0.00%
img.meituan.net,0,0.00%,4,4,0.00%
hlx.meituan.com,0,0.00%,2,2,0.00%
lx0.meituan.com,0,0.00%,2,2,0.00%
log2.cmpassport.com,0,0.00%,4,4,0.00%
httpdns.meituan.com,0,0.00%,2,2,0.00%
medusa.dianping.com,0,0.00%,2,2,0.00%
catdot.dianping.com,0,0.00%,2,2,0.00%
api.neixin.cn,0,0.00%,2,2,0.00%
wpsfile.ks3-cn-beijing.ksyun.com,0,0.00%,4,4,0.00%
vas2t-api.wps.cn,0,0.00%,2,2,0.00%
docteamapi.wps.cn,0,0.00%,8,8,0.00%
wemeet-da2.qq.com,0,0.00%,6,6,0.00%
tcloud.tim.qq.com,0,0.00%,6,6,0.00%
bd0.d.meituan.net,0,0.00%,2,2,0.00%
m1.d.meituan.net,0,0.00%,2,2,0.00%
o4.d.meituan.net,0,0.00%,2,2,0.00%
p2.d.meituan.net,0,0.00%,2,2,0.00%
maplocatesdksnapshot.dreport.meituan.net,0,0.00%,2,2,0.00%
p6.d.meituan.net,0,0.00%,2,2,0.00%
p13.d.meituan.net,0,0.00%,2,2,0.00%
wmapi-mt.meituan.com,0,0.00%,2,2,0.00%
ns1.eu.bitnames.com,0,0.00%,4,4,0.00%
ns2.eu.bitnames.com,0,0.00%,4,4,0.00%
catfront.dianping.com,0,0.00%,4,4,0.00%
portal-portm.meituan.com,0,0.00%,4,4,0.00%
configuration.ls.apple.com,0,0.00%,32,32,0.00%
ns2.us.bitnames.com,0,0.00%,2,2,0.00%
gspe35-ssl.ls-apple.com.akadns.net,0,0.00%,4,4,0.00%
vas2t-spa.wps.cn,0,0.00%,2,2,0.00%
qn.cache.wpscdn.cn,0,0.00%,6,6,0.00%
config.teams.microsoft.com,0,0.00%,23,23,0.00%
i.waimai.meituan.com,0,0.00%,2,2,0.00%
m4.d.meituan.net,0,0.00%,2,2,0.00%
p4.d.meituan.net,0,0.00%,2,2,0.00%
p5.d.meituan.net,0,0.00%,2,2,0.00%
data-sdk-uuid-report.dreport.meituan.net,0,0.00%,2,2,0.00%
dreport.meituan.net,0,0.00%,4,4,0.00%
r3---sn-ni5een7s.gvt1.com,0,0.00%,2,2,0.00%
h5.sinaimg.cn,0,0.00%,11,11,0.00%
vip.storage.weibo.com,0,0.00%,2,2,0.00%
public.us.sinaimg.cn,0,0.00%,2,2,0.00%
simg.s.weibo.com,0,0.00%,2,2,0.00%
mediadata.api.weibo.com,0,0.00%,4,4,0.00%
ef-dongfeng.tanx.com,0,0.00%,5,5,0.00%
s1.d.meituan.net,0,0.00%,2,2,0.00%
tvax1.sinaimg.cn,0,0.00%,12,12,0.00%
k.us.sinaimg.cn,0,0.00%,2,2,0.00%
array614.prod.do.dsp.mp.microsoft.com,0,0.00%,17,17,0.00%
m8.music.126.net.163jiasu.com,0,0.00%,2,2,0.00%
work.weixin.qq.com,0,0.00%,2,2,0.00%
settings.data.microsoft.com,0,0.00%,4,4,0.00%
api.cortana.ai,0,0.00%,2,2,0.00%
nav.smartscreen.microsoft.com,0,0.00%,6,6,0.00%
adsp.xunlei.com,0,0.00%,3,3,0.00%
stinmmtn.vivo.com.cn,0,0.00%,1,1,0.00%
jd.com,0,0.00%,2,2,0.00%
vod-settings.volcvod.com,0,0.00%,1,1,0.00%
i2.hoopchina.com.cn,0,0.00%,2,2,0.00%
i10.hoopchina.com.cn,0,0.00%,1,1,0.00%
api-access.pangolin-sdk-toutiao.com,0,0.00%,15,15,0.00%
sentry.hupu.com,0,0.00%,3,3,0.00%
i4.hoopchina.com.cn,0,0.00%,2,2,0.00%
i5.hoopchina.com.cn,0,0.00%,2,2,0.00%
e-goblin.hupu.com,0,0.00%,2,2,0.00%
doh.dns.apple.com,0,0.00%,3,3,0.00%
pop3.nfs-china.com,0,0.00%,11,11,0.00%
img03.sogoucdn.com,0,0.00%,4,4,0.00%
event.toggle.qq.com,0,0.00%,18,18,0.00%
gd.unicommusic.gtimg.com,0,0.00%,2,2,0.00%
slapi-biz.oray.net,0,0.00%,1,1,0.00%
gccp-opm.glodon.com,0,0.00%,1,1,0.00%
gwsht.glodon.com,0,0.00%,2,2,0.00%
ime.sogou.com,0,0.00%,11,11,0.00%
app-analytics.ultraleap.com,0,0.00%,12,12,0.00%
cf.aliyun.com,0,0.00%,2,2,0.00%
xl7xml.client.xunlei.com,0,0.00%,2,2,0.00%
sensors.ibreader.com,0,0.00%,5,5,0.00%
v1.cnzz.com,0,0.00%,1,1,0.00%
c.cnzz.com,0,0.00%,4,4,0.00%
z6.cnzz.com,0,0.00%,1,1,0.00%
ei.cnzz.com,0,0.00%,2,2,0.00%
cnzz.mmstat.com,0,0.00%,3,3,0.00%
ie.bjd.com.cn,0,0.00%,1,1,0.00%
erebor.douban.com,0,0.00%,2,2,0.00%
snssdk.bjd.com.cn,0,0.00%,2,2,0.00%
adreq.bjd.com.cn,0,0.00%,2,2,0.00%
bj.bjd.com.cn,0,0.00%,1,1,0.00%
stat.download.xunlei.com,0,0.00%,2,2,0.00%
ota3.jia.360.cn,0,0.00%,2,2,0.00%
app.home.360.cn,0,0.00%,2,2,0.00%
jia.360.cn,0,0.00%,2,2,0.00%
p4.ssl.qhimg.com,0,0.00%,3,3,0.00%
mirrors.ustc.edu.cn,0,0.00%,8,8,0.00%
alt7-mtalk.google.com,0,0.00%,2,2,0.00%
sa-update-asf.snb.it,0,0.00%,4,4,0.00%
voice.baidu.com,0,0.00%,8,8,0.00%
qmbd-h3.baidu.com,0,0.00%,2,2,0.00%
h2tcbox.baidu.com,0,0.00%,2,2,0.00%
sptest.baidu.com,0,0.00%,2,2,0.00%
ns3.cstnet.cn,0,0.00%,14,14,0.00%
v2.caxa.com,0,0.00%,2,2,0.00%
www.gongyeyun.com,0,0.00%,4,4,0.00%
cad-lib.caxa.com,0,0.00%,2,2,0.00%
crash.glodon.com,0,0.00%,8,8,0.00%
app.bilibili.com,0,0.00%,6,6,0.00%
valid-apple.g.aaplimg.com,0,0.00%,2,2,0.00%
baidu-cn-north-00001.bj-a.bcebos.com,0,0.00%,4,4,0.00%
ipcdn.g.aaplimg.com,0,0.00%,2,2,0.00%
www.dingtalk.com.gds.alibabadns.com,0,0.00%,2,2,0.00%
msg.csdn.net,0,0.00%,12,12,0.00%
kunpeng-sc.csdnimg.cn,0,0.00%,6,6,0.00%
statistic.csdn.net,0,0.00%,15,15,0.00%
redisdatarecall.csdn.net,0,0.00%,13,13,0.00%
image6.pubmatic.com,0,0.00%,7,7,0.00%
token.rubiconproject.com,0,0.00%,10,10,0.00%
dsum-sec.casalemedia.com,0,0.00%,2,2,0.00%
googlecm.hit.gemius.pl,0,0.00%,12,12,0.00%
zhannei-dm.csdn.net,0,0.00%,14,14,0.00%
ums.acuityplatform.com,0,0.00%,2,2,0.00%
tcpconn4.tencent.com,0,0.00%,2,2,0.00%
tcpconn2.tencent.com,0,0.00%,2,2,0.00%
tcpconn6.tencent.com,0,0.00%,2,2,0.00%
tcpconn.tencent.com,0,0.00%,2,2,0.00%
tcpconn3.tencent.com,0,0.00%,2,2,0.00%
tcpconn5.tencent.com,0,0.00%,2,2,0.00%
ttxyajs.data.kuiniuca.com,0,0.00%,8,8,0.00%
pull-rtmp-l95.douyincdn.com,0,0.00%,10,10,0.00%
a.safe.360.cn,0,0.00%,6,6,0.00%
commerce.safe.360.cn,0,0.00%,4,4,0.00%
vip3.alidns.com,0,0.00%,10,10,0.00%
picasso-static.xiaohongshu.com,0,0.00%,4,4,0.00%
cstm.baidu.com,0,0.00%,11,11,0.00%
android.rqd.qq.com,0,0.00%,5,5,0.00%
moneytizer-d.openx.net,0,0.00%,2,2,0.00%
prebid.smilewanted.com,0,0.00%,4,4,0.00%
array610.prod.do.dsp.mp.microsoft.com,0,0.00%,5,5,0.00%
node-470.kr.stars.run,0,0.00%,17,17,0.00%
t.nyaatracker.com,0,0.00%,8,8,0.00%
recsys.cnki.net,0,0.00%,2,2,0.00%
pull-rtmp-l27.douyincdn.com,0,0.00%,9,9,0.00%
push-rtmp-f5-vs.douyincdn.com,0,0.00%,6,6,0.00%
pull-flv-l95.douyincdn.com,0,0.00%,10,10,0.00%
pay.bilibili.com,0,0.00%,6,6,0.00%
pull-flv-l6-hs.pstatp.com,0,0.00%,7,7,0.00%
push-rtmp-vr-f5.douyincdn.com,0,0.00%,6,6,0.00%
p0.ssl.img.360kuai.com,0,0.00%,7,7,0.00%
7et2ri.qqscml.ml,0,0.00%,2,2,0.00%
pull-hls-vr-l6.douyincdn.com,0,0.00%,8,8,0.00%
vs.biz.weibo.com,0,0.00%,9,9,0.00%
pull-flv-f26.douyincdn.com,0,0.00%,6,6,0.00%
alt3-mtalk.google.com,0,0.00%,5,5,0.00%
adashbc.ut.taobao.com,0,0.00%,8,8,0.00%
pull-f5.flive.douyincdn.com,0,0.00%,10,10,0.00%
push-rtmp-l26-cny.douyincdn.com,0,0.00%,4,4,0.00%
push-rtmp-l11-cny.douyincdn.com,0,0.00%,7,7,0.00%
pull-hls-f13.douyincdn.com,0,0.00%,6,6,0.00%
pull-rtmp-l6-cny.douyincdn.com,0,0.00%,6,6,0.00%
jm.v2api.xyz,0,0.00%,6,6,0.00%
cdn.bootcss.com,0,0.00%,2,2,0.00%
plugin.sowise.cn,0,0.00%,2,2,0.00%
pull-hls-f29.douyincdn.com,0,0.00%,7,7,0.00%
pull-lls-l26.douyincdn.com,0,0.00%,9,9,0.00%
as.xiaohongshu.com,0,0.00%,10,10,0.00%
push-rtmp-f5-io.flive.douyincdn.com,0,0.00%,6,6,0.00%
apppush.xiaohongshu.com,0,0.00%,11,11,0.00%
push-rtmp-hs-f5-encryption.douyincdn.com,0,0.00%,6,6,0.00%
pull-flv-l11-cny.douyincdn.com,0,0.00%,6,6,0.00%
push-rtmp-l95.douyincdn.com,0,0.00%,4,4,0.00%
jpushsc.m.jd.com,0,0.00%,6,6,0.00%
www.trendmd.com,0,0.00%,2,2,0.00%
wxa.weixin.qq.com,0,0.00%,17,17,0.00%
vse.baidu.com,0,0.00%,2,2,0.00%
rdelivery.qq.com,0,0.00%,8,8,0.00%
config.ab.qq.com,0,0.00%,2,2,0.00%
th.pinduoduo.com,0,0.00%,6,6,0.00%
ws.shimo.im,0,0.00%,6,6,0.00%
image.cnki.net,0,0.00%,2,2,0.00%
jw.ucas.ac.cn,0,0.00%,2,2,0.00%
aid.m.taobao.com,0,0.00%,3,3,0.00%
mum.alibabachengdun.com,0,0.00%,3,3,0.00%
puds.ucweb.com,0,0.00%,3,3,0.00%
openacs.m.taobao.com,0,0.00%,3,3,0.00%
policy.video.iqiyi.com,0,0.00%,10,10,0.00%
open-cms-api.uc.cn,0,0.00%,3,3,0.00%
ucus.ucweb.com,0,0.00%,5,5,0.00%
applog-perf.uc.cn,0,0.00%,3,3,0.00%
adtrack.ucweb.com,0,0.00%,3,3,0.00%
api.ximalaya.com,0,0.00%,3,3,0.00%
access.open.uc.cn,0,0.00%,3,3,0.00%
navigis.uc.cn,0,0.00%,5,5,0.00%
coral2.uc.cn,0,0.00%,3,3,0.00%
quark-api.uc.cn,0,0.00%,3,3,0.00%
na61-rmbsync-upaas.uc.cn,0,0.00%,5,5,0.00%
teredo.remlab.net,0,0.00%,4,4,0.00%
vs3.bj2ct.u3.ucweb.com,0,0.00%,3,3,0.00%
na61-ucc-upaas.uc.cn,0,0.00%,9,9,0.00%
frontier.snssdk.com,0,0.00%,2,2,0.00%
rmm233.github.io,0,0.00%,61,61,0.00%
assistant.ceping.com,0,0.00%,6,6,0.00%
transfer-hw.ceping.com,0,0.00%,2,2,0.00%
api.u-tools.cn,0,0.00%,2,2,0.00%
puds-down.uc.cn,0,0.00%,3,3,0.00%
adashx4yt.m.taobao.com,0,0.00%,3,3,0.00%
conf-drcn.cloud.dbankcloud.cn,0,0.00%,8,8,0.00%
ubacollect-drcn.cloud.dbankcloud.cn,0,0.00%,4,4,0.00%
nsp-hicloud-cloudphotonorth4-p02-drcn.obs.cn-north-4.myhuaweicloud.cn,0,0.00%,5,5,0.00%
m.zizouqixs.com,0,0.00%,3,3,0.00%
m.hongrenxs.cc,0,0.00%,3,3,0.00%
m.7shuwu.cc,0,0.00%,3,3,0.00%
mdap.alipay.com,0,0.00%,7,7,0.00%
evalai.cn,0,0.00%,2,2,0.00%
ixia-updates.ixiacom.com,0,0.00%,1,1,0.00%
inside-gateway.alipay.com,0,0.00%,6,6,0.00%
acs-mum.alibabachengdun.com,0,0.00%,3,3,0.00%
east-order.oss-cn-hangzhou.aliyuncs.com,0,0.00%,2,2,0.00%
195.sammentik.cf,0,0.00%,1,1,0.00%
joogh2uf.nodedata.net,0,0.00%,4,4,0.00%
ntes53.mail.163.com,0,0.00%,4,4,0.00%
security.uc.cn,0,0.00%,3,3,0.00%
userver-upaas.uc.cn,0,0.00%,3,3,0.00%
bcloud.uc.cn,0,0.00%,3,3,0.00%
umdc.alibabachengdun.com,0,0.00%,3,3,0.00%
cmhk.tcpbbr.xyz,0,0.00%,11,11,0.00%
unpm-upaas.uc.cn,0,0.00%,5,5,0.00%
sg02.ipv2.xyz,0,0.00%,26,26,0.00%
www.hxkba.com,0,0.00%,14,14,0.00%
t.10jqka.com.cn,0,0.00%,8,8,0.00%
slavedns.123ths.com,0,0.00%,9,9,0.00%
eq.10jqka.com.cn,0,0.00%,27,27,0.00%
ozone.10jqka.com.cn,0,0.00%,4,4,0.00%
adm.10jqka.com.cn,0,0.00%,17,17,0.00%
news.10jqka.com.cn,0,0.00%,11,11,0.00%
recommend.10jqka.com.cn,0,0.00%,4,4,0.00%
u.thsi.cn,0,0.00%,6,6,0.00%
dict.hexin.cn,0,0.00%,10,10,0.00%
bi.10jqka.com.cn,0,0.00%,15,15,0.00%
assessmonitor.ceping.com,0,0.00%,7,7,0.00%
onedscolprdwus01.westus.cloudapp.azure.com,0,0.00%,4,4,0.00%
snz04pap001.storage.live.com,0,0.00%,4,4,0.00%
nsp-hicloud-cloudphotonorth4-p03-drcn.obs.cn-north-4.myhuaweicloud.cn,0,0.00%,2,2,0.00%
circlepic.upqzfile.com,0,0.00%,2,2,0.00%
pic.upqzfile.com,0,0.00%,2,2,0.00%
circlevideo.upqzfile.com,0,0.00%,2,2,0.00%
video.upqzfile.com,0,0.00%,2,2,0.00%
other.upqzfile.com,0,0.00%,2,2,0.00%
mobilelog.upqzfile.com,0,0.00%,2,2,0.00%
ied-tqos-tgp.qq.com,0,0.00%,1,1,0.00%
apponline.research.qq.com,0,0.00%,14,14,0.00%
login.psvr.wps.cn,0,0.00%,10,10,0.00%
ad.us.sinaimg.cn,0,0.00%,6,6,0.00%
webadvisorc.rest.gti.mcafee.com,0,0.00%,8,8,0.00%
connect.rom.miui.com,0,0.00%,20,20,0.00%
account.sogou.com,0,0.00%,19,19,0.00%
pc.profile.pinyin.sogou.com,0,0.00%,13,13,0.00%
profile.pinyin.sogou.com,0,0.00%,14,14,0.00%
pinyin.sogou.com,0,0.00%,12,12,0.00%
ocsp05.actalis.it,0,0.00%,18,18,0.00%
wcjs.sbj.cnipa.gov.cn,0,0.00%,2,2,0.00%
openapi-drcn.cloud.dbankcloud.cn,0,0.00%,2,2,0.00%
httpdns.kwd.inkuai.com,0,0.00%,8,8,0.00%
trdovmsssea.ipv6.microsoft.com.akadns.net,0,0.00%,2,2,0.00%
datahub.zhihu.com,0,0.00%,4,4,0.00%
pheecws.foxitsoftware.cn,0,0.00%,2,2,0.00%
adp.veda.top,0,0.00%,2,2,0.00%
wns.notify.trafficmanager.net,0,0.00%,4,4,0.00%
srv.sec.miui.com,0,0.00%,2,2,0.00%
adv.sec.miui.com,0,0.00%,2,2,0.00%
api.sec.miui.com,0,0.00%,4,4,0.00%
data.sec.miui.com,0,0.00%,4,4,0.00%
game.sec.miui.com,0,0.00%,2,2,0.00%
thm.market.xiaomi.com,0,0.00%,4,4,0.00%
dsp.ads.umeng.com,0,0.00%,6,6,0.00%
899081r30khhvhus2e37b91to5vh8ut3islkvpdqrit0uekfg3nvv5nr.tt.x.bsgslb.cn,0,0.00%,2,2,0.00%
www.hotjob.cn,0,0.00%,2,2,0.00%
hztp.hotjob.cn,0,0.00%,2,2,0.00%
cloud.safe.360.cn,0,0.00%,18,18,0.00%
uploader.shimo.im,0,0.00%,6,6,0.00%
qappcenterv6.3g.qq.com,0,0.00%,5,5,0.00%
task.ac.cn,0,0.00%,2,2,0.00%
gs.getui.net,0,0.00%,2,2,0.00%
tracker2.itzmx.com,0,0.00%,4,4,0.00%
s.deepl.com,0,0.00%,6,6,0.00%
df.tanx.com,0,0.00%,3,3,0.00%
appupgrade.vivo.com.cn,0,0.00%,2,2,0.00%
ali-bj-pcdn-11.biliapi.net,0,0.00%,2,2,0.00%
followservice.kugou.com,0,0.00%,4,4,0.00%
m-cloud.zhihu.com,0,0.00%,6,6,0.00%
miwifi.com,0,0.00%,2,2,0.00%
hiai-mars-drcn.emui.hicloud.com,0,0.00%,3,3,0.00%
lp-push-server-253.lastpass.com,0,0.00%,2,2,0.00%
open.taou.com,0,0.00%,2,2,0.00%
array512.prod.do.dsp.mp.microsoft.com,0,0.00%,6,6,0.00%
array508.prod.do.dsp.mp.microsoft.com,0,0.00%,14,14,0.00%
leplayer.vgs.lenovo.com.cn,0,0.00%,1,1,0.00%
sus.lex.lenovo.com.cn,0,0.00%,2,2,0.00%
hisearch-drcn.dt.dbankcloud.com,0,0.00%,2,2,0.00%
acd.op.hicloud.com,0,0.00%,7,7,0.00%
sdkserver.op.hicloud.com,0,0.00%,2,2,0.00%
pushservice-drcn.dt.dbankcloud.cn,0,0.00%,2,2,0.00%
events.op.hicloud.com,0,0.00%,4,4,0.00%
n.sinaimg.cn,0,0.00%,6,6,0.00%
appdlc-drcn.hispace.dbankcloud.cn,0,0.00%,15,15,0.00%
uc-drcn.hispace.dbankcloud.cn,0,0.00%,6,6,0.00%
store1.hispace.hicloud.com,0,0.00%,7,7,0.00%
geover.prod.do.dsp.mp.microsoft.com,0,0.00%,13,13,0.00%
apd-vodp2pnat.teg.tencent-cloud.net,0,0.00%,8,8,0.00%
txp2p2.liveplay.egame.qq.com,0,0.00%,2,2,0.00%
txpcdn-direct.liveplay.egame.qq.com,0,0.00%,2,2,0.00%
flv265-txpcdn.liveplay.egame.qq.com,0,0.00%,2,2,0.00%
txp2p1.liveplay.egame.qq.com,0,0.00%,2,2,0.00%
flv265-txpcdn-direct.liveplay.egame.qq.com,0,0.00%,2,2,0.00%
xnet-flv265.liveplay.egame.qq.com,0,0.00%,2,2,0.00%
tracker-01.qvb.qcloud.com,0,0.00%,4,4,0.00%
txpcdn.liveplay.egame.qq.com,0,0.00%,2,2,0.00%
xnet-flv264.liveplay.egame.qq.com,0,0.00%,2,2,0.00%
terms-drcn.platform.dbankcloud.cn,0,0.00%,5,5,0.00%
hwpub-s01-drcn.cloud.dbankcloud.cn,0,0.00%,4,4,0.00%
data.mistat.xiaomi.com,0,0.00%,4,4,0.00%
proxy.whaledata.com,0,0.00%,4,4,0.00%
www.duokan.com,0,0.00%,4,4,0.00%
bbsclick.10jqka.com.cn,0,0.00%,4,4,0.00%
community.touzime.com,0,0.00%,4,4,0.00%
mobilegw.alipaydns.com,0,0.00%,4,4,0.00%
cloudlive-xp2p.kpl.qq.com,0,0.00%,2,2,0.00%
cloudctrl.gcloud.qq.com,0,0.00%,2,2,0.00%
ip6.ssl.msdk.qq.com,0,0.00%,6,6,0.00%
ios.crashsight.qq.com,0,0.00%,2,2,0.00%
guid.tpns.tencent.com,0,0.00%,2,2,0.00%
dns5.cdn30.org,0,0.00%,2,2,0.00%
d2f1a68rmuokoa.cloudfront.net,0,0.00%,1,1,0.00%
app-support.blackmagicdesign.com,0,0.00%,1,1,0.00%
de4.videofile.me,0,0.00%,1,1,0.00%
msg.iqiyi.com,0,0.00%,12,12,0.00%
dev.livebeaches.com,0,0.00%,1,1,0.00%
ingest.perchsecurity.com,0,0.00%,1,1,0.00%
httpring.qq.com,0,0.00%,2,2,0.00%
staging.app.bloomfarming.com,0,0.00%,1,1,0.00%
pc.push.126.net,0,0.00%,8,8,0.00%
v4-14.hiaoxui.work,0,0.00%,6,6,0.00%
mtdlp.sankuai.com,0,0.00%,6,6,0.00%
flux.hcdn.qiyi.com,0,0.00%,6,6,0.00%
plugin.browser.qq.com,0,0.00%,6,6,0.00%
jp04.v2netapp.com,0,0.00%,8,8,0.00%
n57.boom.skin,0,0.00%,10,10,0.00%
n05.boom.skin,0,0.00%,12,12,0.00%
collect.kugou.com,0,0.00%,4,4,0.00%
delivery.51zmt.net,0,0.00%,4,4,0.00%
www.sinfors.com.cn,0,0.00%,2,2,0.00%
s.bbm0v.cn,0,0.00%,8,8,0.00%
gsa.apple.com,0,0.00%,8,8,0.00%
gsas.apple.com,0,0.00%,5,5,0.00%
only-934288-124-16-140-6.nstool.haowu.link,0,0.00%,1,1,0.00%
router-default.apps.openshift4.gnome.org,0,0.00%,2,2,0.00%
array805.prod.do.dsp.mp.microsoft.com,0,0.00%,6,6,0.00%
array804.prod.do.dsp.mp.microsoft.com,0,0.00%,14,14,0.00%
www.scootersoftware.com,0,0.00%,2,2,0.00%
array807.prod.do.dsp.mp.microsoft.com,0,0.00%,7,7,0.00%
quota.fe.apple-dns.cn,0,0.00%,6,6,0.00%
onedscolprdeus09.eastus.cloudapp.azure.com,0,0.00%,6,6,0.00%
only-623358-124-16-140-6.nstool.netease.com,0,0.00%,1,1,0.00%
array802.prod.do.dsp.mp.microsoft.com,0,0.00%,14,14,0.00%
iosapps.itunes.g.aaplimg.com,0,0.00%,2,2,0.00%
p204-quota.icloud.com.cn,0,0.00%,4,4,0.00%
auth.grammarly.com,0,0.00%,16,16,0.00%
gslb.xcloud.sandai.net,0,0.00%,17,17,0.00%
teams.live.com,0,0.00%,2,2,0.00%
inisdup.qihucdn.com,0,0.00%,18,18,0.00%
only-292784-124-16-140-6.nstool.laiqukankan.com,0,0.00%,1,1,0.00%
www.360.com,0,0.00%,693,693,0.00%
www.sina.com.cn,0,0.00%,238,238,0.00%
bl6pap003.storage.live.com,0,0.00%,6,6,0.00%
thirdqq.qlogo.cn,0,0.00%,6,6,0.00%
res.qhupdate.com,0,0.00%,5,5,0.00%
www.clarity.ms,0,0.00%,13,13,0.00%
configuration-server-lb-1105093370.us-east-1.elb.amazonaws.com,0,0.00%,4,4,0.00%
s.ludashi.com,0,0.00%,30,30,0.00%
apigtwb2c.us.dell.com,0,0.00%,4,4,0.00%
services.gfe.nvidia.com,0,0.00%,11,11,0.00%
dc1-pp.ksn.kaspersky-labs.com,0,0.00%,8,8,0.00%
mx25.xmvmess.com,0,0.00%,1,1,0.00%
ieonline.microsoft.com,0,0.00%,4,4,0.00%
wdcp.microsoft.com,0,0.00%,18,18,0.00%
changer8.net,0,0.00%,11,11,0.00%
china.bing123.com,0,0.00%,6,6,0.00%
www.databasebydesignllc.com,0,0.00%,11,11,0.00%
msn-china.bing123.com,0,0.00%,5,5,0.00%
vowel.egsesisurgires.tk,0,0.00%,1,1,0.00%
fcmtoken.googleapis.com,0,0.00%,2,2,0.00%
metrics.raptr.com,0,0.00%,4,4,0.00%
docs.live.net,0,0.00%,16,16,0.00%
device.delicloud.com,0,0.00%,13,13,0.00%
data6.video.iqiyi.com,0,0.00%,14,14,0.00%
XSP-efz.ms-acdc.office.com,0,0.00%,4,4,0.00%
i-dm3-cor005.api.p001.1drv.com,0,0.00%,4,4,0.00%
s.vconf.f.360.cn,0,0.00%,5,5,0.00%
settings-prod-wjp-1.japanwest.cloudapp.azure.com,0,0.00%,12,12,0.00%
directconfig.ab.qq.com,0,0.00%,15,15,0.00%
www.sxz8.club,0,0.00%,8,8,0.00%
vcheck.f.360.cn,0,0.00%,21,21,0.00%
d19h5bl8fn71bo.cloudfront.net,0,0.00%,4,4,0.00%
sp1.sangfor.com.cn,0,0.00%,90,90,0.00%
v10.vortex-win.data.microsoft.com,0,0.00%,27,27,0.00%
settings-prod-sea-1.southeastasia.cloudapp.azure.com,0,0.00%,4,4,0.00%
onedriveclucproddm20029.blob.core.windows.net,0,0.00%,4,4,0.00%
tamasi.pizzakaravan.hu,0,0.00%,1,1,0.00%
ups.ksmobile.net,0,0.00%,16,16,0.00%
delivery.maihehd.com,0,0.00%,6,6,0.00%
sqm.telemetry.microsoft.com,0,0.00%,20,20,0.00%
im.collab.reuters.net,0,0.00%,6,6,0.00%
pook.com,0,0.00%,6,6,0.00%
qiao.baidu.com,0,0.00%,6,6,0.00%
v1.baidupcs.com,0,0.00%,7,7,0.00%
nbcache00.baidupcs.com,0,0.00%,4,4,0.00%
sogovpn.com,0,0.00%,6,6,0.00%
gamec.boombeachgame.com,0,0.00%,8,8,0.00%
sip.reuters.net,0,0.00%,5,5,0.00%
and.game.coc.qq.com,0,0.00%,6,6,0.00%
meeting.huaweicloud.com,0,0.00%,8,8,0.00%
teams.microsoft.com,0,0.00%,10,10,0.00%
cn-release-pub-room-gz.lgame.qq.com,0,0.00%,4,4,0.00%
www.facebook.com,0,0.00%,10,10,0.00%
api.weibo.com,0,0.00%,8,8,0.00%
server1.yoics.net,0,0.00%,7,7,0.00%
server2.yoics.net,0,0.00%,6,6,0.00%
auth.collab.reuters.net,0,0.00%,6,6,0.00%
hxce.cn,0,0.00%,6,6,0.00%
pic.263em.com,0,0.00%,4,4,0.00%
ios.game.coc.qq.com,0,0.00%,6,6,0.00%
gamec.clashroyaleapp.com,0,0.00%,8,8,0.00%
tr.skype.com,0,0.00%,4,4,0.00%
vzuu.com,0,0.00%,6,6,0.00%
im.welink.huaweicloud.com,0,0.00%,6,6,0.00%
game.brawlstars.cn,0,0.00%,6,6,0.00%
wss.tim.qq.com,0,0.00%,6,6,0.00%
271509e17755a70d683b7f40cdb3eec6df604067.u.fdmpkg.org,0,0.00%,6,6,0.00%
uwewe.com,0,0.00%,2,2,0.00%
webex.com.cn,0,0.00%,2,2,0.00%
zhumu.me,0,0.00%,4,4,0.00%
d.wn51.com,0,0.00%,4,4,0.00%
pcmgr-cdn.vipguanjia.net,0,0.00%,2,2,0.00%
ddf.1proh.com,0,0.00%,2,2,0.00%
stun.syncthing.net,0,0.00%,9,9,0.00%
weather-drcn.music.hicloud.com,0,0.00%,4,4,0.00%
nsp-hicloud-cloudphotonorth4-p03-drcn.obs.cn-north-4.myhuaweicloud.com,0,0.00%,2,2,0.00%
httpdns.huaweicloud.com,0,0.00%,6,6,0.00%
bigota.miwifi.com,0,0.00%,2,2,0.00%
cloudphoto-drcn.cloud.dbankcloud.cn,0,0.00%,4,4,0.00%
siyuan-sync.b3logfile.com,0,0.00%,2,2,0.00%
onedriveclucproddm20026.blob.core.windows.net,0,0.00%,11,11,0.00%
mail.checkthewarehouze.ml,0,0.00%,1,1,0.00%
yuncl-zs.51fapiao.cn,0,0.00%,3,3,0.00%
decisionhub-drcn.emui.dbankcloud.com,0,0.00%,6,6,0.00%
offline.aps.amap.com,0,0.00%,23,23,0.00%
forum-api-drcn.jos.hicloud.com,0,0.00%,7,7,0.00%
datacollector-drcn.dt.hicloud.com,0,0.00%,11,11,0.00%
api.cloud.huawei.com,0,0.00%,4,4,0.00%
forum-api-drcn.jos.dbankcloud.cn,0,0.00%,2,2,0.00%
jxs-drcn.jos.dbankcloud.cn,0,0.00%,4,4,0.00%
rms-drcn.platform.dbankcloud.com,0,0.00%,2,2,0.00%
video.yidianzixun.com,0,0.00%,56,56,0.00%
sns-drcn.platform.dbankcloud.cn,0,0.00%,6,6,0.00%
im1.hicloud.com,0,0.00%,5,5,0.00%
vdwmto3.bdstatic.com,0,0.00%,33,33,0.00%
1fc542b0b3ee4a6f9517143c3586f87f.fp.measure.office.com,0,0.00%,1,1,0.00%
tjtv3.wn51.com,0,0.00%,2,2,0.00%
update-pcsafe.2345.cc,0,0.00%,8,8,0.00%
helpinfockeniu1.ksmobile.com,0,0.00%,4,4,0.00%
mini.eastday.com,0,0.00%,2,2,0.00%
sdkapiv2.bizport.cn,0,0.00%,8,8,0.00%
nanism.art,0,0.00%,6,6,0.00%
pop3.aliyun.com,0,0.00%,6,6,0.00%
softbus-msg.wps.cn,0,0.00%,2,2,0.00%
kfcs.csc.com.cn,0,0.00%,17,17,0.00%
iceoiw.ni56es2qy.gq,0,0.00%,1,1,0.00%
tiny.china.qiniu.com.trpcdn.NET,0,0.00%,3,3,0.00%
cp3.huoying666.com,0,0.00%,6,6,0.00%
platform.bing.com,0,0.00%,8,8,0.00%
tycs.hpccube.com,0,0.00%,3,3,0.00%
stocks-edge.apple.com,0,0.00%,2,2,0.00%
be59399.wz.glados-config.net,0,0.00%,8,8,0.00%
www.aliyundrive.com,0,0.00%,8,8,0.00%
dsm01pap007.storage.live.com,0,0.00%,11,11,0.00%
onedriveclucproddm20047.blob.core.windows.net,0,0.00%,2,2,0.00%
ocsp.usertrust.com,0,0.00%,11,11,0.00%
motd.ubuntu.com,0,0.00%,24,24,0.00%
orange-pcsafe.2345.cc,0,0.00%,24,24,0.00%
config.safedog.cn,0,0.00%,6,6,0.00%
down.safedog.cn,0,0.00%,3,3,0.00%
onedriveclucprodbn20047.blob.core.windows.net,0,0.00%,8,8,0.00%
fd.api.iris.microsoft.com,0,0.00%,4,4,0.00%
down1.thorzip.muxin.fun,0,0.00%,2,2,0.00%
doi.cnjournals.com,0,0.00%,2,2,0.00%
zhxin.xfplay.com,0,0.00%,6,6,0.00%
update.safedog.cn,0,0.00%,2,2,0.00%
service.alljournals.cn,0,0.00%,3,3,0.00%
aus5.mozilla.org,0,0.00%,27,27,0.00%
prod.balrog.prod.cloudops.mozgcp.net,0,0.00%,2,2,0.00%
helpdesktop1.ksmobile.com,0,0.00%,4,4,0.00%
wpvip.duba.net,0,0.00%,2,2,0.00%
union.infoc.duba.net,0,0.00%,2,2,0.00%
event.games.laohu.com,0,0.00%,4,4,0.00%
bbs-api.mihoyo.com,0,0.00%,6,6,0.00%
hicall-enhance-drcn.emui.dbankcloud.com,0,0.00%,4,4,0.00%
cn.mclean.50union.com,0,0.00%,5,5,0.00%
securityapi.d3-pr-tm.com,0,0.00%,6,6,0.00%
tm-sdk.platinumai.net,0,0.00%,8,8,0.00%
shuc-other.ksord.com,0,0.00%,14,14,0.00%
global.infoapis.com,0,0.00%,2,2,0.00%
d15po2y6qe9yxr.cloudfront.net,0,0.00%,1,1,0.00%
iface2.iqiyi.com,0,0.00%,4,4,0.00%
creator.zoho.com,0,0.00%,2,2,0.00%
global.infoapis.net,0,0.00%,4,4,0.00%
settings-prod-wus3-1.westus3.cloudapp.azure.com,0,0.00%,8,8,0.00%
spatialsearch.is.autonavi.com,0,0.00%,6,6,0.00%
t7z.cupid.iqiyi.com,0,0.00%,2,2,0.00%
l-rcd.iqiyi.com,0,0.00%,4,4,0.00%
msga.cupid.iqiyi.com,0,0.00%,4,4,0.00%
mirror.clarkson.edu,0,0.00%,2,2,0.00%
neuro.debian.net,0,0.00%,2,2,0.00%
api.iqiyi.com,0,0.00%,4,4,0.00%
ifacelog.iqiyi.com,0,0.00%,4,4,0.00%
cache.video.iqiyi.com,0,0.00%,4,4,0.00%
cards.iqiyi.com,0,0.00%,2,2,0.00%
v-2a384bf4.71edge.com,0,0.00%,2,2,0.00%
v-7a8dc82f.71edge.com,0,0.00%,2,2,0.00%
v-2a38440b.71edge.com,0,0.00%,2,2,0.00%
img7.iqiyipic.com,0,0.00%,2,2,0.00%
hwvipkid.vipkidcdn.com,0,0.00%,5,5,0.00%
rsync.releases.ubuntu.com,0,0.00%,4,4,0.00%
7195c67.pf.gladns.com,0,0.00%,2,2,0.00%
7195c67.pd.gladns.com,0,0.00%,2,2,0.00%
7195c67.pa.gladns.com,0,0.00%,2,2,0.00%
7195c67.pe.gladns.com,0,0.00%,2,2,0.00%
7195c67.pc.gladns.com,0,0.00%,2,2,0.00%
7195c67.pg.gladns.com,0,0.00%,4,4,0.00%
7195c67.pb.gladns.com,0,0.00%,2,2,0.00%
v-7a8dc831.71edge.com,0,0.00%,2,2,0.00%
api.m.taobao.com,0,0.00%,5,5,0.00%
v6-data.video.dns.iqiyi.com,0,0.00%,2,2,0.00%
new.em-acplumbing.com,0,0.00%,1,1,0.00%
cloudctl.speiyou.com,0,0.00%,4,4,0.00%
cn-beijing.log.aliyuncs.com.cn-beijing.log.aliyuncs.com,0,0.00%,4,4,0.00%
xeszx-py-online.cn-beijing.log.aliyuncs.com,0,0.00%,8,8,0.00%
322fbb17aa371817ba7415b59f5ecea9.dlied1.cdntips.net,0,0.00%,4,4,0.00%
www.i0rp1l2j.com,0,0.00%,4,4,0.00%
oss.mail.qq.com,0,0.00%,16,16,0.00%
ss.dolphinpaper.com,0,0.00%,2,2,0.00%
sirius.mwbsys.com,0,0.00%,2,2,0.00%
ai1.acciff.com,0,0.00%,4,4,0.00%
tracker-public.tjupt.org,0,0.00%,8,8,0.00%
consul-kv.app.kdsec.org,0,0.00%,4,4,0.00%
consul.app.kdsec.org,0,0.00%,6,6,0.00%
cpestatus.hipplayconnect.com,0,0.00%,18,18,0.00%
diagnosis.ad.xiaomi.com,0,0.00%,4,4,0.00%
cn-shanghai.axt.aliyun.com,0,0.00%,6,6,0.00%
cn-shenzhen.axt.aliyun.com,0,0.00%,18,18,0.00%
clientlog.music.163.com,0,0.00%,6,6,0.00%
hk4.v2u9.top,0,0.00%,18,18,0.00%
22082c5dc02e4643bb2c4417b346f0fb.fp.measure.office.com,0,0.00%,1,1,0.00%
waconatm.officeapps.live.com,0,0.00%,12,12,0.00%
c.xzhwdz.com,0,0.00%,120,120,0.00%
gza.edge.boom.skin,0,0.00%,6,6,0.00%
grafana.net,0,0.00%,4,4,0.00%
report.uchiha.ltd,0,0.00%,10,10,0.00%
middle.yun.139.com,0,0.00%,2,2,0.00%
pico.eset.com,0,0.00%,10,10,0.00%
mobile.events.data.trafficmanager.net,0,0.00%,26,26,0.00%
7902f652-rh7400-rix76f-nu3o.pccw.alrihla.net,0,0.00%,6,6,0.00%
tac.googleapis.com,0,0.00%,2,2,0.00%
loader-professional.com,0,0.00%,2,2,0.00%
dc.di.atlas.samsung.com,0,0.00%,2,2,0.00%
packages.gitlab.com,0,0.00%,42,42,0.00%
api.cn-weathernews.cn,0,0.00%,2,2,0.00%
staging.app.trackgo.com,0,0.00%,1,1,0.00%
dig.feishu.cn,0,0.00%,4,4,0.00%
e44ee7b.ph.gladns.com,0,0.00%,2,2,0.00%
e44ee7b.pg.gladns.com,0,0.00%,2,2,0.00%
e44ee7b.pa.gladns.com,0,0.00%,2,2,0.00%
array510.prod.do.dsp.mp.microsoft.com,0,0.00%,26,26,0.00%
stun.douyucdn.cn,0,0.00%,6,6,0.00%
j.v4.1.kiki789.com,0,0.00%,8,8,0.00%
pgyapi.oray.net,0,0.00%,4,4,0.00%
i4.cwip.eset.com,0,0.00%,2,2,0.00%
push.ynote.youdao.com,0,0.00%,7,7,0.00%
open.qurl.f.360.cn,0,0.00%,4,4,0.00%
array613.prod.do.dsp.mp.microsoft.com,0,0.00%,4,4,0.00%
api.installer.xiaomi.com,0,0.00%,2,2,0.00%
adash-emas.cn-hangzhou.aliyuncs.com,0,0.00%,2,2,0.00%
flash.sec.miui.com,0,0.00%,2,2,0.00%
app.market.xiaomi.com,0,0.00%,4,4,0.00%
etl-xlmc-ssl.sandai.net,0,0.00%,4,4,0.00%
api.tw06.xlmc.sec.miui.com,0,0.00%,2,2,0.00%
hub5u.wap.sandai.net,0,0.00%,2,2,0.00%
master.wap.dphub.sandai.net,0,0.00%,2,2,0.00%
bg1.market.xiaomi.com,0,0.00%,2,2,0.00%
idx.m.hub.sandai.net,0,0.00%,2,2,0.00%
hub5pn.wap.sandai.net,0,0.00%,2,2,0.00%
pr.m.hub.sandai.net,0,0.00%,2,2,0.00%
sr.m.hub.sandai.net,0,0.00%,2,2,0.00%
pbg0.market.xiaomi.com,0,0.00%,2,2,0.00%
download.get.live.cn,0,0.00%,2,2,0.00%
i4.c.eset.com,0,0.00%,4,4,0.00%
dispatch.b.api.cqttech.com,0,0.00%,1,1,0.00%
onedscolprdjpe03.japaneast.cloudapp.azure.com,0,0.00%,2,2,0.00%
deepl.com,0,0.00%,5,5,0.00%
sdupm.360.cn,0,0.00%,32,32,0.00%
online2.ts.api.xiangtatech.com,0,0.00%,9,9,0.00%
dataserver2.17rd.com,0,0.00%,2,2,0.00%
yr.easyfly.tk,0,0.00%,1,1,0.00%
cmgz.10242018.xyz,0,0.00%,8,8,0.00%
onedscolprdeus13.eastus.cloudapp.azure.com,0,0.00%,6,6,0.00%
serveraddrweb.kugou.com,0,0.00%,4,4,0.00%
api100-eeft-drive-quic-lf.feishu.cn,0,0.00%,7,7,0.00%
weixin.qq.com,0,0.00%,25,25,0.00%
update.os.nfschina.com,0,0.00%,16,16,0.00%
d33vwaa6rdensn.cloudfront.net,0,0.00%,11,11,0.00%
c61s4.jamjams3.net,0,0.00%,10,10,0.00%
content.rconfig.qq.com,0,0.00%,4,4,0.00%
i.weread.qq.com,0,0.00%,2,2,0.00%
oss.weread.qq.com,0,0.00%,2,2,0.00%
szmg.qq.com,0,0.00%,2,2,0.00%
ap-shanghai.cls.tencentcs.com,0,0.00%,2,2,0.00%
wp.shanhutech.cn,0,0.00%,3,3,0.00%
ts-crl.ws.symantec.com,0,0.00%,2,2,0.00%
c26s2.jamjams.net,0,0.00%,2,2,0.00%
c61s5.jamjams3.net,0,0.00%,2,2,0.00%
c61s801.jamjams3.net,0,0.00%,2,2,0.00%
c26s3.jamjams.net,0,0.00%,2,2,0.00%
c61s3.jamjams3.net,0,0.00%,1,1,0.00%
c26s4.jamjams.net,0,0.00%,2,2,0.00%
c26s1.jamjams.net,0,0.00%,2,2,0.00%
emp-api.baidu.com,0,0.00%,15,15,0.00%
apib.stapi.cc,0,0.00%,4,4,0.00%
newdtt.usb.cloud.duba.net,0,0.00%,6,6,0.00%
stat.centbrowser.cn.w.kunlunca.com,0,0.00%,2,2,0.00%
analysis-acc-ssl.xunlei.com,0,0.00%,2,2,0.00%
sla-bac.nutrislice.com,0,0.00%,1,1,0.00%
anidex.moe,0,0.00%,4,4,0.00%
tracker.kali.org,0,0.00%,2,2,0.00%
pow7.com,0,0.00%,2,2,0.00%
torrent.mp3quran.net,0,0.00%,4,4,0.00%
tehconnection.eu,0,0.00%,4,4,0.00%
file.service.qq.com,0,0.00%,4,4,0.00%
onedriveclucproddm20025.blob.core.windows.net,0,0.00%,5,5,0.00%
platform.wondershare.com,0,0.00%,4,4,0.00%
mvgroup.org,0,0.00%,6,6,0.00%
master9.teamviewer.com,0,0.00%,4,4,0.00%
tracker.publictorrent.net,0,0.00%,6,6,0.00%
113gb5.g132d3.10002tli.device-ddp2-dns.ictun.com,0,0.00%,8,8,0.00%
sz-videocloud-dev.oss-cn-shenzhen.aliyuncs.com,0,0.00%,8,8,0.00%
freerainbowtables.com,0,0.00%,4,4,0.00%
open.tracker.cl,0,0.00%,42,42,0.00%
tracker.ddunlimited.net,0,0.00%,2,2,0.00%
securetoken.googleapis.com,0,0.00%,2,2,0.00%
hub5sr.v6.shub.sandai.net,0,0.00%,2,2,0.00%
tracker.lilithraws.org,0,0.00%,2,2,0.00%
imws.sobot.com,0,0.00%,4,4,0.00%
onedriveclucprodbn20039.blob.core.windows.net,0,0.00%,4,4,0.00%
app-a04.lp1.npns.srv.nintendo.net,0,0.00%,2,2,0.00%
baibako.tv,0,0.00%,2,2,0.00%
p217-caldav.icloud.com.cn,0,0.00%,2,2,0.00%
speedtest-rtc.xtsmart.link,0,0.00%,4,4,0.00%
tracker.parrotsec.org,0,0.00%,4,4,0.00%
bt.3dmgame.com,0,0.00%,4,4,0.00%
api.polargrizzly.com,0,0.00%,4,4,0.00%
m.reachmax.cn,0,0.00%,4,4,0.00%
pmp.365dmp.com,0,0.00%,4,4,0.00%
ws-std01.sunlogin.oray.com,0,0.00%,14,14,0.00%
mgtracker.org,0,0.00%,2,2,0.00%
theodoric.fr,0,0.00%,2,2,0.00%
p2plive-ws.douyucdn.cn,0,0.00%,8,8,0.00%
wap.sogou.com,0,0.00%,2,2,0.00%
announce.partis.si,0,0.00%,2,2,0.00%
fe-mtweapp-log.dreport.meituan.net,0,0.00%,5,5,0.00%
t.publictracker.xyz,0,0.00%,2,2,0.00%
vaiwan.com,0,0.00%,2,2,0.00%
smtp.flawcra.cc,0,0.00%,2,2,0.00%
api.game.meizu.com,0,0.00%,6,6,0.00%
zephir.monocul.us,0,0.00%,4,4,0.00%
tracker.uw0.xyz,0,0.00%,3,3,0.00%
api.8864029a8b01d50a95d558b5792ce2d6.pw,0,0.00%,4,4,0.00%
tracker3.itzmx.com,0,0.00%,2,2,0.00%
btx.anifilm.tv,0,0.00%,4,4,0.00%
r2---sn-2x3elnel.gvt1.com,0,0.00%,4,4,0.00%
tracker.torrentleech.org,0,0.00%,4,4,0.00%
tr.doogh.club,0,0.00%,6,6,0.00%
bt.unionpeer.org,0,0.00%,4,4,0.00%
8d0968d6458e0ad0.jijifun.com,0,0.00%,4,4,0.00%
210194c475687be6.jijifun.com,0,0.00%,4,4,0.00%
tracker.zerobytes.xyz,0,0.00%,4,4,0.00%
asst-api.ksord.com,0,0.00%,4,4,0.00%
www.thegeeks.bz,0,0.00%,2,2,0.00%
tracker.coppersurfer.tk,0,0.00%,4,4,0.00%
t.btcland.xyz,0,0.00%,2,2,0.00%
loanfin.com.au,0,0.00%,61,61,0.00%
account.cnblogs.com,0,0.00%,8,8,0.00%
abufinzio.monocul.us,0,0.00%,2,2,0.00%
tracker.supertracker.net,0,0.00%,4,4,0.00%
mbsug.ssl.so.com,0,0.00%,23,23,0.00%
browser6.qhimg.com,0,0.00%,13,13,0.00%
hk-4.upjs.xyz,0,0.00%,36,36,0.00%
hk1-4.nigirocloud.com,0,0.00%,6,6,0.00%
nl3-5.nigirocloud.com,0,0.00%,9,9,0.00%
nl1-7.nigirocloud.com,0,0.00%,8,8,0.00%
nl1-8.nigirocloud.com,0,0.00%,9,9,0.00%
nl3-1.nigirocloud.com,0,0.00%,8,8,0.00%
nl3-2.nigirocloud.com,0,0.00%,9,9,0.00%
nl3-3.nigirocloud.com,0,0.00%,9,9,0.00%
uk1-3.nigirocloud.com,0,0.00%,9,9,0.00%
nl3-6.nigirocloud.com,0,0.00%,9,9,0.00%
nl3-7.nigirocloud.com,0,0.00%,8,8,0.00%
nl3-8.nigirocloud.com,0,0.00%,9,9,0.00%
uk1-1.nigirocloud.com,0,0.00%,9,9,0.00%
uk1-2.nigirocloud.com,0,0.00%,8,8,0.00%
uk1-4.nigirocloud.com,0,0.00%,9,9,0.00%
browser2.qhimg.com,0,0.00%,5,5,0.00%
wenda.tianya.cn,0,0.00%,6,6,0.00%
rq.kpcct.cloud.duba.net,0,0.00%,15,15,0.00%
api.lxqp.360.cn,0,0.00%,7,7,0.00%
umc.rising.com.cn,0,0.00%,8,8,0.00%
pop3.buaa.edu.cn,0,0.00%,3,3,0.00%
relay-6556aec6.net.anydesk.com,0,0.00%,8,8,0.00%
archive.cloudera.com,0,0.00%,3,3,0.00%
t.hdhome.org,0,0.00%,6,6,0.00%
public1.114dns.com,0,0.00%,25,25,0.00%
fortune.com,0,0.00%,3,3,0.00%
www.usps.com,0,0.00%,3,3,0.00%
api.wcc.best,0,0.00%,8,8,0.00%
eulixos.com,0,0.00%,2,2,0.00%
erigon-mainnet--rpc.datahub.figment.io,0,0.00%,2,2,0.00%
doh.360.cn,0,0.00%,14,14,0.00%
server3.yoics.net,0,0.00%,7,7,0.00%
extdns002.ford.com,0,0.00%,2,2,0.00%
dns006.ford.com,0,0.00%,2,2,0.00%
ns10.servicio-online.net,0,0.00%,8,8,0.00%
10.push2his.eastmoney.com,0,0.00%,4,4,0.00%
11.push2his.eastmoney.com,0,0.00%,4,4,0.00%
dns13.servidoresdns.net,0,0.00%,4,4,0.00%
nsb.whogohost.com,0,0.00%,6,6,0.00%
dns14.servidoresdns.net,0,0.00%,4,4,0.00%
nsa.whogohost.com,0,0.00%,6,6,0.00%
www.safedog.cn,0,0.00%,4,4,0.00%
13.push2his.eastmoney.com,0,0.00%,2,2,0.00%
94.push2his.eastmoney.com,0,0.00%,2,2,0.00%
24.push2his.eastmoney.com,0,0.00%,2,2,0.00%
78.push2his.eastmoney.com,0,0.00%,3,3,0.00%
47.push2his.eastmoney.com,0,0.00%,4,4,0.00%
hnyd.817777.xyz,0,0.00%,4,4,0.00%
33.push2his.eastmoney.com,0,0.00%,2,2,0.00%
rb.symcb.com,0,0.00%,5,5,0.00%
ns73.hostgator.mx,0,0.00%,4,4,0.00%
derek.ns.cloudflare.com,0,0.00%,6,6,0.00%
aida.ns.cloudflare.com,0,0.00%,6,6,0.00%
amos.ns.cloudflare.com,0,0.00%,6,6,0.00%
robert.ns.cloudflare.com,0,0.00%,3,3,0.00%
dimitris.ns.cloudflare.com,0,0.00%,2,2,0.00%
teresa.ns.cloudflare.com,0,0.00%,8,8,0.00%
ns1hnx.name.com,0,0.00%,2,2,0.00%
ns-1954.awsdns-52.co.uk,0,0.00%,2,2,0.00%
ns2cvx.name.com,0,0.00%,2,2,0.00%
ns2.magnoliadns.net,0,0.00%,2,2,0.00%
ns3gmt.name.com,0,0.00%,6,6,0.00%
ns1.magnoliadns.net,0,0.00%,2,2,0.00%
anahi.ns.cloudflare.com,0,0.00%,14,14,0.00%
micah.ns.cloudflare.com,0,0.00%,2,2,0.00%
ch.pro.io,0,0.00%,2,2,0.00%
nl.pro.io,0,0.00%,2,2,0.00%
ridge.ns.cloudflare.com,0,0.00%,2,2,0.00%
ns1.nameself.com,0,0.00%,7,7,0.00%
p.dnh.net,0,0.00%,2,2,0.00%
free02.indowebsite.net,0,0.00%,2,2,0.00%
ns2.proaktif.org,0,0.00%,2,2,0.00%
ns2.lcn.com,0,0.00%,4,4,0.00%
ns1.dinsoradvertising.com,0,0.00%,2,2,0.00%
ns1.lcn.com,0,0.00%,4,4,0.00%
free01.indowebsite.net,0,0.00%,2,2,0.00%
ns1mtw.name.com,0,0.00%,6,6,0.00%
ns1.undeveloped.com,0,0.00%,22,22,0.00%
ns0.lcn.com,0,0.00%,4,4,0.00%
magnolia.ns.cloudflare.com,0,0.00%,4,4,0.00%
ns2cqs.name.com,0,0.00%,4,4,0.00%
ns2.undeveloped.com,0,0.00%,21,21,0.00%
ns2.instyserver.com,0,0.00%,6,6,0.00%
ns-1349.awsdns-40.org,0,0.00%,2,2,0.00%
indie.ns.cloudflare.com,0,0.00%,2,2,0.00%
ns1.instyserver.com,0,0.00%,6,6,0.00%
ganz.ns.cloudflare.com,0,0.00%,8,8,0.00%
gitea.com,0,0.00%,2,2,0.00%
dns1.cosmotown.com,0,0.00%,2,2,0.00%
gloria.ns.cloudflare.com,0,0.00%,6,6,0.00%
dns2.cosmotown.com,0,0.00%,2,2,0.00%
ns2.ihosting.pk,0,0.00%,2,2,0.00%
ns2.directorysecure.com,0,0.00%,4,4,0.00%
ns1.ihosting.pk,0,0.00%,2,2,0.00%
ns2.assigned.network,0,0.00%,2,2,0.00%
dns1.dapurhosting.net,0,0.00%,4,4,0.00%
ns1068.ui-dns.org,0,0.00%,2,2,0.00%
freedns5.registrar-servers.com,0,0.00%,2,2,0.00%
nsb.bookmyname.com,0,0.00%,4,4,0.00%
ns2.hostnil.com,0,0.00%,2,2,0.00%
ns1.assigned.network,0,0.00%,2,2,0.00%
ns1.blacknightdns.com,0,0.00%,2,2,0.00%
ns1036.ui-dns.biz,0,0.00%,3,3,0.00%
nsa.bookmyname.com,0,0.00%,4,4,0.00%
oswald.ns.cloudflare.com,0,0.00%,6,6,0.00%
nsc.bookmyname.com,0,0.00%,4,4,0.00%
ns-2011.awsdns-59.co.uk,0,0.00%,2,2,0.00%
ns1.directorysecure.com,0,0.00%,4,4,0.00%
ns1.hostnil.com,0,0.00%,2,2,0.00%
miki.ns.cloudflare.com,0,0.00%,9,9,0.00%
cosmin.ns.cloudflare.com,0,0.00%,2,2,0.00%
ns2.blacknightdns.com,0,0.00%,2,2,0.00%
banana.dnspod.net,0,0.00%,6,6,0.00%
ns11.webrserver.com,0,0.00%,2,2,0.00%
ns34.creativeon.net,0,0.00%,2,2,0.00%
rusty.dnspod.net,0,0.00%,6,6,0.00%
gannon.ns.cloudflare.com,0,0.00%,4,4,0.00%
chi-ns1.websitehostserver.net,0,0.00%,8,8,0.00%
ns10.webrserver.com,0,0.00%,2,2,0.00%
ams-ns1.websitehostserver.net,0,0.00%,8,8,0.00%
ns.liquidweb.com,0,0.00%,4,4,0.00%
ns2.kissconnect.net,0,0.00%,2,2,0.00%
ns4.highhosters.com,0,0.00%,2,2,0.00%
ns1.btj-system.xyz,0,0.00%,2,2,0.00%
ns200.anycast.me,0,0.00%,13,13,0.00%
ns2.hostingmadeeasy.com,0,0.00%,2,2,0.00%
ns3cpr.name.com,0,0.00%,2,2,0.00%
gabriel.ns.cloudflare.com,0,0.00%,6,6,0.00%
thea.ns.cloudflare.com,0,0.00%,4,4,0.00%
lex.ns.cloudflare.com,0,0.00%,4,4,0.00%
1587788.vhost26.mianbeian.top,0,0.00%,2,2,0.00%
ns2.btj-system.xyz,0,0.00%,2,2,0.00%
ns4236.hostgator.com,0,0.00%,5,5,0.00%
skydomeart.com,0,0.00%,2,2,0.00%
ns4235.hostgator.com,0,0.00%,5,5,0.00%
ns2.bh-ht-11.webhostbox.net,0,0.00%,2,2,0.00%
ns4lny.name.com,0,0.00%,4,4,0.00%
ns2.whoisdomain.kr,0,0.00%,7,7,0.00%
ns-1142.awsdns-14.org,0,0.00%,2,2,0.00%
ns-1199.awsdns-21.org,0,0.00%,2,2,0.00%
ns3.meganameservers.eu,0,0.00%,2,2,0.00%
ns1051.ui-dns.de,0,0.00%,2,2,0.00%
ns-248.awsdns-31.com,0,0.00%,2,2,0.00%
ns2.exonhost.com,0,0.00%,2,2,0.00%
ns-1479.awsdns-56.org,0,0.00%,2,2,0.00%
ns-682.awsdns-21.net,0,0.00%,3,3,0.00%
cdns1.main-hosting.eu,0,0.00%,10,10,0.00%
ns-1627.awsdns-11.co.uk,0,0.00%,2,2,0.00%
ns-1273.awsdns-31.org,0,0.00%,4,4,0.00%
ns-237.awsdns-29.com,0,0.00%,2,2,0.00%
ns1.exonhost.com,0,0.00%,2,2,0.00%
ns-1581.awsdns-05.co.uk,0,0.00%,2,2,0.00%
ns-974.awsdns-57.net,0,0.00%,2,2,0.00%
ns795.hostgator.com.br,0,0.00%,2,2,0.00%
ns-1332.awsdns-38.org,0,0.00%,4,4,0.00%
ns3.nic.ru,0,0.00%,83,83,0.00%
ns3.whoisdomain.kr,0,0.00%,7,7,0.00%
ns6.awardspace.com,0,0.00%,4,4,0.00%
ns-1904.awsdns-46.co.uk,0,0.00%,4,4,0.00%
ns-554.awsdns-05.net,0,0.00%,2,2,0.00%
ns132.sgcloudhosting.com,0,0.00%,2,2,0.00%
shoppinghub-247.com,0,0.00%,2,2,0.00%
ns2bls.name.com,0,0.00%,39,39,0.00%
ns131.sgcloudhosting.com,0,0.00%,2,2,0.00%
ns4.whoisdomain.kr,0,0.00%,8,8,0.00%
ns8.nic.ru,0,0.00%,52,52,0.00%
ns-691.awsdns-22.net,0,0.00%,2,2,0.00%
hawk-host.mars.orderbox-dns.com,0,0.00%,2,2,0.00%
marlowe.ns.cloudflare.com,0,0.00%,16,16,0.00%
ns3cfp.name.com,0,0.00%,4,4,0.00%
ns1.whoisdomain.kr,0,0.00%,7,7,0.00%
ns133.sgcloudhosting.com,0,0.00%,2,2,0.00%
bs59.hostwindsdns.com,0,0.00%,2,2,0.00%
sleepingvishnu.com,0,0.00%,2,2,0.00%
ns3.highhosters.com,0,0.00%,2,2,0.00%
ns1040.ui-dns.org,0,0.00%,2,2,0.00%
aryanna.ns.cloudflare.com,0,0.00%,2,2,0.00%
ns134.sgcloudhosting.com,0,0.00%,2,2,0.00%
anirban.ns.cloudflare.com,0,0.00%,2,2,0.00%
aitana.ns.cloudflare.com,0,0.00%,6,6,0.00%
gabriella.ns.cloudflare.com,0,0.00%,4,4,0.00%
ns1.zolahost.net,0,0.00%,2,2,0.00%
etienne.ns.cloudflare.com,0,0.00%,4,4,0.00%
bs60.hostwindsdns.com,0,0.00%,2,2,0.00%
nia.ns.cloudflare.com,0,0.00%,30,30,0.00%
ns-1796.awsdns-32.co.uk,0,0.00%,2,2,0.00%
ns1.free.thdns.com,0,0.00%,2,2,0.00%
cpanel07-ns2.reliablewebhosting.ca,0,0.00%,2,2,0.00%
ns-422.awsdns-52.com,0,0.00%,2,2,0.00%
slots-th.com,0,0.00%,2,2,0.00%
ns3.dominios.uol.com.br,0,0.00%,7,7,0.00%
cns14.hostgator.com,0,0.00%,4,4,0.00%
ns1.dominios.uol.com.br,0,0.00%,10,10,0.00%
ns.second-ns.com,0,0.00%,4,4,0.00%
ns-1443.awsdns-52.org,0,0.00%,2,2,0.00%
ns2.dominios.uol.com.br,0,0.00%,7,7,0.00%
ns1.reg365.net,0,0.00%,2,2,0.00%
ns3.second-ns.de,0,0.00%,4,4,0.00%
ns1022.ui-dns.biz,0,0.00%,8,8,0.00%
ns1085.ui-dns.org,0,0.00%,7,7,0.00%
ns1114.ui-dns.com,0,0.00%,9,9,0.00%
itzel.ns.cloudflare.com,0,0.00%,2,2,0.00%
ns0.reg365.net,0,0.00%,2,2,0.00%
tony.ns.cloudflare.com,0,0.00%,8,8,0.00%
ns2.reg365.net,0,0.00%,2,2,0.00%
strong.dnspod.net,0,0.00%,2,2,0.00%
amanda.ns.cloudflare.com,0,0.00%,2,2,0.00%
argument.dnspod.net,0,0.00%,2,2,0.00%
dax.ns.cloudflare.com,0,0.00%,2,2,0.00%
ns-1622.awsdns-10.co.uk,0,0.00%,2,2,0.00%
demi.ns.cloudflare.com,0,0.00%,6,6,0.00%
ns-207.awsdns-25.com,0,0.00%,4,4,0.00%
ns1.bdydns.cn,0,0.00%,10,10,0.00%
docks17.rzone.de,0,0.00%,4,4,0.00%
nsb.n0c.com,0,0.00%,2,2,0.00%
michelle.ns.cloudflare.com,0,0.00%,4,4,0.00%
ns3.iwantmyname.net,0,0.00%,6,6,0.00%
ns-527.awsdns-01.net,0,0.00%,2,2,0.00%
ns1.ipage.com,0,0.00%,16,16,0.00%
siwells.com,0,0.00%,2,2,0.00%
ns1122.ui-dns.org,0,0.00%,2,2,0.00%
ns-1246.awsdns-27.org,0,0.00%,3,3,0.00%
ns1.iwantmyname.net,0,0.00%,6,6,0.00%
ns1.ozkula.com.tr,0,0.00%,2,2,0.00%
ns-1975.awsdns-54.co.uk,0,0.00%,2,2,0.00%
kareem.ns.cloudflare.com,0,0.00%,22,22,0.00%
ns2.ozkula.com.tr,0,0.00%,2,2,0.00%
shades08.rzone.de,0,0.00%,4,4,0.00%
ns-309.awsdns-38.com,0,0.00%,2,2,0.00%
nsa.n0c.com,0,0.00%,2,2,0.00%
ns2.zolahost.net,0,0.00%,2,2,0.00%
ns1070.ui-dns.com,0,0.00%,2,2,0.00%
ns2.iwantmyname.net,0,0.00%,6,6,0.00%
ns1.sswebplus.net,0,0.00%,2,2,0.00%
olivia.ns.cloudflare.com,0,0.00%,2,2,0.00%
dora.ns.cloudflare.com,0,0.00%,6,6,0.00%
ns-rs2.gmoserver.jp,0,0.00%,12,12,0.00%
ns4.iwantmyname.net,0,0.00%,6,6,0.00%
ns2.sswebplus.net,0,0.00%,2,2,0.00%
sofia.ns.cloudflare.com,0,0.00%,10,10,0.00%
ns8.webline-dns.com,0,0.00%,2,2,0.00%
aiden.ns.cloudflare.com,0,0.00%,6,6,0.00%
nsc.n0c.com,0,0.00%,2,2,0.00%
ns1.contabo.net,0,0.00%,6,6,0.00%
keira.ns.cloudflare.com,0,0.00%,2,2,0.00%
bradley.ns.cloudflare.com,0,0.00%,12,12,0.00%
carlane.ns.cloudflare.com,0,0.00%,2,2,0.00%
ns6.veridyen.com,0,0.00%,2,2,0.00%
ns7.webline-dns.com,0,0.00%,2,2,0.00%
abns1.dnsredirect.in,0,0.00%,2,2,0.00%
cory.ns.cloudflare.com,0,0.00%,2,2,0.00%
ns66.d9hosting.com,0,0.00%,18,18,0.00%
alexis.ns.cloudflare.com,0,0.00%,4,4,0.00%
ns1hwy.name.com,0,0.00%,4,4,0.00%
dns2.home.pl,0,0.00%,7,7,0.00%
major.ns.cloudflare.com,0,0.00%,8,8,0.00%
ns1.onlydomains.com,0,0.00%,6,6,0.00%
ns1.dnsredirect.in,0,0.00%,2,2,0.00%
boxing.dnspod.net,0,0.00%,2,2,0.00%
shades01.rzone.de,0,0.00%,6,6,0.00%
ns1.bluehost.in,0,0.00%,13,13,0.00%
belle.dnspod.net,0,0.00%,2,2,0.00%
ns1071.ui-dns.de,0,0.00%,2,2,0.00%
ns28.netafrooz.com,0,0.00%,4,4,0.00%
ns1055.ui-dns.com,0,0.00%,2,2,0.00%
docks12.rzone.de,0,0.00%,2,2,0.00%
ns2.myclientserver.com,0,0.00%,2,2,0.00%
pdns01.domaincontrol.com,0,0.00%,6,6,0.00%
sns39.hostgator.in,0,0.00%,2,2,0.00%
docks09.rzone.de,0,0.00%,6,6,0.00%
dns2.rumahosting.com,0,0.00%,4,4,0.00%
ns40.domaincontrol.com,0,0.00%,6,6,0.00%
mona.ns.cloudflare.com,0,0.00%,7,7,0.00%
cns13.hostgator.com,0,0.00%,2,2,0.00%
ed.ns.cloudflare.com,0,0.00%,10,10,0.00%
pdns02.domaincontrol.com,0,0.00%,6,6,0.00%
ns1.myclientserver.com,0,0.00%,2,2,0.00%
keyla.ns.cloudflare.com,0,0.00%,12,12,0.00%
ns3.site4now.net,0,0.00%,4,4,0.00%
ns-1366.awsdns-42.org,0,0.00%,2,2,0.00%
suspension1.mydomainprovider.com,0,0.00%,18,18,0.00%
ns2.site4now.net,0,0.00%,3,3,0.00%
shades15.rzone.de,0,0.00%,2,2,0.00%
ns3.hostley.io,0,0.00%,4,4,0.00%
dns11.firestorm.ch,0,0.00%,2,2,0.00%
ns1lmy.name.com,0,0.00%,4,4,0.00%
ns2.wpx.net,0,0.00%,4,4,0.00%
ns4.hostley.io,0,0.00%,3,3,0.00%
carol.ns.cloudflare.com,0,0.00%,2,2,0.00%
m.ns.arvancdn.com,0,0.00%,4,4,0.00%
ns-846.awsdns-41.net,0,0.00%,2,2,0.00%
saanvi.ns.cloudflare.com,0,0.00%,18,18,0.00%
snail.dnspod.net,0,0.00%,2,2,0.00%
docks16.rzone.de,0,0.00%,6,6,0.00%
gabe.ns.cloudflare.com,0,0.00%,2,2,0.00%
huxley.ns.cloudflare.com,0,0.00%,14,14,0.00%
ns1030.ui-dns.org,0,0.00%,2,2,0.00%
diana.ns.cloudflare.com,0,0.00%,4,4,0.00%
brandon.dnspod.net,0,0.00%,2,2,0.00%
ns1109.ui-dns.biz,0,0.00%,2,2,0.00%
ns-1531.awsdns-63.org,0,0.00%,4,4,0.00%
string.dnspod.net,0,0.00%,2,2,0.00%
sunny.ns.cloudflare.com,0,0.00%,2,2,0.00%
delilah.ns.cloudflare.com,0,0.00%,8,8,0.00%
ns2.nacault1.armadaservers.com,0,0.00%,2,2,0.00%
ns2.onlydomains.com,0,0.00%,6,6,0.00%
dodecagon.dnspod.net,0,0.00%,2,2,0.00%
a1-156.akam.net,0,0.00%,2,2,0.00%
ns1-477.axc.nl,0,0.00%,2,2,0.00%
ns1.nacault1.armadaservers.com,0,0.00%,2,2,0.00%
ns1.xeonbd.com,0,0.00%,2,2,0.00%
ns3.onlydomains.com,0,0.00%,6,6,0.00%
ns-285.awsdns-35.com,0,0.00%,4,4,0.00%
ns2.xeonbd.com,0,0.00%,2,2,0.00%
ns1099.ui-dns.com,0,0.00%,2,2,0.00%
simone.ns.cloudflare.com,0,0.00%,4,4,0.00%
fay.ns.cloudflare.com,0,0.00%,2,2,0.00%
sasha.ns.cloudflare.com,0,0.00%,4,4,0.00%
ns2btz.name.com,0,0.00%,8,8,0.00%
blocked1.nic.ru,0,0.00%,2,2,0.00%
ns3.hostmar.com,0,0.00%,6,6,0.00%
ns3dgj.name.com,0,0.00%,4,4,0.00%
rob.ns.cloudflare.com,0,0.00%,6,6,0.00%
ns2.md-in-71.hostgatorwebservers.com,0,0.00%,2,2,0.00%
ns32.hostgator.com.br,0,0.00%,2,2,0.00%
emily.ns.cloudflare.com,0,0.00%,2,2,0.00%
thin.dnspod.net,0,0.00%,2,2,0.00%
ns.planet-ic.de,0,0.00%,2,2,0.00%
ns4hny.name.com,0,0.00%,2,2,0.00%
ns1.md-in-71.hostgatorwebservers.com,0,0.00%,2,2,0.00%
randall.ns.cloudflare.com,0,0.00%,8,8,0.00%
ns1.prezent.nl,0,0.00%,2,2,0.00%
doma634347.earth.orderbox-dns.com,0,0.00%,4,4,0.00%
nsn1.mijndomein.nl,0,0.00%,15,15,0.00%
ns4.sitebizden.com,0,0.00%,4,4,0.00%
ns2.idwebhost.com,0,0.00%,6,6,0.00%
ns1.zenbox.pl,0,0.00%,2,2,0.00%
kia.ns.cloudflare.com,0,0.00%,8,8,0.00%
thcservers.venus.orderbox-dns.com,0,0.00%,2,2,0.00%
sistemaelab.com,0,0.00%,2,2,0.00%
lillian.dnspod.net,0,0.00%,2,2,0.00%
ns.secundairedns.nl,0,0.00%,4,4,0.00%
blocked2.nic.ru,0,0.00%,2,2,0.00%
ns4.hostmar.com,0,0.00%,6,6,0.00%
thcservers.mars.orderbox-dns.com,0,0.00%,2,2,0.00%
thcservers.earth.orderbox-dns.com,0,0.00%,2,2,0.00%
ns.p4.net,0,0.00%,2,2,0.00%
ns2.whois.com,0,0.00%,4,4,0.00%
ns8220.hostgator.com,0,0.00%,2,2,0.00%
thcservers.mercury.orderbox-dns.com,0,0.00%,2,2,0.00%
ns4.whois.com,0,0.00%,4,4,0.00%
augustus.ns.cloudflare.com,0,0.00%,2,2,0.00%
ns-1587.awsdns-06.co.uk,0,0.00%,2,2,0.00%
ns8219.hostgator.com,0,0.00%,2,2,0.00%
ns30321.newipdns.com,0,0.00%,1,1,0.00%
ns3.whois.com,0,0.00%,3,3,0.00%
ns2.zenbox.pl,0,0.00%,2,2,0.00%
ns3.sitebizden.com,0,0.00%,4,4,0.00%
ns6440.hostgator.com,0,0.00%,2,2,0.00%
ns30322.newipdns.com,0,0.00%,1,1,0.00%
ns1.whois.com,0,0.00%,6,6,0.00%
bison.ezoicns.com,0,0.00%,4,4,0.00%
ns7.arad360.com,0,0.00%,2,2,0.00%
llama.ezoicns.com,0,0.00%,4,4,0.00%
ns-1780.awsdns-30.co.uk,0,0.00%,2,2,0.00%
dns099.a.register.com,0,0.00%,4,4,0.00%
philofwine.com,0,0.00%,2,2,0.00%
dns1.3produccion.com,0,0.00%,2,2,0.00%
dns1.sitezoogle.com,0,0.00%,6,6,0.00%
ns2.vodien.com,0,0.00%,2,2,0.00%
cdns1.interserver.net,0,0.00%,2,2,0.00%
ns1.kei.pl,0,0.00%,2,2,0.00%
ns1075.ui-dns.biz,0,0.00%,4,4,0.00%
ns41.sbc-dns.com,0,0.00%,2,2,0.00%
poetictweets.com,0,0.00%,2,2,0.00%
ns2.podkryshey.com,0,0.00%,2,2,0.00%
ns2.servidordosangolanos.com,0,0.00%,2,2,0.00%
ns4911.banahosting.com,0,0.00%,2,2,0.00%
orca.instantdomains.com,0,0.00%,4,4,0.00%
ns5.be,0,0.00%,2,2,0.00%
dns2.sitezoogle.com,0,0.00%,10,10,0.00%
ns3.ps.kz,0,0.00%,2,2,0.00%
petrosolcrm.com,0,0.00%,2,2,0.00%
coho.instantdomains.com,0,0.00%,6,6,0.00%
eu.atakdomain.com,0,0.00%,2,2,0.00%
eu.guzelhosting.com,0,0.00%,4,4,0.00%
ns2.domainit.com,0,0.00%,2,2,0.00%
ns2.atthost.pl,0,0.00%,2,2,0.00%
ns1089.ui-dns.com,0,0.00%,2,2,0.00%
dns2.3produccion.com,0,0.00%,2,2,0.00%
tr.atakdomain.com,0,0.00%,2,2,0.00%
jill.ns.cloudflare.com,0,0.00%,8,8,0.00%
gordon.ns.cloudflare.com,0,0.00%,2,2,0.00%
anastasia.ns.cloudflare.com,0,0.00%,4,4,0.00%
ns4.host-age.ro,0,0.00%,2,2,0.00%
ns1.domainit.com,0,0.00%,2,2,0.00%
ns1.3ghdes.com,0,0.00%,2,2,0.00%
serenity.ns.cloudflare.com,0,0.00%,2,2,0.00%
lamar.ns.cloudflare.com,0,0.00%,6,6,0.00%
ns1.host-age.ro,0,0.00%,2,2,0.00%
ns-148.awsdns-18.com,0,0.00%,2,2,0.00%
ns1.camoogroup.com,0,0.00%,2,2,0.00%
ns-1470.awsdns-55.org,0,0.00%,3,3,0.00%
ns-1506.awsdns-60.org,0,0.00%,3,3,0.00%
ns1.podogrevmatrasa.com,0,0.00%,2,2,0.00%
leia.ns.cloudflare.com,0,0.00%,16,16,0.00%
ns4217.hostgator.com,0,0.00%,2,2,0.00%
ns-2037.awsdns-62.co.uk,0,0.00%,4,4,0.00%
ns2.hostmonster.com,0,0.00%,4,4,0.00%
ns1.jimdo.com,0,0.00%,2,2,0.00%
ns-1566.awsdns-03.co.uk,0,0.00%,2,2,0.00%
ns3.jogjahost.co.id,0,0.00%,2,2,0.00%
ns1.pokonfetke.com,0,0.00%,2,2,0.00%
ns1093.ui-dns.org,0,0.00%,6,6,0.00%
ns4218.hostgator.com,0,0.00%,2,2,0.00%
ns1.ascendits.net,0,0.00%,2,2,0.00%
cesar.ns.cloudflare.com,0,0.00%,2,2,0.00%
darek.ns.jdm.pl,0,0.00%,2,2,0.00%
ns1kwy.name.com,0,0.00%,2,2,0.00%
ns-523.awsdns-01.net,0,0.00%,2,2,0.00%
matteo.ns.cloudflare.com,0,0.00%,6,6,0.00%
ns2.3ghdes.com,0,0.00%,2,2,0.00%
ns-975.awsdns-57.net,0,0.00%,5,5,0.00%
ns1122.ui-dns.biz,0,0.00%,6,6,0.00%
leland.ns.cloudflare.com,0,0.00%,4,4,0.00%
ns-252.awsdns-31.com,0,0.00%,2,2,0.00%
ns-89.awsdns-11.com,0,0.00%,2,2,0.00%
ns151.resellerone.host,0,0.00%,2,2,0.00%
sevki.ns.cloudflare.com,0,0.00%,8,8,0.00%
ns1.jsbr.net.br,0,0.00%,2,2,0.00%
tosana.ns.cloudflare.com,0,0.00%,4,4,0.00%
ns-170-c.gandi.net,0,0.00%,2,2,0.00%
ns1.serversks.com,0,0.00%,2,2,0.00%
nelly.ns.cloudflare.com,0,0.00%,6,6,0.00%
ns3.webglobe.com,0,0.00%,2,2,0.00%
lisa.neostrada.nl,0,0.00%,4,4,0.00%
ns-1430.awsdns-50.org,0,0.00%,2,2,0.00%
ns2.pokonfetke.com,0,0.00%,2,2,0.00%
ns-1288.awsdns-33.org,0,0.00%,2,2,0.00%
ns152.resellerone.host,0,0.00%,2,2,0.00%
cloud1.triara.com,0,0.00%,2,2,0.00%
ns1.itopplus.com,0,0.00%,2,2,0.00%
plpchemicals.com,0,0.00%,2,2,0.00%
d2.hutara.com,0,0.00%,2,2,0.00%
ns-1704.awsdns-21.co.uk,0,0.00%,2,2,0.00%
ns-1945.awsdns-51.co.uk,0,0.00%,2,2,0.00%
ns3npv.name.com,0,0.00%,2,2,0.00%
polyams.com,0,0.00%,2,2,0.00%
ns2.serversks.com,0,0.00%,2,2,0.00%
ns-207-a.gandi.net,0,0.00%,2,2,0.00%
cloud2.triara.com,0,0.00%,2,2,0.00%
ns-364.awsdns-45.com,0,0.00%,2,2,0.00%
ns4ksy.name.com,0,0.00%,4,4,0.00%
lia.ns.cloudflare.com,0,0.00%,5,5,0.00%
christina.neostrada.nl,0,0.00%,4,4,0.00%
ns-958.awsdns-55.net,0,0.00%,2,2,0.00%
ns-1188.awsdns-20.org,0,0.00%,2,2,0.00%
ethan.ns.cloudflare.com,0,0.00%,2,2,0.00%
ns2.fatcow.com,0,0.00%,2,2,0.00%
cs83.hostingberry.com,0,0.00%,2,2,0.00%
ns1.fatcow.com,0,0.00%,2,2,0.00%
ns2.md-in-59.webhostbox.net,0,0.00%,2,2,0.00%
cloud3.triara.com,0,0.00%,2,2,0.00%
anna.ns.cloudflare.com,0,0.00%,6,6,0.00%
patryk.ns.cloudflare.com,0,0.00%,4,4,0.00%
ns1.brandbucket.com,0,0.00%,4,4,0.00%
ns2.brandbucket.com,0,0.00%,4,4,0.00%
thomas.ns.cloudflare.com,0,0.00%,4,4,0.00%
cs83.hostneverdie.com,0,0.00%,2,2,0.00%
ns-916.awsdns-50.net,0,0.00%,2,2,0.00%
ns2.jsbr.net.br,0,0.00%,2,2,0.00%
ns2.webglobe.cz,0,0.00%,2,2,0.00%
ns1.bh-43.webhostbox.net,0,0.00%,2,2,0.00%
ns2.bh-43.webhostbox.net,0,0.00%,2,2,0.00%
samara.ns.cloudflare.com,0,0.00%,4,4,0.00%
ns1.hyp.net,0,0.00%,6,6,0.00%
aaron.ns.cloudflare.com,0,0.00%,2,2,0.00%
harmony.ns.cloudflare.com,0,0.00%,4,4,0.00%
dawn.ns.cloudflare.com,0,0.00%,2,2,0.00%
ns2.hyp.net,0,0.00%,7,7,0.00%
sandra.neostrada.nl,0,0.00%,4,4,0.00%
ns1.judes-wellbeing-health.com,0,0.00%,2,2,0.00%
ns-203-c.gandi.net,0,0.00%,2,2,0.00%
frederica.dnspod.net,0,0.00%,2,2,0.00%
ns-21-b.gandi.net,0,0.00%,2,2,0.00%
bongo.ezoicns.com,0,0.00%,2,2,0.00%
paniwtrampkach.com,0,0.00%,2,2,0.00%
ns1.dnsimple.com,0,0.00%,18,18,0.00%
clint.ns.cloudflare.com,0,0.00%,8,8,0.00%
ns1.audiostreamvolt.com,0,0.00%,2,2,0.00%
dns10.ovh.ca,0,0.00%,3,3,0.00%
crab.ezoicns.com,0,0.00%,2,2,0.00%
dion.ns.cloudflare.com,0,0.00%,2,2,0.00%
ns1.seliton.com,0,0.00%,2,2,0.00%
ns2.cloud.telenet.be,0,0.00%,2,2,0.00%
ns1.gocheapweb.com,0,0.00%,4,4,0.00%
dns1.zyro.com,0,0.00%,11,11,0.00%
kianchau.ns.cloudflare.com,0,0.00%,2,2,0.00%
ns2.seliton.com,0,0.00%,2,2,0.00%
ns2.velocitydatacenter3.biz,0,0.00%,2,2,0.00%
dave.ns.cloudflare.com,0,0.00%,6,6,0.00%
shaz.ns.cloudflare.com,0,0.00%,2,2,0.00%
alfred.ns.cloudflare.com,0,0.00%,2,2,0.00%
ns2.webmo.fr,0,0.00%,2,2,0.00%
mrddns002.misterdomain.eu,0,0.00%,2,2,0.00%
ns2lns.name.com,0,0.00%,2,2,0.00%
ns3.webnames.ca,0,0.00%,6,6,0.00%
vip4.alidns.com,0,0.00%,4,4,0.00%
ns148.umbler.in,0,0.00%,6,6,0.00%
ns2.webnames.ca,0,0.00%,5,5,0.00%
docks11.rzone.de,0,0.00%,2,2,0.00%
mrddns001.misterdomain.eu,0,0.00%,2,2,0.00%
ac12.com,0,0.00%,10,10,0.00%
ns30.dnshubpro.com,0,0.00%,4,4,0.00%
dns2.serverfreak.biz,0,0.00%,4,4,0.00%
personaliteagenciadigital.com,0,0.00%,2,2,0.00%
ns-1197.awsdns-21.org,0,0.00%,2,2,0.00%
cody.ns.cloudflare.com,0,0.00%,6,6,0.00%
colin.ns.cloudflare.com,0,0.00%,4,4,0.00%
ns1017.ui-dns.de,0,0.00%,2,2,0.00%
ns-1616.awsdns-10.co.uk,0,0.00%,2,2,0.00%
ns1.domenai.lt,0,0.00%,2,2,0.00%
ns1019.ui-dns.org,0,0.00%,7,7,0.00%
shades14.rzone.de,0,0.00%,6,6,0.00%
ns-766.awsdns-31.net,0,0.00%,2,2,0.00%
mrddns004.misterdomain.eu,0,0.00%,2,2,0.00%
dns3.host-redirect.com,0,0.00%,2,2,0.00%
mrddns003.misterdomain.eu,0,0.00%,2,2,0.00%
amit.ns.cloudflare.com,0,0.00%,6,6,0.00%
ns1.krystal.uk,0,0.00%,2,2,0.00%
noor.ns.cloudflare.com,0,0.00%,9,9,0.00%
dns1.serverfreak.biz,0,0.00%,4,4,0.00%
monroe.ns.cloudflare.com,0,0.00%,2,2,0.00%
docks06.rzone.de,0,0.00%,7,7,0.00%
ns3.domenai.lt,0,0.00%,2,2,0.00%
dns2.wfolio.ru,0,0.00%,6,6,0.00%
ns1042.ui-dns.biz,0,0.00%,2,2,0.00%
dns1.wfolio.ru,0,0.00%,6,6,0.00%
ns2.krystal.uk,0,0.00%,2,2,0.00%
ns3.locaweb.com.br,0,0.00%,2,2,0.00%
dns2.host-redirect.com,0,0.00%,2,2,0.00%
ns1.locaweb.com.br,0,0.00%,4,4,0.00%
pretzels.dnspod.net,0,0.00%,4,4,0.00%
ns2.matbao.com,0,0.00%,11,11,0.00%
ns1.md-in-59.webhostbox.net,0,0.00%,2,2,0.00%
dns4.host-redirect.com,0,0.00%,2,2,0.00%
joan.dnspod.net,0,0.00%,4,4,0.00%
ns2.domenai.lt,0,0.00%,2,2,0.00%
ns1097.ui-dns.com,0,0.00%,3,3,0.00%
dns2.wfolio.com,0,0.00%,6,6,0.00%
ns1032.ui-dns.de,0,0.00%,2,2,0.00%
piratetweets.com,0,0.00%,2,2,0.00%
ns1067.ui-dns.org,0,0.00%,3,3,0.00%
ns-1030.awsdns-00.org,0,0.00%,2,2,0.00%
ns-1969.awsdns-54.co.uk,0,0.00%,4,4,0.00%
ns-204.awsdns-25.com,0,0.00%,6,6,0.00%
ns1.dataplugs.com,0,0.00%,2,2,0.00%
ns-780.awsdns-33.net,0,0.00%,2,2,0.00%
tr.guzelhosting.com,0,0.00%,4,4,0.00%
eoin.ns.cloudflare.com,0,0.00%,4,4,0.00%
dns2.ninjahosting.pe,0,0.00%,2,2,0.00%
pixsomar.com,0,0.00%,1,1,0.00%
dns1.ninjahosting.pe,0,0.00%,2,2,0.00%
ns1.bizmaserver.com,0,0.00%,2,2,0.00%
ns-1414.awsdns-48.org,0,0.00%,2,2,0.00%
ns-1075.awsdns-06.org,0,0.00%,2,2,0.00%
ns1bcp.name.com,0,0.00%,2,2,0.00%
ns-1783.awsdns-30.co.uk,0,0.00%,2,2,0.00%
ns1.jp2.fcomet.com,0,0.00%,2,2,0.00%
marvin.ns.cloudflare.com,0,0.00%,2,2,0.00%
docks19.rzone.de,0,0.00%,6,6,0.00%
ns3fgq.name.com,0,0.00%,4,4,0.00%
nsbak.pavietnam.net,0,0.00%,6,6,0.00%
konnor.ns.cloudflare.com,0,0.00%,18,18,0.00%
greg.ns.cloudflare.com,0,0.00%,30,30,0.00%
meera.ns.cloudflare.com,0,0.00%,4,4,0.00%
jamie.ns.cloudflare.com,0,0.00%,2,2,0.00%
ns4htz.name.com,0,0.00%,9,9,0.00%
ns1.dotvndns.vn,0,0.00%,4,4,0.00%
addilyn.ns.cloudflare.com,0,0.00%,6,6,0.00%
ns1.pavietnam.vn,0,0.00%,8,8,0.00%
ns1052.ui-dns.biz,0,0.00%,4,4,0.00%
ns2.hoststar.hosting,0,0.00%,2,2,0.00%
ns1.adk-media.com,0,0.00%,2,2,0.00%
ns3.dotvndns.vn,0,0.00%,4,4,0.00%
trey.ns.cloudflare.com,0,0.00%,4,4,0.00%
ns1.namefind.com,0,0.00%,4,4,0.00%
ns2.dotvndns.vn,0,0.00%,4,4,0.00%
ns1095.ui-dns.org,0,0.00%,6,6,0.00%
ns2.namefind.com,0,0.00%,4,4,0.00%
ns1111.ui-dns.com,0,0.00%,6,6,0.00%
ns4.zonedns.vn,0,0.00%,10,10,0.00%
ns2.pavietnam.vn,0,0.00%,4,4,0.00%
nsbak.dotvndns.com,0,0.00%,2,2,0.00%
ns2.adk-media.com,0,0.00%,2,2,0.00%
ns.nastaro.com,0,0.00%,2,2,0.00%
pharmastudyinfo.com,0,0.00%,2,2,0.00%
ns1083.ui-dns.de,0,0.00%,4,4,0.00%
ns2.zonedns.vn,0,0.00%,10,10,0.00%
ns5.gransy.com,0,0.00%,2,2,0.00%
philuxglobalenergy.com,0,0.00%,2,2,0.00%
cp1.aktasweb.com,0,0.00%,2,2,0.00%
philuxglobalvn.com,0,0.00%,2,2,0.00%
ns2.pergeguvenlik.com,0,0.00%,2,2,0.00%
ns3.gransy.com,0,0.00%,2,2,0.00%
ns1.zonedns.vn,0,0.00%,10,10,0.00%
ns-344.awsdns-43.com,0,0.00%,2,2,0.00%
ns3.webhostingireland.ie,0,0.00%,3,3,0.00%
ns1.aznet.vn,0,0.00%,2,2,0.00%
ns.datacenter.no,0,0.00%,4,4,0.00%
ns1-06.azure-dns.com,0,0.00%,10,10,0.00%
agustin.ns.cloudflare.com,0,0.00%,2,2,0.00%
ns1087.ui-dns.biz,0,0.00%,6,6,0.00%
ns-926.awsdns-51.net,0,0.00%,2,2,0.00%
ns3.zonedns.vn,0,0.00%,10,10,0.00%
nsbak.aznet.vn,0,0.00%,2,2,0.00%
ns4.gransy.com,0,0.00%,2,2,0.00%
lloyd.ns.cloudflare.com,0,0.00%,2,2,0.00%
server.nastaro.com,0,0.00%,2,2,0.00%
ns2.iukanet.com,0,0.00%,2,2,0.00%
ns1.hoststar.hosting,0,0.00%,2,2,0.00%
veronica.ns.cloudflare.com,0,0.00%,2,2,0.00%
irns1.netafraz.com,0,0.00%,6,6,0.00%
ns3-06.azure-dns.org,0,0.00%,2,2,0.00%
ns1081.ui-dns.com,0,0.00%,4,4,0.00%
ns2.gransy.com,0,0.00%,2,2,0.00%
ns1.netfirms.com,0,0.00%,8,8,0.00%
ns1.pergeguvenlik.com,0,0.00%,2,2,0.00%
ns2.aznet.vn,0,0.00%,2,2,0.00%
philuxfidelity.com,0,0.00%,2,2,0.00%
ns4-06.azure-dns.info,0,0.00%,2,2,0.00%
ns3.parspack.co,0,0.00%,4,4,0.00%
nsbr1.servidores.srv.br,0,0.00%,2,2,0.00%
ns1-248-75.pantiphost.com,0,0.00%,2,2,0.00%
ns2.netfirms.com,0,0.00%,7,7,0.00%
ns3.mycreditrepairsite.com,0,0.00%,4,4,0.00%
ns-1553.awsdns-02.co.uk,0,0.00%,4,4,0.00%
ns2-248-75.pantiphost.com,0,0.00%,2,2,0.00%
ns2.parspack.co,0,0.00%,4,4,0.00%
ns-382.awsdns-47.com,0,0.00%,2,2,0.00%
ns-cloud-v1.hostify.vn,0,0.00%,2,2,0.00%
ns4.mycreditrepairsite.com,0,0.00%,4,4,0.00%
ns114.inhostedns.com,0,0.00%,2,2,0.00%
ns1.tasvirweb.com,0,0.00%,2,2,0.00%
ns-700.awsdns-23.net,0,0.00%,2,2,0.00%
dns062.a.register.com,0,0.00%,2,2,0.00%
nsbr2.servidores.srv.br,0,0.00%,2,2,0.00%
ns3flt.name.com,0,0.00%,2,2,0.00%
ns0.phase8.net,0,0.00%,6,6,0.00%
ns1114.ui-dns.biz,0,0.00%,8,8,0.00%
ns5261.webempresa.eu,0,0.00%,2,2,0.00%
phronic.com,0,0.00%,2,2,0.00%
ns37.domaincontrol.com,0,0.00%,2,2,0.00%
cns448.hostgator.com,0,0.00%,4,4,0.00%
ns1.stablehost.com,0,0.00%,4,4,0.00%
ns4.parspack.co,0,0.00%,4,4,0.00%
ns4kmw.name.com,0,0.00%,4,4,0.00%
ns-47-a.gandi.net,0,0.00%,2,2,0.00%
ns1098.ui-dns.com,0,0.00%,8,8,0.00%
pidmanagementportal.com,0,0.00%,2,2,0.00%
cns447.hostgator.com,0,0.00%,4,4,0.00%
ns38.domaincontrol.com,0,0.00%,2,2,0.00%
tessa.ns.cloudflare.com,0,0.00%,18,18,0.00%
ns2.dataplugs.com,0,0.00%,2,2,0.00%
ns214.inhostedns.net,0,0.00%,2,2,0.00%
ns2.stablehost.com,0,0.00%,2,2,0.00%
alina.ns.cloudflare.com,0,0.00%,10,10,0.00%
ns2.nina.vn,0,0.00%,2,2,0.00%
ns1.parspack.co,0,0.00%,4,4,0.00%
ns1103.ui-dns.de,0,0.00%,10,10,0.00%
ns2.tasvirweb.com,0,0.00%,2,2,0.00%
ns3.dataplugs.com,0,0.00%,2,2,0.00%
ns3.cloud.telenet.be,0,0.00%,2,2,0.00%
ns1.nina.vn,0,0.00%,2,2,0.00%
harlan.ns.cloudflare.com,0,0.00%,2,2,0.00%
ns40.sbc-dns.com,0,0.00%,2,2,0.00%
arushi.ns.cloudflare.com,0,0.00%,2,2,0.00%
ns-196-c.gandi.net,0,0.00%,2,2,0.00%
es-cn-0pp1l8f1v001204h1.public.elasticsearch.aliyuncs.com,0,0.00%,63,63,0.00%
ns314.inhostedns.org,0,0.00%,2,2,0.00%
ns1036.ui-dns.de,0,0.00%,4,4,0.00%
kobe.ns.cloudflare.com,0,0.00%,2,2,0.00%
ns840.umbler.co.uk,0,0.00%,4,4,0.00%
ns-1493.awsdns-58.org,0,0.00%,2,2,0.00%
ns5.speedyconnect.net,0,0.00%,2,2,0.00%
ns6.l4dns.com,0,0.00%,6,6,0.00%
ns1053.ui-dns.com,0,0.00%,4,4,0.00%
shopbase.earth.orderbox-dns.com,0,0.00%,6,6,0.00%
dns031.a.register.com,0,0.00%,2,2,0.00%
ns1041.ui-dns.de,0,0.00%,4,4,0.00%
ns-1851.awsdns-39.co.uk,0,0.00%,2,2,0.00%
shopbase.venus.orderbox-dns.com,0,0.00%,6,6,0.00%
ns-53.awsdns-06.com,0,0.00%,2,2,0.00%
id2.fastns.my.id,0,0.00%,2,2,0.00%
ns6321.hostgator.com,0,0.00%,2,2,0.00%
ns-858.awsdns-43.net,0,0.00%,2,2,0.00%
shopbase.mercury.orderbox-dns.com,0,0.00%,5,5,0.00%
ns92.cloudracked.com,0,0.00%,2,2,0.00%
ns1040.ui-dns.de,0,0.00%,6,6,0.00%
id1.fastns.my.id,0,0.00%,2,2,0.00%
ns134.mschosting.com,0,0.00%,2,2,0.00%
ns6322.hostgator.com,0,0.00%,2,2,0.00%
shopbase.mars.orderbox-dns.com,0,0.00%,5,5,0.00%
camel.ezoicns.com,0,0.00%,2,2,0.00%
laura.dnspod.net,0,0.00%,2,2,0.00%
ns297.websitewelcome.com,0,0.00%,1,1,0.00%
ns1.c017jp1193.info,0,0.00%,1,1,0.00%
ns4.domainnamedns.com,0,0.00%,11,11,0.00%
ns14.cloudns.net,0,0.00%,1,1,0.00%
pns14.cloudns.net,0,0.00%,1,1,0.00%
ns3.domainnamedns.com,0,0.00%,22,22,0.00%
ns2.c017jp1193.info,0,0.00%,2,2,0.00%
ns1.domainnamedns.com,0,0.00%,21,21,0.00%
ns2.domainnamedns.com,0,0.00%,23,23,0.00%
SEVKI.NS.CLOUDFLARE.com,0,0.00%,1,1,0.00%
webquoteklinepic.eastmoney.com,0,0.00%,8,8,0.00%
ns2.hans.hosteurope.de,0,0.00%,2,2,0.00%
ee15ba61-wschat-wschatalb-6fcf-2062696737.us-east-1.elb.amazonaws.com,0,0.00%,2,2,0.00%
ns01.squarespacedns.com,0,0.00%,3,3,0.00%
ns02.squarespacedns.com,0,0.00%,4,4,0.00%
ns03.squarespacedns.com,0,0.00%,2,2,0.00%
ns04.squarespacedns.com,0,0.00%,4,4,0.00%
lvps83-169-20-52.dedicated.hosteurope.de,0,0.00%,1,1,0.00%
park.jinmi.com,0,0.00%,3,3,0.00%
verification-px3cplpa.ns3.dan.hosting,0,0.00%,2,2,0.00%
tools.l.google.com,0,0.00%,4,4,0.00%
brad.ns.cloudflare.com,0,0.00%,12,12,0.00%
mia.ns.cloudflare.com,0,0.00%,12,12,0.00%
dns1.bigrock.in,0,0.00%,1,1,0.00%
pearl.ns.cloudflare.com,0,0.00%,6,6,0.00%
ns5.here.ro,0,0.00%,2,2,0.00%
maxspeed141.rayanegarco.com,0,0.00%,1,1,0.00%
ns02.cashparking.com,0,0.00%,10,10,0.00%
gwen.ns.cloudflare.com,0,0.00%,4,4,0.00%
ns3.cypack.com,0,0.00%,2,2,0.00%
ns298.websitewelcome.com,0,0.00%,1,1,0.00%
ns4.cypack.com,0,0.00%,2,2,0.00%
sureandcure.com,0,0.00%,1,1,0.00%
voyager.cline.it,0,0.00%,1,1,0.00%
APAC03.azure-devices.net,0,0.00%,1,1,0.00%
ns2.ubuildshop.com,0,0.00%,1,1,0.00%
dom.ns.cloudflare.com,0,0.00%,5,5,0.00%
youpto.com,0,0.00%,1,1,0.00%
joselyn.ns.cloudflare.com,0,0.00%,2,2,0.00%
ns1.ubuildshop.com,0,0.00%,1,1,0.00%
sfaj56.com,0,0.00%,1,1,0.00%
sdzkhy.com,0,0.00%,1,1,0.00%
ns101.mschosting.com,0,0.00%,1,1,0.00%
dee.ns.cloudflare.com,0,0.00%,4,4,0.00%
ns102.mschosting.com,0,0.00%,1,1,0.00%
kyree.ns.cloudflare.com,0,0.00%,1,1,0.00%
ns1.loopia.se,0,0.00%,122,122,0.00%
daytoutiao.com,0,0.00%,1,1,0.00%
dns1.xpress.com.mx,0,0.00%,2,2,0.00%
ns1100.ui-dns.org,0,0.00%,2,2,0.00%
ns2.justhost.com,0,0.00%,4,4,0.00%
dns2.xpress.com.mx,0,0.00%,2,2,0.00%
ns1.justhost.com,0,0.00%,3,3,0.00%
ns2.ibspark.com,0,0.00%,2,2,0.00%
love.ns.cloudflare.com,0,0.00%,2,2,0.00%
ns1.ibspark.com,0,0.00%,2,2,0.00%
ns1062.ui-dns.de,0,0.00%,1,1,0.00%
ns1070.ui-dns.org,0,0.00%,2,2,0.00%
ns1021.ui-dns.com,0,0.00%,1,1,0.00%
ns6816.hostgator.com,0,0.00%,1,1,0.00%
ns1.akkyservicios.mx,0,0.00%,2,2,0.00%
ns1112.ui-dns.com,0,0.00%,5,5,0.00%
ns1.webhosted.nl,0,0.00%,2,2,0.00%
yisroel.ns.cloudflare.com,0,0.00%,5,5,0.00%
hattie.ns.cloudflare.com,0,0.00%,1,1,0.00%
wmcec.com,0,0.00%,2,2,0.00%
otto.ns.cloudflare.com,0,0.00%,2,2,0.00%
ns3.akkyservicios.mx,0,0.00%,2,2,0.00%
dns3.netsons.net,0,0.00%,2,2,0.00%
dns4.bigrock.in,0,0.00%,1,1,0.00%
ns2.webhosted.net,0,0.00%,1,1,0.00%
ns1101.ui-dns.biz,0,0.00%,1,1,0.00%
teagan.ns.cloudflare.com,0,0.00%,2,2,0.00%
ns560.websitewelcome.com,0,0.00%,1,1,0.00%
dns3.bigrock.in,0,0.00%,2,2,0.00%
ns559.websitewelcome.com,0,0.00%,1,1,0.00%
viddy.ns.cloudflare.com,0,0.00%,10,10,0.00%
dns2.bigrock.in,0,0.00%,1,1,0.00%
dns4.netsons.net,0,0.00%,1,1,0.00%
ns4.hostinger.com.br,0,0.00%,2,2,0.00%
ns1065.ui-dns.de,0,0.00%,2,2,0.00%
ns1.messagingengine.com,0,0.00%,4,4,0.00%
ns2.akkyservicios.mx,0,0.00%,2,2,0.00%
ns1034.ui-dns.org,0,0.00%,2,2,0.00%
ns1035.ui-dns.com,0,0.00%,1,1,0.00%
ns21025.ztomy.com,0,0.00%,1,1,0.00%
sole.cline.it,0,0.00%,2,2,0.00%
dilbert.ns.cloudflare.com,0,0.00%,1,1,0.00%
ns1.mireene.com,0,0.00%,1,1,0.00%
ns11025.ztomy.com,0,0.00%,1,1,0.00%
ns2.mireene.com,0,0.00%,1,1,0.00%
dns2.netsons.net,0,0.00%,1,1,0.00%
dns2.parking-page.net,0,0.00%,2,2,0.00%
dns1.parking-page.net,0,0.00%,1,1,0.00%
laila.ns.cloudflare.com,0,0.00%,3,3,0.00%
ns1.thinline.cz,0,0.00%,1,1,0.00%
ns2.thinline.cz,0,0.00%,1,1,0.00%
ns3.cesky-hosting.eu,0,0.00%,2,2,0.00%
api.boxcryptor.com,0,0.00%,6,6,0.00%
qb-extension.firebaseio.com,0,0.00%,10,10,0.00%
ns1063.ui-dns.com,0,0.00%,7,7,0.00%
ns1115.ui-dns.biz,0,0.00%,4,4,0.00%
ns1024.ui-dns.org,0,0.00%,1,1,0.00%
ns1063.ui-dns.de,0,0.00%,1,1,0.00%
ns4.fabulous.com,0,0.00%,4,4,0.00%
diskapi.n.shifen.com,0,0.00%,10,10,0.00%
ns-1141.awsdns-14.org,0,0.00%,3,3,0.00%
yeet4iel.nodedata.net,0,0.00%,2,2,0.00%
ns1bdg.name.com,0,0.00%,3,3,0.00%
ns-1651.awsdns-14.co.uk,0,0.00%,1,1,0.00%
ns3dty.name.com,0,0.00%,1,1,0.00%
ns-192.awsdns-24.com,0,0.00%,2,2,0.00%
ns4cfn.name.com,0,0.00%,3,3,0.00%
ns-873.awsdns-45.net,0,0.00%,1,1,0.00%
anton.ns.cloudflare.com,0,0.00%,2,2,0.00%
ns4cjp.name.com,0,0.00%,5,5,0.00%
priscilla.ns.cloudflare.com,0,0.00%,3,3,0.00%
ns7.csof.net,0,0.00%,2,2,0.00%
ns4.csof.net,0,0.00%,2,2,0.00%
ns2.csof.net,0,0.00%,2,2,0.00%
verification-f4064387.ns3.dan.hosting,0,0.00%,1,1,0.00%
ns1.csof.net,0,0.00%,2,2,0.00%
ns3.csof.net,0,0.00%,2,2,0.00%
dns3003a.trouble-free.net,0,0.00%,3,3,0.00%
ns8.csof.net,0,0.00%,2,2,0.00%
ns5.csof.net,0,0.00%,2,2,0.00%
ns1.ecpage.com,0,0.00%,18,18,0.00%
ns2.ecpage.com,0,0.00%,19,19,0.00%
ns6815.hostgator.com,0,0.00%,2,2,0.00%
navy.dnspod.net,0,0.00%,2,2,0.00%
vip2.alidns.com,0,0.00%,4,4,0.00%
ns1118.ui-dns.de,0,0.00%,3,3,0.00%
vip1.alidns.com,0,0.00%,6,6,0.00%
dns4.sered.net,0,0.00%,8,8,0.00%
octans.dnspod.net,0,0.00%,2,2,0.00%
truda.dnspod.net,0,0.00%,2,2,0.00%
kristina.ns.cloudflare.com,0,0.00%,4,4,0.00%
ns1054.ui-dns.com,0,0.00%,1,1,0.00%
ns1.magpiedns.com,0,0.00%,4,4,0.00%
ns2.magpiedns.com,0,0.00%,2,2,0.00%
yr668.com,0,0.00%,2,2,0.00%
heyi-info.com,0,0.00%,2,2,0.00%
dns1.host.ie,0,0.00%,1,1,0.00%
dns105.ovh.net,0,0.00%,1,1,0.00%
ns1096.ui-dns.org,0,0.00%,2,2,0.00%
s.17986.net,0,0.00%,2,2,0.00%
ns2.webspacekit.com,0,0.00%,2,2,0.00%
ns1.konyahosting.com,0,0.00%,2,2,0.00%
ns1.webspacekit.com,0,0.00%,1,1,0.00%
dns28.saveonhosting.com,0,0.00%,1,1,0.00%
dns2.host.ie,0,0.00%,1,1,0.00%
ns2.konyahosting.com,0,0.00%,1,1,0.00%
ns8.cnolnic.net,0,0.00%,1,1,0.00%
ns2.construtorahabitat.com,0,0.00%,1,1,0.00%
ns7.cnolnic.net,0,0.00%,1,1,0.00%
zeus.ns.cloudflare.com,0,0.00%,2,2,0.00%
ns1.dingodns.com,0,0.00%,1,1,0.00%
ns2.dingodns.com,0,0.00%,1,1,0.00%
ns2.blueprintdigital.org,0,0.00%,1,1,0.00%
nsc.planethoster.net,0,0.00%,1,1,0.00%
ns1033.ui-dns.org,0,0.00%,1,1,0.00%
ns01.cashparking.com,0,0.00%,7,7,0.00%
rene.ns.cloudflare.com,0,0.00%,6,6,0.00%
ns1.blueprintdigital.org,0,0.00%,1,1,0.00%
ns1060.ui-dns.com,0,0.00%,1,1,0.00%
ns1.construtorahabitat.com,0,0.00%,1,1,0.00%
ns2.hosting.co.kr,0,0.00%,10,10,0.00%
ashton.ns.cloudflare.com,0,0.00%,2,2,0.00%
nsb.planethoster.net,0,0.00%,1,1,0.00%
ns6.here.ro,0,0.00%,4,4,0.00%
ns2.r4l.com,0,0.00%,6,6,0.00%
ns1.r4l.com,0,0.00%,6,6,0.00%
ns1.arvixeshared.com,0,0.00%,1,1,0.00%
ns2.arvixeshared.com,0,0.00%,2,2,0.00%
dns27.saveonhosting.com,0,0.00%,1,1,0.00%
warrior.nii.net,0,0.00%,2,2,0.00%
archer.nii.net,0,0.00%,2,2,0.00%
zzsgmsh.com,0,0.00%,1,1,0.00%
ns1.rentondc.com,0,0.00%,2,2,0.00%
ns2.mdnsservice.com,0,0.00%,2,2,0.00%
ns15.ovh.net,0,0.00%,2,2,0.00%
ns2.rentondc.com,0,0.00%,1,1,0.00%
ns1101.ui-dns.de,0,0.00%,2,2,0.00%
ns1.c026jp1855.info,0,0.00%,1,1,0.00%
aragorn.ns.cloudflare.com,0,0.00%,2,2,0.00%
ns2.c026jp1855.info,0,0.00%,1,1,0.00%
tucana.dnspod.net,0,0.00%,2,2,0.00%
root-dns.netcup.net,0,0.00%,3,3,0.00%
jay.ns.cloudflare.com,0,0.00%,3,3,0.00%
gcr.io,0,0.00%,28,28,0.00%
ns3.flexbe.com,0,0.00%,13,13,0.00%
blingblingface.site,0,0.00%,1,1,0.00%
ns2.4everdns.com,0,0.00%,2,2,0.00%
ns1.flexbe.ru,0,0.00%,26,26,0.00%
ns-1530.awsdns-63.org,0,0.00%,2,2,0.00%
ns1.4everdns.com,0,0.00%,2,2,0.00%
ns2.flexbe.ru,0,0.00%,14,14,0.00%
ns-387.awsdns-48.com,0,0.00%,4,4,0.00%
ns2glx.name.com,0,0.00%,1,1,0.00%
aurora.ns.cloudflare.com,0,0.00%,4,4,0.00%
ns-824.awsdns-39.net,0,0.00%,2,2,0.00%
bruno.dnspod.net,0,0.00%,2,2,0.00%
hayes.ns.cloudflare.com,0,0.00%,2,2,0.00%
ns.wedos.cz,0,0.00%,5,5,0.00%
melnicoff.ns.cloudflare.com,0,0.00%,4,4,0.00%
ns2.mysecurecloudhost.com,0,0.00%,10,10,0.00%
joy.dnspod.net,0,0.00%,2,2,0.00%
ns4.cibergenios.com,0,0.00%,1,1,0.00%
ball.dnspod.net,0,0.00%,2,2,0.00%
ns1.mysecurecloudhost.com,0,0.00%,10,10,0.00%
ns4.cdmondns-01.org,0,0.00%,1,1,0.00%
ns1.cdmon.net,0,0.00%,2,2,0.00%
cskwindsolarservices.site,0,0.00%,1,1,0.00%
ns1102.ui-dns.de,0,0.00%,3,3,0.00%
ns1088.ui-dns.com,0,0.00%,2,2,0.00%
ns1.nvhost.com.br,0,0.00%,2,2,0.00%
ns1059.ui-dns.org,0,0.00%,1,1,0.00%
dns2.papaki.gr,0,0.00%,1,1,0.00%
dansyarisi.site,0,0.00%,1,1,0.00%
ansel.dnspod.net,0,0.00%,1,1,0.00%
boat.dnspod.net,0,0.00%,2,2,0.00%
ns2.nvhost.com.br,0,0.00%,1,1,0.00%
n.ns.arvancdn.com,0,0.00%,1,1,0.00%
ns.wedos.net,0,0.00%,6,6,0.00%
reese.ns.cloudflare.com,0,0.00%,10,10,0.00%
sandboxhub.site,0,0.00%,2,2,0.00%
ns2.cnolnic.net,0,0.00%,3,3,0.00%
ns1.cnolnic.net,0,0.00%,3,3,0.00%
anita.ns.cloudflare.com,0,0.00%,2,2,0.00%
jimmy.ns.cloudflare.com,0,0.00%,2,2,0.00%
ns.wedos.eu,0,0.00%,5,5,0.00%
non-fungibletoken.site,0,0.00%,2,2,0.00%
ns.wedos.com,0,0.00%,6,6,0.00%
lady.ns.cloudflare.com,0,0.00%,2,2,0.00%
elmo.ns.cloudflare.com,0,0.00%,12,12,0.00%
assistant.dnspod.net,0,0.00%,2,2,0.00%
vera.ns.cloudflare.com,0,0.00%,5,5,0.00%
carrera.ns.cloudflare.com,0,0.00%,2,2,0.00%
vda2800a.trouble-free.net,0,0.00%,1,1,0.00%
ns1.tildadns.com,0,0.00%,27,27,0.00%
drill.dnspod.net,0,0.00%,2,2,0.00%
v0n0.nic.shopping,0,0.00%,1,1,0.00%
verification-aa720847.ns3.dan.hosting,0,0.00%,1,1,0.00%
ns2.sara8.site,0,0.00%,1,1,0.00%
jeff.ns.cloudflare.com,0,0.00%,6,6,0.00%
ns-208-a.gandi.net,0,0.00%,2,2,0.00%
jeep.dnspod.net,0,0.00%,2,2,0.00%
nsr4.domeny.com,0,0.00%,5,5,0.00%
nsr2.domeny.com,0,0.00%,5,5,0.00%
ns-12.awsdns-01.com,0,0.00%,2,2,0.00%
ns1080.ui-dns.biz,0,0.00%,1,1,0.00%
ns1.sara8.site,0,0.00%,1,1,0.00%
ns-236-c.gandi.net,0,0.00%,2,2,0.00%
ns57.sellvir.com,0,0.00%,1,1,0.00%
janet.ns.cloudflare.com,0,0.00%,2,2,0.00%
ns1126.ui-dns.com,0,0.00%,3,3,0.00%
ns-1250.awsdns-28.org,0,0.00%,2,2,0.00%
ns17.inhostedns.com,0,0.00%,1,1,0.00%
gibbon.dnspod.net,0,0.00%,2,2,0.00%
ns-1879.awsdns-42.co.uk,0,0.00%,1,1,0.00%
alan.ns.cloudflare.com,0,0.00%,5,5,0.00%
verification-ei10nvsi.ns3.dan.hosting,0,0.00%,2,2,0.00%
pedro.ns.cloudflare.com,0,0.00%,4,4,0.00%
ns-64-c.gandi.net,0,0.00%,3,3,0.00%
ns-251.awsdns-31.com,0,0.00%,2,2,0.00%
sage.ns.cloudflare.com,0,0.00%,2,2,0.00%
marge.ns.cloudflare.com,0,0.00%,3,3,0.00%
ns-49-a.gandi.net,0,0.00%,1,1,0.00%
ns1016.ui-dns.de,0,0.00%,4,4,0.00%
ns-201-b.gandi.net,0,0.00%,1,1,0.00%
ns-931.awsdns-52.net,0,0.00%,2,2,0.00%
ns2.afiliaze.com,0,0.00%,2,2,0.00%
career.dnspod.net,0,0.00%,2,2,0.00%
ns3.inwx.eu,0,0.00%,18,18,0.00%
ns1.desec.io,0,0.00%,2,2,0.00%
ns-44-a.gandi.net,0,0.00%,2,2,0.00%
evelyn.ns.cloudflare.com,0,0.00%,2,2,0.00%
ns-96-b.gandi.net,0,0.00%,3,3,0.00%
ns2.desec.org,0,0.00%,1,1,0.00%
ns09.domaincontrol.com,0,0.00%,2,2,0.00%
ns2.orion.servidor.net.br,0,0.00%,1,1,0.00%
cypress.dnspod.net,0,0.00%,2,2,0.00%
ns-117-b.gandi.net,0,0.00%,1,1,0.00%
ns6351.hostgator.com,0,0.00%,2,2,0.00%
ns1.freehosting.com,0,0.00%,4,4,0.00%
ns1.afiliaze.com,0,0.00%,1,1,0.00%
ns-176-c.gandi.net,0,0.00%,1,1,0.00%
ns10.domaincontrol.com,0,0.00%,2,2,0.00%
norman.ns.cloudflare.com,0,0.00%,4,4,0.00%
sloan.ns.cloudflare.com,0,0.00%,21,21,0.00%
topbags.site,0,0.00%,1,1,0.00%
ns-132-c.gandi.net,0,0.00%,1,1,0.00%
ns1.orion.servidor.net.br,0,0.00%,1,1,0.00%
ns-219-a.gandi.net,0,0.00%,2,2,0.00%
ns-172-b.gandi.net,0,0.00%,1,1,0.00%
suhailandhamsa.site,0,0.00%,1,1,0.00%
hockey.dnspod.net,0,0.00%,1,1,0.00%
ns-127-c.gandi.net,0,0.00%,1,1,0.00%
xanthe.dnspod.net,0,0.00%,2,2,0.00%
ns34.domaincontrol.com,0,0.00%,1,1,0.00%
ns-87-b.gandi.net,0,0.00%,2,2,0.00%
ns-46-a.gandi.net,0,0.00%,1,1,0.00%
ns-89-a.gandi.net,0,0.00%,1,1,0.00%
andiaditya.site,0,0.00%,1,1,0.00%
wonderland.dnspod.net,0,0.00%,4,4,0.00%
ns110.inhostedns.com,0,0.00%,1,1,0.00%
ns-193-c.gandi.net,0,0.00%,1,1,0.00%
dns01.gmoserver.jp,0,0.00%,3,3,0.00%
ns-15-c.gandi.net,0,0.00%,1,1,0.00%
ns-187-b.gandi.net,0,0.00%,2,2,0.00%
evan.ns.cloudflare.com,0,0.00%,2,2,0.00%
ns210.inhostedns.net,0,0.00%,1,1,0.00%
courtney.ns.cloudflare.com,0,0.00%,6,6,0.00%
ns-253-c.gandi.net,0,0.00%,1,1,0.00%
current.dnspod.net,0,0.00%,2,2,0.00%
ns-68-b.gandi.net,0,0.00%,2,2,0.00%
ns310.inhostedns.org,0,0.00%,1,1,0.00%
ns-250-a.gandi.net,0,0.00%,2,2,0.00%
ns-187-a.gandi.net,0,0.00%,2,2,0.00%
ns-196-b.gandi.net,0,0.00%,2,2,0.00%
amy.dnspod.net,0,0.00%,2,2,0.00%
ns-150-c.gandi.net,0,0.00%,1,1,0.00%
ns1078.ui-dns.org,0,0.00%,2,2,0.00%
readit.site,0,0.00%,2,2,0.00%
ns1120.ui-dns.de,0,0.00%,1,1,0.00%
ns2.s31.com.br,0,0.00%,2,2,0.00%
ns1.adman.com,0,0.00%,1,1,0.00%
ns3.lpmtr.net,0,0.00%,8,8,0.00%
ns1109.ui-dns.com,0,0.00%,4,4,0.00%
ns-143-a.gandi.net,0,0.00%,1,1,0.00%
ns2.lpmtr.net,0,0.00%,4,4,0.00%
ns1123.ui-dns.com,0,0.00%,1,1,0.00%
ns27.inhostedns.net,0,0.00%,2,2,0.00%
ns1029.ui-dns.de,0,0.00%,4,4,0.00%
ns1027.ui-dns.biz,0,0.00%,3,3,0.00%
aktifasi-skema-tarif.site,0,0.00%,2,2,0.00%
blob.bnz10prdstr19a.store.core.windows.NET,0,0.00%,2,2,0.00%
ns4.lpmtr.net,0,0.00%,8,8,0.00%
ns2.adman.com,0,0.00%,2,2,0.00%
ns-186-b.gandi.net,0,0.00%,1,1,0.00%
ns37.inhostedns.org,0,0.00%,1,1,0.00%
ns.inwx.de,0,0.00%,9,9,0.00%
una.dnspod.net,0,0.00%,1,1,0.00%
dns7.serverfreak.biz,0,0.00%,2,2,0.00%
drizzle.dnspod.net,0,0.00%,2,2,0.00%
ns1.s31.com.br,0,0.00%,1,1,0.00%
dns02.gmoserver.jp,0,0.00%,3,3,0.00%
arturo.ns.cloudflare.com,0,0.00%,3,3,0.00%
erin.ns.cloudflare.com,0,0.00%,14,14,0.00%
ns-1800.awsdns-33.co.uk,0,0.00%,1,1,0.00%
ns-164-b.gandi.net,0,0.00%,2,2,0.00%
ns-370.awsdns-46.com,0,0.00%,1,1,0.00%
ns-923.awsdns-51.net,0,0.00%,2,2,0.00%
alberto.ns.cloudflare.com,0,0.00%,6,6,0.00%
ns-576.awsdns-08.net,0,0.00%,1,1,0.00%
ns-1554.awsdns-02.co.uk,0,0.00%,1,1,0.00%
ns5.webrserver.com,0,0.00%,1,1,0.00%
ns6.webrserver.com,0,0.00%,1,1,0.00%
ns10.ovh.ca,0,0.00%,4,4,0.00%
beacher.dnspod.net,0,0.00%,2,2,0.00%
achiel.ns.cloudflare.com,0,0.00%,10,10,0.00%
ns1.bh-62.webhostbox.net,0,0.00%,1,1,0.00%
ns.garitto.com,0,0.00%,2,2,0.00%
ns.ocnk.net,0,0.00%,1,1,0.00%
ns-1599.awsdns-07.co.uk,0,0.00%,1,1,0.00%
jerry.ns.cloudflare.com,0,0.00%,8,8,0.00%
lorna.ns.cloudflare.com,0,0.00%,10,10,0.00%
p2.trdns.com,0,0.00%,1,1,0.00%
p1.trdns.com,0,0.00%,2,2,0.00%
ns1.jino.ru,0,0.00%,14,14,0.00%
ns2.jino.ru,0,0.00%,9,9,0.00%
ns4.jino.ru,0,0.00%,10,10,0.00%
ns3.insales.ru,0,0.00%,4,4,0.00%
ns1.beget.ru,0,0.00%,67,67,0.00%
appdoclone.shop,0,0.00%,1,1,0.00%
ns1.frienddns.info,0,0.00%,48,48,0.00%
ns-1072.awsdns-06.org,0,0.00%,1,1,0.00%
memphis.ns.cloudflare.com,0,0.00%,4,4,0.00%
ns2.rootdns.xyz,0,0.00%,2,2,0.00%
ns-1595.awsdns-07.co.uk,0,0.00%,2,2,0.00%
ns48.hostgator.com.br,0,0.00%,1,1,0.00%
ns-354.awsdns-44.com,0,0.00%,3,3,0.00%
martha.ns.cloudflare.com,0,0.00%,4,4,0.00%
ns-724.awsdns-26.net,0,0.00%,1,1,0.00%
ns-wh2.web.z.com,0,0.00%,6,6,0.00%
sponseer.shop,0,0.00%,1,1,0.00%
emerie.ns.cloudflare.com,0,0.00%,6,6,0.00%
shades12.rzone.de,0,0.00%,3,3,0.00%
ns-wh1.web.z.com,0,0.00%,6,6,0.00%
weston.ns.cloudflare.com,0,0.00%,2,2,0.00%
curitiba.ns.porkbun.com,0,0.00%,4,4,0.00%
fortaleza.ns.porkbun.com,0,0.00%,4,4,0.00%
dane.ns.cloudflare.com,0,0.00%,8,8,0.00%
maceio.ns.porkbun.com,0,0.00%,6,6,0.00%
avnicreation.shop,0,0.00%,1,1,0.00%
c.pizzacorporation.com,0,0.00%,2,2,0.00%
datacluster3.cipsup.cn,0,0.00%,8,8,0.00%
googlecode.l.googleusercontent.com,0,0.00%,6,6,0.00%
hn.xinhuanet.com,0,0.00%,2,2,0.00%
news3.xinhuanet.com,0,0.00%,2,2,0.00%
gfwsl.geforce.com,0,0.00%,3,3,0.00%
inf.ldmnq.com,0,0.00%,4,4,0.00%
metadata.packet.net,0,0.00%,4,4,0.00%
midchina.xinhuanet.com,0,0.00%,2,2,0.00%
aider.meizu.com,0,0.00%,3,3,0.00%
dns.console.aliyun.com,0,0.00%,4,4,0.00%
gracieunitedhancock.classic.kicksite.net,0,0.00%,1,1,0.00%
register.naas.huawei.com,0,0.00%,4,4,0.00%
zxid-m.mobileservice.cn,0,0.00%,4,4,0.00%
xred.mooo.com,0,0.00%,4,4,0.00%
www.hq.news.cn,0,0.00%,2,2,0.00%
www.hq.xinhuanet.com,0,0.00%,2,2,0.00%
open.tingjiandan.com,0,0.00%,4,4,0.00%
mail2.ivory-pomelo.com,0,0.00%,2,2,0.00%
gns1.huaweicloud-dns.com,0,0.00%,2,2,0.00%
gns1.huaweicloud-dns.cn,0,0.00%,2,2,0.00%
gns1.huaweicloud-dns.org,0,0.00%,2,2,0.00%
conf-drcn-cloud-dbankcloud-cn-drcn.appacc.dbankedge.net,0,0.00%,2,2,0.00%
conf-drcn-cloud-dbankcloud-cn-drcn.edge.dbankedge.cn,0,0.00%,2,2,0.00%
cn-jiangsu001.edge.dbankedge.cn,0,0.00%,2,2,0.00%
cloudres-drcn.dbankcdn.cn,0,0.00%,2,2,0.00%
cloudres-drcn.dbankcdn.globalsign.c.cdnhwc1.cn,0,0.00%,2,2,0.00%
ns2.huaweicloud-dns.org,0,0.00%,2,2,0.00%
ns2.huaweicloud-dns.com,0,0.00%,2,2,0.00%
userk-drcn.cloud.dbankcloud.cn,0,0.00%,2,2,0.00%
ns3.huaweicloud-dns.cn,0,0.00%,2,2,0.00%
ns3.huaweicloud-dns.com,0,0.00%,2,2,0.00%
userk-drcn-cloud-dbankcloud-cn-drcn.appacc.dbankedge.cn,0,0.00%,2,2,0.00%
userk-drcn-cloud-dbankcloud-cn-drcn.edge.dbankedge.cn,0,0.00%,2,2,0.00%
ak.privatelink.msidentity.com,0,0.00%,2,2,0.00%
pim-drcn.cloud.dbankcloud.cn,0,0.00%,2,2,0.00%
pim-drcn-cloud-dbankcloud-cn-drcn.appacc.dbankedge.net,0,0.00%,2,2,0.00%
api.opensubtitles.com,0,0.00%,4,4,0.00%
f.gtld-servers.net,0,0.00%,4,4,0.00%
pim-drcn-cloud-dbankcloud-cn-drcn.edge.dbankedge.cn,0,0.00%,2,2,0.00%
game.bb.qq.com,0,0.00%,2,2,0.00%
explorer.sharemyworks.com,0,0.00%,1,1,0.00%
api.insight.synology.com,0,0.00%,4,4,0.00%
self-events-data.trafficmanager.net,0,0.00%,6,6,0.00%
onedscolprdneu04.northeurope.cloudapp.azure.com,0,0.00%,2,2,0.00%
35.courier-push-apple.com.akadns.net,0,0.00%,2,2,0.00%
apac-china-courier-4.push-apple.com.akadns.net,0,0.00%,14,14,0.00%
ns-os1.qq.com,0,0.00%,2,2,0.00%
ecs.office.trafficmanager.net,0,0.00%,2,2,0.00%
ecs-office.s-0005.s-msedge.net,0,0.00%,2,2,0.00%
s-0005.s-msedge.net,0,0.00%,2,2,0.00%
hk.vtnas.com,0,0.00%,4,4,0.00%
s.f.qh-lb.com,0,0.00%,4,4,0.00%
www.yahoo.com,0,0.00%,4,4,0.00%
new-fp-shed.wg1.b.yahoo.com,0,0.00%,4,4,0.00%
ns.cnmobile.net,0,0.00%,2,2,0.00%
ns2.cnmobile.net,0,0.00%,6,6,0.00%
sslpcsnb2.jomodns.com,0,0.00%,2,2,0.00%
teams.office.com,0,0.00%,2,2,0.00%
auth-collab.platform.refinitiv.com,0,0.00%,2,2,0.00%
link-ro5m7bg7.gaapqcloud.com.cn,0,0.00%,2,2,0.00%
yl.qq.com.cloud.tc.qq.com,0,0.00%,2,2,0.00%
teams-mira-afd.trafficmanager.net,0,0.00%,2,2,0.00%
im-collab.platform.refinitiv.com,0,0.00%,2,2,0.00%
qiao.e.shifen.com,0,0.00%,2,2,0.00%
ns2.e.shifen.com,0,0.00%,2,2,0.00%
ns4.e.shifen.com,0,0.00%,2,2,0.00%
ns1.e.shifen.com,0,0.00%,2,2,0.00%
ns3.e.shifen.com,0,0.00%,2,2,0.00%
ns5.e.shifen.com,0,0.00%,2,2,0.00%
game.cr.qq.com,0,0.00%,2,2,0.00%
bj.pcsdownload.n.shifen.com,0,0.00%,2,2,0.00%
ns1.n.shifen.com,0,0.00%,2,2,0.00%
ns3.n.shifen.com,0,0.00%,2,2,0.00%
ns4.n.shifen.com,0,0.00%,2,2,0.00%
aoufnebg.dayugslb.com,0,0.00%,2,2,0.00%
ali.picupload.weibo.com,0,0.00%,2,2,0.00%
link-q89r7hhv.gaapqcloud.com,0,0.00%,2,2,0.00%
teams-office-com.s-0005.s-msedge.net,0,0.00%,2,2,0.00%
yl.qq.com.x2v6.sched.dcloudstc.com,0,0.00%,2,2,0.00%
link-6tm8io8v.gaapqcloud.com.cn,0,0.00%,2,2,0.00%
bjali.picupload.weibo.com,0,0.00%,2,2,0.00%
3.courier-push-apple.com.akadns.net,0,0.00%,2,2,0.00%
update.b.cqttech.com,0,0.00%,4,4,0.00%
kms.library.hk,0,0.00%,2,2,0.00%
datacluster2.cipsup.cn,0,0.00%,12,12,0.00%
browserkernel.baidu.com,0,0.00%,6,6,0.00%
ossapi.baidu.com,0,0.00%,2,2,0.00%
mbrowser.baidu.com,0,0.00%,2,2,0.00%
pimlog.baidu.com,0,0.00%,4,4,0.00%
whk1.noapp.xyz,0,0.00%,2,2,0.00%
lcs.baidu.com,0,0.00%,6,6,0.00%
afdconf.baidu.com,0,0.00%,8,8,0.00%
i5.weather.oppomobile.com,0,0.00%,2,2,0.00%
api.inunison.net,0,0.00%,2,2,0.00%
mail4.rabbit-tigger.com,0,0.00%,4,4,0.00%
learn.derose.app,0,0.00%,1,1,0.00%
sa5.tuisong.baidu.com,0,0.00%,2,2,0.00%
iosapps.itunes.apple.com,0,0.00%,2,2,0.00%
ext.baidu.com,0,0.00%,6,6,0.00%
lowes.com,0,0.00%,8,8,0.00%
captive.g.aaplimg.com,0,0.00%,6,6,0.00%
musicstatus.itunes.apple.com,0,0.00%,8,8,0.00%
api.app.gtja.com,0,0.00%,4,4,0.00%
staging.globusjourneys.in,0,0.00%,1,1,0.00%
updateime.baidu.com,0,0.00%,4,4,0.00%
mail.htstart.cn,0,0.00%,4,4,0.00%
update.minipage.2345.cc,0,0.00%,2,2,0.00%
update-minipage.2345.cc,0,0.00%,2,2,0.00%
ts.minipage.2345.cc,0,0.00%,2,2,0.00%
update-ruanjian.2345.com,0,0.00%,2,2,0.00%
ryrc.ruijienetworks.com,0,0.00%,2,2,0.00%
www.weiyun.com,0,0.00%,3,3,0.00%
report.huatuo.qq.com,0,0.00%,4,4,0.00%
ui.ptlogin2.qq.com,0,0.00%,4,4,0.00%
t.minipage.2345.cc,0,0.00%,2,2,0.00%
dtin1.bitznet.cloud,0,0.00%,6,6,0.00%
inappcheck-ak.itunes-apple.com.akadns.net,0,0.00%,2,2,0.00%
gnar.grammarly.com,0,0.00%,6,6,0.00%
soft.hitun.io,0,0.00%,2,2,0.00%
subscribe.rss-node.com,0,0.00%,2,2,0.00%
m.o4aac.ga,0,0.00%,1,1,0.00%
trouter-azsc-asse-0-b.trouter.skype.com,0,0.00%,2,2,0.00%
api.b.qianxin.com,0,0.00%,8,8,0.00%
testip.internet-census.org,0,0.00%,120,120,0.00%
onedscolprdcus10.centralus.cloudapp.azure.com,0,0.00%,2,2,0.00%
shavar.services.mozilla.com,0,0.00%,15,15,0.00%
pic.qiantucdn.com,0,0.00%,2,2,0.00%
browser-api.2345.cc,0,0.00%,14,14,0.00%
stock.xueqiu.com,0,0.00%,13,13,0.00%
copilot-telemetry.githubusercontent.com,0,0.00%,2,2,0.00%
fundmobapi.eastmoney.com,0,0.00%,4,4,0.00%
APAC05.azure-devices.net,0,0.00%,2,2,0.00%
gsp64-ssl.ls-apple.com.akadns.net,0,0.00%,11,11,0.00%
lwlog.laiwang.com,0,0.00%,2,2,0.00%
ns.dns.net.cn,0,0.00%,1,1,0.00%
dict.cnki.net,0,0.00%,4,4,0.00%
da.anythinktech.com,0,0.00%,2,2,0.00%
alita.pc.mi.com,0,0.00%,4,4,0.00%
orange-dc.alibaba.com,0,0.00%,3,3,0.00%
adash.man.aliyuncs.com,0,0.00%,4,4,0.00%
dc.sigmob.cn,0,0.00%,4,4,0.00%
alimei-api.aliyun.com,0,0.00%,1,1,0.00%
alimail-access-agent-ay29-v6.aliyun.com.gds.alibabadns.com,0,0.00%,2,2,0.00%
plugin.xl7.xunlei.com,0,0.00%,1,1,0.00%
ins-mfa9hirw.ias.tencent-cloud.net,0,0.00%,2,2,0.00%
busuanzi.ibruce.info,0,0.00%,4,4,0.00%
vcsa.vmware.com,0,0.00%,3,3,0.00%
map.qq.com,0,0.00%,2,2,0.00%
pr.map.qq.com,0,0.00%,2,2,0.00%
apikey.map.qq.com,0,0.00%,6,6,0.00%
confinfo.map.qq.com,0,0.00%,4,4,0.00%
overseactrl.map.qq.com,0,0.00%,7,7,0.00%
vectorsdk.map.qq.com,0,0.00%,11,11,0.00%
displaycatalog.mp.microsoft.com,0,0.00%,7,7,0.00%
socket.pan.baidu.com,0,0.00%,3,3,0.00%
vc.y.qq.com,0,0.00%,2,2,0.00%
auth-v2.oray.com,0,0.00%,10,10,0.00%
ddns.oray.com,0,0.00%,1,1,0.00%
client.10jqka.com.cn,0,0.00%,2,2,0.00%
ai.10jqka.com.cn,0,0.00%,2,2,0.00%
open.mobile.qq.com,0,0.00%,2,2,0.00%
fp-vs.azureedge.net,0,0.00%,2,2,0.00%
fp-as.azureedge.net,0,0.00%,2,2,0.00%
face.t.sinajs.cn,0,0.00%,3,3,0.00%
hiya.browser.360.cn,0,0.00%,15,15,0.00%
nj.h.bcsp2p.baidu.com,0,0.00%,2,2,0.00%
rc10-fc12.oray.com,0,0.00%,2,2,0.00%
res.qhmsg.com,0,0.00%,1,1,0.00%
p.api.pc120.com,0,0.00%,2,2,0.00%
s3.nzbdw.com,0,0.00%,4,4,0.00%
slp2p-east-std1054.oray.net,0,0.00%,2,2,0.00%
c.s.360.cn,0,0.00%,1,1,0.00%
yyb.eve.mdt.qq.com,0,0.00%,6,6,0.00%
677fe2d47a239ed3090a7dea614682c3.dlied1.cdntips.net,0,0.00%,2,2,0.00%
map.lianjia.com,0,0.00%,1,1,0.00%
99e61f8b592192257eff49fed26609dd.dlied1.cdntips.net,0,0.00%,1,1,0.00%
suggestion.baidu.com,0,0.00%,6,6,0.00%
577a47befb676471cf5e2c0e7bb070d3.dlied1.cdntips.net,0,0.00%,1,1,0.00%
maponline2.bdimg.com,0,0.00%,1,1,0.00%
license.chinauos.com,0,0.00%,1,1,0.00%
appstore.uniontech.com,0,0.00%,1,1,0.00%
swallow.apple.com,0,0.00%,4,4,0.00%
login.oray.com,0,0.00%,2,2,0.00%
data.uniontech.com,0,0.00%,1,1,0.00%
store.oray.com,0,0.00%,2,2,0.00%
store-api.oray.com,0,0.00%,2,2,0.00%
tk.oray.com,0,0.00%,2,2,0.00%
fsigns.duba.net.scc.topgslb.com,0,0.00%,1,1,0.00%
api.51yund.com,0,0.00%,1,1,0.00%
fe3.delivery.mp.microsoft.com,0,0.00%,2,2,0.00%
ingest.quantummetric.com,0,0.00%,2,2,0.00%
paimgcdn.baidu.com,0,0.00%,2,2,0.00%
bdapapi3.uniontech.com,0,0.00%,3,3,0.00%
bdapapi1.uniontech.com,0,0.00%,3,3,0.00%
dns.digitale-gesellschaft.ch,0,0.00%,3,3,0.00%
api.8864029a8b01d50a95d558b5792ce2d6.com,0,0.00%,5,5,0.00%
wanproxy-bj.127.net,0,0.00%,2,2,0.00%
dt.netease.im,0,0.00%,2,2,0.00%
api.iplay.163.com,0,0.00%,2,2,0.00%
interface3.music.163.com.163jiasu.com,0,0.00%,5,5,0.00%
only-290764-159-226-95-33.nstool.haowu.link,0,0.00%,1,1,0.00%
api.k.163.com,0,0.00%,2,2,0.00%
lbs.netease.im,0,0.00%,2,2,0.00%
wannos.127.net,0,0.00%,2,2,0.00%
clientlog3.music.163.com,0,0.00%,4,4,0.00%
guzzoni-apple-com.v.aaplimg.com,0,0.00%,6,6,0.00%
sf.symcb.com,0,0.00%,2,2,0.00%
p1.music.126.net,0,0.00%,2,2,0.00%
open.e.189.cn,0,0.00%,6,6,0.00%
c6.y.qq.com,0,0.00%,2,2,0.00%
p2.music.126.net,0,0.00%,2,2,0.00%
gsp-ssl.ls.apple.com,0,0.00%,11,11,0.00%
icon.docer.wps.cn,0,0.00%,2,2,0.00%
augloop.office.com,0,0.00%,2,2,0.00%
rdweb.wvd.microsoft.com,0,0.00%,2,2,0.00%
query.prod.cms.rt.microsoft.com,0,0.00%,2,2,0.00%
wxagame.weixin.qq.com,0,0.00%,2,2,0.00%
pnsfeedback.dingtalk.com,0,0.00%,2,2,0.00%
resolver-eu.lelux.fi,0,0.00%,4,4,0.00%
vip.dingtalk.com,0,0.00%,2,2,0.00%
log.officeaid.com,0,0.00%,2,2,0.00%
ocsp2.g.aaplimg.com,0,0.00%,6,6,0.00%
shavar.prod.mozaws.net,0,0.00%,11,11,0.00%
api.smoot.apple.cn,0,0.00%,2,2,0.00%
i.gtimg.cn,0,0.00%,4,4,0.00%
d3-pr-cu-sb-ns-primary.servicebus.windows.net,0,0.00%,2,2,0.00%
d3-pr-cu-sb-ns-primary-err.servicebus.windows.net,0,0.00%,2,2,0.00%
d3-pr-cu-app-gcrapicore.azurewebsites.net,0,0.00%,2,2,0.00%
punch.p2p.qq.com,0,0.00%,10,10,0.00%
music-test.cymini.qq.com,0,0.00%,2,2,0.00%
livephoto.us.sinaimg.cn,0,0.00%,3,3,0.00%
login2.dingtalk.com,0,0.00%,4,4,0.00%
batch-rgeo.is.autonavi.com,0,0.00%,2,2,0.00%
profile.firefox.com.cn,0,0.00%,5,5,0.00%
sync.firefox.com.cn,0,0.00%,5,5,0.00%
s8-sync.firefox.com.cn,0,0.00%,4,4,0.00%
cl4-cn.apple.com,0,0.00%,8,8,0.00%
iphonesubmissions.apple.com,0,0.00%,3,3,0.00%
datacollect.foxmail.com.cn,0,0.00%,8,8,0.00%
dualstack-mpsapi.amap.com,0,0.00%,5,5,0.00%
h-adashx.ut.dingtalk.com,0,0.00%,4,4,0.00%
keyrotate.qq.com,0,0.00%,2,2,0.00%
ins-5fdz0eh7.ias.tencent-cloud.net,0,0.00%,2,2,0.00%
snowflake.qq.com,0,0.00%,4,4,0.00%
ipv4.gdt.qq.com,0,0.00%,2,2,0.00%
gatherer.m.qq.com,0,0.00%,2,2,0.00%
astrategy.beacon.qq.com,0,0.00%,4,4,0.00%
mazu.m.qq.com,0,0.00%,6,6,0.00%
ins-j1yx5oul.ias.tencent-cloud.net,0,0.00%,3,3,0.00%
sq.bls.mdt.qq.com,0,0.00%,2,2,0.00%
p.qpic.cn,0,0.00%,4,4,0.00%
ctlogin.qq.com,0,0.00%,8,8,0.00%
ctlogin5.qq.com,0,0.00%,8,8,0.00%
ctlogin3.qq.com,0,0.00%,8,8,0.00%
ctlogin6.qq.com,0,0.00%,8,8,0.00%
rs9.qq.com,0,0.00%,8,8,0.00%
ts9.qq.com,0,0.00%,6,6,0.00%
cdn.xsj.qq.com,0,0.00%,2,2,0.00%
uconf.f.360.cn,0,0.00%,2,2,0.00%
juhacqev.sched.sma.tdnsstic1.cn,0,0.00%,3,3,0.00%
dualstack-restios.amap.com,0,0.00%,5,5,0.00%
ftn.mail.qq.com,0,0.00%,8,8,0.00%
udpolimenew.baidu.com,0,0.00%,8,8,0.00%
mobi2.hexin.cn,0,0.00%,5,5,0.00%
push.hexin.cn,0,0.00%,15,15,0.00%
m.10jqka.com.cn,0,0.00%,14,14,0.00%
cachedxhw.10jqka.com.cn,0,0.00%,2,2,0.00%
e.thsi.cn,0,0.00%,4,4,0.00%
auth.10jqka.com.cn,0,0.00%,2,2,0.00%
cachet.hexin.cn,0,0.00%,2,2,0.00%
vaserviece.10jqka.com.cn,0,0.00%,2,2,0.00%
www.10jqka.com.cn,0,0.00%,2,2,0.00%
bonree.htsec.com,0,0.00%,3,3,0.00%
getuixfr.htsec.com,0,0.00%,6,6,0.00%
api.ipify.org,0,0.00%,4,4,0.00%
ops.htsec.com,0,0.00%,3,3,0.00%
ipdns.htsec.com,0,0.00%,4,4,0.00%
sensorsdatareceive.htsec.com,0,0.00%,5,5,0.00%
opscloud.htsec.com,0,0.00%,3,3,0.00%
netty.htsec.com,0,0.00%,2,2,0.00%
yunhxly.sseinfo.com,0,0.00%,2,2,0.00%
yunsyly.sseinfo.com,0,0.00%,2,2,0.00%
yunxjqly.sseinfo.com,0,0.00%,2,2,0.00%
yuncsly.sseinfo.com,0,0.00%,2,2,0.00%
yuncdydly.sseinfo.com,0,0.00%,2,2,0.00%
stockinfo.htsec.com,0,0.00%,4,4,0.00%
startpage.foxitsoftware.com,0,0.00%,2,2,0.00%
ins-5tsp1vmk.ias.tencent-cloud.net,0,0.00%,2,2,0.00%
miaixp01.alpinesec.org,0,0.00%,2,2,0.00%
r3---sn-2x3elnel.gvt1.com,0,0.00%,6,6,0.00%
oth.bls.mdt.qq.com,0,0.00%,2,2,0.00%
pic6.y.qq.com,0,0.00%,2,2,0.00%
multi-az-ad.kuaishou.com,0,0.00%,2,2,0.00%
gw2.wishingstarmoye.com,0,0.00%,1,1,0.00%
6to4.ipv6.microsoft.com,0,0.00%,2,2,0.00%
cl2-cn.apple.com,0,0.00%,4,4,0.00%
tr.gingersoftware.com,0,0.00%,2,2,0.00%
statics.kongzhong.com,0,0.00%,2,2,0.00%
prod.mrodevicemgr.live.com.akadns.NET,0,0.00%,2,2,0.00%
asia.configsvc1.live.com.akadns.NET,0,0.00%,4,4,0.00%
static.deepl.com,0,0.00%,12,12,0.00%
api-new.bignox.com,0,0.00%,2,2,0.00%
wu-bg-shim.trafficmanager.NET,0,0.00%,4,4,0.00%
aads.shuzilm.cn,0,0.00%,2,2,0.00%
ipv4.shuzilm.cn,0,0.00%,2,2,0.00%
appcloud.zhihu.com,0,0.00%,2,2,0.00%
open.kuaishouzt.com,0,0.00%,4,4,0.00%
daa.shuzilm.cn,0,0.00%,2,2,0.00%
alibabacdn.gds.aliyuncdn.space,0,0.00%,2,2,0.00%
config.cmpassport.com,0,0.00%,4,4,0.00%
log1.cmpassport.com,0,0.00%,2,2,0.00%
offmsg.umeng.com,0,0.00%,2,2,0.00%
gw2api.kongzhong.com,0,0.00%,2,2,0.00%
vpn.shanhe.com,0,0.00%,2,2,0.00%
it-sdp-tjcon.jd.com,0,0.00%,4,4,0.00%
appcloud2.zhihu.com,0,0.00%,2,2,0.00%
vdn3.vzuu.com,0,0.00%,3,3,0.00%
vdn1.vzuu.com,0,0.00%,2,2,0.00%
httpdns.c.cdnhwc2.com,0,0.00%,2,2,0.00%
aidatatest.zhihu.com,0,0.00%,2,2,0.00%
roi.soulapp.cn,0,0.00%,2,2,0.00%
us-west-las-5.openssl3.com,0,0.00%,4,4,0.00%
cm-10-37.getui.com,0,0.00%,2,2,0.00%
cn-ms.galaxyappstore.com,0,0.00%,2,2,0.00%
dls2.bigdata.samsung.com.cn,0,0.00%,2,2,0.00%
a.fxltsbl.com,0,0.00%,2,2,0.00%
clientmessages.gingersoftware.com,0,0.00%,2,2,0.00%
cn-api.samsungpositioning.com.cn,0,0.00%,2,2,0.00%
gos-api.gos-gsp.io,0,0.00%,2,2,0.00%
dls-udc.dqa.samsung.com.cn,0,0.00%,2,2,0.00%
dmonitor.lkcoffee.com,0,0.00%,4,4,0.00%
tools.3g.qq.com,0,0.00%,6,6,0.00%
iie.arp.cn,0,0.00%,2,2,0.00%
capi.lkcoffee.com,0,0.00%,2,2,0.00%
botinfo01.hbq.rcs.chinamobile.com,0,0.00%,2,2,0.00%
config.rcs.chinamobile.com,0,0.00%,2,2,0.00%
ga.gamedl.qq.com,0,0.00%,6,6,0.00%
rc10-linux.oray.com,0,0.00%,2,2,0.00%
5gmcsip05.hbq.rcs.chinamobile.com,0,0.00%,2,2,0.00%
courier.bz.mgtv.com,0,0.00%,2,2,0.00%
iap-orders-drcn.cloud.huawei.com.cn,0,0.00%,2,2,0.00%
iap-subscr-drcn.cloud.huawei.com.cn,0,0.00%,2,2,0.00%
im-drcn.platform.dbankcloud.cn,0,0.00%,2,2,0.00%
imlong-sa-p04-drcn.platform.dbankcloud.cn,0,0.00%,2,2,0.00%
jp_32.antchatxj.com,0,0.00%,4,4,0.00%
upfile-drcn.platform.hicloud.com,0,0.00%,2,2,0.00%
dps-drcn.jos.dbankcloud.cn,0,0.00%,2,2,0.00%
connectivitycheck.cbg-app.huawei.com.cn,0,0.00%,2,2,0.00%
t5.appmeasurements.com,0,0.00%,2,2,0.00%
hio-api.jd.com,0,0.00%,2,2,0.00%
rr.office.microsoft.com,0,0.00%,2,2,0.00%
sns.cfzq.com,0,0.00%,2,2,0.00%
only-227056-159-226-95-38.nstool.laiqukankan.com,0,0.00%,1,1,0.00%
analytics.mpay.netease.com,0,0.00%,2,2,0.00%
data.hexin.cn,0,0.00%,2,2,0.00%
m.analytics.126.net,0,0.00%,2,2,0.00%
obus-dc20058-cn.heytapmobi.com,0,0.00%,2,2,0.00%
appconf-ocs.heytapdownload.com,0,0.00%,4,4,0.00%
inappcheck-cn.itunes-apple.com.akadns.net,0,0.00%,2,2,0.00%
appcdcbjpip1.jianguoyun.com,0,0.00%,2,2,0.00%
api-cn.theme.heytapmobi.com,0,0.00%,2,2,0.00%
obus-cn.dc.heytapmobi.com,0,0.00%,2,2,0.00%
wdoc-75389.picgzc.qpic.cn,0,0.00%,2,2,0.00%
docrp.weixin.qq.com,0,0.00%,2,2,0.00%
jspatch.qzone.qq.com,0,0.00%,2,2,0.00%
doc.weixin.qq.com,0,0.00%,2,2,0.00%
bkimg.cdn.bcebos.com,0,0.00%,2,2,0.00%
reports.baidu.com,0,0.00%,2,2,0.00%
uss.lenovomm.com,0,0.00%,2,2,0.00%
cloudi.browser.oppomobile.com,0,0.00%,2,2,0.00%
git.koal.com,0,0.00%,2,2,0.00%
open.work.weixin.qq.com,0,0.00%,2,2,0.00%
47412848670ef53c8c0048f8078f3224.dlied1.cdntips.net,0,0.00%,4,4,0.00%
login.im.qcloud.com,0,0.00%,11,11,0.00%
www.rabbitmq.com,0,0.00%,2,2,0.00%
cdn.meeting.tencent.com,0,0.00%,1,1,0.00%
oth.str.beacon.qq.com,0,0.00%,6,6,0.00%
xcast.netcond.qq.com,0,0.00%,4,4,0.00%
app.terra-master.com,0,0.00%,2,2,0.00%
se4.360simg.com,0,0.00%,1,1,0.00%
aqv.hicloud.com,0,0.00%,2,2,0.00%
browser5.qhimg.com,0,0.00%,2,2,0.00%
api-cn.game.heytapmobi.com,0,0.00%,2,2,0.00%
api.cdo.oppomobile.com,0,0.00%,2,2,0.00%
dragate.dc.oppomobile.com,0,0.00%,4,4,0.00%
www.xboxab.com,0,0.00%,8,8,0.00%
mqq-plugin.qq.com,0,0.00%,2,2,0.00%
shimo.im,0,0.00%,8,8,0.00%
e316d1f5c13a425fe9a8b30bb24c072b.dlied1.cdntips.net,0,0.00%,2,2,0.00%
ai.cmbchina.com,0,0.00%,2,2,0.00%
mbmodule-openapi.paas.cmbchina.com,0,0.00%,2,2,0.00%
mobile.cmbchina.com,0,0.00%,4,4,0.00%
poi.10jqka.com.cn,0,0.00%,4,4,0.00%
acp.zh.cmbchina.com,0,0.00%,2,2,0.00%
netpay.cmbchina.com,0,0.00%,2,2,0.00%
pub-api-gateway.paas.cmbchina.com,0,0.00%,2,2,0.00%
cmp.zh.cmbchina.com,0,0.00%,2,2,0.00%
465fe81be1b5cc4f9a8c4f8553cfa7cd.dlied1.cdntips.net,0,0.00%,2,2,0.00%
img.biquge-app.com,0,0.00%,2,2,0.00%
b217da3058f4c69e705d4b40a968b540.dlied1.cdntips.net,0,0.00%,2,2,0.00%
yl.zh.cmbchina.com,0,0.00%,2,2,0.00%
webapi.amap.com,0,0.00%,3,3,0.00%
gz-lb1.internet-g.spanner.alipaydns.com,0,0.00%,10,10,0.00%
log.cmbchina.com,0,0.00%,2,2,0.00%
it-sdp-tjcon.jd.com.gslb.qianxun.com,0,0.00%,6,6,0.00%
www.mayiwxw.com,0,0.00%,2,2,0.00%
api.st615.com,0,0.00%,16,16,0.00%
browser.events.data.microsoft.com,0,0.00%,6,6,0.00%
s3m7.fenxi.com,0,0.00%,2,2,0.00%
update.haozip.2345.com,0,0.00%,4,4,0.00%
renderer.aibixby.com.cn,0,0.00%,2,2,0.00%
dh.alyun.cn,0,0.00%,2,2,0.00%
p1.ssl.qhimg.com,0,0.00%,3,3,0.00%
mbads.paas.cmbchina.com,0,0.00%,2,2,0.00%
track.shimo.im,0,0.00%,8,8,0.00%
hlth.io.mi.com,0,0.00%,2,2,0.00%
static.m.cmbchina.com,0,0.00%,2,2,0.00%
mark.l.qq.com,0,0.00%,6,6,0.00%
vd.l.qq.com,0,0.00%,2,2,0.00%
c303.cloudmark.com,0,0.00%,2,2,0.00%
discovery.razor.cloudmark.com,0,0.00%,4,4,0.00%
1099ddb.vfra.dscew.ml,0,0.00%,1,1,0.00%
ns1.kapper.NET,0,0.00%,4,4,0.00%
ns7.kapper.NET,0,0.00%,4,4,0.00%
ns5.kapper.NET,0,0.00%,4,4,0.00%
ns3.kapper.NET,0,0.00%,4,4,0.00%
ns2.kapper.NET,0,0.00%,4,4,0.00%
cloudpush.iqiyi.com,0,0.00%,14,14,0.00%
sec1.rcode0.NET,0,0.00%,6,6,0.00%
p211-ckdatabase.icloud.com.cn,0,0.00%,2,2,0.00%
drive.weixin.qq.com,0,0.00%,4,4,0.00%
appleid.apple.com,0,0.00%,2,2,0.00%
sl-arm2.azure-100.tk,0,0.00%,61,61,0.00%
sa-update.spamassassin.org,0,0.00%,2,2,0.00%
c302.cloudmark.com,0,0.00%,2,2,0.00%
e2c28.gcp.gvt2.com,0,0.00%,2,2,0.00%
ca-s2.fatvpn.ml,0,0.00%,2,2,0.00%
reflections.repeatmd.com,0,0.00%,1,1,0.00%
study.huixiangtiandi.com,0,0.00%,2,2,0.00%
408662a206f24e79bbdf0810d6ce694f.fp.measure.office.com,0,0.00%,1,1,0.00%
n48.boom.skin,0,0.00%,10,10,0.00%
api.wondercv.com,0,0.00%,6,6,0.00%
n04.boom.skin,0,0.00%,7,7,0.00%
s100.boom.skin,0,0.00%,7,7,0.00%
n119.boom.skin,0,0.00%,7,7,0.00%
n47.boom.skin,0,0.00%,7,7,0.00%
ntemp17.boom.skin,0,0.00%,7,7,0.00%
us4.edge.boom.skin,0,0.00%,8,8,0.00%
ntemp08.boom.skin,0,0.00%,7,7,0.00%
ntemp04.boom.skin,0,0.00%,7,7,0.00%
ntemp03.boom.skin,0,0.00%,7,7,0.00%
us3.edge.boom.skin,0,0.00%,7,7,0.00%
ntemp06.boom.skin,0,0.00%,7,7,0.00%
ntemp07.boom.skin,0,0.00%,7,7,0.00%
n54.boom.skin,0,0.00%,7,7,0.00%
n21.boom.skin,0,0.00%,7,7,0.00%
n24.boom.skin,0,0.00%,7,7,0.00%
ntemp05.boom.skin,0,0.00%,7,7,0.00%
ntemp19.boom.skin,0,0.00%,9,9,0.00%
ntemp10.boom.skin,0,0.00%,7,7,0.00%
ntemp15.boom.skin,0,0.00%,7,7,0.00%
n62.boom.skin,0,0.00%,7,7,0.00%
n28.boom.skin,0,0.00%,7,7,0.00%
ntemp18.boom.skin,0,0.00%,7,7,0.00%
n43.boom.skin,0,0.00%,8,8,0.00%
n116.boom.skin,0,0.00%,7,7,0.00%
ntemp16.boom.skin,0,0.00%,7,7,0.00%
ntemp09.boom.skin,0,0.00%,7,7,0.00%
n32.boom.skin,0,0.00%,7,7,0.00%
n22.boom.skin,0,0.00%,7,7,0.00%
ntemp02.boom.skin,0,0.00%,7,7,0.00%
n06.boom.skin,0,0.00%,7,7,0.00%
nm2.boom.skin,0,0.00%,7,7,0.00%
n37.boom.skin,0,0.00%,8,8,0.00%
s102.boom.skin,0,0.00%,7,7,0.00%
s103.boom.skin,0,0.00%,7,7,0.00%
s105.boom.skin,0,0.00%,7,7,0.00%
s01.boom.skin,0,0.00%,7,7,0.00%
n96.boom.skin,0,0.00%,7,7,0.00%
s104.boom.skin,0,0.00%,7,7,0.00%
n17.boom.skin,0,0.00%,7,7,0.00%
n30.boom.skin,0,0.00%,7,7,0.00%
n11.boom.skin,0,0.00%,7,7,0.00%
n110.boom.skin,0,0.00%,8,8,0.00%
n13.boom.skin,0,0.00%,7,7,0.00%
n09.boom.skin,0,0.00%,7,7,0.00%
n27.boom.skin,0,0.00%,7,7,0.00%
n63.boom.skin,0,0.00%,7,7,0.00%
n92.boom.skin,0,0.00%,7,7,0.00%
n77.boom.skin,0,0.00%,7,7,0.00%
n60.boom.skin,0,0.00%,7,7,0.00%
ntemp25.boom.skin,0,0.00%,7,7,0.00%
n100.boom.skin,0,0.00%,7,7,0.00%
n114.boom.skin,0,0.00%,7,7,0.00%
nk1.boom.skin,0,0.00%,9,9,0.00%
nk2.boom.skin,0,0.00%,9,9,0.00%
nk3.boom.skin,0,0.00%,7,7,0.00%
nk5.boom.skin,0,0.00%,7,7,0.00%
nk6.boom.skin,0,0.00%,8,8,0.00%
nk7.boom.skin,0,0.00%,7,7,0.00%
nf1.boom.skin,0,0.00%,7,7,0.00%
nf3.boom.skin,0,0.00%,7,7,0.00%
nk4.boom.skin,0,0.00%,9,9,0.00%
nf4.boom.skin,0,0.00%,7,7,0.00%
nf5.boom.skin,0,0.00%,7,7,0.00%
nf2.boom.skin,0,0.00%,7,7,0.00%
nf8.boom.skin,0,0.00%,7,7,0.00%
nf10.boom.skin,0,0.00%,7,7,0.00%
nf6.boom.skin,0,0.00%,7,7,0.00%
nf7.boom.skin,0,0.00%,7,7,0.00%
nf11.boom.skin,0,0.00%,7,7,0.00%
n170.boom.skin,0,0.00%,7,7,0.00%
nj1.boom.skin,0,0.00%,8,8,0.00%
nj2.boom.skin,0,0.00%,7,7,0.00%
nf9.boom.skin,0,0.00%,7,7,0.00%
nj3.boom.skin,0,0.00%,8,8,0.00%
nj4.boom.skin,0,0.00%,7,7,0.00%
nj5.boom.skin,0,0.00%,7,7,0.00%
nj6.boom.skin,0,0.00%,7,7,0.00%
nj8.boom.skin,0,0.00%,7,7,0.00%
nj7.boom.skin,0,0.00%,7,7,0.00%
nj9.boom.skin,0,0.00%,7,7,0.00%
nja.boom.skin,0,0.00%,7,7,0.00%
njb.boom.skin,0,0.00%,8,8,0.00%
njc.boom.skin,0,0.00%,9,9,0.00%
njd.boom.skin,0,0.00%,7,7,0.00%
nje.boom.skin,0,0.00%,10,10,0.00%
nk8.boom.skin,0,0.00%,9,9,0.00%
nk9.boom.skin,0,0.00%,7,7,0.00%
nka.boom.skin,0,0.00%,7,7,0.00%
nkc.boom.skin,0,0.00%,7,7,0.00%
nkb.boom.skin,0,0.00%,7,7,0.00%
nkd.boom.skin,0,0.00%,7,7,0.00%
nl1.boom.skin,0,0.00%,7,7,0.00%
nke.boom.skin,0,0.00%,7,7,0.00%
nl2.boom.skin,0,0.00%,7,7,0.00%
nl3.boom.skin,0,0.00%,7,7,0.00%
nl4.boom.skin,0,0.00%,7,7,0.00%
nl5.boom.skin,0,0.00%,7,7,0.00%
nl6.boom.skin,0,0.00%,7,7,0.00%
nl7.boom.skin,0,0.00%,7,7,0.00%
nl9.boom.skin,0,0.00%,7,7,0.00%
nla.boom.skin,0,0.00%,7,7,0.00%
n61.boom.skin,0,0.00%,8,8,0.00%
nl8.boom.skin,0,0.00%,7,7,0.00%
s101.boom.skin,0,0.00%,7,7,0.00%
n67.boom.skin,0,0.00%,8,8,0.00%
n74.boom.skin,0,0.00%,7,7,0.00%
nm1.boom.skin,0,0.00%,7,7,0.00%
us8.edge.boom.skin,0,0.00%,7,7,0.00%
us5.edge.boom.skin,0,0.00%,7,7,0.00%
us6.edge.boom.skin,0,0.00%,7,7,0.00%
us7.edge.boom.skin,0,0.00%,7,7,0.00%
us9.edge.boom.skin,0,0.00%,8,8,0.00%
us1.edge.boom.skin,0,0.00%,7,7,0.00%
us10.edge.boom.skin,0,0.00%,7,7,0.00%
us2.edge.boom.skin,0,0.00%,8,8,0.00%
nm3.boom.skin,0,0.00%,7,7,0.00%
nm4.boom.skin,0,0.00%,7,7,0.00%
jp2.boom.skin,0,0.00%,8,8,0.00%
nm5.boom.skin,0,0.00%,7,7,0.00%
nm6.boom.skin,0,0.00%,7,7,0.00%
nm7.boom.skin,0,0.00%,7,7,0.00%
nm8.boom.skin,0,0.00%,7,7,0.00%
nma.boom.skin,0,0.00%,7,7,0.00%
nm9.boom.skin,0,0.00%,7,7,0.00%
nmb.boom.skin,0,0.00%,7,7,0.00%
n93.boom.skin,0,0.00%,8,8,0.00%
nmc.boom.skin,0,0.00%,7,7,0.00%
n111.boom.skin,0,0.00%,8,8,0.00%
n115.boom.skin,0,0.00%,8,8,0.00%
nmd.boom.skin,0,0.00%,7,7,0.00%
n117.boom.skin,0,0.00%,7,7,0.00%
jp15.boom.skin,0,0.00%,7,7,0.00%
jp16.boom.skin,0,0.00%,7,7,0.00%
jp18.boom.skin,0,0.00%,7,7,0.00%
jp20.boom.skin,0,0.00%,7,7,0.00%
jp7.boom.skin,0,0.00%,7,7,0.00%
jp6.boom.skin,0,0.00%,8,8,0.00%
jp8.boom.skin,0,0.00%,8,8,0.00%
jp9.boom.skin,0,0.00%,8,8,0.00%
jp11.boom.skin,0,0.00%,7,7,0.00%
jp13.boom.skin,0,0.00%,7,7,0.00%
jp14.boom.skin,0,0.00%,8,8,0.00%
jp19.boom.skin,0,0.00%,8,8,0.00%
nn1.boom.skin,0,0.00%,7,7,0.00%
nn2.boom.skin,0,0.00%,8,8,0.00%
nn3.boom.skin,0,0.00%,7,7,0.00%
jp10.boom.skin,0,0.00%,7,7,0.00%
jp12.boom.skin,0,0.00%,8,8,0.00%
nn5.boom.skin,0,0.00%,7,7,0.00%
nn7.boom.skin,0,0.00%,7,7,0.00%
jp1.boom.skin,0,0.00%,8,8,0.00%
jp5.boom.skin,0,0.00%,10,10,0.00%
nn14.boom.skin,0,0.00%,7,7,0.00%
nn12.boom.skin,0,0.00%,8,8,0.00%
nn4.boom.skin,0,0.00%,7,7,0.00%
nn13.boom.skin,0,0.00%,7,7,0.00%
nn8.boom.skin,0,0.00%,7,7,0.00%
nn6.boom.skin,0,0.00%,7,7,0.00%
nn9.boom.skin,0,0.00%,7,7,0.00%
nna.boom.skin,0,0.00%,7,7,0.00%
nn11.boom.skin,0,0.00%,7,7,0.00%
opt7.boom.skin,0,0.00%,7,7,0.00%
jp3.boom.skin,0,0.00%,8,8,0.00%
opt6.boom.skin,0,0.00%,7,7,0.00%
opt15.boom.skin,0,0.00%,7,7,0.00%
jp4.boom.skin,0,0.00%,7,7,0.00%
opt22.boom.skin,0,0.00%,7,7,0.00%
opt23.boom.skin,0,0.00%,7,7,0.00%
opt25.boom.skin,0,0.00%,7,7,0.00%
opt26.boom.skin,0,0.00%,7,7,0.00%
opt2.boom.skin,0,0.00%,7,7,0.00%
opt21.boom.skin,0,0.00%,7,7,0.00%
opt8.boom.skin,0,0.00%,7,7,0.00%
opt10.boom.skin,0,0.00%,7,7,0.00%
opt24.boom.skin,0,0.00%,7,7,0.00%
opt11.boom.skin,0,0.00%,8,8,0.00%
opt9.boom.skin,0,0.00%,7,7,0.00%
opt13.boom.skin,0,0.00%,7,7,0.00%
opt14.boom.skin,0,0.00%,7,7,0.00%
opt1.boom.skin,0,0.00%,7,7,0.00%
opt20.boom.skin,0,0.00%,7,7,0.00%
opt12.boom.skin,0,0.00%,8,8,0.00%
opt17.boom.skin,0,0.00%,8,8,0.00%
opt3.boom.skin,0,0.00%,7,7,0.00%
opt4.boom.skin,0,0.00%,7,7,0.00%
opt5.boom.skin,0,0.00%,7,7,0.00%
opt16.boom.skin,0,0.00%,7,7,0.00%
opt18.boom.skin,0,0.00%,7,7,0.00%
opt19.boom.skin,0,0.00%,7,7,0.00%
ns-1364.awsdns-42.org,0,0.00%,2,2,0.00%
dbsu.cmcm.com,0,0.00%,2,2,0.00%
ip.parrotdns.com,0,0.00%,60,60,0.00%
ap2.agora.io,0,0.00%,1,1,0.00%
ap3.agora.io,0,0.00%,1,1,0.00%
ap4-tls.agora.io,0,0.00%,1,1,0.00%
ap3-tls.agora.io,0,0.00%,1,1,0.00%
ap2-tls.agora.io,0,0.00%,1,1,0.00%
report-edge.agora.io,0,0.00%,1,1,0.00%
ap4.agora.io,0,0.00%,2,2,0.00%
ap1.agora.io,0,0.00%,2,2,0.00%
ap1-tls.agora.io,0,0.00%,1,1,0.00%
apiavalon.myhug.cn,0,0.00%,2,2,0.00%
ap5-tls.agora.io,0,0.00%,2,2,0.00%
sdk.open.talk.getui.com,0,0.00%,4,4,0.00%
sdk.open.talk.gepush.com,0,0.00%,1,1,0.00%
sdk.open.talk.getui.net,0,0.00%,1,1,0.00%
cm-10-18.getui.com,0,0.00%,2,2,0.00%
arpha.taobao.com,0,0.00%,3,3,0.00%
default-query.trtc.tencent-cloud.com,0,0.00%,2,2,0.00%
mlvbdc.live.qcloud.com,0,0.00%,24,24,0.00%
cloudservice22.kingsoft-office-service.com,0,0.00%,2,2,0.00%
pqc.myhug.cn,0,0.00%,6,6,0.00%
wtt.tcpbbr.xyz,0,0.00%,1,1,0.00%
metrics-drcn.dt.hicloud.com,0,0.00%,1,1,0.00%
cohort.ccs.mcafee.com,0,0.00%,6,6,0.00%
provision.ccs.mcafee.com,0,0.00%,2,2,0.00%
ns1.c-msedge.net,0,0.00%,6,6,0.00%
e4a8257b91944813a5e1336358c98a20.fp.measure.office.com,0,0.00%,1,1,0.00%
dnet.mb.qq.com,0,0.00%,2,2,0.00%
sunwk.fun,0,0.00%,2,2,0.00%
clt.sangfor.com.cn,0,0.00%,8,8,0.00%
update.kingsoftstore.com,0,0.00%,2,2,0.00%
diana.ie.sogou.com,0,0.00%,6,6,0.00%
evolwallpaper-api.papegames.cn,0,0.00%,8,8,0.00%
hotnews.duba.com,0,0.00%,5,5,0.00%
driverbooster-api.drivergenius.com,0,0.00%,7,7,0.00%
api.pc120.com,0,0.00%,6,6,0.00%
staging.v2.myteachlink.com,0,0.00%,2,2,0.00%
admission.pku.edu.cn,0,0.00%,2,2,0.00%
www.cs.tsinghua.edu.cn,0,0.00%,2,2,0.00%
stock.hostmonit.com,0,0.00%,2,2,0.00%
settings-prod-scus-1.southcentralus.cloudapp.azure.com,0,0.00%,12,12,0.00%
pop.ie.sogou.com,0,0.00%,7,7,0.00%
dm2305.storage.live.com,0,0.00%,4,4,0.00%
c17a476ea10c4aceb1fd7efa413a7d43.fp.measure.office.com,0,0.00%,1,1,0.00%
settings-prod-scus-2.southcentralus.cloudapp.azure.com,0,0.00%,10,10,0.00%
a2-65.akam.net,0,0.00%,2,2,0.00%
a7-64.akam.net,0,0.00%,2,2,0.00%
a1-127.akam.net,0,0.00%,2,2,0.00%
a24-66.akam.net,0,0.00%,2,2,0.00%
san3ar.github.io,0,0.00%,1,1,0.00%
ds.kaspersky.com,0,0.00%,18,18,0.00%
4e65e2f3e1dc4c018e825f0a9971f601.fp.measure.office.com,0,0.00%,1,1,0.00%
up2.jia.360.cn,0,0.00%,8,8,0.00%
eyktkpzypweq.exitlist.co,0,0.00%,1,1,0.00%
huangzhun05.github.io,0,0.00%,1,1,0.00%
update3.sangfor.net,0,0.00%,24,24,0.00%
i.kuwo.cn,0,0.00%,8,8,0.00%
array509.prod.do.dsp.mp.microsoft.com,0,0.00%,9,9,0.00%
pz.antsysht.com,0,0.00%,1,1,0.00%
bn1304.storage.live.com,0,0.00%,8,8,0.00%
info.52pcfree.com,0,0.00%,18,18,0.00%
e.coding.net,0,0.00%,4,4,0.00%
dsm04pap001.storage.live.com,0,0.00%,2,2,0.00%
by3302.storage.live.com,0,0.00%,2,2,0.00%
demonhe.coding.net,0,0.00%,3,3,0.00%
t-khd.2345.cc,0,0.00%,7,7,0.00%
polka.typekit.com,0,0.00%,2,2,0.00%
gc.kis.v2.scr.kaspersky-labs.com,0,0.00%,4,4,0.00%
contacts.icloud.com,0,0.00%,2,2,0.00%
30d3dfa8-5787-4cc8-9674-3de116f91368.oms.opinsights.azure.com,0,0.00%,4,4,0.00%
ssl.mail.126.com,0,0.00%,2,2,0.00%
cn.mvconf.50union.com,0,0.00%,4,4,0.00%
as.com,0,0.00%,1,1,0.00%
d0.awsstatic.com,0,0.00%,1,1,0.00%
c.jia.mn,0,0.00%,2,2,0.00%
service.weather.msn.cn,0,0.00%,5,5,0.00%
tile-service.weather.msn.cn,0,0.00%,4,4,0.00%
cn.aiclean.50union.com,0,0.00%,2,2,0.00%
r3---sn-2x3elnez.gvt1.com,0,0.00%,9,9,0.00%
api.mxgcat.wang,0,0.00%,2,2,0.00%
git.octodata.com.cn,0,0.00%,2,2,0.00%
d.xfinfr.com,0,0.00%,2,2,0.00%
api.statistics.tobii.com,0,0.00%,2,2,0.00%
1.rlb.router.teamviewer.cn,0,0.00%,2,2,0.00%
be59399.cw.glados-config.net,0,0.00%,4,4,0.00%
be59399.td.glados-config.net,0,0.00%,4,4,0.00%
be59399.wx.glados-config.net,0,0.00%,4,4,0.00%
be59399.nx.glados-config.net,0,0.00%,4,4,0.00%
be59399.th.glados-config.net,0,0.00%,4,4,0.00%
be59399.tt.glados-config.net,0,0.00%,4,4,0.00%
be59399.ts.glados-config.net,0,0.00%,4,4,0.00%
be59399.wy.glados-config.net,0,0.00%,4,4,0.00%
wss.app.yinxiang.com,0,0.00%,2,2,0.00%
by3301.storage.live.com,0,0.00%,5,5,0.00%
antifatigue.laohu.com,0,0.00%,2,2,0.00%
r3---sn-2x3elnes.gvt1.com,0,0.00%,4,4,0.00%
c0a3a0241b9e4a468782769f34666272.fp.measure.office.com,0,0.00%,1,1,0.00%
jp03-vm0.entry.srthdw.art,0,0.00%,5,5,0.00%
cpanel.magnasoftbim.com,0,0.00%,1,1,0.00%
discussion.evernote.com,0,0.00%,2,2,0.00%
pdloader.com,0,0.00%,2,2,0.00%
scs-hcdn.iqiyi.com,0,0.00%,2,2,0.00%
v-2a384402.71edge.com,0,0.00%,2,2,0.00%
seed.siri.apple.com,0,0.00%,2,2,0.00%
prod-data.acquisition.grammarlyaws.com,0,0.00%,2,2,0.00%
update-haozip.2345.cc,0,0.00%,2,2,0.00%
flashloader.net,0,0.00%,2,2,0.00%
jp02-vm0.entry.srthdw.art,0,0.00%,4,4,0.00%
chi01pap001.storage.live.com,0,0.00%,2,2,0.00%
msg.autohome.com.cn,0,0.00%,2,2,0.00%
msgsrv01.oray.net,0,0.00%,4,4,0.00%
t.undefined-site.top,0,0.00%,4,4,0.00%
api.lsplayer.com,0,0.00%,2,2,0.00%
alt1-mtalk.google.com,0,0.00%,2,2,0.00%
www.alignmentforum.org,0,0.00%,1,1,0.00%
rp.m.hub.sandai.net,0,0.00%,2,2,0.00%
wns.y.qq.com,0,0.00%,2,2,0.00%
wnsmusic.qq.com,0,0.00%,2,2,0.00%
mt.y.qq.com,0,0.00%,4,4,0.00%
ad.tencentmusic.com,0,0.00%,4,4,0.00%
musicpunch.p2p.qq.com,0,0.00%,2,2,0.00%
ping.huatuo.qq.com,0,0.00%,2,2,0.00%
stats.music.xiaomi.com,0,0.00%,2,2,0.00%
ws6.stream.qqmusic.qq.com,0,0.00%,2,2,0.00%
dispatch.updrv.com,0,0.00%,14,14,0.00%
www.so.com,0,0.00%,17,17,0.00%
az667904-pme.azureedge.net,0,0.00%,2,2,0.00%
global.quickconnect.cn,0,0.00%,2,2,0.00%
cs.weishi.ijinshan.com,0,0.00%,2,2,0.00%
kmwatson.events.data.microsoft.com,0,0.00%,2,2,0.00%
smtp.iscas.ac.cn,0,0.00%,12,12,0.00%
ini.sdup.360.cn,0,0.00%,4,4,0.00%
url-query.api.pc120.com,0,0.00%,8,8,0.00%
m.xiaomi.com,0,0.00%,2,2,0.00%
m.mi.com,0,0.00%,2,2,0.00%
paris.trial.paladinsoftware.com,0,0.00%,1,1,0.00%
rttf.citrix.com,0,0.00%,1,1,0.00%
vscode-update.trafficmanager.net,0,0.00%,2,2,0.00%
waws-prod-sg1-057.sip.azurewebsites.windows.net,0,0.00%,2,2,0.00%
vscode-update-sea.azurewebsites.net,0,0.00%,2,2,0.00%
onedscolprdwus04.westus.cloudapp.azure.com,0,0.00%,2,2,0.00%
cs22.wpc.v0cdn.net,0,0.00%,2,2,0.00%
oth.ludashi.com,0,0.00%,2,2,0.00%
ds.download.windowsupdate.com,0,0.00%,2,2,0.00%
fe2.update.microsoft.com,0,0.00%,4,4,0.00%
iots01-g2.oray.net,0,0.00%,2,2,0.00%
pr4.getnjnd.com,0,0.00%,4,4,0.00%
forums.developer.nvidia.com,0,0.00%,4,4,0.00%
sh.sys-stat.download,0,0.00%,2,2,0.00%
bs2-1.getnjnd.com,0,0.00%,19,19,0.00%
bs1-1.getnjnd.com,0,0.00%,26,26,0.00%
appsso.oh.isrc.ac.cn,0,0.00%,4,4,0.00%
hk-proxy.isrc.ac.cn,0,0.00%,9,9,0.00%
www.mi.com,0,0.00%,7,7,0.00%
7e0ee17389484800b93382d0775c09b3.fp.measure.office.com,0,0.00%,1,1,0.00%
bn1301.storage.live.com,0,0.00%,2,2,0.00%
ue.mbgstore.lenovo.com.cn,0,0.00%,4,4,0.00%
vrzk9nuhhsudshnuvgoxfjx8lthwaqxy.yundunwaf2.com,0,0.00%,4,4,0.00%
esm.ubuntu.com,0,0.00%,4,4,0.00%
packagecloud.io,0,0.00%,6,6,0.00%
d2mdw063ttlqtq.cloudfront.net,0,0.00%,6,6,0.00%
referrals.getambassador.com,0,0.00%,61,61,0.00%
theoldreader.com,0,0.00%,4,4,0.00%
imap.tgs-mail.de,0,0.00%,61,61,0.00%
data.hackerwatch.org,0,0.00%,5,5,0.00%
steamusercontent-a.akamaihd.net,0,0.00%,1,1,0.00%
124.t.keepitpumpin.io,0,0.00%,2,2,0.00%
hblj-387f1f.playlist-fibre.org,0,0.00%,4,4,0.00%
service.ubuntukylin.com,0,0.00%,1,1,0.00%
myip.ipip.net,0,0.00%,4,4,0.00%
www.wps.cn,0,0.00%,14,14,0.00%
dual-spo-0004.spo-msedge.net,0,0.00%,22,22,0.00%
gz3.520vpn.us,0,0.00%,28,28,0.00%
www.microsoft.com-c-3.edgekey.net,0,0.00%,2,2,0.00%
ios-informationplatform.wps.cn,0,0.00%,4,4,0.00%
p218-contacts.icloud.com.cn,0,0.00%,1,1,0.00%
apd-pcdnvodstat.teg.tencent-cloud.net,0,0.00%,6,6,0.00%
e2c26.gcp.gvt2.com,0,0.00%,2,2,0.00%
e2c53.gcp.gvt2.com,0,0.00%,2,2,0.00%
0.t.dancevalidator.io,0,0.00%,2,2,0.00%
login.weixin.qq.com,0,0.00%,9,9,0.00%
proxy-provider-converter-six.vercel.app,0,0.00%,2,2,0.00%
myyw.jamaica-doctor.net,0,0.00%,2,2,0.00%
passport.weibo.com,0,0.00%,2,2,0.00%
www.theoccult.bz,0,0.00%,2,2,0.00%
tracker.kuroy.me,0,0.00%,4,4,0.00%
tracker2.dler.org,0,0.00%,2,2,0.00%
opentracker.cc,0,0.00%,4,4,0.00%
nleditor.osi.office.net,0,0.00%,3,3,0.00%
analytics.cnblogs.com,0,0.00%,8,8,0.00%
master16.teamviewer.com,0,0.00%,4,4,0.00%
tracker.torrentbytes.net,0,0.00%,2,2,0.00%
www.cnblogs.com,0,0.00%,8,8,0.00%
tracker.openbittorrent.com,0,0.00%,2,2,0.00%
impression.update.netease.com,0,0.00%,2,2,0.00%
netlink-sigma.proxima.nie.netease.com,0,0.00%,2,2,0.00%
tracker.gcvchp.com,0,0.00%,2,2,0.00%
inferno.demonoid.is,0,0.00%,2,2,0.00%
tracker.xdvdz.com,0,0.00%,2,2,0.00%
kklulqbwyj3s3g2i2otjajef2a3kychks2t3agsbv2hdwtiymkbnueid.tor2web.it,0,0.00%,2,2,0.00%
torrents-nn.cn,0,0.00%,4,4,0.00%
a1.cnblogs.com,0,0.00%,10,10,0.00%
extensions.gnome.org,0,0.00%,3,3,0.00%
remarq.scienceconnect.io,0,0.00%,6,6,0.00%
tracker.electro-torrent.pl,0,0.00%,2,2,0.00%
api.blockcypher.com,0,0.00%,8,8,0.00%
master14.teamviewer.com,0,0.00%,10,10,0.00%
isk.richardsw.club,0,0.00%,1,1,0.00%
tracker.grepler.com,0,0.00%,2,2,0.00%
s1.nsatu.com,0,0.00%,2,2,0.00%
torrent.arjlover.net,0,0.00%,2,2,0.00%
buny.uk,0,0.00%,2,2,0.00%
api.dropboxapi.com,0,0.00%,4,4,0.00%
cmpp.gentags.net,0,0.00%,2,2,0.00%
lark-frontier-hl.snssdk.com,0,0.00%,2,2,0.00%
www.xwt-classics.net,0,0.00%,2,2,0.00%
tracker.hiyj.cn,0,0.00%,2,2,0.00%
open.acgnxtracker.com,0,0.00%,2,2,0.00%
tracker.mywaifu.best,0,0.00%,2,2,0.00%
blog-static.cnblogs.com,0,0.00%,2,2,0.00%
bt-tracker.gamexp.ru,0,0.00%,2,2,0.00%
itera.bz,0,0.00%,2,2,0.00%
h3o2.me,0,0.00%,2,2,0.00%
creative.7o7.cx,0,0.00%,1,1,0.00%
zgc.ai-cas.com,0,0.00%,2,2,0.00%
chennuo.xyz,0,0.00%,2,2,0.00%
lbdata.tj.ijinshan.com,0,0.00%,6,6,0.00%
hdweb.mail.split.netease.com,0,0.00%,6,6,0.00%
intf-pc.ludashi.com,0,0.00%,12,12,0.00%
pr.x.hub.sandai.net,0,0.00%,16,16,0.00%
store.viveport.com,0,0.00%,4,4,0.00%
ams03pap001.storage.live.com,0,0.00%,2,2,0.00%
ysdk.qq.com,0,0.00%,4,4,0.00%
p46-contacts.icloud.com,0,0.00%,1,1,0.00%
newmail.guazi.com,0,0.00%,3,3,0.00%
cache.datamart.windows.com,0,0.00%,1,1,0.00%
hostupdate.vmware.com,0,0.00%,1,1,0.00%
cdimage.ubuntu.com,0,0.00%,2,2,0.00%
cloud-images.ubuntu.com,0,0.00%,1,1,0.00%
kl.hnayg.com,0,0.00%,2,2,0.00%
cloud11.rising.com.cn,0,0.00%,2,2,0.00%
chinaeast2-0.in.applicationinsights.azure.cn,0,0.00%,2,2,0.00%
s2.hdslb.com,0,0.00%,4,4,0.00%
okapi.ezoicns.com,0,0.00%,4,4,0.00%
ns-83.awsdns-10.com,0,0.00%,4,4,0.00%
ns-903.awsdns-48.net,0,0.00%,2,2,0.00%
zebra.ezoicns.com,0,0.00%,4,4,0.00%
ns-1070.awsdns-05.org,0,0.00%,2,2,0.00%
ns-1569.awsdns-04.co.uk,0,0.00%,2,2,0.00%
ns-818.awsdns-38.net,0,0.00%,2,2,0.00%
ns-104.awsdns-13.com,0,0.00%,2,2,0.00%
ns-1499.awsdns-59.org,0,0.00%,2,2,0.00%
ns-2017.awsdns-60.co.uk,0,0.00%,2,2,0.00%
ns-1608.awsdns-09.co.uk,0,0.00%,2,2,0.00%
ns346.hostgator.com.br,0,0.00%,2,2,0.00%
ns-495.awsdns-61.com,0,0.00%,2,2,0.00%
ns-560.awsdns-06.net,0,0.00%,2,2,0.00%
ns347.hostgator.com.br,0,0.00%,2,2,0.00%
ns16.tepuyserver.net,0,0.00%,2,2,0.00%
ns15.tepuyserver.net,0,0.00%,2,2,0.00%
ns447.hostgator.com.br,0,0.00%,2,2,0.00%
ns446.hostgator.com.br,0,0.00%,2,2,0.00%
jasper.ns.cloudflare.com,0,0.00%,12,12,0.00%
zahir.ns.cloudflare.com,0,0.00%,4,4,0.00%
ns-1815.awsdns-34.co.uk,0,0.00%,2,2,0.00%
hawk-host.venus.orderbox-dns.com,0,0.00%,2,2,0.00%
vayu1.firstveda.com,0,0.00%,2,2,0.00%
ns96.hostgator.mx,0,0.00%,2,2,0.00%
ns-258.awsdns-32.com,0,0.00%,2,2,0.00%
ns97.hostgator.mx,0,0.00%,2,2,0.00%
ns-579.awsdns-08.net,0,0.00%,2,2,0.00%
hawk-host.earth.orderbox-dns.com,0,0.00%,2,2,0.00%
ns1.escacreative.com,0,0.00%,2,2,0.00%
ns1.siegevalley.com,0,0.00%,2,2,0.00%
hawk-host.mercury.orderbox-dns.com,0,0.00%,2,2,0.00%
inf.safe.360.cn,0,0.00%,12,12,0.00%
ns1.my-ndns.com,0,0.00%,2,2,0.00%
ns3.aplus.net,0,0.00%,4,4,0.00%
t.ns.arvancdn.com,0,0.00%,2,2,0.00%
ns2.aplus.net,0,0.00%,4,4,0.00%
ns-774.awsdns-32.net,0,0.00%,4,4,0.00%
mina.ns.cloudflare.com,0,0.00%,2,2,0.00%
ns1.startlogic.com,0,0.00%,4,4,0.00%
ns50.wpxhosting.com,0,0.00%,2,2,0.00%
ns8442.hostgator.com,0,0.00%,2,2,0.00%
ns-1525.awsdns-62.org,0,0.00%,2,2,0.00%
ns8441.hostgator.com,0,0.00%,2,2,0.00%
ns2.escacreative.com,0,0.00%,2,2,0.00%
ns51.wpxhosting.com,0,0.00%,2,2,0.00%
ns2.siegevalley.com,0,0.00%,2,2,0.00%
ns1.cpanel.ltd,0,0.00%,2,2,0.00%
ns2.ayrshire-domains.com,0,0.00%,2,2,0.00%
ns1.aplus.net,0,0.00%,4,4,0.00%
ns-188.awsdns-23.com,0,0.00%,2,2,0.00%
ns2.cpanel.ltd,0,0.00%,2,2,0.00%
docks15.rzone.de,0,0.00%,2,2,0.00%
ns-1022.awsdns-63.net,0,0.00%,2,2,0.00%
shades02.rzone.de,0,0.00%,2,2,0.00%
ns-1193.awsdns-21.org,0,0.00%,2,2,0.00%
ns46.latinoamericahosting.com,0,0.00%,2,2,0.00%
ns-1988.awsdns-56.co.uk,0,0.00%,6,6,0.00%
ns2.netop.de,0,0.00%,2,2,0.00%
ns-326.awsdns-40.com,0,0.00%,2,2,0.00%
ns1.dotarai.com,0,0.00%,4,4,0.00%
ns1.hawkhost.com,0,0.00%,8,8,0.00%
ns1.ayrshire-domains.com,0,0.00%,2,2,0.00%
ns1.netop.de,0,0.00%,2,2,0.00%
ns041.auroradns.eu,0,0.00%,2,2,0.00%
ns5.l4dns.com,0,0.00%,4,4,0.00%
ns1020.ui-dns.de,0,0.00%,4,4,0.00%
ns2.dotarai.com,0,0.00%,4,4,0.00%
ns29.netafrooz.com,0,0.00%,4,4,0.00%
ns5.awardspace.com,0,0.00%,4,4,0.00%
ns33.hostgator.com.br,0,0.00%,2,2,0.00%
ns3.cloudoon.org,0,0.00%,2,2,0.00%
ns2.startlogic.com,0,0.00%,4,4,0.00%
ns2.cloudoon.net,0,0.00%,4,4,0.00%
ns-156-b.gandi.net,0,0.00%,2,2,0.00%
ns1.cloudoon.com,0,0.00%,2,2,0.00%
ns-115-c.gandi.net,0,0.00%,2,2,0.00%
shades11.rzone.de,0,0.00%,2,2,0.00%
sillythemonk.com,0,0.00%,2,2,0.00%
ns3.altervista.com,0,0.00%,2,2,0.00%
ns2.my-ndns.com,0,0.00%,2,2,0.00%
ns043.auroradns.info,0,0.00%,2,2,0.00%
ns-122-a.gandi.net,0,0.00%,2,2,0.00%
vin.ns.cloudflare.com,0,0.00%,3,3,0.00%
ns1.altervista.com,0,0.00%,2,2,0.00%
ns042.auroradns.nl,0,0.00%,2,2,0.00%
ns2.altervista.com,0,0.00%,2,2,0.00%
egg.dnspod.net,0,0.00%,2,2,0.00%
ns6211.hostgator.com,0,0.00%,2,2,0.00%
ns1058.ui-dns.de,0,0.00%,2,2,0.00%
ns3.hostmultitecno.net,0,0.00%,2,2,0.00%
ns2.hostmultitecno.net,0,0.00%,2,2,0.00%
ns1.hostmultitecno.net,0,0.00%,2,2,0.00%
tiffany.ns.cloudflare.com,0,0.00%,3,3,0.00%
alaric.ns.cloudflare.com,0,0.00%,2,2,0.00%
yichun.ns.cloudflare.com,0,0.00%,5,5,0.00%
ligia.ns.cloudflare.com,0,0.00%,2,2,0.00%
shortcapitalinvestments.com,0,0.00%,2,2,0.00%
ns2.terabytesserver.com,0,0.00%,4,4,0.00%
kuna1117639.mercury.orderbox-dns.com,0,0.00%,16,16,0.00%
f1g1ns1.dnspod.net,0,0.00%,20,20,0.00%
kuna1117639.mars.orderbox-dns.com,0,0.00%,14,14,0.00%
kuna1117639.venus.orderbox-dns.com,0,0.00%,14,14,0.00%
ns2.free.thdns.com,0,0.00%,2,2,0.00%
kuna1117639.earth.orderbox-dns.com,0,0.00%,14,14,0.00%
ns2.bdydns.cn,0,0.00%,10,10,0.00%
array.dnspod.net,0,0.00%,2,2,0.00%
ns1.khaliid.net,0,0.00%,2,2,0.00%
ns.mailplug.com,0,0.00%,2,2,0.00%
ns2.htshosting.org,0,0.00%,2,2,0.00%
bishop.dnspod.net,0,0.00%,2,2,0.00%
leif.ns.cloudflare.com,0,0.00%,4,4,0.00%
ns2.ktek.net,0,0.00%,2,2,0.00%
ns6.diymysite.com,0,0.00%,2,2,0.00%
doma634347.mercury.orderbox-dns.com,0,0.00%,4,4,0.00%
ns1.htshosting.org,0,0.00%,2,2,0.00%
haley.ns.cloudflare.com,0,0.00%,2,2,0.00%
ns5.diymysite.com,0,0.00%,2,2,0.00%
doma634347.venus.orderbox-dns.com,0,0.00%,4,4,0.00%
ns1058.ui-dns.com,0,0.00%,4,4,0.00%
ns2.khaliid.net,0,0.00%,2,2,0.00%
shura-island.com,0,0.00%,2,2,0.00%
vayu2.firstveda.com,0,0.00%,2,2,0.00%
dj.dnspod.net,0,0.00%,2,2,0.00%
doma634347.mars.orderbox-dns.com,0,0.00%,4,4,0.00%
ns2.ynsjg.com,0,0.00%,2,2,0.00%
sns40.hostgator.in,0,0.00%,2,2,0.00%
morgan.ns.cloudflare.com,0,0.00%,4,4,0.00%
ns2.yunnandns.com,0,0.00%,2,2,0.00%
pub.dnspod.net,0,0.00%,2,2,0.00%
sierra.ns.cloudflare.com,0,0.00%,4,4,0.00%
ns1062.ui-dns.org,0,0.00%,4,4,0.00%
ns1.yunnandns.com,0,0.00%,2,2,0.00%
donna.ns.cloudflare.com,0,0.00%,2,2,0.00%
lee.ns.cloudflare.com,0,0.00%,6,6,0.00%
langston.ns.cloudflare.com,0,0.00%,4,4,0.00%
shuliangjt.com,0,0.00%,2,2,0.00%
earl.ns.cloudflare.com,0,0.00%,2,2,0.00%
ns1.idwebhost.com,0,0.00%,2,2,0.00%
ns1060.ui-dns.org,0,0.00%,4,4,0.00%
dns2.laoxuehost.com,0,0.00%,2,2,0.00%
dns4.laoxuehost.com,0,0.00%,2,2,0.00%
dns3.laoxuehost.com,0,0.00%,2,2,0.00%
sickgp.com,0,0.00%,2,2,0.00%
dns1.laoxuehost.com,0,0.00%,2,2,0.00%
ns1116.ui-dns.biz,0,0.00%,6,6,0.00%
ns1091.ui-dns.com,0,0.00%,4,4,0.00%
ns1.kissconnect.net,0,0.00%,2,2,0.00%
valentina.dnspod.net,0,0.00%,2,2,0.00%
ns-1751.awsdns-26.co.uk,0,0.00%,2,2,0.00%
ns-320.awsdns-40.com,0,0.00%,3,3,0.00%
dns2.zyro.com,0,0.00%,11,11,0.00%
ns3.registrant-verification.ispapi.net,0,0.00%,4,4,0.00%
ns-713.awsdns-25.net,0,0.00%,4,4,0.00%
dns143.a.register.com,0,0.00%,2,2,0.00%
dns12.firestorm-isp.com,0,0.00%,2,2,0.00%
ns1064.ui-dns.de,0,0.00%,3,3,0.00%
ns1038.ui-dns.biz,0,0.00%,2,2,0.00%
dns212.b.register.com,0,0.00%,8,8,0.00%
seampcombr.com,0,0.00%,2,2,0.00%
shades04.rzone.de,0,0.00%,4,4,0.00%
ns1.hosteggs.com,0,0.00%,4,4,0.00%
ns3gmv.name.com,0,0.00%,6,6,0.00%
ns1124.ui-dns.org,0,0.00%,2,2,0.00%
ns15.thebeehost.com,0,0.00%,2,2,0.00%
ns2.IRANDNS.com,0,0.00%,2,2,0.00%
26569.venus.orderbox-dns.com,0,0.00%,2,2,0.00%
chloe.ns.cloudflare.com,0,0.00%,6,6,0.00%
ns2.hosteggs.com,0,0.00%,4,4,0.00%
piers.ns.cloudflare.com,0,0.00%,6,6,0.00%
rohin.ns.cloudflare.com,0,0.00%,3,3,0.00%
dns14.firestorm.ch,0,0.00%,2,2,0.00%
roxy.ns.cloudflare.com,0,0.00%,2,2,0.00%
ns2.doselesagencia.com,0,0.00%,2,2,0.00%
ns2.shoplocanda.com,0,0.00%,2,2,0.00%
dns13.firestorm-isp.com,0,0.00%,2,2,0.00%
ns.dandomain.dk,0,0.00%,10,10,0.00%
ns30.g-dns.com,0,0.00%,2,2,0.00%
ns2.thcservers.com,0,0.00%,2,2,0.00%
ns1.cargocollective.com,0,0.00%,4,4,0.00%
ns2.cargocollective.com,0,0.00%,8,8,0.00%
ns1.shoplocanda.com,0,0.00%,2,2,0.00%
ns1.meganameservers.eu,0,0.00%,2,2,0.00%
ns2.meganameservers.eu,0,0.00%,2,2,0.00%
sl.senseyun.com,0,0.00%,4,4,0.00%
ns303.hostgator.com.br,0,0.00%,2,2,0.00%
cloud4.thepowerhost.in,0,0.00%,2,2,0.00%
cloud3.thepowerhost.in,0,0.00%,2,2,0.00%
ns1.thepowerhost.in,0,0.00%,2,2,0.00%
ns04.domainserver.ne.jp,0,0.00%,2,2,0.00%
lance.dnspod.net,0,0.00%,2,2,0.00%
lara.ns.cloudflare.com,0,0.00%,4,4,0.00%
matt.ns.cloudflare.com,0,0.00%,6,6,0.00%
fish.dnspod.net,0,0.00%,2,2,0.00%
coconut.dnspod.net,0,0.00%,2,2,0.00%
ns-1859.awsdns-40.co.uk,0,0.00%,2,2,0.00%
nicole.ns.cloudflare.com,0,0.00%,2,2,0.00%
stand.dnspod.net,0,0.00%,2,2,0.00%
ns1117.ui-dns.com,0,0.00%,2,2,0.00%
concert.dnspod.net,0,0.00%,2,2,0.00%
june.ns.cloudflare.com,0,0.00%,4,4,0.00%
ns-16.awsdns-02.com,0,0.00%,2,2,0.00%
emma.dnspod.net,0,0.00%,2,2,0.00%
ns6.nbcuni.com,0,0.00%,2,2,0.00%
ns1048.ui-dns.biz,0,0.00%,2,2,0.00%
dns1.rumahosting.com,0,0.00%,4,4,0.00%
ns1.nbcuni.com,0,0.00%,2,2,0.00%
dns210.a.register.com,0,0.00%,2,2,0.00%
NS4.IRANDNS.com,0,0.00%,2,2,0.00%
ns2.nbcuni.com,0,0.00%,2,2,0.00%
ns5.nbcuni.com,0,0.00%,2,2,0.00%
ns3.wpx.net,0,0.00%,4,4,0.00%
ns1.rbe1.g-srv.net,0,0.00%,2,2,0.00%
dns2.web-hosting.com,0,0.00%,2,2,0.00%
ns1094.ui-dns.org,0,0.00%,2,2,0.00%
ns3.nbcuni.com,0,0.00%,2,2,0.00%
irns2.netafraz.com,0,0.00%,6,6,0.00%
ns03.trademarkarea.com,0,0.00%,2,2,0.00%
ns3.ctctdns.co.uk,0,0.00%,2,2,0.00%
ns4.nbcuni.com,0,0.00%,2,2,0.00%
ns02.trademarkarea.com,0,0.00%,2,2,0.00%
ns1.ctctdns.com,0,0.00%,2,2,0.00%
ns01.trademarkarea.com,0,0.00%,2,2,0.00%
ns-1041.awsdns-02.org,0,0.00%,2,2,0.00%
ns1.wpx.net,0,0.00%,4,4,0.00%
ns1.IRANDNS.com,0,0.00%,2,2,0.00%
dale.ns.cloudflare.com,0,0.00%,6,6,0.00%
ns-1994.awsdns-57.co.uk,0,0.00%,2,2,0.00%
ns2.newpages.us,0,0.00%,2,2,0.00%
ns03.domainserver.ne.jp,0,0.00%,2,2,0.00%
ns4.ctctdns.io,0,0.00%,2,2,0.00%
ns-470.awsdns-58.com,0,0.00%,2,2,0.00%
NS3.IRANDNS.com,0,0.00%,2,2,0.00%
ns1.scicube.us,0,0.00%,2,2,0.00%
ns29.g-dns.com,0,0.00%,2,2,0.00%
hundred.dnspod.net,0,0.00%,2,2,0.00%
ns-528.awsdns-02.net,0,0.00%,2,2,0.00%
ns2.itnetwork.co.th,0,0.00%,2,2,0.00%
ns1.newpages.us,0,0.00%,2,2,0.00%
ns2.ctctdns.net,0,0.00%,2,2,0.00%
kenneth.ns.cloudflare.com,0,0.00%,2,2,0.00%
melinda.ns.cloudflare.com,0,0.00%,3,3,0.00%
ns2.scicube.us,0,0.00%,2,2,0.00%
daphne.ns.cloudflare.com,0,0.00%,2,2,0.00%
ns1.itnetwork.co.th,0,0.00%,2,2,0.00%
zita.ns.cloudflare.com,0,0.00%,2,2,0.00%
dns1.safenames.com,0,0.00%,2,2,0.00%
ns6313.hostgator.com,0,0.00%,2,2,0.00%
ns133.mschosting.com,0,0.00%,2,2,0.00%
ns6314.hostgator.com,0,0.00%,2,2,0.00%
butterfly.dnspod.net,0,0.00%,2,2,0.00%
ns132.mschosting.com,0,0.00%,2,2,0.00%
ns1048.ui-dns.com,0,0.00%,2,2,0.00%
guppy.ezoicns.com,0,0.00%,2,2,0.00%
louis.dnspod.net,0,0.00%,2,2,0.00%
ns1076.ui-dns.biz,0,0.00%,4,4,0.00%
quoll.ezoicns.com,0,0.00%,2,2,0.00%
ns1061.ui-dns.org,0,0.00%,4,4,0.00%
ns1.madrakpro.com,0,0.00%,2,2,0.00%
ns2.ultahost.com,0,0.00%,2,2,0.00%
ns3.ultahost.com,0,0.00%,2,2,0.00%
ns4.ultahost.com,0,0.00%,2,2,0.00%
ns1.ultahost.com,0,0.00%,2,2,0.00%
ns1110.ui-dns.biz,0,0.00%,2,2,0.00%
ns5.routedns.net,0,0.00%,2,2,0.00%
ns2.wasps.net.au,0,0.00%,2,2,0.00%
ns6.routedns.net,0,0.00%,2,2,0.00%
ns2.arsuzweb.com,0,0.00%,2,2,0.00%
ns1.wasps.net.au,0,0.00%,2,2,0.00%
ns1.cloud.telenet.be,0,0.00%,2,2,0.00%
ns2.photocubs.com,0,0.00%,2,2,0.00%
ns1.arsuzweb.com,0,0.00%,2,2,0.00%
ns1.photocubs.com,0,0.00%,2,2,0.00%
ns-1346.awsdns-40.org,0,0.00%,2,2,0.00%
ns-1971.awsdns-54.co.uk,0,0.00%,2,2,0.00%
ns-42.awsdns-05.com,0,0.00%,2,2,0.00%
ns-628.awsdns-14.net,0,0.00%,4,4,0.00%
nsa1.srv53.net,0,0.00%,2,2,0.00%
nsb2.srv53.org,0,0.00%,2,2,0.00%
nsb2.srv53.net,0,0.00%,2,2,0.00%
act12.com,0,0.00%,14,14,0.00%
nsa3.srv53.org,0,0.00%,2,2,0.00%
ns1.nazwa.pl,0,0.00%,4,4,0.00%
nsd1.srv53.org,0,0.00%,2,2,0.00%
ns355.registrosdns.com,0,0.00%,2,2,0.00%
ns2.stwtx.com,0,0.00%,2,2,0.00%
cortney.ns.cloudflare.com,0,0.00%,10,10,0.00%
nsd3.srv53.com,0,0.00%,2,2,0.00%
aircraft.dnspod.net,0,0.00%,2,2,0.00%
ns1072.ui-dns.org,0,0.00%,5,5,0.00%
ns2.fwebi.com,0,0.00%,2,2,0.00%
secns20.fastcpanelserver.com,0,0.00%,2,2,0.00%
raina.ns.cloudflare.com,0,0.00%,6,6,0.00%
ns1.fwebi.com,0,0.00%,2,2,0.00%
ns1037.ui-dns.com,0,0.00%,2,2,0.00%
peerocolada.com,0,0.00%,2,2,0.00%
nsb2.srv53.com,0,0.00%,2,2,0.00%
ns1086.ui-dns.com,0,0.00%,2,2,0.00%
gracie.ns.cloudflare.com,0,0.00%,2,2,0.00%
sgprmns170.fastcpanelserver.com,0,0.00%,2,2,0.00%
ns2dhj.name.com,0,0.00%,2,2,0.00%
ns3jmt.name.com,0,0.00%,2,2,0.00%
ns22.migracem.com,0,0.00%,2,2,0.00%
ns1.velocitydatacenter3.biz,0,0.00%,2,2,0.00%
ns2.gatordns.net,0,0.00%,2,2,0.00%
ns4blx.name.com,0,0.00%,4,4,0.00%
radish.dnspod.net,0,0.00%,2,2,0.00%
ns21.migracem.com,0,0.00%,2,2,0.00%
ns1103.ui-dns.org,0,0.00%,4,4,0.00%
ns-1494.awsdns-58.org,0,0.00%,2,2,0.00%
jo.dnspod.net,0,0.00%,2,2,0.00%
nsc2.srv53.com,0,0.00%,2,2,0.00%
dns0.heteml.jp,0,0.00%,2,2,0.00%
dns180.a.register.com,0,0.00%,2,2,0.00%
ns534.umbler.com,0,0.00%,4,4,0.00%
ns-44.awsdns-05.com,0,0.00%,2,2,0.00%
dns1.heteml.jp,0,0.00%,2,2,0.00%
ns1106.ui-dns.com,0,0.00%,2,2,0.00%
ns11630.phdns24.es,0,0.00%,2,2,0.00%
r.ns.arvancdn.com,0,0.00%,2,2,0.00%
ns-953.awsdns-55.net,0,0.00%,2,2,0.00%
j.ns.arvancdn.com,0,0.00%,2,2,0.00%
ns1034.ui-dns.biz,0,0.00%,8,8,0.00%
ns1076.ui-dns.de,0,0.00%,6,6,0.00%
andy.ns.cloudflare.com,0,0.00%,4,4,0.00%
dns2.rebel.ca,0,0.00%,4,4,0.00%
ns283.umbler.com.br,0,0.00%,4,4,0.00%
brynne.ns.cloudflare.com,0,0.00%,2,2,0.00%
ns02.hostfactory.ch,0,0.00%,2,2,0.00%
shades09.rzone.de,0,0.00%,2,2,0.00%
dns11630.phdns24.es,0,0.00%,2,2,0.00%
terry.ns.cloudflare.com,0,0.00%,22,22,0.00%
ns3.everleap.com,0,0.00%,2,2,0.00%
ns2.singapore.cloudns.io,0,0.00%,2,2,0.00%
ns1054.ui-dns.de,0,0.00%,2,2,0.00%
ns1.singapore.cloudns.io,0,0.00%,2,2,0.00%
ace.ns.cloudflare.com,0,0.00%,5,5,0.00%
ns1.domaintechnik.at,0,0.00%,2,2,0.00%
ns01.hostfactory.ch,0,0.00%,2,2,0.00%
ns1.perevozim-gruz.com,0,0.00%,2,2,0.00%
ns2.everleap.com,0,0.00%,2,2,0.00%
ns-1409.awsdns-48.org,0,0.00%,2,2,0.00%
ns1.sswebtech.in,0,0.00%,2,2,0.00%
ns2.hawkhost.com,0,0.00%,6,6,0.00%
ns-1782.awsdns-30.co.uk,0,0.00%,2,2,0.00%
ns1102.ui-dns.biz,0,0.00%,2,2,0.00%
pdns82.ultradns.net,0,0.00%,2,2,0.00%
ns267.cretaforce.gr,0,0.00%,2,2,0.00%
cruz.ns.cloudflare.com,0,0.00%,2,2,0.00%
ns2.judes-wellbeing-health.com,0,0.00%,2,2,0.00%
ns-541.awsdns-03.net,0,0.00%,2,2,0.00%
bijoymedia.earth.orderbox-dns.com,0,0.00%,2,2,0.00%
ns2.sswebtech.in,0,0.00%,2,2,0.00%
bijoymedia.mars.orderbox-dns.com,0,0.00%,2,2,0.00%
ns-138-b.gandi.net,0,0.00%,2,2,0.00%
bijoymedia.mercury.orderbox-dns.com,0,0.00%,2,2,0.00%
ns2.perevozim-gruz.com,0,0.00%,2,2,0.00%
ns4.publicdnsservice.com,0,0.00%,4,4,0.00%
karina.ns.cloudflare.com,0,0.00%,2,2,0.00%
ns3.publicdnsservice.com,0,0.00%,4,4,0.00%
ns1.reclaimhosting.com,0,0.00%,2,2,0.00%
premium-ns1.dnsowl.com,0,0.00%,2,2,0.00%
dns3.netcloudns.com,0,0.00%,2,2,0.00%
ns2.reclaimhosting.com,0,0.00%,2,2,0.00%
rita.ns.cloudflare.com,0,0.00%,10,10,0.00%
ns2.publicdnsservice.com,0,0.00%,4,4,0.00%
dns3.dapurhosting.net,0,0.00%,4,4,0.00%
premium-ns2.dnsowl.com,0,0.00%,2,2,0.00%
ns20.prog.expert,0,0.00%,2,2,0.00%
dns4.netcloudns.com,0,0.00%,2,2,0.00%
ns1.publicdnsservice.com,0,0.00%,4,4,0.00%
premium-ns3.dnsowl.com,0,0.00%,2,2,0.00%
dns2.dwhost.net,0,0.00%,2,2,0.00%
pateorepublicx.com,0,0.00%,2,2,0.00%
dell.ns.cloudflare.com,0,0.00%,5,5,0.00%
pns24.cloudns.net,0,0.00%,2,2,0.00%
hassan.ns.cloudflare.com,0,0.00%,2,2,0.00%
ns-30-a.gandi.net,0,0.00%,2,2,0.00%
ns30.prog.expert,0,0.00%,2,2,0.00%
ns-146.awsdns-18.com,0,0.00%,2,2,0.00%
ns3.serversnow.co,0,0.00%,1,1,0.00%
pns22.cloudns.net,0,0.00%,2,2,0.00%
paylineker.com,0,0.00%,2,2,0.00%
pns21.cloudns.net,0,0.00%,2,2,0.00%
ns-1575.awsdns-04.co.uk,0,0.00%,2,2,0.00%
ns987.hostgator.com.br,0,0.00%,2,2,0.00%
dns3.dwhost.net,0,0.00%,2,2,0.00%
ns-909.awsdns-49.net,0,0.00%,2,2,0.00%
pns23.cloudns.net,0,0.00%,2,2,0.00%
ns201.prog.expert,0,0.00%,2,2,0.00%
ns1089.ui-dns.org,0,0.00%,4,4,0.00%
ns1059.ui-dns.biz,0,0.00%,4,4,0.00%
ns3.domaintechnik.at,0,0.00%,2,2,0.00%
ns-2027.awsdns-61.co.uk,0,0.00%,2,2,0.00%
ns2.serviceportapottyrentals.com,0,0.00%,2,2,0.00%
ns1095.ui-dns.com,0,0.00%,6,6,0.00%
ns1029.ui-dns.org,0,0.00%,4,4,0.00%
ns1.asmallorange.com,0,0.00%,2,2,0.00%
ns200.prog.expert,0,0.00%,2,2,0.00%
tegan.ns.cloudflare.com,0,0.00%,2,2,0.00%
ns1108.ui-dns.org,0,0.00%,2,2,0.00%
ns2.asmallorange.com,0,0.00%,2,2,0.00%
trace.ns.cloudflare.com,0,0.00%,2,2,0.00%
ns1026.ui-dns.de,0,0.00%,2,2,0.00%
ns2.domaintechnik.at,0,0.00%,2,2,0.00%
ns2.antagus.de,0,0.00%,2,2,0.00%
vessel.dnspod.net,0,0.00%,2,2,0.00%
ns1125.ui-dns.biz,0,0.00%,2,2,0.00%
ns4012.mochahost.com,0,0.00%,2,2,0.00%
volume.dnspod.net,0,0.00%,2,2,0.00%
ns1.partnerconsole.net,0,0.00%,2,2,0.00%
ns3012.mochahost.com,0,0.00%,2,2,0.00%
ns1.nethouse.ru,0,0.00%,4,4,0.00%
paw-facts.com,0,0.00%,2,2,0.00%
aws.vbnm.cf,0,0.00%,1,1,0.00%
ns4.domaintechnik.at,0,0.00%,2,2,0.00%
ns2.nethouse.ru,0,0.00%,4,4,0.00%
ns-1132.awsdns-13.org,0,0.00%,2,2,0.00%
ns1-01.azure-dns.com,0,0.00%,2,2,0.00%
ns2.pe7pxuxk3.com,0,0.00%,2,2,0.00%
ns2-01.azure-dns.net,0,0.00%,2,2,0.00%
ns3-01.azure-dns.org,0,0.00%,2,2,0.00%
ns4-01.azure-dns.info,0,0.00%,2,2,0.00%
ns.beonintermedia.com,0,0.00%,2,2,0.00%
ns1.pe7pxuxk3.com,0,0.00%,2,2,0.00%
pcbaojie.com,0,0.00%,2,2,0.00%
arya.ns.cloudflare.com,0,0.00%,11,11,0.00%
miles.ns.cloudflare.com,0,0.00%,3,3,0.00%
damiete.ns.cloudflare.com,0,0.00%,2,2,0.00%
ns-672.awsdns-20.net,0,0.00%,2,2,0.00%
dns1.harmonweb.net,0,0.00%,2,2,0.00%
keenan.ns.cloudflare.com,0,0.00%,6,6,0.00%
ingrid.ns.cloudflare.com,0,0.00%,4,4,0.00%
ns2.incauthorityweb.com,0,0.00%,6,6,0.00%
nicolas.ns.cloudflare.com,0,0.00%,6,6,0.00%
ns-1889.awsdns-44.co.uk,0,0.00%,2,2,0.00%
ns2.dataspaces.com,0,0.00%,10,10,0.00%
ns1.dataspaces.com,0,0.00%,10,10,0.00%
valentin.ns.cloudflare.com,0,0.00%,2,2,0.00%
dns086.a.register.com,0,0.00%,2,2,0.00%
ns2.dnshigh.com,0,0.00%,2,2,0.00%
jonah.ns.cloudflare.com,0,0.00%,4,4,0.00%
gardenia.dnspod.net,0,0.00%,2,2,0.00%
ns-1351.awsdns-40.org,0,0.00%,2,2,0.00%
us.guzelhosting.com,0,0.00%,4,4,0.00%
dns051.b.register.com,0,0.00%,6,6,0.00%
ns.galiciahosting.com,0,0.00%,2,2,0.00%
ns2.hostsilo.com,0,0.00%,4,4,0.00%
felipe.ns.cloudflare.com,0,0.00%,2,2,0.00%
ns1.weblium.com,0,0.00%,2,2,0.00%
ns3.nazwa.pl,0,0.00%,4,4,0.00%
dns2.talahost.com,0,0.00%,2,2,0.00%
ns1.hbahosting.com,0,0.00%,2,2,0.00%
dns205.a.register.com,0,0.00%,2,2,0.00%
ns1.eurodns.com,0,0.00%,6,6,0.00%
ns1.dnshigh.com,0,0.00%,2,2,0.00%
ns1.hostsilo.com,0,0.00%,4,4,0.00%
vda3300b.trouble-free.net,0,0.00%,2,2,0.00%
ns2.eurodns.com,0,0.00%,4,4,0.00%
sg.guzelhosting.com,0,0.00%,6,6,0.00%
ns2.nazwa.pl,0,0.00%,4,4,0.00%
ns2.dnscpanel.com,0,0.00%,2,2,0.00%
ns2111316.ztomy.com,0,0.00%,6,6,0.00%
ns-156-a.gandi.net,0,0.00%,2,2,0.00%
ns3.eurodns.com,0,0.00%,4,4,0.00%
ns-1348.awsdns-40.org,0,0.00%,2,2,0.00%
ns1.md-uk-2.webhostbox.net,0,0.00%,2,2,0.00%
ns4.eurodns.com,0,0.00%,4,4,0.00%
ns1.onetop-invest.com,0,0.00%,2,2,0.00%
ns11316.ztomy.com,0,0.00%,6,6,0.00%
danica.ns.cloudflare.com,0,0.00%,4,4,0.00%
sk.s5.cm.ns2.58.ztomy.com,0,0.00%,2,2,0.00%
ns-168-c.gandi.net,0,0.00%,2,2,0.00%
ns129.hostgator.com.br,0,0.00%,2,2,0.00%
pagadaconto.com,0,0.00%,2,2,0.00%
dns3.talahost.com,0,0.00%,2,2,0.00%
ns4.ekkhost.com,0,0.00%,2,2,0.00%
nirvana.easydns.net,0,0.00%,3,3,0.00%
lana.ns.cloudflare.com,0,0.00%,6,6,0.00%
ns2fhn.name.com,0,0.00%,2,2,0.00%
ns128.hostgator.com.br,0,0.00%,2,2,0.00%
ns2.jogjahost.co.id,0,0.00%,2,2,0.00%
ns1110.ui-dns.com,0,0.00%,3,3,0.00%
info653475.earth.orderbox-dns.com,0,0.00%,2,2,0.00%
ns1.jogjahost.co.id,0,0.00%,2,2,0.00%
cns2075.hostgator.com,0,0.00%,2,2,0.00%
cns2076.hostgator.com,0,0.00%,4,4,0.00%
pam.ns.cloudflare.com,0,0.00%,8,8,0.00%
ns4lqx.name.com,0,0.00%,2,2,0.00%
ns1.websupport.sk,0,0.00%,2,2,0.00%
ns2fwz.name.com,0,0.00%,2,2,0.00%
ns-443.awsdns-55.com,0,0.00%,4,4,0.00%
bayan.ns.cloudflare.com,0,0.00%,2,2,0.00%
ns1120.ui-dns.com,0,0.00%,4,4,0.00%
ns2.web.de,0,0.00%,4,4,0.00%
ns2.websupport.sk,0,0.00%,4,4,0.00%
info653475.mercury.orderbox-dns.com,0,0.00%,2,2,0.00%
parksproduce.com,0,0.00%,2,2,0.00%
ns3dgr.name.com,0,0.00%,2,2,0.00%
ns45.hostgator.mx,0,0.00%,2,2,0.00%
ns4.jogjahost.co.id,0,0.00%,2,2,0.00%
dns15.ovh.net,0,0.00%,1,1,0.00%
ns1058.ui-dns.biz,0,0.00%,3,3,0.00%
ns3.mdnsservice.com,0,0.00%,1,1,0.00%
ns3.hosting-services.net.au,0,0.00%,1,1,0.00%
nile.ns.cloudflare.com,0,0.00%,4,4,0.00%
motorhead.easydns.org,0,0.00%,3,3,0.00%
ns2.hosting-services.net.au,0,0.00%,1,1,0.00%
ns8.cnmsn.net,0,0.00%,10,10,0.00%
rush.easydns.com,0,0.00%,4,4,0.00%
vick.ns.cloudflare.com,0,0.00%,4,4,0.00%
ns1.mdnsservice.com,0,0.00%,4,4,0.00%
ns1.hosting-services.net.au,0,0.00%,1,1,0.00%
ns1.gg4dns.com.br,0,0.00%,1,1,0.00%
ns67.kebirhost.com,0,0.00%,1,1,0.00%
agent31.juming.com,0,0.00%,10,10,0.00%
ns4.cnolnic.com,0,0.00%,1,1,0.00%
ns66.kebirhost.com,0,0.00%,2,2,0.00%
ns3.cnolnic.com,0,0.00%,1,1,0.00%
ns2.gg4dns.com.br,0,0.00%,1,1,0.00%
x8.x9.client.api.vpngate2.jp,0,0.00%,3,3,0.00%
ns104.cloudns.net,0,0.00%,1,1,0.00%
adrian.ns.cloudflare.com,0,0.00%,6,6,0.00%
ns101.cloudns.net,0,0.00%,1,1,0.00%
ns103.cloudns.net,0,0.00%,1,1,0.00%
ns894.hostgator.com.br,0,0.00%,1,1,0.00%
ns895.hostgator.com.br,0,0.00%,1,1,0.00%
pns104.cloudns.net,0,0.00%,2,2,0.00%
ns1081.ui-dns.de,0,0.00%,4,4,0.00%
pns103.cloudns.net,0,0.00%,1,1,0.00%
ns1053.ui-dns.org,0,0.00%,4,4,0.00%
ns102.cloudns.net,0,0.00%,2,2,0.00%
ns1038.ui-dns.de,0,0.00%,1,1,0.00%
pns102.cloudns.net,0,0.00%,1,1,0.00%
hurricaneturf.com,0,0.00%,2,2,0.00%
pns101.cloudns.net,0,0.00%,2,2,0.00%
ns105.ovh.net,0,0.00%,1,1,0.00%
ns216.inhostedns.net,0,0.00%,2,2,0.00%
yolanda.ns.cloudflare.com,0,0.00%,6,6,0.00%
ns1027.ui-dns.com,0,0.00%,3,3,0.00%
verification-r28bz6zm.ns3.dan.hosting,0,0.00%,1,1,0.00%
ns1038.ui-dns.org,0,0.00%,4,4,0.00%
ns1023.ui-dns.biz,0,0.00%,4,4,0.00%
ns1029.ui-dns.com,0,0.00%,3,3,0.00%
ns2.webhostinghub.com,0,0.00%,2,2,0.00%
ns1.webhostinghub.com,0,0.00%,2,2,0.00%
onedscolprdjpe00.japaneast.cloudapp.azure.com,0,0.00%,2,2,0.00%
ns4.webhostingireland.eu,0,0.00%,4,4,0.00%
ns2.webhostingireland.ie,0,0.00%,4,4,0.00%
ns1.webhostingireland.ie,0,0.00%,4,4,0.00%
ns2.c021jp0715.info,0,0.00%,1,1,0.00%
17.push2his.eastmoney.com,0,0.00%,1,1,0.00%
ns1.c021jp0715.info,0,0.00%,2,2,0.00%
space.dingtalk.com,0,0.00%,1,1,0.00%
71.push2his.eastmoney.com,0,0.00%,4,4,0.00%
ns2.dnsnuts.com,0,0.00%,2,2,0.00%
dns2.hostiq.ua,0,0.00%,3,3,0.00%
dns1.hostiq.ua,0,0.00%,3,3,0.00%
ns2.linuxsupercloud.com,0,0.00%,2,2,0.00%
83.push2his.eastmoney.com,0,0.00%,2,2,0.00%
15.push2his.eastmoney.com,0,0.00%,1,1,0.00%
ns2.digitalpacific.com.au,0,0.00%,2,2,0.00%
ns4249.hostgator.com,0,0.00%,2,2,0.00%
ns8428.hostgator.com,0,0.00%,1,1,0.00%
ns4250.hostgator.com,0,0.00%,2,2,0.00%
ns8427.hostgator.com,0,0.00%,2,2,0.00%
ncomment.kuwo.cn,0,0.00%,2,2,0.00%
itinerantepistolaries.com,0,0.00%,1,1,0.00%
cftylngy.com,0,0.00%,2,2,0.00%
wp4.idcloudhost.com,0,0.00%,2,2,0.00%
cloud.lixueyang.site,0,0.00%,2,2,0.00%
wp3.idcloudhost.com,0,0.00%,1,1,0.00%
ns1.hostinger.com.br,0,0.00%,2,2,0.00%
2.push2his.eastmoney.com,0,0.00%,3,3,0.00%
19.push2his.eastmoney.com,0,0.00%,1,1,0.00%
ns3.hostinger.com.br,0,0.00%,2,2,0.00%
ns1.mywahosting.com,0,0.00%,5,5,0.00%
molly.ns.cloudflare.com,0,0.00%,2,2,0.00%
nsa.planethoster.net,0,0.00%,1,1,0.00%
yunbaijc.com,0,0.00%,2,2,0.00%
ns2.mywahosting.com,0,0.00%,5,5,0.00%
ns3.fabulous.com,0,0.00%,4,4,0.00%
ns2.hostinger.com.br,0,0.00%,1,1,0.00%
ns2.fabulous.com,0,0.00%,4,4,0.00%
ns-155-b.gandi.net,0,0.00%,1,1,0.00%
ns1.fabulous.com,0,0.00%,4,4,0.00%
cns1.sedoparking.com,0,0.00%,3,3,0.00%
ns-153-c.gandi.net,0,0.00%,1,1,0.00%
84.push2his.eastmoney.com,0,0.00%,1,1,0.00%
chance.ns.cloudflare.com,0,0.00%,4,4,0.00%
ns-1077.awsdns-06.org,0,0.00%,2,2,0.00%
peter.ns.cloudflare.com,0,0.00%,1,1,0.00%
ns-1752.awsdns-27.co.uk,0,0.00%,1,1,0.00%
ns-115-a.gandi.net,0,0.00%,2,2,0.00%
tani.ns.cloudflare.com,0,0.00%,2,2,0.00%
ns1.xbiz.ne.jp,0,0.00%,2,2,0.00%
ns-876.awsdns-45.net,0,0.00%,1,1,0.00%
ns1122.ui-dns.de,0,0.00%,2,2,0.00%
gerardo.ns.cloudflare.com,0,0.00%,5,5,0.00%
cns2.sedoparking.com,0,0.00%,3,3,0.00%
ns3.xbiz.ne.jp,0,0.00%,1,1,0.00%
ns1084.ui-dns.org,0,0.00%,1,1,0.00%
verification-9135b60d.ns3.dan.hosting,0,0.00%,2,2,0.00%
ns1066.ui-dns.biz,0,0.00%,1,1,0.00%
ns2.xbiz.ne.jp,0,0.00%,2,2,0.00%
ns1031.ui-dns.com,0,0.00%,2,2,0.00%
quentin.ns.cloudflare.com,0,0.00%,2,2,0.00%
ns4.openhostingservice.com,0,0.00%,2,2,0.00%
ns2.openhostingservice.com,0,0.00%,1,1,0.00%
ns5.openhostingservice.com,0,0.00%,1,1,0.00%
ns1.tutaryazilim.com,0,0.00%,2,2,0.00%
ns1.openhostingservice.com,0,0.00%,1,1,0.00%
ns3.openhostingservice.com,0,0.00%,1,1,0.00%
booln.com,0,0.00%,2,2,0.00%
ns78.domaincontrol.com,0,0.00%,1,1,0.00%
lacerta.dnspod.net,0,0.00%,2,2,0.00%
sara.ns.cloudflare.com,0,0.00%,4,4,0.00%
susan.ns.cloudflare.com,0,0.00%,2,2,0.00%
sl2.sedo.com,0,0.00%,1,1,0.00%
sl1.sedo.com,0,0.00%,1,1,0.00%
edward.ns.cloudflare.com,0,0.00%,2,2,0.00%
dns2.hostiners.com,0,0.00%,1,1,0.00%
us2.jetdino.com,0,0.00%,2,2,0.00%
dns.internic.ca,0,0.00%,1,1,0.00%
ns1.digitalpacific.com.au,0,0.00%,2,2,0.00%
us1.jetdino.com,0,0.00%,1,1,0.00%
ns1.server48.com,0,0.00%,2,2,0.00%
lisa.ns.cloudflare.com,0,0.00%,4,4,0.00%
ns3.digitalpacific.com,0,0.00%,1,1,0.00%
webquotestaticpic.dfcfw.com,0,0.00%,5,5,0.00%
ns4.digitalpacific.com,0,0.00%,2,2,0.00%
ns1.22.cn,0,0.00%,2,2,0.00%
ns4.panthur.com,0,0.00%,1,1,0.00%
ns2.server48.com,0,0.00%,1,1,0.00%
ns2.22.cn,0,0.00%,2,2,0.00%
ns2.panthur.com,0,0.00%,2,2,0.00%
ns1.panthur.com,0,0.00%,1,1,0.00%
ns3.panthur.com,0,0.00%,2,2,0.00%
ns1022.ui-dns.org,0,0.00%,1,1,0.00%
b-ir22.serverpars.com,0,0.00%,2,2,0.00%
ns1.dnsnuts.com,0,0.00%,1,1,0.00%
ns77.domaincontrol.com,0,0.00%,2,2,0.00%
a-ir22.serverpars.com,0,0.00%,2,2,0.00%
ns1048.ui-dns.de,0,0.00%,3,3,0.00%
ns1.linuxsupercloud.com,0,0.00%,1,1,0.00%
ns2.tutaryazilim.com,0,0.00%,1,1,0.00%
infinity9pro.shop,0,0.00%,1,1,0.00%
d.pizzacorporation.com,0,0.00%,2,2,0.00%
b.pizzacorporation.com,0,0.00%,4,4,0.00%
blair.ns.cloudflare.com,0,0.00%,1,1,0.00%
vda2800b.trouble-free.net,0,0.00%,2,2,0.00%
ns1.misspark.com,0,0.00%,32,32,0.00%
ns1.urano.servidor.net.br,0,0.00%,4,4,0.00%
ns-2042.awsdns-63.co.uk,0,0.00%,1,1,0.00%
treasure.ns.cloudflare.com,0,0.00%,3,3,0.00%
dns3.serverfreak.biz,0,0.00%,1,1,0.00%
ns2.urano.servidor.net.br,0,0.00%,4,4,0.00%
dns4.serverfreak.biz,0,0.00%,1,1,0.00%
elle.ns.cloudflare.com,0,0.00%,4,4,0.00%
ns-1445.awsdns-52.org,0,0.00%,1,1,0.00%
ns-2006.awsdns-58.co.uk,0,0.00%,1,1,0.00%
ns-794.awsdns-35.net,0,0.00%,1,1,0.00%
third-dns.netcup.net,0,0.00%,4,4,0.00%
watson.ns.cloudflare.com,0,0.00%,1,1,0.00%
second-dns.netcup.net,0,0.00%,3,3,0.00%
ulhas1.theprodns.com,0,0.00%,1,1,0.00%
dns7a.serverfreak.biz,0,0.00%,1,1,0.00%
ns-1043.awsdns-02.org,0,0.00%,1,1,0.00%
ns-2008.awsdns-59.co.uk,0,0.00%,1,1,0.00%
dns8.serverfreak.biz,0,0.00%,1,1,0.00%
chuck.ns.cloudflare.com,0,0.00%,6,6,0.00%
ns-209.awsdns-26.com,0,0.00%,2,2,0.00%
ns1.cowcart.net,0,0.00%,5,5,0.00%
dns8a.serverfreak.biz,0,0.00%,1,1,0.00%
uma.ns.cloudflare.com,0,0.00%,8,8,0.00%
ns2.cowcart.net,0,0.00%,5,5,0.00%
ns-1456.awsdns-54.org,0,0.00%,1,1,0.00%
alice.ns.cloudflare.com,0,0.00%,1,1,0.00%
ns-1880.awsdns-43.co.uk,0,0.00%,1,1,0.00%
ns-233.awsdns-29.com,0,0.00%,2,2,0.00%
ns-744.awsdns-29.net,0,0.00%,2,2,0.00%
ulhas2.theprodns.com,0,0.00%,2,2,0.00%
ns2.extraweb.az,0,0.00%,1,1,0.00%
ns02.smarthost.az,0,0.00%,1,1,0.00%
ns01.smarthost.az,0,0.00%,1,1,0.00%
ns1.extraweb.az,0,0.00%,2,2,0.00%
ns-128.awsdns-16.com,0,0.00%,2,2,0.00%
meilani.ns.cloudflare.com,0,0.00%,3,3,0.00%
ns2.misspark.com,0,0.00%,30,30,0.00%
ns-1354.awsdns-41.org,0,0.00%,1,1,0.00%
ns3.cafe24dns.co.kr,0,0.00%,2,2,0.00%
paris.ns.cloudflare.com,0,0.00%,10,10,0.00%
verification-d588aacb.ns3.dan.hosting,0,0.00%,6,6,0.00%
ns1.cafe24dns.co.kr,0,0.00%,2,2,0.00%
ns-112-b.gandi.net,0,0.00%,1,1,0.00%
ns5.cloudez.io,0,0.00%,1,1,0.00%
ns49.hostgator.com.br,0,0.00%,2,2,0.00%
damian.ns.cloudflare.com,0,0.00%,4,4,0.00%
ns4.cloudez.io,0,0.00%,2,2,0.00%
ns-1314.awsdns-36.org,0,0.00%,1,1,0.00%
ns-1694.awsdns-19.co.uk,0,0.00%,2,2,0.00%
desi.ns.cloudflare.com,0,0.00%,2,2,0.00%
ns1.cloudez.io,0,0.00%,1,1,0.00%
ns4.misspark.com,0,0.00%,30,30,0.00%
mcgrory.ns.cloudflare.com,0,0.00%,4,4,0.00%
marek.ns.cloudflare.com,0,0.00%,4,4,0.00%
ns1.storeinodns.com,0,0.00%,2,2,0.00%
ns-1272.awsdns-31.org,0,0.00%,4,4,0.00%
meiling.ns.cloudflare.com,0,0.00%,4,4,0.00%
ns-78-c.gandi.net,0,0.00%,1,1,0.00%
ns3.misspark.com,0,0.00%,15,15,0.00%
bryce.ns.cloudflare.com,0,0.00%,16,16,0.00%
ns-1955.awsdns-52.co.uk,0,0.00%,1,1,0.00%
ns2.cloudez.io,0,0.00%,1,1,0.00%
ns2.storeinodns.com,0,0.00%,2,2,0.00%
ns3.cloudez.io,0,0.00%,2,2,0.00%
coco.bunny.net,0,0.00%,7,7,0.00%
ns-524.awsdns-01.net,0,0.00%,1,1,0.00%
ns01.crystone.se,0,0.00%,2,2,0.00%
ns3.storeinodns.com,0,0.00%,2,2,0.00%
ns-2032.awsdns-62.co.uk,0,0.00%,2,2,0.00%
ns1.empretienda.net,0,0.00%,1,1,0.00%
ns4-l2.nic.ru,0,0.00%,14,14,0.00%
ns2.ilait.se,0,0.00%,2,2,0.00%
ns2.empretienda.net,0,0.00%,1,1,0.00%
ns2.headsite.se,0,0.00%,12,12,0.00%
ns2.frienddns.info,0,0.00%,24,24,0.00%
ns3.empretienda.net,0,0.00%,1,1,0.00%
v0n0.nic.sale,0,0.00%,6,6,0.00%
ns4.empretienda.net,0,0.00%,2,2,0.00%
ns2.jambofixhosting.com,0,0.00%,2,2,0.00%
kim.ns.cloudflare.com,0,0.00%,2,2,0.00%
ns1.netangels.ru,0,0.00%,2,2,0.00%
deb.ns.cloudflare.com,0,0.00%,1,1,0.00%
ns2.netangels.ru,0,0.00%,3,3,0.00%
lou.ns.cloudflare.com,0,0.00%,4,4,0.00%
ivan.ns.cloudflare.com,0,0.00%,4,4,0.00%
ns1.jambofixhosting.com,0,0.00%,2,2,0.00%
ns3.netangels.ru,0,0.00%,2,2,0.00%
ns1.inleed.net,0,0.00%,5,5,0.00%
ns1068.ui-dns.com,0,0.00%,2,2,0.00%
milan.ns.cloudflare.com,0,0.00%,4,4,0.00%
ns548.hostgator.com.br,0,0.00%,2,2,0.00%
dns2.cafe24.com,0,0.00%,4,4,0.00%
ns5.binero.se,0,0.00%,10,10,0.00%
clayton.ns.cloudflare.com,0,0.00%,6,6,0.00%
dns2.fastdns24.org,0,0.00%,4,4,0.00%
ns549.hostgator.com.br,0,0.00%,2,2,0.00%
ns4.netangels.ru,0,0.00%,1,1,0.00%
ns2.domdom.net,0,0.00%,1,1,0.00%
ns-244-a.gandi.net,0,0.00%,1,1,0.00%
dns1.cafe24.co.kr,0,0.00%,4,4,0.00%
59.push2his.eastmoney.com,0,0.00%,3,3,0.00%
ns2.beget.ru,0,0.00%,54,54,0.00%
ns-1495.awsdns-58.org,0,0.00%,1,1,0.00%
dns1.cafe24.com,0,0.00%,2,2,0.00%
ns-269.awsdns-33.com,0,0.00%,1,1,0.00%
ns-898.awsdns-48.net,0,0.00%,1,1,0.00%
balloon.dnspod.net,0,0.00%,2,2,0.00%
marissa.ns.cloudflare.com,0,0.00%,6,6,0.00%
ns3.resellerinterface.de,0,0.00%,2,2,0.00%
ns-128-c.gandi.net,0,0.00%,2,2,0.00%
ns1.resellerinterface.de,0,0.00%,2,2,0.00%
ns10.avishost.com,0,0.00%,2,2,0.00%
ns2.resellerinterface.de,0,0.00%,1,1,0.00%
ns58.sellvir.com,0,0.00%,1,1,0.00%
ns11.avishost.com,0,0.00%,1,1,0.00%
ns1.dnsmadeeasy.com,0,0.00%,4,4,0.00%
ns.makeshop.jp,0,0.00%,2,2,0.00%
ns2.makeshop.jp,0,0.00%,2,2,0.00%
ns2.inwx.de,0,0.00%,9,9,0.00%
ram.ns.cloudflare.com,0,0.00%,2,2,0.00%
ns2.inleed.net,0,0.00%,5,5,0.00%
ns1.ukit.com,0,0.00%,10,10,0.00%
v0n0.nic.school,0,0.00%,4,4,0.00%
ns2.platformalp.ru,0,0.00%,6,6,0.00%
zoe.ns.cloudflare.com,0,0.00%,4,4,0.00%
pola.ns.cloudflare.com,0,0.00%,4,4,0.00%
piper.ns.cloudflare.com,0,0.00%,2,2,0.00%
wesley.ns.cloudflare.com,0,0.00%,4,4,0.00%
shades13.rzone.de,0,0.00%,4,4,0.00%
savanna.ns.cloudflare.com,0,0.00%,2,2,0.00%
crystal.ns.cloudflare.com,0,0.00%,4,4,0.00%
corey.ns.cloudflare.com,0,0.00%,2,2,0.00%
jacob.ns.cloudflare.com,0,0.00%,3,3,0.00%
linda.ns.cloudflare.com,0,0.00%,2,2,0.00%
ns2.svenskadomaner.se,0,0.00%,2,2,0.00%
ns876.hostgator.com.br,0,0.00%,2,2,0.00%
ns2.1gb.ru,0,0.00%,4,4,0.00%
ns877.hostgator.com.br,0,0.00%,2,2,0.00%
ns4021.mochahost.com,0,0.00%,1,1,0.00%
ns4.spaceweb.pro,0,0.00%,14,14,0.00%
ns3021.mochahost.com,0,0.00%,2,2,0.00%
68.push2his.eastmoney.com,0,0.00%,2,2,0.00%
50.push2his.eastmoney.com,0,0.00%,7,7,0.00%
ns3.frienddns.net,0,0.00%,48,48,0.00%
23.push2his.eastmoney.com,0,0.00%,1,1,0.00%
ns2.whc.ca,0,0.00%,1,1,0.00%
ns3.whc.ca,0,0.00%,2,2,0.00%
ns1.whc.ca,0,0.00%,2,2,0.00%
ns2.seoadword.com,0,0.00%,1,1,0.00%
ns1099.ifastnet.com,0,0.00%,4,4,0.00%
b.gmoregistry.net,0,0.00%,2,2,0.00%
l.gmoregistry.net,0,0.00%,1,1,0.00%
k.gmoregistry.net,0,0.00%,1,1,0.00%
72.push2his.eastmoney.com,0,0.00%,2,2,0.00%
87.push2his.eastmoney.com,0,0.00%,1,1,0.00%
69.push2his.eastmoney.com,0,0.00%,4,4,0.00%
ns1042.ui-dns.de,0,0.00%,1,1,0.00%
ns3.headsite.se,0,0.00%,12,12,0.00%
ns2.bh-62.webhostbox.net,0,0.00%,2,2,0.00%
ns2.blackproject8120.shop,0,0.00%,1,1,0.00%
eleanor.ns.cloudflare.com,0,0.00%,6,6,0.00%
ns3.missdns.net,0,0.00%,2,2,0.00%
ns1.blackproject8120.shop,0,0.00%,1,1,0.00%
dns2018b.trouble-free.net,0,0.00%,2,2,0.00%
ns2.ballou.se,0,0.00%,2,2,0.00%
dns2018a.trouble-free.net,0,0.00%,1,1,0.00%
ns4.frienddns.net,0,0.00%,48,48,0.00%
ns3.ukit.com,0,0.00%,10,10,0.00%
ns362.hostgator.com.br,0,0.00%,2,2,0.00%
fiona.ns.cloudflare.com,0,0.00%,6,6,0.00%
ext.henzanapp.com,0,0.00%,8,8,0.00%
collabrtc.rtc.trafficmanager.net.b-0016.b-msedge.net,0,0.00%,2,2,0.00%
openmsf.msf.tencent-cloud.com,0,0.00%,2,2,0.00%
b-0016.b-msedge.net,0,0.00%,2,2,0.00%
9.courier-push-apple.com.akadns.net,0,0.00%,2,2,0.00%
statistic.live.126.net,0,0.00%,2,2,0.00%
yunxin-data-live-126-net-yq.ntes53.netease.com,0,0.00%,2,2,0.00%
contacts.fe.apple-dns.net,0,0.00%,4,4,0.00%
d28139t0r7hg1k.cloudfront.net,0,0.00%,1,1,0.00%
sadownload-new.mcafee.com.edgekey.net,0,0.00%,2,2,0.00%
wechat.intelcupid.com,0,0.00%,2,2,0.00%
alb-krmaiwe3bwhbkec015.cn-beijing.alb.aliyuncs.com,0,0.00%,2,2,0.00%
www.jl.news.cn,0,0.00%,2,2,0.00%
www.jl.xinhuanet.com,0,0.00%,2,2,0.00%
pixel-eu.rubiconproject.com,0,0.00%,2,2,0.00%
x01.aidata.io,0,0.00%,2,2,0.00%
sync.mathtag.com,0,0.00%,2,2,0.00%
pixel.rubiconproject.com,0,0.00%,6,6,0.00%
ssbsync-global.smartadserver.com,0,0.00%,2,2,0.00%
image8.pubmatic.com,0,0.00%,2,2,0.00%
match.adsrvr.org,0,0.00%,2,2,0.00%
x.bidswitch.net,0,0.00%,2,2,0.00%
pixel-eu.rubiconproject.net.akadns.net,0,0.00%,2,2,0.00%
usersync-geo-global.usersync-prod-sas.akadns.net,0,0.00%,2,2,0.00%
g.geogslb.com,0,0.00%,2,2,0.00%
ns2.global.gslb-ns.net,0,0.00%,2,2,0.00%
ns3.global.gslb-ns.net,0,0.00%,2,2,0.00%
ns1.global.gslb-ns.net,0,0.00%,2,2,0.00%
pixel.rubiconproject.net.akadns.net,0,0.00%,2,2,0.00%
pixel-origin.mathtag.com,0,0.00%,2,2,0.00%
user-data-apac-jp.bidswitch.net,0,0.00%,2,2,0.00%
ssbsync-apac1.smartadserver.com,0,0.00%,2,2,0.00%
ib.sin1.geoadnxs.com,0,0.00%,2,2,0.00%
ns1.apac.gslb-ns.net,0,0.00%,2,2,0.00%
s.amazon-adsystem.com,0,0.00%,2,2,0.00%
gum.sg1.vip.prod.criteo.com,0,0.00%,2,2,0.00%
id5-sync.com,0,0.00%,2,2,0.00%
s.cpx.to,0,0.00%,2,2,0.00%
pixel.quantserve.com,0,0.00%,2,2,0.00%
global.px.quantserve.com,0,0.00%,1,1,0.00%
kvt.sddan.com,0,0.00%,2,2,0.00%
slb-browser-traffic.mbgcdn.lenovo.com.cn,0,0.00%,2,2,0.00%
cloudrest.mbgcdn.lenovo.com.cn,0,0.00%,2,2,0.00%
nsl.mbgcdn.lenovo.com.cn,0,0.00%,2,2,0.00%
prebid.a-mo.net,0,0.00%,2,2,0.00%
bidder.criteo.com,0,0.00%,2,2,0.00%
a0.nic.io,0,0.00%,2,2,0.00%
shb.richaudience.com,0,0.00%,2,2,0.00%
ads.themoneytizer.com,0,0.00%,2,2,0.00%
bidder.sg1.vip.prod.criteo.com,0,0.00%,2,2,0.00%
1266287590.rsc.cdn77.org,0,0.00%,2,2,0.00%
ads.pubmatic.com,0,0.00%,2,2,0.00%
image2.pubmatic.com,0,0.00%,1,1,0.00%
doh.dns.apple.com.v.aaplimg.com,0,0.00%,2,2,0.00%
px-eu.adhigh.net,0,0.00%,2,2,0.00%
u2.amazonaws.com,0,0.00%,2,2,0.00%
elb-aws-jp-adizio-1511153879.ap-northeast-1.elb.amazonaws.com,0,0.00%,2,2,0.00%
c-bing-com.a-0001.a-msedge.net,0,0.00%,2,2,0.00%
dual-a-0001.a-msedge.net,0,0.00%,2,2,0.00%
widget.as.criteo.com,0,0.00%,2,2,0.00%
widget.sg1.vip.prod.criteo.com,0,0.00%,2,2,0.00%
creativecdn.com,0,0.00%,2,2,0.00%
cdn.connectad.io,0,0.00%,2,2,0.00%
sync.smartadserver.com,0,0.00%,2,2,0.00%
ice.360yield.com,0,0.00%,1,1,0.00%
ns-515.awsdns-00.net,0,0.00%,2,2,0.00%
rtb-csync-apac1.smartadserver.com,0,0.00%,2,2,0.00%
ssum-sec.casalemedia.com,0,0.00%,6,6,0.00%
sync.search.spotxchange.com,0,0.00%,2,2,0.00%
ssum-sec.casalemedia.com.cdn.cloudflare.net,0,0.00%,2,2,0.00%
sync.search-gtm.spotxchange.com.akadns.net,0,0.00%,2,2,0.00%
sin01.sync.search.spotxchange.com,0,0.00%,1,1,0.00%
image4.pubmatic.com,0,0.00%,2,2,0.00%
image4-v2.pubmnet.com,0,0.00%,2,2,0.00%
spug-sgc.pubmnet.com,0,0.00%,2,2,0.00%
ap.lijit.com,0,0.00%,3,3,0.00%
wu-bg-shim.trafficmanager.net,0,0.00%,4,4,0.00%
vap.lijit.com,0,0.00%,1,1,0.00%
acm-stoc.org,0,0.00%,2,2,0.00%
arc.trafficmanager.net,0,0.00%,4,4,0.00%
global.asimov.events.data.trafficmanager.net,0,0.00%,4,4,0.00%
tm1.dns-tm.com,0,0.00%,2,2,0.00%
tm2.dns-tm.com,0,0.00%,2,2,0.00%
ns4-09.azure-dns.info,0,0.00%,2,2,0.00%
onedscolprdjpw03.japanwest.cloudapp.azure.com,0,0.00%,2,2,0.00%
an.yandex.ru,0,0.00%,2,2,0.00%
gbapi.eastmoney.com,0,0.00%,4,4,0.00%
digicertwc.rubiconproject.com.edgekey.net,0,0.00%,2,2,0.00%
msn-cn.a-0032.a-msedge.net,0,0.00%,2,2,0.00%
eus.rubiconproject.com,0,0.00%,2,2,0.00%
vtnt.cnode.xyz,0,0.00%,4,4,0.00%
ad.turn.com,0,0.00%,2,2,0.00%
ad.turn.com.akadns.net,0,0.00%,2,2,0.00%
platformcn.maps.glbdns2.microsoft.com,0,0.00%,2,2,0.00%
fe-platformcn-maps-atm.trafficmanager.net,0,0.00%,2,2,0.00%
omgup1.xiaojukeji.com,0,0.00%,2,2,0.00%
hna-router-omg-v6.xiaojukeji.com,0,0.00%,2,2,0.00%
um.simpli.fi,0,0.00%,2,2,0.00%
ssp-sync.criteo.com,0,0.00%,2,2,0.00%
ssp-sync.sg1.vip.prod.criteo.com,0,0.00%,2,2,0.00%
geo-eu-us-sticky.delivery-prod-sas.akadns.net,0,0.00%,2,2,0.00%
eqx.smartadserver.com,0,0.00%,2,2,0.00%
www.tns-counter.ru,0,0.00%,2,2,0.00%
mail.arubafin.com,0,0.00%,2,2,0.00%
sync.adkernel.com,0,0.00%,2,2,0.00%
1.cpm.ak-is2.net,0,0.00%,2,2,0.00%
csm.sg1.as.criteo.net,0,0.00%,2,2,0.00%
csm.sg1.vip.prod.criteo.net,0,0.00%,2,2,0.00%
h.gtld-servers.net,0,0.00%,2,2,0.00%
api.home.news.cn,0,0.00%,2,2,0.00%
bbs.home.news.cn,0,0.00%,2,2,0.00%
t.news.cn,0,0.00%,2,2,0.00%
alb-fqpg5b5fb7n0izq8et.cn-hangzhou.alb.aliyuncs.com,0,0.00%,2,2,0.00%
8361147c-rh7400-rink2v-1d9xe.pccw.alrihla.net,0,0.00%,2,2,0.00%
g-msn-com-nsatc.trafficmanager.net,0,0.00%,2,2,0.00%
tm1.edgedns-tm.info,0,0.00%,4,4,0.00%
edge-microsoft-com.dual-a-0036.a-msedge.net,0,0.00%,4,4,0.00%
dual-a-0036.a-msedge.net,0,0.00%,2,2,0.00%
update1.sangfor.net.cdn20.com,0,0.00%,2,2,0.00%
guard.sec.xiaojukeji.com,0,0.00%,3,3,0.00%
n1.ofidc.com,0,0.00%,2,2,0.00%
hnb-router-pb-v6.diditaxi.com.cn,0,0.00%,2,2,0.00%
report.im.qcloud.com,0,0.00%,2,2,0.00%
ns4.ntes53.nease.net,0,0.00%,2,2,0.00%
ns1.ntes53.netease.com,0,0.00%,2,2,0.00%
ns5.ntes53.nease.net,0,0.00%,2,2,0.00%
cname.dict.ntes53.netease.com,0,0.00%,2,2,0.00%
dict.ntes53.netease.com,0,0.00%,2,2,0.00%
www.js.news.cn,0,0.00%,2,2,0.00%
www.js.xinhuanet.com,0,0.00%,2,2,0.00%
ns2-35.azure-dns.net,0,0.00%,4,4,0.00%
ns4-35.azure-dns.info,0,0.00%,4,4,0.00%
ns3-35.azure-dns.org,0,0.00%,4,4,0.00%
sh.mp.weixin.qq.com,0,0.00%,2,2,0.00%
reswx.tc.qq.com,0,0.00%,2,2,0.00%
mfn-sched.jcloud-cdn.com,0,0.00%,2,2,0.00%
39.courier-push-apple.com.akadns.net,0,0.00%,4,4,0.00%
update.eset.com,0,0.00%,6,6,0.00%
update.gtm.eset.com,0,0.00%,1,1,0.00%
pico.gtm.eset.com,0,0.00%,2,2,0.00%
fz.house.news.cn,0,0.00%,2,2,0.00%
fair.vnexpress.net,0,0.00%,2,2,0.00%
www.hainan.news.cn,0,0.00%,2,2,0.00%
mailfilter-ng-4.sunet.se,0,0.00%,4,4,0.00%
mailfilter-ng-3.sunet.se,0,0.00%,4,4,0.00%
mailfilter-ng-1.sunet.se,0,0.00%,4,4,0.00%
mailfilter-ng-2.sunet.se,0,0.00%,4,4,0.00%
smtp.uu.se,0,0.00%,4,4,0.00%
smtp-out1.uu.se,0,0.00%,4,4,0.00%
pinyin.thunisoft.com,0,0.00%,7,7,0.00%
kklulqbwyj3s3g2i2otjajef2a3kychks2t3agsbv2hdwtiymkbnueid.tor2web.in,0,0.00%,8,8,0.00%
api-shb1.pinduoduo.com,0,0.00%,2,2,0.00%
sina.cn,0,0.00%,8,8,0.00%
ffapi.baidu.com,0,0.00%,2,2,0.00%
wap.cmpassport.com,0,0.00%,4,4,0.00%
m.sogo.com,0,0.00%,5,5,0.00%
updates.os.nfschina.com,0,0.00%,7,7,0.00%
doh-ch.blahdns.com,0,0.00%,4,4,0.00%
cfw9ceoxz.uyoo.gq,0,0.00%,1,1,0.00%
grs.dbankcloud.cn,0,0.00%,6,6,0.00%
grs.dbankcloud.eu,0,0.00%,3,3,0.00%
jddriving.theorytestpro.co.uk,0,0.00%,1,1,0.00%
q.rising.cn,0,0.00%,4,4,0.00%
onedriveclucproddm20006.blob.core.windows.net,0,0.00%,3,3,0.00%
sat02pap001.storage.live.com,0,0.00%,2,2,0.00%
g-ns-1167.awsdns-15.com,0,0.00%,2,2,0.00%
g-ns-591.awsdns-15.com,0,0.00%,2,2,0.00%
g-ns-1743.awsdns-15.com,0,0.00%,2,2,0.00%
g-ns-16.awsdns-15.com,0,0.00%,2,2,0.00%
am.zdmimg.com,0,0.00%,2,2,0.00%
sploit-edge.smartscreen.microsoft.com,0,0.00%,9,9,0.00%
ksn-tcert-geo.kaspersky-labs.com,0,0.00%,8,8,0.00%
comment-api.smzdm.com,0,0.00%,2,2,0.00%
d3u8eo6n4jxbvx.cloudfront.net,0,0.00%,1,1,0.00%
gs-drcn.game.dbankcloud.com,0,0.00%,2,2,0.00%
vd6.l.qq.com,0,0.00%,4,4,0.00%
i0.hdslb.com.04f6a54d.c.cdnhwc1.com,0,0.00%,2,2,0.00%
c7b8e2a2072947f68801c5f7a2687135.fp.measure.office.com,0,0.00%,1,1,0.00%
union.video.qq.com,0,0.00%,4,4,0.00%
nodeyun.video.qq.com,0,0.00%,4,4,0.00%
vip.video.qq.com,0,0.00%,6,6,0.00%
pbaccess.video.qq.com,0,0.00%,4,4,0.00%
htwuhan.oss-cn-beijing.aliyuncs.com,0,0.00%,2,2,0.00%
i-dsm01p-cor004.api.p001.1drv.com,0,0.00%,2,2,0.00%
weather.api.moji.com,0,0.00%,2,2,0.00%
discovery-v4-4.syncthing.net,0,0.00%,2,2,0.00%
galleon.dmall.com,0,0.00%,2,2,0.00%
gwmini.dmall.com,0,0.00%,2,2,0.00%
logman.dmall.com,0,0.00%,2,2,0.00%
cnj8p3hx.sched.sma-dk.tdnsstic1.cn.cjt.krcdn.idatacube.com,0,0.00%,2,2,0.00%
track.mediav.com,0,0.00%,3,3,0.00%
popup.browser.360.cn,0,0.00%,2,2,0.00%
api.zhaomishijie.com,0,0.00%,2,2,0.00%
papi.look.360.cn,0,0.00%,5,5,0.00%
open.onebox.so.com,0,0.00%,2,2,0.00%
apps.webofknowledge.com,0,0.00%,2,2,0.00%
www.isay365.com,0,0.00%,2,2,0.00%
query.rec.360.cn,0,0.00%,3,3,0.00%
a.dmall.com,0,0.00%,2,2,0.00%
static.dmall.com,0,0.00%,2,2,0.00%
api-pricetag.dmall.com,0,0.00%,2,2,0.00%
rec.dmall.com,0,0.00%,2,2,0.00%
p204-fmfmobile.icloud.com.cn,0,0.00%,2,2,0.00%
fmfmobile.fe.apple-dns.cn,0,0.00%,2,2,0.00%
p204-keyvalueservice.icloud.com.cn,0,0.00%,2,2,0.00%
mum.m.alibaba.com,0,0.00%,2,2,0.00%
configuration.apple.com.akadns.net,0,0.00%,10,10,0.00%
api-mayi.django.t.taobao.com,0,0.00%,2,2,0.00%
api-sh.django.t.taobao.com.gds.alibabadns.com,0,0.00%,2,2,0.00%
m.npdfr1.ga,0,0.00%,1,1,0.00%
uri6.com,0,0.00%,2,2,0.00%
hc3.tdm.qq.com,0,0.00%,2,2,0.00%
cdn.mairuan.com,0,0.00%,2,2,0.00%
www.mathtype.cn,0,0.00%,2,2,0.00%
www.googleoptimize.com,0,0.00%,2,2,0.00%
beian.miit.gov.cn,0,0.00%,2,2,0.00%
w.cnzz.com,0,0.00%,2,2,0.00%
ip2072148258.funshion.com,0,0.00%,4,4,0.00%
pic.mairuan.com,0,0.00%,2,2,0.00%
tj.makeding.com,0,0.00%,2,2,0.00%
api3.mairuan.com,0,0.00%,2,2,0.00%
wp.qiye.qq.com,0,0.00%,2,2,0.00%
t.gdt.qq.com,0,0.00%,2,2,0.00%
admin.qidian.qq.com,0,0.00%,2,2,0.00%
chat.qidian.qq.com,0,0.00%,2,2,0.00%
consolecgi.qidian.qq.com,0,0.00%,2,2,0.00%
pingtas.qq.com,0,0.00%,2,2,0.00%
v.qidian.qq.com,0,0.00%,4,4,0.00%
fereport.qidian.qq.com,0,0.00%,2,2,0.00%
tamaegis.com,0,0.00%,2,2,0.00%
ins-609loygs.ias.tencent-cloud.net,0,0.00%,2,2,0.00%
bh4d9od16a-dsn.algolia.net,0,0.00%,1,1,0.00%
wx-women.kcs2.top,0,0.00%,2,2,0.00%
api.sobot.com,0,0.00%,2,2,0.00%
coral520.github.io,0,0.00%,1,1,0.00%
thirdwx.qlogo.cn,0,0.00%,8,8,0.00%
apm.wetest.qq.com,0,0.00%,2,2,0.00%
gpcloud.tgpa.qq.com,0,0.00%,2,2,0.00%
90a0561c-b997-4151-8a6b-16af40f4446d.hk.node.touhou.earth,0,0.00%,4,4,0.00%
moapi.wps.cn,0,0.00%,2,2,0.00%
meeting.kdocs.cn,0,0.00%,2,2,0.00%
getip.wps.cn,0,0.00%,2,2,0.00%
f3.duba.com,0,0.00%,2,2,0.00%
api.md.wpscdn.cn,0,0.00%,1,1,0.00%
dl.wps.md.wpscdn.cn,0,0.00%,1,1,0.00%
cn.patch.battle.net,0,0.00%,6,6,0.00%
mail.nfs-china.com,0,0.00%,13,13,0.00%
dove.xueqiu.com,0,0.00%,2,2,0.00%
utoken.umeng.com,0,0.00%,1,1,0.00%
qmas.xueqiu.com,0,0.00%,1,1,0.00%
xqsj.gjzq.com.cn,0,0.00%,2,2,0.00%
xueqiu.glsc.com.cn,0,0.00%,1,1,0.00%
xueqiu.com,0,0.00%,1,1,0.00%
xqdoc.imedao.com,0,0.00%,1,1,0.00%
open.xueqiu.com,0,0.00%,3,3,0.00%
8uof.herokuapp.com,0,0.00%,1,1,0.00%
al-conf.tianti.com,0,0.00%,1,1,0.00%
tnc3-alisc1.zijieapi.com,0,0.00%,1,1,0.00%
only-759349-159-226-95-33.nstool.zhuanzfx.com,0,0.00%,1,1,0.00%
conn5.coloros.com,0,0.00%,2,2,0.00%
lcdn-locator.apple.com,0,0.00%,3,3,0.00%
i6.weather.oppomobile.com,0,0.00%,1,1,0.00%
quality-cdn.shouji.sogou.com,0,0.00%,1,1,0.00%
vpa-cdn.shouji.sogou.com,0,0.00%,1,1,0.00%
mini.ffnews.cn,0,0.00%,2,2,0.00%
show-g.mediav.com,0,0.00%,5,5,0.00%
cos.ffnews.cn,0,0.00%,1,1,0.00%
api.ffnews.cn,0,0.00%,1,1,0.00%
s3m5.fenxi.com,0,0.00%,1,1,0.00%
ssxd.mediav.com,0,0.00%,12,12,0.00%
mmstl-tianhe.tanx.com,0,0.00%,1,1,0.00%
mo.m.tmall.com,0,0.00%,1,1,0.00%
eid.jd.com,0,0.00%,4,4,0.00%
mars.jd.com,0,0.00%,3,3,0.00%
perf.m.jd.com,0,0.00%,3,3,0.00%
115.lingdiany.com,0,0.00%,1,1,0.00%
ccflbs.m.jd.com,0,0.00%,3,3,0.00%
aks.jdpay.com,0,0.00%,6,6,0.00%
anti-sdk-report.m.jd.com,0,0.00%,3,3,0.00%
ccfjma.m.jd.com,0,0.00%,3,3,0.00%
rjsb-token-m.jd.com,0,0.00%,3,3,0.00%
policy.jd.com,0,0.00%,3,3,0.00%
jpushjd.m.jd.com,0,0.00%,3,3,0.00%
ex.m.jd.com,0,0.00%,3,3,0.00%
un.m.jd.com,0,0.00%,3,3,0.00%
lbsapi.m.jd.com,0,0.00%,3,3,0.00%
blackhole.m.jd.com,0,0.00%,3,3,0.00%
lbsgw.m.jd.com,0,0.00%,3,3,0.00%
im-x.jd.com,0,0.00%,1,1,0.00%
plogin.m.jd.com,0,0.00%,3,3,0.00%
land.024888.net,0,0.00%,1,1,0.00%
ossresource.win-stock.com.cn,0,0.00%,1,1,0.00%
www.csrc.gov.cn,0,0.00%,1,1,0.00%
cicc.m.zhiye.com,0,0.00%,1,1,0.00%
v6.s.360.cn,0,0.00%,3,3,0.00%
res2.wx.qq.com,0,0.00%,1,1,0.00%
t.wg.360-api.cn,0,0.00%,2,2,0.00%
www.xiaohongshu.com,0,0.00%,8,8,0.00%
crash.xiaohongshu.com,0,0.00%,10,10,0.00%
adashxgc.ut.taobao.com,0,0.00%,8,8,0.00%
lng.xiaohongshu.com,0,0.00%,11,11,0.00%
l.gm.mob.com,0,0.00%,8,8,0.00%
odc.officeapps.live.com,0,0.00%,1,1,0.00%
cdn.odc.officeapps.live.com,0,0.00%,2,2,0.00%
rn-resource-app.xiaohongshu.com,0,0.00%,8,8,0.00%
fe-static.xhscdn.com,0,0.00%,5,5,0.00%
uspider.yuanshen.com,0,0.00%,2,2,0.00%
netmon.stat.360safe.com,0,0.00%,5,5,0.00%
static.360.cn,0,0.00%,3,3,0.00%
api.game.360.cn,0,0.00%,3,3,0.00%
bt.xxx-tracker.com,0,0.00%,11,11,0.00%
tracker.pirateparty.gr,0,0.00%,22,22,0.00%
tracker.devil-torrents.pl,0,0.00%,11,11,0.00%
public.144dns.com,0,0.00%,4,4,0.00%
xdzyfw.10jqka.com.cn,0,0.00%,2,2,0.00%
omgup.xiaojukeji.com,0,0.00%,4,4,0.00%
freight.xiaojukeji.com,0,0.00%,4,4,0.00%
raven.xiaojukeji.com,0,0.00%,4,4,0.00%
crl.digicert-cn.com,0,0.00%,2,2,0.00%
connect.facebook.net,0,0.00%,3,3,0.00%
wwads.cn,0,0.00%,3,3,0.00%
analyticspixel.microsoft.com,0,0.00%,2,2,0.00%
passport.csdn.net,0,0.00%,2,2,0.00%
encrypted-tbn0.gstatic.com,0,0.00%,4,4,0.00%
pica.zhimg.com.download.ks-cdn.com,0,0.00%,2,2,0.00%
2022.acmmm.org,0,0.00%,1,1,0.00%
ipv4-ipv6-phase4.cat.sh.vip.dianping.com,0,0.00%,2,2,0.00%
prism-report-knb.dreport.meituan.net,0,0.00%,1,1,0.00%
tw14.virtual-strike.com,0,0.00%,1,1,0.00%
event.xiaohongshu.com,0,0.00%,2,2,0.00%
m.igame.163.com,0,0.00%,3,3,0.00%
meishi.meituan.com,0,0.00%,2,2,0.00%
m.360buyimg.com,0,0.00%,2,2,0.00%
ie-api.sreminder.cn,0,0.00%,2,2,0.00%
117-num.teddymobile.cn,0,0.00%,2,2,0.00%
imgcps.jd.com,0,0.00%,2,2,0.00%
ins-g4ztq7u7.ias.tencent-cloud.net,0,0.00%,4,4,0.00%
img2x-v6-sched.jcloudedge.com,0,0.00%,2,2,0.00%
collector.github.com,0,0.00%,2,2,0.00%
github-cloud.s3.amazonaws.com,0,0.00%,2,2,0.00%
37.courier-push-apple.com.akadns.net,0,0.00%,10,10,0.00%
calendars.icloud.com,0,0.00%,4,4,0.00%
caldav.fe.apple-dns.cn,0,0.00%,4,4,0.00%
download.gfe.nvidia.com,0,0.00%,2,2,0.00%
securepubads.g.doubleclick.net,0,0.00%,4,4,0.00%
api.redisinsight.redislabs.com,0,0.00%,1,1,0.00%
p208-caldav.icloud.com.cn,0,0.00%,2,2,0.00%
mobads-logs.baidu.com,0,0.00%,2,2,0.00%
quark.sm.cn,0,0.00%,2,2,0.00%
so-h3.upaas.uc.cn,0,0.00%,2,2,0.00%
image-ad.sm.cn,0,0.00%,2,2,0.00%
openacs4uc.m.taobao.com,0,0.00%,2,2,0.00%
pns.alicdn.com,0,0.00%,2,2,0.00%
wolong-dsp.sm.cn,0,0.00%,2,2,0.00%
uc9.ucweb.com,0,0.00%,2,2,0.00%
broccoli.uc.cn,0,0.00%,2,2,0.00%
loginservice.kugou.com,0,0.00%,4,4,0.00%
characteristics.service.kugou.com,0,0.00%,2,2,0.00%
iflow-api.uc.cn,0,0.00%,2,2,0.00%
cms.uc.cn,0,0.00%,2,2,0.00%
pis.alicdn.com,0,0.00%,2,2,0.00%
wea.uc.cn,0,0.00%,2,2,0.00%
track.uc.cn,0,0.00%,2,2,0.00%
ff.uc.cn,0,0.00%,2,2,0.00%
ff.dayu.com,0,0.00%,2,2,0.00%
udpolimeok.baidu.com,0,0.00%,6,6,0.00%
sugs.m.sm.cn,0,0.00%,2,2,0.00%
sdk-log.partner.sm.cn,0,0.00%,2,2,0.00%
s-adashx.ut.uc.cn,0,0.00%,2,2,0.00%
quantify.v.xunlei.com,0,0.00%,2,2,0.00%
gaode-jmacs.m.taobao.com,0,0.00%,4,4,0.00%
openjmacs4uc.m.taobao.com,0,0.00%,2,2,0.00%
slp2p-east-biz02.oray.net,0,0.00%,2,2,0.00%
log.m.sm.cn,0,0.00%,2,2,0.00%
e2cs17.gcp.gvt2.com,0,0.00%,2,2,0.00%
px.effirst.com,0,0.00%,4,4,0.00%
coral-task.uc.cn,0,0.00%,2,2,0.00%
mparticle.uc.cn,0,0.00%,2,2,0.00%
m.uczzd.cn,0,0.00%,2,2,0.00%
page-sm-cn.sm-tc.cn,0,0.00%,2,2,0.00%
safe.ucweb.com,0,0.00%,2,2,0.00%
wolong.sm.cn,0,0.00%,2,2,0.00%
nearby-drcn.platform.dbankcloud.com,0,0.00%,2,2,0.00%
maas.mail.163.com,0,0.00%,2,2,0.00%
order.sm.cn,0,0.00%,2,2,0.00%
mailpub.nosdn.127.net,0,0.00%,4,4,0.00%
client.tv.uc.cn,0,0.00%,1,1,0.00%
consumer.entitlement.skype.com,0,0.00%,2,2,0.00%
voice-service.uc.cn,0,0.00%,2,2,0.00%
www.miaoshoucdn.com,0,0.00%,2,2,0.00%
u.miaoshoucdn.com,0,0.00%,2,2,0.00%
desktop-release.notion-static.com,0,0.00%,4,4,0.00%
logs-01.loggly.com,0,0.00%,4,4,0.00%
http-inputs-notion.splunkcloud.com,0,0.00%,4,4,0.00%
servicewechat.com,0,0.00%,6,6,0.00%
c.sm.cn,0,0.00%,2,2,0.00%
emoji.uc.cn,0,0.00%,2,2,0.00%
pssn.alicdn.com,0,0.00%,2,2,0.00%
baijiahao.baidu.com,0,0.00%,4,4,0.00%
teams-ring.msedge.net,0,0.00%,4,4,0.00%
wedocare.com,0,0.00%,2,2,0.00%
cdn.uviewui.com,0,0.00%,2,2,0.00%
referee.xiaohongshu.com,0,0.00%,2,2,0.00%
t3.xiaohongshu.com,0,0.00%,2,2,0.00%
kds.wps.cn,0,0.00%,2,2,0.00%
service-jfd9xofd-1301650804.sh.apigw.tencentcs.com,0,0.00%,2,2,0.00%
service-jayntqrk-1301650804.gz.apigw.tencentcs.com,0,0.00%,2,2,0.00%
commnat-main-gc.ess.apple.com,0,0.00%,2,2,0.00%
p29-keyvalueservice.icloud.com.cn,0,0.00%,2,2,0.00%
na61-na62.wagbridge.alibaba.taobao.com,0,0.00%,2,2,0.00%
commnat-main-gc.ess-apple.com.akadns.net,0,0.00%,2,2,0.00%
jtrn.is.autonavi.com.gds.alibabadns.com,0,0.00%,2,2,0.00%
init-cdn.itunes-apple.com.akadns.net,0,0.00%,6,6,0.00%
www.icloud.g.aaplimg.com,0,0.00%,2,2,0.00%
cl2-cn.ls-apple.com.akadns.net,0,0.00%,2,2,0.00%
ins-gzw2jbpv.ias.tencent-cloud.net,0,0.00%,4,4,0.00%
furtive-cobalt-ec1.notion.site,0,0.00%,3,3,0.00%
api.adguard.com,0,0.00%,8,8,0.00%
dcs.foxitreader.cn,0,0.00%,2,2,0.00%
mucp.api.account.microsoft.com,0,0.00%,2,2,0.00%
app.grammarly.com,0,0.00%,4,4,0.00%
www.flickr.com,0,0.00%,4,4,0.00%
st.pinyin.sogou.com,0,0.00%,6,6,0.00%
s3gw.cmbchina.com,0,0.00%,2,2,0.00%
gz-lb1.internet.v6.spanner.alipaydns.com,0,0.00%,8,8,0.00%
www.23tm.com,0,0.00%,4,4,0.00%
seeds-open.xycdn.com.gslb.kuiniuca.com,0,0.00%,2,2,0.00%
push-rtmp-vr-f5.s.bytefcdn.com,0,0.00%,3,3,0.00%
pull-rtmp-l27.douyincdn.com.live-play.galileo.jcloud-cdn.com,0,0.00%,2,2,0.00%
push-rtmp-f5-vs.douyincdn.com.c.bytefcdn.com,0,0.00%,2,2,0.00%
6d62457f7ffb2595a54f0d1612405733.free-lbv26.idouyinvod.com,0,0.00%,2,2,0.00%
push-rtmp-l26-cny.douyincdn.com.c.cdnhwc3.com,0,0.00%,2,2,0.00%
push-rtmp-l95.douyincdn.com.ctdns.cn,0,0.00%,2,2,0.00%
pull-flv-l27.douyincdn.com.live-play.galileo.jcloud-cdn.com,0,0.00%,2,2,0.00%
pull-flv-f26.douyincdn.com.c.cdnhwc3.com,0,0.00%,2,2,0.00%
pull-hls-f13.douyincdn.com.a.bdydns.com,0,0.00%,2,2,0.00%
pull-hls-f29.douyincdn.com.ucloud.com.cn,0,0.00%,2,2,0.00%
push-rtmp-f5-cny.douyincdn.com.c.bytefcdn.com,0,0.00%,2,2,0.00%
pull-rtmp-l95.douyincdn.com.ctdns.cn,0,0.00%,2,2,0.00%
pull-flv-l11-cny.douyincdn.com.tcdnlive.com,0,0.00%,2,2,0.00%
push-rtmp-spe-l3.douyincdn.com.230b2a2545cfa773.queniufm.com,0,0.00%,2,2,0.00%
pull-rtmp-f29.douyincdn.com.ucloud.com.cn,0,0.00%,4,4,0.00%
push-rtmp-vr-l3.douyincdn.com.230b2a2545cfa773.queniufm.com,0,0.00%,2,2,0.00%
tuzhi.23tm.com,0,0.00%,2,2,0.00%
static.wishingstarmoye.com,0,0.00%,1,1,0.00%
1671aab.ne.gladns.com,0,0.00%,4,4,0.00%
1671aab.nb.gladns.com,0,0.00%,3,3,0.00%
1671aab.nh.gladns.com,0,0.00%,4,4,0.00%
1671aab.nc.gladns.com,0,0.00%,2,2,0.00%
1671aab.ng.gladns.com,0,0.00%,2,2,0.00%
www.gstatic.cn,0,0.00%,12,12,0.00%
1671aab.nf.gladns.com,0,0.00%,2,2,0.00%
1671aab.nd.gladns.com,0,0.00%,4,4,0.00%
1671aab.na.gladns.com,0,0.00%,2,2,0.00%
dispatcher.is.autonavi.com.gds.alibabadns.com,0,0.00%,3,3,0.00%
sa4.tuisong.baidu.com,0,0.00%,2,2,0.00%
img.wishingstarmoye.com,0,0.00%,1,1,0.00%
api.gotokeep.com,0,0.00%,2,2,0.00%
frodo.douban.com,0,0.00%,2,2,0.00%
appdump.nie.netease.com,0,0.00%,2,2,0.00%
onedscolprdcus14.centralus.cloudapp.azure.com,0,0.00%,2,2,0.00%
appdump-lbc.nie.netease.com,0,0.00%,2,2,0.00%
kgb-ifs.tanx.com,0,0.00%,2,2,0.00%
b-gtc.getui.net,0,0.00%,2,2,0.00%
www.sublimetext.com,0,0.00%,2,2,0.00%
amcore.rest.gti.mcafee.com,0,0.00%,2,2,0.00%
yccc.123nat.com,0,0.00%,2,2,0.00%
www.doudoubird.cn,0,0.00%,2,2,0.00%
h5.vedamobi.com,0,0.00%,2,2,0.00%
c.tile.openstreetmap.org,0,0.00%,2,2,0.00%
auth.api.nsfocus.com,0,0.00%,6,6,0.00%
9d25867f05e5e2923fc23a9b16092b00.dl.txcdns.com,0,0.00%,2,2,0.00%
ocsp.sectigo.com,0,0.00%,1,1,0.00%
tc.forward.douban.com,0,0.00%,2,2,0.00%
w82414s.astarvpn.center,0,0.00%,1,1,0.00%
cn-sh.sasg4e.ccddns.lol,0,0.00%,2,2,0.00%
l-0003.l-dc-msedge.NET,0,0.00%,2,2,0.00%
magic.h3c.com,0,0.00%,2,2,0.00%
spec.pdfxd.com,0,0.00%,2,2,0.00%
yijirecovery.com,0,0.00%,4,4,0.00%
log.miwifi.com,0,0.00%,4,4,0.00%
1ef35d170f3956199fc0feb0ccac0747.safeframe.googlesyndication.com,0,0.00%,1,1,0.00%
pixel.tapad.com,0,0.00%,2,2,0.00%
0du-u492b3ee0-c48-a1d49-s1661320863-i9fe25f48-0.ap.dotnxdomain.net,0,0.00%,1,1,0.00%
0ds-u492b3ee0-c48-a1d49-s1661320863-i9fe25f48-0.ap.dotnxdomain.net,0,0.00%,1,1,0.00%
04u-u492b3ee0-c48-a1d49-s1661320863-i9fe25f48-0.ap.dotnxdomain.net,0,0.00%,1,1,0.00%
14u-u492b3ee0-c48-a1d49-s1661320863-i9fe25f48-0.ap.dotnxdomain.net,0,0.00%,1,1,0.00%
sync.go.sonobi.com,0,0.00%,1,1,0.00%
mx.cstnet.cn,0,0.00%,16,16,0.00%
pixel-sync.sitescout.com,0,0.00%,3,3,0.00%
v.vaptcha.com,0,0.00%,2,2,0.00%
bohuiws.tywangcai.com,0,0.00%,2,2,0.00%
p211-keyvalueservice.icloud.com.cn,0,0.00%,2,2,0.00%
onedscolprdwus06.westus.cloudapp.azure.com,0,0.00%,8,8,0.00%
www.researchgate.net,0,0.00%,4,4,0.00%
0du-results-u492b3ee0-c48-a1d49-s1661320863-i9fe25f48-0.ap.dotnxdomain.net,0,0.00%,1,1,0.00%
edge.cache.cc.163.com,0,0.00%,1,1,0.00%
ali-video-dashen.cc.netease.com,0,0.00%,2,2,0.00%
god.gameyw.netease.com,0,0.00%,2,2,0.00%
watch.iot.mi.com,0,0.00%,2,2,0.00%
pic6.y.qq.com.cloud.tc.qq.com,0,0.00%,1,1,0.00%
mbd.n.shifen.com,0,0.00%,4,4,0.00%
seeds-open.xycdn.com,0,0.00%,2,2,0.00%
onedscolprdcus01.centralus.cloudapp.azure.com,0,0.00%,2,2,0.00%
ali-video-dashen.cc.netease.com.w.cdngslb.com,0,0.00%,2,2,0.00%
god-main-cn.ntes53.netease.com,0,0.00%,2,2,0.00%
jy.thix.cn,0,0.00%,1,1,0.00%
imeclient.openspeech.cn,0,0.00%,2,2,0.00%
log-upload.mihoyo.com,0,0.00%,2,2,0.00%
calendars.fe.apple-dns.net,0,0.00%,2,2,0.00%
05c3b39.pc.gladns.com,0,0.00%,4,4,0.00%
mesu-cdn.origin-apple.com.akadns.net,0,0.00%,1,1,0.00%
www.canva.cn,0,0.00%,4,4,0.00%
config.edge.skype.com.trafficmanager.NET,0,0.00%,2,2,0.00%
sdk.open.extension.getui.com,0,0.00%,3,3,0.00%
tqt.weibo.cn,0,0.00%,2,2,0.00%
vpn1.wanda.cn,0,0.00%,4,4,0.00%
grpc.biliapi.net,0,0.00%,2,2,0.00%
api.g.micloud.xiaomi.net,0,0.00%,2,2,0.00%
open.meituan.com,0,0.00%,2,2,0.00%
umservices.gingersoftware.com,0,0.00%,2,2,0.00%
druid.if.qidian.com,0,0.00%,1,1,0.00%
druidv6.if.qidian.com,0,0.00%,1,1,0.00%
qdreaderpic-1252317822.picsh.myqcloud.com,0,0.00%,2,2,0.00%
qdstatic-1252317822.file.myqcloud.com,0,0.00%,1,1,0.00%
public-1252317822.image.myqcloud.com,0,0.00%,2,2,0.00%
qdreaderpic-1252317822.file.myqcloud.com,0,0.00%,1,1,0.00%
monitor.if.qidian.com,0,0.00%,2,2,0.00%
path.qidian.com,0,0.00%,2,2,0.00%
path.book.qq.com,0,0.00%,1,1,0.00%
cdb.meituan.com,0,0.00%,1,1,0.00%
u1.img.mobile.sina.cn,0,0.00%,1,1,0.00%
05c3b39.pg.gladns.com,0,0.00%,4,4,0.00%
ftp.ext.hp.com,0,0.00%,5,5,0.00%
apphub.qzone.qq.com,0,0.00%,2,2,0.00%
ii.gdt.qq.com,0,0.00%,4,4,0.00%
bl3301.storage.live.com,0,0.00%,6,6,0.00%
mini.group.qq.com,0,0.00%,2,2,0.00%
bnz05pap001.storage.live.com,0,0.00%,2,2,0.00%
developer.apple.com,0,0.00%,2,2,0.00%
cas.wx.lenovo.com.cn,0,0.00%,2,2,0.00%
static.wx.lenovo.com.cn,0,0.00%,2,2,0.00%
static.test.wx.lenovo.com.cn,0,0.00%,1,1,0.00%
rtclbs.zaijia.com,0,0.00%,2,2,0.00%
upload.wx.lenovo.com,0,0.00%,2,2,0.00%
awareness-api-drcn.ai.dbankcloud.com,0,0.00%,2,2,0.00%
ftp.hp.com,0,0.00%,5,5,0.00%
downloadtpt.gamedl.qq.com,0,0.00%,4,4,0.00%
mmstat.ucweb.com,0,0.00%,2,2,0.00%
wow-upgrade.uc.cn,0,0.00%,4,4,0.00%
doh.li,0,0.00%,4,4,0.00%
update.browser.qq.com,0,0.00%,2,2,0.00%
panel.cercisnetwork.net,0,0.00%,61,61,0.00%
neofeed.org,0,0.00%,2,2,0.00%
stats.credly.com,0,0.00%,1,1,0.00%
cfa4e18f311d4091b7d62a4aeed408a1.fp.measure.office.com,0,0.00%,1,1,0.00%
data.video.qiyi.com,0,0.00%,2,2,0.00%
update.pc.mi.com,0,0.00%,2,2,0.00%
e2cs26.gcp.gvt2.com,0,0.00%,2,2,0.00%
websv.aliyundrive.com,0,0.00%,62,62,0.00%
confluence.bidinte.top,0,0.00%,18,18,0.00%
array511.prod.do.dsp.mp.microsoft.com,0,0.00%,12,12,0.00%
bitbucket.bidinte.top,0,0.00%,36,36,0.00%
blades.aliyun.com,0,0.00%,10,10,0.00%
analysis.sangfor.com.cn,0,0.00%,50,50,0.00%
ins-k5tkxji1.ias.tencent-cloud.net,0,0.00%,18,18,0.00%
chpm.sangfor.com.cn,0,0.00%,46,46,0.00%
cbs-u.sports.cctv.com,0,0.00%,12,12,0.00%
cbs-i.sports.cctv.com,0,0.00%,12,12,0.00%
hgc3.edgehelper.com,0,0.00%,2,2,0.00%
bn02pap001.storage.live.com,0,0.00%,2,2,0.00%
node2.ayden.icu,0,0.00%,24,24,0.00%
sf1.helloking.win,0,0.00%,6,6,0.00%
jira.bidinte.top,0,0.00%,18,18,0.00%
b29f269.pd.gladns.com,0,0.00%,6,6,0.00%
b29f269.pg.gladns.com,0,0.00%,7,7,0.00%
b29f269.ph.gladns.com,0,0.00%,7,7,0.00%
b29f269.pf.gladns.com,0,0.00%,6,6,0.00%
b29f269.pe.gladns.com,0,0.00%,7,7,0.00%
b29f269.pb.gladns.com,0,0.00%,7,7,0.00%
b29f269.pc.gladns.com,0,0.00%,6,6,0.00%
b29f269.pa.gladns.com,0,0.00%,7,7,0.00%
b29f269.ts.cloudflare.systems,0,0.00%,10,10,0.00%
update.helper.2345.cc,0,0.00%,2,2,0.00%
2kma.cn,0,0.00%,2,2,0.00%
activity01.yunzhanxinxi.com,0,0.00%,2,2,0.00%
alliance.yunzhanxinxi.com,0,0.00%,2,2,0.00%
info.uuhfl.com,0,0.00%,2,2,0.00%
cdn.images.qianxingniwo.com,0,0.00%,2,2,0.00%
cloud.google.com,0,0.00%,10,10,0.00%
outlook.gogo66.cloud,0,0.00%,10,10,0.00%
vl.dt-autoopt.ru,0,0.00%,1,1,0.00%
js.a.yximgs.com,0,0.00%,4,4,0.00%
ws-pclivemate.pull.yximgs.com,0,0.00%,4,4,0.00%
e71e16d.hc.gladns.com,0,0.00%,2,2,0.00%
e71e16d.hd.gladns.com,0,0.00%,2,2,0.00%
e71e16d.ha.gladns.com,0,0.00%,2,2,0.00%
e71e16d.hf.gladns.com,0,0.00%,2,2,0.00%
e71e16d.ph.gladns.com,0,0.00%,4,4,0.00%
e71e16d.pe.gladns.com,0,0.00%,2,2,0.00%
e71e16d.hb.gladns.com,0,0.00%,2,2,0.00%
e71e16d.he.gladns.com,0,0.00%,2,2,0.00%
e71e16d.pg.gladns.com,0,0.00%,2,2,0.00%
e71e16d.pf.gladns.com,0,0.00%,2,2,0.00%
device.sangfor.com.cn,0,0.00%,10,10,0.00%
vpn.oceanum.cn,0,0.00%,18,18,0.00%
ali-kmplive.pull.yximgs.com,0,0.00%,4,4,0.00%
xy.pull.yximgs.com,0,0.00%,5,5,0.00%
s12.upd.kaspersky.com,0,0.00%,2,2,0.00%
ws-proxy.pull.yximgs.com,0,0.00%,6,6,0.00%
bsrv.qq.com,0,0.00%,2,2,0.00%
jp06-vm0.entry.srthdw.art,0,0.00%,2,2,0.00%
p208-quota.icloud.com.cn,0,0.00%,2,2,0.00%
us.archive.ubuntu.com,0,0.00%,4,4,0.00%
httpsdns.baidu.com,0,0.00%,4,4,0.00%
mims.icbc.com.cn,0,0.00%,2,2,0.00%
oisc.icbc.com.cn,0,0.00%,2,2,0.00%
mail.dingtalk.com,0,0.00%,12,12,0.00%
db-safe.2345.cc,0,0.00%,4,4,0.00%
mms.pinduoduo.com,0,0.00%,4,4,0.00%
33aef1e.ts.cloudflare.systems,0,0.00%,4,4,0.00%
search.10jqka.com.cn,0,0.00%,2,2,0.00%
ms.10jqka.com.cn,0,0.00%,2,2,0.00%
ipv6.ts.qq.com,0,0.00%,2,2,0.00%
d.10jqka.com.cn,0,0.00%,2,2,0.00%
zhxin2.xfplay.com,0,0.00%,2,2,0.00%
tx-kmplive.pull.yximgs.com,0,0.00%,2,2,0.00%
ai.iwencai.com,0,0.00%,2,2,0.00%
p207-quota.icloud.com.cn,0,0.00%,2,2,0.00%
avalon.myhug.cn,0,0.00%,1,1,0.00%
stats.huochaipro.com,0,0.00%,1,1,0.00%
10.courier-push-apple.com.akadns.net,0,0.00%,2,2,0.00%
analytics.map.qq.com,0,0.00%,2,2,0.00%
ocsps.ssl.com,0,0.00%,4,4,0.00%
mirrors.fedoraproject.org,0,0.00%,7,7,0.00%
edgeapi.slack.com,0,0.00%,9,9,0.00%
wss-primary.slack.com,0,0.00%,4,4,0.00%
hoots.co.uk,0,0.00%,1,1,0.00%
annemills.foxbyte.uk,0,0.00%,1,1,0.00%
login.chinacloudapi.cn,0,0.00%,2,2,0.00%
app.slack.com,0,0.00%,6,6,0.00%
login.partner.microsoftonline.cn,0,0.00%,4,4,0.00%
sodium.slp.pos.here.com,0,0.00%,2,2,0.00%
connect-drcn.dbankcloud.cn,0,0.00%,10,10,0.00%
control.aps.amap.com,0,0.00%,2,2,0.00%
api-skytone-6-drcn.cloud.dbankcloud.cn,0,0.00%,2,2,0.00%
api-skytone-2-drcn.cloud.dbankcloud.cn,0,0.00%,2,2,0.00%
chi01pap002.storage.live.com,0,0.00%,8,8,0.00%
onedriveclucprodbn20048.blob.core.windows.net,0,0.00%,2,2,0.00%
i-bn2b-cor003.api.p001.1drv.com,0,0.00%,2,2,0.00%
appcfg.v.qq.com,0,0.00%,4,4,0.00%
p43-contacts.icloud.com,0,0.00%,2,2,0.00%
onedscolprdfrc01.francecentral.cloudapp.azure.com,0,0.00%,2,2,0.00%
pxyygxtq.nodelist.xyz,0,0.00%,5,5,0.00%
toggles.viveport.com,0,0.00%,4,4,0.00%
is.iscas.ac.cn,0,0.00%,2,2,0.00%
apu-chin.htccomm.com.cn,0,0.00%,1,1,0.00%
dlp-transit.100tal.com,0,0.00%,3,3,0.00%
host-5-138-25-122.stavropol.ru,0,0.00%,1,1,0.00%
analytics.ff.avast.com,0,0.00%,2,2,0.00%
ipm-provider.ff.avast.com,0,0.00%,2,2,0.00%
ldc.lenovo.com.cn.trpcdn.NET,0,0.00%,2,2,0.00%
services.myendnoteweb.com,0,0.00%,2,2,0.00%
ispip.clang.cn,0,0.00%,2,2,0.00%
caldavhz.qiye.163.com,0,0.00%,2,2,0.00%
1e7d137c4429484db195b5d3e5f3fa61.fp.measure.office.com,0,0.00%,1,1,0.00%
sub.paasmi.com,0,0.00%,2,2,0.00%
pus3-collabhubrtc.officeapps.live.com,0,0.00%,2,2,0.00%
fcmconnection.googleapis.com,0,0.00%,2,2,0.00%
jp-ntt-2.nodeok.icu,0,0.00%,1,1,0.00%
vulfile.masterconn.qq.com,0,0.00%,6,6,0.00%
launcher.store.epicgames.com,0,0.00%,1,1,0.00%
client.docer.wps.cn,0,0.00%,2,2,0.00%
a57c477848144e1492bd0efa029366a8.fp.measure.office.com,0,0.00%,2,2,0.00%
2018.hackthefuture.be,0,0.00%,1,1,0.00%
rc10-g6.oray.com,0,0.00%,2,2,0.00%
ip.taobao.com,0,0.00%,4,4,0.00%
ipv6.china.qiniu.com.trpcdn.NET,0,0.00%,1,1,0.00%
mail.inpuracithu.ga,0,0.00%,1,1,0.00%
diagnosis.ludashi.com,0,0.00%,2,2,0.00%
yd-02.paofunlink.com,0,0.00%,2,2,0.00%
yd-01.paofunlink.com,0,0.00%,2,2,0.00%
iknow.n.shifen.com,0,0.00%,2,2,0.00%
cmrelay-basic-2.nodesub.com,0,0.00%,2,2,0.00%
cmrelay-basic-1.nodesub.com,0,0.00%,2,2,0.00%
api.vip.iqiyi.com,0,0.00%,2,2,0.00%
adash.m.taobao.com,0,0.00%,2,2,0.00%
advanced-cm-2.nodesub.com,0,0.00%,2,2,0.00%
contracts.canonical.com,0,0.00%,1,1,0.00%
advanced-cm-1.nodesub.com,0,0.00%,2,2,0.00%
pgy-api.oray.com,0,0.00%,6,6,0.00%
e2c36.gcp.gvt2.com,0,0.00%,3,3,0.00%
iplc.a.hellossr.com,0,0.00%,2,2,0.00%
iplc.b.hellossr.com,0,0.00%,2,2,0.00%
data.bytedance.net,0,0.00%,2,2,0.00%
sha-cu-001.omo-m0m.com,0,0.00%,13,13,0.00%
maoruimas.github.io,0,0.00%,1,1,0.00%
community.iqiyi.com,0,0.00%,2,2,0.00%
mirrors.kernel.org,0,0.00%,2,2,0.00%
onedscolprdwus08.westus.cloudapp.azure.com,0,0.00%,4,4,0.00%
prod.nexusrules.live.com.akadns.NET,0,0.00%,2,2,0.00%
b32ef56de8f9420eac6e273a1c257444.fp.measure.office.com,0,0.00%,1,1,0.00%
d28n7yywqog3r7.cloudfront.net,0,0.00%,6,6,0.00%
manjaro.moson.eu,0,0.00%,2,2,0.00%
c.urs.microsoft.com,0,0.00%,6,6,0.00%
pcapp.youku.com,0,0.00%,2,2,0.00%
cs9.wpc.v0cdn.net,0,0.00%,4,4,0.00%
e44ee7b.pd.gladns.com,0,0.00%,2,2,0.00%
e44ee7b.pf.gladns.com,0,0.00%,2,2,0.00%
e44ee7b.pc.gladns.com,0,0.00%,2,2,0.00%
e44ee7b.pe.gladns.com,0,0.00%,2,2,0.00%
genuine.adobe.com,0,0.00%,2,2,0.00%
p.youku.com,0,0.00%,2,2,0.00%
az700632-pme.azureedge.net,0,0.00%,2,2,0.00%
az700632-pme.ec.azureedge.net,0,0.00%,4,4,0.00%
boot3.jeecg.com,0,0.00%,2,2,0.00%
iecvlist.microsoft.com,0,0.00%,4,4,0.00%
upload-va.synacast.com,0,0.00%,2,2,0.00%
sisiow.slyip.com,0,0.00%,2,2,0.00%
online2.b.api.cqttech.com,0,0.00%,1,1,0.00%
ldc.lenovo.com.cn.trpcdn.net,0,0.00%,2,2,0.00%
flow.logitech.io,0,0.00%,4,4,0.00%
nexus.prod.osssc.ac.cn,0,0.00%,4,4,0.00%
www36oo.com,0,0.00%,2,2,0.00%
f-log-mac-extension.grammarly.io,0,0.00%,2,2,0.00%
code.osssc.ac.cn,0,0.00%,2,2,0.00%
developer.download.nvidia.com,0,0.00%,2,2,0.00%
ss.shanhutech.cn,0,0.00%,1,1,0.00%
user-api.setapp.com,0,0.00%,2,2,0.00%
ru.10242018.xyz,0,0.00%,2,2,0.00%
cu.10242018.xyz,0,0.00%,6,6,0.00%
krypt.10242018.xyz,0,0.00%,2,2,0.00%
de.10242018.xyz,0,0.00%,2,2,0.00%
oracle-kr.10242018.xyz,0,0.00%,1,1,0.00%
gmo.10242018.xyz,0,0.00%,2,2,0.00%
oraclejp.10242018.xyz,0,0.00%,2,2,0.00%
tsukaeru.10242018.xyz,0,0.00%,1,1,0.00%
hinet.10242018.xyz,0,0.00%,2,2,0.00%
hk-bgp.10242018.xyz,0,0.00%,1,1,0.00%
ovhsgp.10242018.xyz,0,0.00%,1,1,0.00%
bl6pap004.storage.live.com,0,0.00%,6,6,0.00%
hkbnjl0.zhs.company,0,0.00%,4,4,0.00%
tr.bangumi.moe,0,0.00%,2,2,0.00%
tracker.loligirl.cn,0,0.00%,2,2,0.00%
cdn-node.cn.cm.jiangmen-01.nekocloud.cn,0,0.00%,2,2,0.00%
app-a05.lp1.npns.srv.nintendo.net,0,0.00%,2,2,0.00%
master5.teamviewer.com,0,0.00%,12,12,0.00%
gsp10-ssl.apple.com,0,0.00%,4,4,0.00%
tracker.nighthawk.pw,0,0.00%,2,2,0.00%
tracker.kamigami.org,0,0.00%,2,2,0.00%
nat-port-1.verysync.cn,0,0.00%,2,2,0.00%
tracker.exorditech.com.tr,0,0.00%,2,2,0.00%
taobao.com,0,0.00%,4,4,0.00%
www.ludashi.com,0,0.00%,2,2,0.00%
g37.update.netease.com,0,0.00%,2,2,0.00%
proxy-state.nie.netease.com,0,0.00%,2,2,0.00%
psycnet.apa.org,0,0.00%,2,2,0.00%
bt.ali213.net,0,0.00%,2,2,0.00%
sphapi-pro.oray.net,0,0.00%,2,2,0.00%
log.u.wps.cn,0,0.00%,2,2,0.00%
h-adashx.dingtalkapps.com,0,0.00%,2,2,0.00%
thetracker.org,0,0.00%,5,5,0.00%
vod0050-aliyun18-vip-lixian.mypikpak.com,0,0.00%,1,1,0.00%
speedtest-rtc.xtspeeder002.xyz,0,0.00%,2,2,0.00%
siambit.com,0,0.00%,2,2,0.00%
master11.teamviewer.com,0,0.00%,6,6,0.00%
basictransl.wps.cn,0,0.00%,2,2,0.00%
msg.rising.com.cn,0,0.00%,2,2,0.00%
mirrorlist.centos.org,0,0.00%,8,8,0.00%
ftp.sjtu.edu.cn,0,0.00%,1,1,0.00%
dl.yarnpkg.com,0,0.00%,1,1,0.00%
autodiscover.163.com,0,0.00%,2,2,0.00%
163.com,0,0.00%,1,1,0.00%
n.dingtalk.com,0,0.00%,1,1,0.00%
a06c679b2c794eb283e5621b9f29f967.fp.measure.office.com,0,0.00%,1,1,0.00%
8234d3396d694ec69ec55995e90247a9.fp.measure.office.com,0,0.00%,1,1,0.00%
yt.droid.ac.cn,0,0.00%,6,6,0.00%
pdns124.ultradns.net,0,0.00%,1,1,0.00%
pdns124.ultradns.org,0,0.00%,1,1,0.00%
www.annualcreditreport.com,0,0.00%,1,1,0.00%
dns2.safenames.net,0,0.00%,2,2,0.00%
dns3.safenames.org,0,0.00%,2,2,0.00%
sam.ns.cloudflare.com,0,0.00%,4,4,0.00%
conrad.ns.cloudflare.com,0,0.00%,6,6,0.00%
sns35.hostgator.in,0,0.00%,2,2,0.00%
sns36.hostgator.in,0,0.00%,2,2,0.00%
dns.4cun.com,0,0.00%,4,4,0.00%
shengzhongchaye.com,0,0.00%,2,2,0.00%
ns-rs1.gmoserver.jp,0,0.00%,10,10,0.00%
sid.ns.cloudflare.com,0,0.00%,4,4,0.00%
ns1.shipsiilkang.com,0,0.00%,2,2,0.00%
ns2.shipsiilkang.com,0,0.00%,2,2,0.00%
mustafa.ns.cloudflare.com,0,0.00%,4,4,0.00%
paislee.ns.cloudflare.com,0,0.00%,4,4,0.00%
paint.dnspod.net,0,0.00%,2,2,0.00%
ns8.arad360.com,0,0.00%,2,2,0.00%
dns2.kandyanservers.com,0,0.00%,2,2,0.00%
tess.dnspod.net,0,0.00%,2,2,0.00%
freedns4.registrar-servers.com,0,0.00%,2,2,0.00%
freedns2.registrar-servers.com,0,0.00%,2,2,0.00%
ns1.terabytesserver.com,0,0.00%,4,4,0.00%
freedns1.registrar-servers.com,0,0.00%,2,2,0.00%
docks05.rzone.de,0,0.00%,2,2,0.00%
adaline.ns.cloudflare.com,0,0.00%,4,4,0.00%
drone.dnspod.net,0,0.00%,2,2,0.00%
freedns3.registrar-servers.com,0,0.00%,2,2,0.00%
rayden.ns.cloudflare.com,0,0.00%,2,2,0.00%
dns1.kandyanservers.com,0,0.00%,2,2,0.00%
fatima.ns.cloudflare.com,0,0.00%,4,4,0.00%
ns2.dandomain.dk,0,0.00%,8,8,0.00%
shades06.rzone.de,0,0.00%,2,2,0.00%
ns2.secureparkme.com,0,0.00%,2,2,0.00%
adam.ns.cloudflare.com,0,0.00%,2,2,0.00%
ns2nsy.name.com,0,0.00%,2,2,0.00%
ns1.secureparkme.com,0,0.00%,2,2,0.00%
bonnie.ns.cloudflare.com,0,0.00%,2,2,0.00%
ns1.server-cpanel.com,0,0.00%,2,2,0.00%
ns1.idwebhost.id,0,0.00%,2,2,0.00%
ns1.thcservers.com,0,0.00%,2,2,0.00%
dns1.alwaysdata.com,0,0.00%,2,2,0.00%
ns2.server-cpanel.com,0,0.00%,2,2,0.00%
ns3.adminvps.ru,0,0.00%,2,2,0.00%
ns.forpsi.net,0,0.00%,2,2,0.00%
ns2.setkenworthpeterbilt.com,0,0.00%,2,2,0.00%
ns4.thcservers.com,0,0.00%,2,2,0.00%
ns1.incauthorityweb.com,0,0.00%,8,8,0.00%
dns2.alwaysdata.com,0,0.00%,2,2,0.00%
ns321.mihanwebhost.com,0,0.00%,2,2,0.00%
mark.dnspod.net,0,0.00%,2,2,0.00%
ns.hostingmadeeasy.com,0,0.00%,2,2,0.00%
ns3.thcservers.com,0,0.00%,2,2,0.00%
ns1.setkenworthpeterbilt.com,0,0.00%,2,2,0.00%
ns1cmt.name.com,0,0.00%,2,2,0.00%
ns712.webempresa.eu,0,0.00%,2,2,0.00%
ns4.hostfastpk.com,0,0.00%,2,2,0.00%
door.dnspod.net,0,0.00%,2,2,0.00%
ns2.nameself.com,0,0.00%,4,4,0.00%
ns3.hostingmadeeasy.com,0,0.00%,2,2,0.00%
ns-b.dns.yourhosting.eu,0,0.00%,2,2,0.00%
ns4.hostingmadeeasy.com,0,0.00%,2,2,0.00%
ns322.mihanwebhost.com,0,0.00%,2,2,0.00%
ns81.kebirhost.com,0,0.00%,2,2,0.00%
ns-a.dns.yourhosting.nl,0,0.00%,2,2,0.00%
ns01.metnurbilisim.com,0,0.00%,2,2,0.00%
live2.navohost.com,0,0.00%,2,2,0.00%
ns2bkr.name.com,0,0.00%,4,4,0.00%
ns80.kebirhost.com,0,0.00%,2,2,0.00%
live1.navohost.com,0,0.00%,2,2,0.00%
ns57.g-dns.com,0,0.00%,2,2,0.00%
ns3cqz.name.com,0,0.00%,4,4,0.00%
ns2.francedns.com,0,0.00%,4,4,0.00%
ns-239.awsdns-29.com,0,0.00%,2,2,0.00%
ns02.metnurbilisim.com,0,0.00%,2,2,0.00%
ns2.rbe1.g-srv.net,0,0.00%,2,2,0.00%
ns1.vietnix.net,0,0.00%,2,2,0.00%
ns1.ghesi.net,0,0.00%,2,2,0.00%
ns58.g-dns.com,0,0.00%,2,2,0.00%
anemone.dnspod.net,0,0.00%,2,2,0.00%
ns2.vietnix.net,0,0.00%,2,2,0.00%
anastasia.dnspod.net,0,0.00%,2,2,0.00%
ns302.hostgator.com.br,0,0.00%,2,2,0.00%
ns-1319.awsdns-36.org,0,0.00%,2,2,0.00%
shades16.rzone.de,0,0.00%,2,2,0.00%
nsbak.vietnix.net,0,0.00%,2,2,0.00%
a7-65.akam.net,0,0.00%,2,2,0.00%
corporate.vip62.noc40.com,0,0.00%,2,2,0.00%
firefly.dnspod.net,0,0.00%,2,2,0.00%
ns1psw.name.com,0,0.00%,2,2,0.00%
hadlee.ns.cloudflare.com,0,0.00%,2,2,0.00%
ns2fjz.name.com,0,0.00%,2,2,0.00%
rainbow.dnspod.net,0,0.00%,2,2,0.00%
ns-1232.awsdns-26.org,0,0.00%,2,2,0.00%
fred.ns.cloudflare.com,0,0.00%,2,2,0.00%
ns4qxz.name.com,0,0.00%,6,6,0.00%
corporate.vip61.noc40.com,0,0.00%,2,2,0.00%
dns5.hostitbro.com,0,0.00%,2,2,0.00%
ns14.dinaodns.net,0,0.00%,2,2,0.00%
joyce.dnspod.net,0,0.00%,2,2,0.00%
ns1016.ui-dns.org,0,0.00%,2,2,0.00%
ns2.tezhost.com,0,0.00%,2,2,0.00%
dns6.hostitbro.com,0,0.00%,2,2,0.00%
ns-1808.awsdns-34.co.uk,0,0.00%,2,2,0.00%
ns1.tezhost.com,0,0.00%,2,2,0.00%
ns-605.awsdns-11.net,0,0.00%,2,2,0.00%
princess.ns.cloudflare.com,0,0.00%,3,3,0.00%
a3-64.akam.net,0,0.00%,2,2,0.00%
ns1034.ui-dns.com,0,0.00%,2,2,0.00%
hangzhou06.xudoodoo.com,0,0.00%,2,2,0.00%
a2-67.akam.net,0,0.00%,2,2,0.00%
auriga.dnspod.net,0,0.00%,4,4,0.00%
ns12.dinaodns.net,0,0.00%,2,2,0.00%
kevin.ns.cloudflare.com,0,0.00%,8,8,0.00%
a16-66.akam.net,0,0.00%,2,2,0.00%
ns231.mihanwebhost.com,0,0.00%,2,2,0.00%
ns1.your-server.de,0,0.00%,2,2,0.00%
a12-65.akam.net,0,0.00%,2,2,0.00%
board.dnspod.net,0,0.00%,4,4,0.00%
ns16.thebeehost.com,0,0.00%,2,2,0.00%
ns1-35.azure-dns.com,0,0.00%,2,2,0.00%
ns-1358.awsdns-41.org,0,0.00%,2,2,0.00%
ns7.cnmsn.net,0,0.00%,10,10,0.00%
ns13.dinaodns.net,0,0.00%,2,2,0.00%
ns-1735.awsdns-24.co.uk,0,0.00%,4,4,0.00%
ns1084.ui-dns.de,0,0.00%,2,2,0.00%
ns3.hostfastpk.com,0,0.00%,2,2,0.00%
ns-86.awsdns-10.com,0,0.00%,2,2,0.00%
lennox.ns.cloudflare.com,0,0.00%,4,4,0.00%
ns8195.hostgator.com,0,0.00%,2,2,0.00%
ns1031.ui-dns.biz,0,0.00%,2,2,0.00%
ns8196.hostgator.com,0,0.00%,2,2,0.00%
ns232.mihanwebhost.com,0,0.00%,2,2,0.00%
ns1120.ui-dns.org,0,0.00%,2,2,0.00%
ns2.hostfastpk.com,0,0.00%,2,2,0.00%
ns1057.ui-dns.com,0,0.00%,2,2,0.00%
ns1.hostfastpk.com,0,0.00%,2,2,0.00%
activation.gfe.nvidia.com,0,0.00%,1,1,0.00%
ns-239-c.gandi.net,0,0.00%,2,2,0.00%
ns1.ktek.net,0,0.00%,2,2,0.00%
ns0.ktek.net,0,0.00%,2,2,0.00%
ns3.francedns.com,0,0.00%,4,4,0.00%
dns2.swizzonic.ch,0,0.00%,2,2,0.00%
dns4.simplecplogin.com,0,0.00%,2,2,0.00%
ns1.parkdomainwithait.com,0,0.00%,2,2,0.00%
dns3.simplecplogin.com,0,0.00%,2,2,0.00%
dns1.swizzonic.ch,0,0.00%,2,2,0.00%
ns0.parkdomainwithait.com,0,0.00%,2,2,0.00%
cactus.dnspod.net,0,0.00%,2,2,0.00%
coco.ns.cloudflare.com,0,0.00%,2,2,0.00%
ns3.hoster.co.id,0,0.00%,2,2,0.00%
ns11.whois.co.kr,0,0.00%,2,2,0.00%
ns2.hoster.co.id,0,0.00%,2,2,0.00%
ns2.mailplug.com,0,0.00%,2,2,0.00%
barmaid.dnspod.net,0,0.00%,2,2,0.00%
ns11.whoisweb.net,0,0.00%,2,2,0.00%
benson.dnspod.net,0,0.00%,2,2,0.00%
ns2.idwebhost.id,0,0.00%,2,2,0.00%
ns4.hoster.co.id,0,0.00%,2,2,0.00%
ns6.xvdns.com,0,0.00%,2,2,0.00%
ns29.iaasdns.com,0,0.00%,2,2,0.00%
ns30.iaasdns.com,0,0.00%,2,2,0.00%
registracom.mercury.orderbox-dns.com,0,0.00%,2,2,0.00%
registracom.earth.orderbox-dns.com,0,0.00%,2,2,0.00%
sergendayambaje.com,0,0.00%,2,2,0.00%
ns2.xvdns.com,0,0.00%,2,2,0.00%
registracom.mars.orderbox-dns.com,0,0.00%,2,2,0.00%
ns6212.hostgator.com,0,0.00%,2,2,0.00%
registracom.venus.orderbox-dns.com,0,0.00%,2,2,0.00%
ns3.xvdns.com,0,0.00%,2,2,0.00%
ns2.admoon.vpsfa.ca,0,0.00%,2,2,0.00%
ns2.discountdomains.co.nz,0,0.00%,2,2,0.00%
ns5.xvdns.com,0,0.00%,2,2,0.00%
ns711.webempresa.eu,0,0.00%,2,2,0.00%
phoenix.ns.cloudflare.com,0,0.00%,2,2,0.00%
ns2.tn.oxa.host,0,0.00%,2,2,0.00%
cpanel07-ns3.reliablewebhosting.ca,0,0.00%,2,2,0.00%
ns1.xvdns.com,0,0.00%,2,2,0.00%
ns1.tn.oxa.host,0,0.00%,2,2,0.00%
serving-legal-documents-inmidwales.com,0,0.00%,2,2,0.00%
sesongty.com,0,0.00%,2,2,0.00%
ns1.tikitaka.biz,0,0.00%,2,2,0.00%
ns115.hostgator.mx,0,0.00%,2,2,0.00%
ns1.francedns.com,0,0.00%,4,4,0.00%
ns1.serverms1.com,0,0.00%,2,2,0.00%
ns114.hostgator.mx,0,0.00%,2,2,0.00%
ns4.xvdns.com,0,0.00%,2,2,0.00%
ns2.tikitaka.biz,0,0.00%,2,2,0.00%
ns2.vdeploy.net,0,0.00%,2,2,0.00%
ns1.admoon.vpsfa.ca,0,0.00%,2,2,0.00%
ns1.seslienkaz.com,0,0.00%,2,2,0.00%
ns2.serverms1.com,0,0.00%,2,2,0.00%
dns193.a.register.com,0,0.00%,2,2,0.00%
dns2.serv590120.servidoresdns.net,0,0.00%,2,2,0.00%
ns1.vdeploy.net,0,0.00%,2,2,0.00%
ns2.seslienkaz.com,0,0.00%,2,2,0.00%
dns1.serv590120.servidoresdns.net,0,0.00%,2,2,0.00%
cpanel07-ns1.reliablewebhosting.ca,0,0.00%,2,2,0.00%
ns2.dewaweb.com,0,0.00%,4,4,0.00%
ns1539.securen.net,0,0.00%,2,2,0.00%
ns4.web.de,0,0.00%,4,4,0.00%
ns1540.securen.net,0,0.00%,2,2,0.00%
ns1.marketleader.com,0,0.00%,4,4,0.00%
clay.ns.cloudflare.com,0,0.00%,4,4,0.00%
cpanel07-ns4.reliablewebhosting.ca,0,0.00%,2,2,0.00%
ns2.inertinc.com,0,0.00%,8,8,0.00%
ns2.suempresa.com,0,0.00%,2,2,0.00%
ns2.domainsafricacloud.com,0,0.00%,2,2,0.00%
dns2.raiolanetworks.es,0,0.00%,4,4,0.00%
ns3.dnsmisitio.net,0,0.00%,2,2,0.00%
ns1.suempresa.com,0,0.00%,2,2,0.00%
jihoon.ns.cloudflare.com,0,0.00%,4,4,0.00%
dns1.raiolanetworks.es,0,0.00%,4,4,0.00%
26569.mercury.orderbox-dns.com,0,0.00%,2,2,0.00%
dns3.raiolanetworks.es,0,0.00%,4,4,0.00%
seleocv.com,0,0.00%,2,2,0.00%
dns2.internetbilisim.net,0,0.00%,2,2,0.00%
26569.earth.orderbox-dns.com,0,0.00%,2,2,0.00%
scubadiving-galapagos.com,0,0.00%,2,2,0.00%
stella.ns.cloudflare.com,0,0.00%,2,2,0.00%
ns-1417.awsdns-49.org,0,0.00%,2,2,0.00%
amber.ns.cloudflare.com,0,0.00%,6,6,0.00%
dns1.internetbilisim.net,0,0.00%,2,2,0.00%
ns2.trdns.com,0,0.00%,2,2,0.00%
ns1.sermayesizeticaret.com,0,0.00%,2,2,0.00%
ns-464.awsdns-58.com,0,0.00%,2,2,0.00%
palmasolar.com,0,0.00%,2,2,0.00%
ns2.palitrahud.com,0,0.00%,2,2,0.00%
ns4fpy.name.com,0,0.00%,2,2,0.00%
ns3.websupport.sk,0,0.00%,2,2,0.00%
ns44.hostgator.mx,0,0.00%,2,2,0.00%
cns6010.bigrock.com,0,0.00%,2,2,0.00%
ns69.hostgator.mx,0,0.00%,2,2,0.00%
ns3.web.de,0,0.00%,4,4,0.00%
setblue.earth.orderbox-dns.com,0,0.00%,2,2,0.00%
abby.ns.cloudflare.com,0,0.00%,6,6,0.00%
ns68.hostgator.mx,0,0.00%,2,2,0.00%
setblue.mercury.orderbox-dns.com,0,0.00%,2,2,0.00%
ns3.ekkhost.com,0,0.00%,2,2,0.00%
ns2.audiostreamvolt.com,0,0.00%,2,2,0.00%
ns1.palitrahud.com,0,0.00%,2,2,0.00%
ns1.accu17.com,0,0.00%,2,2,0.00%
james.ns.cloudflare.com,0,0.00%,2,2,0.00%
setblue.mars.orderbox-dns.com,0,0.00%,2,2,0.00%
ns7.cpi.ad.jp,0,0.00%,2,2,0.00%
ns10.icasei.com.br,0,0.00%,2,2,0.00%
ns1.epizy.com,0,0.00%,2,2,0.00%
ns2.domainoffensive.eu,0,0.00%,2,2,0.00%
lindsey.ns.cloudflare.com,0,0.00%,2,2,0.00%
ns6.cpi.ad.jp,0,0.00%,2,2,0.00%
setblue.venus.orderbox-dns.com,0,0.00%,2,2,0.00%
ns3.domainoffensive.net,0,0.00%,2,2,0.00%
ns697.hostgator.com.br,0,0.00%,2,2,0.00%
verification-z88e0wek.ns3.dan.hosting,0,0.00%,2,2,0.00%
ns46.wpxhosting.com,0,0.00%,2,2,0.00%
ns2.accu17.com,0,0.00%,2,2,0.00%
ns945.hostgator.com.br,0,0.00%,2,2,0.00%
ns1056.ui-dns.org,0,0.00%,2,2,0.00%
ns1.izhr.org,0,0.00%,2,2,0.00%
ns944.hostgator.com.br,0,0.00%,2,2,0.00%
ns1.domaindiscover.com,0,0.00%,2,2,0.00%
ns-574.awsdns-07.net,0,0.00%,4,4,0.00%
ns2.domaindiscover.com,0,0.00%,2,2,0.00%
ns1.domainoffensive.de,0,0.00%,2,2,0.00%
ns2.pananchita89.com,0,0.00%,2,2,0.00%
algin.ns.cloudflare.com,0,0.00%,4,4,0.00%
ns2.qhoster.net,0,0.00%,2,2,0.00%
ns2.datacenter.no,0,0.00%,2,2,0.00%
pargastec.com,0,0.00%,1,1,0.00%
ns1.ezzed.com,0,0.00%,2,2,0.00%
saw.dnspod.net,0,0.00%,2,2,0.00%
ns2.ezzed.com,0,0.00%,2,2,0.00%
cns488.hostgator.com,0,0.00%,2,2,0.00%
ns1.ekkhost.com,0,0.00%,2,2,0.00%
cns487.hostgator.com,0,0.00%,2,2,0.00%
panaxvina.com,0,0.00%,2,2,0.00%
ns1.pananchita89.com,0,0.00%,2,2,0.00%
nova.ns.cloudflare.com,0,0.00%,2,2,0.00%
ns6209.hostgator.com,0,0.00%,2,2,0.00%
palongtraveller.com,0,0.00%,2,2,0.00%
info653475.mars.orderbox-dns.com,0,0.00%,2,2,0.00%
maria.ns.cloudflare.com,0,0.00%,2,2,0.00%
info653475.venus.orderbox-dns.com,0,0.00%,2,2,0.00%
ns-248-b.gandi.net,0,0.00%,2,2,0.00%
ns-158-c.gandi.net,0,0.00%,2,2,0.00%
ns-1770.awsdns-29.co.uk,0,0.00%,2,2,0.00%
ns-1624.awsdns-11.co.uk,0,0.00%,2,2,0.00%
ns-254.awsdns-31.com,0,0.00%,2,2,0.00%
ans1.hostcocoa.com,0,0.00%,2,2,0.00%
ans2.hostcocoa.com,0,0.00%,2,2,0.00%
ans3.hostcocoa.com,0,0.00%,2,2,0.00%
ans4.hostcocoa.com,0,0.00%,2,2,0.00%
dns208.b.register.com,0,0.00%,2,2,0.00%
ns975.hostgator.com.br,0,0.00%,2,2,0.00%
ns2.site5.com,0,0.00%,2,2,0.00%
ali.ns.cloudflare.com,0,0.00%,2,2,0.00%
ryan.ns.cloudflare.com,0,0.00%,10,10,0.00%
luciana.ns.cloudflare.com,0,0.00%,2,2,0.00%
ns986.hostgator.com.br,0,0.00%,2,2,0.00%
rapper.dnspod.net,0,0.00%,2,2,0.00%
ns1025.ui-dns.com,0,0.00%,4,4,0.00%
ns1057.ui-dns.biz,0,0.00%,4,4,0.00%
ns2.34sp.com,0,0.00%,2,2,0.00%
ns1.outmailstore.com,0,0.00%,2,2,0.00%
houston.ns.cloudflare.com,0,0.00%,2,2,0.00%
romina.ns.cloudflare.com,0,0.00%,4,4,0.00%
bart.ns.cloudflare.com,0,0.00%,4,4,0.00%
jo.ns.cloudflare.com,0,0.00%,2,2,0.00%
ns.34sp.com,0,0.00%,2,2,0.00%
ownbeuty.com,0,0.00%,2,2,0.00%
ns2.weblium.com,0,0.00%,2,2,0.00%
ns2.outmailstore.com,0,0.00%,2,2,0.00%
ns-195-c.gandi.net,0,0.00%,2,2,0.00%
ns2.webhostingserver.nl,0,0.00%,2,2,0.00%
dns2.markum.net,0,0.00%,2,2,0.00%
outofthisworldfarming.com,0,0.00%,2,2,0.00%
ns-195-a.gandi.net,0,0.00%,2,2,0.00%
ns6574.hostgator.com,0,0.00%,2,2,0.00%
ns1.webhostingserver.nl,0,0.00%,2,2,0.00%
ns-1835.awsdns-37.co.uk,0,0.00%,2,2,0.00%
ns6573.hostgator.com,0,0.00%,2,2,0.00%
ns2.internetbilisim.net,0,0.00%,2,2,0.00%
kolton.ns.cloudflare.com,0,0.00%,6,6,0.00%
p5sur6zbn.com,0,0.00%,2,2,0.00%
rajeev.ns.cloudflare.com,0,0.00%,2,2,0.00%
ns-107-b.gandi.net,0,0.00%,2,2,0.00%
ns-140.awsdns-17.com,0,0.00%,2,2,0.00%
ns3.webhostingserver.nl,0,0.00%,2,2,0.00%
ns1115.ui-dns.de,0,0.00%,4,4,0.00%
ns3.qhoster.net,0,0.00%,2,2,0.00%
vda3300a.trouble-free.net,0,0.00%,2,2,0.00%
ns1119.ui-dns.com,0,0.00%,4,4,0.00%
ns1.internetbilisim.net,0,0.00%,2,2,0.00%
ns1.sdnisiioedns.com,0,0.00%,1,1,0.00%
ns1.octagonpa.com,0,0.00%,2,2,0.00%
p-desgin.com,0,0.00%,2,2,0.00%
ns1.qhoster.net,0,0.00%,2,2,0.00%
ns4.qhoster.net,0,0.00%,2,2,0.00%
ns1126.ui-dns.org,0,0.00%,2,2,0.00%
ns974.hostgator.com.br,0,0.00%,2,2,0.00%
ns1071.ui-dns.biz,0,0.00%,2,2,0.00%
ns1113.ui-dns.org,0,0.00%,2,2,0.00%
99.push2his.eastmoney.com,0,0.00%,2,2,0.00%
vicente.ns.cloudflare.com,0,0.00%,4,4,0.00%
ns-1227.awsdns-25.org,0,0.00%,2,2,0.00%
orphicwarrior.com,0,0.00%,2,2,0.00%
ns-1144.awsdns-15.org,0,0.00%,2,2,0.00%
cns6009.bigrock.com,0,0.00%,2,2,0.00%
ns2.bizmaserver.com,0,0.00%,2,2,0.00%
ns1.cmshigh.com,0,0.00%,2,2,0.00%
ns-35.awsdns-04.com,0,0.00%,2,2,0.00%
ns-1760.awsdns-28.co.uk,0,0.00%,2,2,0.00%
ns2.yoncu.com,0,0.00%,2,2,0.00%
ns1074.ui-dns.org,0,0.00%,2,2,0.00%
ns2.dothome.co.kr,0,0.00%,4,4,0.00%
ns-178.awsdns-22.com,0,0.00%,2,2,0.00%
dahlia.ns.cloudflare.com,0,0.00%,4,4,0.00%
ns3.dothome.co.kr,0,0.00%,2,2,0.00%
ns-993.awsdns-60.net,0,0.00%,2,2,0.00%
ns1.dothome.co.kr,0,0.00%,4,4,0.00%
ns.namedserver.net,0,0.00%,2,2,0.00%
ns1.odeaweb.com,0,0.00%,4,4,0.00%
ns2.namedserver.net,0,0.00%,2,2,0.00%
ns1.yoncu.com,0,0.00%,2,2,0.00%
ns2.odeaweb.com,0,0.00%,4,4,0.00%
ns2.cmshigh.com,0,0.00%,2,2,0.00%
ns995.hostgator.com.br,0,0.00%,2,2,0.00%
22.push2his.eastmoney.com,0,0.00%,2,2,0.00%
ns1.enter-system.com,0,0.00%,4,4,0.00%
ns2.enter-system.com,0,0.00%,4,4,0.00%
75.push2his.eastmoney.com,0,0.00%,2,2,0.00%
ns1qsy.name.com,0,0.00%,6,6,0.00%
sk.s5.cm.ns1.58.ztomy.com,0,0.00%,2,2,0.00%
ns1.plaindns.net,0,0.00%,2,2,0.00%
ns1080.ui-dns.org,0,0.00%,2,2,0.00%
ns-1163.awsdns-17.org,0,0.00%,2,2,0.00%
ns-694.awsdns-22.net,0,0.00%,2,2,0.00%
logan.ns.cloudflare.com,0,0.00%,5,5,0.00%
ns4.diymysite.com,0,0.00%,2,2,0.00%
ns-1265.awsdns-30.org,0,0.00%,2,2,0.00%
ns-317.awsdns-39.com,0,0.00%,2,2,0.00%
ns3.tiscomhosting.eu,0,0.00%,2,2,0.00%
ns-1895.awsdns-44.co.uk,0,0.00%,2,2,0.00%
ns1.hddpool5.net,0,0.00%,2,2,0.00%
ns-489.awsdns-61.com,0,0.00%,2,2,0.00%
ns2.hddpool5.net,0,0.00%,2,2,0.00%
nero.ns.cloudflare.com,0,0.00%,2,2,0.00%
ns4210.hostgator.com,0,0.00%,2,2,0.00%
nsr.igtlottery.it,0,0.00%,4,4,0.00%
97.push2his.eastmoney.com,0,0.00%,2,2,0.00%
46.push2his.eastmoney.com,0,0.00%,2,2,0.00%
ns4209.hostgator.com,0,0.00%,2,2,0.00%
bicycle.dnspod.net,0,0.00%,2,2,0.00%
ns4.hbahosting.com,0,0.00%,2,2,0.00%
ns1.sislan.net,0,0.00%,2,2,0.00%
sigrid.dnspod.net,0,0.00%,2,2,0.00%
nsm.igtlottery.it,0,0.00%,4,4,0.00%
ulla.ns.cloudflare.com,0,0.00%,8,8,0.00%
nsc.igtlottery.it,0,0.00%,4,4,0.00%
ns2.hbahosting.com,0,0.00%,2,2,0.00%
ns3.hbahosting.com,0,0.00%,4,4,0.00%
elisa.ns.cloudflare.com,0,0.00%,2,2,0.00%
ns2.sislan.net,0,0.00%,2,2,0.00%
ns2.plaindns.net,0,0.00%,2,2,0.00%
norah.ns.cloudflare.com,0,0.00%,2,2,0.00%
ns-1515.awsdns-61.org,0,0.00%,2,2,0.00%
carmelo.ns.cloudflare.com,0,0.00%,6,6,0.00%
ns-1492.awsdns-58.org,0,0.00%,2,2,0.00%
amir.ns.cloudflare.com,0,0.00%,4,4,0.00%
ns.jagoanweb.com,0,0.00%,2,2,0.00%
ns-1978.awsdns-55.co.uk,0,0.00%,2,2,0.00%
ns4.aloojamiento.com,0,0.00%,2,2,0.00%
ns1.cloud-95215f.managed-vps.net,0,0.00%,4,4,0.00%
ns-225.awsdns-28.com,0,0.00%,2,2,0.00%
ns6499.hostgator.com,0,0.00%,2,2,0.00%
ns.jagoanhosting.com,0,0.00%,2,2,0.00%
ns-814.awsdns-37.net,0,0.00%,2,2,0.00%
ns6012.hostgator.com,0,0.00%,2,2,0.00%
ns6500.hostgator.com,0,0.00%,2,2,0.00%
ns1082.ui-dns.com,0,0.00%,2,2,0.00%
ns6011.hostgator.com,0,0.00%,2,2,0.00%
ns6629.hostgator.com,0,0.00%,2,2,0.00%
ns1043.ui-dns.de,0,0.00%,2,2,0.00%
ns1048.ui-dns.org,0,0.00%,2,2,0.00%
ns1043.ui-dns.biz,0,0.00%,2,2,0.00%
ns1113.ui-dns.com,0,0.00%,2,2,0.00%
ns2.rulerhost.com,0,0.00%,4,4,0.00%
ns1103.ui-dns.biz,0,0.00%,2,2,0.00%
ns1090.ui-dns.biz,0,0.00%,2,2,0.00%
henrik.ns.cloudflare.com,0,0.00%,2,2,0.00%
ns1031.ui-dns.org,0,0.00%,2,2,0.00%
ns1117.ui-dns.de,0,0.00%,2,2,0.00%
norm.ns.cloudflare.com,0,0.00%,2,2,0.00%
ns1.rulerhost.com,0,0.00%,4,4,0.00%
ns3.partnerconsole.net,0,0.00%,2,2,0.00%
ns1108.ui-dns.de,0,0.00%,4,4,0.00%
ns2.safaricombusiness.co.ke,0,0.00%,2,2,0.00%
ns2.partnerconsole.net,0,0.00%,2,2,0.00%
ns121.f7-networks.com,0,0.00%,2,2,0.00%
kaiser.ns.cloudflare.com,0,0.00%,2,2,0.00%
ns1072.ui-dns.com,0,0.00%,4,4,0.00%
ns1073.ui-dns.org,0,0.00%,2,2,0.00%
ns120.f7-networks.com,0,0.00%,2,2,0.00%
ns1057.ui-dns.de,0,0.00%,2,2,0.00%
clover5.jayahost.net,0,0.00%,2,2,0.00%
ns3.dnscpanel.com,0,0.00%,2,2,0.00%
kay.ns.cloudflare.com,0,0.00%,4,4,0.00%
clover6.jayahost.net,0,0.00%,2,2,0.00%
ns1.nurjahanandsonsbd.com,0,0.00%,2,2,0.00%
ns1.vulcano.servidor.seg.br,0,0.00%,2,2,0.00%
dns2.harmonweb.net,0,0.00%,2,2,0.00%
ns47.wpxhosting.com,0,0.00%,2,2,0.00%
ns13.dnsowner.com,0,0.00%,2,2,0.00%
ns20.dnsproviders.info,0,0.00%,4,4,0.00%
ns14.dnsowner.com,0,0.00%,2,2,0.00%
ns1.antagus.de,0,0.00%,2,2,0.00%
ns1086.ui-dns.de,0,0.00%,2,2,0.00%
dns.rebel.ca,0,0.00%,4,4,0.00%
ns1030.ui-dns.biz,0,0.00%,2,2,0.00%
ns2.vulcano.servidor.seg.br,0,0.00%,2,2,0.00%
ns1.dnscpanel.com,0,0.00%,2,2,0.00%
ns-1080.awsdns-07.org,0,0.00%,2,2,0.00%
ns48.hostgator.mx,0,0.00%,2,2,0.00%
ns40.dns2us.com,0,0.00%,4,4,0.00%
ns1.icasei.com.br,0,0.00%,4,4,0.00%
ns1.netfrontier.info,0,0.00%,2,2,0.00%
ns49.hostgator.mx,0,0.00%,2,2,0.00%
ns1.myukcloud.com,0,0.00%,2,2,0.00%
katja.ns.cloudflare.com,0,0.00%,2,2,0.00%
ns4.weblium.com,0,0.00%,2,2,0.00%
ns2.myukcloud.com,0,0.00%,2,2,0.00%
margo.ns.cloudflare.com,0,0.00%,2,2,0.00%
ns1.nfdns.net,0,0.00%,2,2,0.00%
ns1.orahost.xyz,0,0.00%,2,2,0.00%
ns3.weblium.com,0,0.00%,2,2,0.00%
elsa.ns.cloudflare.com,0,0.00%,2,2,0.00%
ns10.dnshoster.net,0,0.00%,4,4,0.00%
chad.ns.cloudflare.com,0,0.00%,6,6,0.00%
ns-1542.awsdns-00.co.uk,0,0.00%,2,2,0.00%
ns-184.awsdns-23.com,0,0.00%,1,1,0.00%
ns-1915.awsdns-47.co.uk,0,0.00%,1,1,0.00%
ns-530.awsdns-02.net,0,0.00%,2,2,0.00%
num5.17986.net,0,0.00%,2,2,0.00%
ns2.easyname.eu,0,0.00%,4,4,0.00%
verification-d66383f2.ns3.dan.hosting,0,0.00%,1,1,0.00%
greaching.com,0,0.00%,1,1,0.00%
ns21018.ztomy.com,0,0.00%,2,2,0.00%
brett.ns.cloudflare.com,0,0.00%,2,2,0.00%
ns11018.ztomy.com,0,0.00%,1,1,0.00%
naya.ns.cloudflare.com,0,0.00%,4,4,0.00%
otter.dnspod.net,0,0.00%,2,2,0.00%
cosmos.dnspod.net,0,0.00%,2,2,0.00%
verification-81ik3kjj.ns3.dan.hosting,0,0.00%,1,1,0.00%
ns4.supercp.com,0,0.00%,1,1,0.00%
ns3.supercp.com,0,0.00%,2,2,0.00%
ns2.supercp.com,0,0.00%,1,1,0.00%
ns1.supercp.com,0,0.00%,1,1,0.00%
xn--7gqr5yj14a.com,0,0.00%,1,1,0.00%
ns1018.ui-dns.de,0,0.00%,1,1,0.00%
ns1.easyname.eu,0,0.00%,3,3,0.00%
ns2.hmsns.com,0,0.00%,1,1,0.00%
ns1022.ui-dns.com,0,0.00%,3,3,0.00%
jared.dnspod.net,0,0.00%,2,2,0.00%
ns1.hmsns.com,0,0.00%,1,1,0.00%
clara.dnspod.net,0,0.00%,2,2,0.00%
ns3.hmsns.com,0,0.00%,2,2,0.00%
win34.irandns.com,0,0.00%,2,2,0.00%
win33.irandns.com,0,0.00%,1,1,0.00%
park.namepre.com,0,0.00%,2,2,0.00%
titan.ns.cloudflare.com,0,0.00%,2,2,0.00%
ns1.sdns.vn,0,0.00%,1,1,0.00%
ns2.sdns.vn,0,0.00%,1,1,0.00%
drake.ns.cloudflare.com,0,0.00%,4,4,0.00%
hw.mail.163.com,0,0.00%,4,4,0.00%
texort.mercury.orderbox-dns.com,0,0.00%,2,2,0.00%
ce1.dns.com,0,0.00%,2,2,0.00%
ce2.dns.com,0,0.00%,2,2,0.00%
ns15.xincache.com,0,0.00%,8,8,0.00%
ns16.xincache.com,0,0.00%,8,8,0.00%
manmianbao.com,0,0.00%,2,2,0.00%
verification-59123282.ns3.dan.hosting,0,0.00%,2,2,0.00%
ns1.fastpark.net,0,0.00%,1,1,0.00%
ns2.fastpark.net,0,0.00%,2,2,0.00%
texort.mars.orderbox-dns.com,0,0.00%,2,2,0.00%
ns.phx4.nearlyfreespeech.net,0,0.00%,2,2,0.00%
texort.earth.orderbox-dns.com,0,0.00%,1,1,0.00%
ns.phx7.nearlyfreespeech.net,0,0.00%,1,1,0.00%
texort.venus.orderbox-dns.com,0,0.00%,1,1,0.00%
dns2.internic.ca,0,0.00%,1,1,0.00%
verification-dyau0qgs.ns3.dan.hosting,0,0.00%,2,2,0.00%
ns1.taipandns.com,0,0.00%,2,2,0.00%
ns2.taipandns.com,0,0.00%,1,1,0.00%
originallyfood.com,0,0.00%,2,2,0.00%
ns1.host-care.com,0,0.00%,2,2,0.00%
wiwan60.calgary.westnet.ca,0,0.00%,2,2,0.00%
ns2.host-care.com,0,0.00%,2,2,0.00%
linheb14.ikoula.com,0,0.00%,1,1,0.00%
www.data5u.com,0,0.00%,6,6,0.00%
ns1.comn.com,0,0.00%,2,2,0.00%
mimi.ns.cloudflare.com,0,0.00%,4,4,0.00%
ns2.comn.com,0,0.00%,2,2,0.00%
ns8913.banahosting.com,0,0.00%,2,2,0.00%
andronicus.ns.cloudflare.com,0,0.00%,2,2,0.00%
ns8912.banahosting.com,0,0.00%,2,2,0.00%
ns2.domainmx.com,0,0.00%,2,2,0.00%
dns3.hostiners.com,0,0.00%,1,1,0.00%
dns4.hostiners.com,0,0.00%,1,1,0.00%
pujiwuliu.com,0,0.00%,1,1,0.00%
dns1.hostiners.com,0,0.00%,2,2,0.00%
ns1.sprinthost.ru,0,0.00%,30,30,0.00%
ns363.hostgator.com.br,0,0.00%,1,1,0.00%
ns8-l2.nic.ru,0,0.00%,16,16,0.00%
dns1.parastorage.com,0,0.00%,1,1,0.00%
ns2.hostiman.ru,0,0.00%,6,6,0.00%
ns-1055.awsdns-03.org,0,0.00%,1,1,0.00%
dns2.parastorage.com,0,0.00%,1,1,0.00%
dns1.yandex.net,0,0.00%,2,2,0.00%
ns-1744.awsdns-26.co.uk,0,0.00%,1,1,0.00%
ns-160-b.gandi.net,0,0.00%,2,2,0.00%
v0n0.nic.salon,0,0.00%,1,1,0.00%
casey.ns.cloudflare.com,0,0.00%,2,2,0.00%
ns3.secureweb.vn,0,0.00%,2,2,0.00%
ns1.secureweb.vn,0,0.00%,1,1,0.00%
ns2.secureweb.vn,0,0.00%,2,2,0.00%
ns-1271.awsdns-30.org,0,0.00%,1,1,0.00%
ns124.f7-networks.com,0,0.00%,2,2,0.00%
ns-1916.awsdns-47.co.uk,0,0.00%,1,1,0.00%
ns-228-a.gandi.net,0,0.00%,1,1,0.00%
hugh.ns.cloudflare.com,0,0.00%,2,2,0.00%
ns-343.awsdns-42.com,0,0.00%,1,1,0.00%
ns123.f7-networks.com,0,0.00%,1,1,0.00%
ns4.dnsmadeeasy.com,0,0.00%,4,4,0.00%
ns-855.awsdns-42.net,0,0.00%,2,2,0.00%
ns1.loopiagroup.com,0,0.00%,2,2,0.00%
kiki.bunny.net,0,0.00%,7,7,0.00%
ns1.de8.fcomet.com,0,0.00%,1,1,0.00%
ns0.dnsmadeeasy.com,0,0.00%,4,4,0.00%
ns2.dnsmadeeasy.com,0,0.00%,4,4,0.00%
ns3.dnsmadeeasy.com,0,0.00%,4,4,0.00%
heidi.ns.cloudflare.com,0,0.00%,2,2,0.00%
gns195b.sendsay.ru,0,0.00%,2,2,0.00%
ns-89-b.gandi.net,0,0.00%,3,3,0.00%
ns-1692.awsdns-19.co.uk,0,0.00%,1,1,0.00%
ns2.gohost.kz,0,0.00%,1,1,0.00%
ns2.de8.fcomet.com,0,0.00%,1,1,0.00%
dns2.site5.com,0,0.00%,3,3,0.00%
ns-534.awsdns-02.net,0,0.00%,2,2,0.00%
dns.site5.com,0,0.00%,4,4,0.00%
ns4.sprinthost.net,0,0.00%,28,28,0.00%
ns.masterhost.ru,0,0.00%,8,8,0.00%
ns2.sprinthost.ru,0,0.00%,28,28,0.00%
ns3.hostland.ru,0,0.00%,3,3,0.00%
ns1.universe-iptv.net,0,0.00%,2,2,0.00%
ns3.gohost.kz,0,0.00%,2,2,0.00%
blob.bz7prdstr10a.store.core.windows.NET,0,0.00%,2,2,0.00%
apollo.ns.cloudflare.com,0,0.00%,2,2,0.00%
ns2.tobiz.net,0,0.00%,2,2,0.00%
ns2.universe-iptv.net,0,0.00%,1,1,0.00%
ns4.binero.se,0,0.00%,10,10,0.00%
ns1.gohost.kz,0,0.00%,2,2,0.00%
6t.shop,0,0.00%,1,1,0.00%
a.dns.ripn.net,0,0.00%,7,7,0.00%
ns4.inleed.net,0,0.00%,5,5,0.00%
ns2.simply.com,0,0.00%,12,12,0.00%
ns3.creatium.io,0,0.00%,6,6,0.00%
ns-1006.awsdns-61.net,0,0.00%,2,2,0.00%
ns-1375.awsdns-43.org,0,0.00%,1,1,0.00%
ns4.zomro.su,0,0.00%,6,6,0.00%
ns-1061.awsdns-04.org,0,0.00%,1,1,0.00%
cyclamen.dnspod.net,0,0.00%,4,4,0.00%
ns-1829.awsdns-36.co.uk,0,0.00%,2,2,0.00%
da400a.trouble-free.net,0,0.00%,2,2,0.00%
ns-695.awsdns-22.net,0,0.00%,2,2,0.00%
da400b.trouble-free.net,0,0.00%,2,2,0.00%
ns29.domaincontrol.com,0,0.00%,1,1,0.00%
verification-3f308ab4.ns3.dan.hosting,0,0.00%,8,8,0.00%
ns30.domaincontrol.com,0,0.00%,2,2,0.00%
ns3.vdsina.ru,0,0.00%,7,7,0.00%
ns2.spaceweb.ru,0,0.00%,12,12,0.00%
ns2.hostup.se,0,0.00%,4,4,0.00%
ns1.egensajt.se,0,0.00%,2,2,0.00%
javier.ns.cloudflare.com,0,0.00%,2,2,0.00%
ns64.wpx.net,0,0.00%,1,1,0.00%
cp4.privatesystems.net,0,0.00%,1,1,0.00%
cp2.privatesystems.net,0,0.00%,2,2,0.00%
ns65.wpx.net,0,0.00%,1,1,0.00%
ns3.sprinthost.net,0,0.00%,13,13,0.00%
ns1.spaceweb.ru,0,0.00%,6,6,0.00%
ns4.missdns.net,0,0.00%,2,2,0.00%
adel.ns.cloudflare.com,0,0.00%,2,2,0.00%
v0n0.nic.services,0,0.00%,5,5,0.00%
ns1.saimnameserver.com,0,0.00%,8,8,0.00%
ns1.hostiman.ru,0,0.00%,6,6,0.00%
clarissa.ns.cloudflare.com,0,0.00%,2,2,0.00%
ns3.spaceweb.pro,0,0.00%,11,11,0.00%
pns44.cloudns.net,0,0.00%,2,2,0.00%
coby.ns.cloudflare.com,0,0.00%,1,1,0.00%
ns87.hostia.name,0,0.00%,2,2,0.00%
ns-174-b.gandi.net,0,0.00%,2,2,0.00%
ns-248-c.gandi.net,0,0.00%,2,2,0.00%
odin.ns.cloudflare.com,0,0.00%,2,2,0.00%
ns05.crystone.se,0,0.00%,4,4,0.00%
ns03.crystone.se,0,0.00%,2,2,0.00%
ns3.ilait.se,0,0.00%,1,1,0.00%
ns2.missdns.net,0,0.00%,2,2,0.00%
ns1085.ui-dns.de,0,0.00%,1,1,0.00%
ns7.binero.se,0,0.00%,10,10,0.00%
ns-125-a.gandi.net,0,0.00%,3,3,0.00%
ns1.domdom.net,0,0.00%,2,2,0.00%
ns1099.ui-dns.org,0,0.00%,2,2,0.00%
ns3.binero.se,0,0.00%,5,5,0.00%
ns04.crystone.se,0,0.00%,2,2,0.00%
dns2.oderland.com,0,0.00%,2,2,0.00%
ns1083.ui-dns.biz,0,0.00%,2,2,0.00%
dns1.oderland.com,0,0.00%,2,2,0.00%
ns4.ilait.se,0,0.00%,1,1,0.00%
ns6.binero.se,0,0.00%,10,10,0.00%
ns1.ilait.se,0,0.00%,2,2,0.00%
ns3.domdom.net,0,0.00%,1,1,0.00%
ns1.p01.antagonist.nl,0,0.00%,2,2,0.00%
ns4.simply.com,0,0.00%,6,6,0.00%
dns3.oderland.com,0,0.00%,4,4,0.00%
ns1106.ui-dns.biz,0,0.00%,1,1,0.00%
ns4.creatium.io,0,0.00%,8,8,0.00%
ns1.simply.com,0,0.00%,14,14,0.00%
ns3.simply.com,0,0.00%,6,6,0.00%
ns1106.ui-dns.de,0,0.00%,1,1,0.00%
ns2.h6dns.online,0,0.00%,1,1,0.00%
ns2.p01.antagonist.net,0,0.00%,2,2,0.00%
ns02.crystone.se,0,0.00%,4,4,0.00%
b.ezdnscenter.com,0,0.00%,4,4,0.00%
ns4.hostup.se,0,0.00%,4,4,0.00%
ns1040.ui-dns.biz,0,0.00%,1,1,0.00%
ns3.hostup.se,0,0.00%,4,4,0.00%
ns1.hostup.se,0,0.00%,2,2,0.00%
ns3.p01.antagonist.de,0,0.00%,1,1,0.00%
ns1dhq.name.com,0,0.00%,2,2,0.00%
ns-165.awsdns-20.com,0,0.00%,3,3,0.00%
ns-1857.awsdns-40.co.uk,0,0.00%,1,1,0.00%
ainsley.ns.cloudflare.com,0,0.00%,2,2,0.00%
ns2.setup.ru,0,0.00%,2,2,0.00%
ns-906.awsdns-49.net,0,0.00%,1,1,0.00%
melany.ns.cloudflare.com,0,0.00%,2,2,0.00%
carlos.ns.cloudflare.com,0,0.00%,2,2,0.00%
stevie.ns.cloudflare.com,0,0.00%,4,4,0.00%
ovary.dnspod.net,0,0.00%,2,2,0.00%
ns2.vdsina.ru,0,0.00%,12,12,0.00%
adele.ns.cloudflare.com,0,0.00%,2,2,0.00%
ns2.lumik.se,0,0.00%,4,4,0.00%
ns2.elainehosting.se,0,0.00%,1,1,0.00%
ns3.lumik.se,0,0.00%,4,4,0.00%
arnold.ns.cloudflare.com,0,0.00%,2,2,0.00%
ns1.ballou.se,0,0.00%,2,2,0.00%
ns2.domains.scot,0,0.00%,1,1,0.00%
ns1.lumik.se,0,0.00%,2,2,0.00%
thejunipertree.scot,0,0.00%,2,2,0.00%
ns2099.ifastnet.com,0,0.00%,4,4,0.00%
ns1.vdsina.ru,0,0.00%,7,7,0.00%
ns1.fsdatans.net,0,0.00%,2,2,0.00%
ns2.fsdatans.net,0,0.00%,2,2,0.00%
ns3-l2.nic.ru,0,0.00%,16,16,0.00%
ns1.elainehosting.se,0,0.00%,2,2,0.00%
ns1.domains.scot,0,0.00%,1,1,0.00%
ns2.ihc.ru,0,0.00%,4,4,0.00%
ns6.inleed.net,0,0.00%,10,10,0.00%
ns3.egensajt.se,0,0.00%,1,1,0.00%
ns3.domains.scot,0,0.00%,1,1,0.00%
ns3.ballou.se,0,0.00%,1,1,0.00%
ns4.vdsina.ru,0,0.00%,10,10,0.00%
ns1.missdns.net,0,0.00%,2,2,0.00%
ns5.inleed.net,0,0.00%,10,10,0.00%
dns.otimo.se,0,0.00%,2,2,0.00%
ns4.domains.scot,0,0.00%,1,1,0.00%
ns3.inleed.net,0,0.00%,5,5,0.00%
ns1.headsite.se,0,0.00%,6,6,0.00%
ns34.win.hostgator.com,0,0.00%,2,2,0.00%
dns2.otimo.se,0,0.00%,1,1,0.00%
ns2.hostingru.net,0,0.00%,1,1,0.00%
ns2.egensajt.se,0,0.00%,1,1,0.00%
ns33.win.hostgator.com,0,0.00%,1,1,0.00%
ns4.egensajt.se,0,0.00%,2,2,0.00%
ns2.loopiagroup.com,0,0.00%,4,4,0.00%
pns43.cloudns.net,0,0.00%,2,2,0.00%
ns3.svenskadomaner.se,0,0.00%,2,2,0.00%
verification-udtn2phw.ns3.dan.hosting,0,0.00%,2,2,0.00%
pns41.cloudns.net,0,0.00%,1,1,0.00%
pns42.cloudns.net,0,0.00%,2,2,0.00%
p205-fmip.icloud.com.cn,0,0.00%,2,2,0.00%
www.jx.news.cn,0,0.00%,2,2,0.00%
www.jx.xinhuanet.com,0,0.00%,2,2,0.00%
mail.zaxfxql.cn,0,0.00%,2,2,0.00%
ns-tel1.qq.com,0,0.00%,2,2,0.00%
www.ln.news.cn,0,0.00%,2,2,0.00%
www.ln.xinhuanet.com,0,0.00%,2,2,0.00%
gld.push.samsungosp.com,0,0.00%,2,2,0.00%
usa4.666670.xyz,0,0.00%,4,4,0.00%
onedscolprdwus10.westus.cloudapp.azure.com,0,0.00%,12,12,0.00%
s-ring.msedge.net,0,0.00%,2,2,0.00%
a-ring-fallback.msedge.net,0,0.00%,4,4,0.00%
113705737.home.news.cn,0,0.00%,2,2,0.00%
www.banyuetan.org,0,0.00%,2,2,0.00%
mail.wokgtg.top,0,0.00%,2,2,0.00%
cdn.app.xinhuanet.com,0,0.00%,2,2,0.00%
focs2022.eecs.berkeley.edu,0,0.00%,2,2,0.00%
settings-prod-wus2-1.westus2.cloudapp.azure.com,0,0.00%,2,2,0.00%
eecs-haproxy-vip.eecs.berkeley.edu,0,0.00%,2,2,0.00%
p209-caldav.icloud.com.cn,0,0.00%,3,3,0.00%
win10-trt.msedge.net,0,0.00%,9,9,0.00%
barcamp.eusib.de,0,0.00%,61,61,0.00%
download.smallpdf.com,0,0.00%,2,2,0.00%
appleimap.126.com,0,0.00%,2,2,0.00%
logziop.reasonsecurity.com,0,0.00%,4,4,0.00%
doh-de.blahdns.com,0,0.00%,4,4,0.00%
valisimofashions.com,0,0.00%,1,1,0.00%
info-push.duba.net,0,0.00%,2,2,0.00%
msg-push.duba.net,0,0.00%,3,3,0.00%
www.feirar.com,0,0.00%,2,2,0.00%
store.log.ksyun.com,0,0.00%,2,2,0.00%
wx29.cg.qq.com,0,0.00%,2,2,0.00%
tools.tmga.qq.com,0,0.00%,2,2,0.00%
control.mna.qq.com,0,0.00%,2,2,0.00%
cn.voice.gcloudcs.com,0,0.00%,2,2,0.00%
speed.ino.qq.com,0,0.00%,2,2,0.00%
travelservice-drcn.cloud.dbankcloud.cn,0,0.00%,2,2,0.00%
trpcpb.imtt.qq.com,0,0.00%,2,2,0.00%
tpush.html5.qq.com,0,0.00%,4,4,0.00%
hllb-hl.mig.tencent-cloud.net,0,0.00%,2,2,0.00%
mtt.str.mdt.qq.com,0,0.00%,2,2,0.00%
littlecdn.com,0,0.00%,6,6,0.00%
kde.qq.com,0,0.00%,2,2,0.00%
rpt.gdt.qq.com,0,0.00%,6,6,0.00%
skin.wsm.360.cn,0,0.00%,2,2,0.00%
photo.pic.sohu.com,0,0.00%,1,1,0.00%
onedriveclucprodbn20043.blob.core.windows.net,0,0.00%,1,1,0.00%
push-rtmp-hs-f5-encryption.douyincdn.com.c.volcfcdndvs.com,0,0.00%,1,1,0.00%
push-rtmp-spe-l6.douyincdn.com.upvcloud.ks-cdn.com,0,0.00%,1,1,0.00%
push-rtmp-l6.ixigua.com.upvcloud.ks-cdn.com,0,0.00%,1,1,0.00%
toutiao.uplive.ks-cdn.com,0,0.00%,1,1,0.00%
fp-vp-nocache.azureedge.net,0,0.00%,1,1,0.00%
array502.prod.do.dsp.mp.microsoft.com,0,0.00%,1,1,0.00%
tracker1.itzmx.com,0,0.00%,2,2,0.00%
ali-bj-pcdn-14.biliapi.net,0,0.00%,2,2,0.00%
onedscolprdweu00.westeurope.cloudapp.azure.com,0,0.00%,1,1,0.00%
st.p.360.cn,0,0.00%,12,12,0.00%
d1tcio87buo4yy.cloudfront.net,0,0.00%,1,1,0.00%
c1--cn-gotcha208.bilivideo.com,0,0.00%,1,1,0.00%
live.bilibili.com,0,0.00%,1,1,0.00%
hw-sh-live-p2p-3.chat.bilibili.com,0,0.00%,1,1,0.00%
stun.chat.bilibili.com,0,0.00%,20,20,0.00%
wps-file.obs.cn-north-4.myhuaweicloud.com,0,0.00%,1,1,0.00%
updatecenter.qq.com,0,0.00%,2,2,0.00%
sp3.sangfor.com.cn,0,0.00%,8,8,0.00%
sp2.sangfor.com.cn,0,0.00%,7,7,0.00%
kstj.baidu.com,0,0.00%,3,3,0.00%
d3hndmbr6e28d5.cloudfront.net,0,0.00%,2,2,0.00%
onedscolprdwus05.westus.cloudapp.azure.com,0,0.00%,9,9,0.00%
www.wiris.net,0,0.00%,11,11,0.00%
267.bshl.ieplgia9929.net,0,0.00%,4,4,0.00%
livenet.video.iqiyi.com,0,0.00%,6,6,0.00%
api-lequ.iqiyi.com,0,0.00%,4,4,0.00%
www.businessfocus.online,0,0.00%,4,4,0.00%
topics.businessfocus.online,0,0.00%,3,3,0.00%
hl2rcv.adobe.com,0,0.00%,2,2,0.00%
www.win10com.com,0,0.00%,2,2,0.00%
ali-bj-pcdn-32.biliapi.net,0,0.00%,2,2,0.00%
pool.nto.org,0,0.00%,4,4,0.00%
inference-location-southeastasia.southeastasia.cloudapp.azure.com,0,0.00%,2,2,0.00%
g7.biz.weibo.com,0,0.00%,4,4,0.00%
bj.linyeming.pub,0,0.00%,8,8,0.00%
www.zhixi.com,0,0.00%,4,4,0.00%
taoquan.taobao.com,0,0.00%,2,2,0.00%
dnnx3exhrd7to.cloudfront.net,0,0.00%,3,3,0.00%
omnatuor.com,0,0.00%,4,4,0.00%
factors.sofire.baidu.com,0,0.00%,2,2,0.00%
packages.crunchbangplusplus.org,0,0.00%,4,4,0.00%
z9.cnzz.com,0,0.00%,2,2,0.00%
z13.cnzz.com,0,0.00%,2,2,0.00%
luas.im.ke.com,0,0.00%,1,1,0.00%
im.api.ke.com,0,0.00%,1,1,0.00%
shu.y.qq.com,0,0.00%,1,1,0.00%
lf5-article.toutiaostatic.com.yangyi19.com,0,0.00%,1,1,0.00%
p3-sign.toutiaoimg.com,0,0.00%,1,1,0.00%
s.weibo.com,0,0.00%,8,8,0.00%
js.t.sinajs.cn,0,0.00%,1,1,0.00%
img.t.sinajs.cn,0,0.00%,2,2,0.00%
sat02pap005.settings.live.net,0,0.00%,1,1,0.00%
d3uniwo7xqjvhe.cloudfront.net,0,0.00%,1,1,0.00%
onedscolprdcus12.centralus.cloudapp.azure.com,0,0.00%,3,3,0.00%
fsr.lenovomm.com,0,0.00%,2,2,0.00%
lsw-fast.lenovo.com.cn,0,0.00%,2,2,0.00%
rd.ilive.cn,0,0.00%,2,2,0.00%
ssl.log.wtlogin.qq.com,0,0.00%,2,2,0.00%
novel.html5.qq.com,0,0.00%,1,1,0.00%
astivysauran.com,0,0.00%,2,2,0.00%
p.qiao.baidu.com,0,0.00%,1,1,0.00%
skin.se.360.cn,0,0.00%,1,1,0.00%
onedscolprdcus00.centralus.cloudapp.azure.com,0,0.00%,1,1,0.00%
webpush.pan.baidu.com,0,0.00%,1,1,0.00%
yun.baidu.com,0,0.00%,1,1,0.00%
p1.img.cctvpic.com,0,0.00%,1,1,0.00%
pannss.bdstatic.com,0,0.00%,1,1,0.00%
staticwx.cdn.bcebos.com,0,0.00%,1,1,0.00%
xlab.baidu.com,0,0.00%,3,3,0.00%
imageadv.ccb.com,0,0.00%,1,1,0.00%
cdn.wwads.cn,0,0.00%,1,1,0.00%
www.ccb.com,0,0.00%,3,3,0.00%
onedscolprdneu02.northeurope.cloudapp.azure.com,0,0.00%,2,2,0.00%
ocsp.comodoca.com,0,0.00%,7,7,0.00%
hk10.virtual-strike.com,0,0.00%,1,1,0.00%
jp10.virtual-strike.com,0,0.00%,1,1,0.00%
imap.mail.me.com,0,0.00%,1,1,0.00%
fxtt.ru,0,0.00%,3,3,0.00%
tracker.videodrugproject.com,0,0.00%,3,3,0.00%
tracker.swateam.org.uk,0,0.00%,2,2,0.00%
allesanddro.de,0,0.00%,3,3,0.00%
trackerxyz.tk,0,0.00%,3,3,0.00%
retracker.spark-rostov.ru,0,0.00%,3,3,0.00%
ins-pe24hspk.ias.tencent-cloud.net,0,0.00%,1,1,0.00%
onedscolprdcus03.centralus.cloudapp.azure.com,0,0.00%,7,7,0.00%
onedscolprdeus06.eastus.cloudapp.azure.com,0,0.00%,1,1,0.00%
i-bl6p-cor003.api.p001.1drv.com,0,0.00%,1,1,0.00%
www.baidupcs.com,0,0.00%,1,1,0.00%
bj.baidupcs.com,0,0.00%,1,1,0.00%
qd.baidupcs.com,0,0.00%,1,1,0.00%
push.zone1.meitudata.com,0,0.00%,1,1,0.00%
mfn.meitu.jcloudimg.com,0,0.00%,1,1,0.00%
onedscolprdfrc07.francecentral.cloudapp.azure.com,0,0.00%,2,2,0.00%
lfghub-anonymous.xboxlive.com,0,0.00%,1,1,0.00%
auth-cloudfront.prod.ims.adobejanus.com,0,0.00%,1,1,0.00%
smvconf.f.360.cn,0,0.00%,1,1,0.00%
configdownload.dbankcdn.cn,0,0.00%,1,1,0.00%
log.avlyun.com,0,0.00%,1,1,0.00%
tmfsdk.m.qq.com,0,0.00%,1,1,0.00%
v20.vortex-win.data.microsoft.com,0,0.00%,1,1,0.00%
onedscolprdcus08.centralus.cloudapp.azure.com,0,0.00%,1,1,0.00%
00736a3f45a6bf1d0b17f8888121da0a.b.hon.cc.cdnhwc8.com,0,0.00%,2,2,0.00%
3b6458b6197c9cbaa68e5101f0b90b9e.b.hon.cc.cdnhwc8.com,0,0.00%,1,1,0.00%
www.mythtao.com,0,0.00%,8,8,0.00%
nt.e23.cn,0,0.00%,1,1,0.00%
download.csdn.net,0,0.00%,2,2,0.00%
imonline.corp.imdada.cn,0,0.00%,2,2,0.00%
redpoint-msg.m.jd.com,0,0.00%,2,2,0.00%
sh.jd.com,0,0.00%,2,2,0.00%
dns.jd.com,0,0.00%,2,2,0.00%
sdkapi-smartop.jiguang.cn,0,0.00%,2,2,0.00%
image.baidu.com,0,0.00%,2,2,0.00%
top.baidu.com,0,0.00%,2,2,0.00%
tuijian.hao123.com,0,0.00%,2,2,0.00%
code.51.com,0,0.00%,2,2,0.00%
baiduzm.37.com,0,0.00%,2,2,0.00%
focus.tianya.cn,0,0.00%,2,2,0.00%
gad.netease.com,0,0.00%,2,2,0.00%
game.hao123.com,0,0.00%,2,2,0.00%
haokan.baidu.com,0,0.00%,2,2,0.00%
wan.baidu.com,0,0.00%,2,2,0.00%
wvw.4366.com,0,0.00%,2,2,0.00%
www.12306.cn,0,0.00%,2,2,0.00%
www.abchina.com,0,0.00%,2,2,0.00%
www.anjuke.com,0,0.00%,2,2,0.00%
www.boc.cn,0,0.00%,2,2,0.00%
www.chsi.com.cn,0,0.00%,2,2,0.00%
www.ctrip.com,0,0.00%,2,2,0.00%
www.eastmoney.com,0,0.00%,2,2,0.00%
www.gaodun.com,0,0.00%,2,2,0.00%
www.mgtv.com,0,0.00%,2,2,0.00%
xueshu.baidu.com,0,0.00%,2,2,0.00%
jump.luna.58.com,0,0.00%,2,2,0.00%
live.baidu.com,0,0.00%,2,2,0.00%
p4psearch.1688.com,0,0.00%,2,2,0.00%
quanmin.baidu.com,0,0.00%,2,2,0.00%
shark-tracer.netease.com,0,0.00%,2,2,0.00%
s.click.taobao.com,0,0.00%,2,2,0.00%
t.vip.com,0,0.00%,2,2,0.00%
tejia.hao123.com,0,0.00%,2,2,0.00%
tv.sohu.com,0,0.00%,2,2,0.00%
u.jd.com,0,0.00%,2,2,0.00%
union-click.jd.com,0,0.00%,2,2,0.00%
v.6.cn,0,0.00%,2,2,0.00%
v.baidu.com,0,0.00%,2,2,0.00%
v.hao123.baidu.com,0,0.00%,2,2,0.00%
www.cnr.cn,0,0.00%,2,2,0.00%
www.cri.cn,0,0.00%,2,2,0.00%
www.people.com.cn,0,0.00%,2,2,0.00%
www.qstheory.cn,0,0.00%,2,2,0.00%
www.youth.cn,0,0.00%,2,2,0.00%
www.yy.com,0,0.00%,2,2,0.00%
shield.hao123.com,0,0.00%,2,2,0.00%
g-api.csdn.net,0,0.00%,2,2,0.00%
as1.m.hao123.com,0,0.00%,2,2,0.00%
mid.hao123.com,0,0.00%,2,2,0.00%
img20.360buyimg.com,0,0.00%,2,2,0.00%
m.360buyimg.com.gslb.qianxun.com,0,0.00%,2,2,0.00%
tbsrecovery.imtt.qq.com,0,0.00%,2,2,0.00%
t12.meishow.vip.cname2985.yjs-cdn.com,0,0.00%,2,2,0.00%
t31.meishow.vip.cname2985.yjs-cdn.com,0,0.00%,2,2,0.00%
wbox.sinaimg.cn,0,0.00%,4,4,0.00%
p211-caldav.icloud.com.cn,0,0.00%,4,4,0.00%
g.cn.miaozhen.com,0,0.00%,4,4,0.00%
voilatile-pa.googleapis.com,0,0.00%,4,4,0.00%
i-dsm01p-cor008.api.p001.1drv.com,0,0.00%,2,2,0.00%
www.thecover.cn,0,0.00%,4,4,0.00%
yun.thecover.cn,0,0.00%,4,4,0.00%
cd.xdplt.com,0,0.00%,2,2,0.00%
pp.xdplt.com,0,0.00%,2,2,0.00%
mi.gdt.qq.com,0,0.00%,2,2,0.00%
open.e.kuaishou.com,0,0.00%,2,2,0.00%
sofire.n.shifen.com,0,0.00%,2,2,0.00%
afd.e.shifen.com,0,0.00%,2,2,0.00%
tbim.n.shifen.com,0,0.00%,2,2,0.00%
tcbox.n.shifen.com,0,0.00%,4,4,0.00%
hmma.e.shifen.com,0,0.00%,4,4,0.00%
browserkernel.n.shifen.com,0,0.00%,2,2,0.00%
qmbd-h3.n.shifen.com,0,0.00%,2,2,0.00%
rtbasia.datahubtrack.com,0,0.00%,2,2,0.00%
post.n.shifen.com,0,0.00%,2,2,0.00%
bdbus-turbonet.baidu.com,0,0.00%,2,2,0.00%
dcdn-query.n.shifen.com,0,0.00%,2,2,0.00%
puncher.dcdn.n.shifen.com,0,0.00%,2,2,0.00%
2aaf6a2d9de902aebe346d738c6ac888.clo.footprintdns.com,0,0.00%,2,2,0.00%
fp-afd-nocache-ccp.azureedge.net,0,0.00%,2,2,0.00%
l-ring.msedge.net,0,0.00%,4,4,0.00%
fp-vs-nocache.azureedge.net,0,0.00%,4,4,0.00%
o-ring.msedge.net,0,0.00%,2,2,0.00%
sdk.split.io,0,0.00%,12,12,0.00%
supl.bd-caict.com,0,0.00%,2,2,0.00%
cloud.pinyin.sogou.com,0,0.00%,6,6,0.00%
api.languagetoolplus.com,0,0.00%,4,4,0.00%
languagetool.org,0,0.00%,2,2,0.00%
analytics.languagetoolplus.com,0,0.00%,2,2,0.00%
cda6f32740dd50c46dd37df1fefeda8f.dlied1.cdntips.net,0,0.00%,4,4,0.00%
amcdn.msftauth.net,0,0.00%,2,2,0.00%
webshell.suite.office.com,0,0.00%,2,2,0.00%
config.fp.measure.office.com,0,0.00%,2,2,0.00%
handycam.alicdn.com,0,0.00%,2,2,0.00%
20.courier-push-apple.com.akadns.net,0,0.00%,2,2,0.00%
webdemo.myscript.com,0,0.00%,2,2,0.00%
www.myscript.com,0,0.00%,2,2,0.00%
webdemoapi.myscript.com,0,0.00%,2,2,0.00%
qrcode.mse.sogou.com,0,0.00%,2,2,0.00%
topnews.imtt.qq.com,0,0.00%,2,2,0.00%
theta.sogoucdn.com,0,0.00%,2,2,0.00%
us.sogou.com,0,0.00%,1,1,0.00%
pb.sogou.com,0,0.00%,2,2,0.00%
sa.gdt.qq.com,0,0.00%,2,2,0.00%
pgdt.gtimg.cn,0,0.00%,2,2,0.00%
api.mousegesturesapi.com,0,0.00%,6,6,0.00%
latex.codecogs.com,0,0.00%,2,2,0.00%
log.kuwo.cn,0,0.00%,5,5,0.00%
mlyric.kuwo.cn,0,0.00%,1,1,0.00%
artistpicserver.kuwo.cn,0,0.00%,1,1,0.00%
musicpay.kuwo.cn,0,0.00%,3,3,0.00%
stat.tpns.tencent.com,0,0.00%,1,1,0.00%
amdc-v6.alipaydns.com,0,0.00%,1,1,0.00%
apisnd.heytapmobi.com,0,0.00%,1,1,0.00%
stockinfo.htsec.com.wswebcdn.com,0,0.00%,4,4,0.00%
ops.htsec.com.wswebcdn.com,0,0.00%,3,3,0.00%
leads.baidu.com,0,0.00%,3,3,0.00%
basic-service.baidu.com,0,0.00%,3,3,0.00%
a1834.dscg2.akamai.net,0,0.00%,2,2,0.00%
gdown.baidu.com,0,0.00%,1,1,0.00%
hao.360.com,0,0.00%,1,1,0.00%
ecmb.bdimg.com,0,0.00%,5,5,0.00%
tukuimg.bdstatic.com,0,0.00%,1,1,0.00%
app-center.cdn.bcebos.com,0,0.00%,1,1,0.00%
xinpub.bj.bcebos.com,0,0.00%,1,1,0.00%
hao1.qhimg.com,0,0.00%,1,1,0.00%
hao2.qhimg.com,0,0.00%,1,1,0.00%
hao3.qhimg.com,0,0.00%,1,1,0.00%
hao4.qhimg.com,0,0.00%,1,1,0.00%
hao5.qhimg.com,0,0.00%,1,1,0.00%
api.qrserver.com,0,0.00%,1,1,0.00%
guess.mediav.com,0,0.00%,1,1,0.00%
rcmdsites.dhrest.com,0,0.00%,1,1,0.00%
hao.ssl.dhrest.com,0,0.00%,1,1,0.00%
i.dhrest.com,0,0.00%,2,2,0.00%
cube.dhrest.com,0,0.00%,1,1,0.00%
cdn.weather.hao.360.cn,0,0.00%,1,1,0.00%
smart.sug.so.com,0,0.00%,1,1,0.00%
user.360kuai.com,0,0.00%,1,1,0.00%
cube.3600.com,0,0.00%,1,1,0.00%
jform2.baidu.com,0,0.00%,1,1,0.00%
s1.ssl.qhres2.com,0,0.00%,1,1,0.00%
gua2.qhimg.com,0,0.00%,1,1,0.00%
cjhd.mediav.com,0,0.00%,1,1,0.00%
s.hao.360.com,0,0.00%,1,1,0.00%
p.ssl.img.360kuai.com,0,0.00%,2,2,0.00%
imgx.mediav.com,0,0.00%,1,1,0.00%
match.p4p.1688.com,0,0.00%,1,1,0.00%
tiku.dhrest.com,0,0.00%,1,1,0.00%
catalog-public-service-prod06.ol.epicgames.com,0,0.00%,1,1,0.00%
gua8.qhimg.com,0,0.00%,1,1,0.00%
live-s3m.mediav.com,0,0.00%,3,3,0.00%
e.htsec.com.wscdns.com,0,0.00%,1,1,0.00%
xdssp.mediav.com,0,0.00%,1,1,0.00%
v5.360game.360.cn,0,0.00%,1,1,0.00%
yxdt.game.keniub.com,0,0.00%,1,1,0.00%
api.open.360-game.net,0,0.00%,1,1,0.00%
gsp10-ssl-cn.ls.apple.com,0,0.00%,3,3,0.00%
s3m6.fenxi.com,0,0.00%,3,3,0.00%
obus-dc20157-cn.heytapmobi.com,0,0.00%,1,1,0.00%
ns1.cyudun.net,0,0.00%,1,1,0.00%
masdkv6.3g.qq.com,0,0.00%,1,1,0.00%
js.redirect.hp.com,0,0.00%,3,3,0.00%
aws-facade-1.dataservices.hp.com,0,0.00%,1,1,0.00%
ucmp-static.sf-express.com,0,0.00%,1,1,0.00%
ucmp.sf-express.com,0,0.00%,2,2,0.00%
ubs.sf-express.com,0,0.00%,1,1,0.00%
mcs-mimp-web.sf-express.com,0,0.00%,1,1,0.00%
gss3.bdstatic.com,0,0.00%,2,2,0.00%
bdimg.share.baidu.com,0,0.00%,2,2,0.00%
fex.bdstatic.com,0,0.00%,11,11,0.00%
s1.bdstatic.com,0,0.00%,2,2,0.00%
mp.360.cn,0,0.00%,1,1,0.00%
ae.weixin.qq.com,0,0.00%,1,1,0.00%
img.baidu.com,0,0.00%,2,2,0.00%
channel-account-ssl.xunlei.com,0,0.00%,1,1,0.00%
m.data.mob.com,0,0.00%,4,4,0.00%
e4h677i7pmwc37o3.aliyunddos1026.com,0,0.00%,4,4,0.00%
awdb.nickname-vocals.net,0,0.00%,2,2,0.00%
o1069899.ingest.sentry.io,0,0.00%,3,3,0.00%
kuaikan.netmon.360safe.com,0,0.00%,2,2,0.00%
uop.umeng.com,0,0.00%,2,2,0.00%
tracking.firefox.com.cn,0,0.00%,2,2,0.00%
tracking.firefox.com.cn.wswebpic.com,0,0.00%,2,2,0.00%
minipc.eastday.com,0,0.00%,1,1,0.00%
0i4k7t9l.sched.sma-dk.tdnsstic1.cn,0,0.00%,2,2,0.00%
sp3.baidu.com,0,0.00%,3,3,0.00%
passport.n.shifen.com,0,0.00%,2,2,0.00%
sslbaidu.jomodns.com,0,0.00%,2,2,0.00%
collect.hupu.com,0,0.00%,2,2,0.00%
movie.hupu.com,0,0.00%,2,2,0.00%
conf.dc.oppomobile.com,0,0.00%,2,2,0.00%
http://t.yangkeduo.com,0,0.00%,1,1,0.00%
peoplestack-pa.clients6.google.com,0,0.00%,2,2,0.00%
chatwoot.unity.cn,0,0.00%,4,4,0.00%
tjzsprod.tsxcx.xyz,0,0.00%,4,4,0.00%
cosfile.tsxcx.xyz,0,0.00%,4,4,0.00%
www.mysmth.net,0,0.00%,2,2,0.00%
xsts.auth.xboxlive.com,0,0.00%,2,2,0.00%
t.captcha.qq.com,0,0.00%,2,2,0.00%
client-office365-tas.msedge.net,0,0.00%,6,6,0.00%
www.grammarly.com,0,0.00%,2,2,0.00%
subscription.grammarly.com,0,0.00%,2,2,0.00%
phx02pap001.storage.live.com,0,0.00%,2,2,0.00%
yum-install.centos.gatknqh.cn,0,0.00%,2,2,0.00%
bn1305.storage.live.com,0,0.00%,4,4,0.00%
alt4-mtalk.google.com,0,0.00%,2,2,0.00%
fengling.7654.com,0,0.00%,4,4,0.00%
position.dftoutiao.com,0,0.00%,3,3,0.00%
amap-aos-info-nogw.amap.com,0,0.00%,2,2,0.00%
rvpn.zju.edu.cn,0,0.00%,2,2,0.00%
data.10jqka.com.cn,0,0.00%,2,2,0.00%
bnz07pap001.storage.live.com,0,0.00%,4,4,0.00%
healthcommon.hicloud.com,0,0.00%,2,2,0.00%
wisedevice-drcn.things.hicloud.com,0,0.00%,2,2,0.00%
pla-prod-sea-sb-ns-ingest-02.servicebus.windows.net,0,0.00%,2,2,0.00%
www.starrocks.com,0,0.00%,1,1,0.00%
adashx.ut.amap.com,0,0.00%,2,2,0.00%
b4bf120.v4.gladns.com,0,0.00%,2,2,0.00%
b4bf120.v5.gladns.com,0,0.00%,2,2,0.00%
b4bf120.v6.gladns.com,0,0.00%,2,2,0.00%
b4bf120.v7.gladns.com,0,0.00%,1,1,0.00%
b4bf120.v8.gladns.com,0,0.00%,2,2,0.00%
b4bf120.v9.gladns.com,0,0.00%,2,2,0.00%
cdn.starrocks.com,0,0.00%,1,1,0.00%
z163picipv6.v.bsclink.cn,0,0.00%,2,2,0.00%
sensorsdata2.read.duokan.com,0,0.00%,2,2,0.00%
quote.eastmoney.com,0,0.00%,4,4,0.00%
stat.v.baidu.com,0,0.00%,2,2,0.00%
lancache.steamcontent.com,0,0.00%,1,1,0.00%
continuum.dds.microsoft.com,0,0.00%,4,4,0.00%
tianqi.eastday.com,0,0.00%,1,1,0.00%
www.kaggle.com,0,0.00%,2,2,0.00%
client.v.baidu.com,0,0.00%,2,2,0.00%
v.xiaodutv.com,0,0.00%,2,2,0.00%
prod-campaignaggregator.omexexternallfb.office.net.akadns.NET,0,0.00%,2,2,0.00%
ca6aa2d1d49d42dea77f8c6fa341a271.fp.measure.office.com,0,0.00%,1,1,0.00%
vamd.cnode.xyz,0,0.00%,2,2,0.00%
search.bilibili.com,0,0.00%,8,8,0.00%
sub.adtchrome.com,0,0.00%,2,2,0.00%
club.vip.qq.com,0,0.00%,2,2,0.00%
mat1.gtimg.com,0,0.00%,2,2,0.00%
cmshowar-1251316161.cos.ap-guangzhou.myqcloud.com,0,0.00%,2,2,0.00%
api.mixpanel.com,0,0.00%,2,2,0.00%
openmobile.qq.com,0,0.00%,2,2,0.00%
fclick.e.shifen.com,0,0.00%,2,2,0.00%
hihealthbase-drcn.things.hicloud.com,0,0.00%,2,2,0.00%
mrobot.pconline.com.cn.wscdns.com,0,0.00%,2,2,0.00%
d1.music.126.net.ctot.baishangeek.cn,0,0.00%,2,2,0.00%
live-cecom-image.bj.bcebos.com,0,0.00%,4,4,0.00%
www.stcn.com,0,0.00%,2,2,0.00%
wapepaper.stcn.com,0,0.00%,2,2,0.00%
ta.trs.cn,0,0.00%,2,2,0.00%
company.stcn.com,0,0.00%,2,2,0.00%
data.stcn.com,0,0.00%,2,2,0.00%
epaper.stcn.com,0,0.00%,2,2,0.00%
finance.stcn.com,0,0.00%,2,2,0.00%
info.stcn.com,0,0.00%,2,2,0.00%
wap.stcn.com,0,0.00%,2,2,0.00%
kuaixun.stcn.com,0,0.00%,2,2,0.00%
rs.stcn.com,0,0.00%,2,2,0.00%
space.stcn.com,0,0.00%,2,2,0.00%
video.stcn.com,0,0.00%,2,2,0.00%
xinpi.stcn.com,0,0.00%,2,2,0.00%
zt.stcn.com,0,0.00%,2,2,0.00%
bshare.optimix.cn,0,0.00%,2,2,0.00%
www.bshare.cn,0,0.00%,2,2,0.00%
cm.e.qq.com,0,0.00%,2,2,0.00%
cms.tanx.com,0,0.00%,2,2,0.00%
cm.fastapi.net,0,0.00%,2,2,0.00%
iclick.cm.admaster.com.cn,0,0.00%,1,1,0.00%
c.yes.youku.com,0,0.00%,2,2,0.00%
its.fugetech.com,0,0.00%,2,2,0.00%
bx01.optimix.asia,0,0.00%,2,2,0.00%
cm-udmp.gridsumdissector.com,0,0.00%,2,2,0.00%
bx.optimix.asia,0,0.00%,2,2,0.00%
bx01.optimix.cn,0,0.00%,2,2,0.00%
tx-gz-live-p2p-backup1.chat.bilibili.com,0,0.00%,2,2,0.00%
accounts.qq.com,0,0.00%,2,2,0.00%
data.sms.heytapmobi.com,0,0.00%,2,2,0.00%
sms.ads.heytapmobi.com,0,0.00%,2,2,0.00%
connectivitycheck.getdropbox.com,0,0.00%,1,1,0.00%
tripapply-appapi.gwhome.com.cn,0,0.00%,2,2,0.00%
netmanager.lkcoffee.com,0,0.00%,2,2,0.00%
open.kwaizt.com,0,0.00%,2,2,0.00%
onedscolprdwus03.westus.cloudapp.azure.com,0,0.00%,2,2,0.00%
msgcenter.kdocs.cn,0,0.00%,2,2,0.00%
weboffice.ks3-cn-beijing.ksyun.com,0,0.00%,2,2,0.00%
atm-settingsfe-prod-geo2.trafficmanager.net,0,0.00%,2,2,0.00%
vas2t-api.kdocs.cn,0,0.00%,2,2,0.00%
account.kdocs.cn,0,0.00%,2,2,0.00%
www.voscreen.com,0,0.00%,2,2,0.00%
pony.ai,0,0.00%,1,1,0.00%
novelapi.baidu.com,0,0.00%,2,2,0.00%
afd.baidu.com,0,0.00%,2,2,0.00%
afdconf.e.shifen.com,0,0.00%,2,2,0.00%
open.a.shifen.com,0,0.00%,2,2,0.00%
update.pan.n.shifen.com,0,0.00%,2,2,0.00%
dxp.baidu.com,0,0.00%,2,2,0.00%
pim.baidu.com,0,0.00%,2,2,0.00%
pim.n.shifen.com,0,0.00%,2,2,0.00%
list.z.qingting.fm,0,0.00%,2,2,0.00%
wappass.n.shifen.com,0,0.00%,2,2,0.00%
static.n.shifen.com,0,0.00%,2,2,0.00%
vipauth.hpplay.cn,0,0.00%,2,2,0.00%
logu.hpplay.cn,0,0.00%,2,2,0.00%
ssdkauth.hpplay.cn,0,0.00%,2,2,0.00%
flash.xiaohongshu.com,0,0.00%,2,2,0.00%
thumbnail0.baidupcs.com,0,0.00%,2,2,0.00%
rp.hpplay.cn,0,0.00%,4,4,0.00%
stg-data.ads.heytapmobi.com,0,0.00%,2,2,0.00%
cl-data.ads.heytapmobi.com,0,0.00%,2,2,0.00%
hmma.baidu.com,0,0.00%,2,2,0.00%
www.xljsci.com,0,0.00%,4,4,0.00%
huiduapi.nuomi.com,0,0.00%,2,2,0.00%
wifibbs.ggsafe.com,0,0.00%,2,2,0.00%
s.search.bilibili.com,0,0.00%,4,4,0.00%
76.push2his.eastmoney.com,0,0.00%,2,2,0.00%
telem-edge.smartscreen.microsoft.com,0,0.00%,2,2,0.00%
pdata.log.mgtv.com,0,0.00%,4,4,0.00%
httpdns-sdk.n.netease.com,0,0.00%,2,2,0.00%
ufosdk.baidu.com,0,0.00%,2,2,0.00%
anti-bot.n.shifen.com,0,0.00%,4,4,0.00%
image.5i5j.com,0,0.00%,2,2,0.00%
amsfile.5i5j.com,0,0.00%,2,2,0.00%
hwxypic.5i5j.com,0,0.00%,2,2,0.00%
xycitys.5i5j.com,0,0.00%,2,2,0.00%
p1-play.edge4k.com,0,0.00%,2,2,0.00%
hivision-drcn.emui.hicloud.com,0,0.00%,3,3,0.00%
wifiad.ggsafe.com,0,0.00%,2,2,0.00%
iwx.mail.qq.com,0,0.00%,4,4,0.00%
adimg.uve.weibo.com,0,0.00%,3,3,0.00%
netapm.music.163.com,0,0.00%,2,2,0.00%
storage.live.com,0,0.00%,2,2,0.00%
news.duote.com,0,0.00%,2,2,0.00%
img1.runjiapp.com,0,0.00%,2,2,0.00%
img4.runjiapp.com,0,0.00%,2,2,0.00%
img5.runjiapp.com,0,0.00%,2,2,0.00%
s5.cnzz.com,0,0.00%,2,2,0.00%
web.50bangzh.com,0,0.00%,2,2,0.00%
www.duote.com,0,0.00%,2,2,0.00%
api.steambig.com,0,0.00%,2,2,0.00%
submit.duote.com,0,0.00%,2,2,0.00%
police.cnool.net,0,0.00%,2,2,0.00%
mbook.duote.com,0,0.00%,2,2,0.00%
union.rising.com.cn,0,0.00%,2,2,0.00%
url.pc120.com,0,0.00%,2,2,0.00%
www.jiangmin.com,0,0.00%,2,2,0.00%
www.zx110.org,0,0.00%,2,2,0.00%
bd-js1.2345.com,0,0.00%,2,2,0.00%
front.steambig.com,0,0.00%,2,2,0.00%
ws.lanhuapp.com,0,0.00%,1,1,0.00%
066f0144-rh8cg0-ria0w6-g0mc.pccw.alrihla.net,0,0.00%,2,2,0.00%
r4---sn-2x3elnee.gvt1.com,0,0.00%,2,2,0.00%
pdata.video.iqiyi.com,0,0.00%,2,2,0.00%
ppcc.inter.qiyi.com,0,0.00%,2,2,0.00%
pushhub.hcdn.iqiyi.com,0,0.00%,2,2,0.00%
media.vuess.net,0,0.00%,1,1,0.00%
array803.prod.do.dsp.mp.microsoft.com,0,0.00%,6,6,0.00%
ipv4.neubt.com,0,0.00%,5,5,0.00%
7jmrbtrvkgcqkldzyob4kotpyvsgz546yvik2xv4rpnfmrhe4imxthqd.tor2web.it,0,0.00%,4,4,0.00%
kt2.pipecandyinc.co,0,0.00%,61,61,0.00%
data.unistream.io,0,0.00%,2,2,0.00%
tw302.sagittarius-link.com,0,0.00%,6,6,0.00%
zntg.10jqka.com.cn,0,0.00%,2,2,0.00%
onedscolprdwus11.westus.cloudapp.azure.com,0,0.00%,4,4,0.00%
dbb66c7ecf0843859cca3d21a61f781e.fp.measure.office.com,0,0.00%,1,1,0.00%
f1ec223f87a44e44959a6b5457a8aada.fp.measure.office.com,0,0.00%,1,1,0.00%
6e2f9599d12445fabf929a4f1434e631.fp.measure.office.com,0,0.00%,2,2,0.00%
c0.ipjingling.com,0,0.00%,4,4,0.00%
time2.cloud.tencent.com,0,0.00%,2,2,0.00%
time3.cloud.tencent.com,0,0.00%,2,2,0.00%
onedscolprdwus13.westus.cloudapp.azure.com,0,0.00%,12,12,0.00%
tts.baidu.com,0,0.00%,2,2,0.00%
intelligence.sangfor.com.cn,0,0.00%,4,4,0.00%
notify.sangfor.com.cn,0,0.00%,4,4,0.00%
cs.10jqka.com.cn,0,0.00%,2,2,0.00%
tracker.open.cd,0,0.00%,2,2,0.00%
helpkprotect1.ksmobile.com,0,0.00%,2,2,0.00%
phototj.photo.store.qq.com,0,0.00%,2,2,0.00%
qqsamestyle-77690.picgzc.qpic.cn,0,0.00%,2,2,0.00%
time4.cloud.tencent.com,0,0.00%,2,2,0.00%
e71e16d.pb.gladns.com,0,0.00%,2,2,0.00%
ws-livemate.pull.yximgs.com,0,0.00%,2,2,0.00%
ws-rwk.pull.etoote.com,0,0.00%,2,2,0.00%
ws01.pull.yximgs.com,0,0.00%,2,2,0.00%
ali-pclivemate.pull.yximgs.com,0,0.00%,2,2,0.00%
ali-rwk.pull.etoote.com,0,0.00%,2,2,0.00%
gcore.yunfan.info,0,0.00%,2,2,0.00%
v.qiihu.com,0,0.00%,3,3,0.00%
v2.qiihu.com,0,0.00%,2,2,0.00%
qapm.baidu.com,0,0.00%,2,2,0.00%
bd-rwk.pull.etoote.com,0,0.00%,2,2,0.00%
justgetflux.com,0,0.00%,2,2,0.00%
e71e16d.tt.cloudflare.systems,0,0.00%,2,2,0.00%
fp-it.fengkongcloud.com,0,0.00%,2,2,0.00%
www.cmpassport.com,0,0.00%,2,2,0.00%
onekey1.cmpassport.com,0,0.00%,2,2,0.00%
auth.wosms.cn,0,0.00%,2,2,0.00%
apppush-sh5.xiaohongshu.com,0,0.00%,2,2,0.00%
opencloud.wostore.cn,0,0.00%,2,2,0.00%
devs.data.mob.com,0,0.00%,2,2,0.00%
f.gm.mob.com,0,0.00%,2,2,0.00%
ci.xiaohongshu.com,0,0.00%,2,2,0.00%
web-resource-app.xiaohongshu.com,0,0.00%,2,2,0.00%
ads-img-al.xhscdn.com,0,0.00%,2,2,0.00%
ads-video-al.xhscdn.com,0,0.00%,2,2,0.00%
efjxmwi.amo.dseoe.ga,0,0.00%,1,1,0.00%
log-verify.mob.com,0,0.00%,2,2,0.00%
weather-edge.apple.com,0,0.00%,2,2,0.00%
lgsq-video.xhscdn.com,0,0.00%,2,2,0.00%
xhsci-10008268.cos.ap-shanghai.myqcloud.com,0,0.00%,2,2,0.00%
dc.xhscdn.com,0,0.00%,2,2,0.00%
umdc.aliapp.org,0,0.00%,2,2,0.00%
sns-img-qn.xhscdn.com,0,0.00%,2,2,0.00%
abc.rudywoo.ml,0,0.00%,1,1,0.00%
airtcpapp.top,0,0.00%,2,2,0.00%
infinity-api.infinitynewtab.com,0,0.00%,2,2,0.00%
browsercfg-drcn.cloud.dbankcloud.cn,0,0.00%,2,2,0.00%
apm.music.163.com,0,0.00%,2,2,0.00%
archive.ubuntu.com,0,0.00%,69,69,0.00%
packages.ros.org,0,0.00%,6,6,0.00%
ports.ubuntu.com,0,0.00%,58,58,0.00%
node8.hnxxcjt.com,0,0.00%,2,2,0.00%
node7.hnxxcjt.com,0,0.00%,2,2,0.00%
update.inter.iqiyi.com,0,0.00%,1,1,0.00%
ns1.sinaedge.com,0,0.00%,2,2,0.00%
videopay.hicloud.com,0,0.00%,2,2,0.00%
videoepg.hicloud.com,0,0.00%,2,2,0.00%
videouser.hicloud.com,0,0.00%,2,2,0.00%
viplevel-drcn.himovie.dbankcloud.cn,0,0.00%,2,2,0.00%
ovv4.alllook.tv,0,0.00%,1,1,0.00%
i-sat02p-cor004.api.p001.1drv.com,0,0.00%,1,1,0.00%
zzhc.vnet.cn,0,0.00%,2,2,0.00%
mobile.ximalaya.com,0,0.00%,1,1,0.00%
CM.SSRSS.CLUB,0,0.00%,2,2,0.00%
jslog.jss.com.cn,0,0.00%,1,1,0.00%
developer.api.autodesk.com,0,0.00%,1,1,0.00%
avatar2-2.pddpic.com,0,0.00%,1,1,0.00%
avatar2-3.pddpic.com,0,0.00%,1,1,0.00%
www.instagram.com,0,0.00%,3,3,0.00%
p.s.360kan.com,0,0.00%,1,1,0.00%
test.friends.getambassador.com,0,0.00%,1,1,0.00%
client-server1.safedog.cn,0,0.00%,1,1,0.00%
acp-ss-an1.adobe.io,0,0.00%,1,1,0.00%
ss879cb2.mesh.speedsonar.com,0,0.00%,2,2,0.00%
b.scorecardresearch.com,0,0.00%,1,1,0.00%
settings.xboxlive.com,0,0.00%,1,1,0.00%
radarsubmissions.apple.com,0,0.00%,1,1,0.00%
csc3-2010-crl.verisign.com,0,0.00%,1,1,0.00%
agps.location.live.net,0,0.00%,1,1,0.00%
grayconfig.ai.xiaomi.com,0,0.00%,2,2,0.00%
94117ca83117430c8f496643a6cd3a7f.fp.measure.office.com,0,0.00%,1,1,0.00%
ffed.toilet-extras.org,0,0.00%,4,4,0.00%
aas.caiyun.feixin.10086.cn,0,0.00%,4,4,0.00%
onedscolprdwus12.westus.cloudapp.azure.com,0,0.00%,2,2,0.00%
r2---sn-2x3elnes.gvt1.com,0,0.00%,10,10,0.00%
officeci-mauservice.azurewebsites.net,0,0.00%,2,2,0.00%
hb.apis.dell.com,0,0.00%,2,2,0.00%
v-7a8dc83d.71edge.com,0,0.00%,2,2,0.00%
settings-prod-cin-2.centralindia.cloudapp.azure.com,0,0.00%,2,2,0.00%
mirrors.dotsrc.org,0,0.00%,2,2,0.00%
33aef1e.nf.gladns.com,0,0.00%,2,2,0.00%
metrics.ubuntu.com,0,0.00%,1,1,0.00%
seed-swallow.siri.apple.com,0,0.00%,2,2,0.00%
v-7a8dc830.71edge.com,0,0.00%,2,2,0.00%
v-2a384bfa.71edge.com,0,0.00%,2,2,0.00%
v-2a384bf7.71edge.com,0,0.00%,2,2,0.00%
paas.lenovo.com.cn,0,0.00%,2,2,0.00%
auth.naea1.uds.lenovo.com,0,0.00%,4,4,0.00%
c-ring.msedge.net,0,0.00%,2,2,0.00%
TRANsIT1.WSlog.ChinaNeTCeNteR.cOm,0,0.00%,2,2,0.00%
clIEnTlOgVodp2p.hAPlAt.NET,0,0.00%,2,2,0.00%
P2pSTunTeST.HAPLAT.NET,0,0.00%,2,2,0.00%
mAMbAp2PVodh5.8686C.com,0,0.00%,2,2,0.00%
dot.tiar.app,0,0.00%,2,2,0.00%
dsm01pap006.storage.live.com,0,0.00%,2,2,0.00%
s.outlook.com,0,0.00%,4,4,0.00%
www.chrome-helper.cc,0,0.00%,4,4,0.00%
sub.ssr.ac,0,0.00%,2,2,0.00%
subserver.maying.io,0,0.00%,2,2,0.00%
naixisubs.com,0,0.00%,2,2,0.00%
e2cs03.gcp.gvt2.com,0,0.00%,2,2,0.00%
ebad288.nb.gladns.com,0,0.00%,2,2,0.00%
ebad288.nh.gladns.com,0,0.00%,2,2,0.00%
ebad288.nd.gladns.com,0,0.00%,2,2,0.00%
www.nvidia.com,0,0.00%,1,1,0.00%
e71e16d.pd.gladns.com,0,0.00%,2,2,0.00%
e71e16d.td.cloudflare.systems,0,0.00%,2,2,0.00%
e71e16d.nx.cloudflare.systems,0,0.00%,2,2,0.00%
honeycomb.wpscdn.cn.download.ks-cdn.com,0,0.00%,1,1,0.00%
accountv2.wpsdns.com,0,0.00%,2,2,0.00%
oapi.dingtalk.com,0,0.00%,2,2,0.00%
wss.rest.gti.mcafee.com,0,0.00%,3,3,0.00%
statsfe2.update.microsoft.com,0,0.00%,2,2,0.00%
slp2p-east-std1013.oray.net,0,0.00%,1,1,0.00%
p210-quota.icloud.com.cn,0,0.00%,1,1,0.00%
g.bing.com,0,0.00%,1,1,0.00%
wscont.apps.microsoft.com.edgesuite.net,0,0.00%,1,1,0.00%
detail.alicdn.com,0,0.00%,1,1,0.00%
kssv-w-yz01.kuaipandata.com,0,0.00%,2,2,0.00%
api.pictureknow.com,0,0.00%,2,2,0.00%
tracker.tamersunion.org,0,0.00%,2,2,0.00%
edge-096.hktko1.ce.apple-dns.net,0,0.00%,2,2,0.00%
simpledesktops.azurewebsites.net,0,0.00%,2,2,0.00%
master8.teamviewer.com,0,0.00%,6,6,0.00%
cn2888.v2free.xyz,0,0.00%,20,20,0.00%
analytics64.techsmith.com,0,0.00%,2,2,0.00%
alltorrents.net,0,0.00%,2,2,0.00%
tracker.ds.is,0,0.00%,1,1,0.00%
trakx.herokuapp.com,0,0.00%,2,2,0.00%
api.interpreter.caiyunai.com,0,0.00%,4,4,0.00%
p4p.arenabg.com,0,0.00%,2,2,0.00%
blackz.ro,0,0.00%,2,2,0.00%
app-b01.lp1.npns.srv.nintendo.net,0,0.00%,2,2,0.00%
s3m.mediav.com,0,0.00%,8,8,0.00%
loginserver.kuwo.cn,0,0.00%,3,3,0.00%
smtp.gmail.com,0,0.00%,4,4,0.00%
show.3.mediav.com,0,0.00%,2,2,0.00%
conf.wifi.360.cn,0,0.00%,2,2,0.00%
ts4.cn.mm.bing.net.lxcvc.com,0,0.00%,2,2,0.00%
ns10.zonecybersite.com,0,0.00%,2,2,0.00%
app.ucas.ac.cn,0,0.00%,4,4,0.00%
www.bangkokbank.com,0,0.00%,2,2,0.00%
ncphn.mars.baofeng.net,0,0.00%,2,2,0.00%
ns1.jcserver.net,0,0.00%,2,2,0.00%
ns-660.awsdns-18.net,0,0.00%,2,2,0.00%
malcolm.ns.cloudflare.com,0,0.00%,2,2,0.00%
ns1027.ui-dns.org,0,0.00%,4,4,0.00%
ns2.asgard8040.com.br,0,0.00%,2,2,0.00%
raquel.ns.cloudflare.com,0,0.00%,4,4,0.00%
ns4.alphadnszone.com,0,0.00%,10,10,0.00%
ns1072.ui-dns.de,0,0.00%,4,4,0.00%
ns2.jcserver.net,0,0.00%,2,2,0.00%
ajay.ns.cloudflare.com,0,0.00%,4,4,0.00%
ns1.adminvps.ru,0,0.00%,2,2,0.00%
bah2.7hostir.com,0,0.00%,2,2,0.00%
ns1062.ui-dns.biz,0,0.00%,4,4,0.00%
julissa.ns.cloudflare.com,0,0.00%,4,4,0.00%
ns2.sermayesizeticaret.com,0,0.00%,2,2,0.00%
ns4.adminvps.net,0,0.00%,2,2,0.00%
ns1.trdns.com,0,0.00%,2,2,0.00%
bah1.7hostir.com,0,0.00%,2,2,0.00%
ns2.adminvps.net,0,0.00%,2,2,0.00%
ns2.marketleader.com,0,0.00%,2,2,0.00%
ns5.alphadnszone.com,0,0.00%,10,10,0.00%
6226380651dc4c02a903778c7ae0bc23.fp.measure.office.com,0,0.00%,1,1,0.00%
ns1.asgard8040.com.br,0,0.00%,2,2,0.00%
ns1.dewaweb.com,0,0.00%,2,2,0.00%
ns3.alphadnszone.com,0,0.00%,10,10,0.00%
ns2.alphadnszone.com,0,0.00%,10,10,0.00%
ns3.dewaweb.com,0,0.00%,2,2,0.00%
ns-v5d4psv5ed.dnswnd.be,0,0.00%,2,2,0.00%
jh-01.jimatdns.com,0,0.00%,2,2,0.00%
ns-d5fyfcd5fd.dnswnd.eu,0,0.00%,2,2,0.00%
ns6.alphadnszone.com,0,0.00%,10,10,0.00%
ns2.boxsecured.com,0,0.00%,2,2,0.00%
ns-jit9trjigd.dnswnd.de,0,0.00%,2,2,0.00%
ns1.alphadnszone.com,0,0.00%,10,10,0.00%
ns1.boxsecured.com,0,0.00%,2,2,0.00%
ns-1334.awsdns-38.org,0,0.00%,2,2,0.00%
ns1.blueape.xyz,0,0.00%,2,2,0.00%
ns-1860.awsdns-40.co.uk,0,0.00%,2,2,0.00%
jh-02.jimatdns.com,0,0.00%,2,2,0.00%
deborah.ns.cloudflare.com,0,0.00%,2,2,0.00%
ns-492.awsdns-61.com,0,0.00%,2,2,0.00%
ns1.ispns.net,0,0.00%,2,2,0.00%
ns1.datakl.com,0,0.00%,2,2,0.00%
ns-587.awsdns-09.net,0,0.00%,2,2,0.00%
ns2.datakl.com,0,0.00%,2,2,0.00%
ns2.blueape.xyz,0,0.00%,2,2,0.00%
ns3.estugo-webhosting.com,0,0.00%,2,2,0.00%
ns.sendoufeng.com,0,0.00%,2,2,0.00%
ns1.discountdomains.co.nz,0,0.00%,2,2,0.00%
dns171.a.register.com,0,0.00%,2,2,0.00%
ns-92-b.gandi.net,0,0.00%,2,2,0.00%
alex.ns.cloudflare.com,0,0.00%,2,2,0.00%
ns1.dnshost.net,0,0.00%,2,2,0.00%
ns-1380.awsdns-44.org,0,0.00%,2,2,0.00%
ns2.dnshost.net,0,0.00%,2,2,0.00%
addyson.ns.cloudflare.com,0,0.00%,2,2,0.00%
buck.ns.cloudflare.com,0,0.00%,4,4,0.00%
ns-1964.awsdns-53.co.uk,0,0.00%,2,2,0.00%
ns-447.awsdns-55.com,0,0.00%,2,2,0.00%
ns-460.awsdns-57.com,0,0.00%,2,2,0.00%
ns-677.awsdns-20.net,0,0.00%,2,2,0.00%
ns-646.awsdns-16.net,0,0.00%,2,2,0.00%
ns2.designstallion.dev,0,0.00%,2,2,0.00%
ns1066.hostgator.com.br,0,0.00%,2,2,0.00%
aliza.ns.cloudflare.com,0,0.00%,2,2,0.00%
candy.ns.cloudflare.com,0,0.00%,4,4,0.00%
zod.ns.cloudflare.com,0,0.00%,2,2,0.00%
dns104.a.register.com,0,0.00%,2,2,0.00%
dns085.a.register.com,0,0.00%,2,2,0.00%
ns-211-c.gandi.net,0,0.00%,2,2,0.00%
ns2.ispns.net,0,0.00%,2,2,0.00%
lennon.ns.cloudflare.com,0,0.00%,2,2,0.00%
ns4.axspace.com,0,0.00%,4,4,0.00%
c.ns.syse.no,0,0.00%,2,2,0.00%
ns3.ispns.net,0,0.00%,2,2,0.00%
ns1.rivalhost.com,0,0.00%,2,2,0.00%
vda1900a.trouble-free.net,0,0.00%,2,2,0.00%
ns1.md-18.webhostbox.net,0,0.00%,2,2,0.00%
vda1900b.trouble-free.net,0,0.00%,2,2,0.00%
ns2.rivalhost.com,0,0.00%,2,2,0.00%
ns2.md-18.webhostbox.net,0,0.00%,2,2,0.00%
ns-250-b.gandi.net,0,0.00%,2,2,0.00%
securepatriotinternet.com,0,0.00%,2,2,0.00%
sei-upt.com,0,0.00%,1,1,0.00%
ns3.bigcommerce.com,0,0.00%,2,2,0.00%
secureinternet4u.com,0,0.00%,2,2,0.00%
secureinternet4usa.com,0,0.00%,2,2,0.00%
slns1.namespro.ca,0,0.00%,2,2,0.00%
slns2.namespro.ca,0,0.00%,2,2,0.00%
secureinternetusa.com,0,0.00%,2,2,0.00%
ns1.doselesagencia.com,0,0.00%,2,2,0.00%
ns3.axspace.com,0,0.00%,2,2,0.00%
anna.dnspod.net,0,0.00%,2,2,0.00%
ns1.dotster.com,0,0.00%,2,2,0.00%
ns-1386.awsdns-45.org,0,0.00%,2,2,0.00%
ns2.dotster.com,0,0.00%,2,2,0.00%
ns289.hostgator.com.br,0,0.00%,2,2,0.00%
ns-1863.awsdns-40.co.uk,0,0.00%,2,2,0.00%
ns-1324.awsdns-37.org,0,0.00%,2,2,0.00%
ns-410.awsdns-51.com,0,0.00%,2,2,0.00%
ns597.hostgator.com.br,0,0.00%,2,2,0.00%
ns1.ukfast.net,0,0.00%,2,2,0.00%
ns0.ukfast.net,0,0.00%,2,2,0.00%
secureinternet4us.com,0,0.00%,2,2,0.00%
ns-1459.awsdns-54.org,0,0.00%,2,2,0.00%
ns-1700.awsdns-20.co.uk,0,0.00%,2,2,0.00%
securepatriotinet.com,0,0.00%,2,2,0.00%
ns02.freenom.com,0,0.00%,2,2,0.00%
isla.ns.cloudflare.com,0,0.00%,2,2,0.00%
3.push2his.eastmoney.com,0,0.00%,2,2,0.00%
61.push2his.eastmoney.com,0,0.00%,2,2,0.00%
dns1.uk2.net,0,0.00%,2,2,0.00%
dns2.uk2.net,0,0.00%,2,2,0.00%
dns3.uk2.net,0,0.00%,2,2,0.00%
ip.jiangxianli.com,0,0.00%,2,2,0.00%
6.push2his.eastmoney.com,0,0.00%,2,2,0.00%
52.push2his.eastmoney.com,0,0.00%,2,2,0.00%
79.push2his.eastmoney.com,0,0.00%,2,2,0.00%
88.push2his.eastmoney.com,0,0.00%,2,2,0.00%
32.push2his.eastmoney.com,0,0.00%,2,2,0.00%
ns2.salamjalil.com,0,0.00%,2,2,0.00%
ns-1198.awsdns-21.org,0,0.00%,2,2,0.00%
ns1.dunford-hittorf.com,0,0.00%,4,4,0.00%
ns-1686.awsdns-18.co.uk,0,0.00%,2,2,0.00%
schoolofcreativechildren.com,0,0.00%,2,2,0.00%
ns5.sitesepeti.com,0,0.00%,2,2,0.00%
ns2.dunford-hittorf.com,0,0.00%,4,4,0.00%
ns-187.awsdns-23.com,0,0.00%,2,2,0.00%
ns1.atnassdomains.com,0,0.00%,2,2,0.00%
ns-856.awsdns-43.net,0,0.00%,2,2,0.00%
ns1047.ui-dns.de,0,0.00%,2,2,0.00%
ns251.hostgator.com.br,0,0.00%,2,2,0.00%
ns250.hostgator.com.br,0,0.00%,2,2,0.00%
ns1051.ui-dns.com,0,0.00%,2,2,0.00%
ns53.d9hosting.com,0,0.00%,2,2,0.00%
ns1110.ui-dns.org,0,0.00%,2,2,0.00%
narcissus.dnspod.net,0,0.00%,2,2,0.00%
sati535424.mars.orderbox-dns.com,0,0.00%,2,2,0.00%
ns4252.hostgator.com,0,0.00%,4,4,0.00%
brodie.ns.cloudflare.com,0,0.00%,2,2,0.00%
ns4251.hostgator.com,0,0.00%,4,4,0.00%
sati535424.earth.orderbox-dns.com,0,0.00%,2,2,0.00%
sati535424.mercury.orderbox-dns.com,0,0.00%,2,2,0.00%
ns1113.ui-dns.biz,0,0.00%,2,2,0.00%
scubadivingdaytripsgalapagos.com,0,0.00%,2,2,0.00%
sati535424.venus.orderbox-dns.com,0,0.00%,2,2,0.00%
ns1049.ui-dns.com,0,0.00%,2,2,0.00%
ns-1710.awsdns-21.co.uk,0,0.00%,2,2,0.00%
ns4.blackhost.com,0,0.00%,2,2,0.00%
scxiaoyaoye.com,0,0.00%,2,2,0.00%
ns1.studiotopia.com,0,0.00%,2,2,0.00%
ns-539.awsdns-03.net,0,0.00%,2,2,0.00%
dns225.a.register.com,0,0.00%,2,2,0.00%
ns2.studiotopia.com,0,0.00%,2,2,0.00%
ns2.futureweb.jp,0,0.00%,2,2,0.00%
dns065.a.register.com,0,0.00%,2,2,0.00%
ns-77.awsdns-09.com,0,0.00%,2,2,0.00%
overcast.dnspod.net,0,0.00%,2,2,0.00%
ns3.studiotopia.com,0,0.00%,2,2,0.00%
ns1032.ui-dns.org,0,0.00%,2,2,0.00%
docks08.rzone.de,0,0.00%,2,2,0.00%
ns1.sctumc.com,0,0.00%,2,2,0.00%
crocodile.dnspod.net,0,0.00%,2,2,0.00%
ns1.futureweb.jp,0,0.00%,2,2,0.00%
grape.dnspod.net,0,0.00%,2,2,0.00%
ns4.p17.dynect.net,0,0.00%,2,2,0.00%
ns1.name.com,0,0.00%,2,2,0.00%
ns2.sctumc.com,0,0.00%,2,2,0.00%
ns61.securehostplanet.com,0,0.00%,2,2,0.00%
ns3.p68.dns.oraclecloud.net,0,0.00%,2,2,0.00%
cardboard.dnspod.net,0,0.00%,2,2,0.00%
ns62.securehostplanet.com,0,0.00%,2,2,0.00%
same.dnspod.net,0,0.00%,2,2,0.00%
ns.forpsi.cz,0,0.00%,2,2,0.00%
ns1.sutoaedns.com,0,0.00%,1,1,0.00%
cora.dnspod.net,0,0.00%,2,2,0.00%
ns21.hostingec.host,0,0.00%,2,2,0.00%
dns020.a.register.com,0,0.00%,2,2,0.00%
wanda.dnspod.net,0,0.00%,2,2,0.00%
ns22.hostingec.host,0,0.00%,2,2,0.00%
ns.forpsi.it,0,0.00%,2,2,0.00%
newt.ns.cloudflare.com,0,0.00%,2,2,0.00%
gyanduniya2.securehostdns.com,0,0.00%,2,2,0.00%
vpn.xidian.edu.cn,0,0.00%,2,2,0.00%
gyanduniya1.securehostdns.com,0,0.00%,2,2,0.00%
elma.ns.cloudflare.com,0,0.00%,2,2,0.00%
ns1jlp.name.com,0,0.00%,2,2,0.00%
dante.ns.cloudflare.com,0,0.00%,2,2,0.00%
ns-1828.awsdns-36.co.uk,0,0.00%,2,2,0.00%
ns-446.awsdns-55.com,0,0.00%,2,2,0.00%
ns14.hawkhost.com,0,0.00%,2,2,0.00%
ns-663.awsdns-18.net,0,0.00%,2,2,0.00%
ns13.hawkhost.com,0,0.00%,2,2,0.00%
cns1.simplexi.com,0,0.00%,2,2,0.00%
rtphexabet88.com,0,0.00%,1,1,0.00%
dijkstra.ihsdns.com,0,0.00%,2,2,0.00%
knuth.ihsdns.com,0,0.00%,2,2,0.00%
cns2.simplexi.com,0,0.00%,2,2,0.00%
option.dnspod.net,0,0.00%,2,2,0.00%
ns-182-a.gandi.net,0,0.00%,2,2,0.00%
walk.ns.cloudflare.com,0,0.00%,2,2,0.00%
audrey.dnspod.net,0,0.00%,2,2,0.00%
ns3jnr.name.com,0,0.00%,4,4,0.00%
ns4ghm.name.com,0,0.00%,2,2,0.00%
ns1.hostens.com,0,0.00%,2,2,0.00%
ns-225-b.gandi.net,0,0.00%,2,2,0.00%
ns2.ghesi.net,0,0.00%,2,2,0.00%
ns2.hostens.com,0,0.00%,2,2,0.00%
ns2.modelcentro.com,0,0.00%,2,2,0.00%
ns2.observatoiredesmarques.fr,0,0.00%,2,2,0.00%
ns596.hostgator.com.br,0,0.00%,2,2,0.00%
ns24.iservidorweb.com,0,0.00%,2,2,0.00%
dns2.ehostingserver.org,0,0.00%,2,2,0.00%
ns1.roadbear.nl,0,0.00%,2,2,0.00%
obs.ns1.fr,0,0.00%,2,2,0.00%
ns3.nameshield.net,0,0.00%,2,2,0.00%
ns3.ghesi.net,0,0.00%,2,2,0.00%
cpns2.turhost.com,0,0.00%,2,2,0.00%
dns1.ehostingserver.org,0,0.00%,2,2,0.00%
ns23.iservidorweb.com,0,0.00%,2,2,0.00%
ns1.domainsafricacloud.com,0,0.00%,2,2,0.00%
cpns1.turhost.com,0,0.00%,2,2,0.00%
ns1.web.de,0,0.00%,2,2,0.00%
ns4.ghesi.net,0,0.00%,2,2,0.00%
ns2.roadbear.nl,0,0.00%,2,2,0.00%
ns-1747.awsdns-26.co.uk,0,0.00%,2,2,0.00%
ns-284.awsdns-35.com,0,0.00%,2,2,0.00%
ns-652.awsdns-17.net,0,0.00%,2,2,0.00%
ginkgo.dnspod.net,0,0.00%,4,4,0.00%
yetta.dnspod.net,0,0.00%,2,2,0.00%
ns1.dnsmisitio.net,0,0.00%,2,2,0.00%
ns-0-a.gandi.net,0,0.00%,2,2,0.00%
ns-92-c.gandi.net,0,0.00%,2,2,0.00%
ns-172-c.gandi.net,0,0.00%,2,2,0.00%
ns-212-c.gandi.net,0,0.00%,2,2,0.00%
ns-134-a.gandi.net,0,0.00%,2,2,0.00%
ns1.cloudsmartly.com,0,0.00%,2,2,0.00%
ns-124-a.gandi.net,0,0.00%,2,2,0.00%
drive.dnspod.net,0,0.00%,2,2,0.00%
ns-8.awsdns-01.com,0,0.00%,2,2,0.00%
ns2.orahost.xyz,0,0.00%,2,2,0.00%
ns-362.awsdns-45.com,0,0.00%,2,2,0.00%
otwereanderson.com,0,0.00%,2,2,0.00%
ns1053.ui-dns.de,0,0.00%,4,4,0.00%
ns1.au2.fcomet.com,0,0.00%,2,2,0.00%
ns2.au2.fcomet.com,0,0.00%,2,2,0.00%
ns1.eupotech.com,0,0.00%,2,2,0.00%
ns1fkl.name.com,0,0.00%,2,2,0.00%
ns1.cbsv.jp,0,0.00%,6,6,0.00%
ns2.cbsv.jp,0,0.00%,4,4,0.00%
ns.onetop-invest.com,0,0.00%,2,2,0.00%
ns2.onetop-invest.com,0,0.00%,2,2,0.00%
ns2.netfrontier.info,0,0.00%,2,2,0.00%
dns3.provider.lk,0,0.00%,2,2,0.00%
ns3.onetop-invest.com,0,0.00%,2,2,0.00%
diva.ns.cloudflare.com,0,0.00%,2,2,0.00%
coen.ns.cloudflare.com,0,0.00%,2,2,0.00%
justin.ns.cloudflare.com,0,0.00%,2,2,0.00%
ns3.gatordns.org,0,0.00%,2,2,0.00%
novasoundsystems.com,0,0.00%,2,2,0.00%
dns4.provider.lk,0,0.00%,2,2,0.00%
oneminuteson.com,0,0.00%,2,2,0.00%
jean.ns.cloudflare.com,0,0.00%,2,2,0.00%
ns4.gatordns.io,0,0.00%,2,2,0.00%
ns1.serviceportapottyrentals.com,0,0.00%,2,2,0.00%
ns2.offshoreracks.com,0,0.00%,2,2,0.00%
ns1.offshoreracks.com,0,0.00%,2,2,0.00%
verification-jowkhxlu.ns3.dan.hosting,0,0.00%,2,2,0.00%
ns2.bero-host.de,0,0.00%,4,4,0.00%
ns-1264.awsdns-30.org,0,0.00%,2,2,0.00%
ns1.gatordns.com,0,0.00%,2,2,0.00%
ns269.kenyawebexperts.co.ke,0,0.00%,2,2,0.00%
ns-1905.awsdns-46.co.uk,0,0.00%,2,2,0.00%
ns1.bero-host.de,0,0.00%,4,4,0.00%
ns-203-b.gandi.net,0,0.00%,2,2,0.00%
clyde.ns.cloudflare.com,0,0.00%,4,4,0.00%
ns-751.awsdns-29.net,0,0.00%,2,2,0.00%
ns2.gestionpro.lat,0,0.00%,2,2,0.00%
ns270.kenyawebexperts.co.ke,0,0.00%,2,2,0.00%
ns-1419.awsdns-49.org,0,0.00%,2,2,0.00%
ns6379.hostgator.com,0,0.00%,2,2,0.00%
ns1.gestionpro.lat,0,0.00%,2,2,0.00%
ns-390.awsdns-48.com,0,0.00%,2,2,0.00%
ns6380.hostgator.com,0,0.00%,2,2,0.00%
ns6225.hostgator.com,0,0.00%,2,2,0.00%
ns6226.hostgator.com,0,0.00%,2,2,0.00%
ns1.mgsservers.com,0,0.00%,2,2,0.00%
onskkn.com,0,0.00%,2,2,0.00%
ns3cjl.name.com,0,0.00%,2,2,0.00%
ns1.hndnsv1.com,0,0.00%,2,2,0.00%
ns2.hndnsv1.com,0,0.00%,2,2,0.00%
braelyn.ns.cloudflare.com,0,0.00%,2,2,0.00%
ns2.mgsservers.com,0,0.00%,2,2,0.00%
docks18.rzone.de,0,0.00%,2,2,0.00%
ns59.tr.dnsowner.com,0,0.00%,2,2,0.00%
ns58.tr.dnsowner.com,0,0.00%,2,2,0.00%
onnjunior.com,0,0.00%,2,2,0.00%
ns2.cloud-95215f.managed-vps.net,0,0.00%,4,4,0.00%
onnjuniors.com,0,0.00%,2,2,0.00%
ns-ay4p8faygd.dnswnd.eu,0,0.00%,2,2,0.00%
ns2.hddpool6.net,0,0.00%,2,2,0.00%
ns1.serversnow.co,0,0.00%,1,1,0.00%
ns2.fragacomunicacao.com,0,0.00%,2,2,0.00%
ns2.serversnow.co,0,0.00%,1,1,0.00%
debuginfo.centos.org,0,0.00%,2,2,0.00%
ns4.serversnow.co,0,0.00%,1,1,0.00%
parked1.uadns.com,0,0.00%,2,2,0.00%
odin.hostcp.xyz,0,0.00%,2,2,0.00%
parked2.uadns.com,0,0.00%,2,2,0.00%
dalary.ns.cloudflare.com,0,0.00%,2,2,0.00%
ns-1239.awsdns-26.org,0,0.00%,2,2,0.00%
pdns82.ultradns.com,0,0.00%,2,2,0.00%
seamus.ns.cloudflare.com,0,0.00%,2,2,0.00%
pdns82.ultradns.biz,0,0.00%,2,2,0.00%
pdns82.ultradns.org,0,0.00%,2,2,0.00%
ns4.dnspro.com.br,0,0.00%,2,2,0.00%
ns-494.awsdns-61.com,0,0.00%,2,2,0.00%
sri.ns.cloudflare.com,0,0.00%,4,4,0.00%
stock2.finance.sina.com.cn,0,0.00%,2,2,0.00%
ns696.hostgator.com.br,0,0.00%,2,2,0.00%
ns1024.ui-dns.biz,0,0.00%,4,4,0.00%
lynn.ns.cloudflare.com,0,0.00%,2,2,0.00%
ns1039.ui-dns.de,0,0.00%,6,6,0.00%
ns1cny.name.com,0,0.00%,2,2,0.00%
ns2.ro.hostsailor.com,0,0.00%,2,2,0.00%
ns1.frault2.hostarmada.net,0,0.00%,2,2,0.00%
verification-768cf101.ns3.dan.hosting,0,0.00%,2,2,0.00%
mirrors.nju.edu.cn,0,0.00%,2,2,0.00%
ns3cgw.name.com,0,0.00%,2,2,0.00%
ns1.ro.hostsailor.com,0,0.00%,2,2,0.00%
ns1109.ui-dns.org,0,0.00%,4,4,0.00%
ns1039.ui-dns.biz,0,0.00%,2,2,0.00%
ns1046.ui-dns.org,0,0.00%,3,3,0.00%
ns1018.ui-dns.com,0,0.00%,4,4,0.00%
ns2.frault2.hostarmada.net,0,0.00%,2,2,0.00%
ns-1579.awsdns-05.co.uk,0,0.00%,2,2,0.00%
ns-234.awsdns-29.com,0,0.00%,2,2,0.00%
ns1124.ui-dns.com,0,0.00%,2,2,0.00%
ns-552.awsdns-05.net,0,0.00%,2,2,0.00%
ns4241.hostgator.com,0,0.00%,2,2,0.00%
ns4242.hostgator.com,0,0.00%,2,2,0.00%
ns-us01.webhostcluster.com,0,0.00%,2,2,0.00%
ns2.dns-21.com,0,0.00%,2,2,0.00%
ns-1385.awsdns-45.org,0,0.00%,2,2,0.00%
ns-us02.webhostcluster.com,0,0.00%,2,2,0.00%
ns4.safaricombusiness.co.ke,0,0.00%,2,2,0.00%
ns-219-c.gandi.net,0,0.00%,2,2,0.00%
ns-1461.awsdns-54.org,0,0.00%,4,4,0.00%
ns-522.awsdns-01.net,0,0.00%,2,2,0.00%
ns3.hostpoint.ch,0,0.00%,2,2,0.00%
ns1.dns-21.com,0,0.00%,2,2,0.00%
sg22.noc223.com,0,0.00%,2,2,0.00%
dns060.a.register.com,0,0.00%,2,2,0.00%
ns58.hostgator.mx,0,0.00%,2,2,0.00%
ns-122-b.gandi.net,0,0.00%,2,2,0.00%
crystal.datasurcloud.sr,0,0.00%,2,2,0.00%
ns3.safaricombusiness.co.ke,0,0.00%,2,2,0.00%
ns59.hostgator.mx,0,0.00%,2,2,0.00%
colette.ns.cloudflare.com,0,0.00%,4,4,0.00%
ns1.okgroupmyanmar.com,0,0.00%,2,2,0.00%
ns-242-a.gandi.net,0,0.00%,2,2,0.00%
ns1090.ui-dns.com,0,0.00%,2,2,0.00%
sg21.noc223.com,0,0.00%,2,2,0.00%
ns4.verigom.com,0,0.00%,2,2,0.00%
ns2.okgroupmyanmar.com,0,0.00%,2,2,0.00%
ns-1377.awsdns-44.org,0,0.00%,2,2,0.00%
ns3.verigom.com,0,0.00%,2,2,0.00%
mirrors.rpmfusion.org,0,0.00%,2,2,0.00%
ns-2028.awsdns-61.co.uk,0,0.00%,2,2,0.00%
ns6630.hostgator.com,0,0.00%,2,2,0.00%
ns-430.awsdns-53.com,0,0.00%,2,2,0.00%
ns-11.awsdns-01.com,0,0.00%,3,3,0.00%
nora.ns.cloudflare.com,0,0.00%,2,2,0.00%
ns-1169.awsdns-18.org,0,0.00%,2,2,0.00%
ns-1615.awsdns-09.co.uk,0,0.00%,2,2,0.00%
matias.ns.cloudflare.com,0,0.00%,4,4,0.00%
ns1.safaricombusiness.co.ke,0,0.00%,2,2,0.00%
ns-990.awsdns-59.net,0,0.00%,2,2,0.00%
ns3.galiciahosting.com,0,0.00%,2,2,0.00%
ns66.hostgator.mx,0,0.00%,2,2,0.00%
ns4.galiciahosting.com,0,0.00%,2,2,0.00%
dns1.hitrost.net,0,0.00%,2,2,0.00%
ns67.hostgator.mx,0,0.00%,2,2,0.00%
ns2.galiciahosting.com,0,0.00%,2,2,0.00%
ns2.messagingengine.com,0,0.00%,2,2,0.00%
ns1021.ui-dns.de,0,0.00%,2,2,0.00%
sneh.ns.cloudflare.com,0,0.00%,2,2,0.00%
ns2.minibird.jp,0,0.00%,2,2,0.00%
oberonbeam.com,0,0.00%,2,2,0.00%
ns3.minibird.jp,0,0.00%,2,2,0.00%
obara7.com,0,0.00%,2,2,0.00%
docks07.rzone.de,0,0.00%,3,3,0.00%
ns1.md-10.webhostbox.net,0,0.00%,2,2,0.00%
ns1.site5.com,0,0.00%,2,2,0.00%
ns2.icasei.com.br,0,0.00%,2,2,0.00%
ns1.minibird.jp,0,0.00%,2,2,0.00%
ns356.registrosdns.com,0,0.00%,2,2,0.00%
ns2.md-10.webhostbox.net,0,0.00%,2,2,0.00%
gas.dnspod.net,0,0.00%,2,2,0.00%
ns1.bahariserver.com,0,0.00%,2,2,0.00%
ns1126.ui-dns.de,0,0.00%,2,2,0.00%
ns1081.ui-dns.biz,0,0.00%,2,2,0.00%
ns1021.ui-dns.org,0,0.00%,2,2,0.00%
cs22.wpc.v0cdn.NET,0,0.00%,2,2,0.00%
jen.ns.cloudflare.com,0,0.00%,2,2,0.00%
ns1.cheapohosting.com,0,0.00%,2,2,0.00%
ns3.tenten.cloud,0,0.00%,2,2,0.00%
ns326.edns1.com,0,0.00%,2,2,0.00%
rommy.ns.cloudflare.com,0,0.00%,2,2,0.00%
ns1.aupro2.fcomet.com,0,0.00%,2,2,0.00%
ns2.aupro2.fcomet.com,0,0.00%,2,2,0.00%
ns2.bahariserver.com,0,0.00%,2,2,0.00%
ns325.edns1.com,0,0.00%,2,2,0.00%
ns1.gzo.com,0,0.00%,2,2,0.00%
ns1.tenten.cloud,0,0.00%,2,2,0.00%
ns-1042.awsdns-02.org,0,0.00%,2,2,0.00%
laylah.ns.cloudflare.com,0,0.00%,2,2,0.00%
ns333.mihanwebhost.com,0,0.00%,2,2,0.00%
ns2.tenten.cloud,0,0.00%,2,2,0.00%
ns325.fastwebhost.com,0,0.00%,2,2,0.00%
alphard.dnspod.net,0,0.00%,2,2,0.00%
ns6.itools.mn,0,0.00%,2,2,0.00%
ns-789.awsdns-34.net,0,0.00%,2,2,0.00%
bronze.dnspod.net,0,0.00%,2,2,0.00%
ns5.itools.mn,0,0.00%,2,2,0.00%
ns326.fastwebhost.com,0,0.00%,2,2,0.00%
ns4.monikerdns.net,0,0.00%,2,2,0.00%
ns2305.nameservers.co.uk,0,0.00%,2,2,0.00%
ns200.01isp.com,0,0.00%,2,2,0.00%
ns1.monikerdns.net,0,0.00%,2,2,0.00%
burt.ns.cloudflare.com,0,0.00%,2,2,0.00%
mira.ns.cloudflare.com,0,0.00%,2,2,0.00%
shopqo.com,0,0.00%,1,1,0.00%
yygbc.com,0,0.00%,2,2,0.00%
ns2.hostpapa.com,0,0.00%,2,2,0.00%
ns1.hostpapa.com,0,0.00%,2,2,0.00%
wells.ns.cloudflare.com,0,0.00%,2,2,0.00%
ns-887.awsdns-46.net,0,0.00%,2,2,0.00%
dns1.plaindns.net,0,0.00%,2,2,0.00%
blob.dz5prdstr15a.store.core.windows.NET,0,0.00%,1,1,0.00%
dns2.plaindns.net,0,0.00%,1,1,0.00%
www.xicidaili.com,0,0.00%,3,3,0.00%
ns1.1pointblank.com,0,0.00%,2,2,0.00%
ns2.1pointblank.com,0,0.00%,1,1,0.00%
ns1019.ui-dns.com,0,0.00%,2,2,0.00%
ns1060.ui-dns.biz,0,0.00%,2,2,0.00%
gangchangjiansuji.com,0,0.00%,2,2,0.00%
ns6374.hostgator.com,0,0.00%,2,2,0.00%
ns1060.ui-dns.de,0,0.00%,1,1,0.00%
ns6373.hostgator.com,0,0.00%,1,1,0.00%
f1g1ns2.dnspod.net,0,0.00%,6,6,0.00%
ns1075.ui-dns.org,0,0.00%,2,2,0.00%
jnjdzg.com,0,0.00%,1,1,0.00%
mjnhh.com,0,0.00%,2,2,0.00%
bobblebunny.com,0,0.00%,1,1,0.00%
js-youke.com,0,0.00%,1,1,0.00%
foefuyi.com,0,0.00%,1,1,0.00%
ns9.hostmar.com,0,0.00%,2,2,0.00%
ns10.hostmar.com,0,0.00%,1,1,0.00%
brjzcl.com,0,0.00%,2,2,0.00%
c.dns.gandi.net,0,0.00%,1,1,0.00%
b.dns.gandi.net,0,0.00%,2,2,0.00%
a.dns.gandi.net,0,0.00%,2,2,0.00%
w.17986.net,0,0.00%,2,2,0.00%
blaque-concierge.com,0,0.00%,2,2,0.00%
ns1.websiteserverbox.com,0,0.00%,2,2,0.00%
variable.dnspod.net,0,0.00%,1,1,0.00%
ns1.domainmx.com,0,0.00%,4,4,0.00%
ns8103.hostgator.com,0,0.00%,1,1,0.00%
ns4.no-ip.com,0,0.00%,1,1,0.00%
pltraffic35.com,0,0.00%,1,1,0.00%
ns-1158.awsdns-16.org,0,0.00%,2,2,0.00%
dns102.register.com,0,0.00%,2,2,0.00%
ns1.bodhosting.com,0,0.00%,1,1,0.00%
ns2.bodhosting.com,0,0.00%,1,1,0.00%
dns-ch2.xinnet.com,0,0.00%,2,2,0.00%
succulentshoppe.com,0,0.00%,2,2,0.00%
dns-ch.xinnet.com,0,0.00%,2,2,0.00%
wns2013.hostgator.com,0,0.00%,2,2,0.00%
wns2014.hostgator.com,0,0.00%,1,1,0.00%
verification-745daa83.ns3.dan.hosting,0,0.00%,2,2,0.00%
c.17986.net,0,0.00%,2,2,0.00%
ziggy.ns.cloudflare.com,0,0.00%,2,2,0.00%
ketomagik.com,0,0.00%,1,1,0.00%
ns2.uk6.fcomet.com,0,0.00%,2,2,0.00%
ns1057.ui-dns.org,0,0.00%,2,2,0.00%
ns1.uk6.fcomet.com,0,0.00%,1,1,0.00%
daniella.ns.cloudflare.com,0,0.00%,2,2,0.00%
ns2.cp-49.webhostbox.net,0,0.00%,2,2,0.00%
ns1.cp-49.webhostbox.net,0,0.00%,2,2,0.00%
ns2.cliaweb.com,0,0.00%,2,2,0.00%
arvind.ns.cloudflare.com,0,0.00%,2,2,0.00%
ns1.cliaweb.com,0,0.00%,2,2,0.00%
ns3.myevent.com,0,0.00%,2,2,0.00%
ns-1177.awsdns-19.org,0,0.00%,2,2,0.00%
www.antiarp.com,0,0.00%,1,1,0.00%
www.goubanjia.com,0,0.00%,1,1,0.00%
free.kuaidaili.com,0,0.00%,1,1,0.00%
44.push2his.eastmoney.com,0,0.00%,1,1,0.00%
novalee.ns.cloudflare.com,0,0.00%,2,2,0.00%
plato.ns.cloudflare.com,0,0.00%,2,2,0.00%
ns-1213.awsdns-23.org,0,0.00%,1,1,0.00%
ns-1556.awsdns-02.co.uk,0,0.00%,1,1,0.00%
sculptor.dnspod.net,0,0.00%,2,2,0.00%
zariyah.ns.cloudflare.com,0,0.00%,2,2,0.00%
taurus.dnspod.net,0,0.00%,2,2,0.00%
fixture.dnspod.net,0,0.00%,2,2,0.00%
glenn.dnspod.net,0,0.00%,2,2,0.00%
ns2224.ispapi.net,0,0.00%,2,2,0.00%
ns-1038.awsdns-01.org,0,0.00%,1,1,0.00%
geranium.dnspod.net,0,0.00%,2,2,0.00%
96.push2his.eastmoney.com,0,0.00%,1,1,0.00%
21.push2his.eastmoney.com,0,0.00%,1,1,0.00%
ns1.svenskadomaner.se,0,0.00%,1,1,0.00%
emely.ns.cloudflare.com,0,0.00%,2,2,0.00%
ns2.saimnameserver.com,0,0.00%,2,2,0.00%
ns6.creatium.ru,0,0.00%,6,6,0.00%
ns5.hosting.reg.ru,0,0.00%,7,7,0.00%
ns1.storeland.ru,0,0.00%,2,2,0.00%
ns1.shop.reg.ru,0,0.00%,1,1,0.00%
ns6.hosting.reg.ru,0,0.00%,6,6,0.00%
ns4.hostiman.com,0,0.00%,6,6,0.00%
ns2.masterhost.ru,0,0.00%,8,8,0.00%
dubhe.dnspod.net,0,0.00%,2,2,0.00%
hyacinth.dnspod.net,0,0.00%,2,2,0.00%
ns8-cloud.nic.ru,0,0.00%,16,16,0.00%
elsie.dnspod.net,0,0.00%,2,2,0.00%
ns2.creatium.io,0,0.00%,6,6,0.00%
ns3.storeland.ru,0,0.00%,2,2,0.00%
ns3.hostiman.com,0,0.00%,7,7,0.00%
ns2.shop.reg.ru,0,0.00%,2,2,0.00%
ns1.masterhost.ru,0,0.00%,8,8,0.00%
ns5.creatium.ru,0,0.00%,6,6,0.00%
ns2.expired.r01.ru,0,0.00%,1,1,0.00%
charles.ns.cloudflare.com,0,0.00%,4,4,0.00%
ns1.creatium.io,0,0.00%,6,6,0.00%
ns4.storeland.ru,0,0.00%,1,1,0.00%
ns-405.awsdns-50.com,0,0.00%,1,1,0.00%
ns1.srvr.pro,0,0.00%,2,2,0.00%
ns-675.awsdns-20.net,0,0.00%,1,1,0.00%
ns88.hostia.name,0,0.00%,2,2,0.00%
ns4-cloud.nic.ru,0,0.00%,14,14,0.00%
kyrie.ns.cloudflare.com,0,0.00%,1,1,0.00%
ns-88-a.gandi.net,0,0.00%,2,2,0.00%
ns2.storeland.ru,0,0.00%,1,1,0.00%
ns-197-c.gandi.net,0,0.00%,1,1,0.00%
ns2.srvr.pro,0,0.00%,2,2,0.00%
litchi.dnspod.net,0,0.00%,4,4,0.00%
cecilia.dnspod.net,0,0.00%,2,2,0.00%
kanye.ns.cloudflare.com,0,0.00%,4,4,0.00%
liv.ns.cloudflare.com,0,0.00%,1,1,0.00%
ns-2-b.gandi.net,0,0.00%,1,1,0.00%
irena.ns.cloudflare.com,0,0.00%,1,1,0.00%
ns1.smartape.ru,0,0.00%,2,2,0.00%
mitchell.ns.cloudflare.com,0,0.00%,2,2,0.00%
ns3.registrant.ru,0,0.00%,1,1,0.00%
ns1kpv.name.com,0,0.00%,2,2,0.00%
robin.ns.cloudflare.com,0,0.00%,2,2,0.00%
hera.ns.cloudflare.com,0,0.00%,2,2,0.00%
suzanne.ns.cloudflare.com,0,0.00%,2,2,0.00%
ns-87-a.gandi.net,0,0.00%,2,2,0.00%
quincy.ns.cloudflare.com,0,0.00%,2,2,0.00%
jose.ns.cloudflare.com,0,0.00%,2,2,0.00%
ns2.hoster.kz,0,0.00%,4,4,0.00%
ns-73-c.gandi.net,0,0.00%,1,1,0.00%
ns2dky.name.com,0,0.00%,2,2,0.00%
samsungserv.ru,0,0.00%,2,2,0.00%
ns4gvx.name.com,0,0.00%,2,2,0.00%
ns1.pananames.com,0,0.00%,2,2,0.00%
desiree.ns.cloudflare.com,0,0.00%,2,2,0.00%
joel.ns.cloudflare.com,0,0.00%,2,2,0.00%
ns2.pananames.com,0,0.00%,1,1,0.00%
ns3.pananames.com,0,0.00%,1,1,0.00%
pete.ns.cloudflare.com,0,0.00%,2,2,0.00%
ns4.pananames.com,0,0.00%,1,1,0.00%
ns3.site.beeline.ru,0,0.00%,2,2,0.00%
lina.ns.cloudflare.com,0,0.00%,2,2,0.00%
keanu.ns.cloudflare.com,0,0.00%,2,2,0.00%
remy.ns.cloudflare.com,0,0.00%,2,2,0.00%
poppy.ns.cloudflare.com,0,0.00%,2,2,0.00%
decker.ns.cloudflare.com,0,0.00%,2,2,0.00%
darl.ns.cloudflare.com,0,0.00%,2,2,0.00%
rihana.ns.cloudflare.com,0,0.00%,2,2,0.00%
ns2.areait.lv,0,0.00%,1,1,0.00%
dns1.mchost.ru,0,0.00%,2,2,0.00%
ns1.webhost1.com,0,0.00%,6,6,0.00%
ns3.areait.lv,0,0.00%,2,2,0.00%
ns1.fozzy.com,0,0.00%,2,2,0.00%
dns2.mchost.com,0,0.00%,1,1,0.00%
ns1.digital-cat.ru,0,0.00%,1,1,0.00%
ns2.fozzy.com,0,0.00%,1,1,0.00%
ns1.areait.lv,0,0.00%,1,1,0.00%
ns.hostland.ru,0,0.00%,4,4,0.00%
ns2.firstvds.ru,0,0.00%,4,4,0.00%
ns1.firstvds.ru,0,0.00%,10,10,0.00%
ns2.ukit.com,0,0.00%,5,5,0.00%
ns1.1gb.ru,0,0.00%,2,2,0.00%
ns1.ihc.ru,0,0.00%,4,4,0.00%
ns1.megagroup.ru,0,0.00%,2,2,0.00%
ns3.rufox.ru,0,0.00%,2,2,0.00%
ns2.megagroup.ru,0,0.00%,2,2,0.00%
mebel-po-proektam.ru,0,0.00%,2,2,0.00%
ns.megagroup.ru,0,0.00%,2,2,0.00%
ns1.mastername.ru,0,0.00%,2,2,0.00%
ns2.smartape.ru,0,0.00%,2,2,0.00%
saransk.ens.mail.ru,0,0.00%,1,1,0.00%
magali.ns.cloudflare.com,0,0.00%,2,2,0.00%
catcher-in-the-rye.nic.se,0,0.00%,1,1,0.00%
rocco.ns.cloudflare.com,0,0.00%,2,2,0.00%
kyzyl.ens.mail.ru,0,0.00%,2,2,0.00%
ns1.platformalp.ru,0,0.00%,10,10,0.00%
ns2.mastername.ru,0,0.00%,2,2,0.00%
ns1.zomro.net,0,0.00%,6,6,0.00%
ns2.zomro.ru,0,0.00%,3,3,0.00%
ns3.zomro.com,0,0.00%,6,6,0.00%
dns1.wfolio.com,0,0.00%,8,8,0.00%
ns0.sitesale.ru,0,0.00%,6,6,0.00%
dns2.yandex.net,0,0.00%,2,2,0.00%
wedding-aksenenko.ru,0,0.00%,1,1,0.00%
dns3.fastdns24.eu,0,0.00%,2,2,0.00%
ns1.r01.ru,0,0.00%,4,4,0.00%
ns1.hoster.kz,0,0.00%,2,2,0.00%
ns4.insales.ru,0,0.00%,2,2,0.00%
ns2.r01.ru,0,0.00%,2,2,0.00%
dns4.fastdns24.link,0,0.00%,4,4,0.00%
dns.fastdns24.com,0,0.00%,2,2,0.00%
ns1.sitesale.ru,0,0.00%,4,4,0.00%
ns.hostingru.net,0,0.00%,2,2,0.00%
ns2.ihordns.net,0,0.00%,2,2,0.00%
ns3.hoster.kz,0,0.00%,2,2,0.00%
ns2.sitesale.ru,0,0.00%,2,2,0.00%
ns1.ihordns.net,0,0.00%,2,2,0.00%
ns3.webhost1.org,0,0.00%,3,3,0.00%
ns42.cloudns.net,0,0.00%,1,1,0.00%
ns41.cloudns.net,0,0.00%,2,2,0.00%
ns1.lealhost.com,0,0.00%,1,1,0.00%
ns43.cloudns.net,0,0.00%,2,2,0.00%
ns4.webhost1.org,0,0.00%,4,4,0.00%
ns2.ra-don.ru,0,0.00%,2,2,0.00%
ns44.cloudns.net,0,0.00%,1,1,0.00%
ns2.lealhost.com,0,0.00%,2,2,0.00%
ns2.webhost1.com,0,0.00%,6,6,0.00%
ns3.ra-don.ru,0,0.00%,2,2,0.00%
ns3.lealhost.ovh,0,0.00%,2,2,0.00%
ns1.ra-don.ru,0,0.00%,2,2,0.00%
ns1.eternalhost.net,0,0.00%,1,1,0.00%
ns2.registrant.ru,0,0.00%,2,2,0.00%
ns3.mchost.ru,0,0.00%,1,1,0.00%
ns2.eternalhost.net,0,0.00%,1,1,0.00%
ns4.mchost.ru,0,0.00%,2,2,0.00%
ns1.h6dns.online,0,0.00%,1,1,0.00%
ns1.umi.ru,0,0.00%,2,2,0.00%
ns.setup.ru,0,0.00%,2,2,0.00%
ns1.registrant.ru,0,0.00%,1,1,0.00%
ns.confidential.domains,0,0.00%,2,2,0.00%
monereo.ru,0,0.00%,1,1,0.00%
ns3.umi.ru,0,0.00%,2,2,0.00%
ns.you-online-dns.net,0,0.00%,1,1,0.00%
nsb1.goodhost.kz,0,0.00%,1,1,0.00%
gns194a.sendsay.ru,0,0.00%,2,2,0.00%
ns4.umi.ru,0,0.00%,1,1,0.00%
peace.zookingsoft.com,0,0.00%,2,2,0.00%
magazine.zookingsoft.com,0,0.00%,2,2,0.00%
29.courier-push-apple.com.akadns.net,0,0.00%,2,2,0.00%
sjy.stream.qqmusic.qq.com.ctdns.cn,0,0.00%,2,2,0.00%
hd.mmstat.com,0,0.00%,2,2,0.00%
ws.mmstat.com,0,0.00%,2,2,0.00%
hd.mmstat.com.gds.alibabadns.com,0,0.00%,2,2,0.00%
ws.mmstat.com.gds.alibabadns.com,0,0.00%,2,2,0.00%
hd-v6.mmstat.com,0,0.00%,2,2,0.00%
hd-v6.mmstat.com.gds.alibabadns.com,0,0.00%,2,2,0.00%
www.nmg.news.cn,0,0.00%,2,2,0.00%
www.nmg.xinhuanet.com,0,0.00%,2,2,0.00%
yb-safe.2345.cc,0,0.00%,8,8,0.00%
ndk.bg,0,0.00%,2,2,0.00%
mail.ndk.bg,0,0.00%,2,2,0.00%
ln.xinhuanet.com,0,0.00%,2,2,0.00%
phfwba-std-g1.oray.net,0,0.00%,2,2,0.00%
phsle5-std05.oray.net,0,0.00%,2,2,0.00%
dts.eqmail.net,0,0.00%,2,2,0.00%
my.vnexpress.net,0,0.00%,2,2,0.00%
cloud.fanruan.com,0,0.00%,2,2,0.00%
passport.iqiyi.com,0,0.00%,4,4,0.00%
onedscolprdjpe04.japaneast.cloudapp.azure.com,0,0.00%,1,1,0.00%
liveupdate01.asus.com,0,0.00%,1,1,0.00%
liveupdate01s.asus.com,0,0.00%,1,1,0.00%
liveupdate01s.asus.com.cn,0,0.00%,1,1,0.00%
ctrip.ceping.com,0,0.00%,2,2,0.00%
only-410039-124-16-140-6.nstool.laiqukankan.com,0,0.00%,1,1,0.00%
cactus.jd.com,0,0.00%,4,4,0.00%
passport.dns.iqiyi.com,0,0.00%,2,2,0.00%
sandbox.itunes.apple.com,0,0.00%,2,2,0.00%
q1.qlogo.cn,0,0.00%,2,2,0.00%
pleivxf.jxpoam.xyz,0,0.00%,4,4,0.00%
nsp-logservice-hiview-p40-drcn.obs.cn-north-2.myhuaweicloud.com,0,0.00%,2,2,0.00%
cm-10-40.getui.com,0,0.00%,2,2,0.00%
service.dcloud.net.cn,0,0.00%,2,2,0.00%
alog.umeng.com,0,0.00%,2,2,0.00%
cm-10-28.getui.com,0,0.00%,2,2,0.00%
default.cn.zb.na610.wagbridge.amap.alibabacorp.com,0,0.00%,2,2,0.00%
aperturehk.06.wf,0,0.00%,2,2,0.00%
kirino023.06.wf,0,0.00%,2,2,0.00%
zgcalos.mudfwd.xyz,0,0.00%,2,2,0.00%
downloadapi.n.shifen.com,0,0.00%,6,6,0.00%
only-782124-124-16-140-6.nstool.zhuanzfx.com,0,0.00%,1,1,0.00%
onedscolprdeus12.eastus.cloudapp.azure.com,0,0.00%,2,2,0.00%
only-986587-124-16-140-6.nstool.netease.com,0,0.00%,1,1,0.00%
onedscolprdfrc02.francecentral.cloudapp.azure.com,0,0.00%,3,3,0.00%
www.onenote.com,0,0.00%,2,2,0.00%
osiprod-krc-celadon-000.cloudapp.net,0,0.00%,2,2,0.00%
intf-pc.shanhutech.cn,0,0.00%,2,2,0.00%
rog-live-service.asus.com,0,0.00%,1,1,0.00%
only-290650-124-16-140-6.nstool.haowu.link,0,0.00%,1,1,0.00%
gllog.kkyd.cn,0,0.00%,4,4,0.00%
onedscolprdcus05.centralus.cloudapp.azure.com,0,0.00%,2,2,0.00%
www.infoq.cn,0,0.00%,4,4,0.00%
www.sciencenet.cn,0,0.00%,3,3,0.00%
www.onlineregister.com,0,0.00%,2,2,0.00%
i-dm3-cor003.api.p001.1drv.com,0,0.00%,4,4,0.00%
find.api.micloud.xiaomi.net,0,0.00%,4,4,0.00%
pay.video.qq.com,0,0.00%,2,2,0.00%
st-v3-univ-srs-win-3502-g3.api.splashtop.com,0,0.00%,2,2,0.00%
news.sxau.edu.cn,0,0.00%,1,1,0.00%
uz99.v.bsclink.cn,0,0.00%,2,2,0.00%
ipv6-datacenter.live.qcloud.com,0,0.00%,2,2,0.00%
login.qfarm.qq.com,0,0.00%,2,2,0.00%
i-bl6p-cor002.api.p001.1drv.com,0,0.00%,2,2,0.00%
f9e9542dq6tz0v6p.aliyunddos1026.com,0,0.00%,2,2,0.00%
auth.split.io,0,0.00%,4,4,0.00%
doc.qmail.com,0,0.00%,2,2,0.00%
d3afeddfd2d6b691141031ef6d8ecc1f.dlied1.cdntips.net,0,0.00%,2,2,0.00%
open.oneplus.net,0,0.00%,4,4,0.00%
i.mail.qq.com,0,0.00%,2,2,0.00%
aloc-control-plus.amap.com,0,0.00%,1,1,0.00%
css-ui.github.io,0,0.00%,1,1,0.00%
www.icode9.com,0,0.00%,4,4,0.00%
toutiao.com,0,0.00%,2,2,0.00%
p53-buy.itunes.apple.com,0,0.00%,2,2,0.00%
vc-mirror.snssdk.com,0,0.00%,2,2,0.00%
collector.n.shifen.com,0,0.00%,2,2,0.00%
pve.proxmox.com,0,0.00%,3,3,0.00%
s3m5.nzwgs.com,0,0.00%,2,2,0.00%
piwik.proxmox.com,0,0.00%,4,4,0.00%
jingyan.baidu.com,0,0.00%,2,2,0.00%
gsp1.baidu.com,0,0.00%,4,4,0.00%
ctt.zdworks.com,0,0.00%,2,2,0.00%
noring.zdworks.com,0,0.00%,2,2,0.00%
clockupdate.zdworks.com,0,0.00%,2,2,0.00%
msg.umengcloud.com,0,0.00%,2,2,0.00%
edgeservices.bing.com,0,0.00%,2,2,0.00%
browser.pipe.aria.microsoft.com,0,0.00%,4,4,0.00%
config.zdworks.com,0,0.00%,2,2,0.00%
rankhit.china.com,0,0.00%,4,4,0.00%
bchina-1.xsfaya.com,0,0.00%,3,3,0.00%
mts-audio.huawangzhixun.com,0,0.00%,4,4,0.00%
vmts.china.com,0,0.00%,4,4,0.00%
mts.huawangzhixun.com,0,0.00%,4,4,0.00%
bchina-2.xsfaya.com,0,0.00%,3,3,0.00%
onedscolprdweu06.westeurope.cloudapp.azure.com,0,0.00%,2,2,0.00%
em.baidu.com,0,0.00%,4,4,0.00%
wi.hit.edu.cn,0,0.00%,1,1,0.00%
bit.jjyy.ml,0,0.00%,1,1,0.00%
tracker.torrentyorg.pl,0,0.00%,2,2,0.00%
tracker.tvunderground.org.ru,0,0.00%,11,11,0.00%
z.crazyhd.com,0,0.00%,2,2,0.00%
retracker.telecom.by,0,0.00%,2,2,0.00%
brain.safe.360.cn,0,0.00%,2,2,0.00%
sug.so.360.cn,0,0.00%,1,1,0.00%
wenku.so.com,0,0.00%,1,1,0.00%
sdk.51.la,0,0.00%,2,2,0.00%
wkimg.bdimg.com,0,0.00%,1,1,0.00%
edu-tob.bdimg.com,0,0.00%,2,2,0.00%
compatm.tplay.qq.com,0,0.00%,4,4,0.00%
api.so.lianmeng.360.cn,0,0.00%,2,2,0.00%
p1.ssl.qhimgs4.com,0,0.00%,4,4,0.00%
d1ucxc6xi3jabg.cloudfront.net,0,0.00%,2,2,0.00%
ps.qhupdate.com,0,0.00%,8,8,0.00%
onedscolprdneu05.northeurope.cloudapp.azure.com,0,0.00%,2,2,0.00%
dd-static.jd.com,0,0.00%,1,1,0.00%
www.cmbchina.com,0,0.00%,2,2,0.00%
p418.ssl.qhimgs4.com,0,0.00%,1,1,0.00%
p419.ssl.qhimgs4.com,0,0.00%,2,2,0.00%
p420.ssl.qhimgs4.com,0,0.00%,2,2,0.00%
p5.ssl.qhimg.com,0,0.00%,2,2,0.00%
p405.ssl.qhimgs4.com,0,0.00%,2,2,0.00%
p1.ssl.qhimgs1.com,0,0.00%,2,2,0.00%
p3.ssl.qhimgs1.com,0,0.00%,2,2,0.00%
p2.ssl.qhimgs1.com,0,0.00%,2,2,0.00%
cm.mediav.com,0,0.00%,1,1,0.00%
login.360.cn,0,0.00%,2,2,0.00%
s0.ssl.qhimg.com,0,0.00%,1,1,0.00%
baike.so.com,0,0.00%,2,2,0.00%
s0.ssl.qhres2.com,0,0.00%,2,2,0.00%
q.baike.so.com,0,0.00%,2,2,0.00%
p.sug.so.com,0,0.00%,2,2,0.00%
match.adsrvr.cn,0,0.00%,1,1,0.00%
api.map.so.com,0,0.00%,2,2,0.00%
p2.ssl.qhimg.com,0,0.00%,1,1,0.00%
update.adobe.com,0,0.00%,2,2,0.00%
activation.sls.microsoft.com,0,0.00%,1,1,0.00%
pcwallpaper.zhhainiao.com,0,0.00%,2,2,0.00%
pdown.stat.360safe.com,0,0.00%,2,2,0.00%
landray.dingtalkapps.com,0,0.00%,1,1,0.00%
p3.ssl.qhimgs0.com,0,0.00%,1,1,0.00%
k.sina.com.cn,0,0.00%,2,2,0.00%
n2.sinaimg.cn,0,0.00%,2,2,0.00%
i.sso.sina.com.cn,0,0.00%,1,1,0.00%
news.sina.com.cn,0,0.00%,1,1,0.00%
n3.sinaimg.cn,0,0.00%,1,1,0.00%
finance.sina.com.cn,0,0.00%,2,2,0.00%
www.sinaimg.cn,0,0.00%,2,2,0.00%
tech.sina.com.cn,0,0.00%,1,1,0.00%
ent.sina.com.cn,0,0.00%,2,2,0.00%
d2.sina.com.cn,0,0.00%,2,2,0.00%
pluto.sina.cn,0,0.00%,2,2,0.00%
d0.sina.com.cn,0,0.00%,1,1,0.00%
sax.sina.com.cn,0,0.00%,2,2,0.00%
d3.sina.com.cn,0,0.00%,2,2,0.00%
comment.sina.com.cn,0,0.00%,1,1,0.00%
s3.pfp.sina.net,0,0.00%,1,1,0.00%
saxn.sina.com.cn,0,0.00%,2,2,0.00%
fav.mix.sina.com.cn,0,0.00%,2,2,0.00%
j.bd.dhsz.cn,0,0.00%,2,2,0.00%
js.bd.dhsz.cn,0,0.00%,2,2,0.00%
interface.sina.cn,0,0.00%,2,2,0.00%
s.u7u9.com,0,0.00%,1,1,0.00%
i3.sinaimg.cn,0,0.00%,4,4,0.00%
mjs.sinaimg.cn,0,0.00%,2,2,0.00%
d9.sina.com.cn,0,0.00%,2,2,0.00%
js.dhsz.cn,0,0.00%,4,4,0.00%
d5.sina.com.cn,0,0.00%,2,2,0.00%
zxgghn.25ku.com,0,0.00%,1,1,0.00%
api.tdp.u7u9.com,0,0.00%,1,1,0.00%
s9.cnzz.com,0,0.00%,2,2,0.00%
img.mix.sina.com.cn,0,0.00%,2,2,0.00%
mfejs.sina.cn,0,0.00%,1,1,0.00%
top.news.sina.com.cn,0,0.00%,3,3,0.00%
j.bd.twlxyx.cn,0,0.00%,1,1,0.00%
j.bs.twlxxl.cn,0,0.00%,2,2,0.00%
static.ws.126.net,0,0.00%,1,1,0.00%
gw.m.163.com,0,0.00%,1,1,0.00%
dl.reg.163.com,0,0.00%,2,2,0.00%
comment.api.163.com,0,0.00%,2,2,0.00%
api.money.126.net,0,0.00%,2,2,0.00%
yt-adp.ws.126.net,0,0.00%,4,4,0.00%
c.m.163.com,0,0.00%,2,2,0.00%
ipservice.ws.126.net,0,0.00%,2,2,0.00%
nex.163.com,0,0.00%,4,4,0.00%
h5.analytics.126.net,0,0.00%,4,4,0.00%
news.163.com,0,0.00%,4,4,0.00%
dy.163.com,0,0.00%,1,1,0.00%
ca01.mellanox.info,0,0.00%,2,2,0.00%
sfsc.gifshow.com,0,0.00%,2,2,0.00%
vmonitor.ws.netease.com,0,0.00%,4,4,0.00%
us.grid.sinaedge.com,0,0.00%,2,2,0.00%
sdkclick.uve.weibo.com,0,0.00%,1,1,0.00%
www.iscas.ac.cn,0,0.00%,1,1,0.00%
majsoul-hk-client.cn-hongkong.log.aliyuncs.com,0,0.00%,2,2,0.00%
wsgwp.diditaxi.com.cn,0,0.00%,2,2,0.00%
ut-static.udache.com,0,0.00%,1,1,0.00%
conf.diditaxi.com.cn,0,0.00%,2,2,0.00%
common.diditaxi.com.cn,0,0.00%,1,1,0.00%
res.xiaojukeji.com,0,0.00%,1,1,0.00%
api.didi.cn,0,0.00%,2,2,0.00%
poi.map.xiaojukeji.com,0,0.00%,2,2,0.00%
adtrack.xiaojukeji.com,0,0.00%,2,2,0.00%
img-ys011.didistatic.com,0,0.00%,1,1,0.00%
wiki.samat.org,0,0.00%,61,61,0.00%
api.udache.com,0,0.00%,1,1,0.00%
s.qhupdate.com,0,0.00%,3,3,0.00%
mail.ttu.edu,0,0.00%,10,10,0.00%
xpzk3.mjt.lu,0,0.00%,11,11,0.00%
api.ssl.so.com,0,0.00%,4,4,0.00%
api.map.diditaxi.com.cn,0,0.00%,1,1,0.00%
p0.ssl.qhimgs4.com,0,0.00%,2,2,0.00%
pt-starimg.didistatic.com,0,0.00%,1,1,0.00%
onedscolprdfrc04.francecentral.cloudapp.azure.com,0,0.00%,2,2,0.00%
pudn-static.oss-cn-beijing.aliyuncs.com,0,0.00%,1,1,0.00%
liwx2000.github.io,0,0.00%,1,1,0.00%
bam-cell.nr-data.net,0,0.00%,1,1,0.00%
m.pinduoduo.net,0,0.00%,2,2,0.00%
m.onegreen.net,0,0.00%,1,1,0.00%
m.onegreen.net.cdn30.com,0,0.00%,3,3,0.00%
fp-afd.azureedge.net,0,0.00%,2,2,0.00%
passport.360.cn,0,0.00%,4,4,0.00%
tongji.wlongchina.com,0,0.00%,4,4,0.00%
cdata.browser.360.cn,0,0.00%,4,4,0.00%
profile.se.360.cn,0,0.00%,4,4,0.00%
profile.chrome.360.cn,0,0.00%,4,4,0.00%
tools.17xiuwang.com,0,0.00%,4,4,0.00%
cseupdate.360safe.com,0,0.00%,4,4,0.00%
www.58pic.com,0,0.00%,2,2,0.00%
tw-07-7F287.ferryhwp8ebm.com,0,0.00%,14,14,0.00%
static.hao86.com,0,0.00%,4,4,0.00%
thirdparty.touker.com,0,0.00%,2,2,0.00%
c.data.mob.com,0,0.00%,2,2,0.00%
n.clarity.ms,0,0.00%,4,4,0.00%
hm.e.shifen.com,0,0.00%,2,2,0.00%
fxgate.baidu.com,0,0.00%,2,2,0.00%
key.xiaoai999.com,0,0.00%,2,2,0.00%
rj.thhej.com,0,0.00%,2,2,0.00%
fclog.baidu.com,0,0.00%,2,2,0.00%
sync.readcube.com,0,0.00%,2,2,0.00%
services.readcube.com,0,0.00%,2,2,0.00%
cpro.zol.com.cn,0,0.00%,2,2,0.00%
opscloud.htsec.com.wsglb0.com,0,0.00%,2,2,0.00%
c.clarity.ms,0,0.00%,2,2,0.00%
xue.baidu.com,0,0.00%,2,2,0.00%
www.net.cn,0,0.00%,4,4,0.00%
seek.10jqka.com.cn,0,0.00%,2,2,0.00%
recommend.docer.wps.cn,0,0.00%,2,2,0.00%
openapi.baidu.com,0,0.00%,5,5,0.00%
vulnerability-search.europe-north1-gke.intellij.net,0,0.00%,2,2,0.00%
update.filezilla-project.org,0,0.00%,4,4,0.00%
cachetwy.thsi.cn,0,0.00%,2,2,0.00%
fp-afd.azurefd.us,0,0.00%,2,2,0.00%
dl3.cdn.filezilla-project.org,0,0.00%,2,2,0.00%
e77a5bf68b462ecfcd52d87e77ca4fc1.clo.footprintdns.com,0,0.00%,1,1,0.00%
kmr.service.kugou.com,0,0.00%,4,4,0.00%
p3.fx.kgimg.com,0,0.00%,2,2,0.00%
www2.kugou.kugou.com,0,0.00%,2,2,0.00%
ns1.jiasule.NET,0,0.00%,2,2,0.00%
api.kuaishouzt.com,0,0.00%,2,2,0.00%
www.bingapis.com,0,0.00%,2,2,0.00%
browser.qq.com,0,0.00%,2,2,0.00%
hao123.xiuchufang.com,0,0.00%,2,2,0.00%
2345.hao715.com,0,0.00%,2,2,0.00%
s4.cnzz.com,0,0.00%,2,2,0.00%
clients.browser.qq.com,0,0.00%,2,2,0.00%
z3.cnzz.com,0,0.00%,2,2,0.00%
empty.kuwo.cn,0,0.00%,2,2,0.00%
nmobi.kuwo.cn,0,0.00%,2,2,0.00%
mgxhtj.kuwo.cn,0,0.00%,2,2,0.00%
array616.prod.do.dsp.mp.microsoft.com,0,0.00%,2,2,0.00%
amp-api-edge-lb.itunes-apple.com.akadns.net,0,0.00%,2,2,0.00%
mreg.kuwo.cn,0,0.00%,2,2,0.00%
nmsearch.kuwo.cn,0,0.00%,2,2,0.00%
sb.firefox.com.cn,0,0.00%,4,4,0.00%
r.bing.com,0,0.00%,2,2,0.00%
cn.cn-0001.cn-msedge.NET,0,0.00%,2,2,0.00%
qiquan.if.iqiyi.com,0,0.00%,2,2,0.00%
phx02pap003.storage.live.com,0,0.00%,2,2,0.00%
p3-douyin-comment.byteimg.com,0,0.00%,2,2,0.00%
oauth.account.jetbrains.com,0,0.00%,2,2,0.00%
weatherapi.market.xiaomi.com,0,0.00%,2,2,0.00%
api.equinox.io,0,0.00%,5,5,0.00%
georeferencer.outerspatial.com,0,0.00%,1,1,0.00%
aqua.hac.lp1.d4c.nintendo.net,0,0.00%,1,1,0.00%
ali-web-player-tracker.biliapi.net,0,0.00%,1,1,0.00%
fp-afd-nocache.azureedge.net,0,0.00%,1,1,0.00%
emweb.securities.eastmoney.com,0,0.00%,1,1,0.00%
ort-stsdk.vivo.com.cn,0,0.00%,1,1,0.00%
vcardsdkservice.vivo.com.cn,0,0.00%,2,2,0.00%
tagaya.hac.lp1.eshop.nintendo.net,0,0.00%,1,1,0.00%
veer.hac.lp1.d4c.nintendo.net,0,0.00%,1,1,0.00%
dauth-lp1.ndas.srv.nintendo.net,0,0.00%,2,2,0.00%
app.c.nf.migu.cn,0,0.00%,2,2,0.00%
stock.eastmoney.com,0,0.00%,2,2,0.00%
tp.pinduoduo.com,0,0.00%,2,2,0.00%
ins-tgrfs7t3.ias.tencent-cloud.net,0,0.00%,2,2,0.00%
www.a.ak.prd.aadg.akadns.net,0,0.00%,2,2,0.00%
57afda59-ed10-407a-a920-26b0b1695d40.assets.booqable.com,0,0.00%,1,1,0.00%
onedriveclucprodbn20012.blob.core.windows.net,0,0.00%,2,2,0.00%
zybuluo.com,0,0.00%,4,4,0.00%
www.zybuluo.com,0,0.00%,2,2,0.00%
p216-imap.mail.icloud.com.cn,0,0.00%,2,2,0.00%
p215-quota.icloud.com.cn,0,0.00%,2,2,0.00%
itunes.com,0,0.00%,2,2,0.00%
message.user.camp,0,0.00%,61,61,0.00%
mmstk.pinduoduo.com,0,0.00%,2,2,0.00%
capi.core-prod.grammarlyaws.com,0,0.00%,2,2,0.00%
y.yynote.cn,0,0.00%,2,2,0.00%
stdtime.gov.hk,0,0.00%,8,8,0.00%
dc1-st.ksn.kaspersky-labs.com,0,0.00%,2,2,0.00%
ieonlinews.trafficmanager.NET,0,0.00%,4,4,0.00%
7998da2750f4458888cc30c86d7f8a79.fp.measure.office.com,0,0.00%,2,2,0.00%
i62hmnztfpzwrhjg34m6ruxem5oe36nulzmxcgbdbkiaceubprkta7ad.tor2web.in,0,0.00%,2,2,0.00%
api.itechs.ac.cn,0,0.00%,2,2,0.00%
4a2b7c481f2c41bca2d74a67a35aa5fc.fp.measure.office.com,0,0.00%,1,1,0.00%
p205-contacts.icloud.com.cn,0,0.00%,2,2,0.00%
rq.qb-lbcct.cloud.duba.net,0,0.00%,2,2,0.00%
cdi-pe-app.letras.ulisboa.pt,0,0.00%,2,2,0.00%
ume1.umetrip.com,0,0.00%,2,2,0.00%
dd44c061c1c94d8ca014e6fb78f3c1e3.fp.measure.office.com,0,0.00%,1,1,0.00%
cdn.cache.netvigators.xyz,0,0.00%,4,4,0.00%
onedscolprduks02.uksouth.cloudapp.azure.com,0,0.00%,3,3,0.00%
b95c44644ac84af18d1c45f7b9402b67.fp.measure.office.com,0,0.00%,1,1,0.00%
flitsoft.slack.com,0,0.00%,2,2,0.00%
d3agi7vo7cz11p.cloudfront.net,0,0.00%,4,4,0.00%
common-us.onedrive.akadns.net,0,0.00%,2,2,0.00%
ocsp.thawte.com,0,0.00%,2,2,0.00%
crl.thawte.com,0,0.00%,2,2,0.00%
changelogs.ubuntu.com,0,0.00%,2,2,0.00%
d3my7gygxlhw3x.cloudfront.net,0,0.00%,1,1,0.00%
onedscolprdfrc00.francecentral.cloudapp.azure.com,0,0.00%,2,2,0.00%
1D.tlu.dl.delivery.mp.microsoft.com,0,0.00%,2,2,0.00%
wolf.sh,0,0.00%,7,7,0.00%
glacial-ravine-7295.morning-tundra-7160.herokuspace.com,0,0.00%,2,2,0.00%
hivoice-drcn.emui.dbankcloud.com,0,0.00%,2,2,0.00%
