domain,num_a_fail,rate_all,num_a_all,num_a_success,rate_a_fail
asia.pool.ntp.org,41275,5.21%,85223,43948,48.43%
rq.r9t1.com,41118,5.19%,81341,40223,50.55%
cn.pool.ntp.org,40032,5.05%,85809,45777,46.65%
optimizationguide-pa.googleapis.com,33949,4.28%,68425,34476,49.61%
big1.f5.lenovo.com.cn,18627,2.35%,18627,0,100.00%
big2.f5.lenovo.com.cn,18616,2.35%,18616,0,100.00%
safebrowsing.googleapis.com,11649,1.47%,23511,11862,49.55%
liveupdate5.f5.lenovo.com.cn,8936,1.13%,8936,0,100.00%
1.ubuntu.pool.ntp.org,8870,1.12%,9076,206,97.73%
3.ubuntu.pool.ntp.org,8791,1.11%,8982,191,97.87%
0.ubuntu.pool.ntp.org,8763,1.11%,8936,173,98.06%
2.ubuntu.pool.ntp.org,8758,1.11%,8922,164,98.16%
registry-1.docker.io,8271,1.04%,10279,2008,80.47%
clientservices.googleapis.com,8134,1.03%,16705,8571,48.69%
update.googleapis.com,7577,0.96%,11830,4253,64.05%
femetrics.grammarly.io,6972,0.88%,14831,7859,47.01%
ipv6.msftconnecttest.com,6874,0.87%,12617,5743,54.48%
browser.360.cn,6401,0.81%,14071,7670,45.49%
android.clients.google.com,6009,0.76%,12896,6887,46.60%
d27xxe7juh1us6.cloudfront.net,5759,0.73%,11764,6005,48.95%
zyx.qq.com,5702,0.72%,13378,7676,42.62%
data.bilibili.com,5627,0.71%,11997,6370,46.90%
www.taobao.com,5382,0.68%,11312,5930,47.58%
clients1.google.com,5186,0.65%,11124,5938,46.62%
pool.ntp.org,4610,0.58%,8025,3415,57.45%
mirrors.aliyun.com,4368,0.55%,4663,295,93.67%
eth.2miners.com,4306,0.54%,4403,97,97.80%
ns1.namebrightdns.com,4292,0.54%,10552,6260,40.67%
ns2.namebrightdns.com,4278,0.54%,10395,6117,41.15%
eu1.ethermine.org,4170,0.53%,4390,220,94.99%
us2.ethermine.org,4168,0.53%,4400,232,94.73%
us1.ethermine.org,4164,0.53%,4380,216,95.07%
asia1.ethermine.org,4103,0.52%,4432,329,92.58%
2.centos.pool.ntp.org,4064,0.51%,5350,1286,75.96%
www.sohu.com,3696,0.47%,8368,4672,44.17%
www.qq.com,3592,0.45%,54490,50898,6.59%
hub5pn.v6.sandai.net,3267,0.41%,3267,0,100.00%
www.ieee.org,3063,0.39%,6858,3795,44.66%
gecko-bd.feishu.cn,2889,0.36%,6075,3186,47.56%
vconf.f.360.cn,2786,0.35%,5649,2863,49.32%
1hkclu.pronetworklink.net,2721,0.34%,6268,3547,43.41%
0.centos.pool.ntp.org,2558,0.32%,2566,8,99.69%
3.centos.pool.ntp.org,2529,0.32%,2530,1,99.96%
1.centos.pool.ntp.org,2426,0.31%,2427,1,99.96%
ntp.sjtu.edu.cn,2349,0.30%,2354,5,99.79%
go.microsoft.com,2301,0.29%,4924,2623,46.73%
gateway.fe.apple-dns.net,2212,0.28%,5083,2871,43.52%
clients4.google.com,2152,0.27%,4617,2465,46.61%
update1.sangfor.net,2041,0.26%,4373,2332,46.67%
internal-api-lark-api.feishu.cn,2036,0.26%,3986,1950,51.08%
honeycomb.wpscdn.cn,2018,0.25%,4347,2329,46.42%
firefox.settings.services.mozilla.com,1974,0.25%,3564,1590,55.39%
n-devs-sgw.tplinkcloud.com.cn,1950,0.25%,4110,2160,47.45%
content-autofill.googleapis.com,1912,0.24%,4295,2383,44.52%
checkip.amazonaws.com,1831,0.23%,1896,65,96.57%
gateway.icloud.com.cn,1767,0.22%,4213,2446,41.94%
treatment.grammarly.com,1701,0.21%,3707,2006,45.89%
nstld.verisign-grs.com,1636,0.21%,1636,0,100.00%
translate.google.cn,1632,0.21%,3429,1797,47.59%
fs.microsoft.com,1625,0.21%,1924,299,84.46%
mimg.127.net,1580,0.20%,1630,50,96.93%
www.zhihu.com,1555,0.20%,3493,1938,44.52%
api.mathpix.com,1528,0.19%,3136,1608,48.72%
gateway.icloud.com,1516,0.19%,3283,1767,46.18%
mcs-bd.feishu.cn,1483,0.19%,3005,1522,49.35%
slardar-bd.feishu.cn,1481,0.19%,3017,1536,49.09%
newtab.firefoxchina.cn,1423,0.18%,2155,732,66.03%
www.chinauos.com,1362,0.17%,79564,78202,1.71%
mathpix.com,1339,0.17%,2778,1439,48.20%
mesu.apple.com,1326,0.17%,2995,1669,44.27%
api2.firefoxchina.cn,1314,0.17%,1965,651,66.87%
a.gtld-servers.net,1310,0.17%,139190,137880,0.94%
dcldshlupt.alicdn.com,1308,0.17%,2721,1413,48.07%
beacons.gcp.gvt2.com,1300,0.16%,2805,1505,46.35%
h.trace.qq.com,1283,0.16%,2927,1644,43.83%
assets.msn.com,1258,0.16%,2871,1613,43.82%
nat.emule.org.cn,1247,0.16%,1327,80,93.97%
www.apple.com,1223,0.15%,2838,1615,43.09%
play.google.com,1206,0.15%,2752,1546,43.82%
play.googleapis.com,1205,0.15%,2639,1434,45.66%
mask-api.icloud.com,1201,0.15%,1426,225,84.22%
www.tp-link.com.cn,1184,0.15%,2589,1405,45.73%
ioshost.qtlcdn.com,1177,0.15%,2492,1315,47.23%
0.openwrt.pool.ntp.org,1174,0.15%,1333,159,88.07%
3.openwrt.pool.ntp.org,1157,0.15%,1308,151,88.46%
img-xlppc-zhan.xunlei.com,1151,0.15%,2605,1454,44.18%
1.openwrt.pool.ntp.org,1139,0.14%,1319,180,86.35%
discovery-v6.verysync.cn,1135,0.14%,1135,0,100.00%
content-signature-2.cdn.mozilla.net,1132,0.14%,2154,1022,52.55%
gateway.fe.apple-dns.cn,1130,0.14%,2925,1795,38.63%
cdn-file.ludashi.com,1123,0.14%,2434,1311,46.14%
s.safe.360.cn,1116,0.14%,2588,1472,43.12%
c.apple.news,1109,0.14%,2443,1334,45.40%
streamdot.douyucdn.cn,1104,0.14%,2471,1367,44.68%
api.docer.wpscdn.cn,1104,0.14%,2333,1229,47.32%
2.openwrt.pool.ntp.org,1089,0.14%,1226,137,88.83%
kv601.prod.do.dsp.mp.microsoft.com,1087,0.14%,2300,1213,47.26%
update.todesk.com,1070,0.14%,2363,1293,45.28%
cache.tv.qq.com,1056,0.13%,2351,1295,44.92%
accounts.google.com,1052,0.13%,2530,1478,41.58%
a1961.g2.akamai.net,1046,0.13%,2129,1083,49.13%
df.cache.wpscdn.cn,1030,0.13%,2215,1185,46.50%
ssl.gstatic.com,1006,0.13%,2374,1368,42.38%
www.belkin.com,1002,0.13%,2110,1108,47.49%
www.google.com.hk,988,0.12%,2063,1075,47.89%
cv.duba.net,979,0.12%,2033,1054,48.16%
init.push.apple.com,963,0.12%,2014,1051,47.82%
hotfix.lenovo.com.cn,943,0.12%,2129,1186,44.29%
prd-elb-smbdevconnnc-cnnw1-0-695323148.cn-northwest-1.elb.amazonaws.com.cn,914,0.12%,1001,87,91.31%
ini.update.360safe.com,909,0.11%,2031,1122,44.76%
toblog.snssdk.com,909,0.11%,1925,1016,47.22%
ntp1.tummy.com,899,0.11%,899,0,100.00%
jtypkz2w.sched.d2.tdnsdp1.cn,898,0.11%,1431,533,62.75%
docs.google.com,885,0.11%,2267,1382,39.04%
r4.res.office365.com,873,0.11%,1862,989,46.89%
qmzgh5-1251003022.file.myqcloud.com,837,0.11%,1939,1102,43.17%
service.fanxing.kugou.com,831,0.10%,1907,1076,43.58%
ts1.cn.mm.bing.net,790,0.10%,1814,1024,43.55%
ts2.cn.mm.bing.net,778,0.10%,1781,1003,43.68%
qurl.f.360.cn,757,0.10%,1658,901,45.66%
offlintab.firefoxchina.cn,749,0.09%,917,168,81.68%
ncsi.6-c-0003.c-msedge.net,748,0.09%,748,0,100.00%
sjy6.stream.qqmusic.qq.com,742,0.09%,1639,897,45.27%
oneclient.sfx.ms,737,0.09%,1395,658,52.83%
tracker.byr.cn,728,0.09%,728,0,100.00%
ichannel.snssdk.com,724,0.09%,1628,904,44.47%
datarouter.ol.epicgames.com,720,0.09%,1535,815,46.91%
software-down.keniu.com,712,0.09%,1532,820,46.48%
apk.cdn.bleachcarnival.com,709,0.09%,1574,865,45.04%
dss0.bdstatic.com,705,0.09%,1578,873,44.68%
imap.gmail.com,697,0.09%,1537,840,45.35%
e6858.e19.s.tl88.net,683,0.09%,1494,811,45.72%
tracker.beeimg.com,666,0.08%,666,0,100.00%
dataflow.biliapi.com,664,0.08%,1471,807,45.14%
pss.bdstatic.com,662,0.08%,1526,864,43.38%
download.windowsupdate.com,661,0.08%,1412,751,46.81%
api.appcues.net,655,0.08%,1366,711,47.95%
client.dropbox.com,654,0.08%,1391,737,47.02%
discovery-v6.syncthing.net,645,0.08%,645,0,100.00%
mainnet.infura.io,644,0.08%,1634,990,39.41%
webrd04.is.autonavi.com,644,0.08%,1362,718,47.28%
webrd01.is.autonavi.com,641,0.08%,1356,715,47.27%
kinesis.us-east-1.amazonaws.com,640,0.08%,1336,696,47.90%
tracker2.wasabii.com.tw,639,0.08%,639,0,100.00%
retracker.lanta-net.ru,638,0.08%,5956,5318,10.71%
hub5pr.v6.phub.sandai.net,636,0.08%,1178,542,53.99%
0.cn.pool.ntp.org,634,0.08%,928,294,68.32%
img-s-msn-com.akamaized.net,630,0.08%,1355,725,46.49%
config.i.duba.net,628,0.08%,1248,620,50.32%
release-75570.gzc.vod.tencent-cloud.com,625,0.08%,1492,867,41.89%
wxapp.tc.qq.com,624,0.08%,1408,784,44.32%
beacons.gvt2.com,623,0.08%,1428,805,43.63%
webrd02.is.autonavi.com,614,0.08%,1343,729,45.72%
webrd03.is.autonavi.com,613,0.08%,1332,719,46.02%
docs.gtimg.com,607,0.08%,1308,701,46.41%
redirector.gvt1.com,604,0.08%,1263,659,47.82%
storage.googleapis.com,601,0.08%,1314,713,45.74%
notifier-configs.airbrake.io,596,0.08%,1268,672,47.00%
docs2.gtimg.com,591,0.07%,1276,685,46.32%
safebrowsing.googleapis-cn.com,585,0.07%,1373,788,42.61%
sdup.qihucdn.com,580,0.07%,833,253,69.63%
auth.docker.io,579,0.07%,1339,760,43.24%
download.windowsupdate.com.a.bdydns.com,579,0.07%,865,286,66.94%
r3.o.lencr.org,577,0.07%,984,407,58.64%
outlook.ha.office365.com,573,0.07%,1045,472,54.83%
p0.qhimg.com,567,0.07%,1214,647,46.71%
down3.huorong.cn,566,0.07%,1199,633,47.21%
ocsp.pki.goog,561,0.07%,1287,726,43.59%
fa000000105.resources.office.net,554,0.07%,1155,601,47.97%
google.com,552,0.07%,1381,829,39.97%
xp.apple.com,550,0.07%,1209,659,45.49%
t7.baidu.com,547,0.07%,1226,679,44.62%
update2.sangfor.net,543,0.07%,818,275,66.38%
i2.hdslb.com,542,0.07%,1219,677,44.46%
g.api.mega.co.nz,540,0.07%,2271,1731,23.78%
f-log-win-extension.grammarly.io,538,0.07%,1318,780,40.82%
3.cn.pool.ntp.org,535,0.07%,645,110,82.95%
easylist-downloads.adblockplus.org,532,0.07%,1086,554,48.99%
tracker.vanitycore.co,531,0.07%,940,409,56.49%
ss1.baidu.com,526,0.07%,1164,638,45.19%
googleads.g.doubleclick.net,522,0.07%,1196,674,43.65%
smartdl.lenovo.com.cn,522,0.07%,1117,595,46.73%
emoji.qpic.cn,519,0.07%,1154,635,44.97%
metrics.icloud.com,516,0.07%,1105,589,46.70%
gimg3.baidu.com,510,0.06%,1185,675,43.04%
broadcast.chat.bilibili.com,508,0.06%,1136,628,44.72%
mqtt-web.zhihu.com,506,0.06%,1009,503,50.15%
httpdns.alicdn.com,505,0.06%,1096,591,46.08%
fsigns.duba.net,504,0.06%,1085,581,46.45%
us.pool.ntp.org,503,0.06%,555,52,90.63%
pic3.zhimg.com,500,0.06%,1082,582,46.21%
1.cn.pool.ntp.org,495,0.06%,671,176,73.77%
pic1.zhimg.com,491,0.06%,1071,580,45.85%
facebook.com,489,0.06%,1121,632,43.62%
ss0.baidu.com,485,0.06%,1122,637,43.23%
opencdnmsdl1.jomodns.com,485,0.06%,1061,576,45.71%
t8.baidu.com,484,0.06%,1162,678,41.65%
steamcdn-a.akamaihd.net,478,0.06%,908,430,52.64%
mam6.netease.com,478,0.06%,478,0,100.00%
detectportal.firefox.com,477,0.06%,25442,24965,1.87%
dss1.bdstatic.com,476,0.06%,1120,644,42.50%
cdn.content.prod.cms.msn.com,476,0.06%,1063,587,44.78%
toblog.ctobsnssdk.com,476,0.06%,1046,570,45.51%
zhihu-web-analytics.zhihu.com,475,0.06%,1835,1360,25.89%
pic4.zhimg.com,474,0.06%,1051,577,45.10%
sf-api.com,474,0.06%,474,0,100.00%
img.alicdn.com,473,0.06%,1049,576,45.09%
pagead2.googlesyndication.com,471,0.06%,1142,671,41.24%
s3-alpha-sig.figma.com,468,0.06%,924,456,50.65%
tr.skype.trafficmanager.net,464,0.06%,464,0,100.00%
internal-api-lark-api.feishu.cn.bytedns1.com,461,0.06%,561,100,82.17%
pic2.zhimg.com,459,0.06%,1027,568,44.69%
zlxx.v.lxcvc.com,458,0.06%,1012,554,45.26%
ss2.baidu.com,457,0.06%,1117,660,40.91%
pancake.apple.com,446,0.06%,995,549,44.82%
slardar-bd.feishu.cn.bytedns1.com,446,0.06%,522,76,85.44%
bifrost-v4.getpostman.com,445,0.06%,969,524,45.92%
csdnimg.cn,443,0.06%,1017,574,43.56%
signaler-pa.clients6.google.com,442,0.06%,992,550,44.56%
drive.google.com,442,0.06%,1134,692,38.98%
6-c-0003.c-msedge.net,441,0.06%,441,0,100.00%
mubu.com,440,0.06%,951,511,46.27%
www.bytedance.com,440,0.06%,939,499,46.86%
stocks-data-service.apple.com,440,0.06%,956,516,46.03%
vweixinf.tc.qq.com,436,0.06%,965,529,45.18%
wildcard.feishu.cn.bytedns1.com,435,0.05%,575,140,75.65%
www3.l.google.com,433,0.05%,912,479,47.48%
e10499.dsce9.akamaiedge.net,430,0.05%,891,461,48.26%
api.segment.io,429,0.05%,928,499,46.23%
ss3.baidu.com,428,0.05%,1069,641,40.04%
cdn.jsdelivr.net,424,0.05%,869,445,48.79%
s.conf.wsm.360.cn,423,0.05%,587,164,72.06%
b.bdstatic.com,420,0.05%,1011,591,41.54%
agt.p.qianxin.com,419,0.05%,419,0,100.00%
tracker.birkenwald.de,417,0.05%,417,0,100.00%
g.alicdn.com,415,0.05%,919,504,45.16%
clients6.google.com,415,0.05%,850,435,48.82%
static.nvidiagrid.net,410,0.05%,467,57,87.79%
szmmsns.qpic.cn,406,0.05%,841,435,48.28%
dldir1v6.qq.com,403,0.05%,887,484,45.43%
tlu.dl.delivery.mp.microsoft.com,403,0.05%,721,318,55.89%
init-china.itunes-apple.com.akadns.net,398,0.05%,880,482,45.23%
vweixinthumb.tc.qq.com,397,0.05%,871,474,45.58%
cdn.cvws.apple-dns.net,397,0.05%,868,471,45.74%
stream.zotero.org,396,0.05%,919,523,43.09%
m.qpic.cn,395,0.05%,913,518,43.26%
firebaselogging-pa.googleapis.com,394,0.05%,915,521,43.06%
file.drivergenius.com,394,0.05%,786,392,50.13%
www.liebao.cn,392,0.05%,764,372,51.31%
code.bdstatic.com,391,0.05%,817,426,47.86%
pull-f3.douyincdn.com,387,0.05%,820,433,47.20%
whoami.akamai.net,386,0.05%,827,441,46.67%
profile-avatar.csdnimg.cn,385,0.05%,841,456,45.78%
pull-tsl-spe-l1.douyincdn.com,384,0.05%,831,447,46.21%
pull-rtmp-f13.douyincdn.com,383,0.05%,837,454,45.76%
masters1.feiyiproxy.com,382,0.05%,728,346,52.47%
sb.scorecardresearch.com,380,0.05%,857,477,44.34%
inappcheck-lb.itunes-apple.com.akadns.net,380,0.05%,1336,956,28.44%
pull-rtmp-l13.douyincdn.com,378,0.05%,1266,888,29.86%
pull-f5-hot.flive.douyincdn.com,376,0.05%,831,455,45.25%
hangouts.google.com,376,0.05%,762,386,49.34%
pull-rtmp-l1.ixigua.com,376,0.05%,829,453,45.36%
pull-flv-l1.ixigua.com,375,0.05%,823,448,45.57%
pull-hls-spe-l26.douyincdn.com,374,0.05%,827,453,45.22%
pull-lls-spe-l3.douyincdn.com,373,0.05%,808,435,46.16%
pull-flv-l13.douyincdn.com,373,0.05%,828,455,45.05%
api.m.jd.com,372,0.05%,823,451,45.20%
uk.pool.ntp.org,372,0.05%,433,61,85.91%
pull-rtmp-l1-cny.douyincdn.com,370,0.05%,808,438,45.79%
aapl-maps.qtlcdn.com,370,0.05%,790,420,46.84%
pull-hls-f5-enc.flive.douyincdn.com,370,0.05%,826,456,44.79%
gates.grammarly.com,368,0.05%,903,535,40.75%
beacons2.gvt2.com,367,0.05%,766,399,47.91%
pull-l3-cny.douyincdn.com,366,0.05%,796,430,45.98%
pull-f5-vs.flive.douyincdn.com,366,0.05%,829,463,44.15%
api2.firefoxchina.cn.wswebpic.com,366,0.05%,799,433,45.81%
2.cn.pool.ntp.org,366,0.05%,448,82,81.70%
findermp.video.qq.com,365,0.05%,842,477,43.35%
img-prod-cms-rt-microsoft-com.akamaized.net,365,0.05%,756,391,48.28%
pull-tsl-vr-l11.douyincdn.com,365,0.05%,804,439,45.40%
pull-lls-l3.douyincdn.com,365,0.05%,788,423,46.32%
pull-rtmp-l11.douyincdn.com,365,0.05%,809,444,45.12%
pull-hls-spe-l6.douyincdn.com,365,0.05%,815,450,44.79%
pull-tsl-spe-l6.douyincdn.com,365,0.05%,810,445,45.06%
pull-lls-f5.flive.douyincdn.com,364,0.05%,813,449,44.77%
pull-rtmp-f1.douyincdn.com,364,0.05%,802,438,45.39%
pull-flv-l3-enc.douyincdn.com,364,0.05%,776,412,46.91%
api.steampowered.com,364,0.05%,728,364,50.00%
pull-flv-vr-l1.douyincdn.com,363,0.05%,781,418,46.48%
pull-f3-proxy.douyincdn.com,363,0.05%,781,418,46.48%
pull-rtmp-l11-source.douyincdn.com,363,0.05%,790,427,45.95%
pull-hls-vr-l1.douyincdn.com,363,0.05%,784,421,46.30%
bt.nfshost.com,363,0.05%,363,0,100.00%
ipv6check-http.steamcontent.com,363,0.05%,363,0,100.00%
pull-tsl-vr-l3.douyincdn.com,362,0.05%,802,440,45.14%
bjacshow.kugou.com,361,0.05%,833,472,43.34%
pull-lls-spe-l1.douyincdn.com,361,0.05%,784,423,46.05%
pull-flv-vr-l26.douyincdn.com,361,0.05%,795,434,45.41%
pull-flv-l11-encryption.douyincdn.com,360,0.05%,798,438,45.11%
s1.hdslb.com,359,0.05%,828,469,43.36%
pull-tsl-vr-l26.douyincdn.com,359,0.05%,792,433,45.33%
pull-flv-l11.douyincdn.com,359,0.05%,787,428,45.62%
pull-hls-f11.douyincdn.com,358,0.05%,790,432,45.32%
pull-rtmp-l6.douyincdn.com,358,0.05%,796,438,44.97%
pull-flv-f11-proxy.douyincdn.com,358,0.05%,782,424,45.78%
pull-f5-io.flive.douyincdn.com,358,0.05%,808,450,44.31%
pull-tsl-spe-l11.douyincdn.com,357,0.05%,791,434,45.13%
pull-f5-mptcp.flive.douyincdn.com,357,0.05%,801,444,44.57%
pull-hls-f5-tsl.douyincdn.com,357,0.05%,778,421,45.89%
pull-flv-f1-proxy.douyincdn.com,357,0.05%,776,419,46.01%
pull-flv-l3-encryption.douyincdn.com,357,0.05%,777,420,45.95%
pull-rtmp-l6-source.douyincdn.com,356,0.04%,801,445,44.44%
pull-flv-l11-source.douyincdn.com,356,0.04%,782,426,45.52%
ocsp.apple.com,356,0.04%,806,450,44.17%
pull-flv-f1.douyincdn.com,356,0.04%,780,424,45.64%
pull-flv-f13.douyincdn.com,355,0.04%,799,444,44.43%
pull-hls-hs-f5-tsl.douyincdn.com,355,0.04%,800,445,44.38%
stocks-sparkline.apple.com,355,0.04%,780,425,45.51%
pull-rtmp-l1-source.douyincdn.com,355,0.04%,778,423,45.63%
pull-hls-spe-l1.douyincdn.com,355,0.04%,778,423,45.63%
pull-f5.douyincdn.com,355,0.04%,787,432,45.11%
liveupdate2.drivergenius.com,354,0.04%,777,423,45.56%
pull-tsl-vr-l6.douyincdn.com,354,0.04%,795,441,44.53%
fonts.gstatic.com,353,0.04%,823,470,42.89%
pull-flv-l1.douyincdn.com,353,0.04%,777,424,45.43%
pull-tsl-l3.douyincdn.com,353,0.04%,783,430,45.08%
pull-flv-l6.douyincdn.com,353,0.04%,774,421,45.61%
picx.zhimg.com,352,0.04%,993,641,35.45%
pull-flv-vr-l6.douyincdn.com,352,0.04%,764,412,46.07%
pull-lls-spe-l11.douyincdn.com,351,0.04%,791,440,44.37%
pull-tsl-vr-l1.douyincdn.com,351,0.04%,763,412,46.00%
pull-hls-vr-l26.douyincdn.com,351,0.04%,770,419,45.58%
pull-flv-l6-source.douyincdn.com,350,0.04%,776,426,45.10%
pull-flv-f96.douyincdn.com,350,0.04%,775,425,45.16%
pull-l3.douyincdn.com,349,0.04%,783,434,44.57%
init.push-apple.com.akadns.net,349,0.04%,800,451,43.62%
pull-rtmp-f11.douyincdn.com,348,0.04%,779,431,44.67%
pull-tsl-hs-spe-f5.douyincdn.com,347,0.04%,764,417,45.42%
pull-rtmp-l26-cny.douyincdn.com,346,0.04%,773,427,44.76%
tracker.nitrix.me,346,0.04%,696,350,49.71%
pull-lls-spe-l6.douyincdn.com,345,0.04%,768,423,44.92%
pull-l3-source.douyincdn.com,345,0.04%,760,415,45.39%
a2p-s01-drcn.xcm.xyx-xylo.com,345,0.04%,1521,1176,22.68%
pull-rtmp-l29.douyincdn.com,345,0.04%,810,465,42.59%
pull-hls-f1.douyincdn.com,344,0.04%,778,434,44.22%
pull-flv-l1-cny.douyincdn.com,344,0.04%,758,414,45.38%
pull-flv-vr-l11.douyincdn.com,343,0.04%,755,412,45.43%
pull-spe-l3.douyincdn.com,343,0.04%,759,416,45.19%
upos-sz-mirrorcoso1.bilivideo.com,342,0.04%,793,451,43.13%
d11.baidupcs.com,342,0.04%,714,372,47.90%
pull-hs-f5-encryption.flive.douyincdn.com,342,0.04%,797,455,42.91%
pull-flv-spe-l6.douyincdn.com,342,0.04%,753,411,45.42%
inappcheck.itunes.apple.com,341,0.04%,1349,1008,25.28%
pull-flv-l6-encryption.douyincdn.com,341,0.04%,762,421,44.75%
pull-flv-spe-l1.douyincdn.com,341,0.04%,762,421,44.75%
pull-vr-l3.douyincdn.com,341,0.04%,768,427,44.40%
pull-flv-f26-proxy.douyincdn.com,340,0.04%,769,429,44.21%
pull-flv-f6.douyincdn.com,340,0.04%,758,418,44.85%
pull-rtmp-l11-cny.douyincdn.com,340,0.04%,760,420,44.74%
pull-hls-f5-vs-tsl.douyincdn.com,340,0.04%,759,419,44.80%
pull-rtmp-l1.douyincdn.com,339,0.04%,765,426,44.31%
help.apple.com,339,0.04%,766,427,44.26%
hicloud.hiwifi.com,339,0.04%,661,322,51.29%
pull-hls-vr-l11.douyincdn.com,338,0.04%,747,409,45.25%
pull-lls-l11.douyincdn.com,338,0.04%,767,429,44.07%
qzone.qq.com,338,0.04%,688,350,49.13%
pull-tsl-spe-l26.douyincdn.com,337,0.04%,752,415,44.81%
upos-sz-mirrorali.bilivideo.com,337,0.04%,776,439,43.43%
ocsp.sca1b.amazontrust.com,337,0.04%,714,377,47.20%
pull-flv-f11.douyincdn.com,337,0.04%,766,429,43.99%
pull-rtmp-f96.douyincdn.com,337,0.04%,756,419,44.58%
www.googleapis.cn,336,0.04%,751,415,44.74%
pc.ximalaya.com,335,0.04%,685,350,48.91%
pull-flv-l1-source.douyincdn.com,335,0.04%,747,412,44.85%
mesu-china.apple.com.akadns.net,334,0.04%,719,385,46.45%
pull-flv-l6-enc.douyincdn.com,334,0.04%,760,426,43.95%
pull-rtmp-f26.douyincdn.com,334,0.04%,748,414,44.65%
k128-mzstatic.gslb.ksyuncdn.com,334,0.04%,695,361,48.06%
tracker.byr.pt,334,0.04%,334,0,100.00%
y.qq.com,333,0.04%,682,349,48.83%
pull-flv-spe-l26.douyincdn.com,333,0.04%,738,405,45.12%
pull-hls-spe-l11.douyincdn.com,333,0.04%,760,427,43.82%
www.tmall.com,333,0.04%,732,399,45.49%
v-fixedinpt1001.71edge.xyz,331,0.04%,620,289,53.39%
pull-flv-l29.douyincdn.com,330,0.04%,814,484,40.54%
pull-hs-spe-f5.douyincdn.com,330,0.04%,750,420,44.00%
e673.dsce9.akamaiedge.net,329,0.04%,672,343,48.96%
pull-hls-f26.douyincdn.com,329,0.04%,733,404,44.88%
adservice.google.com,328,0.04%,776,448,42.27%
14.tlu.dl.delivery.mp.microsoft.com,328,0.04%,708,380,46.33%
pull-flv-l26.douyincdn.com,328,0.04%,738,410,44.44%
pull-tsl-spe-l3.douyincdn.com,326,0.04%,731,405,44.60%
pull-rtmp-f6.douyincdn.com,326,0.04%,740,414,44.05%
pull-hls-f96.douyincdn.com,325,0.04%,732,407,44.40%
pull-flv-spe-l11.douyincdn.com,325,0.04%,733,408,44.34%
img-home.csdnimg.cn,324,0.04%,729,405,44.44%
kv501.prod.do.dsp.mp.microsoft.com,323,0.04%,1194,871,27.05%
pull-flv-f29.douyincdn.com,323,0.04%,743,420,43.47%
v6ncsi.msedge.net,323,0.04%,609,286,53.04%
pull-flv-l6-cny.douyincdn.com,321,0.04%,729,408,44.03%
pull-flv-l26-cny.douyincdn.com,321,0.04%,716,395,44.83%
help.origin-apple.com.akadns.net,320,0.04%,683,363,46.85%
pull-hs-f5.flive.douyincdn.com,320,0.04%,740,420,43.24%
pull-tsl-l11.douyincdn.com,320,0.04%,728,408,43.96%
e11290.dspg.akamaiedge.net,319,0.04%,663,344,48.11%
mcs-bd.feishu.cn.w.cdngslb.com,319,0.04%,654,335,48.78%
es.f.360.cn,319,0.04%,671,352,47.54%
download.docker.com,319,0.04%,423,104,75.41%
dtl.update.updrv.com,318,0.04%,720,402,44.17%
res.ldmnq.com,316,0.04%,736,420,42.93%
msedge.b.tlu.dl.delivery.mp.microsoft.com,315,0.04%,696,381,45.26%
zhanzhang.toutiao.com,314,0.04%,749,435,41.92%
play.itunes.apple.com,314,0.04%,706,392,44.48%
beacons3.gvt2.com,314,0.04%,694,380,45.24%
pull-hls-f6.douyincdn.com,314,0.04%,712,398,44.10%
video-hw-drcn.dbankcdn.cn,313,0.04%,720,407,43.47%
storecatalogrevocation.storequality.microsoft.com,312,0.04%,625,313,49.92%
img.alicdn.com.danuoyi.alicdn.com,309,0.04%,671,362,46.05%
tracker.coalition.space,309,0.04%,633,324,48.82%
ipv6.l.google.com,307,0.04%,307,0,100.00%
download.visualstudio.microsoft.com,307,0.04%,640,333,47.97%
sdkoptedge.chinanetcenter.com,307,0.04%,676,369,45.41%
tracker.bt4g.com,307,0.04%,894,587,34.34%
pull-rtmp-f6-hs.pstatp.com,306,0.04%,685,379,44.67%
filedownload.lenovo.com,304,0.04%,647,343,46.99%
gspe1-ssl.ls.apple.com,302,0.04%,659,357,45.83%
clientconfig.akamai.steamstatic.com,302,0.04%,640,338,47.19%
api.weathercn.com,301,0.04%,706,405,42.63%
pull-flv-f1-hs.pstatp.com,300,0.04%,646,346,46.44%
slardar-bd.feishu.cn.w.cdngslb.com,298,0.04%,602,304,49.50%
1595096.sched.d0-dk.tdnsdp1.cn,298,0.04%,650,352,45.85%
pull-f5-hs.flive.pstatp.com,292,0.04%,655,363,44.58%
ts4.cn.mm.bing.net,291,0.04%,734,443,39.65%
events.launchdarkly.com,290,0.04%,631,341,45.96%
api1.origin.com,290,0.04%,645,355,44.96%
d2nxq2uap88usk.cloudfront.net,288,0.04%,646,358,44.58%
zconfig.alibabausercontent.com,287,0.04%,630,343,45.56%
twitter.com,287,0.04%,682,395,42.08%
img-blog.csdnimg.cn,285,0.04%,662,377,43.05%
mg-mg.facebook.com,284,0.04%,677,393,41.95%
push-rtmp-l3.douyincdn.com,282,0.04%,609,327,46.31%
pull-rtmp-l6-hs.pstatp.com,281,0.04%,626,345,44.89%
pull-flv-l6.ixigua.com,281,0.04%,631,350,44.53%
ja-ks.facebook.com,281,0.04%,610,329,46.07%
dtapp-pub.dingtalk.com,280,0.04%,567,287,49.38%
tracker.ipv6tracker.ru,279,0.04%,279,0,100.00%
sw-ke.facebook.com,279,0.04%,672,393,41.52%
pull-flv-f6-hs.pstatp.com,279,0.04%,626,347,44.57%
i.hhrspb7.top,279,0.04%,565,286,49.38%
e13678.ca2.s.tl88.net,279,0.04%,626,347,44.57%
push-rtmp-l29.douyincdn.com,277,0.03%,620,343,44.68%
so-so.facebook.com,277,0.03%,672,395,41.22%
pull-f5-hs.pstatp.com,277,0.03%,613,336,45.19%
push-rtmp-f5-hs.pstatp.com,277,0.03%,658,381,42.10%
pull-hs-f5.flive.huoshanlive.com,276,0.03%,626,350,44.09%
pull-hs-f5.flive.ihuoshanlive.com,275,0.03%,646,371,42.57%
steamstore-a.akamaihd.net,275,0.03%,572,297,48.08%
pull-f3-hs.pstatp.com,275,0.03%,614,339,44.79%
pull-l3-hs.pstatp.com,275,0.03%,608,333,45.23%
setup.icloud.com,274,0.03%,621,347,44.12%
mon.zijieapi.com.bytedns1.com,274,0.03%,945,671,28.99%
guide-acs.m.taobao.com,273,0.03%,560,287,48.75%
pull-rtmp-l1-hs.pstatp.com,273,0.03%,615,342,44.39%
gw.alipayobjects.com,272,0.03%,604,332,45.03%
pull-rtmp-l6.ixigua.com,272,0.03%,609,337,44.66%
push-rtmp-l1-cny.douyincdn.com,271,0.03%,627,356,43.22%
dl.delivery.mp.microsoft.com,271,0.03%,584,313,46.40%
push-rtmp-l13.douyincdn.com,271,0.03%,596,325,45.47%
www.cntv.cn,269,0.03%,638,369,42.16%
pull-flv-l1-hs.pstatp.com,268,0.03%,594,326,45.12%
optimize.duba.net,268,0.03%,521,253,51.44%
ldc-fast.lenovo.com.cn,268,0.03%,582,314,46.05%
push-rtmp-l11-encryption.douyincdn.com,267,0.03%,594,327,44.95%
safebrowsing.google.com,267,0.03%,563,296,47.42%
push-rtmp-l3-encryption.douyincdn.com,266,0.03%,578,312,46.02%
pull-rtmp-f1-hs.pstatp.com,263,0.03%,596,333,44.13%
push-rtmp-f5.douyincdn.com,263,0.03%,597,334,44.05%
groups.google.com,262,0.03%,654,392,40.06%
push-rtmp-hs-vr-f5.douyincdn.com,260,0.03%,618,358,42.07%
api.epicgames.dev,260,0.03%,551,291,47.19%
tracker.cyberia.is,259,0.03%,259,0,100.00%
t11.baidu.com,257,0.03%,602,345,42.69%
tlu.dl.delivery.mp.microsoft.com.w.alikunlun.com,257,0.03%,528,271,48.67%
assets2.msn.com,256,0.03%,590,334,43.39%
tpc.googlesyndication.com,256,0.03%,610,354,41.97%
l2.hiwifi.com,256,0.03%,504,248,50.79%
rinkeby.infura.io,256,0.03%,532,276,48.12%
push-rtmp-l6.douyincdn.com,256,0.03%,562,306,45.55%
vdn6.vzuu.com,256,0.03%,549,293,46.63%
push-rtmp-vr-l26.douyincdn.com,255,0.03%,572,317,44.58%
push-rtmp-l6-cny.douyincdn.com,255,0.03%,568,313,44.89%
push-rtmp-l3-enc.douyincdn.com,254,0.03%,561,307,45.28%
tracker.hama3.net,254,0.03%,558,304,45.52%
push-rtmp-spe-l1.douyincdn.com,253,0.03%,598,345,42.31%
push-rtmp-l6-hs.pstatp.com,253,0.03%,564,311,44.86%
push-rtmp-l6.ixigua.com,253,0.03%,575,322,44.00%
push-rtmp-l3-hs.pstatp.com,253,0.03%,556,303,45.50%
t12.baidu.com,252,0.03%,593,341,42.50%
push-rtmp-l1.ixigua.com,252,0.03%,587,335,42.93%
push-rtmp-vr-l1.douyincdn.com,251,0.03%,567,316,44.27%
push-rtmp-l3-cny.douyincdn.com,251,0.03%,565,314,44.42%
clients2.googleusercontent.com,251,0.03%,554,303,45.31%
res.u-tools.cn,250,0.03%,542,292,46.13%
push-rtmp-hs-spe-f5.douyincdn.com,249,0.03%,588,339,42.35%
www.googletagmanager.com,248,0.03%,692,444,35.84%
push-rtmp-l1.douyincdn.com,248,0.03%,576,328,43.06%
push-rtmp-spe-l26.douyincdn.com,248,0.03%,552,304,44.93%
mon.zijieapi.com.dsa.dnsv1.com.cn,248,0.03%,441,193,56.24%
app-measurement.com,247,0.03%,583,336,42.37%
t10.baidu.com,247,0.03%,576,329,42.88%
slb-p2p.vcloud.ks-live.com,247,0.03%,532,285,46.43%
f-log-extension.grammarly.io,247,0.03%,692,445,35.69%
push-rtmp-spe-l11.douyincdn.com,247,0.03%,562,315,43.95%
push-rtmp-spe-l6.douyincdn.com,247,0.03%,553,306,44.67%
valid.apple.com,246,0.03%,549,303,44.81%
ow1.res.office365.com,246,0.03%,518,272,47.49%
push-rtmp-vr-l6.douyincdn.com,246,0.03%,546,300,45.05%
push-rtmp-l26.douyincdn.com,246,0.03%,554,308,44.40%
push-rtmp-l6-enc.douyincdn.com,245,0.03%,550,305,44.55%
push-rtmp-hs-f5.huoshanlive.com,245,0.03%,576,331,42.53%
bds.snssdk.com,245,0.03%,554,309,44.22%
bimp.hdslb.com,244,0.03%,541,297,45.10%
y.gtimg.cn,244,0.03%,552,308,44.20%
push-rtmp-l1-hs.pstatp.com,244,0.03%,560,316,43.57%
v1.go2yd.com,244,0.03%,538,294,45.35%
push-rtmp-f5-enc.douyincdn.com,243,0.03%,557,314,43.63%
package-search.services.jetbrains.com,243,0.03%,473,230,51.37%
14.au.download.windowsupdate.com,242,0.03%,513,271,47.17%
down-30005.sz.gfp.tencent-cloud.com,242,0.03%,516,274,46.90%
sf3-fe-tos.pglstatp-toutiao.com,242,0.03%,517,275,46.81%
himg.bdimg.com,242,0.03%,532,290,45.49%
gateway.bitrenren.com,240,0.03%,518,278,46.33%
push-rtmp-l6-encryption.douyincdn.com,240,0.03%,547,307,43.88%
ins-59d1h3tv.ias.tencent-cloud.net,240,0.03%,559,319,42.93%
atm-settingsfe-prod-geo2.trafficmanager.NET,240,0.03%,587,347,40.89%
self.events.data.microsoft.com,239,0.03%,25709,25470,0.93%
push-rtmp-hs-f5.douyincdn.com,238,0.03%,564,326,42.20%
atm-fp-direct.office.com,238,0.03%,488,250,48.77%
push-rtmp-vr-l11.douyincdn.com,237,0.03%,539,302,43.97%
push-rtmp-f5.ihuoshanlive.com,236,0.03%,566,330,41.70%
appdl-1-drcn.dbankcdn.com,236,0.03%,526,290,44.87%
partner.googleadservices.com,235,0.03%,529,294,44.42%
d.dropbox.com,235,0.03%,483,248,48.65%
sites.google.com,233,0.03%,574,341,40.59%
dldir2.qq.com,233,0.03%,282,49,82.62%
cwx.qlogo.cn,232,0.03%,525,293,44.19%
settings-bd.feishu.cn,231,0.03%,429,198,53.85%
push-rtmp-l11.douyincdn.com,231,0.03%,539,308,42.86%
disc801.prod.do.dsp.mp.microsoft.com,231,0.03%,484,253,47.73%
0.pool.ntp.org,230,0.03%,434,204,53.00%
gecko-bd.feishu.cn.w.cdngslb.com,229,0.03%,458,229,50.00%
cdn.ynuf.aliapp.org,229,0.03%,490,261,46.73%
plugins.jetbrains.com,229,0.03%,460,231,49.78%
ocsp.dcocsp.cn,228,0.03%,492,264,46.34%
hcfy.app,228,0.03%,454,226,50.22%
u.qurl.f.360.cn,228,0.03%,484,256,47.11%
global.asimov.events.data.trafficmanager.NET,228,0.03%,436,208,52.29%
upos-sz-staticcos-cmask.bilivideo.com,227,0.03%,496,269,45.77%
cu003.www.duba.net,227,0.03%,467,240,48.61%
3071995.dsp-dk.sched.dcloudstc.com,226,0.03%,474,248,47.68%
rhc.sonatype.com,225,0.03%,231,6,97.40%
v6-1.nigirocloud.com,224,0.03%,224,0,100.00%
tt-ru.facebook.com,223,0.03%,426,203,52.35%
grs.dbankcloud.asia,223,0.03%,459,236,48.58%
cu005.www.duba.net,222,0.03%,470,248,47.23%
sy-sy.facebook.com,222,0.03%,421,199,52.73%
tracker.xfsub.com,222,0.03%,222,0,100.00%
calendar.google.com,221,0.03%,533,312,41.46%
he-il.facebook.com,221,0.03%,403,182,54.84%
ulfbrueggemann.no-ip.org,221,0.03%,221,0,100.00%
cdn.ghostery.com,221,0.03%,455,234,48.57%
tsbrowser.xiangtatech.com,220,0.03%,515,295,42.72%
v6-4.nigirocloud.com,220,0.03%,220,0,100.00%
2.debian.pool.ntp.org,219,0.03%,355,136,61.69%
hdns.ksyun.com,219,0.03%,462,243,47.40%
v6-3.nigirocloud.com,219,0.03%,405,186,54.07%
wppkg.baidupcs.com,218,0.03%,457,239,47.70%
cb-iq.facebook.com,218,0.03%,421,203,51.78%
ko-kr.facebook.com,217,0.03%,423,206,51.30%
static-xl.a.88cdn.com,216,0.03%,465,249,46.45%
tangram-config.gdt.qq.com,216,0.03%,511,295,42.27%
itunes.apple.com,216,0.03%,470,254,45.96%
android.googleapis.com,216,0.03%,501,285,43.11%
bkssl.bdimg.com,215,0.03%,524,309,41.03%
my-mm.facebook.com,215,0.03%,415,200,51.81%
or-in.facebook.com,215,0.03%,420,205,51.19%
kn-in.facebook.com,215,0.03%,415,200,51.81%
autopush.prod.mozaws.net,215,0.03%,456,241,47.15%
tracker.bluefrog.pw,215,0.03%,429,214,50.12%
aka.ms,214,0.03%,431,217,49.65%
dsp.mbgcdn.lenovo.com.cn,214,0.03%,519,305,41.23%
km-kh.facebook.com,214,0.03%,409,195,52.32%
v6-2.nigirocloud.com,214,0.03%,214,0,100.00%
cloud.tencent.com,214,0.03%,477,263,44.86%
ky-kg.facebook.com,213,0.03%,413,200,51.57%
e8652.dscx.akamaiedge.net,213,0.03%,440,227,48.41%
data.bilicdn2.com,212,0.03%,461,249,45.99%
et-ee.facebook.com,212,0.03%,407,195,52.09%
tx.pull.yximgs.com,212,0.03%,461,249,45.99%
v10.events.data.microsoft.com,211,0.03%,38006,37795,0.56%
www.msftncsi.com,211,0.03%,24427,24216,0.86%
tg-tj.facebook.com,211,0.03%,403,192,52.36%
hy-am.facebook.com,211,0.03%,407,196,51.84%
zh-tw.facebook.com,211,0.03%,400,189,52.75%
ws.pull.yximgs.com,211,0.03%,450,239,46.89%
www.google.com.ar,210,0.03%,589,379,35.65%
plus.google.com,210,0.03%,534,324,39.33%
hi-in.facebook.com,210,0.03%,409,199,51.34%
pl-pl.facebook.com,210,0.03%,406,196,51.72%
sv-se.facebook.com,210,0.03%,408,198,51.47%
services.addons.mozilla.org,210,0.03%,329,119,63.83%
repo.huaweicloud.com,209,0.03%,531,322,39.36%
hub5u.v6.phub.sandai.net,209,0.03%,209,0,100.00%
zh-cn.facebook.com,209,0.03%,404,195,51.73%
uk-ua.facebook.com,209,0.03%,407,198,51.35%
fa-ir.facebook.com,209,0.03%,400,191,52.25%
me.apple-dns.net,209,0.03%,447,238,46.76%
pic.rmb.bdstatic.com,208,0.03%,473,265,43.97%
upload.youtube.com,208,0.03%,515,307,40.39%
onedrive.live.com,208,0.03%,529,321,39.32%
www.google.com.cy,208,0.03%,522,314,39.85%
updateleak.qihucdn.com,208,0.03%,442,234,47.06%
th-th.facebook.com,208,0.03%,410,202,50.73%
vi-vn.facebook.com,208,0.03%,396,188,52.53%
be01mr9s.sched.d2.tdnsdp1.cn,208,0.03%,370,162,56.22%
upload.twitter.com,207,0.03%,492,285,42.07%
upload-oss.vzuu.com,207,0.03%,397,190,52.14%
search.yahoo.com,207,0.03%,515,308,40.19%
assets.yiban.io,207,0.03%,429,222,48.25%
mt-mt.facebook.com,207,0.03%,410,203,50.49%
te-in.facebook.com,207,0.03%,401,194,51.62%
ml-in.facebook.com,207,0.03%,397,190,52.14%
tracker.1337x.org,206,0.03%,9473,9267,2.17%
www.google.co.cr,206,0.03%,510,304,40.39%
www.google.com.ai,206,0.03%,577,371,35.70%
kk-kz.facebook.com,206,0.03%,396,190,52.02%
uz-uz.facebook.com,206,0.03%,400,194,51.50%
bolt.dropbox.com,206,0.03%,429,223,48.02%
www.google.com.au,205,0.03%,517,312,39.65%
youtube.com,205,0.03%,515,310,39.81%
onenote.com,205,0.03%,410,205,50.00%
paper.dropbox.com,205,0.03%,524,319,39.12%
darwin.b.qianxin.com,205,0.03%,452,247,45.35%
inappcheck.itunes.apple.com.w.alikunlun.com,205,0.03%,454,249,45.15%
es-la.facebook.com,205,0.03%,391,186,52.43%
gu-in.facebook.com,205,0.03%,405,200,50.62%
showcase.dropbox.com,204,0.03%,526,322,38.78%
upos-sz-mirrorhwo1.bilivideo.com,204,0.03%,463,259,44.06%
zz-tr.facebook.com,204,0.03%,404,200,50.50%
pa-in.facebook.com,204,0.03%,392,188,52.04%
tumblr.com,204,0.03%,455,251,44.84%
heartbeat.dm.origin.com,204,0.03%,447,243,45.64%
boss.hdslb.com,203,0.03%,461,258,44.03%
youtubei.googleapis.com,203,0.03%,430,227,47.21%
iscas-itechs-kg.feishu.cn,203,0.03%,362,159,56.08%
be-by.facebook.com,203,0.03%,398,195,51.01%
zh-hk.facebook.com,203,0.03%,397,194,51.13%
grifon.info,203,0.03%,391,188,51.92%
inews.gtimg.com,203,0.03%,416,213,48.80%
www.google.com.bo,202,0.03%,513,311,39.38%
www.google.com.bz,202,0.03%,556,354,36.33%
ne-np.facebook.com,202,0.03%,384,182,52.60%
si-lk.facebook.com,202,0.03%,386,184,52.33%
lo-la.facebook.com,202,0.03%,394,192,51.27%
bd.pull.yximgs.com,202,0.03%,440,238,45.91%
tracker.doko.moe,202,0.03%,391,189,51.66%
static.hdslb.com,201,0.03%,439,238,45.79%
www.google.co.bw,201,0.03%,501,300,40.12%
www.google.com.cu,201,0.03%,561,360,35.83%
ks.pull.yximgs.com,201,0.03%,441,240,45.58%
upos-sz-mirrorcos.bilivideo.com,200,0.03%,539,339,37.11%
www.google.com.do,200,0.03%,565,365,35.40%
www.google.com.br,200,0.03%,502,302,39.84%
www.google.com.af,199,0.03%,575,376,34.61%
dropbox.com,199,0.03%,524,325,37.98%
www.google.com.bh,199,0.03%,497,298,40.04%
gamea.haydaygame.com,199,0.03%,390,191,51.03%
ur-pk.facebook.com,199,0.03%,376,177,52.93%
ru-ru.facebook.com,199,0.03%,390,191,51.03%
am-et.facebook.com,199,0.03%,385,186,51.69%
s1.vip.wpscdn.cn,198,0.02%,458,260,43.23%
upload.docs.google.com,198,0.02%,507,309,39.05%
www.google.com.co,198,0.02%,505,307,39.21%
www.google.com.bn,198,0.02%,500,302,39.60%
sr-rs.facebook.com,198,0.02%,379,181,52.24%
fonts.googleapis.com,197,0.02%,734,537,26.84%
bg-bg.facebook.com,197,0.02%,385,188,51.17%
cp601.prod.do.dsp.mp.microsoft.com,196,0.02%,422,226,46.45%
www.google.com.ag,196,0.02%,576,380,34.03%
tz-ma.facebook.com,196,0.02%,381,185,51.44%
ja-jp.facebook.com,196,0.02%,376,180,52.13%
ali.pull.yximgs.com,196,0.02%,429,233,45.69%
smp-device-content.apple.com,196,0.02%,619,423,31.66%
netty.yunduoketang.com,195,0.02%,423,228,46.10%
ps-af.facebook.com,195,0.02%,373,178,52.28%
ar-ar.facebook.com,195,0.02%,370,175,52.70%
com,195,0.02%,395,200,49.37%
self-events-data.trafficmanager.NET,195,0.02%,378,183,51.59%
m.youtube.com,194,0.02%,499,305,38.88%
www.google.com.bd,194,0.02%,561,367,34.58%
contacts.google.com,194,0.02%,394,200,49.24%
ff-ng.facebook.com,194,0.02%,377,183,51.46%
fi-fi.facebook.com,194,0.02%,379,185,51.19%
6qnz2sy8.sched.d2.tdnsdp1.cn,194,0.02%,368,174,52.72%
firebaseinstallations.googleapis.com,193,0.02%,444,251,43.47%
e4518.dscapi7.akamaiedge.net,192,0.02%,386,194,49.74%
www.google.co.ck,192,0.02%,555,363,34.59%
1.pool.ntp.org,192,0.02%,358,166,53.63%
miserupdate.aliyun.com,192,0.02%,429,237,44.76%
video-tx-drcn.dbankcdn.cn,192,0.02%,416,224,46.15%
2.android.pool.ntp.org,191,0.02%,377,186,50.66%
ksn-file-geo.kaspersky-labs.com,191,0.02%,448,257,42.63%
2.pool.ntp.org,191,0.02%,360,169,53.06%
3.pool.ntp.org,191,0.02%,361,170,52.91%
dl.pinyin.sogou.com,191,0.02%,416,225,45.91%
nj.cschannel.anticheatexpert.com,191,0.02%,472,281,40.47%
gw.alicdn.com,190,0.02%,429,239,44.29%
dl.google.com,190,0.02%,378,188,50.26%
tp.m-team.cc,189,0.02%,425,236,44.47%
s.cn.bing.net,189,0.02%,402,213,47.01%
ha-ng.facebook.com,189,0.02%,374,185,50.53%
pt.lax.mx,189,0.02%,270,81,70.00%
at.alicdn.com,188,0.02%,429,241,43.82%
unpkg.zhimg.com,187,0.02%,394,207,47.46%
stocks-data-service.lb-apple.com.akadns.net,187,0.02%,400,213,46.75%
finder.video.qq.com,186,0.02%,394,208,47.21%
gchat.qpic.cn,185,0.02%,428,243,43.22%
fc1tn.baidu.com,184,0.02%,413,229,44.55%
updates.cdn-apple.com,184,0.02%,403,219,45.66%
e12919.dscd.akamaiedge.net,183,0.02%,369,186,49.59%
zhihu-pics-upload.zhimg.com,181,0.02%,373,192,48.53%
m701.music.126.net,180,0.02%,408,228,44.12%
vdn.vzuu.com,180,0.02%,385,205,46.75%
cc.adingo.jp,180,0.02%,416,236,43.27%
ipv6.msftncsi.com,180,0.02%,350,170,51.43%
res.servicewechat.com,179,0.02%,380,201,47.11%
s1.cn.bing.net,179,0.02%,400,221,44.75%
img0yjvjvvuvw.cdn.cache102.xyz,179,0.02%,343,164,52.19%
public.gdtimg.com,179,0.02%,406,227,44.09%
f7.baidu.com,178,0.02%,397,219,44.84%
SIN-efz.ms-acdc.office.com,177,0.02%,441,264,40.14%
tracker.bittor.xyz,177,0.02%,376,199,47.07%
ipv6.neubt.com,176,0.02%,176,0,100.00%
www.xilinx.com,176,0.02%,318,142,55.35%
2.rhel.pool.ntp.org,176,0.02%,186,10,94.62%
p0.meituan.net,175,0.02%,384,209,45.57%
dotplayer.coldlake1.com,175,0.02%,346,171,50.58%
mdp-appconf-cn.heytapdownload.com,175,0.02%,521,346,33.59%
inz5jaqbqg.feishu.cn,174,0.02%,385,211,45.19%
adi6u4riy2.feishu.cn,172,0.02%,367,195,46.87%
ali-origin.pull.yximgs.com,171,0.02%,375,204,45.60%
image.sinajs.cn,171,0.02%,359,188,47.63%
cu010.www.duba.net,170,0.02%,366,196,46.45%
lupic.cdn.bcebos.com,169,0.02%,403,234,41.94%
ocsp.digicert.cn,169,0.02%,373,204,45.31%
mssdk-bu.bytedance.com,168,0.02%,362,194,46.41%
www.inoreader.com,168,0.02%,379,211,44.33%
all.feishu.cn.w.kunluncan.com,168,0.02%,342,174,49.12%
stats.g.doubleclick.net,167,0.02%,404,237,41.34%
alimov2.a.yximgs.com,167,0.02%,357,190,46.78%
wifi.vivo.com.cn,167,0.02%,383,216,43.60%
cstaticdun.126.net,166,0.02%,374,208,44.39%
acstatic-dun.126.net,166,0.02%,391,225,42.46%
ali2.a.yximgs.com,166,0.02%,345,179,48.12%
intellij-experiments.appspot.com,166,0.02%,360,194,46.11%
resources.jetbrains.com,165,0.02%,327,162,50.46%
public-treatment.prod-experimentation.grammarlyaws.com,165,0.02%,376,211,43.88%
api.kz.naruto.red,165,0.02%,331,166,49.85%
bt.neu6.edu.cn,165,0.02%,165,0,100.00%
tx-origin.pull.yximgs.com,165,0.02%,371,206,44.47%
time1.apple.com,165,0.02%,326,161,50.61%
dl.kkdownload.com,164,0.02%,326,162,50.31%
test.steampowered.com,164,0.02%,336,172,48.81%
appledownload.qtlcdn.com,163,0.02%,361,198,45.15%
cmshow.gtimg.cn,163,0.02%,383,220,42.56%
static.geetest.com,162,0.02%,342,180,47.37%
m801.music.126.net,162,0.02%,386,224,41.97%
api2.gettoby.com,162,0.02%,359,197,45.13%
broker.mina.mi.com,162,0.02%,371,209,43.67%
log-api.pangolin-sdk-toutiao-b.com,162,0.02%,389,227,41.65%
mini.360.cn,161,0.02%,377,216,42.71%
upos-sz-mirrorhw.bilivideo.com,160,0.02%,387,227,41.34%
smarthome-drcn.dbankcdn.com,160,0.02%,377,217,42.44%
a1887.dscq.akamai.net,160,0.02%,332,172,48.19%
l5.gslb.ksyuncdn.com,160,0.02%,320,160,50.00%
static.yximgs.com,160,0.02%,343,183,46.65%
sqimg.qq.com,159,0.02%,337,178,47.18%
ws-keyboard.shouji.sogou.com,159,0.02%,377,218,42.18%
aeu.alicdn.com,159,0.02%,346,187,45.95%
monorepo-production-edge-alb-985829473.us-east-1.elb.amazonaws.com,158,0.02%,320,162,49.38%
s.url.cn,158,0.02%,340,182,46.47%
3.rhel.pool.ntp.org,158,0.02%,159,1,99.37%
ks-adaptive.pull.yximgs.com,158,0.02%,347,189,45.53%
lf3-cdn-tos.bytegoofy.com,158,0.02%,352,194,44.89%
www.download.windowsupdate.com,157,0.02%,336,179,46.73%
tx-game.pull.yximgs.com,157,0.02%,351,194,44.73%
bd-proxy.pull.yximgs.com,157,0.02%,349,192,44.99%
internal-api-lark-api.feishu.cn.w.cdngslb.com,156,0.02%,325,169,48.00%
apps.mzstatic.com,155,0.02%,343,188,45.19%
ks-origin.pull.yximgs.com,155,0.02%,346,191,44.80%
ws-adaptive.pull.yximgs.com,155,0.02%,344,189,45.06%
dss2.bdstatic.com,154,0.02%,354,200,43.50%
cm.g.doubleclick.net,154,0.02%,369,215,41.73%
v1-hwllqv.onewsvod.com,154,0.02%,319,165,48.28%
ws-origin.pull.yximgs.com,154,0.02%,342,188,45.03%
userlink.alicdn.com,154,0.02%,361,207,42.66%
qzonestyle.gtimg.cn,153,0.02%,344,191,44.48%
h5hosting.dbankcdn.com,153,0.02%,332,179,46.08%
bd-origin.pull.yximgs.com,153,0.02%,339,186,45.13%
wxsnsdythumb.wxs.qq.com,153,0.02%,331,178,46.22%
repo.zotero.org,153,0.02%,361,208,42.38%
gfwsl.geforce.cn,153,0.02%,208,55,73.56%
tx-proxy.pull.yximgs.com,153,0.02%,344,191,44.48%
store.steampowered.com,153,0.02%,301,148,50.83%
crl.certum.pl,152,0.02%,315,163,48.25%
clients.l.google.com,151,0.02%,323,172,46.75%
img.qwps.cn,151,0.02%,315,164,47.94%
deff.nelreports.net,150,0.02%,365,215,41.10%
cl3.apple.com,150,0.02%,325,175,46.15%
bd-adaptive.pull.yximgs.com,150,0.02%,345,195,43.48%
ali-adaptive.pull.yximgs.com,150,0.02%,331,181,45.32%
se.360.cn,149,0.02%,343,194,43.44%
ali-proxy.pull.yximgs.com,149,0.02%,339,190,43.95%
HND-efz.ms-acdc.office.com,149,0.02%,348,199,42.82%
t2.xiaohongshu.com,148,0.02%,353,205,41.93%
tx-adaptive.pull.yximgs.com,148,0.02%,341,193,43.40%
img1.pcfg.cache.wpscdn.cn,147,0.02%,338,191,43.49%
cu004.www.duba.net,147,0.02%,273,126,53.85%
vdn6-1.vzuu.com,147,0.02%,302,155,48.68%
e15275.g.akamaiedge.net,147,0.02%,304,157,48.36%
hudong.alicdn.com,146,0.02%,317,171,46.06%
ks-proxy.pull.yximgs.com,146,0.02%,330,184,44.24%
uz95.v.trpcdn.net,146,0.02%,322,176,45.34%
login.live.com,145,0.02%,11325,11180,1.28%
cp801.prod.do.dsp.mp.microsoft.com,145,0.02%,309,164,46.93%
ali2.a.kwimgs.com,145,0.02%,296,151,48.99%
e15275.g.akamaiedge.NET,145,0.02%,282,137,51.42%
x1.c.lencr.org,144,0.02%,8890,8746,1.62%
16.au.download.windowsupdate.com,144,0.02%,308,164,46.75%
ip.42.pl,144,0.02%,6781,6637,2.12%
m.ykimg.com,144,0.02%,310,166,46.45%
vdn5-1.vzuu.com,144,0.02%,288,144,50.00%
vdn5.vzuu.com,144,0.02%,293,149,49.15%
cm-cn-central-00001.albatross.10086.cn,144,0.02%,324,180,44.44%
p1.meituan.net,143,0.02%,344,201,41.57%
0.asia.pool.ntp.org,143,0.02%,266,123,53.76%
desktop.docker.com,142,0.02%,286,144,49.65%
3.asia.pool.ntp.org,141,0.02%,257,116,54.86%
datarouter-weighted.ol.epicgames.com,141,0.02%,286,145,49.30%
1.rhel.pool.ntp.org,140,0.02%,142,2,98.59%
stocks-sparkline-lb.apple.com.akadns.net,140,0.02%,292,152,47.95%
scrootca2.ocsp.secomtrust.net,139,0.02%,288,149,48.26%
ali.static.yximgs.com,139,0.02%,302,163,46.03%
0.rhel.pool.ntp.org,138,0.02%,140,2,98.57%
v9-hwllqv.onewsvod.com,138,0.02%,298,160,46.31%
init.ess.apple.com,137,0.02%,277,140,49.46%
f.c2r.ts.cdn.office.net,137,0.02%,288,151,47.57%
play-fe.googleapis.com,137,0.02%,334,197,41.02%
v2.kwaicdn.com,137,0.02%,290,153,47.24%
s3.amazonaws.com,136,0.02%,277,141,49.10%
contentcenter-drcn.dbankcdn.com,136,0.02%,295,159,46.10%
ssl-google-analytics.l.google.com,136,0.02%,301,165,45.18%
ms.bdimg.com,135,0.02%,323,188,41.80%
puui.qpic.cn,135,0.02%,298,163,45.30%
www.iqiyi.com,135,0.02%,334,199,40.42%
p2.a.yximgs.com,135,0.02%,289,154,46.71%
www.wodaywo100001.com,134,0.02%,3968,3834,3.38%
library-service.live.use1a.on.epicgames.com,134,0.02%,289,155,46.37%
frontier-im.douyin.com.w.cdngslb.com,134,0.02%,303,169,44.22%
js2.a.kwimgs.com,134,0.02%,272,138,49.26%
tx-ad.a.yximgs.com,133,0.02%,287,154,46.34%
browser.360.cn.qh-cdn.com,132,0.02%,289,157,45.67%
tx2.a.yximgs.com,132,0.02%,276,144,47.83%
k128-inapp.gslb.ksyuncdn.com,131,0.02%,301,170,43.52%
appdl6-drcn.dbankcdn.cn,131,0.02%,289,158,45.33%
api3-eeft-gateway-lf.feishu.cn,131,0.02%,268,137,48.88%
d2.a.kwimgs.com,131,0.02%,266,135,49.25%
tx2.a.kwimgs.com,131,0.02%,275,144,47.64%
disc501.prod.do.dsp.mp.microsoft.com,131,0.02%,358,227,36.59%
atm-settingsfe-prod-geo2.trafficmanager.net,130,0.02%,1397,1267,9.31%
txmov6.a.kwimgs.com,130,0.02%,272,142,47.79%
search-operate.cdn.bcebos.com,129,0.02%,303,174,42.57%
p4.a.yximgs.com,129,0.02%,289,160,44.64%
2076077.sched.d0.tdnsdp1.cn,129,0.02%,194,65,66.49%
d1-ks.a.kwimgs.com,129,0.02%,273,144,47.25%
a1992.dscd.akamai.net,129,0.02%,262,133,49.24%
ocsp.rootg2.amazontrust.com,128,0.02%,270,142,47.41%
googlehosted.l.googleusercontent.com,128,0.02%,291,163,43.99%
p1k05ba99n.feishu.cn,128,0.02%,278,150,46.04%
d2-ks.a.kwimgs.com,128,0.02%,264,136,48.48%
p4.music.126.net,127,0.02%,293,166,43.34%
agsupdate.adobe.com,127,0.02%,263,136,48.29%
api3-eeft-imfile-lf.feishu.cn,127,0.02%,253,126,50.20%
ks.push.yximgs.com,127,0.02%,265,138,47.92%
d1.a.kwimgs.com,127,0.02%,260,133,48.85%
d2-yoda.a.kwimgs.com,127,0.02%,258,131,49.22%
d3-ec.a.kwimgs.com,127,0.02%,258,131,49.22%
sf3-cdn-tos.douyinstatic.com,127,0.02%,295,168,43.05%
clients2.google.com,126,0.02%,6106,5980,2.06%
pancake.cdn-apple.com.akadns.net,126,0.02%,277,151,45.49%
cma.itunes.apple.com,126,0.02%,297,171,42.42%
ali-ad.a.yximgs.com,126,0.02%,280,154,45.00%
d1-reco.a.kwimgs.com,126,0.02%,260,134,48.46%
p2-live.a.yximgs.com,126,0.02%,268,142,47.01%
cdn-ali-file-shc.shanhutech.cn,125,0.02%,252,127,49.60%
txdwkmov.a.kwimgs.com,125,0.02%,264,139,47.35%
d1-yoda.a.kwimgs.com,125,0.02%,254,129,49.21%
fundingchoicesmessages.google.com,124,0.02%,309,185,40.13%
download.zotero.org,124,0.02%,266,142,46.62%
appdl-drcn.dbankcdn.com,124,0.02%,271,147,45.76%
d0.baidupcs.com,124,0.02%,253,129,49.01%
eqdwjv3myb.feishu.cn,124,0.02%,199,75,62.31%
tx6.a.kwimgs.com,124,0.02%,259,135,47.88%
d3-yoda.a.kwimgs.com,124,0.02%,253,129,49.01%
tam.cdn-go.cn,124,0.02%,203,79,61.08%
d3-magic.static.yximgs.com,123,0.02%,266,143,46.24%
d3-reco.a.kwimgs.com,123,0.02%,252,129,48.81%
alimov6.a.yximgs.com,123,0.02%,270,147,45.56%
d2-push.static.yximgs.com,123,0.02%,260,137,47.31%
public-cdn.cloud.unitychina.cn,122,0.02%,263,141,46.39%
ux70.v.trpcdn.NET,122,0.02%,286,164,42.66%
internal-api.feishu.cn,122,0.02%,264,142,46.21%
opencdnqiniustaticv6.jomodns.com,122,0.02%,249,127,49.00%
v4-vod.kwaicdn.com,122,0.02%,263,141,46.39%
tx.static.yximgs.com,122,0.02%,269,147,45.35%
static.inkuai.com,122,0.02%,264,142,46.21%
d4-magic.a.kwimgs.com,122,0.02%,249,127,49.00%
d2-reco.a.kwimgs.com,122,0.02%,254,132,48.03%
img-blog.csdn.net,121,0.02%,268,147,45.15%
img.infinitynewtab.com,121,0.02%,280,159,43.21%
self-events-data.trafficmanager.net,121,0.02%,923,802,13.11%
baikebcs.bdimg.com,121,0.02%,289,168,41.87%
img30.360buyimg.com,121,0.02%,257,136,47.08%
v1.oskwai.com,121,0.02%,269,148,44.98%
yximgs-webrtc.liveplay.myqcloud.com,121,0.02%,255,134,47.45%
d5-ks.a.kwimgs.com,121,0.02%,257,136,47.08%
m7.music.126.net,120,0.02%,278,158,43.17%
instantmessaging-pa.googleapis.com,120,0.02%,291,171,41.24%
apidata.googleusercontent.com,120,0.02%,259,139,46.33%
ali2-course.video.yximgs.com,120,0.02%,261,141,45.98%
alicmvod.a.etoote.com,120,0.02%,256,136,46.88%
ws-p2p.pull.yximgs.com,120,0.02%,260,140,46.15%
d1-push.static.yximgs.com,120,0.02%,257,137,46.69%
v2.oskwai.com,120,0.02%,264,144,45.45%
txmov6.a.yximgs.com,120,0.02%,265,145,45.28%
d1-magic.static.yximgs.com,120,0.02%,259,139,46.33%
lf3-static.bytednsdoc.com,120,0.02%,265,145,45.28%
conf.f.qh-lb.com,120,0.02%,243,123,49.38%
s3plus.meituan.net,119,0.02%,268,149,44.40%
aladin.wxqcloud.qq.com,119,0.02%,261,142,45.59%
dbe610da.feishu.cn.dsa.dnsv1.com,119,0.02%,185,66,64.32%
p5.a.yximgs.com,119,0.02%,267,148,44.57%
d2-magic.static.yximgs.com,119,0.02%,262,143,45.42%
txcmvod.a.etoote.com,119,0.02%,254,135,46.85%
d3-ks.a.kwimgs.com,119,0.02%,251,132,47.41%
ks-p2p.pull.yximgs.com,119,0.02%,259,140,45.95%
v5.kwaicdn.com,119,0.02%,262,143,45.42%
www.emerald.com,118,0.01%,226,108,52.21%
vod-all.qiniu.com.volcgslb.com,118,0.01%,148,30,79.73%
dlassets-ssl.xboxlive.com,118,0.01%,243,125,48.56%
crl.apple.com,118,0.01%,252,134,46.83%
txdwk.a.yximgs.com,118,0.01%,259,141,45.56%
v3.kwaicdn.com,118,0.01%,260,142,45.38%
v1-vod.kwaicdn.com,118,0.01%,255,137,46.27%
internal-api-lark-api.feishu.cn.dsa.dnsv1.com.cn,118,0.01%,181,63,65.19%
helpx.adobe.com,117,0.01%,255,138,45.88%
uz95.v.trpcdn.NET,117,0.01%,251,134,46.61%
xp.itunes-apple.com.akadns.net,117,0.01%,265,148,44.15%
appoptimize-drcn.dbankcdn.cn,117,0.01%,263,146,44.49%
console.cloud.google.com,117,0.01%,260,143,45.00%
txdwkmov.a.yximgs.com,117,0.01%,258,141,45.35%
d3-kkd.a.kspkg.com,117,0.01%,253,136,46.25%
p5-live.a.yximgs.com,117,0.01%,260,143,45.00%
aliqcmmov.a.etoote.com,117,0.01%,257,140,45.53%
p3.eckwai.com,117,0.01%,249,132,46.99%
d2-kkd.a.kspkg.com,117,0.01%,254,137,46.06%
fc-ccimage.baidu.com,116,0.01%,268,152,43.28%
s1.url.cn,116,0.01%,259,143,44.79%
rc10-g4.oray.com,116,0.01%,255,139,45.49%
acs.youku.com,116,0.01%,271,155,42.80%
e6913.dscx.akamaiedge.net,116,0.01%,241,125,48.13%
conn1.oppomobile.com,116,0.01%,252,136,46.03%
mqtt-internal-public.zhihu.com,116,0.01%,249,133,46.59%
apd-vodp2plogin.teg.tencent-cloud.net,116,0.01%,297,181,39.06%
api.twitter.com,116,0.01%,389,273,29.82%
p2.adkwai.com,116,0.01%,259,143,44.79%
v2-mg07.kwaicdn.com,116,0.01%,248,132,46.77%
ali-p2p.pull.yximgs.com,116,0.01%,249,133,46.59%
p1-live.a.yximgs.com,116,0.01%,255,139,45.49%
v5-skvod.kwaicdn.com,116,0.01%,251,135,46.22%
txmov2.a.yximgs.com,116,0.01%,251,135,46.22%
jscm.a.etoote.com,116,0.01%,254,138,45.67%
js.a.kspkg.com,116,0.01%,249,133,46.59%
3gimg.qq.com,115,0.01%,238,123,48.32%
p2.eckwai.com,115,0.01%,252,137,45.63%
v4.oskwai.com,115,0.01%,259,144,44.40%
alicmmov.a.etoote.com,115,0.01%,254,139,45.28%
p3.adkwai.com,115,0.01%,248,133,46.37%
d4-ks.a.kwimgs.com,115,0.01%,239,124,48.12%
hw-p2p.pull.yximgs.com,115,0.01%,249,134,46.18%
d2-ec.a.kwimgs.com,115,0.01%,241,126,47.72%
d3-push.static.yximgs.com,115,0.01%,250,135,46.00%
v2-vod.kwaicdn.com,115,0.01%,248,133,46.37%
e19240.ca.s.tl88.NET,114,0.01%,221,107,51.58%
www.vod.lxdns.com,114,0.01%,254,140,44.88%
p9.qhimg.com,114,0.01%,288,174,39.58%
fa000000005.resources.office.net,114,0.01%,235,121,48.51%
su.itunes.apple.com,114,0.01%,262,148,43.51%
bt1.archive.org,114,0.01%,418,304,27.27%
play-lh.googleusercontent.com,114,0.01%,286,172,39.86%
txqcmmov.a.etoote.com,114,0.01%,254,140,44.88%
v1.douyinvod.com,113,0.01%,251,138,45.02%
pic.cnblogs.com,113,0.01%,254,141,44.49%
dellupdater.dell.com,113,0.01%,244,131,46.31%
hw-adaptive.pull.yximgs.com,113,0.01%,250,137,45.20%
txdwkvod.a.etoote.com,113,0.01%,245,132,46.12%
ali.push.yximgs.com,113,0.01%,249,136,45.38%
appdl-2-drcn.dbankcdn.com,112,0.01%,246,134,45.53%
v26-cold.douyinvod.com,112,0.01%,259,147,43.24%
d3.a.kwimgs.com,112,0.01%,241,129,46.47%
s2-10958.kwimgs.com,112,0.01%,243,131,46.09%
p1.a.yximgs.com,112,0.01%,249,137,44.98%
v3.oskwai.com,112,0.01%,268,156,41.79%
hw-origin.pull.yximgs.com,112,0.01%,251,139,44.62%
p3-live.a.yximgs.com,112,0.01%,252,140,44.44%
bd.push.yximgs.com,112,0.01%,241,129,46.47%
d1-ec.a.kwimgs.com,112,0.01%,240,128,46.67%
qcloud.dpfile.com,111,0.01%,247,136,44.94%
p3.toutiaoimg.com,111,0.01%,241,130,46.06%
v1-dwkvod.kwaicdn.com,111,0.01%,242,131,45.87%
txcmmov.a.etoote.com,111,0.01%,248,137,44.76%
p1.eckwai.com,111,0.01%,242,131,45.87%
tracker.pussytorrents.org,110,0.01%,332,222,33.13%
global.asimov.events.data.trafficmanager.net,110,0.01%,1446,1336,7.61%
wxa.wxs.qq.com,110,0.01%,224,114,49.11%
jsqcmmov.a.etoote.com,110,0.01%,256,146,42.97%
b1.nel.goog,110,0.01%,251,141,43.82%
jsmov2.a.yximgs.com,110,0.01%,245,135,44.90%
bd-p2p.pull.yximgs.com,110,0.01%,237,127,46.41%
sf3-cdn-tos.toutiaostatic.com,110,0.01%,238,128,46.22%
p4-live.a.yximgs.com,109,0.01%,250,141,43.60%
bt2.archive.org,109,0.01%,396,287,27.53%
lf3-config.bytetcc.com,109,0.01%,237,128,45.99%
v3-vod.kwaicdn.com,109,0.01%,237,128,45.99%
tx-p2p.pull.yximgs.com,109,0.01%,237,128,45.99%
p1.adkwai.com,109,0.01%,244,135,44.67%
mobile-gtalk.l.google.com,109,0.01%,277,168,39.35%
dev,108,0.01%,108,0,100.00%
fanyi-cdn.cdn.bcebos.com,108,0.01%,239,131,45.19%
msfwifi.3g.qq.com,108,0.01%,258,150,41.86%
storage.360buyimg.com,108,0.01%,227,119,47.58%
sf6-cdn-tos.toutiaostatic.com,108,0.01%,239,131,45.19%
appdl-3-drcn.dbankcdn.com,107,0.01%,245,138,43.67%
setup.fe.apple-dns.net,107,0.01%,245,138,43.67%
d1-kkd.a.kspkg.com,107,0.01%,234,127,45.73%
cdn2.ime.sogou.com,106,0.01%,226,120,46.90%
sz-qiniu-all.volcgtm.com,106,0.01%,218,112,48.62%
gspe79-cn-ssl.ls.apple.com,106,0.01%,223,117,47.53%
api.islide.cc,106,0.01%,162,56,65.43%
uci.edog.cdn.office.net,105,0.01%,223,118,47.09%
ipcdn.apple.com,105,0.01%,255,150,41.18%
ocsp-lb.apple.com.akadns.net,105,0.01%,236,131,44.49%
v4.kwaicdn.com,105,0.01%,245,140,42.86%
www.news.cn,105,0.01%,238,133,44.12%
outlook.office365.com,104,0.01%,3350,3246,3.10%
cp501.prod.do.dsp.mp.microsoft.com,104,0.01%,370,266,28.11%
subca.crl.certum.pl,104,0.01%,212,108,49.06%
s2.cn.bing.net,104,0.01%,228,124,45.61%
entitlement-public-service-prod.ak.epicgames.com,104,0.01%,210,106,49.52%
cdn1.ime.sogou.com,104,0.01%,236,132,44.07%
d4-ec.a.kwimgs.com,104,0.01%,232,128,44.83%
lf3-cdn-tos.bytescm.com,104,0.01%,235,131,44.26%
addons-pa.clients6.google.com,104,0.01%,228,124,45.61%
fa000000043.resources.office.net,103,0.01%,215,112,47.91%
imgconvert.csdnimg.cn,103,0.01%,225,122,45.78%
conn2.oppomobile.com,103,0.01%,223,120,46.19%
lf3-short.bytegoofy.com,103,0.01%,238,135,43.28%
tx-game.push.yximgs.com,102,0.01%,251,149,40.64%
lf-cdn-tos.bytescm.com,102,0.01%,215,113,47.44%
cdn.exp.xiaomi.com,101,0.01%,230,129,43.91%
internal-api-space.feishu.cn,101,0.01%,218,117,46.33%
downloads.upd.kaspersky.com,101,0.01%,210,109,48.10%
img11.360buyimg.com,101,0.01%,227,126,44.49%
valipl10.cp31.ott.cibntv.net,100,0.01%,222,122,45.05%
t8.dropbox.com,100,0.01%,199,99,50.25%
wwc.alicdn.com,100,0.01%,212,112,47.17%
v26.douyinvod.com,100,0.01%,217,117,46.08%
iduy64c.qiniudns.com,99,0.01%,130,31,76.15%
api.amemv.com,99,0.01%,232,133,42.67%
graph.facebook.com,99,0.01%,241,142,41.08%
crl.pki.goog,99,0.01%,206,107,48.06%
tracker.bitsearch.to,99,0.01%,296,197,33.45%
a5.behance.net,99,0.01%,204,105,48.53%
cdn2.jianshu.io,98,0.01%,234,136,41.88%
y.gtimg.cn.tc.qq.com,98,0.01%,141,43,69.50%
tracker1.myporn.club,98,0.01%,286,188,34.27%
go.microsoft.com.edgekey.net,98,0.01%,211,113,46.45%
static.dataservices.hp.com,97,0.01%,202,105,48.02%
down.qq.com,97,0.01%,262,165,37.02%
ieeexplore.ieee.org,97,0.01%,227,130,42.73%
aop-pic-drcn.dbankcdn.com,97,0.01%,209,112,46.41%
pki-goog.l.google.com,97,0.01%,238,141,40.76%
aliimg.a.yximgs.com,97,0.01%,201,104,48.26%
translate.googleapis.com,97,0.01%,254,157,38.19%
mcs.zijieapi.com,96,0.01%,209,113,45.93%
fanyiapp.cdn.bcebos.com,96,0.01%,213,117,45.07%
tj.wifi.liebao.cn,96,0.01%,205,109,46.83%
ca.iadsdk.apple.com,96,0.01%,219,123,43.84%
mesu-cdn.apple.com.akadns.net,96,0.01%,211,115,45.50%
zinwdptedg.feishu.cn,96,0.01%,209,113,45.93%
cipv6gn.v.trpcdn.net,96,0.01%,220,124,43.64%
datacenter.eastmoney.com,96,0.01%,211,115,45.50%
api.dropbox.com,96,0.01%,219,123,43.84%
sf1-cdn-tos.toutiaostatic.com,96,0.01%,220,124,43.64%
qzs.gdtimg.com,95,0.01%,219,124,43.38%
g4.ykimg.com,95,0.01%,203,108,46.80%
mqtt.zhihu.com,95,0.01%,231,136,41.13%
down4.7654.com,95,0.01%,183,88,51.91%
us.sinaimg.cn.w.alikunlun.net,95,0.01%,202,107,47.03%
vconf.f.qh-lb.com,95,0.01%,199,104,47.74%
login.msa.msidentity.com,94,0.01%,341,247,27.57%
g2.ykimg.com,94,0.01%,202,108,46.53%
g1.ykimg.com,94,0.01%,202,108,46.53%
acm-prod.disqus.com,94,0.01%,202,108,46.53%
update-windows.grammarly.com,94,0.01%,193,99,48.70%
p06-caldav.icloud.com,94,0.01%,183,89,51.37%
dl1.gj.qq.com,94,0.01%,173,79,54.34%
tx.push.yximgs.com,94,0.01%,237,143,39.66%
www-www.bing.com.trafficmanager.NET,94,0.01%,171,77,54.97%
dl.pop.www.duba.net,93,0.01%,174,81,53.45%
images.cnblogs.com,93,0.01%,201,108,46.27%
pc-plugin-plg-wpscdn-cn-idvh11c.qiniudns.com,93,0.01%,133,40,69.92%
s0.meituan.net,92,0.01%,202,110,45.54%
static.youku.com,92,0.01%,198,106,46.46%
img13.360buyimg.com,92,0.01%,193,101,47.67%
j1hqc7ee.sched.d0-dk.tdnsdp1.cn,92,0.01%,200,108,46.00%
mbdp01.bdstatic.com,92,0.01%,211,119,43.60%
tsearch.snssdk.com,91,0.01%,200,109,45.50%
ux70.v.trpcdn.net,91,0.01%,226,135,40.27%
e6987.a.akamaiedge.net,91,0.01%,189,98,48.15%
hcdnd101.gslb.c.cdnhwc2.com,91,0.01%,193,102,47.15%
baidubox-emoji.cdn.bcebos.com,91,0.01%,192,101,47.40%
live.primis.tech,91,0.01%,200,109,45.50%
tnc3-bjlgy.zijieapi.com,90,0.01%,193,103,46.63%
upload.jianshu.io,90,0.01%,215,125,41.86%
dl.360safe.com.qh-cdn.com,90,0.01%,195,105,46.15%
ocsp.apple.com.download.ks-cdn.com,89,0.01%,190,101,46.84%
gspe79-ssl.ls.apple.com,89,0.01%,199,110,44.72%
1min.pcfg.cache.wpscdn.cn.qiniudns.com,89,0.01%,128,39,69.53%
dl.360safe.com.dl.360qhcdn.com,89,0.01%,191,102,46.60%
e8652.dscx.akamaiedge.NET,89,0.01%,184,95,48.37%
cdn.ark.qq.com,88,0.01%,183,95,48.09%
wework.qpic.cn,88,0.01%,199,111,44.22%
1.debian.pool.ntp.org,88,0.01%,153,65,57.52%
s4.cn.bing.net,88,0.01%,200,112,44.00%
detectportal.prod.mozaws.net,88,0.01%,16949,16861,0.52%
dm.video.weibocdn.com,88,0.01%,206,118,42.72%
kq438fobs8.feishu.cn,88,0.01%,146,58,60.27%
normandy-cdn.services.mozilla.com,87,0.01%,193,106,45.08%
pub.idqqimg.com.sched.legopic1.tdnsv6.com,87,0.01%,172,85,50.58%
login.feishu.cn,87,0.01%,191,104,45.55%
cds.apple.com,87,0.01%,190,103,45.79%
browser.360.cn.download.ks-cdn.com,87,0.01%,180,93,48.33%
img12.360buyimg.com,87,0.01%,199,112,43.72%
res.wx.qq.com.sched.legopic1.tdnsv6.com,87,0.01%,189,102,46.03%
account-public-service-prod.ak.epicgames.com,87,0.01%,181,94,48.07%
0.debian.pool.ntp.org,86,0.01%,152,66,56.58%
bt.okmp3.ru,86,0.01%,1003,917,8.57%
api.feelgood.cn,86,0.01%,179,93,48.04%
download.mozilla.org,86,0.01%,163,77,52.76%
client-api.itunes.apple.com,86,0.01%,198,112,43.43%
appdl-11-drcn.dbankcdn.com,86,0.01%,190,104,45.26%
linux.teamviewer.com,86,0.01%,157,71,54.78%
www.tm.a.prd.aadg.trafficmanager.net,86,0.01%,189,103,45.50%
v3-ot01.kwaicdn.com,86,0.01%,259,173,33.20%
pd.itunes.apple.com,86,0.01%,203,117,42.36%
cdn.icloud-content.com,85,0.01%,167,82,50.90%
g3.ykimg.com,85,0.01%,187,102,45.45%
img-all.qiniu.com.volcgslb.com,85,0.01%,109,24,77.98%
cdn.weather.hao.360.cn,85,0.01%,183,98,46.45%
crl.microsoft.com,85,0.01%,158,73,53.80%
vcardsdkservice.vivo.com.cn,85,0.01%,636,551,13.36%
img10.360buyimg.com,85,0.01%,185,100,45.95%
img14.360buyimg.com,85,0.01%,194,109,43.81%
v6.kwaicdn.com,85,0.01%,245,160,34.69%
verify.snssdk.com,85,0.01%,196,111,43.37%
lf3-cdn2-tos.bytescm.com,85,0.01%,196,111,43.37%
p3.music.126.net,84,0.01%,251,167,33.47%
mixv4-2.194610.xyz,84,0.01%,308,224,27.27%
dotbeats.douyucdn.cn,84,0.01%,178,94,47.19%
android.l.google.com,84,0.01%,181,97,46.41%
wu-bg-shim.trafficmanager.NET,84,0.01%,326,242,25.77%
versioncheck-bg.addons.mozilla.org,84,0.01%,121,37,69.42%
msnzlxxglobal.v.lxcvc.com,84,0.01%,181,97,46.41%
vscode-sync.trafficmanager.net,83,0.01%,3099,3016,2.68%
cd.huoying666.com,83,0.01%,162,79,51.23%
dm.toutiao.com,83,0.01%,173,90,47.98%
mvgforumtracker.mvgroup.org,83,0.01%,3303,3220,2.51%
clientlog.wanmei.com,83,0.01%,194,111,42.78%
www.webofknowledge.com,83,0.01%,181,98,45.86%
mt.lenovo.com.cn,83,0.01%,184,101,45.11%
images2015.cnblogs.com,83,0.01%,181,98,45.86%
r1.ykimg.com,83,0.01%,180,97,46.11%
16.tlu.dl.delivery.mp.microsoft.com,83,0.01%,179,96,46.37%
dl-debug.dropbox.com,83,0.01%,181,98,45.86%
grs.platform.dbankcloud.ru,83,0.01%,169,86,49.11%
googleads4.g.doubleclick.net,83,0.01%,181,98,45.86%
wl.jd.com,83,0.01%,184,101,45.11%
e19240.ca.s.tl88.net,83,0.01%,190,107,43.68%
vcs.snssdk.com,83,0.01%,179,96,46.37%
css.ykimg.com,82,0.01%,186,104,44.09%
opencdnbd.jomodns.com,82,0.01%,195,113,42.05%
download-installer.cdn.mozilla.net,82,0.01%,165,83,49.70%
gmscompliance-pa.googleapis.com,82,0.01%,189,107,43.39%
hw.zuimeitianqi.com,82,0.01%,185,103,44.32%
www.apple.com.edgekey.net.globalredir.akadns.net,82,0.01%,177,95,46.33%
dcldshlupt.alicdn.com.danuoyi.tbcache.com,82,0.01%,159,77,51.57%
xxbg.snssdk.com,82,0.01%,185,103,44.32%
gspe35-ssl.ls.apple.com.w.alikunlun.com,82,0.01%,169,87,48.52%
vthumb.ykimg.com,81,0.01%,181,100,44.75%
download.jetbrains.com.cn,81,0.01%,208,127,38.94%
init-p01st.push.apple.com,81,0.01%,162,81,50.00%
init-p01md.apple.com,81,0.01%,187,106,43.32%
pics0.baidu.com,81,0.01%,176,95,46.02%
config.edge.skype.com.trafficmanager.NET,81,0.01%,175,94,46.29%
sjy6.stream.qqmusic.qq.com.vdncache.com,81,0.01%,138,57,58.70%
k256.gslb.ksyuncdn.com,81,0.01%,164,83,49.39%
jtypkz2w.sched.d2.tdnsdp1.cn.cjt.vwnti.yrzhcloud.cn,81,0.01%,165,84,49.09%
lf3-csp.bytetos.com,81,0.01%,189,108,42.86%
gss0.bdstatic.com,80,0.01%,179,99,44.69%
p4.music.126.net.163jiasu.com,80,0.01%,177,97,45.20%
www.a.shifen.com,80,0.01%,1506,1426,5.31%
app.axure.cloud,80,0.01%,150,70,53.33%
js.ykimg.com,80,0.01%,176,96,45.45%
uci.cdn.office.net,80,0.01%,170,90,47.06%
download.microsoft.com,80,0.01%,149,69,53.69%
lz4hlmtcf5.feishu.cn,80,0.01%,173,93,46.24%
adl.windows.com,80,0.01%,151,71,52.98%
e28578.d.akamaiedge.net,80,0.01%,162,82,49.38%
vscode-sync-ase-01.azurewebsites.NET,80,0.01%,151,71,52.98%
x.research.qq.com,79,0.01%,44705,44626,0.18%
assets.msn.cn,79,0.01%,5583,5504,1.42%
prod.fus.aws.intellij.net,79,0.01%,164,85,48.17%
upload-cdn.orayimg.com,79,0.01%,169,90,46.75%
e11408.d.akamaiedge.net,79,0.01%,161,82,49.07%
cipv6gn.v.trpcdn.NET,79,0.01%,170,91,46.47%
jkbxcx-static.yqgz.beijing.gov.cn,79,0.01%,172,93,45.93%
opencdnglobalv6.jomodns.com,79,0.01%,160,81,49.38%
cdn.wwads.cn,79,0.01%,206,127,38.35%
d20wxjqjgi3st.cloudfront.net,79,0.01%,175,96,45.14%
bd2.a.kwimgs.com,79,0.01%,155,76,50.97%
izn4cyqeu8.feishu.cn,79,0.01%,133,54,59.40%
mmbiz.qpic.cn.sched.legopic1.tdnsv6.com,78,0.01%,174,96,44.83%
api.flash.cn,78,0.01%,177,99,44.07%
tongji.flash.cn,78,0.01%,182,104,42.86%
upload-images.jianshu.io,78,0.01%,183,105,42.62%
dynamic.t0.tiles.ditu.live.com,78,0.01%,178,100,43.82%
emdl.ws.microsoft.com,78,0.01%,181,103,43.09%
nv00.cdn.bcebos.com,78,0.01%,174,96,44.83%
luckyvideo.peopletech.cn,78,0.01%,180,102,43.33%
ww1.sinaimg.cn.w.alikunlun.com,78,0.01%,172,94,45.35%
qt010.china.line.qiniudns.com,78,0.01%,172,94,45.35%
lf3-beecdn.bytetos.com,78,0.01%,185,107,42.16%
settings-ssl.xboxlive.com,77,0.01%,166,89,46.39%
v11.douyinvod.com,77,0.01%,173,96,44.51%
www.yisu.com,77,0.01%,177,100,43.50%
adx-static.ksosoft.com,77,0.01%,176,99,43.75%
certs.apple.com,77,0.01%,175,98,44.00%
appdl-12-drcn.dbankcdn.com,77,0.01%,166,89,46.39%
captcha.gtimg.com,77,0.01%,157,80,49.04%
www.zhihu.com.dsa.dnsv1.com,77,0.01%,157,80,49.04%
arc.trafficmanager.NET,77,0.01%,142,65,54.23%
lf1-cdn-tos.bytegoofy.com,76,0.01%,167,91,45.51%
main.appstore.vivo.com.cn,76,0.01%,164,88,46.34%
cmmsns.qpic.cn,76,0.01%,166,90,45.78%
partiality.itunes.apple.com,76,0.01%,171,95,44.44%
s0.2mdn.net,76,0.01%,162,86,46.91%
sslbaiduv6.jomodns.com,76,0.01%,172,96,44.19%
remotedesktop-pa.googleapis.com,76,0.01%,176,100,43.18%
cs02-pps-drcn.dbankcdn.com,76,0.01%,155,79,49.03%
e589fa51.zhihu.com.dsa.dnsv1.com,76,0.01%,157,81,48.41%
main.gamecenter.vivo.com.cn,76,0.01%,156,80,48.72%
dotserver.douyucdn.cn,75,0.01%,174,99,43.10%
web.sdk.qcloud.com,75,0.01%,167,92,44.91%
downloaddispatch.itunes.apple.com,75,0.01%,170,95,44.12%
k1-ipv6.gslb.ksyuncdn.com,75,0.01%,159,84,47.17%
dscache.tencent-cloud.cn,74,0.01%,165,91,44.85%
emres.dfcfw.com,74,0.01%,164,90,45.12%
tce.alicdn.com,74,0.01%,156,82,47.44%
pull-flv-l3-enc.douyincdn.com.w.alikunlun.net,74,0.01%,153,79,48.37%
lf.snssdk.com,74,0.01%,156,82,47.44%
officecdn.microsoft.com,74,0.01%,157,83,47.13%
sz-ucloud-ipv4.ucloudnaming.info,74,0.01%,155,81,47.74%
v3-ot02.kwaicdn.com,74,0.01%,260,186,28.46%
v9.douyinvod.com,74,0.01%,150,76,49.33%
helpdesk.bytedance.com,74,0.01%,171,97,43.27%
steampipe.akamaized.net,73,0.01%,155,82,47.10%
journal.hep.com.cn,73,0.01%,169,96,43.20%
config.i.duba.net.w.kunlunar.com,73,0.01%,145,72,50.34%
ns2.parkingcrew.net,73,0.01%,17323,17250,0.42%
dk3.ache.pdf.officeoncloud.cn,73,0.01%,167,94,43.71%
list3.ppstream.com.iqiyi.com,73,0.01%,167,94,43.71%
ocsp.globalsign.com,73,0.01%,184,111,39.67%
dmpstatic.cdn.bcebos.com,73,0.01%,163,90,44.79%
15min.pcfg.cache.wpscdn.cn,73,0.01%,149,76,48.99%
opencdnbdcharon.jomodns.com,73,0.01%,162,89,45.06%
sslbaidu.jomodns.com,73,0.01%,170,97,42.94%
honeycomb.wpscdn.cn.download.ks-cdn.com,73,0.01%,153,80,47.71%
gslb-dsa-tc.zhihu.com,73,0.01%,153,80,47.71%
ecs.office.com,72,0.01%,5359,5287,1.34%
wwcdn.weixin.qq.com,72,0.01%,151,79,47.68%
midas.gtimg.cn,72,0.01%,159,87,45.28%
3.debian.pool.ntp.org,72,0.01%,134,62,53.73%
mss0.bdstatic.com,72,0.01%,171,99,42.11%
www.tm.ak.prd.aadg.trafficmanager.net,72,0.01%,157,85,45.86%
opencdnglobal.jomodns.com,72,0.01%,150,78,48.00%
emcharts.dfcfw.com,72,0.01%,162,90,44.44%
investor.shutterstock.com,72,0.01%,113,41,63.72%
www.nvidia.cn,71,0.01%,162,91,43.83%
ns02.000webhost.com,71,0.01%,303,232,23.43%
www.taobao.com.danuoyi.tbcache.com,71,0.01%,161,90,44.10%
qzs.tc.qq.com,71,0.01%,150,79,47.33%
pull-flv-vr-l1.douyincdn.com.wsdvs.com,71,0.01%,154,83,46.10%
p3-sign.toutiaoimg.com,71,0.01%,148,77,47.97%
offlintab.firefoxchina.cn.wscdns.com,71,0.01%,157,86,45.22%
prda.aadg.msidentity.com,71,0.01%,311,240,22.83%
emcharts.eastmoney.com,71,0.01%,161,90,44.10%
wx.qlogo.cn,70,0.01%,9693,9623,0.72%
qpic.y.qq.com,70,0.01%,142,72,49.30%
catalog-public-service-prod.ak.epicgames.com,70,0.01%,152,82,46.05%
pc001.download.wh.cmcm.com,70,0.01%,165,95,42.42%
inappcheck-cn.itunes-apple.com.akadns.net,70,0.01%,265,195,26.42%
f-log-mac-extension.grammarly.io,70,0.01%,161,91,43.48%
s.ssl.qhimg.com,70,0.01%,158,88,44.30%
live-ali.xhscdn.com,70,0.01%,162,92,43.21%
weatherapi.vivo.com.cn,70,0.01%,162,92,43.21%
p6-be-pack-sign.pglstatp-toutiao.com,70,0.01%,168,98,41.67%
mobile.ximalaya.com,70,0.01%,209,139,33.49%
cf.iadsdk.apple.com,69,0.01%,163,94,42.33%
steam-chat.com,69,0.01%,129,60,53.49%
pull-flv-l1-cny.douyincdn.com.wsdvs.com,69,0.01%,145,76,47.59%
ns01.000webhost.com,69,0.01%,304,235,22.70%
www.nvidia.com,69,0.01%,153,84,45.10%
8744550.pack.tcdn.qq.com,69,0.01%,473,404,14.59%
ins-diu1q33u.ias.tencent-cloud.net,69,0.01%,171,102,40.35%
apifcv2.flash.cn,69,0.01%,147,78,46.94%
hcdnw.bili.c.cdnhwc2.com,69,0.01%,147,78,46.94%
www.tm.a.prd.aadg.akadns.net,68,0.01%,158,90,43.04%
ocsp2.globalsign.com,68,0.01%,177,109,38.42%
show.bilibili.com,68,0.01%,145,77,46.90%
pull-l3.douyincdn.com.w.alikunlun.net,68,0.01%,144,76,47.22%
code.bdstatic.com.a.bdydns.com,68,0.01%,138,70,49.28%
emcharts.dftzj.com,68,0.01%,159,91,42.77%
opencdnbdsimage.jomodns.com,68,0.01%,156,88,43.59%
s.bdstatic.com,68,0.01%,147,79,46.26%
pcs-sdk-server.alibaba.com,67,0.01%,11874,11807,0.56%
pgpstatic.games.wanmei.com,67,0.01%,156,89,42.95%
jp04-vm0.entry.srthdw.art,67,0.01%,151,84,44.37%
v11-x.douyinvod.com,67,0.01%,151,84,44.37%
dl.ijinshan.com,67,0.01%,148,81,45.27%
pull-f3-proxy.douyincdn.com.w.alikunlun.net,67,0.01%,143,76,46.85%
pull-flv-l1.douyincdn.com.gccdn.net,67,0.01%,140,73,47.86%
datacenter.eastmoney.com.cdn.dnsv1.com,67,0.01%,148,81,45.27%
opencdnbdimgtn.jomodns.com,67,0.01%,152,85,44.08%
iduxzj9.qiniudns.com,66,0.01%,303,237,21.78%
updatem.360safe.com,66,0.01%,5432,5366,1.22%
g.y.qq.com,66,0.01%,126,60,52.38%
lf3-cdn-tos.bytegecko.com,66,0.01%,140,74,47.14%
p3-zeus.byteimg.com,66,0.01%,142,76,46.48%
ykimg.alicdn.com,66,0.01%,146,80,45.21%
update1.sangfor.net.cdn20.com,66,0.01%,710,644,9.30%
pull-flv-l1-source.douyincdn.com.wsdvs.com,66,0.01%,138,72,47.83%
launcher-public-service-prod.ak.epicgames.com,66,0.01%,142,76,46.48%
image.lixiangdao.vip,66,0.01%,148,82,44.59%
v5-j.douyinvod.com,66,0.01%,144,78,45.83%
bdimg.share.baidu.com,66,0.01%,157,91,42.04%
kjk3jf40.sched.sma-dk.tdnsstic1.cn,66,0.01%,152,86,43.42%
feilian-staging.bytedance.com,66,0.01%,164,98,40.24%
android.apis.google.com,66,0.01%,141,75,46.81%
ad.doubleclick.net,66,0.01%,149,83,44.30%
cdnimg.3g.qq.com,65,0.01%,158,93,41.14%
v5-e.douyinvod.com,65,0.01%,139,74,46.76%
zmptxy.v.trpcdn.NET,65,0.01%,157,92,41.40%
pull-rtmp-l1-source.douyincdn.com.wsdvs.com,65,0.01%,146,81,44.52%
jx.cdn.qhstatic.com,65,0.01%,155,90,41.94%
vd3.bdstatic.com,64,0.01%,144,80,44.44%
scc.bytedance.com,64,0.01%,134,70,47.76%
se2.itunes.apple.com,64,0.01%,119,55,53.78%
ns1.parkingcrew.net,64,0.01%,17672,17608,0.36%
sf6-cdn-tos.douyinstatic.com,64,0.01%,139,75,46.04%
gtd.alicdn.com,64,0.01%,137,73,46.72%
down.anticheatexpert.com,64,0.01%,150,86,42.67%
na61-na62.wagbridge.alibaba.alibaba.com,64,0.01%,538,474,11.90%
33aef1e.nh.gladns.com,64,0.01%,136,72,47.06%
pc-mon.snssdk.com,64,0.01%,130,66,49.23%
pull-flv-f1-proxy.douyincdn.com.wsdvs.com,64,0.01%,138,74,46.38%
msedge.api.cdp.microsoft.com,63,0.01%,2162,2099,2.91%
img-s.msn.cn,63,0.01%,153,90,41.18%
p3.music.126.net.163jiasu.com,63,0.01%,182,119,34.62%
lf3-cdn-tos.bytecdntp.com,63,0.01%,136,73,46.32%
ib.snssdk.com,63,0.01%,136,73,46.32%
conn5.coloros.com,63,0.01%,161,98,39.13%
swscan.apple.com,63,0.01%,140,77,45.00%
ecs.office.trafficmanager.NET,63,0.01%,111,48,56.76%
v20.events.data.microsoft.com,62,0.01%,6669,6607,0.93%
qing.wps.cn,62,0.01%,5884,5822,1.05%
liangcang-material.alicdn.com,62,0.01%,138,76,44.93%
filedownload.csw.lenovo.com,62,0.01%,140,78,44.29%
archive.kylinos.cn,62,0.01%,124,62,50.00%
sns-img-bd.xhscdn.com,62,0.01%,152,90,40.79%
pull-hls-vr-l1.douyincdn.com.wsdvs.com,62,0.01%,134,72,46.27%
pull-l3-cny.douyincdn.com.w.alikunlun.com,62,0.01%,132,70,46.97%
pull-vr-l3.douyincdn.com.230b2a2545cfa773.queniucf.com,62,0.01%,129,67,48.06%
configdownload.dbankcdn.cn,62,0.01%,142,80,43.66%
v.qq.com,62,0.01%,139,77,44.60%
33aef1e.nb.gladns.com,62,0.01%,135,73,45.93%
live.xhscdn.com,62,0.01%,155,93,40.00%
line3-h5-mobile-api.biligame.com,62,0.01%,132,70,46.97%
content.dellsupportcenter.com,62,0.01%,125,63,49.60%
h-adashx.ut.taobao.com,61,0.01%,9337,9276,0.65%
img1.baidu.com,61,0.01%,133,72,45.86%
dl2.360safe.com,61,0.01%,153,92,39.87%
pull-tsl-l3.douyincdn.com.w.alikunlun.net,61,0.01%,141,80,43.26%
pull-hls-f1.douyincdn.com.wsdvs.com,61,0.01%,141,80,43.26%
pull-spe-l3.douyincdn.com.230b2a2545cfa773.queniucf.com,61,0.01%,128,67,47.66%
graphql.sketch.cloud,61,0.01%,122,61,50.00%
p26-be-pack-sign.pglstatp-toutiao.com,61,0.01%,154,93,39.61%
caldav.fe.apple-dns.net,61,0.01%,134,73,45.52%
k1.gslb.ksyuncdn.com,61,0.01%,138,77,44.20%
wxsnsdy.wxs.qq.com,61,0.01%,133,72,45.86%
apps-mzstatic-cdn.itunes-apple.com.akadns.net,61,0.01%,138,77,44.20%
h-adashx.ut.taobao.com.gds.alibabadns.com,61,0.01%,206,145,29.61%
pull-tsl-vr-l1.douyincdn.com.wsdvs.com,61,0.01%,132,71,46.21%
seraph.zijieapi.com,61,0.01%,138,77,44.20%
up-q.qh-lb.com,61,0.01%,124,63,49.19%
11.benhuapp.com,61,0.01%,121,60,50.41%
safebrowsing-re.aaplimg.com,60,0.01%,109,49,55.05%
digitalassetlinks.googleapis.com,60,0.01%,123,63,48.78%
game.haydaygame.com,60,0.01%,124,64,48.39%
mssdk-bu.snssdk.com,60,0.01%,140,80,42.86%
a1843.g1.akamai.net,60,0.01%,124,64,48.39%
pull-f5-hs.pstatp.com.c.bytefcdn.com,60,0.01%,123,63,48.78%
pull-rtmp-f1.douyincdn.com.wsdvs.com,60,0.01%,134,74,44.78%
pull-lls-spe-l1.douyincdn.com.wsdvs.com,60,0.01%,143,83,41.96%
push-rtmp-l3.douyincdn.com.w.kunlunso.com,60,0.01%,120,60,50.00%
pull-f3.douyincdn.com.m.alikunlun.net,60,0.01%,128,68,46.88%
venus.douyucdn.cn,60,0.01%,126,66,47.62%
s.mzstatic.com,60,0.01%,133,73,45.11%
ns2.dnsnw.com,60,0.01%,9549,9489,0.63%
ebad288.nc.gladns.com,60,0.01%,148,88,40.54%
qzs.qq.com.sched.legopic2.tdnsv6.com,60,0.01%,125,65,48.00%
ipv6.china.qiniu.com.trpcdn.net,60,0.01%,133,73,45.11%
pingjs.qq.com,60,0.01%,148,88,40.54%
i0.hdslb.com.w.kunlunno.com,60,0.01%,125,65,48.00%
static-res.qq.com,60,0.01%,135,75,44.44%
p6.toutiaoimg.com,60,0.01%,140,80,42.86%
tconf.f.360.cn,59,0.01%,8310,8251,0.71%
avatar2-1.pddpic.com,59,0.01%,124,65,47.58%
socwxsns.video.qq.com,59,0.01%,135,76,43.70%
pics1.baidu.com,59,0.01%,130,71,45.38%
down3.huorong.cn.c.cdnhwc1.com,59,0.01%,115,56,51.30%
pull-hls-spe-l11.douyincdn.com.sched.l9.tdnsv5.com,59,0.01%,129,70,45.74%
push-rtmp-l1.douyincdn.com.wsdvs.com,59,0.01%,152,93,38.82%
push-rtmp-l3-cny.douyincdn.com.w.kunlunso.com,59,0.01%,130,71,45.38%
opentracker.acgnx.se,59,0.01%,222,163,26.58%
ns1.dnsnw.com,59,0.01%,9477,9418,0.62%
ocsp.digicert.cn.w.cdngslb.com,59,0.01%,125,66,47.20%
a1507.dscw27.akamai.net,59,0.01%,123,64,47.97%
img0.baidu.com,58,0.01%,128,70,45.31%
cn.gme.qcloud.com,58,0.01%,134,76,43.28%
e12437.d.akamaiedge.net,58,0.01%,119,61,48.74%
sslhotpcs.jomodns.com,58,0.01%,125,67,46.40%
probe.icloud.com,58,0.01%,125,67,46.40%
push-rtmp-l3-encryption.douyincdn.com.w.kunlunso.com,58,0.01%,125,67,46.40%
push-rtmp-l3-enc.douyincdn.com.w.kunlunso.com,58,0.01%,128,70,45.31%
baichuan-sdk.alicdn.com,58,0.01%,136,78,42.65%
pull-flv-f1.douyincdn.com.gccdn.net,58,0.01%,132,74,43.94%
a1091.dscb.akamai.net,58,0.01%,119,61,48.74%
v5.douyinvod.com,58,0.01%,131,73,44.27%
v83-016.douyinvod.com,58,0.01%,138,80,42.03%
substrate.office.com,57,0.01%,2761,2704,2.06%
s3a.pstatp.com,57,0.01%,129,72,44.19%
v5-i.douyinvod.com,57,0.01%,120,63,47.50%
pdf-file.pdfxd.com,57,0.01%,125,68,45.60%
scholar.google.com,57,0.01%,120,63,47.50%
aapl-edge0.qtlcdn.com,57,0.01%,125,68,45.60%
pull-flv-l1-hs.pstatp.com.wsdvs.com,57,0.01%,131,74,43.51%
pull-l3-source.douyincdn.com.w.cdngslb.com,57,0.01%,127,70,44.88%
gss3.bdstatic.com,57,0.01%,138,81,41.30%
33aef1e.nd.gladns.com,57,0.01%,118,61,48.31%
bcefdyflvq.jomodns.com,57,0.01%,124,67,45.97%
ims-prod06.adobelogin.com,57,0.01%,134,77,42.54%
hw2.a.kwimgs.com,57,0.01%,117,60,48.72%
www.bit-hdtv.com,56,0.01%,2666,2610,2.10%
cdn.ap.bittorrent.com,56,0.01%,117,61,47.86%
u2-000.ecukwai.com,56,0.01%,113,57,49.56%
e4894.g.akamaiedge.net,56,0.01%,115,59,48.70%
miserupdate.aliyun.com.danuoyi.tbcache.com,56,0.01%,133,77,42.11%
cdn-file.ludashi.com.m.alikunlun.net,56,0.01%,126,70,44.44%
assets.msn.cn-c.edgekey.net.globalredir.akadns.net,56,0.01%,112,56,50.00%
wd-prod-ss.trafficmanager.NET,56,0.01%,104,48,53.85%
ris-prod.trafficmanager.NET,56,0.01%,105,49,53.33%
www.tm.lg.prod.aadmsa.trafficmanager.NET,56,0.01%,100,44,56.00%
teredo.ipv6.microsoft.com,55,0.01%,117847,117792,0.05%
vortex.data.microsoft.com,55,0.01%,9580,9525,0.57%
v5-h.douyinvod.com,55,0.01%,125,70,44.00%
scrootca1.ocsp.secomtrust.net,55,0.01%,119,64,46.22%
p3-be-pack-sign.pglstatp-toutiao.com,55,0.01%,126,71,43.65%
pull-rtmp-l1-hs.pstatp.com.wsdvs.com,55,0.01%,122,67,45.08%
u104-ml.gslb.ksyuncdn.com,55,0.01%,119,64,46.22%
pull-rtmp-l1.douyincdn.com.wsdvs.com,55,0.01%,132,77,41.67%
33aef1e.ng.gladns.com,55,0.01%,109,54,50.46%
bl6pap004.storage.live.com,55,0.01%,591,536,9.31%
pull-tsl-spe-l1.douyincdn.com.wsdvs.com,55,0.01%,119,64,46.22%
s6110-ml.gslb.ksyuncdn.com,55,0.01%,110,55,50.00%
pull-l3-hs.pstatp.com.w.alikunlun.net,55,0.01%,118,63,46.61%
48l6nsax.sched.v1lego-dk.tdnsvod1.cn,55,0.01%,125,70,44.00%
assets.msn.com.edgekey.net,55,0.01%,109,54,50.46%
al.p2p.huya.com,55,0.01%,127,72,43.31%
mon.zijieapi.com,54,0.01%,9690,9636,0.56%
img2.baidu.com,54,0.01%,121,67,44.63%
mbdp02.bdstatic.com,54,0.01%,118,64,45.76%
fullscreen-detail.alicdn.com,54,0.01%,116,62,46.55%
sf1-dycdn-tos.pstatp.com,54,0.01%,116,62,46.55%
gss0.baidu.com,54,0.01%,122,68,44.26%
apps.apple.com.cdn30.com,54,0.01%,143,89,37.76%
2852517.sched.v1lego.tdnsvod1.cn,54,0.01%,110,56,49.09%
push-rtmp-vr-l1.douyincdn.com.wsdvs.com,54,0.01%,138,84,39.13%
pull-hls-f5-vs-tsl.douyincdn.com.w.kunluncan.com,54,0.01%,114,60,47.37%
wvcfg.alicdn.com,54,0.01%,136,82,39.71%
bcstobos.jomodns.com,54,0.01%,116,62,46.55%
emupdate.avcdn.net,54,0.01%,108,54,50.00%
m.taobao.com,54,0.01%,118,64,45.76%
dailyupdate.wangwang.taobao.com,54,0.01%,121,67,44.63%
pull-hls-spe-l1.douyincdn.com.wsdvs.com,54,0.01%,119,65,45.38%
datacenter-web.eastmoney.com,54,0.01%,122,68,44.26%
grouptalk.c2c.qq.com,54,0.01%,119,65,45.38%
duba-defend.zhhainiao.com,53,0.01%,12281,12228,0.43%
h-adashx-internal.ut.taobao.com,53,0.01%,214,161,24.77%
www.tribalmixes.com,53,0.01%,2979,2926,1.78%
prod.ingestion-edge.prod.dataops.mozgcp.NET,53,0.01%,143,90,37.06%
mobile.events.data.trafficmanager.net,53,0.01%,708,655,7.49%
wappass.bdimg.com,53,0.01%,131,78,40.46%
feed-image.baidu.com,53,0.01%,118,65,44.92%
sqdd.myapp.com,53,0.01%,114,61,46.49%
m15.360buyimg.com,53,0.01%,115,62,46.09%
pull-flv-l3-encryption.douyincdn.com.w.alikunlun.net,53,0.01%,118,65,44.92%
pull-lls-spe-l3.douyincdn.com.230b2a2545cfa773.queniucf.com,53,0.01%,119,66,44.54%
pull-rtmp-f1-hs.pstatp.com.wsdvs.com,53,0.01%,118,65,44.92%
dl.static.iqiyi.com,53,0.01%,169,116,31.36%
www.ifeng.com,53,0.01%,118,65,44.92%
www.bytedance.com.w.cdngslb.com,53,0.01%,110,57,48.18%
line1-log.biligame.net,53,0.01%,111,58,47.75%
browser.360.cn.ucloud.com.cn,53,0.01%,124,71,42.74%
erh4gbw3.sched.v1lego-dk.tdnsvod1.cn,53,0.01%,113,60,46.90%
emres.eastmoney.com,53,0.01%,121,68,43.80%
u1-000.ecukwai.com,53,0.01%,109,56,48.62%
stat.microvirt.com,53,0.01%,109,56,48.62%
img.www.duba.net,52,0.01%,124,72,41.94%
tiebapic.baidu.com,52,0.01%,116,64,44.83%
is4-ssl.mzstatic.com,52,0.01%,125,73,41.60%
prod-streaming-video-msn-com.akamaized.net,52,0.01%,114,62,45.61%
tnc3-alisc1.zijieapi.com,52,0.01%,107,55,48.60%
push-rtmp-spe-l1.douyincdn.com.wsdvs.com,52,0.01%,125,73,41.60%
sslzz.jomodns.com,52,0.01%,108,56,48.15%
www.download.windowsupdate.com.download.ks-cdn.com,52,0.01%,105,53,49.52%
browser.360.cn.ucloudnaming.cn,52,0.01%,116,64,44.83%
adsmind.ugdtimg.com,52,0.01%,126,74,41.27%
amp-api.media.apple.com,52,0.01%,106,54,49.06%
opencdnzhihustatic.jomodns.com,52,0.01%,116,64,44.83%
gf9xlqa6wd.feishu.cn,51,0.01%,115,64,44.35%
sg.pool.ntp.org,51,0.01%,127,76,40.16%
sns-video-bd.xhscdn.com,51,0.01%,120,69,42.50%
cdn.cnbj1.fds.api.mi-img.com,51,0.01%,116,65,43.97%
beacons-handoff.gcp.gvt2.com,51,0.01%,113,62,45.13%
static.cnblogs.com,51,0.01%,102,51,50.00%
u01-ml.gslb.ksyuncdn.com,51,0.01%,110,59,46.36%
pull-flv-f29.douyincdn.com.ucloud.com.cn,51,0.01%,120,69,42.50%
hao5.qhimg.com,51,0.01%,120,69,42.50%
wa.qq.com,51,0.01%,123,72,41.46%
v5-colda.douyinvod.com,51,0.01%,127,76,40.16%
cname.api.origin.com,51,0.01%,109,58,46.79%
static.googleadsserving.cn,51,0.01%,122,71,41.80%
experiments.apple.com,51,0.01%,101,50,50.50%
p3.douyinpic.com,51,0.01%,106,55,48.11%
aa.google.com,51,0.01%,116,65,43.97%
switch.pcfg.cache.wpscdn.cn,50,0.01%,11533,11483,0.43%
d.docs.live.net,50,0.01%,895,845,5.59%
img.meituan.net,50,0.01%,242,192,20.66%
platformcn.maps.glbdns2.microsoft.com,50,0.01%,113,63,44.25%
metadata.templates.cdn.office.net,50,0.01%,113,63,44.25%
pull-flv-spe-l11.douyincdn.com.sched.l9.tdnsv5.com,50,0.01%,119,69,42.02%
pull-flv-f1-hs.pstatp.com.wsdvs.com,50,0.01%,108,58,46.30%
static.mysmth.net,50,0.01%,110,60,45.45%
pull-flv-spe-l1.douyincdn.com.wsdvs.com,50,0.01%,113,63,44.25%
hmcdn.baidu.com,50,0.01%,120,70,41.67%
m.baike.com,50,0.01%,104,54,48.08%
p9.toutiaoimg.com,50,0.01%,124,74,40.32%
ra.gtimg.com,49,0.01%,112,63,43.75%
conf.f.360.cn,49,0.01%,1268,1219,3.86%
cds-temp.apple.com.akadns.net,49,0.01%,114,65,42.98%
skconf.f.qh-lb.com,49,0.01%,118,69,41.53%
static.360.cn,49,0.01%,107,58,45.79%
pull-flv-f11.douyincdn.com.sched.l8.tdnsv5.com,49,0.01%,110,61,44.55%
push-rtmp-l3-hs.pstatp.com.w.kunlunso.com,49,0.01%,109,60,44.95%
pull-lls-l3.douyincdn.com.w.cdngslb.com,49,0.01%,104,55,47.12%
iadsdk.qtlcdn.com,49,0.01%,108,59,45.37%
tnc3-aliec2.snssdk.com,49,0.01%,115,66,42.61%
cdn-api-verify.mob.com,49,0.01%,108,59,45.37%
ebad288.na.gladns.com,49,0.01%,127,78,38.58%
detail.alicdn.com,49,0.01%,118,69,41.53%
pull-flv-l1.ixigua.com.wsdvs.com,49,0.01%,107,58,45.79%
img1.360buyimg.com,49,0.01%,106,57,46.23%
mask-api.fe.apple-dns.net,49,0.01%,106,57,46.23%
d.skconf.f.360.cn,48,0.01%,6827,6779,0.70%
www.google.com,48,0.01%,16711,16663,0.29%
dotplayer.coldlake1.com.w.cdngslb.com,48,0.01%,114,66,42.11%
beacons5.gvt3.com,48,0.01%,104,56,46.15%
apic.douyucdn.cn,48,0.01%,107,59,44.86%
play-china.itunes-apple.com.akadns.net,48,0.01%,118,70,40.68%
tnc3-bjlgy.snssdk.com,48,0.01%,100,52,48.00%
y.gtimg.cn.sched.ssd.tdnsv6.com,48,0.01%,113,65,42.48%
pull-rtmp-l1.ixigua.com.wsdvs.com,48,0.01%,108,60,44.44%
push-rtmp-l26.douyincdn.com.c.cdnhwc3.com,48,0.01%,100,52,48.00%
push-rtmp-l1-cny.douyincdn.com.wsdvs.com,48,0.01%,124,76,38.71%
pull-rtmp-l1-cny.douyincdn.com.wsdvs.com,48,0.01%,110,62,43.64%
v5-colde.douyinvod.com,48,0.01%,108,60,44.44%
vcs.zijieapi.com,48,0.01%,102,54,47.06%
yiyun.n.shifen.com,47,0.01%,840,793,5.60%
drive.wps.cn,47,0.01%,5178,5131,0.91%
is1-ssl.mzstatic.com,47,0.01%,115,68,40.87%
ipv6.google.com,47,0.01%,2088,2041,2.25%
cdn.staticfile.org,47,0.01%,110,63,42.73%
s6130-ml.gslb.ksyuncdn.com,47,0.01%,106,59,44.34%
ss0.bdstatic.com,47,0.01%,114,67,41.23%
datarouter-prod.ak.epicgames.com,47,0.01%,102,55,46.08%
tile-service.weather.microsoft.com,46,0.01%,8804,8758,0.52%
api.msn.com,46,0.01%,2848,2802,1.62%
csdn.log-global.aliyuncs.com.w.cdngslb.com,46,0.01%,100,54,46.00%
pull-hls-f5-tsl.douyincdn.com.w.cdngslb.com,46,0.01%,102,56,45.10%
common-afdrk.fe.1drv.com,46,0.01%,327,281,14.07%
caldav.icloud.com,46,0.01%,100,54,46.00%
sb-ssl.google.com,46,0.01%,106,60,43.40%
pkgupdate7.synology.com,46,0.01%,114,68,40.35%
www.tm.a.prd.aadg.trafficmanager.NET,46,0.01%,108,62,42.59%
btrace.qq.com,45,0.01%,7953,7908,0.57%
imap-mail.outlook.com,45,0.01%,1263,1218,3.56%
accounts.logi.com,45,0.01%,106,61,42.45%
download.mcafee.com,45,0.01%,102,57,44.12%
w278o2k77x.feishu.cn,45,0.01%,101,56,44.55%
dsp.lenovo.com.cn.trpcdn.net,45,0.01%,105,60,42.86%
fex.bdstatic.com,45,0.01%,123,78,36.59%
mv.music.tc.qq.com,44,0.01%,2656,2612,1.66%
www.icloud.com,44,0.01%,879,835,5.01%
s.f.360.cn,44,0.01%,28074,28030,0.16%
tx-dwk.pull.yximgs.com,44,0.01%,105,61,41.90%
v5-f.douyinvod.com,44,0.01%,105,61,41.90%
swdist.apple.com,44,0.01%,101,57,43.56%
tconf2.f.360.cn,43,0.01%,6151,6108,0.70%
wu-bg-shim.trafficmanager.net,43,0.01%,607,564,7.08%
circlevideo2.photo.qq.com,43,0.01%,100,57,43.00%
js-rwk.pull.etoote.com,43,0.01%,104,61,41.35%
wspeed.qq.com,42,0.01%,287,245,14.63%
s03-ml.gslb.ksyuncdn.com,42,0.01%,103,61,40.78%
h5api.m.taobao.com,42,0.01%,109,67,38.53%
mobile.events.data.microsoft.com,41,0.01%,9193,9152,0.45%
ue.lenovomm.cn,41,0.01%,1362,1321,3.01%
hao.ssl.dhrest.com,41,0.01%,118,77,34.75%
cjhd.mediav.com,41,0.01%,102,61,40.20%
functional.events.data.microsoft.com,40,0.01%,1656,1616,2.42%
prod.detectportal.prod.cloudops.mozgcp.net,40,0.01%,14926,14886,0.27%
cdn-cn.nekocloud.cn,40,0.01%,511,471,7.83%
push-rtmp-l1.ixigua.com.wsdvs.com,40,0.01%,120,80,33.33%
d1--cn-gotcha208.bilivideo.com,40,0.01%,101,61,39.60%
ic.wps.cn,39,0.00%,2119,2080,1.84%
iris-de-prod-azsc-eas-b.eastasia.cloudapp.azure.com,39,0.00%,441,402,8.84%
s1.ssl.qhres2.com,39,0.00%,114,75,34.21%
ns.freeparking.co.nz,39,0.00%,154,115,25.32%
www.paypal.com,39,0.00%,103,64,37.86%
pc-plugin-plg.wpscdn.cn,38,0.00%,5416,5378,0.70%
www.tvnihon.com,38,0.00%,2965,2927,1.28%
open.tracker.cl,38,0.00%,1497,1459,2.54%
ns2.freeparking.co.nz,38,0.00%,153,115,24.84%
account.wps.cn,37,0.00%,1858,1821,1.99%
www.yuwabits.net,37,0.00%,2339,2302,1.58%
dldir1.qq.com.tcdn.qq.com,37,0.00%,153,116,24.18%
epicgames-download1-1251447533.file.myqcloud.com,37,0.00%,105,68,35.24%
ldc.lenovo.com.cn,36,0.00%,6756,6720,0.53%
bag.itunes.apple.com,36,0.00%,1762,1726,2.04%
music.163.com,36,0.00%,1386,1350,2.60%
pub.idqqimg.com,36,0.00%,5134,5098,0.70%
and.game.coc.qq.com,36,0.00%,367,331,9.81%
ecn.dev.ditu.live.com,35,0.00%,1028,993,3.40%
incoming.telemetry.mozilla.org,34,0.00%,6965,6931,0.49%
skconf.f.360.cn,34,0.00%,131,97,25.95%
settings-prod-scus-1.southcentralus.cloudapp.azure.com,34,0.00%,317,283,10.73%
wd-prod-ss.trafficmanager.net,34,0.00%,494,460,6.88%
default.exp-tas.com,33,0.00%,14140,14107,0.23%
config.edge.skype.com,33,0.00%,6939,6906,0.48%
pub.idqqimg.com.tc.qq.com,33,0.00%,152,119,21.71%
msg.qy.net,33,0.00%,1485,1452,2.22%
mirrors.tuna.tsinghua.edu.cn,33,0.00%,1272,1239,2.59%
t-ruanjian.2345.cc,33,0.00%,109,76,30.28%
ecs.office.trafficmanager.net,33,0.00%,197,164,16.75%
i0.hdslb.com,32,0.00%,1524,1492,2.10%
wdl1.cache.wps.cn,32,0.00%,3581,3549,0.89%
isure6.stream.qqmusic.qq.com,32,0.00%,1658,1626,1.93%
dl.360safe.com,32,0.00%,1227,1195,2.61%
pc-store.lenovomm.cn,32,0.00%,769,737,4.16%
wpad.www.tendawifi.com,32,0.00%,778,746,4.11%
post.ksosoft.com,31,0.00%,1467,1436,2.11%
t14.baidu.com,30,0.00%,1079,1049,2.78%
tracker.publicbt.com,30,0.00%,199,169,15.08%
www-www.bing.com.trafficmanager.net,30,0.00%,471,441,6.37%
ns1.dynu.com,30,0.00%,127,97,23.62%
ns4.dynu.com,30,0.00%,123,93,24.39%
update.code.visualstudio.com,29,0.00%,2610,2581,1.11%
1min.pcfg.cache.wpscdn.cn,29,0.00%,3634,3605,0.80%
isure.stream.qqmusic.qq.com,29,0.00%,1708,1679,1.70%
common-geo.ha.1drv.com,29,0.00%,161,132,18.01%
ns3.dynu.com,29,0.00%,123,94,23.58%
cl.vd.f.360.cn,28,0.00%,4971,4943,0.56%
login.microsoftonline.com,28,0.00%,2152,2124,1.30%
gameplay.intel.com,28,0.00%,1443,1415,1.94%
sadownload.mcafee.com,28,0.00%,1406,1378,1.99%
visualstudio-devdiv-c2s.msedge.net,28,0.00%,1737,1709,1.61%
us-v20.events.data.microsoft.com,28,0.00%,8723,8695,0.32%
ns6.dynu.com,28,0.00%,123,95,22.76%
ns5.dynu.com,28,0.00%,123,95,22.76%
ping.pinyin.sogou.com,27,0.00%,13693,13666,0.20%
router10.teamviewer.com,27,0.00%,2711,2684,1.00%
tracker.vectahosting.eu,27,0.00%,380,353,7.11%
www.msftncsi.com.edgesuite.net,27,0.00%,1492,1465,1.81%
up.f.360.cn,27,0.00%,103,76,26.21%
ns2.dynu.com,27,0.00%,127,100,21.26%
downv6.qq.com,26,0.00%,165,139,15.76%
aqqmusic.tc.qq.com,26,0.00%,1706,1680,1.52%
sconf.f.360.cn,26,0.00%,3890,3864,0.67%
helpdubaclient.ksmobile.com,26,0.00%,2226,2200,1.17%
api.onedrive.com,26,0.00%,2047,2021,1.27%
www-cdn.icloud.com.akadns.net,26,0.00%,577,551,4.51%
www.baidu.com,25,0.00%,244364,244339,0.01%
az764295.vo.msecnd.net,25,0.00%,11509,11484,0.22%
sjy.stream.qqmusic.qq.com,25,0.00%,1659,1634,1.51%
cloud-rest.lenovomm.com,25,0.00%,1444,1419,1.73%
login.windows.net,25,0.00%,673,648,3.71%
filehelper.weixin.qq.com,25,0.00%,10375,10350,0.24%
appimg.dbankcdn.com,25,0.00%,253,228,9.88%
settings-prod-wjp-1.japanwest.cloudapp.azure.com,25,0.00%,213,188,11.74%
v10.vortex-win.data.microsoft.com,25,0.00%,1001,976,2.50%
settings-prod-cin-1.centralindia.cloudapp.azure.com,25,0.00%,241,216,10.37%
sjy.stream.qqmusic.qq.com.vdncache.com,25,0.00%,134,109,18.66%
config.pinyin.sogou.com,24,0.00%,19510,19486,0.12%
info.pinyin.sogou.com,24,0.00%,10111,10087,0.24%
notice.wps.cn,24,0.00%,1397,1373,1.72%
stun-h5.qvb.qcloud.com,24,0.00%,191,167,12.57%
db.CN.clamav.net,24,0.00%,141,117,17.02%
zz.bdstatic.com,23,0.00%,804,781,2.86%
le.wps.cn,23,0.00%,1155,1132,1.99%
qr.wps.cn,23,0.00%,1141,1118,2.02%
zj-roaming.wps.cn,23,0.00%,1284,1261,1.79%
vip.wps.cn,23,0.00%,1413,1390,1.63%
vasapi.wps.cn,23,0.00%,1485,1462,1.55%
roaming.wps.cn,23,0.00%,1243,1220,1.85%
zw-roaming.wps.cn,23,0.00%,1148,1125,2.00%
dyn.wps.cn,23,0.00%,1451,1428,1.59%
update.wps.cn,23,0.00%,6157,6134,0.37%
vm.gtimg.cn,23,0.00%,2575,2552,0.89%
lucky.wps.cn,23,0.00%,1285,1262,1.79%
www.gsd92gov.com,23,0.00%,327,304,7.03%
slscr.update.microsoft.com,23,0.00%,2950,2927,0.78%
ns1.panamans.com,23,0.00%,10339,10316,0.22%
ns2.panamans.com,23,0.00%,10320,10297,0.22%
wd-prod-ss-as-southeast-4-fe.southeastasia.cloudapp.azure.com,23,0.00%,346,323,6.65%
www.msftconnecttest.com,22,0.00%,7940,7918,0.28%
zt.wps.cn,22,0.00%,1171,1149,1.88%
wd-prod-ss-as-southeast-3-fe.southeastasia.cloudapp.azure.com,22,0.00%,395,373,5.57%
settings-prod-scus-2.southcentralus.cloudapp.azure.com,22,0.00%,242,220,9.09%
wildcard.weather.microsoft.com.edgekey.net,22,0.00%,225,203,9.78%
client.wns.windows.com,21,0.00%,8096,8075,0.26%
dl.vas.wpscdn.cn,21,0.00%,1240,1219,1.69%
sv.symcb.com,21,0.00%,545,524,3.85%
docer.wps.cn,21,0.00%,1559,1538,1.35%
home.wps.cn,21,0.00%,1346,1325,1.56%
wdl1.file.cache.docer.com,21,0.00%,1263,1242,1.66%
kdocs.cn,21,0.00%,1279,1258,1.64%
dldir1.qq.com,21,0.00%,4437,4416,0.47%
tracker.tasvideos.org,21,0.00%,2732,2711,0.77%
kv801.prod.do.dsp.mp.microsoft.com,21,0.00%,796,775,2.64%
teams.events.data.microsoft.com,21,0.00%,589,568,3.57%
wd-prod-ss-as-southeast-1-fe.southeastasia.cloudapp.azure.com,21,0.00%,336,315,6.25%
ocsp.entrust.net,20,0.00%,2599,2579,0.77%
www.youtube.com,20,0.00%,1708,1688,1.17%
outlook.office.com,20,0.00%,1318,1298,1.52%
tunnel.cfw.trustedsource.org,20,0.00%,950,930,2.11%
s.symcb.com,20,0.00%,716,696,2.79%
settings-prod-wus2-2.westus2.cloudapp.azure.com,20,0.00%,242,222,8.26%
onedriveclucprodbn20003.blob.core.windows.net,20,0.00%,114,94,17.54%
config.edge.skype.com.trafficmanager.net,20,0.00%,355,335,5.63%
broker.miwifi.com,19,0.00%,7106,7087,0.27%
crl.verisign.com,19,0.00%,2412,2393,0.79%
normandy.cdn.mozilla.net,19,0.00%,1113,1094,1.71%
slapi.oray.net,19,0.00%,12633,12614,0.15%
dig.bdurl.net,19,0.00%,1586,1567,1.20%
iris-de-prod-azsc-eas.eastasia.cloudapp.azure.com,19,0.00%,195,176,9.74%
hub.upyun.com,18,0.00%,3502,3484,0.51%
dw-online.ksosoft.com,18,0.00%,1325,1307,1.36%
pconf.f.360.cn,18,0.00%,5486,5468,0.33%
acdc-direct.office.com,18,0.00%,540,522,3.33%
update.360safe.com,18,0.00%,2358,2340,0.76%
js1.pcfg.cache.wpscdn.cn,18,0.00%,1042,1024,1.73%
settings-prod-eus2-1.eastus2.cloudapp.azure.com,18,0.00%,187,169,9.63%
router6.teamviewer.com,18,0.00%,2674,2656,0.67%
dlied6.qq.com,18,0.00%,2347,2329,0.77%
update-khd.2345.cc,18,0.00%,847,829,2.13%
ags.privatelink.msidentity.com,18,0.00%,111,93,16.22%
settings-prod-uks-2.uksouth.cloudapp.azure.com,18,0.00%,268,250,6.72%
settings-win.data.microsoft.com,17,0.00%,50344,50327,0.03%
ctldl.windowsupdate.com,17,0.00%,27241,27224,0.06%
p3p.sogou.com,17,0.00%,7349,7332,0.23%
waconafd.officeapps.live.com,17,0.00%,475,458,3.58%
iphone-ld.apple.com,17,0.00%,1344,1327,1.26%
s1.symcb.com,17,0.00%,546,529,3.11%
infoc2.duba.net,17,0.00%,1394,1377,1.22%
settings-prod-uks-1.uksouth.cloudapp.azure.com,17,0.00%,210,193,8.10%
wd-prod-ss-as-southeast-2-fe.southeastasia.cloudapp.azure.com,17,0.00%,305,288,5.57%
login.wpscdn.cn,17,0.00%,537,520,3.17%
onedriveclucproddm20007.blob.core.windows.net,17,0.00%,176,159,9.66%
onedriveclucprodbn20002.blob.core.windows.net,17,0.00%,312,295,5.45%
ak.privatelink.msidentity.com,17,0.00%,185,168,9.19%
nexusrules.officeapps.live.com,16,0.00%,10491,10475,0.15%
get.sogou.com,16,0.00%,13857,13841,0.12%
init.itunes.apple.com,16,0.00%,2153,2137,0.74%
onedriveclucprodbn20010.blob.core.windows.net,16,0.00%,304,288,5.26%
teams.microsoft.com,16,0.00%,1014,998,1.58%
onedriveclucprodbn20021.blob.core.windows.net,16,0.00%,305,289,5.25%
arc.trafficmanager.net,16,0.00%,383,367,4.18%
configuration.apple.com.akadns.net,16,0.00%,402,386,3.98%
settings-prod-wus2-1.westus2.cloudapp.azure.com,16,0.00%,210,194,7.62%
settings-prod-cin-2.centralindia.cloudapp.azure.com,16,0.00%,181,165,8.84%
cn-bing-com.cn.a-0001.a-msedge.net,16,0.00%,258,242,6.20%
t13.baidu.com,15,0.00%,791,776,1.90%
wp.safe.360.cn,15,0.00%,15855,15840,0.09%
am.abc.wdpdk.link,15,0.00%,791,776,1.90%
oth.eve.mdt.qq.com,15,0.00%,6216,6201,0.24%
ris.api.iris.microsoft.com,15,0.00%,3796,3781,0.40%
t.khd.2345.cc,15,0.00%,3881,3866,0.39%
disc601.prod.do.dsp.mp.microsoft.com,15,0.00%,1046,1031,1.43%
mrodevicemgr.officeapps.live.com,15,0.00%,972,957,1.54%
onedscolprdeus11.eastus.cloudapp.azure.com,15,0.00%,145,130,10.34%
live.github.com,15,0.00%,357,342,4.20%
api.vc.bilibili.com,14,0.00%,19943,19929,0.07%
dsp.lenovo.com.cn,14,0.00%,4871,4857,0.29%
checkappexec.microsoft.com,14,0.00%,4314,4300,0.32%
smartscreen-prod.microsoft.com,14,0.00%,12051,12037,0.12%
edge.microsoft.com,14,0.00%,24787,24773,0.06%
mini.browser.360.cn,14,0.00%,4551,4537,0.31%
ulogs.umeng.com,14,0.00%,1405,1391,1.00%
g.live.com,14,0.00%,1486,1472,0.94%
sns-avatar-qc.xhscdn.com,14,0.00%,379,365,3.69%
g.csdnimg.cn,14,0.00%,1039,1025,1.35%
onedriveclucprodbn20040.blob.core.windows.net,14,0.00%,317,303,4.42%
eas.outlook.com,14,0.00%,441,427,3.17%
edge.skype.com,14,0.00%,238,224,5.88%
chi01pap001.storage.live.com,14,0.00%,121,107,11.57%
settings-prod-eus2-2.eastus2.cloudapp.azure.com,14,0.00%,175,161,8.00%
bnz07pap001.storage.live.com,14,0.00%,137,123,10.22%
skydrivesync.policies.live.net,13,0.00%,464,451,2.80%
appconf.mail.163.com,13,0.00%,1393,1380,0.93%
cn.bing.com,13,0.00%,5625,5612,0.23%
api.weibo.cn,13,0.00%,731,718,1.78%
officeclient.microsoft.com,13,0.00%,1356,1343,0.96%
openapp.wpscdn.cn,13,0.00%,730,717,1.78%
dev.ditu.live.com,13,0.00%,2143,2130,0.61%
t-safe.2345.cc,13,0.00%,140,127,9.29%
onedriveclucproddm20027.blob.core.windows.net,13,0.00%,275,262,4.73%
onedriveclucproddm20044.blob.core.windows.net,13,0.00%,313,300,4.15%
onedriveclucprodbn20004.blob.core.windows.net,13,0.00%,290,277,4.48%
onedriveclucproddm20038.blob.core.windows.net,13,0.00%,292,279,4.45%
honeycomb.wps.cn,13,0.00%,993,980,1.31%
config.teams.microsoft.com,13,0.00%,1425,1412,0.91%
baidu-cn-north-00001.bj-a.bcebos.com,13,0.00%,270,257,4.81%
www.yahoo.com,13,0.00%,7776,7763,0.17%
onedriveclucprodbn20037.blob.core.windows.net,13,0.00%,100,87,13.00%
ns.parktons.com,13,0.00%,7153,7140,0.18%
alibaba.cdn.servers.hbly0592.com.cn,13,0.00%,204,191,6.37%
time.apple.com,12,0.00%,4300,4288,0.28%
res.wx.qq.com,12,0.00%,2062,2050,0.58%
mmbiz.qpic.cn,12,0.00%,5565,5553,0.22%
ping-edge.smartscreen.microsoft.com,12,0.00%,864,852,1.39%
www.microsoft.com,12,0.00%,6384,6372,0.19%
blobcollector.events.data.trafficmanager.NET,12,0.00%,192,180,6.25%
onedriveclucproddm20018.blob.core.windows.net,12,0.00%,306,294,3.92%
onedriveclucproddm20040.blob.core.windows.net,12,0.00%,300,288,4.00%
onedriveclucproddm20008.blob.core.windows.net,12,0.00%,317,305,3.79%
www.sina.com,12,0.00%,7552,7540,0.16%
common.cnblogs.com,12,0.00%,380,368,3.16%
ocsp.entrust.net.edgekey.net,12,0.00%,240,228,5.00%
sls.update.microsoft.com,12,0.00%,960,948,1.25%
cc.f.360.cn,12,0.00%,205,193,5.85%
onedscolprdwus05.westus.cloudapp.azure.com,12,0.00%,135,123,8.89%
hm.e.shifen.com,12,0.00%,376,364,3.19%
hkg4.edgehelper.com,12,0.00%,122,110,9.84%
sjy6.stream.qqmusic.qq.com.ctdns.cn,12,0.00%,135,123,8.89%
tracker.lilithraws.cf,11,0.00%,425,414,2.59%
outlookmobile-office365-tas.msedge.net,11,0.00%,289,278,3.81%
imgcache.qq.com,11,0.00%,771,760,1.43%
th.bing.com,11,0.00%,710,699,1.55%
www.notion.so,11,0.00%,1855,1844,0.59%
mmbiz.qlogo.cn,11,0.00%,561,550,1.96%
router9.teamviewer.com,11,0.00%,2693,2682,0.41%
www.msn.cn,11,0.00%,1923,1912,0.57%
ac.dun.163.com,11,0.00%,734,723,1.50%
settings-prod-sea-2.southeastasia.cloudapp.azure.com,11,0.00%,195,184,5.64%
ieonlinews.microsoft.com,11,0.00%,1084,1073,1.01%
hub5u.sandai.net,11,0.00%,271,260,4.06%
push.services.mozilla.com,11,0.00%,1138,1127,0.97%
data.grammarly.com,11,0.00%,387,376,2.84%
teams.live.com,11,0.00%,141,130,7.80%
update-pcsafe.2345.cc,11,0.00%,110,99,10.00%
dsm01pap007.storage.live.com,11,0.00%,172,161,6.40%
onedriveclucproddm20042.blob.core.windows.net,11,0.00%,290,279,3.79%
api100-eeft-drive-quic-lf.feishu.cn,11,0.00%,234,223,4.70%
tm1.edgedns-tm.info,11,0.00%,616,605,1.79%
onedscolprdwus08.westus.cloudapp.azure.com,11,0.00%,133,122,8.27%
onedscolprdwus03.westus.cloudapp.azure.com,11,0.00%,154,143,7.14%
onedscolprdwus11.westus.cloudapp.azure.com,11,0.00%,139,128,7.91%
sjy.stream.qqmusic.qq.com.ctdns.cn,11,0.00%,138,127,7.97%
ns2.parktons.com,11,0.00%,7161,7150,0.15%
settings-prod-eus-1.eastus.cloudapp.azure.com,11,0.00%,206,195,5.34%
static.zhihu.com,10,0.00%,821,811,1.22%
aps.amap.com,10,0.00%,2509,2499,0.40%
www.expressapisv2.net,10,0.00%,2135,2125,0.47%
client.mail.163.com,10,0.00%,1697,1687,0.59%
cs.dds.microsoft.com,10,0.00%,664,654,1.51%
onedscolprdaus02.australiasoutheast.cloudapp.azure.com,10,0.00%,116,106,8.62%
mon.snssdk.com,10,0.00%,778,768,1.29%
onedscolprdcus04.centralus.cloudapp.azure.com,10,0.00%,126,116,7.94%
onedriveclucprodbn20014.blob.core.windows.net,10,0.00%,293,283,3.41%
wdcp.microsoft.com,10,0.00%,710,700,1.41%
ups.ksmobile.net,10,0.00%,692,682,1.45%
waconatm.officeapps.live.com,10,0.00%,405,395,2.47%
reswx.tc.qq.com,10,0.00%,171,161,5.85%
onedscolprdcus01.centralus.cloudapp.azure.com,10,0.00%,140,130,7.14%
capi.grammarly.com,10,0.00%,241,231,4.15%
storage.live.com,10,0.00%,317,307,3.15%
onedscolprdwus13.westus.cloudapp.azure.com,10,0.00%,105,95,9.52%
outlook.ms-acdc.office.com,10,0.00%,579,569,1.73%
odc-commonafdrk-geo.onedrive.akadns.net,10,0.00%,279,269,3.58%
onedscolprdeus03.eastus.cloudapp.azure.com,10,0.00%,136,126,7.35%
diskapi.baidu.com,9,0.00%,6369,6360,0.14%
sp1.baidu.com,9,0.00%,1951,1942,0.46%
time.nist.gov,9,0.00%,1227,1218,0.73%
crl.comodoca.com,9,0.00%,1148,1139,0.78%
im.dingtalk.com,9,0.00%,524,515,1.72%
rs1.qq.com,9,0.00%,4840,4831,0.19%
ocsp2-lb.apple.com.akadns.net,9,0.00%,1825,1816,0.49%
translate.google.com,9,0.00%,1514,1505,0.59%
update.pan.baidu.com,9,0.00%,5061,5052,0.18%
softbus-device.wps.cn,9,0.00%,1389,1380,0.65%
ts3.cn.mm.bing.net,9,0.00%,589,580,1.53%
fe3cr.delivery.mp.microsoft.com,9,0.00%,3702,3693,0.24%
tr.p.360.cn,9,0.00%,1501,1492,0.60%
tsfe.trafficshaping.dsp.mp.microsoft.com,9,0.00%,2256,2247,0.40%
adstats.tencentmusic.com,9,0.00%,335,326,2.69%
client.teamviewer.com,9,0.00%,779,770,1.16%
www.biztorrents.com,9,0.00%,401,392,2.24%
login.microsoft.com,9,0.00%,615,606,1.46%
app.huabao.360.cn,9,0.00%,1976,1967,0.46%
download.jetbrains.com,9,0.00%,240,231,3.75%
www.microvirt.com,9,0.00%,774,765,1.16%
api.kylinos.cn,9,0.00%,965,956,0.93%
apis.map.qq.com,9,0.00%,292,283,3.08%
pull-hls-vr-l6.douyincdn.com,9,0.00%,834,825,1.08%
settings-prod-sea-1.southeastasia.cloudapp.azure.com,9,0.00%,206,197,4.37%
vdwmto3.bdstatic.com,9,0.00%,402,393,2.24%
helpdesktop1.ksmobile.com,9,0.00%,219,210,4.11%
fe3.delivery.mp.microsoft.com,9,0.00%,242,233,3.72%
hgc3.edgehelper.com,9,0.00%,174,165,5.17%
onedscolprdcus13.centralus.cloudapp.azure.com,9,0.00%,145,136,6.21%
misc.360buyimg.com,9,0.00%,111,102,8.11%
c-hzgt2.getui.com,9,0.00%,105,96,8.57%
ris-prod.trafficmanager.net,9,0.00%,195,186,4.62%
odc-commonafdrk-brs.onedrive.akadns.net,9,0.00%,246,237,3.66%
hksk2.edgehelper.com,9,0.00%,139,130,6.47%
cpro.baidustatic.com,8,0.00%,716,708,1.12%
t15.baidu.com,8,0.00%,746,738,1.07%
skydrive.wns.windows.com,8,0.00%,1908,1900,0.42%
fe2cr.update.microsoft.com,8,0.00%,1286,1278,0.62%
waws-prod-sg1-057-feea.southeastasia.cloudapp.azure.com,8,0.00%,136,128,5.88%
messaging.engagement.office.com,8,0.00%,396,388,2.02%
i.y.qq.com,8,0.00%,419,411,1.91%
tr.abirxo.cf,8,0.00%,2369,2361,0.34%
cn.archive.ubuntu.com,8,0.00%,1360,1352,0.59%
ditu.baidu.com,8,0.00%,239,231,3.35%
onedriveclucprodbn20020.blob.core.windows.net,8,0.00%,283,275,2.83%
help-tower.2345.cc,8,0.00%,782,774,1.02%
is.snssdk.com,8,0.00%,666,658,1.20%
info.wps.cn,8,0.00%,1007,999,0.79%
onedriveclucproddm20023.blob.core.windows.net,8,0.00%,282,274,2.84%
dup.baidustatic.com,8,0.00%,910,902,0.88%
plus.wps.cn,8,0.00%,497,489,1.61%
evoke-windowsservices-tas.msedge.net,8,0.00%,628,620,1.27%
fb98ab9159f51fd0.jijifun.com,8,0.00%,1269,1261,0.63%
b-ring.msedge.net,8,0.00%,138,130,5.80%
tcloud.tim.qq.com,8,0.00%,111,103,7.21%
vcheck.f.360.cn,8,0.00%,447,439,1.79%
onedscolprdwus04.westus.cloudapp.azure.com,8,0.00%,130,122,6.15%
onedscolprdcus05.centralus.cloudapp.azure.com,8,0.00%,123,115,6.50%
global.in.ai.monitor.azure.com,8,0.00%,136,128,5.88%
ocsp.digicert.com,7,0.00%,3848,3841,0.18%
pan.baidu.com,7,0.00%,28404,28397,0.02%
t9.baidu.com,7,0.00%,1208,1201,0.58%
licensing.mp.microsoft.com,7,0.00%,2210,2203,0.32%
catalog.gamepass.com,7,0.00%,2701,2694,0.26%
crl4.digicert.com,7,0.00%,1360,1353,0.51%
www.kdocs.cn,7,0.00%,1829,1822,0.38%
otheve.beacon.qq.com,7,0.00%,1773,1766,0.39%
qdyn.wps.cn,7,0.00%,1508,1501,0.46%
captive.apple.com,7,0.00%,1667,1660,0.42%
acs.m.taobao.com,7,0.00%,541,534,1.29%
www.mvgroup.org,7,0.00%,1622,1615,0.43%
umwatson.events.data.microsoft.com,7,0.00%,2797,2790,0.25%
configuration.apple.com,7,0.00%,822,815,0.85%
onedriveclucprodbn20024.blob.core.windows.net,7,0.00%,289,282,2.42%
onedriveclucproddm20046.blob.core.windows.net,7,0.00%,249,242,2.81%
k8s.gcr.io,7,0.00%,5467,5460,0.13%
softm.update.360safe.com,7,0.00%,1118,1111,0.63%
pull-f5.flive.douyincdn.com,7,0.00%,839,832,0.83%
onedscolprdwus01.westus.cloudapp.azure.com,7,0.00%,126,119,5.56%
ocsp05.actalis.it,7,0.00%,332,325,2.11%
ws-std01.sunlogin.oray.com,7,0.00%,1156,1149,0.61%
onedscolprdcus10.centralus.cloudapp.azure.com,7,0.00%,103,96,6.80%
dm2305.storage.live.com,7,0.00%,124,117,5.65%
onedscolprdcus14.centralus.cloudapp.azure.com,7,0.00%,122,115,5.74%
onedscolprdwus06.westus.cloudapp.azure.com,7,0.00%,124,117,5.65%
s-ring.msedge.net,7,0.00%,125,118,5.60%
win10-trt.msedge.net,7,0.00%,479,472,1.46%
onedscolprdcus00.centralus.cloudapp.azure.com,7,0.00%,126,119,5.56%
onedscolprdcus03.centralus.cloudapp.azure.com,7,0.00%,131,124,5.34%
onedscolprdcus08.centralus.cloudapp.azure.com,7,0.00%,130,123,5.38%
prod.roaming1.live.com.akadns.net,7,0.00%,101,94,6.93%
onedscolprdwus02.westus.cloudapp.azure.com,7,0.00%,135,128,5.19%
tracker.ccp.ovh,7,0.00%,234,227,2.99%
onedscolprdeus00.eastus.cloudapp.azure.com,7,0.00%,128,121,5.47%
edge.activity.windows.com,7,0.00%,126,119,5.56%
ns3-04.azure-dns.org,7,0.00%,108,101,6.48%
rq.upgrade.cmpc.cmcm.com,6,0.00%,3752,3746,0.16%
windows.policies.live.net,6,0.00%,217,211,2.76%
update.huorong.cn,6,0.00%,1520,1514,0.39%
bugreport.huorong.cn,6,0.00%,1359,1353,0.44%
www.bing.com,6,0.00%,12070,12064,0.05%
shuc-pc-hunt.ksord.com,6,0.00%,12465,12459,0.05%
t-safe.2345.com,6,0.00%,499,493,1.20%
crl3.digicert.com,6,0.00%,393,387,1.53%
hm.baidu.com,6,0.00%,4436,4430,0.14%
browser.events.data.msn.cn,6,0.00%,596,590,1.01%
c.bing.com,6,0.00%,902,896,0.67%
ntp.msn.cn,6,0.00%,628,622,0.96%
stat.sd.360.cn,6,0.00%,1539,1533,0.39%
docer-api.kdocs.cn,6,0.00%,1189,1183,0.50%
sms.wps.cn,6,0.00%,1147,1141,0.52%
aefd.nelreports.net,6,0.00%,647,641,0.93%
db.local.clamav.net,6,0.00%,5612,5606,0.11%
www.sangfor.com,6,0.00%,3541,3535,0.17%
gimg4.baidu.com,6,0.00%,464,458,1.29%
psg1-collabhubrtc.officeapps.live.com,6,0.00%,115,109,5.22%
imap.163.com,6,0.00%,1543,1537,0.39%
x2.c.lencr.org,6,0.00%,357,351,1.68%
pull-flv-f5-enc.flive.douyincdn.com,6,0.00%,808,802,0.74%
api.zhihu.com,6,0.00%,883,877,0.68%
graph.microsoft.com,6,0.00%,1138,1132,0.53%
pingfore.qq.com,6,0.00%,454,448,1.32%
stat6.y.qq.com,6,0.00%,441,435,1.36%
lens.zhihu.com,6,0.00%,1037,1031,0.58%
outlook.live.com,6,0.00%,1370,1364,0.44%
sl-log.oray.net,6,0.00%,2175,2169,0.28%
ynuf.aliapp.org,6,0.00%,433,427,1.39%
ccm-frontier.feishu.cn,6,0.00%,274,268,2.19%
gaea.meituan.com,6,0.00%,266,260,2.26%
www.freerainbowtables.com,6,0.00%,185,179,3.24%
onedscolprdcus02.centralus.cloudapp.azure.com,6,0.00%,120,114,5.00%
go.ie.sogou.com,6,0.00%,1178,1172,0.51%
wsus.f.360.cn,6,0.00%,412,406,1.46%
fpc.msedge.net,6,0.00%,175,169,3.43%
www.hao123.com,6,0.00%,495,489,1.21%
shuc-pc-snow.ksord.com,6,0.00%,231,225,2.60%
sensors.ibreader.com,6,0.00%,112,106,5.36%
cmhk.tcpbbr.xyz,6,0.00%,525,519,1.14%
onedscolprdeus02.eastus.cloudapp.azure.com,6,0.00%,121,115,4.96%
www.facebook.com,6,0.00%,543,537,1.10%
aus5.mozilla.org,6,0.00%,455,449,1.32%
global.infoapis.net,6,0.00%,173,167,3.47%
onedriveclucprodbn20044.blob.core.windows.net,6,0.00%,279,273,2.15%
onedriveclucproddm20025.blob.core.windows.net,6,0.00%,287,281,2.09%
onedriveclucprodbn20039.blob.core.windows.net,6,0.00%,312,306,1.92%
APAC05.azure-devices.net,6,0.00%,167,161,3.59%
lbdata.tj.ijinshan.com,6,0.00%,213,207,2.82%
onedscolprdwus10.westus.cloudapp.azure.com,6,0.00%,128,122,4.69%
onedscolprdwus12.westus.cloudapp.azure.com,6,0.00%,108,102,5.56%
oauth.account.jetbrains.com,6,0.00%,148,142,4.05%
cdn.cache.netvigators.xyz,6,0.00%,200,194,3.00%
static.360buyimg.com,6,0.00%,111,105,5.41%
discord.heihachi.pw,6,0.00%,354,348,1.69%
www.tm.lg.prod.aadmsa.trafficmanager.net,6,0.00%,190,184,3.16%
global.in.ai.privatelink.monitor.azure.com,6,0.00%,125,119,4.80%
ccm-frontier-hl.feishu.cn,6,0.00%,133,127,4.51%
ns4-04.azure-dns.info,6,0.00%,109,103,5.50%
roaming.officeapps.live.com,5,0.00%,1623,1618,0.31%
github.com,5,0.00%,4432,4427,0.11%
i1.hdslb.com,5,0.00%,1139,1134,0.44%
sp0.baidu.com,5,0.00%,1954,1949,0.26%
pcrec.baidu.com,5,0.00%,990,985,0.51%
zhuanlan.zhihu.com,5,0.00%,1734,1729,0.29%
pica.zhimg.com,5,0.00%,1127,1122,0.44%
cgi.ark.qq.com,5,0.00%,396,391,1.26%
raw.githubusercontent.com,5,0.00%,2253,2248,0.22%
time.windows.com,5,0.00%,2308,2303,0.22%
map.baidu.com,5,0.00%,1525,1520,0.33%
f.video.weibocdn.com,5,0.00%,449,444,1.11%
arc.msn.com,5,0.00%,6001,5996,0.08%
cloud.browser.360.cn,5,0.00%,4075,4070,0.12%
galaxy.safe.360.cn,5,0.00%,1339,1334,0.37%
qdun-data.qq.com,5,0.00%,1566,1561,0.32%
qd-update.qq.com,5,0.00%,1277,1272,0.39%
mobile.pipe.aria.microsoft.com,5,0.00%,1487,1482,0.34%
agd2.p.360.cn,5,0.00%,1970,1965,0.25%
srtb.msn.com,5,0.00%,595,590,0.84%
iaas.wps.cn,5,0.00%,953,948,0.52%
docer.kdocs.cn,5,0.00%,1113,1108,0.45%
geo.wps.cn,5,0.00%,1158,1153,0.43%
avatar.qwps.cn,5,0.00%,1118,1113,0.45%
learning.u.wpscdn.cn,5,0.00%,359,354,1.39%
infoc0.duba.net,5,0.00%,465,460,1.08%
prod-classifyclient.normandy.prod.cloudops.mozgcp.net,5,0.00%,182,177,2.75%
activity.windows.com,5,0.00%,1451,1446,0.34%
edgedl.me.gvt1.com,5,0.00%,1531,1526,0.33%
dc.applicationinsights.microsoft.com,5,0.00%,123,118,4.07%
bizapi.csdn.net,5,0.00%,605,600,0.83%
spo-ring.msedge.net,5,0.00%,161,156,3.11%
drive.wpsdns.com,5,0.00%,593,588,0.84%
shortconn.im.qcloud.com,5,0.00%,3513,3508,0.14%
m.hotmail.com,5,0.00%,244,239,2.05%
weather-api.extfans.com,5,0.00%,914,909,0.55%
cdn.onenote.net,5,0.00%,597,592,0.84%
onedscolprdeus01.eastus.cloudapp.azure.com,5,0.00%,110,105,4.55%
update.client.163.com,5,0.00%,1223,1218,0.41%
mcs.snssdk.com,5,0.00%,518,513,0.97%
onedscolprdwus09.westus.cloudapp.azure.com,5,0.00%,124,119,4.03%
visualstudio-devdiv-c2s-msedge-net.e-0009.e-msedge.net,5,0.00%,281,276,1.78%
ncc.avast.com,5,0.00%,684,679,0.73%
bnz05pap002.storage.live.com,5,0.00%,170,165,2.94%
onedscolprdwus14.westus.cloudapp.azure.com,5,0.00%,130,125,3.85%
www.douban.com,5,0.00%,531,526,0.94%
array603.prod.do.dsp.mp.microsoft.com,5,0.00%,474,469,1.05%
array614.prod.do.dsp.mp.microsoft.com,5,0.00%,425,420,1.18%
ime.sogou.com,5,0.00%,917,912,0.55%
image6.pubmatic.com,5,0.00%,295,290,1.69%
pull-flv-l6-hs.pstatp.com,5,0.00%,587,582,0.85%
auth.grammarly.com,5,0.00%,437,432,1.14%
inisdup.qihucdn.com,5,0.00%,425,420,1.18%
services.gfe.nvidia.com,5,0.00%,538,533,0.93%
gfwsl.geforce.com,5,0.00%,192,187,2.60%
whk1.noapp.xyz,5,0.00%,136,131,3.68%
captive.g.aaplimg.com,5,0.00%,165,160,3.03%
gnar.grammarly.com,5,0.00%,142,137,3.52%
drive.weixin.qq.com,5,0.00%,390,385,1.28%
onedscolprdeus10.eastus.cloudapp.azure.com,5,0.00%,138,133,3.62%
client-office365-tas.msedge.net,5,0.00%,492,487,1.02%
config-edge-skype.l-0007.l-msedge.net,5,0.00%,269,264,1.86%
onedscolprdeus05.eastus.cloudapp.azure.com,5,0.00%,144,139,3.47%
ss1.bdstatic.com,4,0.00%,676,672,0.59%
cn.ntp.org.cn,4,0.00%,960,956,0.42%
sugar.zhihu.com,4,0.00%,936,932,0.43%
rq.wh.cmcm.com,4,0.00%,10740,10736,0.04%
szextshort.weixin.qq.com,4,0.00%,3012,3008,0.13%
www.bilibili.com,4,0.00%,1822,1818,0.22%
c.go-mpulse.net,4,0.00%,2345,2341,0.17%
dns.msftncsi.com,4,0.00%,78951,78947,0.01%
geo.prod.do.dsp.mp.microsoft.com,4,0.00%,1981,1977,0.20%
zhidao.baidu.com,4,0.00%,2541,2537,0.16%
h5.qzone.qq.com,4,0.00%,14213,14209,0.03%
rs2.qq.com,4,0.00%,4963,4959,0.08%
www.telecommandsvc.microsoft.com,4,0.00%,368,364,1.09%
crl.usertrust.com,4,0.00%,406,402,0.99%
qingcenter.wps.cn,4,0.00%,7609,7605,0.05%
bk.info.zb.qq.com,4,0.00%,550,546,0.73%
m8.music.126.net,4,0.00%,370,366,1.08%
dns.weixin.qq.com.cn,4,0.00%,14879,14875,0.03%
caldav.163.com,4,0.00%,2256,2252,0.18%
szminorshort.weixin.qq.com,4,0.00%,947,943,0.42%
fclick.baidu.com,4,0.00%,805,801,0.50%
c.msn.com,4,0.00%,582,578,0.69%
dc.services.visualstudio.com,4,0.00%,1524,1520,0.26%
classify-client.services.mozilla.com,4,0.00%,840,836,0.48%
edu.ntp.org.cn,4,0.00%,611,607,0.65%
ntp1.aliyun.com,4,0.00%,842,838,0.48%
time1.cloud.tencent.com,4,0.00%,718,714,0.56%
connc.gj.qq.com,4,0.00%,3506,3502,0.11%
extshort.weixin.qq.com,4,0.00%,5224,5220,0.08%
ssl.look.360.cn,4,0.00%,1092,1088,0.37%
www.gstatic.com,4,0.00%,861,857,0.46%
inference.location.live.net,4,0.00%,710,706,0.56%
pc-store-lb.lenovomm.cn,4,0.00%,231,227,1.73%
dd.browser.360.cn,4,0.00%,3281,3277,0.12%
oneocsp.microsoft.com,4,0.00%,266,262,1.50%
k-ring.msedge.net,4,0.00%,141,137,2.84%
compiles.overleaf.com,4,0.00%,325,321,1.23%
captive-cidr.origin-apple.com.akadns.net,4,0.00%,164,160,2.44%
info.lenovo.com.cn,4,0.00%,866,862,0.46%
hovv.yilanvaas.com,4,0.00%,416,412,0.96%
windows.msn.cn,4,0.00%,977,973,0.41%
array513.prod.do.dsp.mp.microsoft.com,4,0.00%,298,294,1.34%
u.y.qq.com,4,0.00%,2969,2965,0.13%
stat.y.qq.com,4,0.00%,2274,2270,0.18%
message.bilibili.com,4,0.00%,1415,1411,0.28%
hao.lenovo.com.cn,4,0.00%,1195,1191,0.33%
uapi.mp.360.cn,4,0.00%,1424,1420,0.28%
tmead.y.qq.com,4,0.00%,176,172,2.27%
www.bitseduce.com,4,0.00%,398,394,1.01%
skyapi.live.net,4,0.00%,363,359,1.10%
api-kos.wps.cn,4,0.00%,174,170,2.30%
tracker.gbitt.info,4,0.00%,395,391,1.01%
tracker.internetwarriors.net,4,0.00%,345,341,1.16%
minorshort.weixin.qq.com,4,0.00%,2452,2448,0.16%
array806.prod.do.dsp.mp.microsoft.com,4,0.00%,387,383,1.03%
cdn.fwupd.org,4,0.00%,272,268,1.47%
array813.prod.do.dsp.mp.microsoft.com,4,0.00%,229,225,1.75%
bubble.ic.ksosoft.com,4,0.00%,705,701,0.57%
marketplace.visualstudio.com,4,0.00%,599,595,0.67%
push.khd.2345.cc,4,0.00%,624,620,0.64%
p2pupgrade.gamedl.qq.com,4,0.00%,1228,1224,0.33%
stat.gamedl.qq.com,4,0.00%,1194,1190,0.34%
ps2.gamedl.qq.com,4,0.00%,1184,1180,0.34%
config.gamedl.qq.com,4,0.00%,1286,1282,0.31%
p2pupdate.gamedl.qq.com,4,0.00%,1157,1153,0.35%
musicps.p2p.qq.com,4,0.00%,2334,2330,0.17%
meeting.tencent.com,4,0.00%,513,509,0.78%
cx.soft.360.cn,4,0.00%,1925,1921,0.21%
c.dun.163.com,4,0.00%,325,321,1.23%
erickson514-my.sharepoint.com,4,0.00%,783,779,0.51%
uf-api6-client.ksord.com,4,0.00%,346,342,1.16%
captcha.zhihu.com,4,0.00%,335,331,1.19%
px.ads.linkedin.cn,4,0.00%,223,219,1.79%
msgcenter.wps.cn,4,0.00%,595,591,0.67%
mumu.nie.netease.com,4,0.00%,593,589,0.67%
aistudio.n.shifen.com,4,0.00%,144,140,2.78%
input.shouji.sogou.com,4,0.00%,735,731,0.54%
array508.prod.do.dsp.mp.microsoft.com,4,0.00%,265,261,1.51%
onedscolprdeus09.eastus.cloudapp.azure.com,4,0.00%,112,108,3.57%
prod.balrog.prod.cloudops.mozgcp.net,4,0.00%,163,159,2.45%
dynsrv.wps.cn,4,0.00%,717,713,0.56%
clientlog3.music.163.com,4,0.00%,499,495,0.80%
oth.str.beacon.qq.com,4,0.00%,237,233,1.69%
www.xboxab.com,4,0.00%,256,252,1.56%
slb-browser-traffic.mbgcdn.lenovo.com.cn,4,0.00%,211,207,1.90%
odc.officeapps.live.com,4,0.00%,120,116,3.33%
node2.ayden.icu,4,0.00%,630,626,0.63%
db-safe.2345.cc,4,0.00%,114,110,3.51%
genuine.adobe.com,4,0.00%,176,172,2.27%
l-ring.msedge.net,4,0.00%,124,120,3.23%
hmma.baidu.com,4,0.00%,204,200,1.96%
ceea167a5a36dedd.jijifun.com,4,0.00%,750,746,0.53%
7a37563370ded05f.jijifun.com,4,0.00%,1054,1050,0.38%
tracker-cdn.moeking.me,4,0.00%,311,307,1.29%
v10.kwaicdn.com,4,0.00%,251,247,1.59%
onedscolprdeus14.eastus.cloudapp.azure.com,4,0.00%,114,110,3.51%
browserconf.vivo.com.cn,4,0.00%,127,123,3.15%
osfsr.lenovomm.com,3,0.00%,16964,16961,0.02%
hpd.baidu.com,3,0.00%,1400,1397,0.21%
dns.google,3,0.00%,23124,23121,0.01%
www.google-analytics.com,3,0.00%,1326,1323,0.23%
st.todesk.com,3,0.00%,1519,1516,0.20%
ts1.qq.com,3,0.00%,4906,4903,0.06%
doh.pub,3,0.00%,5456,5453,0.05%
app.wpscdn.cn,3,0.00%,414,411,0.72%
dr.cs3.duba.net,3,0.00%,730,727,0.41%
upext.chrome.360.cn,3,0.00%,363,360,0.83%
yun.tim.qq.com,3,0.00%,214,211,1.40%
i.snssdk.com,3,0.00%,451,448,0.67%
dlswbr.baidu.com,3,0.00%,740,737,0.41%
ssl.ptlogin2.qq.com,3,0.00%,413,410,0.73%
www.meituan.com,3,0.00%,1348,1345,0.22%
nsclick.baidu.com,3,0.00%,861,858,0.35%
als.baidu.com,3,0.00%,337,334,0.89%
update100.sangfor.com.cn,3,0.00%,2462,2459,0.12%
channels.weixin.qq.com,3,0.00%,409,406,0.73%
sp2.baidu.com,3,0.00%,824,821,0.36%
bingciservice.koreasouth.cloudapp.azure.com,3,0.00%,538,535,0.56%
retcode.taobao.com,3,0.00%,144,141,2.08%
pc-plugin.wpscdn.cn,3,0.00%,1004,1001,0.30%
vip-rec.ksord.com,3,0.00%,265,262,1.13%
www.overleaf.com,3,0.00%,729,726,0.41%
conf.wsm.360.cn,3,0.00%,1996,1993,0.15%
dualstack-a.apilocate.amap.com,3,0.00%,447,444,0.67%
push-rest.zui.com,3,0.00%,161,158,1.86%
dsm01pap003.storage.live.com,3,0.00%,105,102,2.86%
alive.github.com,3,0.00%,2610,2607,0.11%
zerossl.ocsp.sectigo.com,3,0.00%,375,372,0.80%
newvpn.arp.cn,3,0.00%,355,352,0.85%
event.csdn.net,3,0.00%,1335,1332,0.22%
report.url.cn,3,0.00%,3199,3196,0.09%
ssl.google-analytics.com,3,0.00%,354,351,0.85%
gitlab.com,3,0.00%,1601,1598,0.19%
cache.yisu.com,3,0.00%,137,134,2.19%
thunderx.rcv.sandai.net,3,0.00%,615,612,0.49%
stun.qqlive.qq.com,3,0.00%,1228,1225,0.24%
au.download.windowsupdate.com,3,0.00%,3062,3059,0.10%
s.360.cn,3,0.00%,3504,3501,0.09%
allall01.baidupcs.com,3,0.00%,832,829,0.36%
www2.public-trust.com,3,0.00%,245,242,1.22%
int.dpool.sina.com.cn,3,0.00%,381,378,0.79%
plussvr.wps.cn,3,0.00%,461,458,0.65%
asst-stat.ksord.com,3,0.00%,141,138,2.13%
service.dg.wps.cn,3,0.00%,206,203,1.46%
gfe.nvidia.com,3,0.00%,539,536,0.56%
imap.cstnet.cn,3,0.00%,572,569,0.52%
helpdubaservice.ksmobile.com,3,0.00%,166,163,1.81%
mccontacts.mail.163.com,3,0.00%,722,719,0.42%
pull-hls-f13.douyincdn.com,3,0.00%,725,722,0.41%
policy.video.iqiyi.com,3,0.00%,595,592,0.50%
china.bing123.com,3,0.00%,268,265,1.12%
asst-api.ksord.com,3,0.00%,148,145,2.03%
diskapi.n.shifen.com,3,0.00%,495,492,0.61%
suggestion.baidu.com,3,0.00%,260,257,1.15%
login2.dingtalk.com,3,0.00%,129,126,2.33%
login.im.qcloud.com,3,0.00%,375,372,0.80%
cohort.ccs.mcafee.com,3,0.00%,214,211,1.40%
2535-ipv4e.clump.dprodmgd106.aa-rt.sharepoint.com,3,0.00%,296,293,1.01%
www.microsoft.com-c-3.edgekey.net,3,0.00%,206,203,1.46%
lark-frontier-hl.snssdk.com,3,0.00%,140,137,2.14%
space.dingtalk.com,3,0.00%,128,125,2.34%
show-g.mediav.com,3,0.00%,283,280,1.06%
init-cdn.itunes-apple.com.akadns.net,3,0.00%,371,368,0.81%
chi01pap002.storage.live.com,3,0.00%,115,112,2.61%
top.baidu.com,3,0.00%,149,146,2.01%
pgdt.gtimg.cn,3,0.00%,1281,1278,0.23%
fclick.e.shifen.com,3,0.00%,110,107,2.73%
video.zhihu.com,3,0.00%,140,137,2.14%
v1.kwaicdn.com,3,0.00%,277,274,1.08%
asf-ris-prod-easia-azsc.eastasia.cloudapp.azure.com,3,0.00%,287,284,1.05%
common.be.1drv.com.l-0003.dc-msedge.net.l-0003.l-msedge.net,3,0.00%,196,193,1.53%
v2-cty05.kwaicdn.com,3,0.00%,248,245,1.21%
v2-cty06.kwaicdn.com,3,0.00%,249,246,1.20%
ocsp.godaddy.com,3,0.00%,107,104,2.80%
onedscolprdwus00.westus.cloudapp.azure.com,3,0.00%,108,105,2.78%
ipv6-static.dns.iqiyi.com,3,0.00%,129,126,2.33%
ia.51.la,3,0.00%,240,237,1.25%
ntp.ubuntu.com,2,0.00%,363307,363305,0.00%
c.skconf.f.360.cn,2,0.00%,1208,1206,0.17%
api.bilibili.com,2,0.00%,1854,1852,0.11%
sl-tk.oray.com,2,0.00%,15110,15108,0.01%
daisy.ubuntu.com,2,0.00%,51899,51897,0.00%
api.live.bilibili.com,2,0.00%,1134,1132,0.18%
grafana.com,2,0.00%,4439,4437,0.05%
bvc.bilivideo.com,2,0.00%,705,703,0.28%
array811.prod.do.dsp.mp.microsoft.com,2,0.00%,450,448,0.44%
www.ximalaya.com,2,0.00%,392,390,0.51%
ts2.qq.com,2,0.00%,4952,4950,0.04%
az700632.vo.msecnd.net,2,0.00%,1696,1694,0.12%
imap.qq.com,2,0.00%,3306,3304,0.06%
i.163.com,2,0.00%,653,651,0.31%
f5-ck.zhhainiao.com,2,0.00%,2149,2147,0.09%
badjs.weixinbridge.com,2,0.00%,1355,1353,0.15%
vipapi.wps.cn,2,0.00%,4254,4252,0.05%
mail.cstnet.cn,2,0.00%,12517,12515,0.02%
mp.weixin.qq.com,2,0.00%,2316,2314,0.09%
p13n.adobe.io,2,0.00%,627,625,0.32%
armmf.adobe.com,2,0.00%,205,203,0.98%
nexus.officeapps.live.com,2,0.00%,2605,2603,0.08%
upload.fp.measure.office.com,2,0.00%,1565,1563,0.13%
api.apple-cloudkit.com,2,0.00%,1464,1462,0.14%
h-adashx-internal.ut.taobao.com.gds.alibabadns.com,2,0.00%,269,267,0.74%
wp.mail.qq.com,2,0.00%,751,749,0.27%
graph.qq.com,2,0.00%,2369,2367,0.08%
cr.file.cloud.duba.net,2,0.00%,198,196,1.01%
pay.wps.cn,2,0.00%,1671,1669,0.12%
common.docer.wps.cn,2,0.00%,252,250,0.79%
win10.ipv6.microsoft.com,2,0.00%,12375,12373,0.02%
api.snapcraft.io,2,0.00%,2856,2854,0.07%
dns1.registrar-servers.com,2,0.00%,96664,96662,0.00%
p.f.360.cn,2,0.00%,2679,2677,0.07%
yun-hl.3g.qq.com,2,0.00%,927,925,0.22%
rmonitor.qq.com,2,0.00%,606,604,0.33%
restapi.amap.com,2,0.00%,500,498,0.40%
aaid.umeng.com,2,0.00%,470,468,0.43%
maps.windows.com,2,0.00%,289,287,0.69%
router4.teamviewer.com,2,0.00%,2489,2487,0.08%
client-api.oray.com,2,0.00%,1713,1711,0.12%
rq.upgrade.lbmini.cmcm.com,2,0.00%,2229,2227,0.09%
errlog.umeng.com,2,0.00%,483,481,0.41%
access.toggle.qq.com,2,0.00%,2001,1999,0.10%
secclientgw.alipay.com,2,0.00%,438,436,0.46%
array507.prod.do.dsp.mp.microsoft.com,2,0.00%,307,305,0.65%
agt.p.360.cn,2,0.00%,1523,1521,0.13%
akn.safe.360.cn,2,0.00%,2096,2094,0.10%
beacon.tingyun.com,2,0.00%,793,791,0.25%
www.googletagservices.com,2,0.00%,367,365,0.54%
odr.mookie1.com,2,0.00%,219,217,0.91%
id.rlcdn.com,2,0.00%,368,366,0.54%
us-u.openx.net,2,0.00%,208,206,0.96%
fp.msedge.net,2,0.00%,507,505,0.39%
author.baidu.com,2,0.00%,140,138,1.43%
i.baidu.com,2,0.00%,164,162,1.22%
router11.teamviewer.com,2,0.00%,2618,2616,0.08%
ts.qq.com,2,0.00%,2517,2515,0.08%
apilocate.amap.com,2,0.00%,211,209,0.95%
ocws.officeapps.live.com,2,0.00%,367,365,0.54%
shmmsns.qpic.cn,2,0.00%,2446,2444,0.08%
app-site-association.cdn-apple.com,2,0.00%,225,223,0.89%
mpvideo.qpic.cn,2,0.00%,243,241,0.82%
logintcp.wps.cn,2,0.00%,587,585,0.34%
iphone-ld.origin-apple.com.akadns.net,2,0.00%,234,232,0.85%
countly.mail.163.com,2,0.00%,442,440,0.45%
nsl.lenovo.com.cn,2,0.00%,1140,1138,0.18%
router2.teamviewer.com,2,0.00%,2855,2853,0.07%
c.y.qq.com,2,0.00%,1547,1545,0.13%
wup.browser.qq.com,2,0.00%,2960,2958,0.07%
conna.gj.qq.com,2,0.00%,1342,1340,0.15%
connb.gj.qq.com,2,0.00%,1237,1235,0.16%
weather2db.cmcm.com,2,0.00%,871,869,0.23%
api.t.sina.com.cn,2,0.00%,374,372,0.53%
bing.com,2,0.00%,961,959,0.21%
fanyi.baidu.com,2,0.00%,619,617,0.32%
c3.pcs.baidu.com,2,0.00%,807,805,0.25%
sat02pap005.storage.live.com,2,0.00%,229,227,0.87%
sharkwsbj.sankuai.com,2,0.00%,177,175,1.13%
spinfo.wps.cn,2,0.00%,338,336,0.59%
web.meituan.com,2,0.00%,182,180,1.10%
www.sogou.com,2,0.00%,1225,1223,0.16%
www.urbandictionary.com,2,0.00%,195,193,1.03%
www.youku.com,2,0.00%,995,993,0.20%
www.jetbrains.com,2,0.00%,1790,1788,0.11%
rq.lbcct.cloud.duba.net,2,0.00%,2221,2219,0.09%
aegis.qq.com,2,0.00%,1686,1684,0.12%
dmd.metaservices.microsoft.com,2,0.00%,517,515,0.39%
www.tm.lg.prod.aadmsa.akadns.net,2,0.00%,111,109,1.80%
packages.microsoft.com,2,0.00%,211,209,0.95%
security.ubuntu.com,2,0.00%,1610,1608,0.12%
ocsp.verisign.com,2,0.00%,636,634,0.31%
hsk-api.oray.com,2,0.00%,6648,6646,0.03%
g.msn.com,2,0.00%,141,139,1.42%
jrebel.npegeek.com,2,0.00%,818,816,0.24%
watson.telemetry.microsoft.com,2,0.00%,5477,5475,0.04%
edge-microsoft-com.dual-a-0036.a-msedge.NET,2,0.00%,378,376,0.53%
deault-exp-tas-com.e-0014.e-msedge.NET,2,0.00%,116,114,1.72%
dict.youdao.com,2,0.00%,1459,1457,0.14%
report.meeting.tencent.com,2,0.00%,194,192,1.03%
max-l.mediav.com,2,0.00%,582,580,0.34%
ts.helper.2345.cc,2,0.00%,270,268,0.74%
list.wallpaper.cloud.duba.net,2,0.00%,337,335,0.59%
wns2-sg2p.wns.windows.com,2,0.00%,140,138,1.43%
array605.prod.do.dsp.mp.microsoft.com,2,0.00%,825,823,0.24%
newxmp.rcv.sandai.net,2,0.00%,205,203,0.98%
weather-data.apple.com.akadns.net,2,0.00%,971,969,0.21%
mirrors.163.com,2,0.00%,539,537,0.37%
msg.video.dns.iqiyi.com,2,0.00%,212,210,0.94%
cntr.wps.cn,2,0.00%,724,722,0.28%
deault-exp-tas-com.e-0014.e-msedge.net,2,0.00%,1725,1723,0.12%
sdl.360safe.com,2,0.00%,1649,1647,0.12%
www.weibo.com,2,0.00%,1064,1062,0.19%
msgstore.www.notion.so,2,0.00%,216,214,0.93%
bk.ps2.gamedl.qq.com,2,0.00%,382,380,0.52%
pcfg.wps.cn,2,0.00%,1600,1598,0.12%
torrent.fedoraproject.org,2,0.00%,249,247,0.80%
download.pinyin.sogou.com,2,0.00%,653,651,0.31%
cc-api-data.adobe.io,2,0.00%,1021,1019,0.20%
ztxdjj-my.sharepoint.com,2,0.00%,415,413,0.48%
inf-faas.meituan.com,2,0.00%,173,171,1.16%
mmhead.c2c.wechat.com,2,0.00%,250,248,0.80%
n.guanjia.qq.com,2,0.00%,474,472,0.42%
logintcpnv.wps.cn,2,0.00%,217,215,0.92%
vpn.ios.ac.cn,2,0.00%,138,136,1.45%
spoc.norton.com,2,0.00%,467,465,0.43%
2csvr-basic.wpsdns.com,2,0.00%,106,104,1.89%
APAC02.azure-devices.net,2,0.00%,104,102,1.92%
dashi.163.com,2,0.00%,250,248,0.80%
jubao.qq.com,2,0.00%,102,100,1.96%
configuration.ls.apple.com,2,0.00%,1880,1878,0.11%
kunpeng-sc.csdnimg.cn,2,0.00%,149,147,1.34%
token.rubiconproject.com,2,0.00%,131,129,1.53%
dsum-sec.casalemedia.com,2,0.00%,156,154,1.28%
googlecm.hit.gemius.pl,2,0.00%,160,158,1.25%
push-rtmp-l26-cny.douyincdn.com,2,0.00%,554,552,0.36%
pull-rtmp-l6-cny.douyincdn.com,2,0.00%,770,768,0.26%
wns.notify.trafficmanager.net,2,0.00%,376,374,0.53%
array512.prod.do.dsp.mp.microsoft.com,2,0.00%,238,236,0.84%
mtdlp.sankuai.com,2,0.00%,196,194,1.02%
www.sina.com.cn,2,0.00%,5361,5359,0.04%
thirdqq.qlogo.cn,2,0.00%,170,168,1.18%
www.clarity.ms,2,0.00%,364,362,0.55%
msn-china.bing123.com,2,0.00%,103,101,1.94%
platform.bing.com,2,0.00%,317,315,0.63%
bbs-api.mihoyo.com,2,0.00%,146,144,1.37%
settings-prod-wus3-1.westus3.cloudapp.azure.com,2,0.00%,212,210,0.94%
s.f.qh-lb.com,2,0.00%,450,448,0.44%
vdn1.vzuu.com,2,0.00%,294,292,0.68%
gz-lb1.internet-g.spanner.alipaydns.com,2,0.00%,263,261,0.76%
diana.ie.sogou.com,2,0.00%,227,225,0.88%
info.52pcfree.com,2,0.00%,498,496,0.40%
musicpunch.p2p.qq.com,2,0.00%,168,166,1.19%
fe2.update.microsoft.com,2,0.00%,530,528,0.38%
blog-static.cnblogs.com,2,0.00%,161,159,1.24%
hdweb.mail.split.netease.com,2,0.00%,283,281,0.71%
cloudrest.mbgcdn.lenovo.com.cn,2,0.00%,196,194,1.02%
dict.ntes53.netease.com,2,0.00%,270,268,0.74%
vd6.l.qq.com,2,0.00%,127,125,1.57%
i0.hdslb.com.04f6a54d.c.cdnhwc1.com,2,0.00%,134,132,1.49%
ssxd.mediav.com,2,0.00%,420,418,0.48%
lbsgw.m.jd.com,2,0.00%,133,131,1.50%
securepubads.g.doubleclick.net,2,0.00%,306,304,0.65%
array511.prod.do.dsp.mp.microsoft.com,2,0.00%,365,363,0.55%
analytics.map.qq.com,2,0.00%,180,178,1.11%
log.u.wps.cn,2,0.00%,138,136,1.45%
thetracker.org,2,0.00%,202,200,0.99%
mirrorlist.centos.org,2,0.00%,435,433,0.46%
ocsp.comodoca.com,2,0.00%,103,101,1.94%
sp3.baidu.com,2,0.00%,172,170,1.16%
xsts.auth.xboxlive.com,2,0.00%,237,235,0.84%
search.bilibili.com,2,0.00%,104,102,1.92%
update.pan.n.shifen.com,2,0.00%,137,135,1.46%
array803.prod.do.dsp.mp.microsoft.com,2,0.00%,186,184,1.08%
ebad288.nd.gladns.com,2,0.00%,113,111,1.77%
www6.53kf.com,2,0.00%,464,462,0.43%
accwww6.53kf.com,2,0.00%,373,371,0.54%
ins-qw3q8ofk.ias.tencent-cloud.NET,2,0.00%,299,297,0.67%
v2-cty01.kwaicdn.com,2,0.00%,262,260,0.76%
v2-cty04.kwaicdn.com,2,0.00%,251,249,0.80%
inappcheck.itunes.apple.com.download.ks-cdn.com,2,0.00%,141,139,1.42%
dldir1.qq.com.mid.dcloudstc.com,2,0.00%,117,115,1.71%
mail.aliyun.com,2,0.00%,419,417,0.48%
mail.yeah.net,2,0.00%,410,408,0.49%
a.privatelink.msidentity.com,2,0.00%,124,122,1.61%
dataflow.biliapi.com.dy.galileo.jcloud-cdn.com,2,0.00%,295,293,0.68%
na61-na62.wagbridge.alibaba.alibaba.com.gds.alibabadns.com,2,0.00%,547,545,0.37%
l-0003.l-msedge.net,2,0.00%,229,227,0.87%
new.qq.com,2,0.00%,171,169,1.17%
v2-cty03.kwaicdn.com,2,0.00%,251,249,0.80%
v2-cty02.kwaicdn.com,2,0.00%,237,235,0.84%
hpd.a.shifen.com,2,0.00%,144,142,1.39%
team-speed-cdn-vip.xunlei.com,2,0.00%,173,171,1.16%
dc.applicationinsights.azure.com,2,0.00%,114,112,1.75%
array602.prod.do.dsp.mp.microsoft.com,2,0.00%,108,106,1.85%
pc-store.mbgstore.lenovo.com.cn,2,0.00%,130,128,1.54%
showxml.qq.com,2,0.00%,134,132,1.49%
stun.l.google.com,2,0.00%,209,207,0.96%
sconf.f.qh-lb.com,2,0.00%,128,126,1.56%
api-shoulei-ssl.xunlei.com,2,0.00%,108,106,1.85%
cc.f.qh-lb.com,2,0.00%,135,133,1.48%
avatars.githubusercontent.com,2,0.00%,144,142,1.39%
regops.uniregistry.link,2,0.00%,1042,1040,0.19%
www.163.com,1,0.00%,100696,100695,0.00%
connectivity-check.ubuntu.com,1,0.00%,53578,53577,0.00%
prod.ingestion-edge.prod.dataops.mozgcp.net,1,0.00%,461,460,0.22%
cs9.wac.phicdn.net,1,0.00%,302,301,0.33%
hsk-embed.oray.com,1,0.00%,9243,9242,0.01%
security.bilibili.com,1,0.00%,219,218,0.46%
passport.bilibili.com,1,0.00%,578,577,0.17%
ug.baidu.com,1,0.00%,1449,1448,0.07%
cm.bilibili.com,1,0.00%,1141,1140,0.09%
fm.dl.126.net,1,0.00%,722,721,0.14%
open.weixin.qq.com,1,0.00%,842,841,0.12%
tim.qq.com,1,0.00%,317,316,0.32%
wbapp.uve.weibo.com,1,0.00%,254,253,0.39%
p.qlogo.cn,1,0.00%,406,405,0.25%
bkvv.video.qq.com,1,0.00%,613,612,0.16%
info.zb.qq.com,1,0.00%,551,550,0.18%
rq.upgrade.cloud.duba.net,1,0.00%,2894,2893,0.03%
123.sogou.com,1,0.00%,650,649,0.15%
contile.services.mozilla.com,1,0.00%,10633,10632,0.01%
array609.prod.do.dsp.mp.microsoft.com,1,0.00%,336,335,0.30%
wx3.sinaimg.cn,1,0.00%,660,659,0.15%
wup.imtt.qq.com,1,0.00%,1404,1403,0.07%
www.toutiao.com,1,0.00%,441,440,0.23%
www.csdn.net,1,0.00%,10533,10532,0.01%
ocsp2.apple.com,1,0.00%,2708,2707,0.04%
c.msn.cn,1,0.00%,473,472,0.21%
pos.baidu.com,1,0.00%,1032,1031,0.10%
stdl.qq.com,1,0.00%,155,154,0.65%
js.aq.qq.com,1,0.00%,173,172,0.58%
passport.baidu.com,1,0.00%,1432,1431,0.07%
miao.baidu.com,1,0.00%,912,911,0.11%
sofire.baidu.com,1,0.00%,347,346,0.29%
wappass.baidu.com,1,0.00%,301,300,0.33%
www2.bing.com,1,0.00%,291,290,0.34%
bj.bcebos.com,1,0.00%,125,124,0.80%
hub5pnc.sandai.net,1,0.00%,1079,1078,0.09%
yungw.taobao.com,1,0.00%,496,495,0.20%
d.pcs.baidu.com,1,0.00%,1316,1315,0.08%
www.gravatar.com,1,0.00%,316,315,0.32%
pcoma.qq.com,1,0.00%,2066,2065,0.05%
sdkapp.mobile.sina.cn,1,0.00%,228,227,0.44%
login.sina.com.cn,1,0.00%,548,547,0.18%
sdkclick.biz.weibo.com,1,0.00%,107,106,0.93%
wbapp.mobile.sina.cn,1,0.00%,209,208,0.48%
pubsub02.oray.net,1,0.00%,11619,11618,0.01%
audid-api.taobao.com,1,0.00%,473,472,0.21%
ib.adnxs.com,1,0.00%,267,266,0.37%
www.beian.gov.cn,1,0.00%,232,231,0.43%
stun.services.mozilla.com,1,0.00%,698,697,0.14%
www.googleapis.com,1,0.00%,2768,2767,0.04%
vv.video.qq.com,1,0.00%,1476,1475,0.07%
interface3.music.163.com,1,0.00%,524,523,0.19%
array503.prod.do.dsp.mp.microsoft.com,1,0.00%,366,365,0.27%
router13.teamviewer.com,1,0.00%,2579,2578,0.04%
xg.pinduoduo.com,1,0.00%,167,166,0.60%
mambap2pvodh5.8686c.com,1,0.00%,218,217,0.46%
interface.bilibili.com,1,0.00%,203,202,0.49%
api.account.xiaomi.com,1,0.00%,334,333,0.30%
adashx.m.taobao.com,1,0.00%,542,541,0.18%
1-courier.sandbox.push.apple.com,1,0.00%,1018,1017,0.10%
bjbgp01.baidupcs.com,1,0.00%,551,550,0.18%
array504.prod.do.dsp.mp.microsoft.com,1,0.00%,889,888,0.11%
sl-collection.oray.net,1,0.00%,1529,1528,0.07%
w.deepl.com,1,0.00%,336,335,0.30%
events.gfe.nvidia.com,1,0.00%,27375,27374,0.00%
connipv6.tencent.com,1,0.00%,102,101,0.98%
im.eulix.xyz,1,0.00%,2645,2644,0.04%
pcsdata.baidu.com,1,0.00%,471,470,0.21%
array611.prod.do.dsp.mp.microsoft.com,1,0.00%,288,287,0.35%
i.meituan.com,1,0.00%,187,186,0.53%
tracker.openzim.org,1,0.00%,214,213,0.47%
color.docer.wps.cn,1,0.00%,1080,1079,0.09%
mam.netease.com,1,0.00%,1093,1092,0.09%
array801.prod.do.dsp.mp.microsoft.com,1,0.00%,281,280,0.36%
array809.prod.do.dsp.mp.microsoft.com,1,0.00%,296,295,0.34%
ppa.launchpad.net,1,0.00%,633,632,0.16%
account.jetbrains.com,1,0.00%,1125,1124,0.09%
yj.52pcfree.com,1,0.00%,146,145,0.68%
cloudconfig.jetbrains.com,1,0.00%,280,279,0.36%
array615.prod.do.dsp.mp.microsoft.com,1,0.00%,307,306,0.33%
nexus-websocket-a.intercom.io,1,0.00%,394,393,0.25%
pcapp-update.youku.com,1,0.00%,206,205,0.49%
szshort.weixin.qq.com,1,0.00%,632,631,0.16%
1.courier-sandbox-push-apple.com.akadns.net,1,0.00%,329,328,0.30%
weather-data.apple.com,1,0.00%,3299,3298,0.03%
l.qq.com,1,0.00%,185,184,0.54%
dp3.qq.com,1,0.00%,287,286,0.35%
targetednotifications-tm.trafficmanager.net,1,0.00%,385,384,0.26%
cyes.youku.com,1,0.00%,182,181,0.55%
title.mgt.xboxlive.com,1,0.00%,139,138,0.72%
bttracker.debian.org,1,0.00%,141,140,0.71%
drive.kdocs.cn,1,0.00%,225,224,0.44%
tracker.moeblog.cn,1,0.00%,385,384,0.26%
www.kanjiantu.com,1,0.00%,295,294,0.34%
time-macos.apple.com,1,0.00%,346,345,0.29%
dyncli.ping-ipv6.com,1,0.00%,20387,20386,0.00%
gateway.kugou.com,1,0.00%,427,426,0.23%
linux.kite.com,1,0.00%,766,765,0.13%
s.xinshuru.com,1,0.00%,456,455,0.22%
t.helper.2345.cc,1,0.00%,691,690,0.14%
www.n1ui5fms.net,1,0.00%,183,182,0.55%
dns1.p03.nsone.net,1,0.00%,1477,1476,0.07%
dns2.p03.nsone.net,1,0.00%,1485,1484,0.07%
ns2.siteground.net,1,0.00%,6260,6259,0.02%
dns3.p03.nsone.net,1,0.00%,1465,1464,0.07%
a.ezdnscenter.com,1,0.00%,419,418,0.24%
push2.eastmoney.com,1,0.00%,717,716,0.14%
ns01.domaincontrol.com,1,0.00%,7734,7733,0.01%
builds.parsecgaming.com,1,0.00%,219,218,0.46%
baike.baidu.com,1,0.00%,700,699,0.14%
25-courier.push.apple.com,1,0.00%,511,510,0.20%
8-courier.push.apple.com,1,0.00%,534,533,0.19%
3-courier.push.apple.com,1,0.00%,488,487,0.20%
ocsp2-cn-lb.apple.com.akadns.net,1,0.00%,258,257,0.39%
6fe97759aa27a0c9.jijifun.com,1,0.00%,588,587,0.17%
h5.sinaimg.cn,1,0.00%,457,456,0.22%
api-access.pangolin-sdk-toutiao.com,1,0.00%,1266,1265,0.08%
c.cnzz.com,1,0.00%,154,153,0.65%
mirrors.ustc.edu.cn,1,0.00%,389,388,0.26%
msg.csdn.net,1,0.00%,583,582,0.17%
registry.npmjs.org,1,0.00%,486,485,0.21%
cstm.baidu.com,1,0.00%,422,421,0.24%
array610.prod.do.dsp.mp.microsoft.com,1,0.00%,323,322,0.31%
pull-flv-f26.douyincdn.com,1,0.00%,750,749,0.13%
geover.prod.do.dsp.mp.microsoft.com,1,0.00%,915,914,0.11%
res.qhupdate.com,1,0.00%,210,209,0.48%
docs.live.net,1,0.00%,665,664,0.15%
motd.ubuntu.com,1,0.00%,678,677,0.15%
orange-pcsafe.2345.cc,1,0.00%,551,550,0.18%
onedriveclucprodbn20047.blob.core.windows.net,1,0.00%,273,272,0.37%
oss.weread.qq.com,1,0.00%,105,104,0.95%
tracker.uw0.xyz,1,0.00%,568,567,0.18%
browser6.qhimg.com,1,0.00%,582,581,0.17%
ns3.whoisdomain.kr,1,0.00%,370,369,0.27%
hub.docker.com,1,0.00%,264,263,0.38%
ns-os1.qq.com,1,0.00%,222,221,0.45%
bj.pcsdownload.n.shifen.com,1,0.00%,132,131,0.76%
ossapi.baidu.com,1,0.00%,227,226,0.44%
ext.baidu.com,1,0.00%,284,283,0.35%
displaycatalog.mp.microsoft.com,1,0.00%,270,269,0.37%
auth-v2.oray.com,1,0.00%,430,429,0.23%
i.gtimg.cn,1,0.00%,259,258,0.39%
vdn3.vzuu.com,1,0.00%,393,392,0.25%
reports.baidu.com,1,0.00%,146,145,0.68%
ip.parrotdns.com,1,0.00%,1039,1038,0.10%
pop.ie.sogou.com,1,0.00%,224,223,0.45%
array509.prod.do.dsp.mp.microsoft.com,1,0.00%,282,281,0.35%
update-haozip.2345.cc,1,0.00%,127,126,0.79%
url-query.api.pc120.com,1,0.00%,150,149,0.67%
ue.mbgstore.lenovo.com.cn,1,0.00%,208,207,0.48%
gz3.520vpn.us,1,0.00%,215,214,0.47%
login.weixin.qq.com,1,0.00%,406,405,0.25%
nleditor.osi.office.net,1,0.00%,696,695,0.14%
extensions.gnome.org,1,0.00%,135,134,0.74%
sadownload-new.mcafee.com.edgekey.net,1,0.00%,150,149,0.67%
edge-microsoft-com.dual-a-0036.a-msedge.net,1,0.00%,664,663,0.15%
sat02pap001.storage.live.com,1,0.00%,129,128,0.78%
m.360buyimg.com,1,0.00%,276,275,0.36%
github-cloud.s3.amazonaws.com,1,0.00%,141,140,0.71%
download.gfe.nvidia.com,1,0.00%,105,104,0.95%
st.pinyin.sogou.com,1,0.00%,340,339,0.29%
bnz05pap001.storage.live.com,1,0.00%,182,181,0.55%
blades.aliyun.com,1,0.00%,301,300,0.33%
c.urs.microsoft.com,1,0.00%,321,320,0.31%
tracker.nighthawk.pw,1,0.00%,142,141,0.70%
tracker.kamigami.org,1,0.00%,150,149,0.67%
p.ssl.img.360kuai.com,1,0.00%,137,136,0.73%
t.captcha.qq.com,1,0.00%,167,166,0.60%
continuum.dds.microsoft.com,1,0.00%,366,365,0.27%
mat1.gtimg.com,1,0.00%,160,159,0.62%
s.search.bilibili.com,1,0.00%,106,105,0.94%
dsm01pap006.storage.live.com,1,0.00%,198,197,0.51%
tracker.tamersunion.org,1,0.00%,306,305,0.33%
browser.pipe.aria.microsoft.com,1,0.00%,247,246,0.40%
api.fanyi.baidu.com,1,0.00%,115,114,0.87%
adse.ximalaya.com,1,0.00%,193,192,0.52%
w.wwwww.wtf,1,0.00%,291,290,0.34%
sns-img-qc.xhscdn.com,1,0.00%,112,111,0.89%
www.ixigua.com,1,0.00%,206,205,0.49%
www.microsoft.com-c-3.edgekey.net.globalredir.akadns.net,1,0.00%,124,123,0.81%
3463d06de0ca9a15.jijifun.com,1,0.00%,193,192,0.52%
wildcard46.go-mpulse.net.edgekey.net,1,0.00%,297,296,0.34%
stsdk.vivo.com.cn,1,0.00%,121,120,0.83%
h5.ssp.qq.com,1,0.00%,120,119,0.83%
js2.a.yximgs.com,1,0.00%,281,280,0.36%
jscmmov.a.etoote.com,1,0.00%,239,238,0.42%
collect-v6.51.la,1,0.00%,117,116,0.85%
find.qq.com,1,0.00%,193,192,0.52%
cgi.qqweb.qq.com,1,0.00%,258,257,0.39%
cgi.find.qq.com,1,0.00%,203,202,0.49%
trace.qq.com,1,0.00%,165,164,0.61%
pacaio.match.qq.com,1,0.00%,144,143,0.69%
jianyi.baidu.com,1,0.00%,111,110,0.90%
g.us.sinaimg.cn,1,0.00%,106,105,0.94%
array607.prod.do.dsp.mp.microsoft.com,1,0.00%,161,160,0.62%
APAC04.azure-devices.net,1,0.00%,234,233,0.43%
rili.update.updrv.com,1,0.00%,131,130,0.76%
hub5pn.sandai.net,1,0.00%,216,215,0.46%
spclient.wg.spotify.com,1,0.00%,154,153,0.65%
ns19.xincache.com,1,0.00%,169,168,0.59%
local.info.g9hc4.cn,1,0.00%,134,133,0.75%
iscas1-my.sharepoint.cn,1,0.00%,205,204,0.49%
waws-prod-sg1-051.cloudapp.NET,1,0.00%,150,149,0.67%
asimov.vortex.data.trafficmanager.NET,1,0.00%,122,121,0.82%
api.cloud.189.cn,1,0.00%,303,302,0.33%
teredo-debian.remlab.net,0,0.00%,1081,1081,0.00%
dl.min.io,0,0.00%,18016,18016,0.00%
rm-bp151dcc75aycqd80to.mysql.rds.aliyuncs.com,0,0.00%,108,108,0.00%
clock.isc.org,0,0.00%,502,502,0.00%
edragent.sangfor.com.cn,0,0.00%,30448,30448,0.00%
query.hicloud.com,0,0.00%,85376,85376,0.00%
bash.givemexyz.in,0,0.00%,6424,6424,0.00%
up-hl.3g.qq.com,0,0.00%,236,236,0.00%
space.bilibili.com,0,0.00%,126,126,0.00%
analytics.yinxiang.com,0,0.00%,2331,2331,0.00%
nav-edge.smartscreen.microsoft.com,0,0.00%,1822,1822,0.00%
39-courier.push.apple.com,0,0.00%,507,507,0.00%
hectorstatic.baidu.com,0,0.00%,1886,1886,0.00%
10-courier.push.apple.com,0,0.00%,526,526,0.00%
log.tailscale.io,0,0.00%,8225,8225,0.00%
api.miwifi.com,0,0.00%,42230,42230,0.00%
smtp.qq.com,0,0.00%,1654,1654,0.00%
bili-dyn-sched.jcloud-cdn.com,0,0.00%,635,635,0.00%
time.pool.aliyun.com,0,0.00%,143,143,0.00%
alpha-cloud-log.cn-hangzhou.log.aliyuncs.com,0,0.00%,1537,1537,0.00%
config.app.yinxiang.com,0,0.00%,163,163,0.00%
rq.drcct.cloud.duba.net,0,0.00%,4178,4178,0.00%
lp.open.weixin.qq.com,0,0.00%,812,812,0.00%
soup.v.qq.com,0,0.00%,1125,1125,0.00%
cb10bdfbd90f88db560d0ad1e8f78722.dlied1.cdntips.net,0,0.00%,123,123,0.00%
packages.deepin.com,0,0.00%,5080,5080,0.00%
flbgpi.yixuedianzishu.com,0,0.00%,1020,1020,0.00%
cloud.acrobat.com,0,0.00%,147,147,0.00%
static.asm.skype.com,0,0.00%,758,758,0.00%
static-asm.secure.skypeassets.com,0,0.00%,650,650,0.00%
ce571486-i.andns.co,0,0.00%,314,314,0.00%
autoupdater.updrv.com,0,0.00%,2162,2162,0.00%
usercount.dockernb.com,0,0.00%,710,710,0.00%
dns.cloudflare.com,0,0.00%,1189,1189,0.00%
s1a.time.edu.cn,0,0.00%,683,683,0.00%
public.dns.iij.jp,0,0.00%,6722,6722,0.00%
telemetry-in.battlenet.com.cn,0,0.00%,861,861,0.00%
controlplane.tailscale.com,0,0.00%,3485,3485,0.00%
zh.us.to,0,0.00%,109,109,0.00%
rq.upgrade.drivergenius.com,0,0.00%,3347,3347,0.00%
proxy.client.163.com,0,0.00%,907,907,0.00%
lbs.mail.163.com,0,0.00%,411,411,0.00%
api.zotero.org,0,0.00%,872,872,0.00%
high-frequency-gray.zhhainiao.com,0,0.00%,2752,2752,0.00%
authds.todesk.com,0,0.00%,4134,4134,0.00%
wechat.todesk.com,0,0.00%,177,177,0.00%
rubyfish.cn,0,0.00%,1391,1391,0.00%
cn-zjcm2.testfaj.top,0,0.00%,204,204,0.00%
dl-ovh01.amna.shop,0,0.00%,766,766,0.00%
account-public-service-prod03.ol.epicgames.com,0,0.00%,571,571,0.00%
gateway.im.weibo.cn,0,0.00%,430,430,0.00%
dp.im.weibo.cn,0,0.00%,412,412,0.00%
conn4.coloros.com,0,0.00%,397,397,0.00%
apd-pcdnwxlogin.teg.tencent-cloud.net,0,0.00%,39380,39380,0.00%
data.bilivideo.com,0,0.00%,422,422,0.00%
apd-pcdnwxstat.teg.tencent-cloud.net,0,0.00%,2672,2672,0.00%
conn3.coloros.com,0,0.00%,240,240,0.00%
android.bugly.qq.com,0,0.00%,754,754,0.00%
adashx.ut.dingtalk.com,0,0.00%,478,478,0.00%
wx.mail.qq.com,0,0.00%,341,341,0.00%
sdk.e.qq.com,0,0.00%,719,719,0.00%
sdkapp.uve.weibo.com,0,0.00%,289,289,0.00%
wx4.sinaimg.cn,0,0.00%,624,624,0.00%
fedoraproject.org,0,0.00%,748,748,0.00%
array606.prod.do.dsp.mp.microsoft.com,0,0.00%,493,493,0.00%
ipv4only.arpa,0,0.00%,17717,17717,0.00%
mpv6.weixin.qq.com,0,0.00%,179,179,0.00%
docs.wps.cn,0,0.00%,115,115,0.00%
ip.sb,0,0.00%,2116,2116,0.00%
api.geetest.com,0,0.00%,484,484,0.00%
api.atlassian.com,0,0.00%,380,380,0.00%
bam.nr-data.net.cdn.cloudflare.net,0,0.00%,255,255,0.00%
resolver.msg.xiaomi.net,0,0.00%,450,450,0.00%
tracker.foreverpirates.co,0,0.00%,349,349,0.00%
tva4.sinaimg.cn,0,0.00%,278,278,0.00%
v2.get.sogou.com,0,0.00%,1732,1732,0.00%
wx1.sinaimg.cn,0,0.00%,665,665,0.00%
mail.google.com,0,0.00%,1824,1824,0.00%
bam.nr-data.net,0,0.00%,1385,1385,0.00%
short.weixin.qq.com,0,0.00%,1236,1236,0.00%
smarthome.hicloud.com,0,0.00%,256,256,0.00%
metrics1.data.hicloud.com,0,0.00%,2626,2626,0.00%
example.org,0,0.00%,7484,7484,0.00%
bitbucket.org,0,0.00%,161,161,0.00%
nodestore.logitech.io,0,0.00%,136,136,0.00%
win1910.ipv6.microsoft.com,0,0.00%,182,182,0.00%
ex.qq.com,0,0.00%,532,532,0.00%
sns-img-hw.xhscdn.com,0,0.00%,270,270,0.00%
dig.lianjia.com,0,0.00%,351,351,0.00%
gorgon.youdao.com,0,0.00%,210,210,0.00%
events-drcn.op.dbankcloud.cn,0,0.00%,558,558,0.00%
22-courier.push.apple.com,0,0.00%,561,561,0.00%
cidian.youdao.com,0,0.00%,351,351,0.00%
metrics1-drcn.dt.dbankcloud.cn,0,0.00%,1461,1461,0.00%
apple.com,0,0.00%,3936,3936,0.00%
time.g.aaplimg.com,0,0.00%,3496,3496,0.00%
puv.tt.browser.360.cn,0,0.00%,2582,2582,0.00%
udpcache.gnvip.net,0,0.00%,619,619,0.00%
passport.escience.cn,0,0.00%,639,639,0.00%
api.safe.360.cn,0,0.00%,4221,4221,0.00%
szlong.weixin.qq.com,0,0.00%,1206,1206,0.00%
software.drivergenius.com,0,0.00%,991,991,0.00%
u6.y.qq.com,0,0.00%,314,314,0.00%
guzzoni.apple.com,0,0.00%,1363,1363,0.00%
alert-cn.battlenet.com.cn,0,0.00%,769,769,0.00%
gsp0.baidu.com,0,0.00%,744,744,0.00%
weather-drcn.music.dbankcloud.cn,0,0.00%,670,670,0.00%
a2p-s01-drcn.cloud.dbankcloud.cn,0,0.00%,289,289,0.00%
dispatcher.is.autonavi.com,0,0.00%,806,806,0.00%
gspe35-ssl.ls.apple.com,0,0.00%,777,777,0.00%
vip.foxitreader.cn,0,0.00%,653,653,0.00%
4e3fbc91775832759f33b21e514bb29c.dlied1.cdntips.net,0,0.00%,150,150,0.00%
mlextshort.weixin.qq.com,0,0.00%,190,190,0.00%
api.apple-cloudkit.fe.apple-dns.net,0,0.00%,1111,1111,0.00%
gitee.com,0,0.00%,2045,2045,0.00%
exmail.qq.com,0,0.00%,765,765,0.00%
in.appcenter.ms,0,0.00%,1143,1143,0.00%
f8ed5d21a44b0e58.jijifun.com,0,0.00%,218,218,0.00%
midinfo.baofeng.com,0,0.00%,2569,2569,0.00%
softcenter-all.os.nfschina.com,0,0.00%,1375,1375,0.00%
i.work.weixin.qq.com,0,0.00%,732,732,0.00%
hector.baidu.com,0,0.00%,470,470,0.00%
apd-pcdnwxnat.teg.tencent-cloud.net,0,0.00%,2775,2775,0.00%
time-ios.g.aaplimg.com,0,0.00%,1604,1604,0.00%
cgicol.amap.com,0,0.00%,2031,2031,0.00%
buy.itunes-apple.com.akadns.net,0,0.00%,160,160,0.00%
pv.sohu.com,0,0.00%,446,446,0.00%
v2.sohu.com,0,0.00%,156,156,0.00%
api.share.baidu.com,0,0.00%,155,155,0.00%
ssl.ptlogin2.graph.qq.com,0,0.00%,2432,2432,0.00%
wn.pos.baidu.com,0,0.00%,626,626,0.00%
user.qzone.qq.com,0,0.00%,428,428,0.00%
i.gdt.qq.com,0,0.00%,105,105,0.00%
eclick.baidu.com,0,0.00%,840,840,0.00%
mail.qq.com,0,0.00%,1188,1188,0.00%
connectivitycheck.platform.hicloud.com,0,0.00%,19854,19854,0.00%
connectivitycheck.cbg-app.huawei.com,0,0.00%,617,617,0.00%
unionsug.baidu.com,0,0.00%,293,293,0.00%
imap.exmail.qq.com,0,0.00%,204,204,0.00%
tieba.baidu.com,0,0.00%,863,863,0.00%
ada.baidu.com,0,0.00%,271,271,0.00%
task.browser.360.cn,0,0.00%,1397,1397,0.00%
darkreader.org,0,0.00%,138,138,0.00%
cloud.huawei.com,0,0.00%,116,116,0.00%
anv.duba.net,0,0.00%,227,227,0.00%
rm.api.weibo.com,0,0.00%,1515,1515,0.00%
show-3.mediav.com,0,0.00%,164,164,0.00%
api.aliyundrive.com,0,0.00%,832,832,0.00%
asimov.vortex.data.trafficmanager.net,0,0.00%,473,473,0.00%
bsg.w.bilicdn1.com,0,0.00%,1127,1127,0.00%
xui.ptlogin2.qq.com,0,0.00%,2368,2368,0.00%
fanyi.youdao.com,0,0.00%,271,271,0.00%
rq.cct.cloud.duba.net,0,0.00%,4128,4128,0.00%
node.video.qq.com,0,0.00%,1740,1740,0.00%
access.video.qq.com,0,0.00%,2332,2332,0.00%
hp3.mail.netease.com,0,0.00%,1031,1031,0.00%
vinci.ie.sogou.com,0,0.00%,108,108,0.00%
mbd.baidu.com,0,0.00%,894,894,0.00%
pushtrs.push.hicloud.com,0,0.00%,1478,1478,0.00%
www.jos.org.cn,0,0.00%,266,266,0.00%
ovo.cn2.llsmall.com,0,0.00%,429,429,0.00%
ex.exmail.qq.com,0,0.00%,151,151,0.00%
pcmgrmonitor.3g.qq.com,0,0.00%,168,168,0.00%
e.so.com,0,0.00%,118,118,0.00%
arms-retcode.aliyuncs.com,0,0.00%,295,295,0.00%
gm.mmstat.com,0,0.00%,895,895,0.00%
wenku.baidu.com,0,0.00%,861,861,0.00%
site.browser.360.cn,0,0.00%,106,106,0.00%
tconf.b.qianxin.com,0,0.00%,420,420,0.00%
loc.map.baidu.com,0,0.00%,2456,2456,0.00%
openlocation-drcn.platform.dbankcloud.com,0,0.00%,1257,1257,0.00%
migration-geo-filter-prd.stargate.cse.ss-inf.net,0,0.00%,196,196,0.00%
www.dadiyouhui01.cn,0,0.00%,595,595,0.00%
eeth9boh.nodedata.net,0,0.00%,446,446,0.00%
gateway.lianjia.com,0,0.00%,253,253,0.00%
mail.iie.ac.cn,0,0.00%,666,666,0.00%
www.tnas.online,0,0.00%,117,117,0.00%
32-courier.push.apple.com,0,0.00%,561,561,0.00%
database.clamav.net,0,0.00%,2501,2501,0.00%
feelchat2.virbox.com,0,0.00%,230,230,0.00%
mtalk.google.com,0,0.00%,5330,5330,0.00%
configserver.hicloud.com,0,0.00%,782,782,0.00%
p.s.360.cn,0,0.00%,369,369,0.00%
dnkeeper.platform.dbankcloud.cn,0,0.00%,1269,1269,0.00%
store-drcn.hispace.dbankcloud.cn,0,0.00%,1254,1254,0.00%
tsms-drcn.platform.dbankcloud.com,0,0.00%,167,167,0.00%
tsms-drcn.security.dbankcloud.cn,0,0.00%,190,190,0.00%
rms-drcn.platform.dbankcloud.cn,0,0.00%,191,191,0.00%
mozilla.cloudflare-dns.com,0,0.00%,477,477,0.00%
alt5-mtalk.google.com,0,0.00%,125,125,0.00%
48afe871-i.andns.co,0,0.00%,186,186,0.00%
th-a.pinduoduo.com,0,0.00%,385,385,0.00%
hiboardng.hicloud.com,0,0.00%,275,275,0.00%
sp.sangfor.com.cn,0,0.00%,6703,6703,0.00%
applog.uc.cn,0,0.00%,446,446,0.00%
goldengate.grammarly.com,0,0.00%,2208,2208,0.00%
boot-01.net.anydesk.com,0,0.00%,2385,2385,0.00%
policy.ccs.mcafee.com,0,0.00%,135,135,0.00%
www.scumall.com,0,0.00%,2211,2211,0.00%
www.oray.com,0,0.00%,1588,1588,0.00%
tkysenwhezsrteagubzihkhhxcbhhsyc.yundunwaf1.com,0,0.00%,1420,1420,0.00%
c2.pcs.baidu.com,0,0.00%,765,765,0.00%
auth.sangfor.com.cn,0,0.00%,13648,13648,0.00%
a.root-servers.net,0,0.00%,43922,43922,0.00%
dsm01pap004.storage.live.com,0,0.00%,136,136,0.00%
sdk-open-phone.getui.com,0,0.00%,899,899,0.00%
www.doc88.com,0,0.00%,215,215,0.00%
win8.ipv6.microsoft.com,0,0.00%,8909,8909,0.00%
oth.str.mdt.qq.com,0,0.00%,941,941,0.00%
weibo.cn,0,0.00%,542,542,0.00%
docs.qq.com,0,0.00%,2317,2317,0.00%
quay.io,0,0.00%,982,982,0.00%
amdc.alipay.com,0,0.00%,255,255,0.00%
sdkaction.biz.weibo.com,0,0.00%,137,137,0.00%
sdkmonitor.biz.weibo.com,0,0.00%,171,171,0.00%
adstrategy.biz.weibo.com,0,0.00%,297,297,0.00%
messaging.ccs.mcafee.com,0,0.00%,231,231,0.00%
qqdata.ab.qq.com,0,0.00%,1173,1173,0.00%
configsvr.msf.3g.qq.com,0,0.00%,911,911,0.00%
aeventlog.beacon.qq.com,0,0.00%,625,625,0.00%
socm.dmp.360.cn,0,0.00%,2628,2628,0.00%
hkb.cloudnnnn.com,0,0.00%,4870,4870,0.00%
p204-contacts.icloud.com.cn,0,0.00%,165,165,0.00%
long.weixin.qq.com,0,0.00%,1608,1608,0.00%
sdkserver-drcn.op.dbankcloud.cn,0,0.00%,540,540,0.00%
pop.qq.com,0,0.00%,372,372,0.00%
softcenter.os3.win.nfschina.com,0,0.00%,750,750,0.00%
api.wandb.ai,0,0.00%,1215,1215,0.00%
28-courier.push.apple.com,0,0.00%,504,504,0.00%
alsg-new.linyeming.pub,0,0.00%,169,169,0.00%
isrc.iscas.ac.cn,0,0.00%,1436,1436,0.00%
note.youdao.com,0,0.00%,17895,17895,0.00%
ssl.mail.163.com,0,0.00%,305,305,0.00%
grs.dbankcloud.com,0,0.00%,1164,1164,0.00%
weibo.com,0,0.00%,4147,4147,0.00%
time-ios.apple.com,0,0.00%,387,387,0.00%
42-courier.push.apple.com,0,0.00%,508,508,0.00%
tracking.miui.com,0,0.00%,1545,1545,0.00%
www.m9ynqi6d.com,0,0.00%,2096,2096,0.00%
m.baidu.com,0,0.00%,981,981,0.00%
hwid.platform.hicloud.com,0,0.00%,184,184,0.00%
apis.live.net,0,0.00%,107,107,0.00%
upd2.sangfor.com.cn,0,0.00%,417,417,0.00%
auth2.sangfor.com.cn,0,0.00%,1022,1022,0.00%
dns.twnic.tw,0,0.00%,3410,3410,0.00%
skl.la1.mclqp.link,0,0.00%,130,130,0.00%
router3.teamviewer.com,0,0.00%,2823,2823,0.00%
report.idqqimg.com,0,0.00%,1115,1115,0.00%
r1---sn-2x3elnel.gvt1.com,0,0.00%,114,114,0.00%
log.tbs.qq.com,0,0.00%,1809,1809,0.00%
31-courier.push.apple.com,0,0.00%,549,549,0.00%
onetag-sys.com,0,0.00%,294,294,0.00%
34-courier.push.apple.com,0,0.00%,492,492,0.00%
sbeacon.sina.com.cn,0,0.00%,195,195,0.00%
vcl-brain.snssdk.com,0,0.00%,396,396,0.00%
tvax4.sinaimg.cn,0,0.00%,518,518,0.00%
tvax2.sinaimg.cn,0,0.00%,627,627,0.00%
dnsscan.shadowserver.org,0,0.00%,260,260,0.00%
webrtcpunch.video.qq.com,0,0.00%,179,179,0.00%
btrace.video.qq.com,0,0.00%,148,148,0.00%
cfg.imtt.qq.com,0,0.00%,134,134,0.00%
supl.platform.hicloud.com,0,0.00%,142,142,0.00%
r2---sn-2x3elnez.gvt1.com,0,0.00%,122,122,0.00%
wx.qq.com,0,0.00%,430,430,0.00%
api3.gifshow.com,0,0.00%,104,104,0.00%
gsp85-cn-ssl.ls.apple.com,0,0.00%,1322,1322,0.00%
s-gm.mmstat.com,0,0.00%,140,140,0.00%
dualstack-logs.amap.com,0,0.00%,366,366,0.00%
cloudflare-dns.com,0,0.00%,2857,2857,0.00%
api.github.com,0,0.00%,2855,2855,0.00%
data.pendo.io,0,0.00%,110,110,0.00%
d2kaokxjvx18eu.cloudfront.net,0,0.00%,127,127,0.00%
loggw.alipay.com.cn,0,0.00%,200,200,0.00%
beacon-api.aliyuncs.com,0,0.00%,488,488,0.00%
centertime.ksyun.com,0,0.00%,250,250,0.00%
api.kingdata.ksyun.com,0,0.00%,241,241,0.00%
filehouse.zhhainiao.com,0,0.00%,683,683,0.00%
relay-b8d08ecc.net.anydesk.com,0,0.00%,1263,1263,0.00%
mpush-api.aliyun.com,0,0.00%,241,241,0.00%
router16.teamviewer.com,0,0.00%,2842,2842,0.00%
api.ad.xiaomi.com,0,0.00%,1017,1017,0.00%
sdkconfig.ad.xiaomi.com,0,0.00%,468,468,0.00%
profile.csdnimg.cn,0,0.00%,723,723,0.00%
silkroad.csdn.net,0,0.00%,613,613,0.00%
minor-api.mihoyo.com,0,0.00%,126,126,0.00%
c.pcs.baidu.com,0,0.00%,511,511,0.00%
ifs.tanx.com,0,0.00%,193,193,0.00%
cloud.dell.com,0,0.00%,285,285,0.00%
b1h.zemanta.com,0,0.00%,126,126,0.00%
search.apps.ubuntu.com,0,0.00%,505,505,0.00%
nj.t.bcsp2p.baidu.com,0,0.00%,2932,2932,0.00%
ww1097.smartadserver.com,0,0.00%,138,138,0.00%
lbs.map.qq.com,0,0.00%,593,593,0.00%
metok.sys.miui.com,0,0.00%,394,394,0.00%
sync.1rx.io,0,0.00%,116,116,0.00%
tt.browser.360.cn,0,0.00%,944,944,0.00%
tva2.sinaimg.cn,0,0.00%,272,272,0.00%
healthdata.hicloud.com,0,0.00%,502,502,0.00%
mobads.baidu.com,0,0.00%,113,113,0.00%
stun.hitv.com,0,0.00%,123,123,0.00%
dns.weixin.qq.com,0,0.00%,2976,2976,0.00%
hag-drcn.op.hicloud.com,0,0.00%,299,299,0.00%
seupdate.360safe.com,0,0.00%,479,479,0.00%
b-gtc.gepush.com,0,0.00%,148,148,0.00%
kunyu.csdn.net,0,0.00%,404,404,0.00%
seapp.stat.360safe.com,0,0.00%,387,387,0.00%
crteam.cn,0,0.00%,316,316,0.00%
gdfp.gifshow.com,0,0.00%,291,291,0.00%
router5.teamviewer.com,0,0.00%,2712,2712,0.00%
support.weixin.qq.com,0,0.00%,749,749,0.00%
a-0001.a-msedge.net,0,0.00%,127,127,0.00%
apm.hexin.cn,0,0.00%,160,160,0.00%
nowcoder.cn-hangzhou.log.aliyuncs.com,0,0.00%,131,131,0.00%
pbjs.e-planning.net,0,0.00%,206,206,0.00%
blog.csdn.net,0,0.00%,1018,1018,0.00%
c.tmyzer.com,0,0.00%,339,339,0.00%
dns.pub,0,0.00%,7743,7743,0.00%
smtp.nfschina.com,0,0.00%,230,230,0.00%
safebrowsing.urlsec.qq.com,0,0.00%,2127,2127,0.00%
natdetection.onethingpcs.com,0,0.00%,236,236,0.00%
conf-darwin.xycdn.com,0,0.00%,751,751,0.00%
tp-b.pinduoduo.com,0,0.00%,439,439,0.00%
35-courier.push.apple.com,0,0.00%,577,577,0.00%
v.gdt.qq.com,0,0.00%,260,260,0.00%
ios.rqd.qq.com,0,0.00%,518,518,0.00%
alfred.ixiacom.com,0,0.00%,3278,3278,0.00%
router7.teamviewer.com,0,0.00%,2885,2885,0.00%
a.sox.si,0,0.00%,12234,12234,0.00%
mail.163.com,0,0.00%,3513,3513,0.00%
pull-lls-spe-l26.douyincdn.com,0,0.00%,781,781,0.00%
whsmarthome.hwcloudtest.cn,0,0.00%,9028,9028,0.00%
newclient.map.baidu.com,0,0.00%,270,270,0.00%
resolver.dingtalk.com,0,0.00%,105,105,0.00%
router14.teamviewer.com,0,0.00%,3029,3029,0.00%
push-rtmp-spe-l3.douyincdn.com,0,0.00%,560,560,0.00%
worldwide.sogou.com,0,0.00%,164,164,0.00%
o1098464.ingest.sentry.io,0,0.00%,319,319,0.00%
pull-flv-l27.douyincdn.com,0,0.00%,771,771,0.00%
push-rtmp-f5-cny.douyincdn.com,0,0.00%,589,589,0.00%
push-rtmp-l27.douyincdn.com,0,0.00%,626,626,0.00%
can-01.t7n4vxsm.dxs5.xyz,0,0.00%,774,774,0.00%
cc.map.qq.com,0,0.00%,334,334,0.00%
wq.jd.com,0,0.00%,256,256,0.00%
api-fc.dutils.com,0,0.00%,108,108,0.00%
api-fd.dutils.com,0,0.00%,176,176,0.00%
cgi.connect.qq.com,0,0.00%,259,259,0.00%
ali-stats.jpush.cn,0,0.00%,446,446,0.00%
sis.jpush.io,0,0.00%,340,340,0.00%
m.mpl.dutils.com,0,0.00%,141,141,0.00%
b.qchannel03.cn,0,0.00%,109,109,0.00%
yqy2356.melissauvc.com,0,0.00%,500,500,0.00%
pay.weixin.qq.com,0,0.00%,300,300,0.00%
wx.tenpay.com,0,0.00%,265,265,0.00%
vpn.maskvpn.cc,0,0.00%,2127,2127,0.00%
info.3g.qq.com,0,0.00%,115,115,0.00%
s.jpush.cn,0,0.00%,282,282,0.00%
easytomessage.com,0,0.00%,263,263,0.00%
pmmtk-a.pinduoduo.com,0,0.00%,378,378,0.00%
pull-rtmp-f29.douyincdn.com,0,0.00%,723,723,0.00%
edge.ivideo.sina.com.cn,0,0.00%,417,417,0.00%
modao.cc,0,0.00%,530,530,0.00%
api.ivideo.sina.com.cn,0,0.00%,447,447,0.00%
api.pinduoduo.com,0,0.00%,320,320,0.00%
push-rtmp-vr-l3.douyincdn.com,0,0.00%,553,553,0.00%
gd-stats.jpush.cn,0,0.00%,139,139,0.00%
papi.funshion.com,0,0.00%,289,289,0.00%
9-courier.push.apple.com,0,0.00%,494,494,0.00%
15-courier.push.apple.com,0,0.00%,541,541,0.00%
api.map.baidu.com,0,0.00%,513,513,0.00%
nvh6bk7t.mirror.aliyuncs.com,0,0.00%,2280,2280,0.00%
upmobile.v.qq.com,0,0.00%,189,189,0.00%
push.hicloud.com,0,0.00%,745,745,0.00%
pss.alicdn.com,0,0.00%,479,479,0.00%
home.hicloud.com,0,0.00%,9315,9315,0.00%
profile.accounts.firefox.com,0,0.00%,268,268,0.00%
token.services.mozilla.com,0,0.00%,143,143,0.00%
gs-loc-cn.apple.com,0,0.00%,1163,1163,0.00%
vpn.maskvpn.org,0,0.00%,2126,2126,0.00%
clientlogvodp2p.haplat.net,0,0.00%,219,219,0.00%
transit1.wslog.chinanetcenter.com,0,0.00%,216,216,0.00%
sync-1-us-west1-g.sync.services.mozilla.com,0,0.00%,242,242,0.00%
mmsns.c2c.wechat.com,0,0.00%,280,280,0.00%
api.accounts.firefox.com,0,0.00%,100,100,0.00%
p2pstuntest.haplat.net,0,0.00%,230,230,0.00%
37-courier.push.apple.com,0,0.00%,539,539,0.00%
ldapi.ldmnq.com,0,0.00%,657,657,0.00%
jp_62.antchatxj.com,0,0.00%,206,206,0.00%
array506.prod.do.dsp.mp.microsoft.com,0,0.00%,507,507,0.00%
aedns.weixin.qq.com,0,0.00%,262,262,0.00%
game.weixin.qq.com,0,0.00%,261,261,0.00%
msgacs.m.taobao.com,0,0.00%,173,173,0.00%
eco.taobao.com,0,0.00%,202,202,0.00%
apoll.m.taobao.com,0,0.00%,122,122,0.00%
amdc.m.taobao.com,0,0.00%,232,232,0.00%
rc.kite.com,0,0.00%,1408,1408,0.00%
b4bf120.pd.gladns.com,0,0.00%,190,190,0.00%
b4bf120.pc.gladns.com,0,0.00%,156,156,0.00%
b4bf120.pb.gladns.com,0,0.00%,159,159,0.00%
b4bf120.pa.gladns.com,0,0.00%,163,163,0.00%
b4bf120.pf.gladns.com,0,0.00%,227,227,0.00%
b4bf120.pg.gladns.com,0,0.00%,195,195,0.00%
b4bf120.pe.gladns.com,0,0.00%,189,189,0.00%
b4bf120.ph.gladns.com,0,0.00%,193,193,0.00%
px.ucweb.com,0,0.00%,199,199,0.00%
logservice.hicloud.com,0,0.00%,401,401,0.00%
logservice1.hicloud.com,0,0.00%,480,480,0.00%
nsp-logservice-hiview-p41-drcn.obs.cn-north-2.myhuaweicloud.com,0,0.00%,165,165,0.00%
hwid-drcn.platform.hicloud.com,0,0.00%,1194,1194,0.00%
oauth-login-drcn.platform.dbankcloud.com,0,0.00%,873,873,0.00%
pmmtk.pinduoduo.com,0,0.00%,256,256,0.00%
cmtw.pinduoduo.com,0,0.00%,138,138,0.00%
loggw-ex.alipay.com,0,0.00%,131,131,0.00%
tracker.iriseden.eu,0,0.00%,295,295,0.00%
sg.bls.mdt.qq.com,0,0.00%,153,153,0.00%
web-drcn.hispace.dbankcloud.cn,0,0.00%,1218,1218,0.00%
readpaper.com,0,0.00%,288,288,0.00%
sdkgw.map.qq.com,0,0.00%,596,596,0.00%
mime.baidu.com,0,0.00%,874,874,0.00%
windows.jingyeqian.com,0,0.00%,124,124,0.00%
bluedot.is.autonavi.com.gds.alibabadns.com,0,0.00%,1383,1383,0.00%
1-courier.push.apple.com,0,0.00%,1575,1575,0.00%
ins-8y4ghcjp.ias.tencent-cloud.net,0,0.00%,167,167,0.00%
smarthome.dbankcloud.cn,0,0.00%,118,118,0.00%
statuse.digitalcertvalidation.com,0,0.00%,136,136,0.00%
mail.nfschina.com,0,0.00%,1627,1627,0.00%
jgw-drcn.jos.dbankcloud.cn,0,0.00%,132,132,0.00%
th-b.pinduoduo.com,0,0.00%,416,416,0.00%
router8.teamviewer.com,0,0.00%,2662,2662,0.00%
bugly.qq.com,0,0.00%,919,919,0.00%
id6.me,0,0.00%,346,346,0.00%
gw5.push.mcp.weibo.cn,0,0.00%,197,197,0.00%
router15.teamviewer.com,0,0.00%,2773,2773,0.00%
web.qun.qq.com,0,0.00%,224,224,0.00%
tcbox.baidu.com,0,0.00%,239,239,0.00%
rs-sg.rustdesk.com,0,0.00%,110,110,0.00%
rs-ny.rustdesk.com,0,0.00%,100,100,0.00%
tvax3.sinaimg.cn,0,0.00%,572,572,0.00%
tva1.sinaimg.cn,0,0.00%,261,261,0.00%
t.kite.com,0,0.00%,1934,1934,0.00%
ins-r23tsuuf.ias.tencent-cloud.net,0,0.00%,892,892,0.00%
pc-api.300624.com,0,0.00%,432,432,0.00%
tva3.sinaimg.cn,0,0.00%,233,233,0.00%
24-courier.push.apple.com,0,0.00%,556,556,0.00%
xiaodu.baidu.com,0,0.00%,151,151,0.00%
restlbs.map.qq.com,0,0.00%,300,300,0.00%
md.openapi.360.cn,0,0.00%,458,458,0.00%
array501.prod.do.dsp.mp.microsoft.com,0,0.00%,250,250,0.00%
meta.pinduoduo.com,0,0.00%,215,215,0.00%
sysupgrade.vivo.com.cn,0,0.00%,126,126,0.00%
vcode-od.vivo.com.cn,0,0.00%,1196,1196,0.00%
ixav-cse.avlyun.com,0,0.00%,144,144,0.00%
msch.f.360.cn,0,0.00%,248,248,0.00%
data.ab.qq.com,0,0.00%,672,672,0.00%
mobilegw.alipay.com,0,0.00%,363,363,0.00%
www.cnki.net,0,0.00%,207,207,0.00%
app.yinxiang.com,0,0.00%,579,579,0.00%
online.ts.api.xiangtatech.com,0,0.00%,382,382,0.00%
tpstelemetry.tencent.com,0,0.00%,1007,1007,0.00%
titan.pinduoduo.com,0,0.00%,176,176,0.00%
tmfsdktcpv4.m.qq.com,0,0.00%,369,369,0.00%
obus-dc20123-cn.heytapmobi.com,0,0.00%,176,176,0.00%
appsec.hicloud.com,0,0.00%,130,130,0.00%
flux.iqiyi.com,0,0.00%,450,450,0.00%
httpdns.n.netease.com,0,0.00%,238,238,0.00%
cf.duba.net,0,0.00%,147,147,0.00%
26-courier.push.apple.com,0,0.00%,516,516,0.00%
log.mmstat.com,0,0.00%,427,427,0.00%
weather.kjjs.360.cn,0,0.00%,1086,1086,0.00%
dispatch.s.xzdesktop.cqttech.com,0,0.00%,945,945,0.00%
docs.nicehash.com,0,0.00%,4267,4267,0.00%
ca.minexmr.com,0,0.00%,4198,4198,0.00%
pool.hashvault.pro,0,0.00%,4202,4202,0.00%
turtlecoin.herominers.com,0,0.00%,4005,4005,0.00%
ar.hpool.com,0,0.00%,3908,3908,0.00%
us1.ethpool.org,0,0.00%,4154,4154,0.00%
www.fullskystar.top,0,0.00%,4000,4000,0.00%
ckb.antpool.com,0,0.00%,3955,3955,0.00%
du.testjj.com,0,0.00%,3960,3960,0.00%
btm.f2pool.com,0,0.00%,4164,4164,0.00%
jp.sparkpool.com,0,0.00%,4315,4315,0.00%
api.nicehash.com,0,0.00%,4247,4247,0.00%
rx.thegov.win,0,0.00%,18060,18060,0.00%
mail.nicehash.com,0,0.00%,4172,4172,0.00%
pool.supportxmr.com,0,0.00%,4181,4181,0.00%
etc.f2pool.com,0,0.00%,4286,4286,0.00%
pool.flooder.org,0,0.00%,4017,4017,0.00%
eth.ss.poolin.com,0,0.00%,4221,4221,0.00%
asia1.ethpool.org,0,0.00%,4274,4274,0.00%
eth.antpool.com,0,0.00%,4212,4212,0.00%
miner.nicehash.com,0,0.00%,4241,4241,0.00%
monerohash.com,0,0.00%,4075,4075,0.00%
blog.nicehash.com,0,0.00%,4243,4243,0.00%
www.jvmonline.com,0,0.00%,3976,3976,0.00%
smtp.nicehash.com,0,0.00%,4239,4239,0.00%
penef6f8f734.slushpool.com,0,0.00%,4227,4227,0.00%
dcr.uupool.cn,0,0.00%,4026,4026,0.00%
eth.uupool.cn,0,0.00%,4145,4145,0.00%
git.rancher.io,0,0.00%,24994,24994,0.00%
api.im.qcloud.com,0,0.00%,1967,1967,0.00%
7jmrbtrvkgcqkldzyob4kotpyvsgz546yvik2xv4rpnfmrhe4imxthqd.tor2web.in,0,0.00%,220,220,0.00%
ustc-edu-cn.mirror.aliyuncs.com,0,0.00%,2820,2820,0.00%
api.mymonero.com,0,0.00%,3960,3960,0.00%
toa.mygametoa.com,0,0.00%,3991,3991,0.00%
donate.v2.xmrig.com,0,0.00%,4076,4076,0.00%
fr.minexmr.com,0,0.00%,4286,4286,0.00%
ns41.hashvault.pro,0,0.00%,3991,3991,0.00%
nhmws.nicehash.com,0,0.00%,4276,4276,0.00%
zec.uupool.cn,0,0.00%,3974,3974,0.00%
sea.wafflepool.com,0,0.00%,3983,3983,0.00%
de.minexmr.com,0,0.00%,4285,4285,0.00%
kmd.antpool.com,0,0.00%,4019,4019,0.00%
pool-fr.supportxmr.com,0,0.00%,4282,4282,0.00%
k8s.entrypoint.ops.sparkpool.com,0,0.00%,4292,4292,0.00%
sg.minexmr.com,0,0.00%,4262,4262,0.00%
verushash.mine.zergpool.com,0,0.00%,4078,4078,0.00%
sbtc.uupool.cn,0,0.00%,4134,4134,0.00%
pool.minexmr.com,0,0.00%,4303,4303,0.00%
donate.ssl.xmrig.com,0,0.00%,4142,4142,0.00%
awsmx.f2pool.com,0,0.00%,4281,4281,0.00%
asia2.ethermine.org,0,0.00%,4328,4328,0.00%
xmr.flooder.org,0,0.00%,4026,4026,0.00%
eth.f2pool.com,0,0.00%,4255,4255,0.00%
btc.f2pool.com,0,0.00%,4110,4110,0.00%
test.nicehash.com,0,0.00%,4228,4228,0.00%
dcr.f2pool.com,0,0.00%,4132,4132,0.00%
b4c.f2pool.com,0,0.00%,4200,4200,0.00%
ss.antpool.com,0,0.00%,4086,4086,0.00%
cn.sparkpool.com,0,0.00%,4239,4239,0.00%
ns11.hashvault.pro,0,0.00%,3958,3958,0.00%
btw.uupool.cn,0,0.00%,3944,3944,0.00%
raven.f2pool.com,0,0.00%,4180,4180,0.00%
pool.minergate.com,0,0.00%,4211,4211,0.00%
tracker.opentrackr.org,0,0.00%,761,761,0.00%
api.pdfxd.com,0,0.00%,169,169,0.00%
dc1.ksn.kaspersky-labs.com,0,0.00%,639,639,0.00%
2-courier.push.apple.com,0,0.00%,502,502,0.00%
sz2.connipv6.qq.com,0,0.00%,105,105,0.00%
sz.connipv6.qq.com,0,0.00%,104,104,0.00%
sh.connipv6.qq.com,0,0.00%,109,109,0.00%
sh2.connipv6.qq.com,0,0.00%,103,103,0.00%
tj.connipv6.qq.com,0,0.00%,106,106,0.00%
tj2.connipv6.qq.com,0,0.00%,107,107,0.00%
stratum.okpool.me,0,0.00%,4155,4155,0.00%
fliplc.getxlx.com,0,0.00%,8064,8064,0.00%
pop.cstnet.cn,0,0.00%,152,152,0.00%
dav.qq.com,0,0.00%,1026,1026,0.00%
mail.ios.ac.cn,0,0.00%,146,146,0.00%
snz04pap002.storage.live.com,0,0.00%,110,110,0.00%
mailer.nicehash.com,0,0.00%,4243,4243,0.00%
connect.unity.cn,0,0.00%,1335,1335,0.00%
developer.unity.cn,0,0.00%,674,674,0.00%
rt-p.kugou.com,0,0.00%,137,137,0.00%
cdp.cloud.unity3d.com,0,0.00%,469,469,0.00%
cerebrum.emotivcloud.com,0,0.00%,481,481,0.00%
hub5p.sandai.net,0,0.00%,55995,55995,0.00%
lookup.nextcloud.com,0,0.00%,6601,6601,0.00%
ping3.teamviewer.com,0,0.00%,2229,2229,0.00%
ping.dgraph.io,0,0.00%,5037,5037,0.00%
pan.cstcloud.cn,0,0.00%,155,155,0.00%
tracker.etree.org,0,0.00%,142,142,0.00%
admin.kdsec.org,0,0.00%,717,717,0.00%
master6.teamviewer.com,0,0.00%,130,130,0.00%
iguvmbs.roygxe.xyz,0,0.00%,1310,1310,0.00%
60-fps.org,0,0.00%,148,148,0.00%
t.overflow.biz,0,0.00%,2368,2368,0.00%
qbwup.imtt.qq.com,0,0.00%,1370,1370,0.00%
tmall.com,0,0.00%,140,140,0.00%
kubernetes-charts.storage.googleapis.com,0,0.00%,240,240,0.00%
6ahddutb1ucc3cp.ru,0,0.00%,3817,3817,0.00%
tracker.fixr.pro,0,0.00%,995,995,0.00%
stun1.douyucdn.cn,0,0.00%,1429,1429,0.00%
tracker.pow7.com,0,0.00%,1421,1421,0.00%
t2.pow7.com,0,0.00%,1518,1518,0.00%
torrents.hikarinokiseki.com,0,0.00%,269,269,0.00%
t.sina.com.cn,0,0.00%,386,386,0.00%
fileplatform.api.weibo.com,0,0.00%,384,384,0.00%
picupload.weibo.com,0,0.00%,1154,1154,0.00%
mail.sina.com.cn,0,0.00%,799,799,0.00%
t.showone.com.cn,0,0.00%,399,399,0.00%
tianya.cn,0,0.00%,374,374,0.00%
my.tianya.cn,0,0.00%,386,386,0.00%
sohu.com,0,0.00%,388,388,0.00%
3g.tianya.cn,0,0.00%,392,392,0.00%
bbs.tianya.cn,0,0.00%,481,481,0.00%
msg.baidu.com,0,0.00%,389,389,0.00%
upload.tieba.baidu.com,0,0.00%,366,366,0.00%
clubajax.autohome.com.cn,0,0.00%,384,384,0.00%
www.youtube-nocookie.com,0,0.00%,508,508,0.00%
icloud.com,0,0.00%,409,409,0.00%
p45-contentws.icloud.com,0,0.00%,678,678,0.00%
dns.baidu.com,0,0.00%,512,512,0.00%
weiyun.com,0,0.00%,395,395,0.00%
yinxiang.com,0,0.00%,378,378,0.00%
docin.com,0,0.00%,383,383,0.00%
login.yahoo.com,0,0.00%,401,401,0.00%
yeah.net,0,0.00%,389,389,0.00%
sina.com.cn,0,0.00%,384,384,0.00%
m0.mail.sina.cn,0,0.00%,396,396,0.00%
qiye.163.com,0,0.00%,410,410,0.00%
mail.10086.cn,0,0.00%,396,396,0.00%
appmail.mail.10086.cn,0,0.00%,380,380,0.00%
chat.google.com,0,0.00%,691,691,0.00%
news.google.com,0,0.00%,392,392,0.00%
www.google.ae,0,0.00%,510,510,0.00%
www.google.al,0,0.00%,401,401,0.00%
www.google.co.ao,0,0.00%,465,465,0.00%
www.google.as,0,0.00%,562,562,0.00%
www.google.ba,0,0.00%,500,500,0.00%
www.google.be,0,0.00%,493,493,0.00%
www.google.bg,0,0.00%,499,499,0.00%
video.weibocdn.com,0,0.00%,710,710,0.00%
picupload.service.weibo.com,0,0.00%,710,710,0.00%
upload.video.sina.com.cn,0,0.00%,396,396,0.00%
www.google.bi,0,0.00%,562,562,0.00%
www.google.bj,0,0.00%,459,459,0.00%
www.google.bs,0,0.00%,558,558,0.00%
www.google.cd,0,0.00%,566,566,0.00%
sinaapp.com,0,0.00%,380,380,0.00%
t.p4p.sina.com.cn,0,0.00%,386,386,0.00%
www.tianya.cn,0,0.00%,539,539,0.00%
wireless.tianya.cn,0,0.00%,367,367,0.00%
www.google.cg,0,0.00%,568,568,0.00%
www.google.ci,0,0.00%,560,560,0.00%
www.google.cl,0,0.00%,505,505,0.00%
www.google.cn,0,0.00%,974,974,0.00%
www.google.cv,0,0.00%,462,462,0.00%
www.google.cz,0,0.00%,392,392,0.00%
www.google.dj,0,0.00%,558,558,0.00%
www.google.dm,0,0.00%,553,553,0.00%
baidu.com,0,0.00%,641,641,0.00%
skype.com,0,0.00%,395,395,0.00%
photo.tianya.cn,0,0.00%,396,396,0.00%
blog.tianya.cn,0,0.00%,403,403,0.00%
m.tianya.cn,0,0.00%,374,374,0.00%
wapp.baidu.com,0,0.00%,382,382,0.00%
uploadphotos.baidu.com,0,0.00%,374,374,0.00%
autohome.com.cn,0,0.00%,395,395,0.00%
youtube.googleapis.com,0,0.00%,399,399,0.00%
youtu.be,0,0.00%,386,386,0.00%
sharepoint.com,0,0.00%,762,762,0.00%
web.wechat.com,0,0.00%,372,372,0.00%
file2.wx.qq.com,0,0.00%,630,630,0.00%
office.com,0,0.00%,377,377,0.00%
www.dropbox.com,0,0.00%,641,641,0.00%
p45-mailws.icloud.com,0,0.00%,733,733,0.00%
sharefile.com,0,0.00%,379,379,0.00%
www.google.cf,0,0.00%,452,452,0.00%
www.google.cm,0,0.00%,461,461,0.00%
www.google.am,0,0.00%,510,510,0.00%
www.google.at,0,0.00%,518,518,0.00%
www.google.az,0,0.00%,512,512,0.00%
www.google.ca,0,0.00%,496,496,0.00%
pcs.baidu.com,0,0.00%,413,413,0.00%
wiz.cn,0,0.00%,389,389,0.00%
doc88.com,0,0.00%,389,389,0.00%
gmail.com,0,0.00%,402,402,0.00%
mail.126.com,0,0.00%,634,634,0.00%
up.sinastorage.com,0,0.00%,409,409,0.00%
mail.263.net,0,0.00%,390,390,0.00%
www.google.de,0,0.00%,516,516,0.00%
jamboard.google.com,0,0.00%,390,390,0.00%
meet.google.com,0,0.00%,400,400,0.00%
photos.google.com,0,0.00%,405,405,0.00%
www.google.ad,0,0.00%,392,392,0.00%
www.google.bf,0,0.00%,441,441,0.00%
www.google.bt,0,0.00%,456,456,0.00%
www.google.by,0,0.00%,465,465,0.00%
www.google.ch,0,0.00%,507,507,0.00%
comm.weixinbridge.com,0,0.00%,126,126,0.00%
www.getdropbox.com,0,0.00%,881,881,0.00%
www.google.dk,0,0.00%,507,507,0.00%
wx2.qq.com,0,0.00%,531,531,0.00%
file.wx.qq.com,0,0.00%,390,390,0.00%
live.com,0,0.00%,398,398,0.00%
t1.pow7.com,0,0.00%,1607,1607,0.00%
retracker.mgts.by,0,0.00%,6334,6334,0.00%
paint.ludashi.com,0,0.00%,138,138,0.00%
report.meituan.com,0,0.00%,214,214,0.00%
s.w.org,0,0.00%,254,254,0.00%
s2.symcb.com,0,0.00%,311,311,0.00%
sealine.youku.com,0,0.00%,181,181,0.00%
sf.symcd.com,0,0.00%,231,231,0.00%
slp2p-east-std1033.oray.net,0,0.00%,210,210,0.00%
slp2p-east-std61.oray.net,0,0.00%,199,199,0.00%
slp2px-east-std31.oray.net,0,0.00%,207,207,0.00%
tip.soku.com,0,0.00%,175,175,0.00%
user.youku.com,0,0.00%,171,171,0.00%
v.youku.com,0,0.00%,187,187,0.00%
v2.reachmax.cn,0,0.00%,225,225,0.00%
vip.youku.com,0,0.00%,176,176,0.00%
share.camoe.cn,0,0.00%,1810,1810,0.00%
frp.zwlin.top,0,0.00%,2249,2249,0.00%
open.acgtracker.com,0,0.00%,176,176,0.00%
online.s.xzdesktop.cqttech.com,0,0.00%,839,839,0.00%
mediaclub.tv,0,0.00%,164,164,0.00%
sdk1xyajs.data.kuiniuca.com,0,0.00%,487,487,0.00%
tracker.files.fm,0,0.00%,394,394,0.00%
nodestore-kiros-prod-lb-132549143.us-east-1.elb.amazonaws.com,0,0.00%,927,927,0.00%
tracker.frozen-layer.net,0,0.00%,241,241,0.00%
sv.symcd.com,0,0.00%,300,300,0.00%
yk-ssp.ad.youku.com,0,0.00%,184,184,0.00%
ynuf.alipay.com,0,0.00%,245,245,0.00%
youku.com,0,0.00%,184,184,0.00%
12-courier.push.apple.com,0,0.00%,512,512,0.00%
secure.pow7.com,0,0.00%,1454,1454,0.00%
denis.stalker.upeer.me,0,0.00%,513,513,0.00%
tracker.tfile.co,0,0.00%,318,318,0.00%
shiyd.cn,0,0.00%,249,249,0.00%
www.zotero.org,0,0.00%,310,310,0.00%
r4---sn-2x3elnez.gvt1.com,0,0.00%,101,101,0.00%
tracker.minglong.org,0,0.00%,145,145,0.00%
www.tg5tj2cu.com,0,0.00%,130,130,0.00%
h4.trakx.nibba.trade,0,0.00%,503,503,0.00%
nvidia.github.io,0,0.00%,396,396,0.00%
apphub.aliyuncs.com,0,0.00%,663,663,0.00%
tracker.anirena.com,0,0.00%,459,459,0.00%
tracker.nucozer-tracker.ml,0,0.00%,301,301,0.00%
r4---sn-2x3elnel.gvt1.com,0,0.00%,275,275,0.00%
odoooacnz-my.sharepoint.com,0,0.00%,398,398,0.00%
yapi.kdsec.org,0,0.00%,31397,31397,0.00%
saladict.crimx.com,0,0.00%,246,246,0.00%
www.blackcats-games.net,0,0.00%,123,123,0.00%
atrack.pow7.com,0,0.00%,1519,1519,0.00%
seeds-darwin.xycdn.com,0,0.00%,346,346,0.00%
dx.doi.org,0,0.00%,225,225,0.00%
ic-business.ks3-cn-beijing.ksyun.com,0,0.00%,233,233,0.00%
bt.firebit.org,0,0.00%,146,146,0.00%
iframe.videodelivery.net,0,0.00%,294,294,0.00%
www.lixiangdao.vip,0,0.00%,121,121,0.00%
tracker.trancetraffic.com,0,0.00%,148,148,0.00%
home.yxgz.vip,0,0.00%,123,123,0.00%
pc-diffpack.wps.cn,0,0.00%,226,226,0.00%
push.thanos.ams.eulix.xyz,0,0.00%,1869,1869,0.00%
api.ultimaker.com,0,0.00%,453,453,0.00%
tracker.filepit.to,0,0.00%,127,127,0.00%
tr.cili001.com,0,0.00%,252,252,0.00%
0d.kebhana.mx,0,0.00%,208,208,0.00%
a.tampermonkey.net,0,0.00%,279,279,0.00%
cloudflarestream.com,0,0.00%,263,263,0.00%
mq.dataservices.hp.com,0,0.00%,262,262,0.00%
beertracker.ml,0,0.00%,198,198,0.00%
bluebird-hd.org,0,0.00%,632,632,0.00%
irrenhaus.dyndns.dk,0,0.00%,149,149,0.00%
all4nothin.net,0,0.00%,157,157,0.00%
tracker.nanoha.org,0,0.00%,297,297,0.00%
openbittorrent.com,0,0.00%,111,111,0.00%
tracker.frozen-layer.com,0,0.00%,227,227,0.00%
xtremewrestlingtorrents.net,0,0.00%,156,156,0.00%
embed.cloudflarestream.com,0,0.00%,263,263,0.00%
filters.adtidy.org,0,0.00%,255,255,0.00%
tracker.moeking.me,0,0.00%,247,247,0.00%
q.soft.360.cn,0,0.00%,292,292,0.00%
q.cnblogs.com,0,0.00%,482,482,0.00%
recycle.i5.cn,0,0.00%,278,278,0.00%
update-drcn.platform.hicloud.com,0,0.00%,832,832,0.00%
hub5u.hz.sandai.net,0,0.00%,141,141,0.00%
app4.i4.cn,0,0.00%,270,270,0.00%
api.dida365.com,0,0.00%,1409,1409,0.00%
serviceplus.phytium.com.cn,0,0.00%,726,726,0.00%
api.yiban.io,0,0.00%,450,450,0.00%
hub5pnc.hz.sandai.net,0,0.00%,150,150,0.00%
domainask.weibanio.cn,0,0.00%,798,798,0.00%
rm-2zelg248g7y2034w7do.mysql.rds.aliyuncs.com,0,0.00%,452,452,0.00%
ios.pclog.i4.cn,0,0.00%,343,343,0.00%
array812.prod.do.dsp.mp.microsoft.com,0,0.00%,437,437,0.00%
hxhvnih.nyjvbs.xyz,0,0.00%,160,160,0.00%
array810.prod.do.dsp.mp.microsoft.com,0,0.00%,113,113,0.00%
v2.cs3.duba.net,0,0.00%,802,802,0.00%
appleimap.163.com,0,0.00%,420,420,0.00%
nstool.netease.com,0,0.00%,566,566,0.00%
yiban.io,0,0.00%,249,249,0.00%
www.update.microsoft.com,0,0.00%,119,119,0.00%
watson.microsoft.com,0,0.00%,110,110,0.00%
web.push.126.net,0,0.00%,249,249,0.00%
notify.adobe.io,0,0.00%,683,683,0.00%
ac.dun.163yun.com,0,0.00%,159,159,0.00%
tools.google.com,0,0.00%,219,219,0.00%
forum.qt.io,0,0.00%,313,313,0.00%
sourcegraph.com,0,0.00%,1216,1216,0.00%
doh.zjurl.cn,0,0.00%,679,679,0.00%
slack.com,0,0.00%,517,517,0.00%
kns.duba.net,0,0.00%,1240,1240,0.00%
boot-02.net.anydesk.com,0,0.00%,2054,2054,0.00%
api.distill.io,0,0.00%,751,751,0.00%
fedora.riscv.rocks,0,0.00%,2726,2726,0.00%
pc-api.wondershare.cc,0,0.00%,423,423,0.00%
dgapi.zhhainiao.com,0,0.00%,903,903,0.00%
udp.cloud.duba.net,0,0.00%,220,220,0.00%
servicediscovery.ccs.mcafee.com,0,0.00%,117,117,0.00%
p3n9w31.cloud,0,0.00%,583,583,0.00%
api-std.sunlogin.oray.com,0,0.00%,1839,1839,0.00%
router12.teamviewer.com,0,0.00%,2813,2813,0.00%
app.smartmailcloud.com,0,0.00%,175,175,0.00%
imap.mail.me.com.akadns.net,0,0.00%,167,167,0.00%
newvip.duba.net,0,0.00%,520,520,0.00%
broadcast2.distill.io,0,0.00%,737,737,0.00%
array612.prod.do.dsp.mp.microsoft.com,0,0.00%,294,294,0.00%
acc.qq.com,0,0.00%,1960,1960,0.00%
data.hicloud.com,0,0.00%,360,360,0.00%
open.u-tools.cn,0,0.00%,343,343,0.00%
o137163.ingest.sentry.io,0,0.00%,180,180,0.00%
imap.sina.com,0,0.00%,1038,1038,0.00%
notify3.note.youdao.com,0,0.00%,1087,1087,0.00%
litedev.ys7.com,0,0.00%,114,114,0.00%
ct.duba.net,0,0.00%,585,585,0.00%
www.ztb.im,0,0.00%,140,140,0.00%
tracker4.itzmx.com,0,0.00%,374,374,0.00%
hq.sinajs.cn,0,0.00%,813,813,0.00%
sec23summer.usenix.hotcrp.com,0,0.00%,171,171,0.00%
dsm01pap008.storage.live.com,0,0.00%,120,120,0.00%
doh-fi.blahdns.com,0,0.00%,231,231,0.00%
www.w3.org,0,0.00%,320103,320103,0.00%
ataprod.remarqable.com,0,0.00%,232,232,0.00%
tuna05.mcddns01.com,0,0.00%,978,978,0.00%
news.qhstatic.com,0,0.00%,385,385,0.00%
mcafee-sustainability.azurewebsites.net,0,0.00%,1523,1523,0.00%
clientstream.launchdarkly.com,0,0.00%,247,247,0.00%
dr.ime.baidu.com,0,0.00%,954,954,0.00%
config.mobile.kugou.com,0,0.00%,331,331,0.00%
shdf01-iopq.cgroads.com,0,0.00%,1009,1009,0.00%
api.weixin.qq.com,0,0.00%,186,186,0.00%
update.drivergenius.com,0,0.00%,557,557,0.00%
conn.wemeet.tencent.com,0,0.00%,166,166,0.00%
contentsec.ac.cn,0,0.00%,412,412,0.00%
todolist.redirect.xzdesktop.cqttech.com,0,0.00%,521,521,0.00%
report.51nwt.com,0,0.00%,199,199,0.00%
clients.config.office.net,0,0.00%,359,359,0.00%
browser.events.data.msn.com,0,0.00%,299,299,0.00%
gtm-sg-6wr2u201t05.gtm-i2d4.com,0,0.00%,904,904,0.00%
searchrecommend.kugou.com,0,0.00%,801,801,0.00%
www.codota.com,0,0.00%,234,234,0.00%
apis-mix-pub.maxhub.vip,0,0.00%,202,202,0.00%
dsm01pap005.storage.live.com,0,0.00%,158,158,0.00%
edgeassetservice.azureedge.net,0,0.00%,309,309,0.00%
be59399.pb.gladns.com,0,0.00%,106,106,0.00%
interface.music.163.com,0,0.00%,202,202,0.00%
huggingface.co,0,0.00%,3227,3227,0.00%
dns.rubyfish.cn,0,0.00%,7934,7934,0.00%
dns.alidns.com,0,0.00%,1359,1359,0.00%
www.cloudflare.com,0,0.00%,240,240,0.00%
ide.liuyingyong.cn,0,0.00%,107,107,0.00%
service-cn.hwccpc.com,0,0.00%,169,169,0.00%
yybadaccess.3g.qq.com,0,0.00%,372,372,0.00%
wh.vipguanjia.net,0,0.00%,334,334,0.00%
stat.lianmeng.360.cn,0,0.00%,298,298,0.00%
sfstat.lianmeng.360.cn,0,0.00%,232,232,0.00%
sp4.tf.360.cn,0,0.00%,209,209,0.00%
repo.hortonworks.com,0,0.00%,175,175,0.00%
array604.prod.do.dsp.mp.microsoft.com,0,0.00%,197,197,0.00%
tips.ime.baidu.com,0,0.00%,128,128,0.00%
www.figma.com,0,0.00%,601,601,0.00%
dpm.demdex.net,0,0.00%,122,122,0.00%
cdnjs.cloudflare.com,0,0.00%,334,334,0.00%
time.asia.apple.com,0,0.00%,1759,1759,0.00%
s.thsi.cn,0,0.00%,366,366,0.00%
analytics.getpostman.com,0,0.00%,301,301,0.00%
11-courier.push.apple.com,0,0.00%,493,493,0.00%
data.vipguanjia.net,0,0.00%,369,369,0.00%
router1.teamviewer.com,0,0.00%,2709,2709,0.00%
array601.prod.do.dsp.mp.microsoft.com,0,0.00%,459,459,0.00%
jp05-vm0.entry.srthdw.art,0,0.00%,161,161,0.00%
jp01-vm0.entry.srthdw.art,0,0.00%,226,226,0.00%
localhost,0,0.00%,14610,14610,0.00%
server.reverse.ac.cn,0,0.00%,5853,5853,0.00%
wspri.coinall.ltd,0,0.00%,673,673,0.00%
gzyd.lanyunshi.cc,0,0.00%,170,170,0.00%
ntp.aliyun.com,0,0.00%,1837,1837,0.00%
g.ceipmsn.com,0,0.00%,133,133,0.00%
mirror.iscas.ac.cn,0,0.00%,1784,1784,0.00%
downloads.yoctoproject.org,0,0.00%,87275,87275,0.00%
chat.api.autohome.com.cn,0,0.00%,109,109,0.00%
33aef1e.ne.gladns.com,0,0.00%,131,131,0.00%
beacons4.gvt2.com,0,0.00%,473,473,0.00%
socc2022.hotcrp.com,0,0.00%,148,148,0.00%
api.raese.top,0,0.00%,442,442,0.00%
localhost.localdomain,0,0.00%,232,232,0.00%
mirrorz.org,0,0.00%,233,233,0.00%
windows.kite.com,0,0.00%,569,569,0.00%
zhushou.huihui.cn,0,0.00%,229,229,0.00%
a.w.bilicdn1.com,0,0.00%,1089,1089,0.00%
comet.jianguoyun.com,0,0.00%,1020,1020,0.00%
88dsf5l.003.1.mclqp.link,0,0.00%,1790,1790,0.00%
ixin.itrus.com.cn,0,0.00%,109,109,0.00%
iepl03.nnooddee.cyou,0,0.00%,227,227,0.00%
pop.sina.com,0,0.00%,597,597,0.00%
www.macpaw.com,0,0.00%,268,268,0.00%
software.macpaw.com,0,0.00%,171,171,0.00%
api.cloud.tenda.com.cn,0,0.00%,2773,2773,0.00%
xgpolardb.mysql.polardb.rds.aliyuncs.com,0,0.00%,39712,39712,0.00%
poll.exmail.qq.com,0,0.00%,859,859,0.00%
qup.b.qianxin.com,0,0.00%,9367,9367,0.00%
es.proj217.app.kdsec.org,0,0.00%,2379,2379,0.00%
assets.contentstack.io,0,0.00%,8235,8235,0.00%
pgw-tel-cld-sl.alicdn.com,0,0.00%,251,251,0.00%
cn-hangzhou.axt.aliyun.com,0,0.00%,1374,1374,0.00%
cn-qingdao.axt.aliyun.com,0,0.00%,1390,1390,0.00%
submit.iacr.org,0,0.00%,100,100,0.00%
c.hljzfkyy.com,0,0.00%,11749,11749,0.00%
tw-gx-1.dnspro.icu,0,0.00%,409,409,0.00%
cn-beijing.axt.aliyun.com,0,0.00%,1275,1275,0.00%
prod.nexusrules.live.com.akadns.net,0,0.00%,341,341,0.00%
n23.boom.skin,0,0.00%,169,169,0.00%
lcznqafr.nodelist.xyz,0,0.00%,695,695,0.00%
cn-zhangjiakou.axt.aliyun.com,0,0.00%,1029,1029,0.00%
doh.opendns.com,0,0.00%,556,556,0.00%
a.passcloud.xyz,0,0.00%,248,248,0.00%
doh.buzz,0,0.00%,609,609,0.00%
pcapp-push.youku.com,0,0.00%,156,156,0.00%
www.nowcoder.com,0,0.00%,265,265,0.00%
ping.manjaro.org,0,0.00%,700,700,0.00%
www.deepl.com,0,0.00%,310,310,0.00%
appdownload.deepl.com,0,0.00%,246,246,0.00%
nowpick.nowcoder.com,0,0.00%,250,250,0.00%
ntemp20.boom.skin,0,0.00%,719,719,0.00%
cn-hongkong.axt.aliyun.com,0,0.00%,1141,1141,0.00%
j.v4.2.kiki789.com,0,0.00%,277,277,0.00%
eu-west-1.axt.aliyun.com,0,0.00%,792,792,0.00%
www.jd.com,0,0.00%,10868,10868,0.00%
osint.bambenekconsulting.com,0,0.00%,176,176,0.00%
hb-b.services.vnc.com,0,0.00%,1472,1472,0.00%
acfsnui7geismdxwansql59rlcjkhc34syupzetume.k2h4.com,0,0.00%,881,881,0.00%
hb-a.services.vnc.com,0,0.00%,1567,1567,0.00%
kt-prod.ess.apple.com,0,0.00%,369,369,0.00%
www.aliyun.com,0,0.00%,699,699,0.00%
hb-c.services.vnc.com,0,0.00%,1546,1546,0.00%
center.bleachcarnival.com,0,0.00%,3178,3178,0.00%
data.bleachcarnival.com,0,0.00%,1591,1591,0.00%
user.cn.union.longu.xyz,0,0.00%,1480,1480,0.00%
devpay.cn.sy.longu.xyz,0,0.00%,1411,1411,0.00%
locprod2-elb-us-west-2.prod.mozaws.net,0,0.00%,2109,2109,0.00%
qmzgh5gm.gameserver.youxigu.com,0,0.00%,1501,1501,0.00%
qmzgh5s2301.gameserver.youxigu.com,0,0.00%,607,607,0.00%
gitter.im,0,0.00%,107,107,0.00%
geo-applefinance-cache.internal.query.g03.yahoodns.net,0,0.00%,240,240,0.00%
1.courier-push-apple.com.akadns.net,0,0.00%,635,635,0.00%
us-sandbox-courier-4.push-apple.com.akadns.net,0,0.00%,562,562,0.00%
swh.app,0,0.00%,403,403,0.00%
sdk.api.bjshcw.com,0,0.00%,158,158,0.00%
kikyo-rest.app.kdsec.org,0,0.00%,440,440,0.00%
link.springer.com,0,0.00%,224,224,0.00%
www.sciencedirect.com,0,0.00%,215,215,0.00%
www.engineeringvillage.com,0,0.00%,168,168,0.00%
dl.acm.org,0,0.00%,429,429,0.00%
apabi.las.ac.cn,0,0.00%,171,171,0.00%
bjvip.las.ac.cn,0,0.00%,172,172,0.00%
www.las.ac.cn,0,0.00%,195,195,0.00%
gpd.las.ac.cn,0,0.00%,173,173,0.00%
pis-pcdn.youku.com,0,0.00%,433,433,0.00%
cdnus.copydesign.net,0,0.00%,109,109,0.00%
long.iwifi.360.cn,0,0.00%,243,243,0.00%
ws2.leetcode.cn,0,0.00%,114,114,0.00%
array608.prod.do.dsp.mp.microsoft.com,0,0.00%,201,201,0.00%
44-courier.push.apple.com,0,0.00%,547,547,0.00%
msgacs.youku.com,0,0.00%,152,152,0.00%
doh.dns.sb,0,0.00%,584,584,0.00%
dashenga.com,0,0.00%,108,108,0.00%
qmzgh5s5286.gameserver.youxigu.com,0,0.00%,143,143,0.00%
4-courier.push.apple.com,0,0.00%,500,500,0.00%
pypi.org,0,0.00%,585441,585441,0.00%
bggts547gukhvmf4cgandlgxxphengxovoyo6ewhns5qmmb2b5oi43yd.tor2web.in,0,0.00%,541,541,0.00%
sh.madagent.tm,0,0.00%,680,680,0.00%
usa1v2.jsssline.top,0,0.00%,3759,3759,0.00%
appexorch.bestsdwan.com,0,0.00%,693,693,0.00%
winatp-gw-cus3.microsoft.com,0,0.00%,1355,1355,0.00%
pr3.getnjnd.com,0,0.00%,1020,1020,0.00%
sh.0xbadc0de.stream,0,0.00%,651,651,0.00%
t1.dxqjy.top,0,0.00%,918,918,0.00%
relay-6810dbc0.net.anydesk.com.cn,0,0.00%,797,797,0.00%
dc1-file.ksn.kaspersky-labs.com,0,0.00%,124,124,0.00%
apc.antiy.net.cn,0,0.00%,1339,1339,0.00%
iepupdate.antiy.cn,0,0.00%,1348,1348,0.00%
clk.lenovo.com.cn,0,0.00%,152,152,0.00%
fmt2.link.ac.cn,0,0.00%,671,671,0.00%
p.l.qq.com,0,0.00%,140,140,0.00%
cm.l.qq.com,0,0.00%,284,284,0.00%
f1604a02-cdb8-457a-8369-6a64e4922e70.zj.node.touhou.earth,0,0.00%,457,457,0.00%
98d033b8-6928-4e27-99ab-142ed34f9491.zj.node.touhou.earth,0,0.00%,450,450,0.00%
dcd0a341-43f5-4258-97ec-a1ed2ba50173.gz.node.touhou.earth,0,0.00%,349,349,0.00%
83041227-55a7-4080-b7e1-9dfc7478ddb0.gz.node.touhou.earth,0,0.00%,408,408,0.00%
48712c51-0c8a-458a-b53f-cbc3e1c93e20.hk.node.touhou.earth,0,0.00%,208,208,0.00%
33837ddc-243b-4f60-91c1-11bd9b602eed.hk.node.touhou.earth,0,0.00%,208,208,0.00%
ba911c47-b38f-4d0b-af5b-3bfc71980995.hk.node.touhou.earth,0,0.00%,219,219,0.00%
4f38f6b4-bed0-40e9-aad8-72a2bc218407.zj.node.touhou.earth,0,0.00%,195,195,0.00%
49e89cc2-696a-4683-ba3e-60304878a4ff.jp.node.touhou.earth,0,0.00%,212,212,0.00%
0b32cd5b-e021-4031-81f6-98a411d66ca1.jp.node.touhou.earth,0,0.00%,214,214,0.00%
3ba0c177-1b23-42a6-be9d-a8bdf1c2bb22.hk.node.touhou.earth,0,0.00%,1376,1376,0.00%
wpad.com,0,0.00%,123,123,0.00%
p218-caldav.icloud.com.cn,0,0.00%,231,231,0.00%
oaagent.baidu.com,0,0.00%,771,771,0.00%
agd.p.360.cn,0,0.00%,296,296,0.00%
d9caa6e02c990b0a.jijifun.com,0,0.00%,876,876,0.00%
dispatch.ts.api.xiangtatech.com,0,0.00%,376,376,0.00%
launcher-public-service-prod06.ol.epicgames.com,0,0.00%,128,128,0.00%
ntp.ntsc.ac.cn,0,0.00%,1023,1023,0.00%
google.cn,0,0.00%,151,151,0.00%
wx1.qq.com,0,0.00%,338,338,0.00%
az667904.vo.msecnd.net,0,0.00%,1786,1786,0.00%
oss.hpconnected.com,0,0.00%,201,201,0.00%
api.basedata.union.longu.xyz,0,0.00%,5084,5084,0.00%
exp.notion.so,0,0.00%,281,281,0.00%
33-courier.push.apple.com,0,0.00%,542,542,0.00%
sdup.360.cn,0,0.00%,635,635,0.00%
blacklist.tampermonkey.net,0,0.00%,268,268,0.00%
access-tel-i.alicdn.com,0,0.00%,205,205,0.00%
account.youku.com,0,0.00%,182,182,0.00%
apimobile.meituan.com,0,0.00%,308,308,0.00%
fourier.alibaba.com,0,0.00%,208,208,0.00%
tracker.gigatorrents.ws,0,0.00%,216,216,0.00%
zgrefgd03.standurl.xyz,0,0.00%,344,344,0.00%
masters-tb.com,0,0.00%,148,148,0.00%
rs-cn.rustdesk.com,0,0.00%,173,173,0.00%
www.datastudy.cc,0,0.00%,134,134,0.00%
hydra.plan9-ns1.com,0,0.00%,196,196,0.00%
data-bg.net,0,0.00%,144,144,0.00%
api.i-meto.com,0,0.00%,194,194,0.00%
appct.jianguoyun.com,0,0.00%,227,227,0.00%
appsec-mobile.meituan.com,0,0.00%,329,329,0.00%
cad.youku.com,0,0.00%,185,185,0.00%
crash2.zhihu.com,0,0.00%,399,399,0.00%
dav.jianguoyun.com,0,0.00%,278,278,0.00%
dd.meituan.com,0,0.00%,348,348,0.00%
userinfo.docer.wps.cn,0,0.00%,152,152,0.00%
www.onlinedo.cn,0,0.00%,125,125,0.00%
xbtrutor.com,0,0.00%,148,148,0.00%
cu1pehnswss01.servicebus.windows.net,0,0.00%,157,157,0.00%
qq.com,0,0.00%,490,490,0.00%
open.trackerlist.xyz,0,0.00%,552,552,0.00%
tracker.xn--vzyr4p.top,0,0.00%,134,134,0.00%
btracker.top,0,0.00%,348,348,0.00%
tracker.corpscorp.online,0,0.00%,351,351,0.00%
torrent.unix-ag.uni-kl.de,0,0.00%,202,202,0.00%
dr.f.360.cn,0,0.00%,234,234,0.00%
tracker.open-internet.nl,0,0.00%,251,251,0.00%
kunpeng.csdn.net,0,0.00%,724,724,0.00%
link.csdn.net,0,0.00%,159,159,0.00%
flbgpi.meiquankongjian.com,0,0.00%,1701,1701,0.00%
master13.teamviewer.com,0,0.00%,108,108,0.00%
retracker.sevstar.net,0,0.00%,274,274,0.00%
datascene.net,0,0.00%,145,145,0.00%
iyes.youku.com,0,0.00%,210,210,0.00%
mapi.dianping.com,0,0.00%,285,285,0.00%
mlog.meituan.com,0,0.00%,176,176,0.00%
14-courier.push.apple.com,0,0.00%,501,501,0.00%
odobagg-my.sharepoint.com,0,0.00%,264,264,0.00%
bt.zlofenix.org,0,0.00%,150,150,0.00%
b23.tv,0,0.00%,240,240,0.00%
weby.aaas.org,0,0.00%,185,185,0.00%
tr.highstar.shop,0,0.00%,112,112,0.00%
tracker.iamhansen.xyz,0,0.00%,203,203,0.00%
p0.ssl.qhimg.com,0,0.00%,297,297,0.00%
pc.pay.youku.com,0,0.00%,171,171,0.00%
pgw-cld-s.alicdn.com,0,0.00%,175,175,0.00%
ping.cloud.tencent.com,0,0.00%,204,204,0.00%
pss-s.alicdn.com,0,0.00%,187,187,0.00%
pu-kos.ks3-cn-beijing.ksyun.com,0,0.00%,209,209,0.00%
qinfo.wps.cn,0,0.00%,236,236,0.00%
miaowu.baidu.com,0,0.00%,145,145,0.00%
21.telegream.online,0,0.00%,164,164,0.00%
open.nyap2p.com,0,0.00%,152,152,0.00%
t.acg.rip,0,0.00%,774,774,0.00%
www.jianshu.com,0,0.00%,189,189,0.00%
i.csdn.net,0,0.00%,133,133,0.00%
px.ads.linkedin.com,0,0.00%,301,301,0.00%
ww62.uatracker.net,0,0.00%,1256,1256,0.00%
trackme.theom.nz,0,0.00%,139,139,0.00%
count.cnblogs.com,0,0.00%,282,282,0.00%
49-courier.push.apple.com,0,0.00%,491,491,0.00%
1337.abcvg.info,0,0.00%,390,390,0.00%
torrent.ubuntu.com,0,0.00%,144,144,0.00%
tr.abiir.top,0,0.00%,143,143,0.00%
yisuapi.yisu.com,0,0.00%,140,140,0.00%
in.hceok.com,0,0.00%,364,364,0.00%
chihaya-heroku.120181311.xyz,0,0.00%,129,129,0.00%
download.api.bsb.baidu.com,0,0.00%,304,304,0.00%
r1---sn-2x3elnee.gvt1.com,0,0.00%,109,109,0.00%
data-vef.xboxlive.com,0,0.00%,226,226,0.00%
torrenttracker.nwc.acsalaska.net,0,0.00%,110,110,0.00%
tr.burnabyhighstar.com,0,0.00%,148,148,0.00%
os2-7.nigirocloud.com,0,0.00%,503,503,0.00%
os2-8.nigirocloud.com,0,0.00%,516,516,0.00%
nl1-1.nigirocloud.com,0,0.00%,521,521,0.00%
nl1-2.nigirocloud.com,0,0.00%,510,510,0.00%
nl1-3.nigirocloud.com,0,0.00%,511,511,0.00%
us2-1.nigirocloud.com,0,0.00%,532,532,0.00%
us2-2.nigirocloud.com,0,0.00%,528,528,0.00%
us2-3.nigirocloud.com,0,0.00%,536,536,0.00%
us2-4.nigirocloud.com,0,0.00%,534,534,0.00%
us3-1.nigirocloud.com,0,0.00%,545,545,0.00%
us3-2.nigirocloud.com,0,0.00%,536,536,0.00%
us3-3.nigirocloud.com,0,0.00%,525,525,0.00%
us3-4.nigirocloud.com,0,0.00%,536,536,0.00%
us3-5.nigirocloud.com,0,0.00%,533,533,0.00%
us3-6.nigirocloud.com,0,0.00%,532,532,0.00%
us3-7.nigirocloud.com,0,0.00%,524,524,0.00%
us3-8.nigirocloud.com,0,0.00%,528,528,0.00%
ap15ad.cdn.node.a.ddns-ounk.xyz,0,0.00%,809,809,0.00%
pcstat.kugou.com,0,0.00%,302,302,0.00%
upd.sangfor.com.cn,0,0.00%,5152,5152,0.00%
apidns.kwd.inkuai.com,0,0.00%,673,673,0.00%
cloudinfo.rising.com.cn,0,0.00%,3876,3876,0.00%
mesh.if.iqiyi.com,0,0.00%,336,336,0.00%
login.tailscale.com,0,0.00%,2712,2712,0.00%
kiteweb.b-cdn.net,0,0.00%,293,293,0.00%
objects.githubusercontent.com,0,0.00%,242,242,0.00%
array808.prod.do.dsp.mp.microsoft.com,0,0.00%,476,476,0.00%
cloud.streamsets.com,0,0.00%,303,303,0.00%
code.eulix.xyz,0,0.00%,500,500,0.00%
api.tabnine.com,0,0.00%,1324,1324,0.00%
zjvpn.zhejianglab.com,0,0.00%,251,251,0.00%
v2-mg02.kwaicdn.com,0,0.00%,437,437,0.00%
httpdns.bcelive.com,0,0.00%,410,410,0.00%
hk1-1.nigirocloud.com,0,0.00%,647,647,0.00%
ts-helper.2345.cc,0,0.00%,332,332,0.00%
kuaishou.httpdns.pro,0,0.00%,199,199,0.00%
static-pcs-sdk-server.alibaba.com,0,0.00%,432,432,0.00%
rq.optimize.cloud.duba.net,0,0.00%,216,216,0.00%
accscdn.m.taobao.com,0,0.00%,373,373,0.00%
sdxl.wanmeilink.com,0,0.00%,320,320,0.00%
uulogin01.com,0,0.00%,249,249,0.00%
garenaconnect.com,0,0.00%,311,311,0.00%
opera-mini.net,0,0.00%,314,314,0.00%
yl.qq.com,0,0.00%,580,580,0.00%
www.letou8.com,0,0.00%,307,307,0.00%
uulogin02.com,0,0.00%,243,243,0.00%
webex.com,0,0.00%,790,790,0.00%
via.cnode.xyz,0,0.00%,642,642,0.00%
hw-web-player-tracker.biliapi.net,0,0.00%,748,748,0.00%
ns1.dns-parking.com,0,0.00%,21373,21373,0.00%
ns2.dns-parking.com,0,0.00%,21426,21426,0.00%
dns1.p05.nsone.net,0,0.00%,1562,1562,0.00%
dns2.p05.nsone.net,0,0.00%,1582,1582,0.00%
dns3.p05.nsone.net,0,0.00%,1569,1569,0.00%
dns4.p05.nsone.net,0,0.00%,1572,1572,0.00%
dns2.namecheaphosting.com,0,0.00%,13812,13812,0.00%
ns03.domaincontrol.com,0,0.00%,9367,9367,0.00%
ns04.domaincontrol.com,0,0.00%,9549,9549,0.00%
ns1.bodis.com,0,0.00%,13552,13552,0.00%
ns65.domaincontrol.com,0,0.00%,5881,5881,0.00%
ns0.wixdns.net,0,0.00%,4070,4070,0.00%
monovm.venus.orderbox-dns.com,0,0.00%,1146,1146,0.00%
ns27.domaincontrol.com,0,0.00%,4569,4569,0.00%
dns3.sered.net,0,0.00%,305,305,0.00%
ns16.domaincontrol.com,0,0.00%,4944,4944,0.00%
ns43.domaincontrol.com,0,0.00%,10294,10294,0.00%
ns11.wixdns.net,0,0.00%,3924,3924,0.00%
dns1.hichina.com,0,0.00%,1777,1777,0.00%
ns19.domaincontrol.com,0,0.00%,14196,14196,0.00%
ns-cloud-c3.googledomains.com,0,0.00%,15599,15599,0.00%
ns-cloud-a1.googledomains.com,0,0.00%,15703,15703,0.00%
dns1.cscdns.net,0,0.00%,870,870,0.00%
ns-cloud-e4.googledomains.com,0,0.00%,15572,15572,0.00%
ns05.domaincontrol.com,0,0.00%,5066,5066,0.00%
ns44.domaincontrol.com,0,0.00%,10220,10220,0.00%
wally.ns.cloudflare.com,0,0.00%,204,204,0.00%
ns20.domaincontrol.com,0,0.00%,14427,14427,0.00%
ns73.domaincontrol.com,0,0.00%,9188,9188,0.00%
dns101.registrar-servers.com,0,0.00%,13824,13824,0.00%
ns-cloud-c2.googledomains.com,0,0.00%,15607,15607,0.00%
ns-cloud-a4.googledomains.com,0,0.00%,15627,15627,0.00%
dns2.cscdns.net,0,0.00%,868,868,0.00%
ns06.domaincontrol.com,0,0.00%,5162,5162,0.00%
dns2.hichina.com,0,0.00%,1773,1773,0.00%
ns-cloud-c1.googledomains.com,0,0.00%,15710,15710,0.00%
ns-cloud-c4.googledomains.com,0,0.00%,15637,15637,0.00%
ns-cloud-d3.googledomains.com,0,0.00%,15846,15846,0.00%
dns2.registrar-servers.com,0,0.00%,97015,97015,0.00%
ns-cloud-a3.googledomains.com,0,0.00%,15675,15675,0.00%
ns14.wixdns.net,0,0.00%,4139,4139,0.00%
ns1.dreamhost.com,0,0.00%,4604,4604,0.00%
ns2.p17.dynect.net,0,0.00%,390,390,0.00%
dns1.p08.nsone.net,0,0.00%,1590,1590,0.00%
ns-cloud-a2.googledomains.com,0,0.00%,15713,15713,0.00%
ns1.sedoparking.com,0,0.00%,5573,5573,0.00%
gerald.ns.cloudflare.com,0,0.00%,312,312,0.00%
ns2.systemdns.com,0,0.00%,2774,2774,0.00%
ns2.dreamhost.com,0,0.00%,4589,4589,0.00%
ns1.wordpress.com,0,0.00%,5974,5974,0.00%
ns3.dreamhost.com,0,0.00%,4605,4605,0.00%
ns2.wordpress.com,0,0.00%,5951,5951,0.00%
ns3.systemdns.com,0,0.00%,2718,2718,0.00%
ns1073.ui-dns.de,0,0.00%,190,190,0.00%
dns102.registrar-servers.com,0,0.00%,13707,13707,0.00%
ns15.wixdns.net,0,0.00%,4114,4114,0.00%
ns3ghw.name.com,0,0.00%,164,164,0.00%
tom.ns.cloudflare.com,0,0.00%,665,665,0.00%
ns1.systemdns.com,0,0.00%,2739,2739,0.00%
ns1.o2switch.net,0,0.00%,992,992,0.00%
ns3.wordpress.com,0,0.00%,5887,5887,0.00%
john.ns.cloudflare.com,0,0.00%,523,523,0.00%
ns-cloud-b2.googledomains.com,0,0.00%,16059,16059,0.00%
ns1123.ui-dns.de,0,0.00%,116,116,0.00%
ns2.bodis.com,0,0.00%,13536,13536,0.00%
ns1.siteground.net,0,0.00%,6384,6384,0.00%
ns28.domaincontrol.com,0,0.00%,4400,4400,0.00%
ns4jnz.name.com,0,0.00%,181,181,0.00%
ns2.o2switch.net,0,0.00%,977,977,0.00%
ns-cloud-b4.googledomains.com,0,0.00%,15894,15894,0.00%
dns210.b.register.com,0,0.00%,213,213,0.00%
ns1.openprovider.nl,0,0.00%,1840,1840,0.00%
ns74.domaincontrol.com,0,0.00%,9978,9978,0.00%
ns1117.ui-dns.org,0,0.00%,131,131,0.00%
ns-cloud-b1.googledomains.com,0,0.00%,15989,15989,0.00%
ns-cloud-b3.googledomains.com,0,0.00%,15989,15989,0.00%
dns036.c.register.com,0,0.00%,1416,1416,0.00%
ns3.openprovider.eu,0,0.00%,1832,1832,0.00%
ns-cloud-d1.googledomains.com,0,0.00%,15678,15678,0.00%
ns-cloud-d4.googledomains.com,0,0.00%,15640,15640,0.00%
dns083.d.register.com,0,0.00%,1531,1531,0.00%
ns2.openprovider.be,0,0.00%,1830,1830,0.00%
ns3.wixdns.net,0,0.00%,4224,4224,0.00%
ns-cloud-d2.googledomains.com,0,0.00%,15682,15682,0.00%
ns2.wixdns.net,0,0.00%,4198,4198,0.00%
ns1044.ui-dns.com,0,0.00%,139,139,0.00%
ns2.nic53.de,0,0.00%,2516,2516,0.00%
ns63.domaincontrol.com,0,0.00%,4620,4620,0.00%
ns2.bluehost.com,0,0.00%,9650,9650,0.00%
ns21055.ztomy.com,0,0.00%,467,467,0.00%
ns1.netregistry.net,0,0.00%,277,277,0.00%
dns21.hichina.com,0,0.00%,1763,1763,0.00%
ns1.amenworld.com,0,0.00%,943,943,0.00%
dns3.p01.nsone.net,0,0.00%,2160,2160,0.00%
ns42.domaincontrol.com,0,0.00%,5727,5727,0.00%
ns2.amenworld.com,0,0.00%,950,950,0.00%
ns13.wixdns.net,0,0.00%,4368,4368,0.00%
ns1.huaweicloud-dns.com,0,0.00%,3838,3838,0.00%
brenda.ns.cloudflare.com,0,0.00%,245,245,0.00%
ns3.netregistry.net,0,0.00%,277,277,0.00%
ns15.domaincontrol.com,0,0.00%,4904,4904,0.00%
ns12.wixdns.net,0,0.00%,4374,4374,0.00%
ns-cloud-e1.googledomains.com,0,0.00%,15558,15558,0.00%
ns2.host-h.net,0,0.00%,368,368,0.00%
dns200.anycast.me,0,0.00%,931,931,0.00%
ns2.sedopark.net,0,0.00%,2048,2048,0.00%
dns1.namecheaphosting.com,0,0.00%,13847,13847,0.00%
ns64.domaincontrol.com,0,0.00%,4608,4608,0.00%
ns1.huaweicloud-dns.cn,0,0.00%,3818,3818,0.00%
ns1.sedopark.net,0,0.00%,2028,2028,0.00%
ns1.huaweicloud-dns.net,0,0.00%,3801,3801,0.00%
ns4.nic.ru,0,0.00%,3239,3239,0.00%
ns2.netregistry.net,0,0.00%,283,283,0.00%
dns4.p03.nsone.net,0,0.00%,1473,1473,0.00%
ns.gestiondecuenta.com,0,0.00%,176,176,0.00%
ns1.huaweicloud-dns.org,0,0.00%,3844,3844,0.00%
ns11055.ztomy.com,0,0.00%,471,471,0.00%
dns7.hichina.com,0,0.00%,1810,1810,0.00%
ns3.colombiahosting.com,0,0.00%,133,133,0.00%
ns2.dan.com,0,0.00%,15331,15331,0.00%
dns1.123hjemmeside.dk,0,0.00%,605,605,0.00%
yahir.ns.cloudflare.com,0,0.00%,217,217,0.00%
ns1088.ui-dns.de,0,0.00%,149,149,0.00%
dns2.123hjemmeside.dk,0,0.00%,607,607,0.00%
toby.ns.cloudflare.com,0,0.00%,203,203,0.00%
jerome.ns.cloudflare.com,0,0.00%,438,438,0.00%
ns1.natrohost.com,0,0.00%,3568,3568,0.00%
ns1020.ui-dns.org,0,0.00%,304,304,0.00%
dns3.123hjemmeside.dk,0,0.00%,602,602,0.00%
ns36.domaincontrol.com,0,0.00%,15273,15273,0.00%
ns1.host-h.net,0,0.00%,365,365,0.00%
moura.ns.cloudflare.com,0,0.00%,266,266,0.00%
ns1.dnsowl.com,0,0.00%,10031,10031,0.00%
ns3.gestiondecuenta.com,0,0.00%,174,174,0.00%
liberty.ns.cloudflare.com,0,0.00%,200,200,0.00%
ns2.dnsimple.com,0,0.00%,913,913,0.00%
ns1.colombiahosting.com,0,0.00%,139,139,0.00%
ns2.dns-h.com,0,0.00%,367,367,0.00%
ns3.dnsimple.com,0,0.00%,912,912,0.00%
ns4.colombiahosting.com,0,0.00%,131,131,0.00%
ns-cloud-e2.googledomains.com,0,0.00%,15686,15686,0.00%
amy.ns.cloudflare.com,0,0.00%,261,261,0.00%
ns4.dnsimple.com,0,0.00%,914,914,0.00%
ns1066.ui-dns.com,0,0.00%,215,215,0.00%
ns10.wixdns.net,0,0.00%,3945,3945,0.00%
todd.ns.cloudflare.com,0,0.00%,465,465,0.00%
ns2.dnsowl.com,0,0.00%,10089,10089,0.00%
ns1069.ui-dns.biz,0,0.00%,146,146,0.00%
ns17.domaincontrol.com,0,0.00%,6837,6837,0.00%
ns3.wpx.ne.jp,0,0.00%,187,187,0.00%
ns2.colombiahosting.com,0,0.00%,138,138,0.00%
ns2.gestiondecuenta.com,0,0.00%,175,175,0.00%
verification2.plaindns.net,0,0.00%,265,265,0.00%
dns3.home.pl,0,0.00%,309,309,0.00%
ns4.gestiondecuenta.com,0,0.00%,171,171,0.00%
ns1.hover.com,0,0.00%,2966,2966,0.00%
ns1066.ui-dns.de,0,0.00%,187,187,0.00%
ns2.hover.com,0,0.00%,2990,2990,0.00%
ns2.inmotionhosting.com,0,0.00%,994,994,0.00%
ns23.domaincontrol.com,0,0.00%,9584,9584,0.00%
ns1079.ui-dns.com,0,0.00%,158,158,0.00%
ns7.wixdns.net,0,0.00%,4169,4169,0.00%
ns24.domaincontrol.com,0,0.00%,9555,9555,0.00%
ns3.dnsowl.com,0,0.00%,10058,10058,0.00%
ns6.wixdns.net,0,0.00%,4178,4178,0.00%
ns1026.ui-dns.org,0,0.00%,180,180,0.00%
ns11.jimdo.com,0,0.00%,411,411,0.00%
ns1068.ui-dns.biz,0,0.00%,208,208,0.00%
ns3.contabo.net,0,0.00%,621,621,0.00%
ns2.contabo.net,0,0.00%,624,624,0.00%
ns1042.ui-dns.org,0,0.00%,110,110,0.00%
ns2.a2hosting.com,0,0.00%,820,820,0.00%
ns3.a2hosting.com,0,0.00%,821,821,0.00%
ns1040.ui-dns.com,0,0.00%,232,232,0.00%
ns4.a2hosting.com,0,0.00%,809,809,0.00%
ns1033.ui-dns.biz,0,0.00%,154,154,0.00%
ns1.a2hosting.com,0,0.00%,821,821,0.00%
ns-cloud-e3.googledomains.com,0,0.00%,15707,15707,0.00%
scott.ns.cloudflare.com,0,0.00%,424,424,0.00%
dns8.hichina.com,0,0.00%,1761,1761,0.00%
ns5.wixdns.net,0,0.00%,4108,4108,0.00%
dns2.p06.nsone.net,0,0.00%,1641,1641,0.00%
kirk.ns.cloudflare.com,0,0.00%,192,192,0.00%
dns17.hichina.com,0,0.00%,1814,1814,0.00%
dns14.hichina.com,0,0.00%,1800,1800,0.00%
serena.ns.cloudflare.com,0,0.00%,202,202,0.00%
ns2fln.name.com,0,0.00%,714,714,0.00%
dns20.hichina.com,0,0.00%,1782,1782,0.00%
roman.ns.cloudflare.com,0,0.00%,207,207,0.00%
ns3.xserver.jp,0,0.00%,4233,4233,0.00%
dns18.hichina.com,0,0.00%,1810,1810,0.00%
ns3bfm.name.com,0,0.00%,503,503,0.00%
dns32.hichina.com,0,0.00%,1814,1814,0.00%
dns1.p06.nsone.net,0,0.00%,1668,1668,0.00%
dns13.hichina.com,0,0.00%,1826,1826,0.00%
ns1.bluehost.com,0,0.00%,9590,9590,0.00%
dns4.hichina.com,0,0.00%,1752,1752,0.00%
ns.udag.org,0,0.00%,1328,1328,0.00%
ns4lpv.name.com,0,0.00%,625,625,0.00%
dns01.muumuu-domain.com,0,0.00%,1619,1619,0.00%
donald.ns.cloudflare.com,0,0.00%,1142,1142,0.00%
ns1049.ui-dns.org,0,0.00%,176,176,0.00%
dns19.hichina.com,0,0.00%,1772,1772,0.00%
dns02.muumuu-domain.com,0,0.00%,1642,1642,0.00%
dns31.hichina.com,0,0.00%,1822,1822,0.00%
dns3.p06.nsone.net,0,0.00%,1646,1646,0.00%
kate.ns.cloudflare.com,0,0.00%,2112,2112,0.00%
ns4.wixdns.net,0,0.00%,4106,4106,0.00%
ns3.netim.net,0,0.00%,232,232,0.00%
dns3.hichina.com,0,0.00%,1770,1770,0.00%
dns4.p06.nsone.net,0,0.00%,1662,1662,0.00%
anuj.ns.cloudflare.com,0,0.00%,240,240,0.00%
ns4233.hostgator.com,0,0.00%,261,261,0.00%
ns2.youcan.shop,0,0.00%,911,911,0.00%
ns1118.ui-dns.org,0,0.00%,170,170,0.00%
sarah.ns.cloudflare.com,0,0.00%,157,157,0.00%
ns1031.ui-dns.de,0,0.00%,180,180,0.00%
ns4234.hostgator.com,0,0.00%,261,261,0.00%
yns2.yahoo.com,0,0.00%,274,274,0.00%
ns1078.ui-dns.biz,0,0.00%,136,136,0.00%
ns1108.ui-dns.biz,0,0.00%,161,161,0.00%
yns1.yahoo.com,0,0.00%,276,276,0.00%
ns1065.ui-dns.com,0,0.00%,155,155,0.00%
dns1.p01.nsone.net,0,0.00%,2141,2141,0.00%
dns2.p01.nsone.net,0,0.00%,2183,2183,0.00%
shades18.rzone.de,0,0.00%,202,202,0.00%
dns10.hichina.com,0,0.00%,1916,1916,0.00%
aron.ns.cloudflare.com,0,0.00%,383,383,0.00%
ns1093.ui-dns.com,0,0.00%,209,209,0.00%
ns12.jimdo.com,0,0.00%,410,410,0.00%
docks04.rzone.de,0,0.00%,202,202,0.00%
ns1.matbao.com,0,0.00%,2680,2680,0.00%
ns1093.ui-dns.de,0,0.00%,212,212,0.00%
jason.ns.cloudflare.com,0,0.00%,334,334,0.00%
dns9.hichina.com,0,0.00%,1931,1931,0.00%
dns26.hichina.com,0,0.00%,1916,1916,0.00%
sandra.ns.cloudflare.com,0,0.00%,223,223,0.00%
ns-a2.conoha.io,0,0.00%,2409,2409,0.00%
dns25.hichina.com,0,0.00%,1888,1888,0.00%
ns01.hostnet.nl,0,0.00%,869,869,0.00%
fortaleza.porkbun.com,0,0.00%,5815,5815,0.00%
ns-a3.conoha.io,0,0.00%,2419,2419,0.00%
ns35.domaincontrol.com,0,0.00%,15239,15239,0.00%
josh.ns.cloudflare.com,0,0.00%,185,185,0.00%
ns-a1.conoha.io,0,0.00%,2421,2421,0.00%
ns2.netim.net,0,0.00%,225,225,0.00%
mckenzie.ns.cloudflare.com,0,0.00%,198,198,0.00%
ns98.worldnic.com,0,0.00%,287,287,0.00%
ns.udag.de,0,0.00%,1344,1344,0.00%
ns1.dan.com,0,0.00%,15399,15399,0.00%
ns2.dynadot.com,0,0.00%,7594,7594,0.00%
ns41.domaincontrol.com,0,0.00%,5691,5691,0.00%
dns047.b.register.com,0,0.00%,113,113,0.00%
ns1098.ui-dns.org,0,0.00%,108,108,0.00%
verification-e4d900f2.ns3.dan.hosting,0,0.00%,1947,1947,0.00%
dns176.d.register.com,0,0.00%,1236,1236,0.00%
ns8.alidns.com,0,0.00%,2971,2971,0.00%
summer.ns.cloudflare.com,0,0.00%,149,149,0.00%
ns2.rumahweb.com,0,0.00%,1132,1132,0.00%
ns73.worldnic.com,0,0.00%,277,277,0.00%
dns223.c.register.com,0,0.00%,1169,1169,0.00%
dns1.p04.nsone.net,0,0.00%,1606,1606,0.00%
ns1.p17.dynect.net,0,0.00%,383,383,0.00%
ns7.alidns.com,0,0.00%,3139,3139,0.00%
ns1087.ui-dns.de,0,0.00%,127,127,0.00%
ns2.mytrafficmanagement.com,0,0.00%,2827,2827,0.00%
ns74.worldnic.com,0,0.00%,267,267,0.00%
ns4.rumahweb.net,0,0.00%,1127,1127,0.00%
ns10.hawkhost.com,0,0.00%,506,506,0.00%
ns1.rumahweb.com,0,0.00%,1125,1125,0.00%
failed-whois-verification.namecheap.com,0,0.00%,4011,4011,0.00%
audrey.ns.cloudflare.com,0,0.00%,115,115,0.00%
ns3.rumahweb.net,0,0.00%,1106,1106,0.00%
pdns2.registrar-servers.com,0,0.00%,1788,1788,0.00%
ns1.nic53.net,0,0.00%,2581,2581,0.00%
verify-contact-details.namecheap.com,0,0.00%,4007,4007,0.00%
braden.ns.cloudflare.com,0,0.00%,148,148,0.00%
dns27.hichina.com,0,0.00%,1714,1714,0.00%
iris.ns.cloudflare.com,0,0.00%,380,380,0.00%
ns1.dynadot.com,0,0.00%,7588,7588,0.00%
ns1087.ui-dns.com,0,0.00%,130,130,0.00%
dns28.hichina.com,0,0.00%,1685,1685,0.00%
ns1113.ui-dns.de,0,0.00%,135,135,0.00%
03.dnsv.jp,0,0.00%,6905,6905,0.00%
ns5.kasserver.com,0,0.00%,1223,1223,0.00%
ns0.transip.net,0,0.00%,1005,1005,0.00%
ns6.kasserver.com,0,0.00%,1210,1210,0.00%
b.dns.hostway.net,0,0.00%,102,102,0.00%
ns2.transip.eu,0,0.00%,997,997,0.00%
evangeline.ns.cloudflare.com,0,0.00%,374,374,0.00%
ns2.domain.com,0,0.00%,3560,3560,0.00%
ns1.transip.nl,0,0.00%,993,993,0.00%
guss.ns.cloudflare.com,0,0.00%,2654,2654,0.00%
ns1.domain.com,0,0.00%,3558,3558,0.00%
ns5.cdmondns-01.com,0,0.00%,526,526,0.00%
ns2.alidns.com,0,0.00%,2768,2768,0.00%
ns1030.ui-dns.de,0,0.00%,190,190,0.00%
eloise.ns.cloudflare.com,0,0.00%,157,157,0.00%
ns1.alidns.com,0,0.00%,2742,2742,0.00%
hal.ns.cloudflare.com,0,0.00%,934,934,0.00%
dns3.p08.nsone.net,0,0.00%,1562,1562,0.00%
ns1.wixdns.net,0,0.00%,4083,4083,0.00%
ns1020.ui-dns.biz,0,0.00%,142,142,0.00%
frank.ns.cloudflare.com,0,0.00%,2045,2045,0.00%
ns2.crazydomains.com,0,0.00%,2829,2829,0.00%
dns23.hichina.com,0,0.00%,1802,1802,0.00%
ignat.ns.cloudflare.com,0,0.00%,146,146,0.00%
ns1.domainhasexpired.com,0,0.00%,950,950,0.00%
ns1.crazydomains.com,0,0.00%,2822,2822,0.00%
01.dnsv.jp,0,0.00%,6929,6929,0.00%
ns2.domainhasexpired.com,0,0.00%,942,942,0.00%
ruth.ns.cloudflare.com,0,0.00%,335,335,0.00%
ns2.cdmon.net,0,0.00%,542,542,0.00%
ns59.domaincontrol.com,0,0.00%,2700,2700,0.00%
02.dnsv.jp,0,0.00%,6882,6882,0.00%
ns3.cdmon.net,0,0.00%,551,551,0.00%
ns4.xserver.jp,0,0.00%,4299,4299,0.00%
ns.udag.net,0,0.00%,1324,1324,0.00%
dns1.p07.nsone.net,0,0.00%,1589,1589,0.00%
chip.ns.cloudflare.com,0,0.00%,182,182,0.00%
dns2.p07.nsone.net,0,0.00%,1608,1608,0.00%
rosalyn.ns.cloudflare.com,0,0.00%,100,100,0.00%
dns3.p07.nsone.net,0,0.00%,1604,1604,0.00%
dns4.p07.nsone.net,0,0.00%,1604,1604,0.00%
david.ns.cloudflare.com,0,0.00%,377,377,0.00%
art.ns.cloudflare.com,0,0.00%,234,234,0.00%
nola.ns.cloudflare.com,0,0.00%,479,479,0.00%
dns22.hichina.com,0,0.00%,1764,1764,0.00%
dorthy.ns.cloudflare.com,0,0.00%,472,472,0.00%
dns1.p02.nsone.net,0,0.00%,1584,1584,0.00%
ntp4.aliyun.com,0,0.00%,711,711,0.00%
carl.ns.cloudflare.com,0,0.00%,287,287,0.00%
aldo.ns.cloudflare.com,0,0.00%,172,172,0.00%
ns2.value-domain.com,0,0.00%,1455,1455,0.00%
fish.ns.cloudflare.com,0,0.00%,202,202,0.00%
ns1.value-domain.com,0,0.00%,1468,1468,0.00%
curitiba.porkbun.com,0,0.00%,5809,5809,0.00%
ns2.domaindiscount24.net,0,0.00%,191,191,0.00%
george.ns.cloudflare.com,0,0.00%,389,389,0.00%
aspen.ns.cloudflare.com,0,0.00%,246,246,0.00%
dns3.name-services.com,0,0.00%,2548,2548,0.00%
chin.ns.cloudflare.com,0,0.00%,262,262,0.00%
gina.ns.cloudflare.com,0,0.00%,545,545,0.00%
ns1.eftydns.com,0,0.00%,479,479,0.00%
ns3.p17.dynect.net,0,0.00%,381,381,0.00%
dean.ns.cloudflare.com,0,0.00%,254,254,0.00%
opal.ns.cloudflare.com,0,0.00%,111,111,0.00%
ns2.eftydns.com,0,0.00%,486,486,0.00%
ns2.reg.ru,0,0.00%,16684,16684,0.00%
aria.ns.cloudflare.com,0,0.00%,165,165,0.00%
ns9.wixdns.net,0,0.00%,3999,3999,0.00%
dns3.cosmotown.com,0,0.00%,210,210,0.00%
ns3.domaindiscount24.net,0,0.00%,201,201,0.00%
dns4.p08.nsone.net,0,0.00%,1555,1555,0.00%
ns8.wixdns.net,0,0.00%,4052,4052,0.00%
ns1.fornex.com,0,0.00%,360,360,0.00%
ns1.domaindiscount24.net,0,0.00%,201,201,0.00%
ns2.fornex.com,0,0.00%,357,357,0.00%
ns10.ovh.net,0,0.00%,799,799,0.00%
monovm.earth.orderbox-dns.com,0,0.00%,1130,1130,0.00%
dns1.sered.net,0,0.00%,338,338,0.00%
dns10.ovh.net,0,0.00%,799,799,0.00%
ns3.fornex.com,0,0.00%,361,361,0.00%
bob.ns.cloudflare.com,0,0.00%,531,531,0.00%
dns2.sered.net,0,0.00%,336,336,0.00%
ns3.stackdns.com,0,0.00%,1830,1830,0.00%
albert.ns.cloudflare.com,0,0.00%,372,372,0.00%
betty.ns.cloudflare.com,0,0.00%,296,296,0.00%
ns1.mytrafficmanagement.com,0,0.00%,2828,2828,0.00%
a.dns.hostway.net,0,0.00%,101,101,0.00%
ken.ns.cloudflare.com,0,0.00%,426,426,0.00%
alla.ns.cloudflare.com,0,0.00%,164,164,0.00%
ns1.maff.com,0,0.00%,1594,1594,0.00%
sergi.ns.cloudflare.com,0,0.00%,141,141,0.00%
aleena.ns.cloudflare.com,0,0.00%,549,549,0.00%
pdns1.registrar-servers.com,0,0.00%,1788,1788,0.00%
nick.ns.cloudflare.com,0,0.00%,178,178,0.00%
ns-a3.cloud.z.com,0,0.00%,213,213,0.00%
ns66.domaincontrol.com,0,0.00%,5786,5786,0.00%
bella.ns.cloudflare.com,0,0.00%,244,244,0.00%
shades05.rzone.de,0,0.00%,207,207,0.00%
ns-a4.cloud.z.com,0,0.00%,207,207,0.00%
ns18.domaincontrol.com,0,0.00%,6892,6892,0.00%
theo.ns.cloudflare.com,0,0.00%,810,810,0.00%
dns4.cosmotown.com,0,0.00%,208,208,0.00%
ns-a1.cloud.z.com,0,0.00%,209,209,0.00%
docks03.rzone.de,0,0.00%,218,218,0.00%
ns2.maff.com,0,0.00%,1559,1559,0.00%
ns7.lwsdns.com,0,0.00%,1351,1351,0.00%
ns245.neubox.net,0,0.00%,282,282,0.00%
ns8.lwsdns.com,0,0.00%,1331,1331,0.00%
ns143.neubox.net,0,0.00%,281,281,0.00%
ns.zxcs.eu,0,0.00%,1025,1025,0.00%
monovm.mercury.orderbox-dns.com,0,0.00%,1146,1146,0.00%
ns.zxcs.be,0,0.00%,1018,1018,0.00%
ns1.netim.net,0,0.00%,229,229,0.00%
asa.ns.cloudflare.com,0,0.00%,320,320,0.00%
ns6.lwsdns.com,0,0.00%,1332,1332,0.00%
cdns2.main-hosting.eu,0,0.00%,328,328,0.00%
ns2.ipage.com,0,0.00%,727,727,0.00%
ns5.lwsdns.com,0,0.00%,1331,1331,0.00%
ns11.worldnic.com,0,0.00%,306,306,0.00%
ns3.afternic.com,0,0.00%,1035,1035,0.00%
ns4.afternic.com,0,0.00%,1057,1057,0.00%
finley.ns.cloudflare.com,0,0.00%,171,171,0.00%
ns2.xserver.jp,0,0.00%,4298,4298,0.00%
dns1.hostgator.com.br,0,0.00%,1005,1005,0.00%
ns1.xserver.jp,0,0.00%,4307,4307,0.00%
dns2.hostgator.com.br,0,0.00%,1019,1019,0.00%
hans.ns.cloudflare.com,0,0.00%,365,365,0.00%
dns2.p02.nsone.net,0,0.00%,1573,1573,0.00%
dns.technorail.com,0,0.00%,2476,2476,0.00%
ns5.xserver.jp,0,0.00%,4298,4298,0.00%
ns1.emailverification.info,0,0.00%,446,446,0.00%
dns3.p02.nsone.net,0,0.00%,1596,1596,0.00%
dns2.technorail.com,0,0.00%,2473,2473,0.00%
ns.tradeindia.com,0,0.00%,377,377,0.00%
dns4.p02.nsone.net,0,0.00%,1593,1593,0.00%
nsid1.rumahweb.com,0,0.00%,347,347,0.00%
dns4.arubadns.cz,0,0.00%,2476,2476,0.00%
ns12.xincache.com,0,0.00%,1735,1735,0.00%
dns3.arubadns.net,0,0.00%,2486,2486,0.00%
dexter.ns.cloudflare.com,0,0.00%,325,325,0.00%
austin.ns.cloudflare.com,0,0.00%,435,435,0.00%
jeremy.ns.cloudflare.com,0,0.00%,250,250,0.00%
kira.ns.cloudflare.com,0,0.00%,300,300,0.00%
virginia.ns.cloudflare.com,0,0.00%,190,190,0.00%
ns1.hostmonster.com,0,0.00%,197,197,0.00%
ns60.domaincontrol.com,0,0.00%,2751,2751,0.00%
ns1.world4you.at,0,0.00%,278,278,0.00%
ns2.world4you.at,0,0.00%,277,277,0.00%
sean.ns.cloudflare.com,0,0.00%,413,413,0.00%
zelda.ns.cloudflare.com,0,0.00%,248,248,0.00%
ns12.servicio-online.net,0,0.00%,279,279,0.00%
salvador.ns.porkbun.com,0,0.00%,681,681,0.00%
dns111.ovh.net,0,0.00%,5372,5372,0.00%
ns54.domaincontrol.com,0,0.00%,7860,7860,0.00%
ns1.webnames.ca,0,0.00%,135,135,0.00%
raphaela.ns.cloudflare.com,0,0.00%,107,107,0.00%
ns13.domaincontrol.com,0,0.00%,6755,6755,0.00%
ns1.bdm.microsoftonline.com,0,0.00%,1246,1246,0.00%
melina.ns.cloudflare.com,0,0.00%,228,228,0.00%
ns14.domaincontrol.com,0,0.00%,6682,6682,0.00%
ns2.vultr.com,0,0.00%,298,298,0.00%
ns2.bdm.microsoftonline.com,0,0.00%,1241,1241,0.00%
ns3.digitalocean.com,0,0.00%,2254,2254,0.00%
perla.ns.cloudflare.com,0,0.00%,2341,2341,0.00%
ns.otherdns.com,0,0.00%,244,244,0.00%
ns1.livedns.co.uk,0,0.00%,2124,2124,0.00%
ns3.bdm.microsoftonline.com,0,0.00%,1248,1248,0.00%
ns48.domaincontrol.com,0,0.00%,7639,7639,0.00%
ns111.ovh.net,0,0.00%,5381,5381,0.00%
ns4.linode.com,0,0.00%,468,468,0.00%
tanner.ns.cloudflare.com,0,0.00%,481,481,0.00%
ns47.domaincontrol.com,0,0.00%,7595,7595,0.00%
ns2.livedns.co.uk,0,0.00%,2121,2121,0.00%
ns.dns2.co.za,0,0.00%,244,244,0.00%
ns1.stackdns.com,0,0.00%,1839,1839,0.00%
ns3.linode.com,0,0.00%,476,476,0.00%
carter.ns.cloudflare.com,0,0.00%,352,352,0.00%
dns11.hichina.com,0,0.00%,1890,1890,0.00%
ns4.bdm.microsoftonline.com,0,0.00%,1233,1233,0.00%
ns3.livedns.co.uk,0,0.00%,2119,2119,0.00%
zara.ns.cloudflare.com,0,0.00%,417,417,0.00%
ns2.linode.com,0,0.00%,466,466,0.00%
ns.dns1.co.za,0,0.00%,244,244,0.00%
monovm.mars.orderbox-dns.com,0,0.00%,1141,1141,0.00%
ns5.linode.com,0,0.00%,477,477,0.00%
dns3.p04.nsone.net,0,0.00%,1625,1625,0.00%
pdns08.domaincontrol.com,0,0.00%,940,940,0.00%
ns.otherdns.net,0,0.00%,244,244,0.00%
ns1.linode.com,0,0.00%,464,464,0.00%
ns2.liqu.id,0,0.00%,112,112,0.00%
ns5.worldnic.com,0,0.00%,307,307,0.00%
ns1018.ui-dns.org,0,0.00%,152,152,0.00%
ns1.liqu.id,0,0.00%,112,112,0.00%
bill.ns.cloudflare.com,0,0.00%,206,206,0.00%
ns2.niagahoster.com,0,0.00%,1999,1999,0.00%
ns-uk.topdns.com,0,0.00%,750,750,0.00%
ns97.worldnic.com,0,0.00%,275,275,0.00%
ns2.jimdo.com,0,0.00%,192,192,0.00%
surina.ns.cloudflare.com,0,0.00%,389,389,0.00%
maceio.porkbun.com,0,0.00%,5773,5773,0.00%
ns1.niagahoster.com,0,0.00%,2006,2006,0.00%
ns11.servicio-online.net,0,0.00%,275,275,0.00%
ns1123.ui-dns.biz,0,0.00%,140,140,0.00%
ns1050.ui-dns.com,0,0.00%,167,167,0.00%
ullis.ns.cloudflare.com,0,0.00%,205,205,0.00%
ns1121.ui-dns.org,0,0.00%,131,131,0.00%
ns1104.ui-dns.de,0,0.00%,121,121,0.00%
salvador.porkbun.com,0,0.00%,5805,5805,0.00%
ns71.domaincontrol.com,0,0.00%,6704,6704,0.00%
ns72.domaincontrol.com,0,0.00%,6833,6833,0.00%
dns.home.pl,0,0.00%,296,296,0.00%
ns4.dinahosting.com,0,0.00%,246,246,0.00%
ns5.byet.org,0,0.00%,130,130,0.00%
ns2.bluehost.in,0,0.00%,726,726,0.00%
grannbo.ns.cloudflare.com,0,0.00%,243,243,0.00%
ns2.dinahosting.com,0,0.00%,253,253,0.00%
ns3.dinahosting.com,0,0.00%,245,245,0.00%
ns.dinahosting.com,0,0.00%,257,257,0.00%
ns1.byet.org,0,0.00%,131,131,0.00%
hk1-6.nigirocloud.com,0,0.00%,545,545,0.00%
ty1-3.nigirocloud.com,0,0.00%,530,530,0.00%
hk1-5.nigirocloud.com,0,0.00%,594,594,0.00%
hk1-7.nigirocloud.com,0,0.00%,738,738,0.00%
hk1-3.nigirocloud.com,0,0.00%,543,543,0.00%
hk1-2.nigirocloud.com,0,0.00%,578,578,0.00%
hk1-8.nigirocloud.com,0,0.00%,553,553,0.00%
au1-1.nigirocloud.com,0,0.00%,539,539,0.00%
au1-3.nigirocloud.com,0,0.00%,528,528,0.00%
au1-2.nigirocloud.com,0,0.00%,526,526,0.00%
au1-4.nigirocloud.com,0,0.00%,548,548,0.00%
au2-2.nigirocloud.com,0,0.00%,517,517,0.00%
au2-1.nigirocloud.com,0,0.00%,532,532,0.00%
ina3.registrar.eu,0,0.00%,462,462,0.00%
au2-3.nigirocloud.com,0,0.00%,523,523,0.00%
au2-4.nigirocloud.com,0,0.00%,526,526,0.00%
de1-1.nigirocloud.com,0,0.00%,522,522,0.00%
ns1.domainesia.net,0,0.00%,1000,1000,0.00%
ns-a2.tenten.vn,0,0.00%,2086,2086,0.00%
ns07.domaincontrol.com,0,0.00%,6985,6985,0.00%
ns1.vercel-dns.com,0,0.00%,642,642,0.00%
ns3.byet.org,0,0.00%,129,129,0.00%
ns08.domaincontrol.com,0,0.00%,7086,7086,0.00%
brit.ns.cloudflare.com,0,0.00%,192,192,0.00%
irma.ns.cloudflare.com,0,0.00%,827,827,0.00%
ray.ns.cloudflare.com,0,0.00%,362,362,0.00%
dns24.hichina.com,0,0.00%,1798,1798,0.00%
ivy.ns.cloudflare.com,0,0.00%,217,217,0.00%
de1-2.nigirocloud.com,0,0.00%,520,520,0.00%
de1-3.nigirocloud.com,0,0.00%,547,547,0.00%
de1-4.nigirocloud.com,0,0.00%,515,515,0.00%
ns2.namecity.com,0,0.00%,146,146,0.00%
de2-1.nigirocloud.com,0,0.00%,523,523,0.00%
jermaine.ns.cloudflare.com,0,0.00%,572,572,0.00%
ns1.gname.net,0,0.00%,107641,107641,0.00%
de2-2.nigirocloud.com,0,0.00%,522,522,0.00%
de2-3.nigirocloud.com,0,0.00%,542,542,0.00%
ns3.regery.net,0,0.00%,173,173,0.00%
ns1.youcan.shop,0,0.00%,911,911,0.00%
jim.ns.cloudflare.com,0,0.00%,359,359,0.00%
ns1.namecity.com,0,0.00%,146,146,0.00%
de2-4.nigirocloud.com,0,0.00%,539,539,0.00%
ian.ns.cloudflare.com,0,0.00%,333,333,0.00%
dns1.nominalia.com,0,0.00%,757,757,0.00%
ee1-1.nigirocloud.com,0,0.00%,528,528,0.00%
alec.ns.cloudflare.com,0,0.00%,279,279,0.00%
brian.ns.cloudflare.com,0,0.00%,190,190,0.00%
ns2.regery.net,0,0.00%,174,174,0.00%
ee1-2.nigirocloud.com,0,0.00%,520,520,0.00%
ns2.gname.net,0,0.00%,108131,108131,0.00%
kara.ns.cloudflare.com,0,0.00%,1200,1200,0.00%
ns1.dns-h.com,0,0.00%,361,361,0.00%
shubhi.ns.cloudflare.com,0,0.00%,196,196,0.00%
meg.ns.cloudflare.com,0,0.00%,292,292,0.00%
ns116.inhostedns.com,0,0.00%,117,117,0.00%
barbara.ns.cloudflare.com,0,0.00%,371,371,0.00%
rocky.ns.cloudflare.com,0,0.00%,516,516,0.00%
damon.ns.cloudflare.com,0,0.00%,339,339,0.00%
ben.ns.cloudflare.com,0,0.00%,330,330,0.00%
rosa.ns.cloudflare.com,0,0.00%,437,437,0.00%
3-get.njalla.fo,0,0.00%,371,371,0.00%
ee1-3.nigirocloud.com,0,0.00%,539,539,0.00%
ee1-4.nigirocloud.com,0,0.00%,529,529,0.00%
us1-1.nigirocloud.com,0,0.00%,540,540,0.00%
nsn2.mijndomein.nl,0,0.00%,1390,1390,0.00%
nsn3.mijndomein.nl,0,0.00%,1387,1387,0.00%
ns1.liquidweb.com,0,0.00%,643,643,0.00%
ns316.inhostedns.org,0,0.00%,118,118,0.00%
ns1.vultr.com,0,0.00%,292,292,0.00%
lola.ns.cloudflare.com,0,0.00%,428,428,0.00%
ty1-4.nigirocloud.com,0,0.00%,525,525,0.00%
ns1cvw.name.com,0,0.00%,1611,1611,0.00%
ty2-1.nigirocloud.com,0,0.00%,514,514,0.00%
ns2.sedoparking.com,0,0.00%,5539,5539,0.00%
mario.ns.cloudflare.com,0,0.00%,740,740,0.00%
ns2dfg.name.com,0,0.00%,489,489,0.00%
ty2-2.nigirocloud.com,0,0.00%,497,497,0.00%
ty2-3.nigirocloud.com,0,0.00%,515,515,0.00%
ns2.locaweb.com.br,0,0.00%,469,469,0.00%
ty2-4.nigirocloud.com,0,0.00%,486,486,0.00%
dns2.p08.nsone.net,0,0.00%,1574,1574,0.00%
ns3ckl.name.com,0,0.00%,403,403,0.00%
eu.dnsenable.com,0,0.00%,2901,2901,0.00%
ty2-5.nigirocloud.com,0,0.00%,516,516,0.00%
ns4kpx.name.com,0,0.00%,256,256,0.00%
tr.dnsenable.com,0,0.00%,2877,2877,0.00%
ns1036.ui-dns.org,0,0.00%,211,211,0.00%
us1-2.nigirocloud.com,0,0.00%,549,549,0.00%
us1-3.nigirocloud.com,0,0.00%,509,509,0.00%
ns4237.hostgator.com,0,0.00%,223,223,0.00%
us.dnsenable.com,0,0.00%,2893,2893,0.00%
ns1024.ui-dns.com,0,0.00%,194,194,0.00%
us1-4.nigirocloud.com,0,0.00%,530,530,0.00%
ns5.hawkhost.com,0,0.00%,386,386,0.00%
ns4238.hostgator.com,0,0.00%,222,222,0.00%
ns1053.ui-dns.biz,0,0.00%,252,252,0.00%
dns1.name-services.com,0,0.00%,2565,2565,0.00%
etta.ns.cloudflare.com,0,0.00%,764,764,0.00%
rachel.ns.cloudflare.com,0,0.00%,351,351,0.00%
ns1052.ui-dns.de,0,0.00%,215,215,0.00%
ns1.webgo.de,0,0.00%,134,134,0.00%
thaddeus.ns.cloudflare.com,0,0.00%,597,597,0.00%
ty2-6.nigirocloud.com,0,0.00%,520,520,0.00%
ns1djs.name.com,0,0.00%,183,183,0.00%
ns2.phase8.net,0,0.00%,1865,1865,0.00%
ashley.ns.cloudflare.com,0,0.00%,225,225,0.00%
ns02.hostnet.nl,0,0.00%,871,871,0.00%
ns2hjl.name.com,0,0.00%,584,584,0.00%
9wu652mg-u.funnull01.vip,0,0.00%,663,663,0.00%
max.ns.cloudflare.com,0,0.00%,326,326,0.00%
ns2.digitalocean.com,0,0.00%,2258,2258,0.00%
ns1.phase8.net,0,0.00%,1887,1887,0.00%
2-can.njalla.in,0,0.00%,410,410,0.00%
ns2ckr.name.com,0,0.00%,945,945,0.00%
f6qya49d.n.funnull31.com,0,0.00%,677,677,0.00%
ns4dmx.name.com,0,0.00%,319,319,0.00%
ns3qty.name.com,0,0.00%,152,152,0.00%
rodney.ns.cloudflare.com,0,0.00%,211,211,0.00%
ns4bht.name.com,0,0.00%,484,484,0.00%
ty2-7.nigirocloud.com,0,0.00%,504,504,0.00%
ns4.webgo.de,0,0.00%,135,135,0.00%
ty2-8.nigirocloud.com,0,0.00%,503,503,0.00%
ns1cnb.name.com,0,0.00%,3258,3258,0.00%
1-you.njalla.no,0,0.00%,410,410,0.00%
os1-1.nigirocloud.com,0,0.00%,502,502,0.00%
ns27.netkl.com,0,0.00%,156,156,0.00%
ns1.beget.com,0,0.00%,6698,6698,0.00%
os1-2.nigirocloud.com,0,0.00%,506,506,0.00%
os1-3.nigirocloud.com,0,0.00%,516,516,0.00%
ns69.worldnic.com,0,0.00%,271,271,0.00%
os1-4.nigirocloud.com,0,0.00%,516,516,0.00%
ns70.worldnic.com,0,0.00%,273,273,0.00%
ns1094.ui-dns.com,0,0.00%,205,205,0.00%
ns3.webgo.de,0,0.00%,138,138,0.00%
ns-a3.tenten.vn,0,0.00%,2112,2112,0.00%
julio.ns.cloudflare.com,0,0.00%,147,147,0.00%
uns02.lolipop.jp,0,0.00%,1175,1175,0.00%
os1-5.nigirocloud.com,0,0.00%,507,507,0.00%
ns2.beget.com,0,0.00%,6616,6616,0.00%
hope.ns.cloudflare.com,0,0.00%,343,343,0.00%
uns01.lolipop.jp,0,0.00%,1188,1188,0.00%
graham.ns.cloudflare.com,0,0.00%,328,328,0.00%
dns4.p01.nsone.net,0,0.00%,2147,2147,0.00%
roan.ns.cloudflare.com,0,0.00%,342,342,0.00%
ns4243.hostgator.com,0,0.00%,200,200,0.00%
leah.ns.cloudflare.com,0,0.00%,266,266,0.00%
paige.ns.cloudflare.com,0,0.00%,202,202,0.00%
ns2.emailverification.info,0,0.00%,576,576,0.00%
ns5.afternic.com,0,0.00%,1487,1487,0.00%
ns4244.hostgator.com,0,0.00%,200,200,0.00%
ns2.webgo.de,0,0.00%,135,135,0.00%
vida.ns.cloudflare.com,0,0.00%,578,578,0.00%
johnathan.ns.cloudflare.com,0,0.00%,285,285,0.00%
ns3.argewebhosting.nl,0,0.00%,165,165,0.00%
ns1.regery.net,0,0.00%,170,170,0.00%
selah.ns.cloudflare.com,0,0.00%,263,263,0.00%
byron.ns.cloudflare.com,0,0.00%,155,155,0.00%
ns2.argewebhosting.com,0,0.00%,165,165,0.00%
ns90.worldnic.com,0,0.00%,286,286,0.00%
ns1.beget.pro,0,0.00%,6786,6786,0.00%
becky.ns.cloudflare.com,0,0.00%,189,189,0.00%
reza.ns.cloudflare.com,0,0.00%,265,265,0.00%
elinore.ns.cloudflare.com,0,0.00%,327,327,0.00%
ns2.beget.pro,0,0.00%,6848,6848,0.00%
may.ns.cloudflare.com,0,0.00%,484,484,0.00%
kai.ns.cloudflare.com,0,0.00%,228,228,0.00%
gail.ns.cloudflare.com,0,0.00%,387,387,0.00%
1-ceci.njalla.do,0,0.00%,187,187,0.00%
felicity.ns.cloudflare.com,0,0.00%,302,302,0.00%
christian.ns.cloudflare.com,0,0.00%,370,370,0.00%
galilea.ns.cloudflare.com,0,0.00%,293,293,0.00%
ns1.argewebhosting.eu,0,0.00%,165,165,0.00%
docks10.rzone.de,0,0.00%,218,218,0.00%
isabel.ns.cloudflare.com,0,0.00%,137,137,0.00%
3-pas.njalla.in,0,0.00%,188,188,0.00%
shades19.rzone.de,0,0.00%,173,173,0.00%
ns1103.ui-dns.com,0,0.00%,247,247,0.00%
docks02.rzone.de,0,0.00%,214,214,0.00%
ns85.worldnic.com,0,0.00%,281,281,0.00%
pablo.ns.cloudflare.com,0,0.00%,294,294,0.00%
ns86.worldnic.com,0,0.00%,278,278,0.00%
ns1092.ui-dns.org,0,0.00%,164,164,0.00%
ns1064.ui-dns.org,0,0.00%,176,176,0.00%
kami.ns.cloudflare.com,0,0.00%,373,373,0.00%
venus.ns.cloudflare.com,0,0.00%,175,175,0.00%
ns1091.ui-dns.de,0,0.00%,160,160,0.00%
ns1049.ui-dns.de,0,0.00%,151,151,0.00%
ns1126.ui-dns.biz,0,0.00%,164,164,0.00%
ns1028.ui-dns.biz,0,0.00%,193,193,0.00%
ns1116.ui-dns.com,0,0.00%,193,193,0.00%
ns25.domaincontrol.com,0,0.00%,6782,6782,0.00%
ns26.domaincontrol.com,0,0.00%,6794,6794,0.00%
journey.ns.cloudflare.com,0,0.00%,103,103,0.00%
leonard.ns.cloudflare.com,0,0.00%,239,239,0.00%
ns28.netkl.com,0,0.00%,154,154,0.00%
brenna.ns.cloudflare.com,0,0.00%,182,182,0.00%
bruce.ns.cloudflare.com,0,0.00%,252,252,0.00%
ns2.myhostadmin.net,0,0.00%,1735,1735,0.00%
ns02.one.com,0,0.00%,3388,3388,0.00%
ns01.one.com,0,0.00%,3205,3205,0.00%
rodrigo.ns.cloudflare.com,0,0.00%,145,145,0.00%
ns144.neubox.net,0,0.00%,280,280,0.00%
ina1.registrar.eu,0,0.00%,455,455,0.00%
ns1073.ui-dns.com,0,0.00%,149,149,0.00%
ina2.registrar.eu,0,0.00%,460,460,0.00%
ns1067.ui-dns.de,0,0.00%,114,114,0.00%
ns2fgv.name.com,0,0.00%,118,118,0.00%
junade.ns.cloudflare.com,0,0.00%,315,315,0.00%
peaches.ns.cloudflare.com,0,0.00%,270,270,0.00%
phil.ns.cloudflare.com,0,0.00%,230,230,0.00%
violet.ns.cloudflare.com,0,0.00%,670,670,0.00%
ns39.domaincontrol.com,0,0.00%,3653,3653,0.00%
mariah.ns.cloudflare.com,0,0.00%,307,307,0.00%
ty1-1.nigirocloud.com,0,0.00%,512,512,0.00%
ns2.gocheapweb.com,0,0.00%,249,249,0.00%
ty1-2.nigirocloud.com,0,0.00%,528,528,0.00%
kayleigh.ns.cloudflare.com,0,0.00%,120,120,0.00%
dns1.host-redirect.com,0,0.00%,141,141,0.00%
ns1.dns.ne.jp,0,0.00%,886,886,0.00%
os1-6.nigirocloud.com,0,0.00%,524,524,0.00%
os2-5.nigirocloud.com,0,0.00%,505,505,0.00%
elias.ns.cloudflare.com,0,0.00%,227,227,0.00%
jm1.dns.com,0,0.00%,32190,32190,0.00%
angelina.ns.cloudflare.com,0,0.00%,283,283,0.00%
ns2.dns.ne.jp,0,0.00%,880,880,0.00%
ns1.dns.com,0,0.00%,11526,11526,0.00%
grace.ns.cloudflare.com,0,0.00%,1023,1023,0.00%
ns3cna.name.com,0,0.00%,3273,3273,0.00%
jm2.dns.com,0,0.00%,33396,33396,0.00%
ns2.veridyen.com,0,0.00%,185,185,0.00%
pdns07.domaincontrol.com,0,0.00%,924,924,0.00%
os2-6.nigirocloud.com,0,0.00%,516,516,0.00%
ns3.niagahoster.com,0,0.00%,396,396,0.00%
steven.ns.cloudflare.com,0,0.00%,404,404,0.00%
ns2.dns.com,0,0.00%,11675,11675,0.00%
ns4fmw.name.com,0,0.00%,343,343,0.00%
os2-4.nigirocloud.com,0,0.00%,509,509,0.00%
noel.ns.cloudflare.com,0,0.00%,388,388,0.00%
os1-7.nigirocloud.com,0,0.00%,520,520,0.00%
rafe.ns.cloudflare.com,0,0.00%,613,613,0.00%
ns1.hostns.io,0,0.00%,168,168,0.00%
damien.ns.cloudflare.com,0,0.00%,118,118,0.00%
cora.ns.cloudflare.com,0,0.00%,161,161,0.00%
os1-8.nigirocloud.com,0,0.00%,515,515,0.00%
ns6.hawkhost.com,0,0.00%,392,392,0.00%
ns-a1.tenten.vn,0,0.00%,2070,2070,0.00%
ns1.veridyen.com,0,0.00%,178,178,0.00%
ns4.niagahoster.com,0,0.00%,392,392,0.00%
os2-1.nigirocloud.com,0,0.00%,496,496,0.00%
ns-canada.topdns.com,0,0.00%,749,749,0.00%
martin.ns.cloudflare.com,0,0.00%,178,178,0.00%
nina.ns.cloudflare.com,0,0.00%,326,326,0.00%
os2-2.nigirocloud.com,0,0.00%,516,516,0.00%
os2-3.nigirocloud.com,0,0.00%,570,570,0.00%
nl3-4.nigirocloud.com,0,0.00%,510,510,0.00%
dns5.name-services.com,0,0.00%,2548,2548,0.00%
ns-usa.topdns.com,0,0.00%,747,747,0.00%
ns2.natrohost.com,0,0.00%,3511,3511,0.00%
ns2.cafe24.co.kr,0,0.00%,1001,1001,0.00%
ezra.ns.cloudflare.com,0,0.00%,137,137,0.00%
dns2.onamae.com,0,0.00%,1815,1815,0.00%
ns1079.ui-dns.biz,0,0.00%,174,174,0.00%
nl1-4.nigirocloud.com,0,0.00%,518,518,0.00%
tim.ns.cloudflare.com,0,0.00%,1638,1638,0.00%
nl1-5.nigirocloud.com,0,0.00%,518,518,0.00%
ns2.domainesia.net,0,0.00%,1037,1037,0.00%
dns1.onamae.com,0,0.00%,1818,1818,0.00%
ns1.cafe24.com,0,0.00%,1023,1023,0.00%
ns2kqz.name.com,0,0.00%,156,156,0.00%
ns1035.ui-dns.de,0,0.00%,212,212,0.00%
sue.ns.cloudflare.com,0,0.00%,556,556,0.00%
ns1.cafe24.co.kr,0,0.00%,990,990,0.00%
ns1055.ui-dns.biz,0,0.00%,142,142,0.00%
ns1094.ui-dns.de,0,0.00%,108,108,0.00%
chi-ns2.websitehostserver.net,0,0.00%,319,319,0.00%
nl1-6.nigirocloud.com,0,0.00%,515,515,0.00%
ns2.cafe24.com,0,0.00%,1026,1026,0.00%
olga.ns.cloudflare.com,0,0.00%,446,446,0.00%
ns2.99midns.com,0,0.00%,1451,1451,0.00%
v1s1.xundns.com,0,0.00%,5592,5592,0.00%
jm1.alidns.com,0,0.00%,2268,2268,0.00%
ns11.xincache.com,0,0.00%,1735,1735,0.00%
ns2.above.com,0,0.00%,14606,14606,0.00%
v1s2.xundns.com,0,0.00%,5609,5609,0.00%
ns2.mtavdns.com,0,0.00%,801,801,0.00%
ns1.above.com,0,0.00%,14728,14728,0.00%
ns1.register.it,0,0.00%,2055,2055,0.00%
now1.dns.com,0,0.00%,1315,1315,0.00%
ns1.99midns.com,0,0.00%,1525,1525,0.00%
ns1.mtavdns.com,0,0.00%,824,824,0.00%
ns17.xincache.com,0,0.00%,176,176,0.00%
ns53.domaincontrol.com,0,0.00%,7855,7855,0.00%
now2.dns.com,0,0.00%,1329,1329,0.00%
ns59.sudoly.com,0,0.00%,212,212,0.00%
ns58.sudoly.com,0,0.00%,204,204,0.00%
ns55.domaincontrol.com,0,0.00%,5925,5925,0.00%
ns18.xincache.com,0,0.00%,176,176,0.00%
ns56.domaincontrol.com,0,0.00%,6001,6001,0.00%
ns2.yeyehaidns.com,0,0.00%,1052,1052,0.00%
dm1.dns.com,0,0.00%,13805,13805,0.00%
ns2.renewyourname.net,0,0.00%,112,112,0.00%
ns1.yeyehaidns.com,0,0.00%,1100,1100,0.00%
devin.ns.cloudflare.com,0,0.00%,622,622,0.00%
dm2.dns.com,0,0.00%,14035,14035,0.00%
dns2.namebay.com,0,0.00%,220,220,0.00%
ns364.dnsever.com,0,0.00%,173,173,0.00%
coleman.ns.cloudflare.com,0,0.00%,144,144,0.00%
ns91.worldnic.com,0,0.00%,257,257,0.00%
harleigh.ns.cloudflare.com,0,0.00%,493,493,0.00%
ns1.renewyourname.net,0,0.00%,107,107,0.00%
ns391.dnsever.com,0,0.00%,186,186,0.00%
dns1.namebay.com,0,0.00%,205,205,0.00%
ns1626.ztomy.com,0,0.00%,1569,1569,0.00%
ns92.worldnic.com,0,0.00%,257,257,0.00%
marjory.ns.cloudflare.com,0,0.00%,441,441,0.00%
ns2.aftermarket.pl,0,0.00%,131,131,0.00%
ns2.yongldns.com,0,0.00%,280,280,0.00%
ns02.domaincontrol.com,0,0.00%,7760,7760,0.00%
naomi.ns.cloudflare.com,0,0.00%,203,203,0.00%
ns9.hawkhost.com,0,0.00%,529,529,0.00%
ns330.dnsever.com,0,0.00%,176,176,0.00%
west.ns.cloudflare.com,0,0.00%,245,245,0.00%
wanda.ns.cloudflare.com,0,0.00%,572,572,0.00%
ns1.inmotionhosting.com,0,0.00%,960,960,0.00%
ns1045.ui-dns.biz,0,0.00%,606,606,0.00%
ns2.wpx.ne.jp,0,0.00%,188,188,0.00%
ns1.hosting.co.kr,0,0.00%,965,965,0.00%
ns311.dnsever.com,0,0.00%,175,175,0.00%
ns1045.ui-dns.com,0,0.00%,579,579,0.00%
ns41.infomaniak.com,0,0.00%,1613,1613,0.00%
aisha.ns.cloudflare.com,0,0.00%,1229,1229,0.00%
ns1.wpx.ne.jp,0,0.00%,187,187,0.00%
ns42.infomaniak.com,0,0.00%,1553,1553,0.00%
salvador.ns.cloudflare.com,0,0.00%,1317,1317,0.00%
ns1045.ui-dns.de,0,0.00%,821,821,0.00%
ns1.aftermarket.pl,0,0.00%,131,131,0.00%
ns6.afternic.com,0,0.00%,1496,1496,0.00%
ns1045.ui-dns.org,0,0.00%,561,561,0.00%
ns2hkt.name.com,0,0.00%,436,436,0.00%
tate.ns.cloudflare.com,0,0.00%,130,130,0.00%
marty.ns.cloudflare.com,0,0.00%,354,354,0.00%
margot.ns.cloudflare.com,0,0.00%,137,137,0.00%
sandy.ns.cloudflare.com,0,0.00%,436,436,0.00%
00000000000000000000000000000000000000000000000000000000000015a.rui77.com,0,0.00%,1005,1005,0.00%
connie.ns.cloudflare.com,0,0.00%,178,178,0.00%
zac.ns.cloudflare.com,0,0.00%,172,172,0.00%
ns1.dne.com,0,0.00%,408,408,0.00%
ns1.squadhelp.com,0,0.00%,788,788,0.00%
ns2.dne.com,0,0.00%,472,472,0.00%
noah.ns.cloudflare.com,0,0.00%,322,322,0.00%
ns2.squadhelp.com,0,0.00%,787,787,0.00%
ns2626.ztomy.com,0,0.00%,1555,1555,0.00%
verification-nputkrls.ns3.dan.hosting,0,0.00%,100,100,0.00%
arch.ns.cloudflare.com,0,0.00%,296,296,0.00%
cris.ns.cloudflare.com,0,0.00%,613,613,0.00%
ns36.worldnic.com,0,0.00%,247,247,0.00%
jm2.alidns.com,0,0.00%,2242,2242,0.00%
ns1.zhaimandns.com,0,0.00%,2559,2559,0.00%
kellen.ns.cloudflare.com,0,0.00%,1544,1544,0.00%
ns2.zhaimandns.com,0,0.00%,2553,2553,0.00%
mike.ns.cloudflare.com,0,0.00%,200,200,0.00%
nucum.ns.cloudflare.com,0,0.00%,104,104,0.00%
ns1.site4now.net,0,0.00%,193,193,0.00%
ns3.epik.com,0,0.00%,1669,1669,0.00%
ns4.epik.com,0,0.00%,1671,1671,0.00%
ns41.worldnic.com,0,0.00%,347,347,0.00%
kelly.ns.cloudflare.com,0,0.00%,313,313,0.00%
cash.ns.cloudflare.com,0,0.00%,330,330,0.00%
macy.ns.cloudflare.com,0,0.00%,105,105,0.00%
amalia.ns.cloudflare.com,0,0.00%,621,621,0.00%
frida.ns.cloudflare.com,0,0.00%,126,126,0.00%
ns2.dondominio.com,0,0.00%,686,686,0.00%
ns1.uniregistrymarket.link,0,0.00%,1262,1262,0.00%
rick.ns.cloudflare.com,0,0.00%,397,397,0.00%
ns2.uniregistrymarket.link,0,0.00%,1239,1239,0.00%
ns1.dondominio.com,0,0.00%,695,695,0.00%
ns03.domaincntrol.com,0,0.00%,862,862,0.00%
ns04.domaincntrol.com,0,0.00%,869,869,0.00%
pltraffic7.com,0,0.00%,143,143,0.00%
ns2.parklogic.com,0,0.00%,1465,1465,0.00%
ns69.domaincontrol.com,0,0.00%,1973,1973,0.00%
ns1.parklogic.com,0,0.00%,1502,1502,0.00%
ns70.domaincontrol.com,0,0.00%,2065,2065,0.00%
verification1.plaindns.net,0,0.00%,261,261,0.00%
prod-sav-park-lb01-1919960993.us-east-2.elb.amazonaws.com,0,0.00%,4051,4051,0.00%
ns1.yongldns.com,0,0.00%,288,288,0.00%
oaklyn.ns.cloudflare.com,0,0.00%,227,227,0.00%
sullivan.ns.cloudflare.com,0,0.00%,530,530,0.00%
annalise.ns.cloudflare.com,0,0.00%,103,103,0.00%
ns349.dnsever.com,0,0.00%,188,188,0.00%
y.ns.joker.com,0,0.00%,422,422,0.00%
z.ns.joker.com,0,0.00%,407,407,0.00%
x.ns.joker.com,0,0.00%,409,409,0.00%
www.youngzsoft.com,0,0.00%,417,417,0.00%
anderson.ns.cloudflare.com,0,0.00%,190,190,0.00%
ns1055.ui-dns.de,0,0.00%,136,136,0.00%
henry.ns.cloudflare.com,0,0.00%,264,264,0.00%
meadow.ns.cloudflare.com,0,0.00%,219,219,0.00%
liz.ns.cloudflare.com,0,0.00%,266,266,0.00%
olof.ns.cloudflare.com,0,0.00%,428,428,0.00%
cloe.ns.cloudflare.com,0,0.00%,286,286,0.00%
ns2clp.name.com,0,0.00%,145,145,0.00%
ns4fmx.name.com,0,0.00%,467,467,0.00%
dan.ns.cloudflare.com,0,0.00%,935,935,0.00%
pdns03.domaincontrol.com,0,0.00%,503,503,0.00%
ara.ns.cloudflare.com,0,0.00%,188,188,0.00%
carioca.ns.cloudflare.com,0,0.00%,170,170,0.00%
pdns04.domaincontrol.com,0,0.00%,511,511,0.00%
guy.ns.cloudflare.com,0,0.00%,241,241,0.00%
neil.ns.cloudflare.com,0,0.00%,560,560,0.00%
ns1cwy.name.com,0,0.00%,210,210,0.00%
ns3jkl.name.com,0,0.00%,274,274,0.00%
ns4dls.name.com,0,0.00%,119,119,0.00%
dns2.name-services.com,0,0.00%,2542,2542,0.00%
dns4.name-services.com,0,0.00%,2563,2563,0.00%
tia.ns.cloudflare.com,0,0.00%,515,515,0.00%
ollie.ns.cloudflare.com,0,0.00%,285,285,0.00%
melissa.ns.cloudflare.com,0,0.00%,278,278,0.00%
hank.ns.cloudflare.com,0,0.00%,213,213,0.00%
pdns13.domaincontrol.com,0,0.00%,439,439,0.00%
pdns14.domaincontrol.com,0,0.00%,436,436,0.00%
dns1.netsons.net,0,0.00%,161,161,0.00%
ns4.fornex.com,0,0.00%,361,361,0.00%
emma.ns.cloudflare.com,0,0.00%,503,503,0.00%
ns30.worldnic.com,0,0.00%,284,284,0.00%
doug.ns.cloudflare.com,0,0.00%,291,291,0.00%
christina.ns.cloudflare.com,0,0.00%,535,535,0.00%
ns27.worldnic.com,0,0.00%,275,275,0.00%
ns0.centralnic.net,0,0.00%,15720,15720,0.00%
leanna.ns.cloudflare.com,0,0.00%,442,442,0.00%
ns11.domaincontrol.com,0,0.00%,6009,6009,0.00%
ns45.worldnic.com,0,0.00%,297,297,0.00%
ns2.inet.vn,0,0.00%,1029,1029,0.00%
ns12.domaincontrol.com,0,0.00%,5999,5999,0.00%
ns46.worldnic.com,0,0.00%,287,287,0.00%
ns39.worldnic.com,0,0.00%,301,301,0.00%
ns4.myhostadmin.net,0,0.00%,1680,1680,0.00%
ns6.myhostadmin.net,0,0.00%,1587,1587,0.00%
ns22.worldnic.com,0,0.00%,317,317,0.00%
ns40.worldnic.com,0,0.00%,301,301,0.00%
ns5.myhostadmin.net,0,0.00%,1664,1664,0.00%
ns32.worldnic.com,0,0.00%,294,294,0.00%
ns1.inet.vn,0,0.00%,1012,1012,0.00%
ns3.myhostadmin.net,0,0.00%,1702,1702,0.00%
ns94.worldnic.com,0,0.00%,267,267,0.00%
ns2kry.name.com,0,0.00%,636,636,0.00%
ns62.worldnic.com,0,0.00%,243,243,0.00%
ns23.worldnic.com,0,0.00%,287,287,0.00%
ns12.worldnic.com,0,0.00%,309,309,0.00%
ns4jpz.name.com,0,0.00%,584,584,0.00%
ns61.worldnic.com,0,0.00%,244,244,0.00%
ns24.worldnic.com,0,0.00%,289,289,0.00%
ns3.inet.vn,0,0.00%,579,579,0.00%
ns51.worldnic.com,0,0.00%,297,297,0.00%
ns1.gabia.co.kr,0,0.00%,2269,2269,0.00%
ns42.worldnic.com,0,0.00%,332,332,0.00%
imani.ns.cloudflare.com,0,0.00%,193,193,0.00%
ns17.worldnic.com,0,0.00%,252,252,0.00%
ns.gabia.net,0,0.00%,2255,2255,0.00%
ns52.worldnic.com,0,0.00%,296,296,0.00%
ruben.ns.cloudflare.com,0,0.00%,208,208,0.00%
joyce.ns.cloudflare.com,0,0.00%,281,281,0.00%
ns4.timeweb.org,0,0.00%,2857,2857,0.00%
rory.ns.cloudflare.com,0,0.00%,258,258,0.00%
ns2.timeweb.ru,0,0.00%,2882,2882,0.00%
ns1.myhostadmin.net,0,0.00%,1723,1723,0.00%
ns49.worldnic.com,0,0.00%,297,297,0.00%
ns1.timeweb.ru,0,0.00%,2920,2920,0.00%
ns16.worldnic.com,0,0.00%,261,261,0.00%
ns28.worldnic.com,0,0.00%,283,283,0.00%
ns1.reg.ru,0,0.00%,16578,16578,0.00%
ns50.worldnic.com,0,0.00%,309,309,0.00%
ns3.timeweb.org,0,0.00%,2918,2918,0.00%
ns15.worldnic.com,0,0.00%,261,261,0.00%
ns2.vercel-dns.com,0,0.00%,648,648,0.00%
ns55.worldnic.com,0,0.00%,280,280,0.00%
nitin.ns.cloudflare.com,0,0.00%,706,706,0.00%
ns56.worldnic.com,0,0.00%,268,268,0.00%
sima.ns.cloudflare.com,0,0.00%,206,206,0.00%
ns35.worldnic.com,0,0.00%,257,257,0.00%
adi.ns.cloudflare.com,0,0.00%,292,292,0.00%
kurt.ns.cloudflare.com,0,0.00%,301,301,0.00%
dns30.hichina.com,0,0.00%,1724,1724,0.00%
ns26.worldnic.com,0,0.00%,299,299,0.00%
ns54.worldnic.com,0,0.00%,272,272,0.00%
dns29.hichina.com,0,0.00%,1746,1746,0.00%
ns25.worldnic.com,0,0.00%,293,293,0.00%
ns53.worldnic.com,0,0.00%,272,272,0.00%
maeve.ns.cloudflare.com,0,0.00%,160,160,0.00%
yew.ns.cloudflare.com,0,0.00%,415,415,0.00%
ns1.atomicat.pro,0,0.00%,200,200,0.00%
ns2.atomicat.pro,0,0.00%,194,194,0.00%
ns57.worldnic.com,0,0.00%,277,277,0.00%
jessica.ns.cloudflare.com,0,0.00%,418,418,0.00%
ns58.worldnic.com,0,0.00%,276,276,0.00%
ns99.worldnic.com,0,0.00%,290,290,0.00%
dns2.nominalia.com,0,0.00%,758,758,0.00%
eva.ns.cloudflare.com,0,0.00%,729,729,0.00%
ns100.worldnic.com,0,0.00%,283,283,0.00%
renan.ns.cloudflare.com,0,0.00%,252,252,0.00%
ns71.worldnic.com,0,0.00%,252,252,0.00%
ns38.worldnic.com,0,0.00%,291,291,0.00%
ns6.worldnic.com,0,0.00%,305,305,0.00%
natasha.ns.cloudflare.com,0,0.00%,2062,2062,0.00%
vasilii.ns.cloudflare.com,0,0.00%,340,340,0.00%
ns2.loopia.se,0,0.00%,1725,1725,0.00%
lucy.ns.cloudflare.com,0,0.00%,834,834,0.00%
tadeo.ns.cloudflare.com,0,0.00%,158,158,0.00%
nico.ns.cloudflare.com,0,0.00%,2415,2415,0.00%
penny.ns.cloudflare.com,0,0.00%,189,189,0.00%
ns-a5.cloudnetvn.com,0,0.00%,165,165,0.00%
ns1.worldnic.com,0,0.00%,285,285,0.00%
ns2.worldnic.com,0,0.00%,285,285,0.00%
ns78.worldnic.com,0,0.00%,261,261,0.00%
ns-a3.cloudnetvn.com,0,0.00%,178,178,0.00%
ns47.worldnic.com,0,0.00%,279,279,0.00%
ns77.worldnic.com,0,0.00%,266,266,0.00%
ns43.worldnic.com,0,0.00%,283,283,0.00%
ns93.worldnic.com,0,0.00%,265,265,0.00%
ns29.worldnic.com,0,0.00%,270,270,0.00%
ns75.worldnic.com,0,0.00%,306,306,0.00%
ns4.worldnic.com,0,0.00%,256,256,0.00%
ns.zxcs.nl,0,0.00%,1016,1016,0.00%
ns87.worldnic.com,0,0.00%,289,289,0.00%
ns18.worldnic.com,0,0.00%,254,254,0.00%
ns48.worldnic.com,0,0.00%,278,278,0.00%
ns1074.ui-dns.com,0,0.00%,195,195,0.00%
ns-a1.cloudnetvn.com,0,0.00%,164,164,0.00%
ns3.worldnic.com,0,0.00%,255,255,0.00%
ns88.worldnic.com,0,0.00%,287,287,0.00%
ns76.worldnic.com,0,0.00%,313,313,0.00%
ns37.worldnic.com,0,0.00%,305,305,0.00%
ns10.worldnic.com,0,0.00%,285,285,0.00%
ns21.worldnic.com,0,0.00%,311,311,0.00%
ns96.worldnic.com,0,0.00%,287,287,0.00%
kinsley.ns.cloudflare.com,0,0.00%,125,125,0.00%
ns1089.ui-dns.biz,0,0.00%,214,214,0.00%
ns2.freehosting.com,0,0.00%,126,126,0.00%
ns95.worldnic.com,0,0.00%,287,287,0.00%
leonidas.ns.cloudflare.com,0,0.00%,263,263,0.00%
ns80.worldnic.com,0,0.00%,311,311,0.00%
ns65.worldnic.com,0,0.00%,312,312,0.00%
ns79.worldnic.com,0,0.00%,306,306,0.00%
ns66.worldnic.com,0,0.00%,312,312,0.00%
ns9.worldnic.com,0,0.00%,296,296,0.00%
ns32.domaincontrol.com,0,0.00%,5867,5867,0.00%
ns44.worldnic.com,0,0.00%,281,281,0.00%
rc09-fc01.oray.com,0,0.00%,199,199,0.00%
ns7.worldnic.com,0,0.00%,297,297,0.00%
glen.ns.cloudflare.com,0,0.00%,349,349,0.00%
ns64.worldnic.com,0,0.00%,295,295,0.00%
ns8.worldnic.com,0,0.00%,305,305,0.00%
ns63.worldnic.com,0,0.00%,299,299,0.00%
ns14.worldnic.com,0,0.00%,289,289,0.00%
dns15.hichina.com,0,0.00%,1738,1738,0.00%
ishaan.ns.cloudflare.com,0,0.00%,128,128,0.00%
ns13.worldnic.com,0,0.00%,280,280,0.00%
dns16.hichina.com,0,0.00%,1738,1738,0.00%
ns81.worldnic.com,0,0.00%,300,300,0.00%
ns33.domaincontrol.com,0,0.00%,3109,3109,0.00%
ns2gtx.name.com,0,0.00%,254,254,0.00%
ns89.worldnic.com,0,0.00%,286,286,0.00%
ns68.worldnic.com,0,0.00%,286,286,0.00%
ns75.domaincontrol.com,0,0.00%,5534,5534,0.00%
ns4.byet.org,0,0.00%,131,131,0.00%
ns67.worldnic.com,0,0.00%,286,286,0.00%
ns72.worldnic.com,0,0.00%,251,251,0.00%
ns76.domaincontrol.com,0,0.00%,5571,5571,0.00%
suspension2.mydomainprovider.com,0,0.00%,139,139,0.00%
ns4.stratoserver.net,0,0.00%,105,105,0.00%
pdns09.domaincontrol.com,0,0.00%,851,851,0.00%
ns2.byet.org,0,0.00%,130,130,0.00%
ns59.worldnic.com,0,0.00%,270,270,0.00%
nsr3.domeny.com,0,0.00%,176,176,0.00%
ns60.worldnic.com,0,0.00%,267,267,0.00%
ns20.worldnic.com,0,0.00%,267,267,0.00%
ns19.worldnic.com,0,0.00%,276,276,0.00%
ns31.domaincontrol.com,0,0.00%,5847,5847,0.00%
dns2.p04.nsone.net,0,0.00%,1608,1608,0.00%
dns4.p04.nsone.net,0,0.00%,1629,1629,0.00%
elly.ns.cloudflare.com,0,0.00%,205,205,0.00%
leo.ns.cloudflare.com,0,0.00%,248,248,0.00%
bingo.ns.cloudflare.com,0,0.00%,142,142,0.00%
raegan.ns.cloudflare.com,0,0.00%,238,238,0.00%
edna.ns.cloudflare.com,0,0.00%,180,180,0.00%
pdns10.domaincontrol.com,0,0.00%,837,837,0.00%
ns2jrt.name.com,0,0.00%,480,480,0.00%
rscloud.rising.net.cn,0,0.00%,1756,1756,0.00%
ns2.register.it,0,0.00%,2051,2051,0.00%
tricia.ns.cloudflare.com,0,0.00%,269,269,0.00%
abdullah.ns.cloudflare.com,0,0.00%,186,186,0.00%
ns1.hosting.reg.ru,0,0.00%,4052,4052,0.00%
webquotepic.eastmoney.com,0,0.00%,307,307,0.00%
ns2.hosting.reg.ru,0,0.00%,3808,3808,0.00%
nsid2.rumahweb.net,0,0.00%,348,348,0.00%
ns4fqz.name.com,0,0.00%,294,294,0.00%
louis.ns.cloudflare.com,0,0.00%,300,300,0.00%
ns4.tld-ns.com,0,0.00%,174,174,0.00%
ns1.tld-ns.net,0,0.00%,177,177,0.00%
ns67.domaincontrol.com,0,0.00%,6455,6455,0.00%
ns3.tld-ns.net,0,0.00%,178,178,0.00%
ns1.mixhost.jp,0,0.00%,507,507,0.00%
ns2.tld-ns.com,0,0.00%,176,176,0.00%
ns3.jino.ru,0,0.00%,900,900,0.00%
dina.ns.cloudflare.com,0,0.00%,332,332,0.00%
04.dnsv.jp,0,0.00%,6929,6929,0.00%
ns84.worldnic.com,0,0.00%,249,249,0.00%
ns2.mixhost.jp,0,0.00%,508,508,0.00%
elliot.ns.cloudflare.com,0,0.00%,364,364,0.00%
ns2.tildadns.com,0,0.00%,928,928,0.00%
nszero2.axc.nl,0,0.00%,232,232,0.00%
ns34.worldnic.com,0,0.00%,267,267,0.00%
ns33.worldnic.com,0,0.00%,270,270,0.00%
karsyn.ns.cloudflare.com,0,0.00%,141,141,0.00%
nszero1.axc.nl,0,0.00%,232,232,0.00%
nsr1.domeny.com,0,0.00%,177,177,0.00%
ns1.lpmtr.net,0,0.00%,198,198,0.00%
nsid4.rumahweb.org,0,0.00%,350,350,0.00%
nsid3.rumahweb.biz,0,0.00%,342,342,0.00%
ns68.domaincontrol.com,0,0.00%,6400,6400,0.00%
gy2.brnt.fun,0,0.00%,3334,3334,0.00%
download.comodo.com,0,0.00%,149,149,0.00%
cdn.download.comodo.com,0,0.00%,141,141,0.00%
walt.ns.cloudflare.com,0,0.00%,880,880,0.00%
ns.gabia.co.kr,0,0.00%,2286,2286,0.00%
ns4clq.name.com,0,0.00%,202,202,0.00%
ns4.mysecurecloudhost.com,0,0.00%,460,460,0.00%
sharon.ns.cloudflare.com,0,0.00%,163,163,0.00%
joaquin.ns.cloudflare.com,0,0.00%,313,313,0.00%
ns83.worldnic.com,0,0.00%,250,250,0.00%
dns2.cafe24.co.kr,0,0.00%,135,135,0.00%
paul.ns.cloudflare.com,0,0.00%,222,222,0.00%
ns12.guzelhosting.com,0,0.00%,786,786,0.00%
ns11.guzelhosting.com,0,0.00%,775,775,0.00%
ns3.mysecurecloudhost.com,0,0.00%,458,458,0.00%
ns1.digitalocean.com,0,0.00%,2256,2256,0.00%
ns2.guzelhosting.com,0,0.00%,785,785,0.00%
clark.ns.cloudflare.com,0,0.00%,368,368,0.00%
collins.ns.cloudflare.com,0,0.00%,122,122,0.00%
ignacio.ns.cloudflare.com,0,0.00%,120,120,0.00%
ns1.guzelhosting.com,0,0.00%,778,778,0.00%
alfa.ns.active24.cz,0,0.00%,131,131,0.00%
mitch.ns.cloudflare.com,0,0.00%,247,247,0.00%
ns1.getcourse.ru,0,0.00%,177,177,0.00%
beta.ns.active24.cz,0,0.00%,134,134,0.00%
ns3.getcourse.ru,0,0.00%,173,173,0.00%
beth.ns.cloudflare.com,0,0.00%,315,315,0.00%
gama.ns.active24.sk,0,0.00%,133,133,0.00%
a.gmoregistry.net,0,0.00%,5677,5677,0.00%
jade.ns.cloudflare.com,0,0.00%,480,480,0.00%
cheryl.ns.cloudflare.com,0,0.00%,263,263,0.00%
karl.ns.cloudflare.com,0,0.00%,378,378,0.00%
dns12.hichina.com,0,0.00%,1914,1914,0.00%
ns2.gcloudns.com,0,0.00%,177,177,0.00%
rustam.ns.cloudflare.com,0,0.00%,278,278,0.00%
alexandra.ns.cloudflare.com,0,0.00%,153,153,0.00%
lila.ns.cloudflare.com,0,0.00%,226,226,0.00%
brianna.ns.cloudflare.com,0,0.00%,309,309,0.00%
peyton.ns.cloudflare.com,0,0.00%,203,203,0.00%
ns3.azdigi.com,0,0.00%,137,137,0.00%
skip.ns.cloudflare.com,0,0.00%,268,268,0.00%
cameron.ns.cloudflare.com,0,0.00%,165,165,0.00%
jake.ns.cloudflare.com,0,0.00%,279,279,0.00%
ns82.worldnic.com,0,0.00%,301,301,0.00%
ns4.azdigi.com,0,0.00%,137,137,0.00%
ada.ns.cloudflare.com,0,0.00%,226,226,0.00%
carla.ns.cloudflare.com,0,0.00%,2549,2549,0.00%
piotr.ns.cloudflare.com,0,0.00%,352,352,0.00%
tori.ns.cloudflare.com,0,0.00%,201,201,0.00%
will.ns.cloudflare.com,0,0.00%,264,264,0.00%
ns1019.ui-dns.biz,0,0.00%,207,207,0.00%
kyle.ns.cloudflare.com,0,0.00%,793,793,0.00%
ns2.taplink.cc,0,0.00%,106,106,0.00%
ns1049.ui-dns.biz,0,0.00%,146,146,0.00%
dns1.papaki.gr,0,0.00%,113,113,0.00%
cass.ns.cloudflare.com,0,0.00%,230,230,0.00%
celeste.ns.cloudflare.com,0,0.00%,281,281,0.00%
ns3.hyp.net,0,0.00%,606,606,0.00%
vita.ns.cloudflare.com,0,0.00%,269,269,0.00%
notify.tabnine.com,0,0.00%,510,510,0.00%
ns4.stackdns.com,0,0.00%,1823,1823,0.00%
ns2.stackdns.com,0,0.00%,1825,1825,0.00%
ns31.worldnic.com,0,0.00%,291,291,0.00%
sreeni.ns.cloudflare.com,0,0.00%,180,180,0.00%
maya.ns.cloudflare.com,0,0.00%,385,385,0.00%
great.jagoanhosting.com,0,0.00%,138,138,0.00%
best.jagoanhosting.com,0,0.00%,136,136,0.00%
pat.ns.cloudflare.com,0,0.00%,450,450,0.00%
ns1.mchost.ru,0,0.00%,140,140,0.00%
ns2.mchost.ru,0,0.00%,142,142,0.00%
ariadne.ns.cloudflare.com,0,0.00%,212,212,0.00%
nena.ns.cloudflare.com,0,0.00%,167,167,0.00%
harley.ns.cloudflare.com,0,0.00%,174,174,0.00%
chase.ns.cloudflare.com,0,0.00%,141,141,0.00%
archer.ns.cloudflare.com,0,0.00%,418,418,0.00%
kip.ns.cloudflare.com,0,0.00%,357,357,0.00%
angela.ns.cloudflare.com,0,0.00%,304,304,0.00%
camilo.ns.cloudflare.com,0,0.00%,111,111,0.00%
ns1bqx.name.com,0,0.00%,545,545,0.00%
adelaide.ns.cloudflare.com,0,0.00%,104,104,0.00%
ns4246.hostgator.com,0,0.00%,189,189,0.00%
ns2dqx.name.com,0,0.00%,193,193,0.00%
ns4245.hostgator.com,0,0.00%,189,189,0.00%
beau.ns.cloudflare.com,0,0.00%,248,248,0.00%
ns3dkz.name.com,0,0.00%,116,116,0.00%
tina.ns.cloudflare.com,0,0.00%,172,172,0.00%
38-courier.push.apple.com,0,0.00%,517,517,0.00%
cdn.packages.deepin.com,0,0.00%,1338,1338,0.00%
3.rlb.router.teamviewer.cn,0,0.00%,15841,15841,0.00%
21-courier.push.apple.com,0,0.00%,506,506,0.00%
www.tp-link.com,0,0.00%,2784,2784,0.00%
community-store-packages.deepin.com,0,0.00%,2687,2687,0.00%
ios.ac.cn,0,0.00%,966,966,0.00%
40-courier.push.apple.com,0,0.00%,533,533,0.00%
50-courier.push.apple.com,0,0.00%,524,524,0.00%
7-courier.push.apple.com,0,0.00%,558,558,0.00%
13-courier.push.apple.com,0,0.00%,515,515,0.00%
c.pc.qq.com,0,0.00%,479,479,0.00%
masterconn.qq.com,0,0.00%,327,327,0.00%
masterconn2.qq.com,0,0.00%,253,253,0.00%
avcloud.e5.sk,0,0.00%,149,149,0.00%
30-courier.push.apple.com,0,0.00%,538,538,0.00%
api.appstore.deepin.org,0,0.00%,2669,2669,0.00%
43-courier.push.apple.com,0,0.00%,505,505,0.00%
46-courier.push.apple.com,0,0.00%,498,498,0.00%
6-courier.push.apple.com,0,0.00%,529,529,0.00%
19-courier.push.apple.com,0,0.00%,529,529,0.00%
29-courier.push.apple.com,0,0.00%,510,510,0.00%
45-courier.push.apple.com,0,0.00%,512,512,0.00%
api.cloudfs.info,0,0.00%,284,284,0.00%
48-courier.push.apple.com,0,0.00%,529,529,0.00%
5-courier.push.apple.com,0,0.00%,526,526,0.00%
18-courier.push.apple.com,0,0.00%,482,482,0.00%
cip.cc,0,0.00%,1466,1466,0.00%
prom-monitorproxy1.fastsdwan.com,0,0.00%,1398,1398,0.00%
27-courier.push.apple.com,0,0.00%,513,513,0.00%
41-courier.push.apple.com,0,0.00%,549,549,0.00%
datacluster4.cipsup.cn,0,0.00%,244,244,0.00%
17-courier.push.apple.com,0,0.00%,510,510,0.00%
20-courier.push.apple.com,0,0.00%,548,548,0.00%
23-courier.push.apple.com,0,0.00%,500,500,0.00%
nist1-nj2.ustiming.org,0,0.00%,164,164,0.00%
36-courier.push.apple.com,0,0.00%,535,535,0.00%
16-courier.push.apple.com,0,0.00%,533,533,0.00%
www.h3c.com.cn,0,0.00%,103,103,0.00%
e-0014.e-msedge.net,0,0.00%,971,971,0.00%
gdmf.apple.com,0,0.00%,230,230,0.00%
vscode-sync-ase-01.azurewebsites.net,0,0.00%,370,370,0.00%
waws-prod-sg1-051.sip.azurewebsites.windows.net,0,0.00%,280,280,0.00%
waws-prod-sg1-051.cloudapp.net,0,0.00%,360,360,0.00%
fe2cr.update.msft.com.trafficmanager.net,0,0.00%,237,237,0.00%
ins-qw3q8ofk.ias.tencent-cloud.net,0,0.00%,845,845,0.00%
47-courier.push.apple.com,0,0.00%,516,516,0.00%
imap.126.com,0,0.00%,183,183,0.00%
dstore-metadata.deepin.cn,0,0.00%,1293,1293,0.00%
clock.fmt.he.net,0,0.00%,969,969,0.00%
m.weibo.cn,0,0.00%,733,733,0.00%
mail.bjtu.edu.cn,0,0.00%,139,139,0.00%
tracker.hdsky.me,0,0.00%,176,176,0.00%
clock.sjc.he.net,0,0.00%,903,903,0.00%
time-nw.nist.gov,0,0.00%,153,153,0.00%
mm.ilovescholar.xyz,0,0.00%,161,161,0.00%
ddns.gnway.com,0,0.00%,147,147,0.00%
app.jianguoyun.com,0,0.00%,674,674,0.00%
clock.nyc.he.net,0,0.00%,899,899,0.00%
iplc-ji.mielink-dns2.com,0,0.00%,523,523,0.00%
load-balancing-system.cmy-dns.com,0,0.00%,646,646,0.00%
gtm-sg-6wr2n62gk0f.gtm-i1d1.com,0,0.00%,741,741,0.00%
bi-track.hypergryph.com,0,0.00%,104,104,0.00%
keyvalueservice.fe.apple-dns.cn,0,0.00%,880,880,0.00%
ios.bugly.qq.com,0,0.00%,587,587,0.00%
alog-default.umeng.com,0,0.00%,179,179,0.00%
havfw69955.lithium.com,0,0.00%,114,114,0.00%
bk.n.shifen.com,0,0.00%,614,614,0.00%
clock.via.net,0,0.00%,901,901,0.00%
files.pfsense.org,0,0.00%,158,158,0.00%
remind.api.weibo.com,0,0.00%,563,563,0.00%
messaging.contact-module.ibm.com,0,0.00%,115,115,0.00%
check.bt.cn,0,0.00%,109,109,0.00%
jp.tiarap.org,0,0.00%,690,690,0.00%
up.vipguanjia.net,0,0.00%,497,497,0.00%
sharedstreams.fe.apple-dns.cn,0,0.00%,152,152,0.00%
gux.glodon.com,0,0.00%,123,123,0.00%
apicdn.app.gtja.com,0,0.00%,202,202,0.00%
dcagent.mecdn.synacast.com,0,0.00%,165,165,0.00%
groupclient.qq.com,0,0.00%,133,133,0.00%
location.services.mozilla.com,0,0.00%,1357,1357,0.00%
www.bt.cn,0,0.00%,239,239,0.00%
v112.v2dns.bar,0,0.00%,463,463,0.00%
developers.google.cn,0,0.00%,329,329,0.00%
access1.tpns.tencent.com,0,0.00%,157,157,0.00%
rum.h5.weibo.cn,0,0.00%,924,924,0.00%
new.weibo.cn,0,0.00%,281,281,0.00%
up.ijinshan.com,0,0.00%,141,141,0.00%
wwfile.work.weixin.qq.com,0,0.00%,1855,1855,0.00%
a-ring.msedge.net,0,0.00%,145,145,0.00%
wx2.sinaimg.cn,0,0.00%,588,588,0.00%
live-trace.bilibili.com,0,0.00%,162,162,0.00%
gsp64-ssl.ls.apple.com,0,0.00%,1137,1137,0.00%
fi.doh.dns.snopyta.org,0,0.00%,177,177,0.00%
apple-finance.query.yahoo.com,0,0.00%,410,410,0.00%
cn.patch.battlenet.com.cn,0,0.00%,138,138,0.00%
config.jpush.cn,0,0.00%,102,102,0.00%
bggts547gukhvmf4cgandlgxxphengxovoyo6ewhns5qmmb2b5oi43yd.tor2web.it,0,0.00%,439,439,0.00%
newsie.2345.com,0,0.00%,121,121,0.00%
position.csdnimg.cn,0,0.00%,676,676,0.00%
stat.10jqka.com.cn,0,0.00%,236,236,0.00%
wss.im.qcloud.com,0,0.00%,195,195,0.00%
metrics1.data.dbankcloud.cn,0,0.00%,208,208,0.00%
tw.pool.ntp.org,0,0.00%,141,141,0.00%
hk.pool.ntp.org,0,0.00%,138,138,0.00%
jp.pool.ntp.org,0,0.00%,128,128,0.00%
shark.dianping.com,0,0.00%,298,298,0.00%
hlx.meituan.com,0,0.00%,100,100,0.00%
lx0.meituan.com,0,0.00%,122,122,0.00%
log2.cmpassport.com,0,0.00%,126,126,0.00%
catdot.dianping.com,0,0.00%,313,313,0.00%
api.neixin.cn,0,0.00%,160,160,0.00%
wpsfile.ks3-cn-beijing.ksyun.com,0,0.00%,208,208,0.00%
docteamapi.wps.cn,0,0.00%,312,312,0.00%
p2.d.meituan.net,0,0.00%,109,109,0.00%
p6.d.meituan.net,0,0.00%,103,103,0.00%
catfront.dianping.com,0,0.00%,175,175,0.00%
portal-portm.meituan.com,0,0.00%,337,337,0.00%
gspe35-ssl.ls-apple.com.akadns.net,0,0.00%,233,233,0.00%
dreport.meituan.net,0,0.00%,231,231,0.00%
vip.storage.weibo.com,0,0.00%,227,227,0.00%
simg.s.weibo.com,0,0.00%,221,221,0.00%
mediadata.api.weibo.com,0,0.00%,282,282,0.00%
ef-dongfeng.tanx.com,0,0.00%,170,170,0.00%
tvax1.sinaimg.cn,0,0.00%,534,534,0.00%
settings.data.microsoft.com,0,0.00%,106,106,0.00%
nav.smartscreen.microsoft.com,0,0.00%,320,320,0.00%
doh.dns.apple.com,0,0.00%,133,133,0.00%
pop3.nfs-china.com,0,0.00%,123,123,0.00%
event.toggle.qq.com,0,0.00%,433,433,0.00%
app-analytics.ultraleap.com,0,0.00%,270,270,0.00%
cf.aliyun.com,0,0.00%,121,121,0.00%
v1.cnzz.com,0,0.00%,107,107,0.00%
cnzz.mmstat.com,0,0.00%,109,109,0.00%
alt7-mtalk.google.com,0,0.00%,133,133,0.00%
h2tcbox.baidu.com,0,0.00%,144,144,0.00%
crash.glodon.com,0,0.00%,156,156,0.00%
app.bilibili.com,0,0.00%,414,414,0.00%
statistic.csdn.net,0,0.00%,683,683,0.00%
redisdatarecall.csdn.net,0,0.00%,680,680,0.00%
zhannei-dm.csdn.net,0,0.00%,495,495,0.00%
ttxyajs.data.kuiniuca.com,0,0.00%,377,377,0.00%
pull-rtmp-l95.douyincdn.com,0,0.00%,808,808,0.00%
a.safe.360.cn,0,0.00%,584,584,0.00%
commerce.safe.360.cn,0,0.00%,561,561,0.00%
android.rqd.qq.com,0,0.00%,380,380,0.00%
node-470.kr.stars.run,0,0.00%,310,310,0.00%
t.nyaatracker.com,0,0.00%,353,353,0.00%
pull-rtmp-l27.douyincdn.com,0,0.00%,808,808,0.00%
push-rtmp-f5-vs.douyincdn.com,0,0.00%,581,581,0.00%
pull-flv-l95.douyincdn.com,0,0.00%,746,746,0.00%
pay.bilibili.com,0,0.00%,127,127,0.00%
push-rtmp-vr-f5.douyincdn.com,0,0.00%,478,478,0.00%
p0.ssl.img.360kuai.com,0,0.00%,150,150,0.00%
vs.biz.weibo.com,0,0.00%,488,488,0.00%
alt3-mtalk.google.com,0,0.00%,132,132,0.00%
adashbc.ut.taobao.com,0,0.00%,568,568,0.00%
push-rtmp-l11-cny.douyincdn.com,0,0.00%,580,580,0.00%
jm.v2api.xyz,0,0.00%,533,533,0.00%
pull-hls-f29.douyincdn.com,0,0.00%,742,742,0.00%
pull-lls-l26.douyincdn.com,0,0.00%,782,782,0.00%
as.xiaohongshu.com,0,0.00%,300,300,0.00%
push-rtmp-f5-io.flive.douyincdn.com,0,0.00%,617,617,0.00%
apppush.xiaohongshu.com,0,0.00%,184,184,0.00%
push-rtmp-hs-f5-encryption.douyincdn.com,0,0.00%,554,554,0.00%
pull-flv-l11-cny.douyincdn.com,0,0.00%,749,749,0.00%
push-rtmp-l95.douyincdn.com,0,0.00%,569,569,0.00%
jpushsc.m.jd.com,0,0.00%,264,264,0.00%
wxa.weixin.qq.com,0,0.00%,388,388,0.00%
th.pinduoduo.com,0,0.00%,262,262,0.00%
na61-rmbsync-upaas.uc.cn,0,0.00%,151,151,0.00%
na61-ucc-upaas.uc.cn,0,0.00%,151,151,0.00%
conf-drcn.cloud.dbankcloud.cn,0,0.00%,265,265,0.00%
ubacollect-drcn.cloud.dbankcloud.cn,0,0.00%,114,114,0.00%
mdap.alipay.com,0,0.00%,246,246,0.00%
evalai.cn,0,0.00%,144,144,0.00%
ntes53.mail.163.com,0,0.00%,189,189,0.00%
unpm-upaas.uc.cn,0,0.00%,251,251,0.00%
sg02.ipv2.xyz,0,0.00%,802,802,0.00%
www.hxkba.com,0,0.00%,108,108,0.00%
eq.10jqka.com.cn,0,0.00%,247,247,0.00%
adm.10jqka.com.cn,0,0.00%,138,138,0.00%
ied-tqos-tgp.qq.com,0,0.00%,137,137,0.00%
apponline.research.qq.com,0,0.00%,776,776,0.00%
login.psvr.wps.cn,0,0.00%,249,249,0.00%
ad.us.sinaimg.cn,0,0.00%,257,257,0.00%
connect.rom.miui.com,0,0.00%,736,736,0.00%
account.sogou.com,0,0.00%,670,670,0.00%
pc.profile.pinyin.sogou.com,0,0.00%,294,294,0.00%
profile.pinyin.sogou.com,0,0.00%,391,391,0.00%
pinyin.sogou.com,0,0.00%,333,333,0.00%
wcjs.sbj.cnipa.gov.cn,0,0.00%,175,175,0.00%
openapi-drcn.cloud.dbankcloud.cn,0,0.00%,440,440,0.00%
httpdns.kwd.inkuai.com,0,0.00%,241,241,0.00%
datahub.zhihu.com,0,0.00%,322,322,0.00%
adv.sec.miui.com,0,0.00%,153,153,0.00%
api.sec.miui.com,0,0.00%,137,137,0.00%
dsp.ads.umeng.com,0,0.00%,151,151,0.00%
cloud.safe.360.cn,0,0.00%,599,599,0.00%
uploader.shimo.im,0,0.00%,577,577,0.00%
qappcenterv6.3g.qq.com,0,0.00%,297,297,0.00%
tracker2.itzmx.com,0,0.00%,251,251,0.00%
appupgrade.vivo.com.cn,0,0.00%,339,339,0.00%
m-cloud.zhihu.com,0,0.00%,310,310,0.00%
acd.op.hicloud.com,0,0.00%,352,352,0.00%
sdkserver.op.hicloud.com,0,0.00%,174,174,0.00%
events.op.hicloud.com,0,0.00%,211,211,0.00%
n.sinaimg.cn,0,0.00%,195,195,0.00%
appdlc-drcn.hispace.dbankcloud.cn,0,0.00%,648,648,0.00%
uc-drcn.hispace.dbankcloud.cn,0,0.00%,322,322,0.00%
store1.hispace.hicloud.com,0,0.00%,214,214,0.00%
apd-vodp2pnat.teg.tencent-cloud.net,0,0.00%,327,327,0.00%
terms-drcn.platform.dbankcloud.cn,0,0.00%,352,352,0.00%
hwpub-s01-drcn.cloud.dbankcloud.cn,0,0.00%,137,137,0.00%
data.mistat.xiaomi.com,0,0.00%,485,485,0.00%
proxy.whaledata.com,0,0.00%,100,100,0.00%
msg.iqiyi.com,0,0.00%,159,159,0.00%
v4-14.hiaoxui.work,0,0.00%,154,154,0.00%
flux.hcdn.qiyi.com,0,0.00%,274,274,0.00%
plugin.browser.qq.com,0,0.00%,290,290,0.00%
jp04.v2netapp.com,0,0.00%,694,694,0.00%
collect.kugou.com,0,0.00%,130,130,0.00%
delivery.51zmt.net,0,0.00%,378,378,0.00%
www.sinfors.com.cn,0,0.00%,1613,1613,0.00%
gsa.apple.com,0,0.00%,380,380,0.00%
gsas.apple.com,0,0.00%,481,481,0.00%
array804.prod.do.dsp.mp.microsoft.com,0,0.00%,146,146,0.00%
array807.prod.do.dsp.mp.microsoft.com,0,0.00%,221,221,0.00%
quota.fe.apple-dns.cn,0,0.00%,130,130,0.00%
array802.prod.do.dsp.mp.microsoft.com,0,0.00%,295,295,0.00%
gslb.xcloud.sandai.net,0,0.00%,410,410,0.00%
www.360.com,0,0.00%,8930,8930,0.00%
bl6pap003.storage.live.com,0,0.00%,166,166,0.00%
s.ludashi.com,0,0.00%,961,961,0.00%
apigtwb2c.us.dell.com,0,0.00%,126,126,0.00%
www.databasebydesignllc.com,0,0.00%,130,130,0.00%
device.delicloud.com,0,0.00%,100,100,0.00%
data6.video.iqiyi.com,0,0.00%,410,410,0.00%
XSP-efz.ms-acdc.office.com,0,0.00%,336,336,0.00%
s.vconf.f.360.cn,0,0.00%,131,131,0.00%
directconfig.ab.qq.com,0,0.00%,311,311,0.00%
www.sxz8.club,0,0.00%,116,116,0.00%
sp1.sangfor.com.cn,0,0.00%,587,587,0.00%
delivery.maihehd.com,0,0.00%,374,374,0.00%
sqm.telemetry.microsoft.com,0,0.00%,296,296,0.00%
im.collab.reuters.net,0,0.00%,335,335,0.00%
pook.com,0,0.00%,305,305,0.00%
qiao.baidu.com,0,0.00%,225,225,0.00%
v1.baidupcs.com,0,0.00%,342,342,0.00%
nbcache00.baidupcs.com,0,0.00%,241,241,0.00%
sogovpn.com,0,0.00%,330,330,0.00%
gamec.boombeachgame.com,0,0.00%,627,627,0.00%
sip.reuters.net,0,0.00%,429,429,0.00%
meeting.huaweicloud.com,0,0.00%,371,371,0.00%
cn-release-pub-room-gz.lgame.qq.com,0,0.00%,274,274,0.00%
api.weibo.com,0,0.00%,506,506,0.00%
server1.yoics.net,0,0.00%,317,317,0.00%
server2.yoics.net,0,0.00%,324,324,0.00%
auth.collab.reuters.net,0,0.00%,330,330,0.00%
hxce.cn,0,0.00%,329,329,0.00%
pic.263em.com,0,0.00%,254,254,0.00%
ios.game.coc.qq.com,0,0.00%,357,357,0.00%
gamec.clashroyaleapp.com,0,0.00%,644,644,0.00%
tr.skype.com,0,0.00%,260,260,0.00%
vzuu.com,0,0.00%,394,394,0.00%
im.welink.huaweicloud.com,0,0.00%,364,364,0.00%
game.brawlstars.cn,0,0.00%,405,405,0.00%
wss.tim.qq.com,0,0.00%,168,168,0.00%
271509e17755a70d683b7f40cdb3eec6df604067.u.fdmpkg.org,0,0.00%,212,212,0.00%
uwewe.com,0,0.00%,369,369,0.00%
webex.com.cn,0,0.00%,243,243,0.00%
zhumu.me,0,0.00%,617,617,0.00%
d.wn51.com,0,0.00%,558,558,0.00%
pcmgr-cdn.vipguanjia.net,0,0.00%,157,157,0.00%
stun.syncthing.net,0,0.00%,124,124,0.00%
weather-drcn.music.hicloud.com,0,0.00%,119,119,0.00%
httpdns.huaweicloud.com,0,0.00%,233,233,0.00%
cloudphoto-drcn.cloud.dbankcloud.cn,0,0.00%,640,640,0.00%
onedriveclucproddm20026.blob.core.windows.net,0,0.00%,274,274,0.00%
decisionhub-drcn.emui.dbankcloud.com,0,0.00%,364,364,0.00%
offline.aps.amap.com,0,0.00%,557,557,0.00%
forum-api-drcn.jos.hicloud.com,0,0.00%,148,148,0.00%
datacollector-drcn.dt.hicloud.com,0,0.00%,418,418,0.00%
api.cloud.huawei.com,0,0.00%,360,360,0.00%
forum-api-drcn.jos.dbankcloud.cn,0,0.00%,112,112,0.00%
jxs-drcn.jos.dbankcloud.cn,0,0.00%,107,107,0.00%
video.yidianzixun.com,0,0.00%,637,637,0.00%
tjtv3.wn51.com,0,0.00%,223,223,0.00%
helpinfockeniu1.ksmobile.com,0,0.00%,113,113,0.00%
sdkapiv2.bizport.cn,0,0.00%,245,245,0.00%
kfcs.csc.com.cn,0,0.00%,767,767,0.00%
tycs.hpccube.com,0,0.00%,326,326,0.00%
www.aliyundrive.com,0,0.00%,139,139,0.00%
ocsp.usertrust.com,0,0.00%,246,246,0.00%
config.safedog.cn,0,0.00%,151,151,0.00%
down.safedog.cn,0,0.00%,125,125,0.00%
fd.api.iris.microsoft.com,0,0.00%,163,163,0.00%
down1.thorzip.muxin.fun,0,0.00%,103,103,0.00%
zhxin.xfplay.com,0,0.00%,291,291,0.00%
hicall-enhance-drcn.emui.dbankcloud.com,0,0.00%,365,365,0.00%
securityapi.d3-pr-tm.com,0,0.00%,109,109,0.00%
tm-sdk.platinumai.net,0,0.00%,500,500,0.00%
shuc-other.ksord.com,0,0.00%,1244,1244,0.00%
spatialsearch.is.autonavi.com,0,0.00%,177,177,0.00%
t7z.cupid.iqiyi.com,0,0.00%,116,116,0.00%
l-rcd.iqiyi.com,0,0.00%,104,104,0.00%
v6-data.video.dns.iqiyi.com,0,0.00%,103,103,0.00%
oss.mail.qq.com,0,0.00%,449,449,0.00%
ai1.acciff.com,0,0.00%,234,234,0.00%
tracker-public.tjupt.org,0,0.00%,237,237,0.00%
consul.app.kdsec.org,0,0.00%,119,119,0.00%
cpestatus.hipplayconnect.com,0,0.00%,371,371,0.00%
diagnosis.ad.xiaomi.com,0,0.00%,153,153,0.00%
cn-shanghai.axt.aliyun.com,0,0.00%,522,522,0.00%
cn-shenzhen.axt.aliyun.com,0,0.00%,1183,1183,0.00%
clientlog.music.163.com,0,0.00%,321,321,0.00%
hk4.v2u9.top,0,0.00%,874,874,0.00%
c.xzhwdz.com,0,0.00%,2769,2769,0.00%
gza.edge.boom.skin,0,0.00%,142,142,0.00%
report.uchiha.ltd,0,0.00%,571,571,0.00%
pico.eset.com,0,0.00%,438,438,0.00%
7902f652-rh7400-rix76f-nu3o.pccw.alrihla.net,0,0.00%,132,132,0.00%
e44ee7b.ph.gladns.com,0,0.00%,116,116,0.00%
e44ee7b.pg.gladns.com,0,0.00%,115,115,0.00%
e44ee7b.pa.gladns.com,0,0.00%,183,183,0.00%
array510.prod.do.dsp.mp.microsoft.com,0,0.00%,494,494,0.00%
stun.douyucdn.cn,0,0.00%,174,174,0.00%
j.v4.1.kiki789.com,0,0.00%,247,247,0.00%
pgyapi.oray.net,0,0.00%,110,110,0.00%
push.ynote.youdao.com,0,0.00%,186,186,0.00%
open.qurl.f.360.cn,0,0.00%,122,122,0.00%
array613.prod.do.dsp.mp.microsoft.com,0,0.00%,226,226,0.00%
app.market.xiaomi.com,0,0.00%,125,125,0.00%
api.tw06.xlmc.sec.miui.com,0,0.00%,120,120,0.00%
dispatch.b.api.cqttech.com,0,0.00%,269,269,0.00%
deepl.com,0,0.00%,216,216,0.00%
sdupm.360.cn,0,0.00%,293,293,0.00%
online2.ts.api.xiangtatech.com,0,0.00%,152,152,0.00%
cmgz.10242018.xyz,0,0.00%,301,301,0.00%
weixin.qq.com,0,0.00%,593,593,0.00%
update.os.nfschina.com,0,0.00%,238,238,0.00%
d33vwaa6rdensn.cloudfront.net,0,0.00%,114,114,0.00%
c61s4.jamjams3.net,0,0.00%,635,635,0.00%
i.weread.qq.com,0,0.00%,240,240,0.00%
c61s801.jamjams3.net,0,0.00%,114,114,0.00%
c61s3.jamjams3.net,0,0.00%,100,100,0.00%
emp-api.baidu.com,0,0.00%,768,768,0.00%
analysis-acc-ssl.xunlei.com,0,0.00%,275,275,0.00%
anidex.moe,0,0.00%,176,176,0.00%
tracker.kali.org,0,0.00%,142,142,0.00%
pow7.com,0,0.00%,140,140,0.00%
torrent.mp3quran.net,0,0.00%,147,147,0.00%
tehconnection.eu,0,0.00%,114,114,0.00%
file.service.qq.com,0,0.00%,124,124,0.00%
platform.wondershare.com,0,0.00%,131,131,0.00%
mvgroup.org,0,0.00%,242,242,0.00%
master9.teamviewer.com,0,0.00%,117,117,0.00%
tracker.publictorrent.net,0,0.00%,229,229,0.00%
113gb5.g132d3.10002tli.device-ddp2-dns.ictun.com,0,0.00%,184,184,0.00%
sz-videocloud-dev.oss-cn-shenzhen.aliyuncs.com,0,0.00%,184,184,0.00%
freerainbowtables.com,0,0.00%,129,129,0.00%
tracker.ddunlimited.net,0,0.00%,142,142,0.00%
securetoken.googleapis.com,0,0.00%,259,259,0.00%
hub5sr.v6.shub.sandai.net,0,0.00%,115,115,0.00%
tracker.lilithraws.org,0,0.00%,156,156,0.00%
imws.sobot.com,0,0.00%,144,144,0.00%
baibako.tv,0,0.00%,153,153,0.00%
speedtest-rtc.xtsmart.link,0,0.00%,153,153,0.00%
tracker.parrotsec.org,0,0.00%,141,141,0.00%
bt.3dmgame.com,0,0.00%,154,154,0.00%
m.reachmax.cn,0,0.00%,162,162,0.00%
pmp.365dmp.com,0,0.00%,133,133,0.00%
theodoric.fr,0,0.00%,118,118,0.00%
p2plive-ws.douyucdn.cn,0,0.00%,529,529,0.00%
announce.partis.si,0,0.00%,156,156,0.00%
fe-mtweapp-log.dreport.meituan.net,0,0.00%,193,193,0.00%
t.publictracker.xyz,0,0.00%,106,106,0.00%
smtp.flawcra.cc,0,0.00%,130,130,0.00%
api.game.meizu.com,0,0.00%,357,357,0.00%
zephir.monocul.us,0,0.00%,409,409,0.00%
api.8864029a8b01d50a95d558b5792ce2d6.pw,0,0.00%,139,139,0.00%
btx.anifilm.tv,0,0.00%,141,141,0.00%
tracker.torrentleech.org,0,0.00%,137,137,0.00%
tr.doogh.club,0,0.00%,103,103,0.00%
bt.unionpeer.org,0,0.00%,139,139,0.00%
8d0968d6458e0ad0.jijifun.com,0,0.00%,134,134,0.00%
tracker.zerobytes.xyz,0,0.00%,397,397,0.00%
t.btcland.xyz,0,0.00%,119,119,0.00%
account.cnblogs.com,0,0.00%,255,255,0.00%
abufinzio.monocul.us,0,0.00%,122,122,0.00%
tracker.supertracker.net,0,0.00%,215,215,0.00%
mbsug.ssl.so.com,0,0.00%,471,471,0.00%
hk-4.upjs.xyz,0,0.00%,124,124,0.00%
hk1-4.nigirocloud.com,0,0.00%,579,579,0.00%
nl3-5.nigirocloud.com,0,0.00%,515,515,0.00%
nl1-7.nigirocloud.com,0,0.00%,504,504,0.00%
nl1-8.nigirocloud.com,0,0.00%,513,513,0.00%
nl3-1.nigirocloud.com,0,0.00%,503,503,0.00%
nl3-2.nigirocloud.com,0,0.00%,507,507,0.00%
nl3-3.nigirocloud.com,0,0.00%,510,510,0.00%
uk1-3.nigirocloud.com,0,0.00%,506,506,0.00%
nl3-6.nigirocloud.com,0,0.00%,515,515,0.00%
nl3-7.nigirocloud.com,0,0.00%,504,504,0.00%
nl3-8.nigirocloud.com,0,0.00%,504,504,0.00%
uk1-1.nigirocloud.com,0,0.00%,500,500,0.00%
uk1-2.nigirocloud.com,0,0.00%,494,494,0.00%
uk1-4.nigirocloud.com,0,0.00%,505,505,0.00%
rq.kpcct.cloud.duba.net,0,0.00%,403,403,0.00%
api.lxqp.360.cn,0,0.00%,279,279,0.00%
umc.rising.com.cn,0,0.00%,244,244,0.00%
relay-6556aec6.net.anydesk.com,0,0.00%,141,141,0.00%
t.hdhome.org,0,0.00%,137,137,0.00%
public1.114dns.com,0,0.00%,2861,2861,0.00%
api.wcc.best,0,0.00%,190,190,0.00%
doh.360.cn,0,0.00%,754,754,0.00%
server3.yoics.net,0,0.00%,318,318,0.00%
ns10.servicio-online.net,0,0.00%,276,276,0.00%
dns13.servidoresdns.net,0,0.00%,376,376,0.00%
nsb.whogohost.com,0,0.00%,447,447,0.00%
dns14.servidoresdns.net,0,0.00%,380,380,0.00%
nsa.whogohost.com,0,0.00%,446,446,0.00%
www.safedog.cn,0,0.00%,123,123,0.00%
hnyd.817777.xyz,0,0.00%,231,231,0.00%
derek.ns.cloudflare.com,0,0.00%,121,121,0.00%
aida.ns.cloudflare.com,0,0.00%,230,230,0.00%
robert.ns.cloudflare.com,0,0.00%,146,146,0.00%
teresa.ns.cloudflare.com,0,0.00%,205,205,0.00%
ns2cvx.name.com,0,0.00%,293,293,0.00%
ns3gmt.name.com,0,0.00%,231,231,0.00%
anahi.ns.cloudflare.com,0,0.00%,242,242,0.00%
micah.ns.cloudflare.com,0,0.00%,309,309,0.00%
ch.pro.io,0,0.00%,192,192,0.00%
nl.pro.io,0,0.00%,193,193,0.00%
ridge.ns.cloudflare.com,0,0.00%,220,220,0.00%
ns1.nameself.com,0,0.00%,311,311,0.00%
p.dnh.net,0,0.00%,186,186,0.00%
ns2.lcn.com,0,0.00%,559,559,0.00%
ns1.lcn.com,0,0.00%,560,560,0.00%
ns1mtw.name.com,0,0.00%,178,178,0.00%
ns1.undeveloped.com,0,0.00%,1374,1374,0.00%
ns0.lcn.com,0,0.00%,559,559,0.00%
magnolia.ns.cloudflare.com,0,0.00%,212,212,0.00%
ns2cqs.name.com,0,0.00%,220,220,0.00%
ns2.undeveloped.com,0,0.00%,1373,1373,0.00%
indie.ns.cloudflare.com,0,0.00%,132,132,0.00%
ganz.ns.cloudflare.com,0,0.00%,434,434,0.00%
gitea.com,0,0.00%,262,262,0.00%
dns1.cosmotown.com,0,0.00%,208,208,0.00%
gloria.ns.cloudflare.com,0,0.00%,390,390,0.00%
dns2.cosmotown.com,0,0.00%,207,207,0.00%
ns1068.ui-dns.org,0,0.00%,195,195,0.00%
nsb.bookmyname.com,0,0.00%,123,123,0.00%
ns1036.ui-dns.biz,0,0.00%,146,146,0.00%
nsa.bookmyname.com,0,0.00%,123,123,0.00%
oswald.ns.cloudflare.com,0,0.00%,201,201,0.00%
nsc.bookmyname.com,0,0.00%,124,124,0.00%
miki.ns.cloudflare.com,0,0.00%,435,435,0.00%
cosmin.ns.cloudflare.com,0,0.00%,192,192,0.00%
gannon.ns.cloudflare.com,0,0.00%,150,150,0.00%
chi-ns1.websitehostserver.net,0,0.00%,318,318,0.00%
ams-ns1.websitehostserver.net,0,0.00%,325,325,0.00%
ns.liquidweb.com,0,0.00%,685,685,0.00%
ns200.anycast.me,0,0.00%,931,931,0.00%
ns3cpr.name.com,0,0.00%,109,109,0.00%
thea.ns.cloudflare.com,0,0.00%,132,132,0.00%
lex.ns.cloudflare.com,0,0.00%,297,297,0.00%
ns4236.hostgator.com,0,0.00%,192,192,0.00%
ns4235.hostgator.com,0,0.00%,192,192,0.00%
ns4lny.name.com,0,0.00%,268,268,0.00%
ns2.whoisdomain.kr,0,0.00%,365,365,0.00%
ns3.meganameservers.eu,0,0.00%,157,157,0.00%
ns1051.ui-dns.de,0,0.00%,105,105,0.00%
cdns1.main-hosting.eu,0,0.00%,327,327,0.00%
ns3.nic.ru,0,0.00%,3235,3235,0.00%
ns2bls.name.com,0,0.00%,253,253,0.00%
ns4.whoisdomain.kr,0,0.00%,364,364,0.00%
ns8.nic.ru,0,0.00%,3158,3158,0.00%
marlowe.ns.cloudflare.com,0,0.00%,557,557,0.00%
ns3cfp.name.com,0,0.00%,143,143,0.00%
ns1.whoisdomain.kr,0,0.00%,366,366,0.00%
ns1040.ui-dns.org,0,0.00%,136,136,0.00%
aryanna.ns.cloudflare.com,0,0.00%,535,535,0.00%
anirban.ns.cloudflare.com,0,0.00%,286,286,0.00%
aitana.ns.cloudflare.com,0,0.00%,118,118,0.00%
gabriella.ns.cloudflare.com,0,0.00%,287,287,0.00%
etienne.ns.cloudflare.com,0,0.00%,227,227,0.00%
nia.ns.cloudflare.com,0,0.00%,338,338,0.00%
ns3.dominios.uol.com.br,0,0.00%,428,428,0.00%
ns1.dominios.uol.com.br,0,0.00%,428,428,0.00%
ns.second-ns.com,0,0.00%,311,311,0.00%
ns2.dominios.uol.com.br,0,0.00%,428,428,0.00%
ns1.reg365.net,0,0.00%,126,126,0.00%
ns3.second-ns.de,0,0.00%,322,322,0.00%
ns1022.ui-dns.biz,0,0.00%,164,164,0.00%
ns1085.ui-dns.org,0,0.00%,243,243,0.00%
ns1114.ui-dns.com,0,0.00%,210,210,0.00%
itzel.ns.cloudflare.com,0,0.00%,296,296,0.00%
ns0.reg365.net,0,0.00%,123,123,0.00%
tony.ns.cloudflare.com,0,0.00%,240,240,0.00%
ns2.reg365.net,0,0.00%,125,125,0.00%
amanda.ns.cloudflare.com,0,0.00%,167,167,0.00%
dax.ns.cloudflare.com,0,0.00%,256,256,0.00%
demi.ns.cloudflare.com,0,0.00%,354,354,0.00%
ns1.bdydns.cn,0,0.00%,927,927,0.00%
docks17.rzone.de,0,0.00%,203,203,0.00%
nsb.n0c.com,0,0.00%,192,192,0.00%
michelle.ns.cloudflare.com,0,0.00%,146,146,0.00%
ns3.iwantmyname.net,0,0.00%,346,346,0.00%
ns1.ipage.com,0,0.00%,728,728,0.00%
ns1122.ui-dns.org,0,0.00%,178,178,0.00%
ns1.iwantmyname.net,0,0.00%,349,349,0.00%
kareem.ns.cloudflare.com,0,0.00%,331,331,0.00%
shades08.rzone.de,0,0.00%,204,204,0.00%
nsa.n0c.com,0,0.00%,192,192,0.00%
ns1070.ui-dns.com,0,0.00%,216,216,0.00%
ns2.iwantmyname.net,0,0.00%,341,341,0.00%
olivia.ns.cloudflare.com,0,0.00%,153,153,0.00%
dora.ns.cloudflare.com,0,0.00%,709,709,0.00%
ns-rs2.gmoserver.jp,0,0.00%,671,671,0.00%
ns4.iwantmyname.net,0,0.00%,351,351,0.00%
sofia.ns.cloudflare.com,0,0.00%,221,221,0.00%
aiden.ns.cloudflare.com,0,0.00%,290,290,0.00%
nsc.n0c.com,0,0.00%,191,191,0.00%
ns1.contabo.net,0,0.00%,628,628,0.00%
keira.ns.cloudflare.com,0,0.00%,162,162,0.00%
bradley.ns.cloudflare.com,0,0.00%,154,154,0.00%
carlane.ns.cloudflare.com,0,0.00%,183,183,0.00%
cory.ns.cloudflare.com,0,0.00%,192,192,0.00%
alexis.ns.cloudflare.com,0,0.00%,374,374,0.00%
ns1hwy.name.com,0,0.00%,157,157,0.00%
dns2.home.pl,0,0.00%,299,299,0.00%
major.ns.cloudflare.com,0,0.00%,421,421,0.00%
ns1.onlydomains.com,0,0.00%,507,507,0.00%
shades01.rzone.de,0,0.00%,207,207,0.00%
ns1.bluehost.in,0,0.00%,727,727,0.00%
ns1071.ui-dns.de,0,0.00%,135,135,0.00%
ns1055.ui-dns.com,0,0.00%,160,160,0.00%
docks12.rzone.de,0,0.00%,230,230,0.00%
pdns01.domaincontrol.com,0,0.00%,310,310,0.00%
docks09.rzone.de,0,0.00%,169,169,0.00%
ns40.domaincontrol.com,0,0.00%,3701,3701,0.00%
mona.ns.cloudflare.com,0,0.00%,194,194,0.00%
ed.ns.cloudflare.com,0,0.00%,182,182,0.00%
pdns02.domaincontrol.com,0,0.00%,308,308,0.00%
keyla.ns.cloudflare.com,0,0.00%,543,543,0.00%
ns3.site4now.net,0,0.00%,196,196,0.00%
suspension1.mydomainprovider.com,0,0.00%,142,142,0.00%
ns2.site4now.net,0,0.00%,196,196,0.00%
shades15.rzone.de,0,0.00%,236,236,0.00%
ns1lmy.name.com,0,0.00%,108,108,0.00%
ns2.wpx.net,0,0.00%,110,110,0.00%
carol.ns.cloudflare.com,0,0.00%,496,496,0.00%
saanvi.ns.cloudflare.com,0,0.00%,193,193,0.00%
docks16.rzone.de,0,0.00%,208,208,0.00%
gabe.ns.cloudflare.com,0,0.00%,283,283,0.00%
huxley.ns.cloudflare.com,0,0.00%,216,216,0.00%
ns1030.ui-dns.org,0,0.00%,168,168,0.00%
diana.ns.cloudflare.com,0,0.00%,555,555,0.00%
ns1109.ui-dns.biz,0,0.00%,159,159,0.00%
sunny.ns.cloudflare.com,0,0.00%,207,207,0.00%
delilah.ns.cloudflare.com,0,0.00%,188,188,0.00%
ns2.onlydomains.com,0,0.00%,509,509,0.00%
ns3.onlydomains.com,0,0.00%,511,511,0.00%
ns1099.ui-dns.com,0,0.00%,142,142,0.00%
simone.ns.cloudflare.com,0,0.00%,195,195,0.00%
fay.ns.cloudflare.com,0,0.00%,389,389,0.00%
sasha.ns.cloudflare.com,0,0.00%,164,164,0.00%
ns2btz.name.com,0,0.00%,217,217,0.00%
ns3.hostmar.com,0,0.00%,400,400,0.00%
ns3dgj.name.com,0,0.00%,225,225,0.00%
rob.ns.cloudflare.com,0,0.00%,303,303,0.00%
emily.ns.cloudflare.com,0,0.00%,599,599,0.00%
ns4hny.name.com,0,0.00%,334,334,0.00%
randall.ns.cloudflare.com,0,0.00%,510,510,0.00%
doma634347.earth.orderbox-dns.com,0,0.00%,275,275,0.00%
nsn1.mijndomein.nl,0,0.00%,1382,1382,0.00%
ns2.idwebhost.com,0,0.00%,170,170,0.00%
kia.ns.cloudflare.com,0,0.00%,165,165,0.00%
ns4.hostmar.com,0,0.00%,400,400,0.00%
ns2.whois.com,0,0.00%,235,235,0.00%
ns4.whois.com,0,0.00%,235,235,0.00%
augustus.ns.cloudflare.com,0,0.00%,3275,3275,0.00%
ns3.whois.com,0,0.00%,234,234,0.00%
ns1.whois.com,0,0.00%,236,236,0.00%
dns1.sitezoogle.com,0,0.00%,295,295,0.00%
orca.instantdomains.com,0,0.00%,156,156,0.00%
dns2.sitezoogle.com,0,0.00%,290,290,0.00%
coho.instantdomains.com,0,0.00%,157,157,0.00%
eu.guzelhosting.com,0,0.00%,162,162,0.00%
jill.ns.cloudflare.com,0,0.00%,336,336,0.00%
gordon.ns.cloudflare.com,0,0.00%,174,174,0.00%
anastasia.ns.cloudflare.com,0,0.00%,334,334,0.00%
serenity.ns.cloudflare.com,0,0.00%,151,151,0.00%
lamar.ns.cloudflare.com,0,0.00%,119,119,0.00%
leia.ns.cloudflare.com,0,0.00%,1029,1029,0.00%
ns2.hostmonster.com,0,0.00%,200,200,0.00%
ns1.jimdo.com,0,0.00%,193,193,0.00%
ns1093.ui-dns.org,0,0.00%,190,190,0.00%
cesar.ns.cloudflare.com,0,0.00%,116,116,0.00%
ns1kwy.name.com,0,0.00%,132,132,0.00%
matteo.ns.cloudflare.com,0,0.00%,111,111,0.00%
ns1122.ui-dns.biz,0,0.00%,167,167,0.00%
leland.ns.cloudflare.com,0,0.00%,116,116,0.00%
sevki.ns.cloudflare.com,0,0.00%,194,194,0.00%
tosana.ns.cloudflare.com,0,0.00%,211,211,0.00%
nelly.ns.cloudflare.com,0,0.00%,222,222,0.00%
ns3npv.name.com,0,0.00%,117,117,0.00%
ns4ksy.name.com,0,0.00%,127,127,0.00%
lia.ns.cloudflare.com,0,0.00%,281,281,0.00%
ethan.ns.cloudflare.com,0,0.00%,151,151,0.00%
ns2.fatcow.com,0,0.00%,139,139,0.00%
ns1.fatcow.com,0,0.00%,138,138,0.00%
anna.ns.cloudflare.com,0,0.00%,204,204,0.00%
patryk.ns.cloudflare.com,0,0.00%,111,111,0.00%
ns1.brandbucket.com,0,0.00%,203,203,0.00%
ns2.brandbucket.com,0,0.00%,212,212,0.00%
thomas.ns.cloudflare.com,0,0.00%,223,223,0.00%
samara.ns.cloudflare.com,0,0.00%,148,148,0.00%
ns1.hyp.net,0,0.00%,617,617,0.00%
aaron.ns.cloudflare.com,0,0.00%,111,111,0.00%
harmony.ns.cloudflare.com,0,0.00%,510,510,0.00%
dawn.ns.cloudflare.com,0,0.00%,253,253,0.00%
ns2.hyp.net,0,0.00%,617,617,0.00%
ns1.dnsimple.com,0,0.00%,903,903,0.00%
clint.ns.cloudflare.com,0,0.00%,205,205,0.00%
dion.ns.cloudflare.com,0,0.00%,167,167,0.00%
ns1.gocheapweb.com,0,0.00%,249,249,0.00%
dns1.zyro.com,0,0.00%,428,428,0.00%
kianchau.ns.cloudflare.com,0,0.00%,127,127,0.00%
dave.ns.cloudflare.com,0,0.00%,541,541,0.00%
shaz.ns.cloudflare.com,0,0.00%,475,475,0.00%
alfred.ns.cloudflare.com,0,0.00%,117,117,0.00%
ns2lns.name.com,0,0.00%,131,131,0.00%
ns3.webnames.ca,0,0.00%,135,135,0.00%
ns2.webnames.ca,0,0.00%,135,135,0.00%
docks11.rzone.de,0,0.00%,228,228,0.00%
ac12.com,0,0.00%,102,102,0.00%
ns30.dnshubpro.com,0,0.00%,532,532,0.00%
cody.ns.cloudflare.com,0,0.00%,330,330,0.00%
colin.ns.cloudflare.com,0,0.00%,200,200,0.00%
ns1017.ui-dns.de,0,0.00%,143,143,0.00%
ns1019.ui-dns.org,0,0.00%,127,127,0.00%
shades14.rzone.de,0,0.00%,240,240,0.00%
dns3.host-redirect.com,0,0.00%,143,143,0.00%
amit.ns.cloudflare.com,0,0.00%,380,380,0.00%
ns1.krystal.uk,0,0.00%,212,212,0.00%
noor.ns.cloudflare.com,0,0.00%,239,239,0.00%
monroe.ns.cloudflare.com,0,0.00%,136,136,0.00%
docks06.rzone.de,0,0.00%,175,175,0.00%
dns2.wfolio.ru,0,0.00%,193,193,0.00%
ns1042.ui-dns.biz,0,0.00%,216,216,0.00%
dns1.wfolio.ru,0,0.00%,178,178,0.00%
ns2.krystal.uk,0,0.00%,206,206,0.00%
ns3.locaweb.com.br,0,0.00%,476,476,0.00%
dns2.host-redirect.com,0,0.00%,141,141,0.00%
ns1.locaweb.com.br,0,0.00%,478,478,0.00%
ns2.matbao.com,0,0.00%,3038,3038,0.00%
dns4.host-redirect.com,0,0.00%,144,144,0.00%
ns1097.ui-dns.com,0,0.00%,205,205,0.00%
dns2.wfolio.com,0,0.00%,184,184,0.00%
ns1032.ui-dns.de,0,0.00%,207,207,0.00%
ns1067.ui-dns.org,0,0.00%,206,206,0.00%
tr.guzelhosting.com,0,0.00%,163,163,0.00%
eoin.ns.cloudflare.com,0,0.00%,120,120,0.00%
ns1bcp.name.com,0,0.00%,187,187,0.00%
marvin.ns.cloudflare.com,0,0.00%,181,181,0.00%
docks19.rzone.de,0,0.00%,192,192,0.00%
ns3fgq.name.com,0,0.00%,176,176,0.00%
nsbak.pavietnam.net,0,0.00%,547,547,0.00%
konnor.ns.cloudflare.com,0,0.00%,924,924,0.00%
greg.ns.cloudflare.com,0,0.00%,489,489,0.00%
meera.ns.cloudflare.com,0,0.00%,223,223,0.00%
jamie.ns.cloudflare.com,0,0.00%,196,196,0.00%
ns4htz.name.com,0,0.00%,215,215,0.00%
ns1.dotvndns.vn,0,0.00%,218,218,0.00%
addilyn.ns.cloudflare.com,0,0.00%,286,286,0.00%
ns1.pavietnam.vn,0,0.00%,554,554,0.00%
ns2.hoststar.hosting,0,0.00%,237,237,0.00%
ns3.dotvndns.vn,0,0.00%,159,159,0.00%
trey.ns.cloudflare.com,0,0.00%,262,262,0.00%
ns1.namefind.com,0,0.00%,274,274,0.00%
ns2.dotvndns.vn,0,0.00%,220,220,0.00%
ns1095.ui-dns.org,0,0.00%,179,179,0.00%
ns2.namefind.com,0,0.00%,272,272,0.00%
ns1111.ui-dns.com,0,0.00%,131,131,0.00%
ns4.zonedns.vn,0,0.00%,466,466,0.00%
ns2.pavietnam.vn,0,0.00%,548,548,0.00%
nsbak.dotvndns.com,0,0.00%,191,191,0.00%
ns1083.ui-dns.de,0,0.00%,186,186,0.00%
ns2.zonedns.vn,0,0.00%,482,482,0.00%
ns1.zonedns.vn,0,0.00%,482,482,0.00%
ns3.webhostingireland.ie,0,0.00%,121,121,0.00%
ns1-06.azure-dns.com,0,0.00%,115,115,0.00%
agustin.ns.cloudflare.com,0,0.00%,217,217,0.00%
ns1087.ui-dns.biz,0,0.00%,157,157,0.00%
ns3.zonedns.vn,0,0.00%,468,468,0.00%
lloyd.ns.cloudflare.com,0,0.00%,239,239,0.00%
ns1.hoststar.hosting,0,0.00%,215,215,0.00%
irns1.netafraz.com,0,0.00%,321,321,0.00%
ns1081.ui-dns.com,0,0.00%,145,145,0.00%
ns1.netfirms.com,0,0.00%,452,452,0.00%
ns3.parspack.co,0,0.00%,144,144,0.00%
ns2.netfirms.com,0,0.00%,442,442,0.00%
ns2.parspack.co,0,0.00%,146,146,0.00%
ns3flt.name.com,0,0.00%,141,141,0.00%
ns0.phase8.net,0,0.00%,1885,1885,0.00%
ns1114.ui-dns.biz,0,0.00%,162,162,0.00%
ns37.domaincontrol.com,0,0.00%,5463,5463,0.00%
ns1.stablehost.com,0,0.00%,142,142,0.00%
ns4.parspack.co,0,0.00%,145,145,0.00%
ns4kmw.name.com,0,0.00%,159,159,0.00%
ns1098.ui-dns.com,0,0.00%,202,202,0.00%
ns38.domaincontrol.com,0,0.00%,5592,5592,0.00%
tessa.ns.cloudflare.com,0,0.00%,243,243,0.00%
ns2.stablehost.com,0,0.00%,142,142,0.00%
alina.ns.cloudflare.com,0,0.00%,373,373,0.00%
ns2.nina.vn,0,0.00%,229,229,0.00%
ns1.parspack.co,0,0.00%,144,144,0.00%
ns1103.ui-dns.de,0,0.00%,222,222,0.00%
ns1.nina.vn,0,0.00%,229,229,0.00%
harlan.ns.cloudflare.com,0,0.00%,137,137,0.00%
arushi.ns.cloudflare.com,0,0.00%,102,102,0.00%
es-cn-0pp1l8f1v001204h1.public.elasticsearch.aliyuncs.com,0,0.00%,12904,12904,0.00%
ns1036.ui-dns.de,0,0.00%,146,146,0.00%
kobe.ns.cloudflare.com,0,0.00%,100,100,0.00%
ns6.l4dns.com,0,0.00%,351,351,0.00%
ns1053.ui-dns.com,0,0.00%,174,174,0.00%
shopbase.earth.orderbox-dns.com,0,0.00%,300,300,0.00%
ns1041.ui-dns.de,0,0.00%,210,210,0.00%
shopbase.venus.orderbox-dns.com,0,0.00%,297,297,0.00%
shopbase.mercury.orderbox-dns.com,0,0.00%,296,296,0.00%
ns1040.ui-dns.de,0,0.00%,140,140,0.00%
shopbase.mars.orderbox-dns.com,0,0.00%,302,302,0.00%
ns4.domainnamedns.com,0,0.00%,1363,1363,0.00%
ns3.domainnamedns.com,0,0.00%,1350,1350,0.00%
ns1.domainnamedns.com,0,0.00%,1383,1383,0.00%
ns2.domainnamedns.com,0,0.00%,1399,1399,0.00%
webquoteklinepic.eastmoney.com,0,0.00%,192,192,0.00%
ns01.squarespacedns.com,0,0.00%,592,592,0.00%
ns02.squarespacedns.com,0,0.00%,595,595,0.00%
ns03.squarespacedns.com,0,0.00%,594,594,0.00%
ns04.squarespacedns.com,0,0.00%,589,589,0.00%
brad.ns.cloudflare.com,0,0.00%,325,325,0.00%
mia.ns.cloudflare.com,0,0.00%,279,279,0.00%
dns1.bigrock.in,0,0.00%,309,309,0.00%
pearl.ns.cloudflare.com,0,0.00%,120,120,0.00%
ns5.here.ro,0,0.00%,127,127,0.00%
ns02.cashparking.com,0,0.00%,634,634,0.00%
gwen.ns.cloudflare.com,0,0.00%,195,195,0.00%
dom.ns.cloudflare.com,0,0.00%,266,266,0.00%
joselyn.ns.cloudflare.com,0,0.00%,277,277,0.00%
dee.ns.cloudflare.com,0,0.00%,173,173,0.00%
kyree.ns.cloudflare.com,0,0.00%,1174,1174,0.00%
ns1.loopia.se,0,0.00%,1649,1649,0.00%
ns1100.ui-dns.org,0,0.00%,100,100,0.00%
ns2.justhost.com,0,0.00%,156,156,0.00%
ns1.justhost.com,0,0.00%,159,159,0.00%
love.ns.cloudflare.com,0,0.00%,175,175,0.00%
ns1062.ui-dns.de,0,0.00%,117,117,0.00%
ns1070.ui-dns.org,0,0.00%,171,171,0.00%
ns1021.ui-dns.com,0,0.00%,154,154,0.00%
ns1112.ui-dns.com,0,0.00%,143,143,0.00%
yisroel.ns.cloudflare.com,0,0.00%,128,128,0.00%
hattie.ns.cloudflare.com,0,0.00%,154,154,0.00%
otto.ns.cloudflare.com,0,0.00%,201,201,0.00%
dns3.netsons.net,0,0.00%,159,159,0.00%
dns4.bigrock.in,0,0.00%,312,312,0.00%
ns1101.ui-dns.biz,0,0.00%,147,147,0.00%
teagan.ns.cloudflare.com,0,0.00%,287,287,0.00%
dns3.bigrock.in,0,0.00%,310,310,0.00%
viddy.ns.cloudflare.com,0,0.00%,458,458,0.00%
dns2.bigrock.in,0,0.00%,315,315,0.00%
dns4.netsons.net,0,0.00%,158,158,0.00%
ns1065.ui-dns.de,0,0.00%,155,155,0.00%
ns1.messagingengine.com,0,0.00%,108,108,0.00%
ns1034.ui-dns.org,0,0.00%,168,168,0.00%
ns1035.ui-dns.com,0,0.00%,131,131,0.00%
dilbert.ns.cloudflare.com,0,0.00%,320,320,0.00%
dns2.netsons.net,0,0.00%,161,161,0.00%
laila.ns.cloudflare.com,0,0.00%,207,207,0.00%
api.boxcryptor.com,0,0.00%,605,605,0.00%
qb-extension.firebaseio.com,0,0.00%,647,647,0.00%
ns1063.ui-dns.com,0,0.00%,301,301,0.00%
ns1115.ui-dns.biz,0,0.00%,138,138,0.00%
ns1024.ui-dns.org,0,0.00%,112,112,0.00%
ns1063.ui-dns.de,0,0.00%,124,124,0.00%
ns1bdg.name.com,0,0.00%,111,111,0.00%
ns3dty.name.com,0,0.00%,244,244,0.00%
ns4cfn.name.com,0,0.00%,208,208,0.00%
anton.ns.cloudflare.com,0,0.00%,148,148,0.00%
ns4cjp.name.com,0,0.00%,176,176,0.00%
priscilla.ns.cloudflare.com,0,0.00%,173,173,0.00%
ns1.ecpage.com,0,0.00%,1059,1059,0.00%
ns2.ecpage.com,0,0.00%,1023,1023,0.00%
ns1118.ui-dns.de,0,0.00%,178,178,0.00%
dns4.sered.net,0,0.00%,301,301,0.00%
kristina.ns.cloudflare.com,0,0.00%,190,190,0.00%
ns1054.ui-dns.com,0,0.00%,131,131,0.00%
dns105.ovh.net,0,0.00%,135,135,0.00%
ns1096.ui-dns.org,0,0.00%,111,111,0.00%
zeus.ns.cloudflare.com,0,0.00%,269,269,0.00%
ns1033.ui-dns.org,0,0.00%,136,136,0.00%
ns01.cashparking.com,0,0.00%,629,629,0.00%
rene.ns.cloudflare.com,0,0.00%,144,144,0.00%
ns1060.ui-dns.com,0,0.00%,123,123,0.00%
ns2.hosting.co.kr,0,0.00%,981,981,0.00%
ashton.ns.cloudflare.com,0,0.00%,144,144,0.00%
ns6.here.ro,0,0.00%,129,129,0.00%
ns2.mdnsservice.com,0,0.00%,142,142,0.00%
ns1101.ui-dns.de,0,0.00%,165,165,0.00%
aragorn.ns.cloudflare.com,0,0.00%,2031,2031,0.00%
root-dns.netcup.net,0,0.00%,138,138,0.00%
jay.ns.cloudflare.com,0,0.00%,384,384,0.00%
gcr.io,0,0.00%,431,431,0.00%
ns3.flexbe.com,0,0.00%,419,419,0.00%
ns1.flexbe.ru,0,0.00%,391,391,0.00%
ns2.flexbe.ru,0,0.00%,377,377,0.00%
ns2glx.name.com,0,0.00%,298,298,0.00%
aurora.ns.cloudflare.com,0,0.00%,246,246,0.00%
hayes.ns.cloudflare.com,0,0.00%,317,317,0.00%
ns.wedos.cz,0,0.00%,171,171,0.00%
melnicoff.ns.cloudflare.com,0,0.00%,127,127,0.00%
ns2.mysecurecloudhost.com,0,0.00%,457,457,0.00%
ns1.mysecurecloudhost.com,0,0.00%,452,452,0.00%
ns4.cdmondns-01.org,0,0.00%,546,546,0.00%
ns1.cdmon.net,0,0.00%,540,540,0.00%
ns1102.ui-dns.de,0,0.00%,154,154,0.00%
ns1088.ui-dns.com,0,0.00%,190,190,0.00%
ns1059.ui-dns.org,0,0.00%,143,143,0.00%
dns2.papaki.gr,0,0.00%,113,113,0.00%
ns.wedos.net,0,0.00%,174,174,0.00%
reese.ns.cloudflare.com,0,0.00%,375,375,0.00%
ns2.cnolnic.net,0,0.00%,342,342,0.00%
ns1.cnolnic.net,0,0.00%,350,350,0.00%
anita.ns.cloudflare.com,0,0.00%,139,139,0.00%
jimmy.ns.cloudflare.com,0,0.00%,132,132,0.00%
ns.wedos.eu,0,0.00%,176,176,0.00%
ns.wedos.com,0,0.00%,177,177,0.00%
lady.ns.cloudflare.com,0,0.00%,274,274,0.00%
elmo.ns.cloudflare.com,0,0.00%,297,297,0.00%
vera.ns.cloudflare.com,0,0.00%,303,303,0.00%
carrera.ns.cloudflare.com,0,0.00%,222,222,0.00%
ns1.tildadns.com,0,0.00%,999,999,0.00%
jeff.ns.cloudflare.com,0,0.00%,291,291,0.00%
nsr4.domeny.com,0,0.00%,175,175,0.00%
nsr2.domeny.com,0,0.00%,172,172,0.00%
ns1080.ui-dns.biz,0,0.00%,132,132,0.00%
janet.ns.cloudflare.com,0,0.00%,239,239,0.00%
ns1126.ui-dns.com,0,0.00%,259,259,0.00%
alan.ns.cloudflare.com,0,0.00%,427,427,0.00%
pedro.ns.cloudflare.com,0,0.00%,197,197,0.00%
sage.ns.cloudflare.com,0,0.00%,410,410,0.00%
marge.ns.cloudflare.com,0,0.00%,270,270,0.00%
ns1016.ui-dns.de,0,0.00%,147,147,0.00%
ns3.inwx.eu,0,0.00%,308,308,0.00%
evelyn.ns.cloudflare.com,0,0.00%,656,656,0.00%
ns09.domaincontrol.com,0,0.00%,1965,1965,0.00%
ns1.freehosting.com,0,0.00%,123,123,0.00%
ns10.domaincontrol.com,0,0.00%,1915,1915,0.00%
norman.ns.cloudflare.com,0,0.00%,214,214,0.00%
sloan.ns.cloudflare.com,0,0.00%,207,207,0.00%
ns34.domaincontrol.com,0,0.00%,3098,3098,0.00%
ns110.inhostedns.com,0,0.00%,142,142,0.00%
dns01.gmoserver.jp,0,0.00%,202,202,0.00%
evan.ns.cloudflare.com,0,0.00%,312,312,0.00%
ns210.inhostedns.net,0,0.00%,141,141,0.00%
courtney.ns.cloudflare.com,0,0.00%,164,164,0.00%
ns310.inhostedns.org,0,0.00%,139,139,0.00%
ns1078.ui-dns.org,0,0.00%,155,155,0.00%
ns3.lpmtr.net,0,0.00%,217,217,0.00%
ns1109.ui-dns.com,0,0.00%,145,145,0.00%
ns2.lpmtr.net,0,0.00%,212,212,0.00%
ns1123.ui-dns.com,0,0.00%,192,192,0.00%
ns1029.ui-dns.de,0,0.00%,226,226,0.00%
ns1027.ui-dns.biz,0,0.00%,157,157,0.00%
ns4.lpmtr.net,0,0.00%,202,202,0.00%
ns.inwx.de,0,0.00%,296,296,0.00%
dns02.gmoserver.jp,0,0.00%,202,202,0.00%
arturo.ns.cloudflare.com,0,0.00%,123,123,0.00%
erin.ns.cloudflare.com,0,0.00%,375,375,0.00%
alberto.ns.cloudflare.com,0,0.00%,195,195,0.00%
achiel.ns.cloudflare.com,0,0.00%,246,246,0.00%
jerry.ns.cloudflare.com,0,0.00%,281,281,0.00%
lorna.ns.cloudflare.com,0,0.00%,235,235,0.00%
ns1.jino.ru,0,0.00%,916,916,0.00%
ns2.jino.ru,0,0.00%,910,910,0.00%
ns4.jino.ru,0,0.00%,963,963,0.00%
ns3.insales.ru,0,0.00%,138,138,0.00%
ns1.beget.ru,0,0.00%,3962,3962,0.00%
memphis.ns.cloudflare.com,0,0.00%,131,131,0.00%
martha.ns.cloudflare.com,0,0.00%,329,329,0.00%
emerie.ns.cloudflare.com,0,0.00%,176,176,0.00%
shades12.rzone.de,0,0.00%,210,210,0.00%
weston.ns.cloudflare.com,0,0.00%,180,180,0.00%
curitiba.ns.porkbun.com,0,0.00%,669,669,0.00%
fortaleza.ns.porkbun.com,0,0.00%,685,685,0.00%
dane.ns.cloudflare.com,0,0.00%,244,244,0.00%
maceio.ns.porkbun.com,0,0.00%,687,687,0.00%
datacluster3.cipsup.cn,0,0.00%,247,247,0.00%
metadata.packet.net,0,0.00%,101,101,0.00%
register.naas.huawei.com,0,0.00%,165,165,0.00%
open.tingjiandan.com,0,0.00%,109,109,0.00%
ns3.huaweicloud-dns.cn,0,0.00%,138,138,0.00%
ns3.huaweicloud-dns.com,0,0.00%,135,135,0.00%
game.bb.qq.com,0,0.00%,221,221,0.00%
api.insight.synology.com,0,0.00%,219,219,0.00%
apac-china-courier-4.push-apple.com.akadns.net,0,0.00%,841,841,0.00%
ecs-office.s-0005.s-msedge.net,0,0.00%,133,133,0.00%
s-0005.s-msedge.net,0,0.00%,246,246,0.00%
hk.vtnas.com,0,0.00%,227,227,0.00%
new-fp-shed.wg1.b.yahoo.com,0,0.00%,477,477,0.00%
sslpcsnb2.jomodns.com,0,0.00%,122,122,0.00%
teams.office.com,0,0.00%,192,192,0.00%
auth-collab.platform.refinitiv.com,0,0.00%,120,120,0.00%
link-ro5m7bg7.gaapqcloud.com.cn,0,0.00%,116,116,0.00%
yl.qq.com.cloud.tc.qq.com,0,0.00%,191,191,0.00%
teams-mira-afd.trafficmanager.net,0,0.00%,222,222,0.00%
im-collab.platform.refinitiv.com,0,0.00%,122,122,0.00%
qiao.e.shifen.com,0,0.00%,122,122,0.00%
ns2.e.shifen.com,0,0.00%,119,119,0.00%
ns4.e.shifen.com,0,0.00%,140,140,0.00%
ns1.e.shifen.com,0,0.00%,138,138,0.00%
ns3.e.shifen.com,0,0.00%,142,142,0.00%
ns5.e.shifen.com,0,0.00%,118,118,0.00%
game.cr.qq.com,0,0.00%,221,221,0.00%
ns1.n.shifen.com,0,0.00%,364,364,0.00%
ns3.n.shifen.com,0,0.00%,358,358,0.00%
ns4.n.shifen.com,0,0.00%,362,362,0.00%
aoufnebg.dayugslb.com,0,0.00%,317,317,0.00%
ali.picupload.weibo.com,0,0.00%,143,143,0.00%
link-q89r7hhv.gaapqcloud.com,0,0.00%,223,223,0.00%
teams-office-com.s-0005.s-msedge.net,0,0.00%,183,183,0.00%
yl.qq.com.x2v6.sched.dcloudstc.com,0,0.00%,202,202,0.00%
link-6tm8io8v.gaapqcloud.com.cn,0,0.00%,223,223,0.00%
bjali.picupload.weibo.com,0,0.00%,162,162,0.00%
update.b.cqttech.com,0,0.00%,159,159,0.00%
datacluster2.cipsup.cn,0,0.00%,241,241,0.00%
browserkernel.baidu.com,0,0.00%,204,204,0.00%
afdconf.baidu.com,0,0.00%,134,134,0.00%
iosapps.itunes.apple.com,0,0.00%,208,208,0.00%
musicstatus.itunes.apple.com,0,0.00%,351,351,0.00%
api.app.gtja.com,0,0.00%,122,122,0.00%
ts.minipage.2345.cc,0,0.00%,107,107,0.00%
www.weiyun.com,0,0.00%,526,526,0.00%
report.huatuo.qq.com,0,0.00%,192,192,0.00%
ui.ptlogin2.qq.com,0,0.00%,139,139,0.00%
t.minipage.2345.cc,0,0.00%,101,101,0.00%
dtin1.bitznet.cloud,0,0.00%,209,209,0.00%
api.b.qianxin.com,0,0.00%,104,104,0.00%
testip.internet-census.org,0,0.00%,2752,2752,0.00%
shavar.services.mozilla.com,0,0.00%,583,583,0.00%
browser-api.2345.cc,0,0.00%,358,358,0.00%
stock.xueqiu.com,0,0.00%,132,132,0.00%
gsp64-ssl.ls-apple.com.akadns.net,0,0.00%,409,409,0.00%
alita.pc.mi.com,0,0.00%,153,153,0.00%
adash.man.aliyuncs.com,0,0.00%,263,263,0.00%
ins-mfa9hirw.ias.tencent-cloud.net,0,0.00%,313,313,0.00%
socket.pan.baidu.com,0,0.00%,106,106,0.00%
vc.y.qq.com,0,0.00%,150,150,0.00%
face.t.sinajs.cn,0,0.00%,119,119,0.00%
hiya.browser.360.cn,0,0.00%,356,356,0.00%
res.qhmsg.com,0,0.00%,106,106,0.00%
s3.nzbdw.com,0,0.00%,116,116,0.00%
yyb.eve.mdt.qq.com,0,0.00%,262,262,0.00%
swallow.apple.com,0,0.00%,622,622,0.00%
dns.digitale-gesellschaft.ch,0,0.00%,244,244,0.00%
api.iplay.163.com,0,0.00%,140,140,0.00%
interface3.music.163.com.163jiasu.com,0,0.00%,700,700,0.00%
lbs.netease.im,0,0.00%,223,223,0.00%
guzzoni-apple-com.v.aaplimg.com,0,0.00%,572,572,0.00%
sf.symcb.com,0,0.00%,303,303,0.00%
p1.music.126.net,0,0.00%,142,142,0.00%
open.e.189.cn,0,0.00%,104,104,0.00%
c6.y.qq.com,0,0.00%,271,271,0.00%
gsp-ssl.ls.apple.com,0,0.00%,840,840,0.00%
resolver-eu.lelux.fi,0,0.00%,208,208,0.00%
vip.dingtalk.com,0,0.00%,855,855,0.00%
shavar.prod.mozaws.net,0,0.00%,184,184,0.00%
api.smoot.apple.cn,0,0.00%,352,352,0.00%
punch.p2p.qq.com,0,0.00%,257,257,0.00%
profile.firefox.com.cn,0,0.00%,201,201,0.00%
sync.firefox.com.cn,0,0.00%,204,204,0.00%
cl4-cn.apple.com,0,0.00%,314,314,0.00%
iphonesubmissions.apple.com,0,0.00%,217,217,0.00%
datacollect.foxmail.com.cn,0,0.00%,177,177,0.00%
ipv4.gdt.qq.com,0,0.00%,120,120,0.00%
astrategy.beacon.qq.com,0,0.00%,148,148,0.00%
mazu.m.qq.com,0,0.00%,154,154,0.00%
p.qpic.cn,0,0.00%,114,114,0.00%
udpolimenew.baidu.com,0,0.00%,411,411,0.00%
cl2-cn.apple.com,0,0.00%,280,280,0.00%
tr.gingersoftware.com,0,0.00%,146,146,0.00%
static.deepl.com,0,0.00%,382,382,0.00%
aads.shuzilm.cn,0,0.00%,155,155,0.00%
appcloud.zhihu.com,0,0.00%,148,148,0.00%
open.kuaishouzt.com,0,0.00%,211,211,0.00%
daa.shuzilm.cn,0,0.00%,147,147,0.00%
config.cmpassport.com,0,0.00%,123,123,0.00%
log1.cmpassport.com,0,0.00%,116,116,0.00%
it-sdp-tjcon.jd.com,0,0.00%,298,298,0.00%
appcloud2.zhihu.com,0,0.00%,160,160,0.00%
httpdns.c.cdnhwc2.com,0,0.00%,616,616,0.00%
aidatatest.zhihu.com,0,0.00%,152,152,0.00%
us-west-las-5.openssl3.com,0,0.00%,210,210,0.00%
tools.3g.qq.com,0,0.00%,449,449,0.00%
iie.arp.cn,0,0.00%,126,126,0.00%
config.rcs.chinamobile.com,0,0.00%,169,169,0.00%
obus-cn.dc.heytapmobi.com,0,0.00%,174,174,0.00%
bkimg.cdn.bcebos.com,0,0.00%,168,168,0.00%
dragate.dc.oppomobile.com,0,0.00%,298,298,0.00%
webapi.amap.com,0,0.00%,133,133,0.00%
it-sdp-tjcon.jd.com.gslb.qianxun.com,0,0.00%,192,192,0.00%
api.st615.com,0,0.00%,1448,1448,0.00%
browser.events.data.microsoft.com,0,0.00%,206,206,0.00%
p1.ssl.qhimg.com,0,0.00%,357,357,0.00%
cloudpush.iqiyi.com,0,0.00%,145,145,0.00%
appleid.apple.com,0,0.00%,101,101,0.00%
api.wondercv.com,0,0.00%,136,136,0.00%
n21.boom.skin,0,0.00%,117,117,0.00%
nk1.boom.skin,0,0.00%,103,103,0.00%
sdk.open.talk.getui.com,0,0.00%,250,250,0.00%
sdk.open.talk.gepush.com,0,0.00%,195,195,0.00%
sdk.open.talk.getui.net,0,0.00%,300,300,0.00%
mlvbdc.live.qcloud.com,0,0.00%,143,143,0.00%
cloudservice22.kingsoft-office-service.com,0,0.00%,229,229,0.00%
metrics-drcn.dt.hicloud.com,0,0.00%,148,148,0.00%
clt.sangfor.com.cn,0,0.00%,187,187,0.00%
evolwallpaper-api.papegames.cn,0,0.00%,106,106,0.00%
ds.kaspersky.com,0,0.00%,411,411,0.00%
update3.sangfor.net,0,0.00%,709,709,0.00%
bn1304.storage.live.com,0,0.00%,104,104,0.00%
e.coding.net,0,0.00%,388,388,0.00%
by3302.storage.live.com,0,0.00%,134,134,0.00%
t-khd.2345.cc,0,0.00%,154,154,0.00%
polka.typekit.com,0,0.00%,100,100,0.00%
ssl.mail.126.com,0,0.00%,132,132,0.00%
service.weather.msn.cn,0,0.00%,143,143,0.00%
tile-service.weather.msn.cn,0,0.00%,142,142,0.00%
r3---sn-2x3elnez.gvt1.com,0,0.00%,143,143,0.00%
api.mxgcat.wang,0,0.00%,120,120,0.00%
git.octodata.com.cn,0,0.00%,119,119,0.00%
by3301.storage.live.com,0,0.00%,264,264,0.00%
jp03-vm0.entry.srthdw.art,0,0.00%,206,206,0.00%
seed.siri.apple.com,0,0.00%,118,118,0.00%
jp02-vm0.entry.srthdw.art,0,0.00%,143,143,0.00%
msgsrv01.oray.net,0,0.00%,126,126,0.00%
wns.y.qq.com,0,0.00%,139,139,0.00%
wnsmusic.qq.com,0,0.00%,134,134,0.00%
ad.tencentmusic.com,0,0.00%,107,107,0.00%
dispatch.updrv.com,0,0.00%,103,103,0.00%
www.so.com,0,0.00%,1366,1366,0.00%
global.quickconnect.cn,0,0.00%,434,434,0.00%
cs.weishi.ijinshan.com,0,0.00%,101,101,0.00%
smtp.iscas.ac.cn,0,0.00%,218,218,0.00%
ini.sdup.360.cn,0,0.00%,119,119,0.00%
oth.ludashi.com,0,0.00%,129,129,0.00%
ds.download.windowsupdate.com,0,0.00%,134,134,0.00%
iots01-g2.oray.net,0,0.00%,278,278,0.00%
pr4.getnjnd.com,0,0.00%,122,122,0.00%
forums.developer.nvidia.com,0,0.00%,558,558,0.00%
sh.sys-stat.download,0,0.00%,575,575,0.00%
bs2-1.getnjnd.com,0,0.00%,314,314,0.00%
bs1-1.getnjnd.com,0,0.00%,340,340,0.00%
appsso.oh.isrc.ac.cn,0,0.00%,236,236,0.00%
hk-proxy.isrc.ac.cn,0,0.00%,898,898,0.00%
www.mi.com,0,0.00%,259,259,0.00%
bn1301.storage.live.com,0,0.00%,145,145,0.00%
theoldreader.com,0,0.00%,126,126,0.00%
www.wps.cn,0,0.00%,279,279,0.00%
ios-informationplatform.wps.cn,0,0.00%,103,103,0.00%
apd-pcdnvodstat.teg.tencent-cloud.net,0,0.00%,316,316,0.00%
0.t.dancevalidator.io,0,0.00%,512,512,0.00%
passport.weibo.com,0,0.00%,876,876,0.00%
www.theoccult.bz,0,0.00%,121,121,0.00%
tracker.kuroy.me,0,0.00%,179,179,0.00%
tracker2.dler.org,0,0.00%,114,114,0.00%
opentracker.cc,0,0.00%,145,145,0.00%
analytics.cnblogs.com,0,0.00%,254,254,0.00%
www.cnblogs.com,0,0.00%,295,295,0.00%
tracker.openbittorrent.com,0,0.00%,140,140,0.00%
netlink-sigma.proxima.nie.netease.com,0,0.00%,135,135,0.00%
tracker.gcvchp.com,0,0.00%,109,109,0.00%
inferno.demonoid.is,0,0.00%,128,128,0.00%
kklulqbwyj3s3g2i2otjajef2a3kychks2t3agsbv2hdwtiymkbnueid.tor2web.it,0,0.00%,267,267,0.00%
torrents-nn.cn,0,0.00%,137,137,0.00%
a1.cnblogs.com,0,0.00%,264,264,0.00%
remarq.scienceconnect.io,0,0.00%,252,252,0.00%
tracker.electro-torrent.pl,0,0.00%,169,169,0.00%
api.blockcypher.com,0,0.00%,644,644,0.00%
master14.teamviewer.com,0,0.00%,108,108,0.00%
tracker.grepler.com,0,0.00%,131,131,0.00%
torrent.arjlover.net,0,0.00%,150,150,0.00%
api.dropboxapi.com,0,0.00%,482,482,0.00%
cmpp.gentags.net,0,0.00%,122,122,0.00%
www.xwt-classics.net,0,0.00%,155,155,0.00%
open.acgnxtracker.com,0,0.00%,172,172,0.00%
tracker.mywaifu.best,0,0.00%,120,120,0.00%
bt-tracker.gamexp.ru,0,0.00%,122,122,0.00%
h3o2.me,0,0.00%,136,136,0.00%
zgc.ai-cas.com,0,0.00%,132,132,0.00%
chennuo.xyz,0,0.00%,125,125,0.00%
intf-pc.ludashi.com,0,0.00%,431,431,0.00%
pr.x.hub.sandai.net,0,0.00%,599,599,0.00%
kl.hnayg.com,0,0.00%,190,190,0.00%
jasper.ns.cloudflare.com,0,0.00%,277,277,0.00%
zahir.ns.cloudflare.com,0,0.00%,158,158,0.00%
inf.safe.360.cn,0,0.00%,650,650,0.00%
mina.ns.cloudflare.com,0,0.00%,151,151,0.00%
docks15.rzone.de,0,0.00%,204,204,0.00%
shades02.rzone.de,0,0.00%,215,215,0.00%
ns1.hawkhost.com,0,0.00%,302,302,0.00%
ns5.l4dns.com,0,0.00%,357,357,0.00%
ns3.cloudoon.org,0,0.00%,348,348,0.00%
ns2.cloudoon.net,0,0.00%,350,350,0.00%
ns1.cloudoon.com,0,0.00%,352,352,0.00%
shades11.rzone.de,0,0.00%,233,233,0.00%
vin.ns.cloudflare.com,0,0.00%,286,286,0.00%
ns1058.ui-dns.de,0,0.00%,159,159,0.00%
tiffany.ns.cloudflare.com,0,0.00%,310,310,0.00%
alaric.ns.cloudflare.com,0,0.00%,115,115,0.00%
yichun.ns.cloudflare.com,0,0.00%,423,423,0.00%
ligia.ns.cloudflare.com,0,0.00%,229,229,0.00%
kuna1117639.mercury.orderbox-dns.com,0,0.00%,967,967,0.00%
f1g1ns1.dnspod.net,0,0.00%,2476,2476,0.00%
kuna1117639.mars.orderbox-dns.com,0,0.00%,967,967,0.00%
kuna1117639.venus.orderbox-dns.com,0,0.00%,967,967,0.00%
kuna1117639.earth.orderbox-dns.com,0,0.00%,944,944,0.00%
ns2.bdydns.cn,0,0.00%,937,937,0.00%
leif.ns.cloudflare.com,0,0.00%,140,140,0.00%
ns6.diymysite.com,0,0.00%,123,123,0.00%
doma634347.mercury.orderbox-dns.com,0,0.00%,279,279,0.00%
haley.ns.cloudflare.com,0,0.00%,133,133,0.00%
ns5.diymysite.com,0,0.00%,125,125,0.00%
doma634347.venus.orderbox-dns.com,0,0.00%,276,276,0.00%
ns1058.ui-dns.com,0,0.00%,125,125,0.00%
doma634347.mars.orderbox-dns.com,0,0.00%,278,278,0.00%
morgan.ns.cloudflare.com,0,0.00%,329,329,0.00%
sierra.ns.cloudflare.com,0,0.00%,173,173,0.00%
ns1062.ui-dns.org,0,0.00%,153,153,0.00%
donna.ns.cloudflare.com,0,0.00%,204,204,0.00%
lee.ns.cloudflare.com,0,0.00%,431,431,0.00%
langston.ns.cloudflare.com,0,0.00%,270,270,0.00%
earl.ns.cloudflare.com,0,0.00%,214,214,0.00%
ns1.idwebhost.com,0,0.00%,168,168,0.00%
ns1060.ui-dns.org,0,0.00%,177,177,0.00%
ns1116.ui-dns.biz,0,0.00%,177,177,0.00%
ns1091.ui-dns.com,0,0.00%,117,117,0.00%
dns2.zyro.com,0,0.00%,425,425,0.00%
ns1038.ui-dns.biz,0,0.00%,112,112,0.00%
dns212.b.register.com,0,0.00%,120,120,0.00%
shades04.rzone.de,0,0.00%,192,192,0.00%
ns3gmv.name.com,0,0.00%,146,146,0.00%
ns1124.ui-dns.org,0,0.00%,176,176,0.00%
chloe.ns.cloudflare.com,0,0.00%,221,221,0.00%
piers.ns.cloudflare.com,0,0.00%,104,104,0.00%
rohin.ns.cloudflare.com,0,0.00%,198,198,0.00%
roxy.ns.cloudflare.com,0,0.00%,378,378,0.00%
ns1.cargocollective.com,0,0.00%,365,365,0.00%
ns2.cargocollective.com,0,0.00%,368,368,0.00%
ns1.meganameservers.eu,0,0.00%,155,155,0.00%
ns2.meganameservers.eu,0,0.00%,150,150,0.00%
lara.ns.cloudflare.com,0,0.00%,275,275,0.00%
matt.ns.cloudflare.com,0,0.00%,257,257,0.00%
fish.dnspod.net,0,0.00%,110,110,0.00%
nicole.ns.cloudflare.com,0,0.00%,392,392,0.00%
stand.dnspod.net,0,0.00%,105,105,0.00%
ns1117.ui-dns.com,0,0.00%,125,125,0.00%
june.ns.cloudflare.com,0,0.00%,261,261,0.00%
ns1048.ui-dns.biz,0,0.00%,124,124,0.00%
ns3.wpx.net,0,0.00%,109,109,0.00%
ns1.rbe1.g-srv.net,0,0.00%,240,240,0.00%
ns1094.ui-dns.org,0,0.00%,130,130,0.00%
irns2.netafraz.com,0,0.00%,325,325,0.00%
ns1.wpx.net,0,0.00%,110,110,0.00%
dale.ns.cloudflare.com,0,0.00%,279,279,0.00%
kenneth.ns.cloudflare.com,0,0.00%,917,917,0.00%
melinda.ns.cloudflare.com,0,0.00%,203,203,0.00%
daphne.ns.cloudflare.com,0,0.00%,215,215,0.00%
zita.ns.cloudflare.com,0,0.00%,217,217,0.00%
dns1.safenames.com,0,0.00%,122,122,0.00%
ns1048.ui-dns.com,0,0.00%,105,105,0.00%
ns1076.ui-dns.biz,0,0.00%,165,165,0.00%
ns1061.ui-dns.org,0,0.00%,149,149,0.00%
ns1110.ui-dns.biz,0,0.00%,216,216,0.00%
act12.com,0,0.00%,102,102,0.00%
ns1.nazwa.pl,0,0.00%,234,234,0.00%
cortney.ns.cloudflare.com,0,0.00%,379,379,0.00%
ns1072.ui-dns.org,0,0.00%,137,137,0.00%
raina.ns.cloudflare.com,0,0.00%,180,180,0.00%
ns1037.ui-dns.com,0,0.00%,140,140,0.00%
ns1086.ui-dns.com,0,0.00%,170,170,0.00%
gracie.ns.cloudflare.com,0,0.00%,259,259,0.00%
ns2dhj.name.com,0,0.00%,455,455,0.00%
ns3jmt.name.com,0,0.00%,187,187,0.00%
ns4blx.name.com,0,0.00%,205,205,0.00%
ns1103.ui-dns.org,0,0.00%,173,173,0.00%
dns0.heteml.jp,0,0.00%,233,233,0.00%
ns534.umbler.com,0,0.00%,100,100,0.00%
dns1.heteml.jp,0,0.00%,236,236,0.00%
ns1106.ui-dns.com,0,0.00%,182,182,0.00%
ns1034.ui-dns.biz,0,0.00%,199,199,0.00%
ns1076.ui-dns.de,0,0.00%,136,136,0.00%
andy.ns.cloudflare.com,0,0.00%,636,636,0.00%
dns2.rebel.ca,0,0.00%,101,101,0.00%
shades09.rzone.de,0,0.00%,200,200,0.00%
terry.ns.cloudflare.com,0,0.00%,227,227,0.00%
ns1054.ui-dns.de,0,0.00%,151,151,0.00%
ace.ns.cloudflare.com,0,0.00%,308,308,0.00%
ns2.hawkhost.com,0,0.00%,305,305,0.00%
ns1102.ui-dns.biz,0,0.00%,134,134,0.00%
cruz.ns.cloudflare.com,0,0.00%,234,234,0.00%
karina.ns.cloudflare.com,0,0.00%,251,251,0.00%
rita.ns.cloudflare.com,0,0.00%,386,386,0.00%
dell.ns.cloudflare.com,0,0.00%,233,233,0.00%
hassan.ns.cloudflare.com,0,0.00%,154,154,0.00%
ns1089.ui-dns.org,0,0.00%,165,165,0.00%
ns1059.ui-dns.biz,0,0.00%,130,130,0.00%
ns1095.ui-dns.com,0,0.00%,194,194,0.00%
ns1029.ui-dns.org,0,0.00%,164,164,0.00%
tegan.ns.cloudflare.com,0,0.00%,267,267,0.00%
trace.ns.cloudflare.com,0,0.00%,414,414,0.00%
ns1026.ui-dns.de,0,0.00%,163,163,0.00%
ns1125.ui-dns.biz,0,0.00%,102,102,0.00%
ns1.partnerconsole.net,0,0.00%,122,122,0.00%
ns1-01.azure-dns.com,0,0.00%,130,130,0.00%
arya.ns.cloudflare.com,0,0.00%,718,718,0.00%
miles.ns.cloudflare.com,0,0.00%,505,505,0.00%
keenan.ns.cloudflare.com,0,0.00%,267,267,0.00%
ingrid.ns.cloudflare.com,0,0.00%,217,217,0.00%
ns2.incauthorityweb.com,0,0.00%,169,169,0.00%
nicolas.ns.cloudflare.com,0,0.00%,113,113,0.00%
ns2.dataspaces.com,0,0.00%,102,102,0.00%
ns1.dataspaces.com,0,0.00%,102,102,0.00%
valentin.ns.cloudflare.com,0,0.00%,350,350,0.00%
jonah.ns.cloudflare.com,0,0.00%,308,308,0.00%
us.guzelhosting.com,0,0.00%,164,164,0.00%
dns051.b.register.com,0,0.00%,148,148,0.00%
felipe.ns.cloudflare.com,0,0.00%,129,129,0.00%
ns3.nazwa.pl,0,0.00%,237,237,0.00%
ns1.eurodns.com,0,0.00%,492,492,0.00%
ns2.eurodns.com,0,0.00%,499,499,0.00%
sg.guzelhosting.com,0,0.00%,164,164,0.00%
ns2.nazwa.pl,0,0.00%,237,237,0.00%
ns3.eurodns.com,0,0.00%,491,491,0.00%
ns4.eurodns.com,0,0.00%,498,498,0.00%
danica.ns.cloudflare.com,0,0.00%,103,103,0.00%
lana.ns.cloudflare.com,0,0.00%,254,254,0.00%
ns2fhn.name.com,0,0.00%,104,104,0.00%
ns1110.ui-dns.com,0,0.00%,139,139,0.00%
pam.ns.cloudflare.com,0,0.00%,414,414,0.00%
ns4lqx.name.com,0,0.00%,305,305,0.00%
ns1.websupport.sk,0,0.00%,144,144,0.00%
ns2fwz.name.com,0,0.00%,224,224,0.00%
bayan.ns.cloudflare.com,0,0.00%,266,266,0.00%
ns1120.ui-dns.com,0,0.00%,178,178,0.00%
ns2.web.de,0,0.00%,114,114,0.00%
ns2.websupport.sk,0,0.00%,143,143,0.00%
ns3dgr.name.com,0,0.00%,130,130,0.00%
ns1058.ui-dns.biz,0,0.00%,125,125,0.00%
ns3.mdnsservice.com,0,0.00%,142,142,0.00%
nile.ns.cloudflare.com,0,0.00%,377,377,0.00%
ns8.cnmsn.net,0,0.00%,493,493,0.00%
vick.ns.cloudflare.com,0,0.00%,216,216,0.00%
ns1.mdnsservice.com,0,0.00%,145,145,0.00%
agent31.juming.com,0,0.00%,267,267,0.00%
adrian.ns.cloudflare.com,0,0.00%,378,378,0.00%
pns104.cloudns.net,0,0.00%,140,140,0.00%
ns1081.ui-dns.de,0,0.00%,134,134,0.00%
pns103.cloudns.net,0,0.00%,137,137,0.00%
ns1053.ui-dns.org,0,0.00%,113,113,0.00%
ns1038.ui-dns.de,0,0.00%,153,153,0.00%
pns102.cloudns.net,0,0.00%,147,147,0.00%
pns101.cloudns.net,0,0.00%,147,147,0.00%
ns105.ovh.net,0,0.00%,133,133,0.00%
ns216.inhostedns.net,0,0.00%,118,118,0.00%
yolanda.ns.cloudflare.com,0,0.00%,1126,1126,0.00%
ns1027.ui-dns.com,0,0.00%,107,107,0.00%
ns1038.ui-dns.org,0,0.00%,131,131,0.00%
ns1023.ui-dns.biz,0,0.00%,129,129,0.00%
ns1029.ui-dns.com,0,0.00%,117,117,0.00%
ns4.webhostingireland.eu,0,0.00%,123,123,0.00%
ns2.webhostingireland.ie,0,0.00%,122,122,0.00%
ns1.webhostingireland.ie,0,0.00%,120,120,0.00%
ns2.dnsnuts.com,0,0.00%,271,271,0.00%
dns2.hostiq.ua,0,0.00%,190,190,0.00%
dns1.hostiq.ua,0,0.00%,193,193,0.00%
ns4249.hostgator.com,0,0.00%,193,193,0.00%
ns4250.hostgator.com,0,0.00%,191,191,0.00%
ncomment.kuwo.cn,0,0.00%,212,212,0.00%
cloud.lixueyang.site,0,0.00%,181,181,0.00%
ns1.mywahosting.com,0,0.00%,249,249,0.00%
molly.ns.cloudflare.com,0,0.00%,180,180,0.00%
ns2.mywahosting.com,0,0.00%,247,247,0.00%
cns1.sedoparking.com,0,0.00%,232,232,0.00%
chance.ns.cloudflare.com,0,0.00%,218,218,0.00%
peter.ns.cloudflare.com,0,0.00%,149,149,0.00%
tani.ns.cloudflare.com,0,0.00%,317,317,0.00%
ns1.xbiz.ne.jp,0,0.00%,105,105,0.00%
ns1122.ui-dns.de,0,0.00%,103,103,0.00%
gerardo.ns.cloudflare.com,0,0.00%,428,428,0.00%
cns2.sedoparking.com,0,0.00%,225,225,0.00%
ns3.xbiz.ne.jp,0,0.00%,104,104,0.00%
ns1084.ui-dns.org,0,0.00%,134,134,0.00%
ns1066.ui-dns.biz,0,0.00%,121,121,0.00%
ns2.xbiz.ne.jp,0,0.00%,107,107,0.00%
ns1031.ui-dns.com,0,0.00%,131,131,0.00%
quentin.ns.cloudflare.com,0,0.00%,176,176,0.00%
ns78.domaincontrol.com,0,0.00%,6747,6747,0.00%
sara.ns.cloudflare.com,0,0.00%,466,466,0.00%
susan.ns.cloudflare.com,0,0.00%,411,411,0.00%
edward.ns.cloudflare.com,0,0.00%,166,166,0.00%
lisa.ns.cloudflare.com,0,0.00%,280,280,0.00%
webquotestaticpic.dfcfw.com,0,0.00%,250,250,0.00%
ns1.22.cn,0,0.00%,1323,1323,0.00%
ns2.22.cn,0,0.00%,1329,1329,0.00%
ns1022.ui-dns.org,0,0.00%,140,140,0.00%
ns1.dnsnuts.com,0,0.00%,273,273,0.00%
ns77.domaincontrol.com,0,0.00%,6764,6764,0.00%
ns1048.ui-dns.de,0,0.00%,175,175,0.00%
blair.ns.cloudflare.com,0,0.00%,145,145,0.00%
ns1.misspark.com,0,0.00%,242,242,0.00%
treasure.ns.cloudflare.com,0,0.00%,178,178,0.00%
elle.ns.cloudflare.com,0,0.00%,258,258,0.00%
third-dns.netcup.net,0,0.00%,135,135,0.00%
watson.ns.cloudflare.com,0,0.00%,176,176,0.00%
second-dns.netcup.net,0,0.00%,140,140,0.00%
chuck.ns.cloudflare.com,0,0.00%,304,304,0.00%
uma.ns.cloudflare.com,0,0.00%,463,463,0.00%
alice.ns.cloudflare.com,0,0.00%,181,181,0.00%
meilani.ns.cloudflare.com,0,0.00%,314,314,0.00%
ns2.misspark.com,0,0.00%,270,270,0.00%
paris.ns.cloudflare.com,0,0.00%,255,255,0.00%
damian.ns.cloudflare.com,0,0.00%,101,101,0.00%
desi.ns.cloudflare.com,0,0.00%,1493,1493,0.00%
ns4.misspark.com,0,0.00%,271,271,0.00%
mcgrory.ns.cloudflare.com,0,0.00%,224,224,0.00%
marek.ns.cloudflare.com,0,0.00%,170,170,0.00%
meiling.ns.cloudflare.com,0,0.00%,502,502,0.00%
ns3.misspark.com,0,0.00%,257,257,0.00%
bryce.ns.cloudflare.com,0,0.00%,193,193,0.00%
coco.bunny.net,0,0.00%,108,108,0.00%
ns4-l2.nic.ru,0,0.00%,581,581,0.00%
kim.ns.cloudflare.com,0,0.00%,478,478,0.00%
ns1.netangels.ru,0,0.00%,148,148,0.00%
deb.ns.cloudflare.com,0,0.00%,294,294,0.00%
ns2.netangels.ru,0,0.00%,137,137,0.00%
lou.ns.cloudflare.com,0,0.00%,704,704,0.00%
ivan.ns.cloudflare.com,0,0.00%,323,323,0.00%
ns3.netangels.ru,0,0.00%,148,148,0.00%
ns1.inleed.net,0,0.00%,100,100,0.00%
milan.ns.cloudflare.com,0,0.00%,175,175,0.00%
dns2.cafe24.com,0,0.00%,134,134,0.00%
ns5.binero.se,0,0.00%,202,202,0.00%
ns4.netangels.ru,0,0.00%,139,139,0.00%
dns1.cafe24.co.kr,0,0.00%,135,135,0.00%
ns2.beget.ru,0,0.00%,3735,3735,0.00%
dns1.cafe24.com,0,0.00%,133,133,0.00%
marissa.ns.cloudflare.com,0,0.00%,163,163,0.00%
ns1.dnsmadeeasy.com,0,0.00%,168,168,0.00%
ns2.inwx.de,0,0.00%,296,296,0.00%
ram.ns.cloudflare.com,0,0.00%,241,241,0.00%
ns1.ukit.com,0,0.00%,201,201,0.00%
ns2.platformalp.ru,0,0.00%,180,180,0.00%
zoe.ns.cloudflare.com,0,0.00%,353,353,0.00%
pola.ns.cloudflare.com,0,0.00%,163,163,0.00%
piper.ns.cloudflare.com,0,0.00%,182,182,0.00%
wesley.ns.cloudflare.com,0,0.00%,296,296,0.00%
shades13.rzone.de,0,0.00%,223,223,0.00%
savanna.ns.cloudflare.com,0,0.00%,106,106,0.00%
crystal.ns.cloudflare.com,0,0.00%,302,302,0.00%
corey.ns.cloudflare.com,0,0.00%,118,118,0.00%
jacob.ns.cloudflare.com,0,0.00%,181,181,0.00%
linda.ns.cloudflare.com,0,0.00%,279,279,0.00%
ns4.spaceweb.pro,0,0.00%,482,482,0.00%
69.push2his.eastmoney.com,0,0.00%,107,107,0.00%
ns1042.ui-dns.de,0,0.00%,167,167,0.00%
eleanor.ns.cloudflare.com,0,0.00%,239,239,0.00%
ns3.ukit.com,0,0.00%,193,193,0.00%
fiona.ns.cloudflare.com,0,0.00%,284,284,0.00%
ext.henzanapp.com,0,0.00%,288,288,0.00%
contacts.fe.apple-dns.net,0,0.00%,241,241,0.00%
d28139t0r7hg1k.cloudfront.net,0,0.00%,144,144,0.00%
a0.nic.io,0,0.00%,468,468,0.00%
ap.lijit.com,0,0.00%,101,101,0.00%
tm1.dns-tm.com,0,0.00%,488,488,0.00%
tm2.dns-tm.com,0,0.00%,430,430,0.00%
gbapi.eastmoney.com,0,0.00%,656,656,0.00%
vtnt.cnode.xyz,0,0.00%,839,839,0.00%
fe-platformcn-maps-atm.trafficmanager.net,0,0.00%,112,112,0.00%
omgup1.xiaojukeji.com,0,0.00%,741,741,0.00%
hna-router-omg-v6.xiaojukeji.com,0,0.00%,481,481,0.00%
alb-fqpg5b5fb7n0izq8et.cn-hangzhou.alb.aliyuncs.com,0,0.00%,254,254,0.00%
dual-a-0036.a-msedge.net,0,0.00%,656,656,0.00%
guard.sec.xiaojukeji.com,0,0.00%,223,223,0.00%
n1.ofidc.com,0,0.00%,226,226,0.00%
hnb-router-pb-v6.diditaxi.com.cn,0,0.00%,125,125,0.00%
report.im.qcloud.com,0,0.00%,146,146,0.00%
cname.dict.ntes53.netease.com,0,0.00%,244,244,0.00%
update.eset.com,0,0.00%,242,242,0.00%
update.gtm.eset.com,0,0.00%,275,275,0.00%
pico.gtm.eset.com,0,0.00%,1166,1166,0.00%
kklulqbwyj3s3g2i2otjajef2a3kychks2t3agsbv2hdwtiymkbnueid.tor2web.in,0,0.00%,228,228,0.00%
sina.cn,0,0.00%,129,129,0.00%
updates.os.nfschina.com,0,0.00%,572,572,0.00%
grs.dbankcloud.cn,0,0.00%,314,314,0.00%
grs.dbankcloud.eu,0,0.00%,134,134,0.00%
q.rising.cn,0,0.00%,160,160,0.00%
sploit-edge.smartscreen.microsoft.com,0,0.00%,204,204,0.00%
gs-drcn.game.dbankcloud.com,0,0.00%,175,175,0.00%
weather.api.moji.com,0,0.00%,122,122,0.00%
track.mediav.com,0,0.00%,158,158,0.00%
papi.look.360.cn,0,0.00%,174,174,0.00%
query.rec.360.cn,0,0.00%,144,144,0.00%
uri6.com,0,0.00%,106,106,0.00%
beian.miit.gov.cn,0,0.00%,296,296,0.00%
pingtas.qq.com,0,0.00%,162,162,0.00%
thirdwx.qlogo.cn,0,0.00%,385,385,0.00%
cn.patch.battle.net,0,0.00%,178,178,0.00%
mail.nfs-china.com,0,0.00%,215,215,0.00%
utoken.umeng.com,0,0.00%,146,146,0.00%
lcdn-locator.apple.com,0,0.00%,393,393,0.00%
mars.jd.com,0,0.00%,270,270,0.00%
perf.m.jd.com,0,0.00%,132,132,0.00%
115.lingdiany.com,0,0.00%,226,226,0.00%
ccflbs.m.jd.com,0,0.00%,141,141,0.00%
aks.jdpay.com,0,0.00%,171,171,0.00%
anti-sdk-report.m.jd.com,0,0.00%,172,172,0.00%
policy.jd.com,0,0.00%,201,201,0.00%
ex.m.jd.com,0,0.00%,211,211,0.00%
un.m.jd.com,0,0.00%,126,126,0.00%
lbsapi.m.jd.com,0,0.00%,105,105,0.00%
blackhole.m.jd.com,0,0.00%,253,253,0.00%
im-x.jd.com,0,0.00%,232,232,0.00%
www.xiaohongshu.com,0,0.00%,274,274,0.00%
crash.xiaohongshu.com,0,0.00%,187,187,0.00%
adashxgc.ut.taobao.com,0,0.00%,159,159,0.00%
lng.xiaohongshu.com,0,0.00%,323,323,0.00%
l.gm.mob.com,0,0.00%,145,145,0.00%
rn-resource-app.xiaohongshu.com,0,0.00%,151,151,0.00%
fe-static.xhscdn.com,0,0.00%,111,111,0.00%
bt.xxx-tracker.com,0,0.00%,109,109,0.00%
wwads.cn,0,0.00%,240,240,0.00%
ins-g4ztq7u7.ias.tencent-cloud.net,0,0.00%,159,159,0.00%
collector.github.com,0,0.00%,120,120,0.00%
calendars.icloud.com,0,0.00%,224,224,0.00%
caldav.fe.apple-dns.cn,0,0.00%,311,311,0.00%
pis.alicdn.com,0,0.00%,199,199,0.00%
udpolimeok.baidu.com,0,0.00%,332,332,0.00%
openjmacs4uc.m.taobao.com,0,0.00%,112,112,0.00%
nearby-drcn.platform.dbankcloud.com,0,0.00%,107,107,0.00%
servicewechat.com,0,0.00%,100,100,0.00%
pssn.alicdn.com,0,0.00%,213,213,0.00%
baijiahao.baidu.com,0,0.00%,213,213,0.00%
referee.xiaohongshu.com,0,0.00%,156,156,0.00%
t3.xiaohongshu.com,0,0.00%,148,148,0.00%
commnat-main-gc.ess.apple.com,0,0.00%,238,238,0.00%
jtrn.is.autonavi.com.gds.alibabadns.com,0,0.00%,115,115,0.00%
api.adguard.com,0,0.00%,105,105,0.00%
gz-lb1.internet.v6.spanner.alipaydns.com,0,0.00%,225,225,0.00%
push-rtmp-vr-f5.s.bytefcdn.com,0,0.00%,248,248,0.00%
push-rtmp-l95.douyincdn.com.ctdns.cn,0,0.00%,122,122,0.00%
pull-hls-f29.douyincdn.com.ucloud.com.cn,0,0.00%,124,124,0.00%
pull-rtmp-l95.douyincdn.com.ctdns.cn,0,0.00%,126,126,0.00%
push-rtmp-spe-l3.douyincdn.com.230b2a2545cfa773.queniufm.com,0,0.00%,118,118,0.00%
pull-rtmp-f29.douyincdn.com.ucloud.com.cn,0,0.00%,134,134,0.00%
push-rtmp-vr-l3.douyincdn.com.230b2a2545cfa773.queniufm.com,0,0.00%,113,113,0.00%
1671aab.ne.gladns.com,0,0.00%,201,201,0.00%
1671aab.nb.gladns.com,0,0.00%,155,155,0.00%
1671aab.nh.gladns.com,0,0.00%,188,188,0.00%
1671aab.nc.gladns.com,0,0.00%,170,170,0.00%
1671aab.ng.gladns.com,0,0.00%,173,173,0.00%
www.gstatic.cn,0,0.00%,510,510,0.00%
1671aab.nf.gladns.com,0,0.00%,152,152,0.00%
1671aab.nd.gladns.com,0,0.00%,153,153,0.00%
1671aab.na.gladns.com,0,0.00%,180,180,0.00%
dispatcher.is.autonavi.com.gds.alibabadns.com,0,0.00%,144,144,0.00%
b-gtc.getui.net,0,0.00%,154,154,0.00%
yccc.123nat.com,0,0.00%,250,250,0.00%
ocsp.sectigo.com,0,0.00%,203,203,0.00%
magic.h3c.com,0,0.00%,283,283,0.00%
mx.cstnet.cn,0,0.00%,309,309,0.00%
seeds-open.xycdn.com,0,0.00%,139,139,0.00%
log-upload.mihoyo.com,0,0.00%,191,191,0.00%
05c3b39.pc.gladns.com,0,0.00%,174,174,0.00%
grpc.biliapi.net,0,0.00%,247,247,0.00%
ftp.ext.hp.com,0,0.00%,183,183,0.00%
ii.gdt.qq.com,0,0.00%,129,129,0.00%
developer.apple.com,0,0.00%,117,117,0.00%
awareness-api-drcn.ai.dbankcloud.com,0,0.00%,103,103,0.00%
ftp.hp.com,0,0.00%,171,171,0.00%
doh.li,0,0.00%,309,309,0.00%
update.browser.qq.com,0,0.00%,129,129,0.00%
update.pc.mi.com,0,0.00%,161,161,0.00%
websv.aliyundrive.com,0,0.00%,1803,1803,0.00%
confluence.bidinte.top,0,0.00%,498,498,0.00%
bitbucket.bidinte.top,0,0.00%,1008,1008,0.00%
analysis.sangfor.com.cn,0,0.00%,1576,1576,0.00%
ins-k5tkxji1.ias.tencent-cloud.net,0,0.00%,287,287,0.00%
chpm.sangfor.com.cn,0,0.00%,1360,1360,0.00%
cbs-u.sports.cctv.com,0,0.00%,347,347,0.00%
cbs-i.sports.cctv.com,0,0.00%,344,344,0.00%
bn02pap001.storage.live.com,0,0.00%,147,147,0.00%
sf1.helloking.win,0,0.00%,156,156,0.00%
jira.bidinte.top,0,0.00%,502,502,0.00%
b29f269.pd.gladns.com,0,0.00%,205,205,0.00%
b29f269.pg.gladns.com,0,0.00%,214,214,0.00%
b29f269.ph.gladns.com,0,0.00%,213,213,0.00%
b29f269.pf.gladns.com,0,0.00%,202,202,0.00%
b29f269.pe.gladns.com,0,0.00%,212,212,0.00%
b29f269.pb.gladns.com,0,0.00%,185,185,0.00%
b29f269.pc.gladns.com,0,0.00%,203,203,0.00%
b29f269.pa.gladns.com,0,0.00%,199,199,0.00%
cloud.google.com,0,0.00%,181,181,0.00%
outlook.gogo66.cloud,0,0.00%,178,178,0.00%
e71e16d.ph.gladns.com,0,0.00%,117,117,0.00%
device.sangfor.com.cn,0,0.00%,472,472,0.00%
vpn.oceanum.cn,0,0.00%,404,404,0.00%
xy.pull.yximgs.com,0,0.00%,318,318,0.00%
ws-proxy.pull.yximgs.com,0,0.00%,393,393,0.00%
jp06-vm0.entry.srthdw.art,0,0.00%,131,131,0.00%
us.archive.ubuntu.com,0,0.00%,292,292,0.00%
mail.dingtalk.com,0,0.00%,590,590,0.00%
zhxin2.xfplay.com,0,0.00%,295,295,0.00%
mirrors.fedoraproject.org,0,0.00%,629,629,0.00%
edgeapi.slack.com,0,0.00%,131,131,0.00%
wss-primary.slack.com,0,0.00%,358,358,0.00%
app.slack.com,0,0.00%,193,193,0.00%
connect-drcn.dbankcloud.cn,0,0.00%,319,319,0.00%
api-skytone-6-drcn.cloud.dbankcloud.cn,0,0.00%,101,101,0.00%
appcfg.v.qq.com,0,0.00%,196,196,0.00%
pxyygxtq.nodelist.xyz,0,0.00%,357,357,0.00%
is.iscas.ac.cn,0,0.00%,141,141,0.00%
analytics.ff.avast.com,0,0.00%,146,146,0.00%
services.myendnoteweb.com,0,0.00%,160,160,0.00%
launcher.store.epicgames.com,0,0.00%,136,136,0.00%
client.docer.wps.cn,0,0.00%,152,152,0.00%
ip.taobao.com,0,0.00%,148,148,0.00%
sha-cu-001.omo-m0m.com,0,0.00%,365,365,0.00%
pcapp.youku.com,0,0.00%,119,119,0.00%
e44ee7b.pd.gladns.com,0,0.00%,140,140,0.00%
e44ee7b.pf.gladns.com,0,0.00%,118,118,0.00%
e44ee7b.pc.gladns.com,0,0.00%,133,133,0.00%
e44ee7b.pe.gladns.com,0,0.00%,115,115,0.00%
iecvlist.microsoft.com,0,0.00%,160,160,0.00%
online2.b.api.cqttech.com,0,0.00%,305,305,0.00%
ldc.lenovo.com.cn.trpcdn.net,0,0.00%,122,122,0.00%
flow.logitech.io,0,0.00%,366,366,0.00%
nexus.prod.osssc.ac.cn,0,0.00%,532,532,0.00%
www36oo.com,0,0.00%,161,161,0.00%
code.osssc.ac.cn,0,0.00%,1465,1465,0.00%
cu.10242018.xyz,0,0.00%,203,203,0.00%
hkbnjl0.zhs.company,0,0.00%,121,121,0.00%
tr.bangumi.moe,0,0.00%,148,148,0.00%
tracker.loligirl.cn,0,0.00%,116,116,0.00%
master5.teamviewer.com,0,0.00%,113,113,0.00%
gsp10-ssl.apple.com,0,0.00%,200,200,0.00%
tracker.exorditech.com.tr,0,0.00%,115,115,0.00%
taobao.com,0,0.00%,134,134,0.00%
www.ludashi.com,0,0.00%,163,163,0.00%
h-adashx.dingtalkapps.com,0,0.00%,107,107,0.00%
speedtest-rtc.xtspeeder002.xyz,0,0.00%,241,241,0.00%
master11.teamviewer.com,0,0.00%,117,117,0.00%
basictransl.wps.cn,0,0.00%,154,154,0.00%
dns2.safenames.net,0,0.00%,124,124,0.00%
dns3.safenames.org,0,0.00%,119,119,0.00%
sam.ns.cloudflare.com,0,0.00%,226,226,0.00%
conrad.ns.cloudflare.com,0,0.00%,119,119,0.00%
dns.4cun.com,0,0.00%,108,108,0.00%
ns-rs1.gmoserver.jp,0,0.00%,668,668,0.00%
sid.ns.cloudflare.com,0,0.00%,344,344,0.00%
mustafa.ns.cloudflare.com,0,0.00%,150,150,0.00%
paislee.ns.cloudflare.com,0,0.00%,163,163,0.00%
docks05.rzone.de,0,0.00%,190,190,0.00%
adaline.ns.cloudflare.com,0,0.00%,101,101,0.00%
rayden.ns.cloudflare.com,0,0.00%,148,148,0.00%
fatima.ns.cloudflare.com,0,0.00%,133,133,0.00%
shades06.rzone.de,0,0.00%,188,188,0.00%
ns2.secureparkme.com,0,0.00%,514,514,0.00%
adam.ns.cloudflare.com,0,0.00%,219,219,0.00%
ns2nsy.name.com,0,0.00%,192,192,0.00%
ns1.secureparkme.com,0,0.00%,509,509,0.00%
bonnie.ns.cloudflare.com,0,0.00%,474,474,0.00%
ns.forpsi.net,0,0.00%,314,314,0.00%
ns1.incauthorityweb.com,0,0.00%,168,168,0.00%
ns1cmt.name.com,0,0.00%,220,220,0.00%
ns2.nameself.com,0,0.00%,314,314,0.00%
ns2bkr.name.com,0,0.00%,324,324,0.00%
ns3cqz.name.com,0,0.00%,299,299,0.00%
ns2.rbe1.g-srv.net,0,0.00%,234,234,0.00%
shades16.rzone.de,0,0.00%,189,189,0.00%
ns1psw.name.com,0,0.00%,178,178,0.00%
hadlee.ns.cloudflare.com,0,0.00%,427,427,0.00%
ns2fjz.name.com,0,0.00%,218,218,0.00%
fred.ns.cloudflare.com,0,0.00%,198,198,0.00%
ns4qxz.name.com,0,0.00%,531,531,0.00%
ns1016.ui-dns.org,0,0.00%,168,168,0.00%
princess.ns.cloudflare.com,0,0.00%,165,165,0.00%
ns1034.ui-dns.com,0,0.00%,111,111,0.00%
auriga.dnspod.net,0,0.00%,272,272,0.00%
kevin.ns.cloudflare.com,0,0.00%,422,422,0.00%
ns1.your-server.de,0,0.00%,310,310,0.00%
board.dnspod.net,0,0.00%,272,272,0.00%
ns7.cnmsn.net,0,0.00%,496,496,0.00%
ns1084.ui-dns.de,0,0.00%,105,105,0.00%
lennox.ns.cloudflare.com,0,0.00%,224,224,0.00%
ns1031.ui-dns.biz,0,0.00%,128,128,0.00%
ns1120.ui-dns.org,0,0.00%,164,164,0.00%
ns1057.ui-dns.com,0,0.00%,160,160,0.00%
dns2.swizzonic.ch,0,0.00%,221,221,0.00%
dns1.swizzonic.ch,0,0.00%,249,249,0.00%
coco.ns.cloudflare.com,0,0.00%,683,683,0.00%
registracom.mercury.orderbox-dns.com,0,0.00%,197,197,0.00%
registracom.earth.orderbox-dns.com,0,0.00%,197,197,0.00%
registracom.mars.orderbox-dns.com,0,0.00%,195,195,0.00%
registracom.venus.orderbox-dns.com,0,0.00%,193,193,0.00%
phoenix.ns.cloudflare.com,0,0.00%,131,131,0.00%
ns2.dewaweb.com,0,0.00%,141,141,0.00%
ns4.web.de,0,0.00%,114,114,0.00%
ns1.marketleader.com,0,0.00%,135,135,0.00%
clay.ns.cloudflare.com,0,0.00%,284,284,0.00%
dns2.raiolanetworks.es,0,0.00%,144,144,0.00%
jihoon.ns.cloudflare.com,0,0.00%,252,252,0.00%
dns1.raiolanetworks.es,0,0.00%,146,146,0.00%
dns3.raiolanetworks.es,0,0.00%,146,146,0.00%
stella.ns.cloudflare.com,0,0.00%,225,225,0.00%
amber.ns.cloudflare.com,0,0.00%,227,227,0.00%
ns4fpy.name.com,0,0.00%,122,122,0.00%
ns3.websupport.sk,0,0.00%,144,144,0.00%
ns3.web.de,0,0.00%,117,117,0.00%
abby.ns.cloudflare.com,0,0.00%,345,345,0.00%
james.ns.cloudflare.com,0,0.00%,233,233,0.00%
ns10.icasei.com.br,0,0.00%,379,379,0.00%
lindsey.ns.cloudflare.com,0,0.00%,201,201,0.00%
ns1056.ui-dns.org,0,0.00%,168,168,0.00%
algin.ns.cloudflare.com,0,0.00%,176,176,0.00%
nova.ns.cloudflare.com,0,0.00%,129,129,0.00%
maria.ns.cloudflare.com,0,0.00%,146,146,0.00%
ans1.hostcocoa.com,0,0.00%,148,148,0.00%
ans2.hostcocoa.com,0,0.00%,146,146,0.00%
ans3.hostcocoa.com,0,0.00%,148,148,0.00%
ans4.hostcocoa.com,0,0.00%,146,146,0.00%
dns208.b.register.com,0,0.00%,184,184,0.00%
ali.ns.cloudflare.com,0,0.00%,216,216,0.00%
ryan.ns.cloudflare.com,0,0.00%,197,197,0.00%
luciana.ns.cloudflare.com,0,0.00%,272,272,0.00%
ns1025.ui-dns.com,0,0.00%,169,169,0.00%
ns1057.ui-dns.biz,0,0.00%,146,146,0.00%
houston.ns.cloudflare.com,0,0.00%,181,181,0.00%
romina.ns.cloudflare.com,0,0.00%,152,152,0.00%
bart.ns.cloudflare.com,0,0.00%,181,181,0.00%
jo.ns.cloudflare.com,0,0.00%,221,221,0.00%
kolton.ns.cloudflare.com,0,0.00%,147,147,0.00%
rajeev.ns.cloudflare.com,0,0.00%,148,148,0.00%
ns1115.ui-dns.de,0,0.00%,190,190,0.00%
ns1119.ui-dns.com,0,0.00%,110,110,0.00%
ns1126.ui-dns.org,0,0.00%,172,172,0.00%
ns1071.ui-dns.biz,0,0.00%,189,189,0.00%
ns1113.ui-dns.org,0,0.00%,158,158,0.00%
vicente.ns.cloudflare.com,0,0.00%,171,171,0.00%
ns2.yoncu.com,0,0.00%,112,112,0.00%
ns1074.ui-dns.org,0,0.00%,158,158,0.00%
ns2.dothome.co.kr,0,0.00%,166,166,0.00%
dahlia.ns.cloudflare.com,0,0.00%,325,325,0.00%
ns3.dothome.co.kr,0,0.00%,170,170,0.00%
ns1.dothome.co.kr,0,0.00%,166,166,0.00%
ns1.yoncu.com,0,0.00%,113,113,0.00%
ns1.enter-system.com,0,0.00%,287,287,0.00%
ns2.enter-system.com,0,0.00%,291,291,0.00%
ns1080.ui-dns.org,0,0.00%,155,155,0.00%
logan.ns.cloudflare.com,0,0.00%,288,288,0.00%
ns4.diymysite.com,0,0.00%,142,142,0.00%
nero.ns.cloudflare.com,0,0.00%,111,111,0.00%
ulla.ns.cloudflare.com,0,0.00%,368,368,0.00%
elisa.ns.cloudflare.com,0,0.00%,531,531,0.00%
norah.ns.cloudflare.com,0,0.00%,147,147,0.00%
carmelo.ns.cloudflare.com,0,0.00%,130,130,0.00%
amir.ns.cloudflare.com,0,0.00%,339,339,0.00%
ns1082.ui-dns.com,0,0.00%,148,148,0.00%
ns1043.ui-dns.de,0,0.00%,158,158,0.00%
ns1048.ui-dns.org,0,0.00%,154,154,0.00%
ns1043.ui-dns.biz,0,0.00%,130,130,0.00%
ns1103.ui-dns.biz,0,0.00%,121,121,0.00%
ns1090.ui-dns.biz,0,0.00%,166,166,0.00%
henrik.ns.cloudflare.com,0,0.00%,171,171,0.00%
ns1031.ui-dns.org,0,0.00%,177,177,0.00%
ns1117.ui-dns.de,0,0.00%,150,150,0.00%
norm.ns.cloudflare.com,0,0.00%,315,315,0.00%
ns3.partnerconsole.net,0,0.00%,124,124,0.00%
ns1108.ui-dns.de,0,0.00%,161,161,0.00%
ns2.partnerconsole.net,0,0.00%,125,125,0.00%
kaiser.ns.cloudflare.com,0,0.00%,139,139,0.00%
ns1072.ui-dns.com,0,0.00%,134,134,0.00%
ns1073.ui-dns.org,0,0.00%,143,143,0.00%
ns1057.ui-dns.de,0,0.00%,106,106,0.00%
kay.ns.cloudflare.com,0,0.00%,471,471,0.00%
ns20.dnsproviders.info,0,0.00%,543,543,0.00%
ns1086.ui-dns.de,0,0.00%,190,190,0.00%
dns.rebel.ca,0,0.00%,101,101,0.00%
ns1030.ui-dns.biz,0,0.00%,129,129,0.00%
ns40.dns2us.com,0,0.00%,533,533,0.00%
ns1.icasei.com.br,0,0.00%,380,380,0.00%
katja.ns.cloudflare.com,0,0.00%,195,195,0.00%
margo.ns.cloudflare.com,0,0.00%,110,110,0.00%
elsa.ns.cloudflare.com,0,0.00%,332,332,0.00%
ns10.dnshoster.net,0,0.00%,536,536,0.00%
chad.ns.cloudflare.com,0,0.00%,251,251,0.00%
ns2.easyname.eu,0,0.00%,228,228,0.00%
ns21018.ztomy.com,0,0.00%,166,166,0.00%
brett.ns.cloudflare.com,0,0.00%,548,548,0.00%
ns11018.ztomy.com,0,0.00%,166,166,0.00%
naya.ns.cloudflare.com,0,0.00%,256,256,0.00%
ns4.supercp.com,0,0.00%,363,363,0.00%
ns3.supercp.com,0,0.00%,361,361,0.00%
ns2.supercp.com,0,0.00%,376,376,0.00%
ns1.supercp.com,0,0.00%,378,378,0.00%
ns1018.ui-dns.de,0,0.00%,138,138,0.00%
ns1.easyname.eu,0,0.00%,222,222,0.00%
ns1022.ui-dns.com,0,0.00%,165,165,0.00%
titan.ns.cloudflare.com,0,0.00%,176,176,0.00%
drake.ns.cloudflare.com,0,0.00%,155,155,0.00%
ns15.xincache.com,0,0.00%,194,194,0.00%
ns16.xincache.com,0,0.00%,183,183,0.00%
ns2.fastpark.net,0,0.00%,101,101,0.00%
ns1.taipandns.com,0,0.00%,258,258,0.00%
ns2.taipandns.com,0,0.00%,256,256,0.00%
www.data5u.com,0,0.00%,308,308,0.00%
mimi.ns.cloudflare.com,0,0.00%,390,390,0.00%
andronicus.ns.cloudflare.com,0,0.00%,295,295,0.00%
ns1.sprinthost.ru,0,0.00%,679,679,0.00%
ns8-l2.nic.ru,0,0.00%,547,547,0.00%
dns1.parastorage.com,0,0.00%,187,187,0.00%
dns2.parastorage.com,0,0.00%,185,185,0.00%
dns1.yandex.net,0,0.00%,222,222,0.00%
casey.ns.cloudflare.com,0,0.00%,150,150,0.00%
hugh.ns.cloudflare.com,0,0.00%,198,198,0.00%
ns4.dnsmadeeasy.com,0,0.00%,170,170,0.00%
kiki.bunny.net,0,0.00%,124,124,0.00%
ns0.dnsmadeeasy.com,0,0.00%,170,170,0.00%
ns2.dnsmadeeasy.com,0,0.00%,166,166,0.00%
ns3.dnsmadeeasy.com,0,0.00%,171,171,0.00%
heidi.ns.cloudflare.com,0,0.00%,199,199,0.00%
ns4.sprinthost.net,0,0.00%,663,663,0.00%
ns.masterhost.ru,0,0.00%,223,223,0.00%
ns2.sprinthost.ru,0,0.00%,674,674,0.00%
ns3.hostland.ru,0,0.00%,246,246,0.00%
apollo.ns.cloudflare.com,0,0.00%,209,209,0.00%
ns4.binero.se,0,0.00%,185,185,0.00%
a.dns.ripn.net,0,0.00%,473,473,0.00%
ns2.simply.com,0,0.00%,394,394,0.00%
ns3.creatium.io,0,0.00%,190,190,0.00%
ns4.zomro.su,0,0.00%,179,179,0.00%
ns29.domaincontrol.com,0,0.00%,6455,6455,0.00%
verification-3f308ab4.ns3.dan.hosting,0,0.00%,487,487,0.00%
ns30.domaincontrol.com,0,0.00%,6417,6417,0.00%
ns2.spaceweb.ru,0,0.00%,481,481,0.00%
javier.ns.cloudflare.com,0,0.00%,236,236,0.00%
ns3.sprinthost.net,0,0.00%,630,630,0.00%
ns1.spaceweb.ru,0,0.00%,477,477,0.00%
adel.ns.cloudflare.com,0,0.00%,300,300,0.00%
clarissa.ns.cloudflare.com,0,0.00%,345,345,0.00%
ns3.spaceweb.pro,0,0.00%,497,497,0.00%
coby.ns.cloudflare.com,0,0.00%,163,163,0.00%
odin.ns.cloudflare.com,0,0.00%,593,593,0.00%
ns1085.ui-dns.de,0,0.00%,148,148,0.00%
ns7.binero.se,0,0.00%,202,202,0.00%
ns1099.ui-dns.org,0,0.00%,106,106,0.00%
ns3.binero.se,0,0.00%,182,182,0.00%
ns1083.ui-dns.biz,0,0.00%,125,125,0.00%
ns6.binero.se,0,0.00%,201,201,0.00%
ns4.simply.com,0,0.00%,386,386,0.00%
ns4.creatium.io,0,0.00%,184,184,0.00%
ns1.simply.com,0,0.00%,400,400,0.00%
ns3.simply.com,0,0.00%,373,373,0.00%
ns1106.ui-dns.de,0,0.00%,161,161,0.00%
b.ezdnscenter.com,0,0.00%,416,416,0.00%
ns1040.ui-dns.biz,0,0.00%,382,382,0.00%
ns1dhq.name.com,0,0.00%,162,162,0.00%
ainsley.ns.cloudflare.com,0,0.00%,132,132,0.00%
melany.ns.cloudflare.com,0,0.00%,493,493,0.00%
carlos.ns.cloudflare.com,0,0.00%,139,139,0.00%
stevie.ns.cloudflare.com,0,0.00%,133,133,0.00%
adele.ns.cloudflare.com,0,0.00%,266,266,0.00%
arnold.ns.cloudflare.com,0,0.00%,272,272,0.00%
ns3-l2.nic.ru,0,0.00%,578,578,0.00%
ns2.ihc.ru,0,0.00%,230,230,0.00%
ns6.inleed.net,0,0.00%,106,106,0.00%
ns3.inleed.net,0,0.00%,101,101,0.00%
usa4.666670.xyz,0,0.00%,497,497,0.00%
doh-de.blahdns.com,0,0.00%,110,110,0.00%
rpt.gdt.qq.com,0,0.00%,198,198,0.00%
push-rtmp-hs-f5-encryption.douyincdn.com.c.volcfcdndvs.com,0,0.00%,103,103,0.00%
tracker1.itzmx.com,0,0.00%,287,287,0.00%
st.p.360.cn,0,0.00%,520,520,0.00%
live.bilibili.com,0,0.00%,107,107,0.00%
stun.chat.bilibili.com,0,0.00%,255,255,0.00%
wps-file.obs.cn-north-4.myhuaweicloud.com,0,0.00%,101,101,0.00%
updatecenter.qq.com,0,0.00%,117,117,0.00%
sp3.sangfor.com.cn,0,0.00%,109,109,0.00%
kstj.baidu.com,0,0.00%,122,122,0.00%
livenet.video.iqiyi.com,0,0.00%,192,192,0.00%
shu.y.qq.com,0,0.00%,124,124,0.00%
s.weibo.com,0,0.00%,104,104,0.00%
img.t.sinajs.cn,0,0.00%,177,177,0.00%
skin.se.360.cn,0,0.00%,126,126,0.00%
tmfsdk.m.qq.com,0,0.00%,221,221,0.00%
www.mythtao.com,0,0.00%,102,102,0.00%
sh.jd.com,0,0.00%,119,119,0.00%
image.baidu.com,0,0.00%,440,440,0.00%
g.cn.miaozhen.com,0,0.00%,475,475,0.00%
mi.gdt.qq.com,0,0.00%,307,307,0.00%
open.e.kuaishou.com,0,0.00%,176,176,0.00%
sdk.split.io,0,0.00%,199,199,0.00%
supl.bd-caict.com,0,0.00%,265,265,0.00%
cloud.pinyin.sogou.com,0,0.00%,162,162,0.00%
api.languagetoolplus.com,0,0.00%,112,112,0.00%
log.kuwo.cn,0,0.00%,249,249,0.00%
artistpicserver.kuwo.cn,0,0.00%,236,236,0.00%
amdc-v6.alipaydns.com,0,0.00%,171,171,0.00%
ecmb.bdimg.com,0,0.00%,139,139,0.00%
hao1.qhimg.com,0,0.00%,138,138,0.00%
hao2.qhimg.com,0,0.00%,112,112,0.00%
hao3.qhimg.com,0,0.00%,135,135,0.00%
guess.mediav.com,0,0.00%,109,109,0.00%
i.dhrest.com,0,0.00%,117,117,0.00%
cube.dhrest.com,0,0.00%,111,111,0.00%
smart.sug.so.com,0,0.00%,163,163,0.00%
user.360kuai.com,0,0.00%,113,113,0.00%
s.hao.360.com,0,0.00%,132,132,0.00%
gsp10-ssl-cn.ls.apple.com,0,0.00%,177,177,0.00%
masdkv6.3g.qq.com,0,0.00%,126,126,0.00%
channel-account-ssl.xunlei.com,0,0.00%,240,240,0.00%
dlp-transit.100tal.com,0,0.00%,141,141,0.00%
bn1305.storage.live.com,0,0.00%,167,167,0.00%
healthcommon.hicloud.com,0,0.00%,109,109,0.00%
b4bf120.v4.gladns.com,0,0.00%,102,102,0.00%
b4bf120.v5.gladns.com,0,0.00%,106,106,0.00%
b4bf120.v9.gladns.com,0,0.00%,104,104,0.00%
quote.eastmoney.com,0,0.00%,186,186,0.00%
vamd.cnode.xyz,0,0.00%,396,396,0.00%
sub.adtchrome.com,0,0.00%,134,134,0.00%
api.mixpanel.com,0,0.00%,351,351,0.00%
connectivitycheck.getdropbox.com,0,0.00%,129,129,0.00%
wappass.n.shifen.com,0,0.00%,140,140,0.00%
flash.xiaohongshu.com,0,0.00%,112,112,0.00%
rp.hpplay.cn,0,0.00%,101,101,0.00%
httpdns-sdk.n.netease.com,0,0.00%,232,232,0.00%
netapm.music.163.com,0,0.00%,312,312,0.00%
7jmrbtrvkgcqkldzyob4kotpyvsgz546yvik2xv4rpnfmrhe4imxthqd.tor2web.it,0,0.00%,180,180,0.00%
data.unistream.io,0,0.00%,187,187,0.00%
tw302.sagittarius-link.com,0,0.00%,221,221,0.00%
c0.ipjingling.com,0,0.00%,105,105,0.00%
intelligence.sangfor.com.cn,0,0.00%,133,133,0.00%
notify.sangfor.com.cn,0,0.00%,136,136,0.00%
cs.10jqka.com.cn,0,0.00%,107,107,0.00%
ws01.pull.yximgs.com,0,0.00%,105,105,0.00%
qapm.baidu.com,0,0.00%,180,180,0.00%
fp-it.fengkongcloud.com,0,0.00%,163,163,0.00%
apppush-sh5.xiaohongshu.com,0,0.00%,104,104,0.00%
opencloud.wostore.cn,0,0.00%,307,307,0.00%
web-resource-app.xiaohongshu.com,0,0.00%,110,110,0.00%
log-verify.mob.com,0,0.00%,125,125,0.00%
browsercfg-drcn.cloud.dbankcloud.cn,0,0.00%,105,105,0.00%
archive.ubuntu.com,0,0.00%,160,160,0.00%
videoepg.hicloud.com,0,0.00%,132,132,0.00%
CM.SSRSS.CLUB,0,0.00%,104,104,0.00%
radarsubmissions.apple.com,0,0.00%,134,134,0.00%
agps.location.live.net,0,0.00%,112,112,0.00%
officeci-mauservice.azurewebsites.net,0,0.00%,109,109,0.00%
33aef1e.nf.gladns.com,0,0.00%,105,105,0.00%
dot.tiar.app,0,0.00%,100,100,0.00%
www.chrome-helper.cc,0,0.00%,112,112,0.00%
ebad288.nb.gladns.com,0,0.00%,136,136,0.00%
ebad288.nh.gladns.com,0,0.00%,125,125,0.00%
master8.teamviewer.com,0,0.00%,113,113,0.00%
cn2888.v2free.xyz,0,0.00%,1436,1436,0.00%
trakx.herokuapp.com,0,0.00%,192,192,0.00%
api.interpreter.caiyunai.com,0,0.00%,183,183,0.00%
blackz.ro,0,0.00%,301,301,0.00%
show.3.mediav.com,0,0.00%,103,103,0.00%
conf.wifi.360.cn,0,0.00%,122,122,0.00%
malcolm.ns.cloudflare.com,0,0.00%,126,126,0.00%
ns1027.ui-dns.org,0,0.00%,136,136,0.00%
raquel.ns.cloudflare.com,0,0.00%,503,503,0.00%
ns4.alphadnszone.com,0,0.00%,552,552,0.00%
ns1072.ui-dns.de,0,0.00%,124,124,0.00%
ajay.ns.cloudflare.com,0,0.00%,260,260,0.00%
ns1062.ui-dns.biz,0,0.00%,175,175,0.00%
julissa.ns.cloudflare.com,0,0.00%,138,138,0.00%
ns2.marketleader.com,0,0.00%,140,140,0.00%
ns5.alphadnszone.com,0,0.00%,542,542,0.00%
ns1.dewaweb.com,0,0.00%,140,140,0.00%
ns3.alphadnszone.com,0,0.00%,549,549,0.00%
ns2.alphadnszone.com,0,0.00%,602,602,0.00%
ns3.dewaweb.com,0,0.00%,139,139,0.00%
ns6.alphadnszone.com,0,0.00%,501,501,0.00%
ns1.alphadnszone.com,0,0.00%,580,580,0.00%
deborah.ns.cloudflare.com,0,0.00%,250,250,0.00%
alex.ns.cloudflare.com,0,0.00%,648,648,0.00%
addyson.ns.cloudflare.com,0,0.00%,255,255,0.00%
buck.ns.cloudflare.com,0,0.00%,208,208,0.00%
aliza.ns.cloudflare.com,0,0.00%,193,193,0.00%
candy.ns.cloudflare.com,0,0.00%,245,245,0.00%
zod.ns.cloudflare.com,0,0.00%,635,635,0.00%
lennon.ns.cloudflare.com,0,0.00%,127,127,0.00%
ns3.bigcommerce.com,0,0.00%,117,117,0.00%
ns1.dotster.com,0,0.00%,180,180,0.00%
ns2.dotster.com,0,0.00%,180,180,0.00%
isla.ns.cloudflare.com,0,0.00%,193,193,0.00%
dns1.uk2.net,0,0.00%,239,239,0.00%
dns2.uk2.net,0,0.00%,238,238,0.00%
dns3.uk2.net,0,0.00%,234,234,0.00%
ip.jiangxianli.com,0,0.00%,114,114,0.00%
ns1.dunford-hittorf.com,0,0.00%,271,271,0.00%
ns2.dunford-hittorf.com,0,0.00%,270,270,0.00%
ns1051.ui-dns.com,0,0.00%,156,156,0.00%
ns1110.ui-dns.org,0,0.00%,154,154,0.00%
ns4252.hostgator.com,0,0.00%,195,195,0.00%
brodie.ns.cloudflare.com,0,0.00%,173,173,0.00%
ns4251.hostgator.com,0,0.00%,204,204,0.00%
ns1113.ui-dns.biz,0,0.00%,125,125,0.00%
ns1049.ui-dns.com,0,0.00%,146,146,0.00%
ns1032.ui-dns.org,0,0.00%,139,139,0.00%
docks08.rzone.de,0,0.00%,174,174,0.00%
ns4.p17.dynect.net,0,0.00%,388,388,0.00%
ns1.name.com,0,0.00%,188,188,0.00%
ns.forpsi.cz,0,0.00%,317,317,0.00%
ns.forpsi.it,0,0.00%,318,318,0.00%
newt.ns.cloudflare.com,0,0.00%,285,285,0.00%
elma.ns.cloudflare.com,0,0.00%,177,177,0.00%
ns1jlp.name.com,0,0.00%,344,344,0.00%
dante.ns.cloudflare.com,0,0.00%,214,214,0.00%
ns14.hawkhost.com,0,0.00%,209,209,0.00%
ns13.hawkhost.com,0,0.00%,203,203,0.00%
walk.ns.cloudflare.com,0,0.00%,306,306,0.00%
ns3jnr.name.com,0,0.00%,155,155,0.00%
ns4ghm.name.com,0,0.00%,223,223,0.00%
cpns2.turhost.com,0,0.00%,179,179,0.00%
cpns1.turhost.com,0,0.00%,181,181,0.00%
ns1.web.de,0,0.00%,114,114,0.00%
ns1053.ui-dns.de,0,0.00%,165,165,0.00%
ns1fkl.name.com,0,0.00%,221,221,0.00%
ns1.cbsv.jp,0,0.00%,116,116,0.00%
ns2.cbsv.jp,0,0.00%,115,115,0.00%
diva.ns.cloudflare.com,0,0.00%,476,476,0.00%
coen.ns.cloudflare.com,0,0.00%,100,100,0.00%
justin.ns.cloudflare.com,0,0.00%,223,223,0.00%
jean.ns.cloudflare.com,0,0.00%,222,222,0.00%
clyde.ns.cloudflare.com,0,0.00%,285,285,0.00%
braelyn.ns.cloudflare.com,0,0.00%,265,265,0.00%
docks18.rzone.de,0,0.00%,188,188,0.00%
dalary.ns.cloudflare.com,0,0.00%,146,146,0.00%
seamus.ns.cloudflare.com,0,0.00%,170,170,0.00%
sri.ns.cloudflare.com,0,0.00%,195,195,0.00%
stock2.finance.sina.com.cn,0,0.00%,157,157,0.00%
ns1024.ui-dns.biz,0,0.00%,163,163,0.00%
lynn.ns.cloudflare.com,0,0.00%,346,346,0.00%
ns1039.ui-dns.de,0,0.00%,148,148,0.00%
mirrors.nju.edu.cn,0,0.00%,110,110,0.00%
ns3cgw.name.com,0,0.00%,123,123,0.00%
ns1109.ui-dns.org,0,0.00%,179,179,0.00%
ns1039.ui-dns.biz,0,0.00%,148,148,0.00%
ns1046.ui-dns.org,0,0.00%,154,154,0.00%
ns1018.ui-dns.com,0,0.00%,143,143,0.00%
ns1124.ui-dns.com,0,0.00%,168,168,0.00%
ns4241.hostgator.com,0,0.00%,206,206,0.00%
ns4242.hostgator.com,0,0.00%,209,209,0.00%
ns3.hostpoint.ch,0,0.00%,1642,1642,0.00%
colette.ns.cloudflare.com,0,0.00%,344,344,0.00%
ns1090.ui-dns.com,0,0.00%,219,219,0.00%
nora.ns.cloudflare.com,0,0.00%,244,244,0.00%
matias.ns.cloudflare.com,0,0.00%,526,526,0.00%
ns1021.ui-dns.de,0,0.00%,122,122,0.00%
sneh.ns.cloudflare.com,0,0.00%,138,138,0.00%
docks07.rzone.de,0,0.00%,208,208,0.00%
ns2.icasei.com.br,0,0.00%,379,379,0.00%
ns1126.ui-dns.de,0,0.00%,137,137,0.00%
ns1081.ui-dns.biz,0,0.00%,142,142,0.00%
ns1021.ui-dns.org,0,0.00%,139,139,0.00%
jen.ns.cloudflare.com,0,0.00%,145,145,0.00%
rommy.ns.cloudflare.com,0,0.00%,115,115,0.00%
laylah.ns.cloudflare.com,0,0.00%,157,157,0.00%
ns4.monikerdns.net,0,0.00%,307,307,0.00%
ns1.monikerdns.net,0,0.00%,300,300,0.00%
burt.ns.cloudflare.com,0,0.00%,308,308,0.00%
mira.ns.cloudflare.com,0,0.00%,256,256,0.00%
ns2.hostpapa.com,0,0.00%,202,202,0.00%
ns1.hostpapa.com,0,0.00%,198,198,0.00%
wells.ns.cloudflare.com,0,0.00%,217,217,0.00%
www.xicidaili.com,0,0.00%,229,229,0.00%
ns1019.ui-dns.com,0,0.00%,120,120,0.00%
ns1060.ui-dns.biz,0,0.00%,116,116,0.00%
ns1060.ui-dns.de,0,0.00%,159,159,0.00%
f1g1ns2.dnspod.net,0,0.00%,296,296,0.00%
ns1075.ui-dns.org,0,0.00%,143,143,0.00%
c.dns.gandi.net,0,0.00%,387,387,0.00%
b.dns.gandi.net,0,0.00%,391,391,0.00%
a.dns.gandi.net,0,0.00%,394,394,0.00%
pltraffic35.com,0,0.00%,226,226,0.00%
dns102.register.com,0,0.00%,471,471,0.00%
dns-ch2.xinnet.com,0,0.00%,168,168,0.00%
dns-ch.xinnet.com,0,0.00%,169,169,0.00%
ziggy.ns.cloudflare.com,0,0.00%,366,366,0.00%
ns1057.ui-dns.org,0,0.00%,126,126,0.00%
daniella.ns.cloudflare.com,0,0.00%,202,202,0.00%
arvind.ns.cloudflare.com,0,0.00%,182,182,0.00%
novalee.ns.cloudflare.com,0,0.00%,293,293,0.00%
plato.ns.cloudflare.com,0,0.00%,398,398,0.00%
zariyah.ns.cloudflare.com,0,0.00%,310,310,0.00%
21.push2his.eastmoney.com,0,0.00%,107,107,0.00%
emely.ns.cloudflare.com,0,0.00%,100,100,0.00%
ns6.creatium.ru,0,0.00%,185,185,0.00%
ns5.hosting.reg.ru,0,0.00%,112,112,0.00%
ns1.shop.reg.ru,0,0.00%,101,101,0.00%
ns6.hosting.reg.ru,0,0.00%,113,113,0.00%
ns2.masterhost.ru,0,0.00%,223,223,0.00%
ns8-cloud.nic.ru,0,0.00%,580,580,0.00%
ns2.creatium.io,0,0.00%,189,189,0.00%
ns2.shop.reg.ru,0,0.00%,105,105,0.00%
ns1.masterhost.ru,0,0.00%,220,220,0.00%
ns5.creatium.ru,0,0.00%,187,187,0.00%
charles.ns.cloudflare.com,0,0.00%,334,334,0.00%
ns1.creatium.io,0,0.00%,190,190,0.00%
ns4-cloud.nic.ru,0,0.00%,583,583,0.00%
kyrie.ns.cloudflare.com,0,0.00%,150,150,0.00%
kanye.ns.cloudflare.com,0,0.00%,253,253,0.00%
liv.ns.cloudflare.com,0,0.00%,409,409,0.00%
irena.ns.cloudflare.com,0,0.00%,314,314,0.00%
mitchell.ns.cloudflare.com,0,0.00%,490,490,0.00%
ns3.registrant.ru,0,0.00%,110,110,0.00%
ns1kpv.name.com,0,0.00%,179,179,0.00%
robin.ns.cloudflare.com,0,0.00%,185,185,0.00%
hera.ns.cloudflare.com,0,0.00%,236,236,0.00%
quincy.ns.cloudflare.com,0,0.00%,124,124,0.00%
jose.ns.cloudflare.com,0,0.00%,127,127,0.00%
ns2dky.name.com,0,0.00%,143,143,0.00%
ns4gvx.name.com,0,0.00%,691,691,0.00%
ns1.pananames.com,0,0.00%,110,110,0.00%
desiree.ns.cloudflare.com,0,0.00%,194,194,0.00%
joel.ns.cloudflare.com,0,0.00%,254,254,0.00%
pete.ns.cloudflare.com,0,0.00%,249,249,0.00%
lina.ns.cloudflare.com,0,0.00%,205,205,0.00%
keanu.ns.cloudflare.com,0,0.00%,137,137,0.00%
remy.ns.cloudflare.com,0,0.00%,216,216,0.00%
poppy.ns.cloudflare.com,0,0.00%,113,113,0.00%
decker.ns.cloudflare.com,0,0.00%,123,123,0.00%
darl.ns.cloudflare.com,0,0.00%,295,295,0.00%
rihana.ns.cloudflare.com,0,0.00%,344,344,0.00%
ns1.webhost1.com,0,0.00%,183,183,0.00%
ns1.fozzy.com,0,0.00%,179,179,0.00%
ns2.fozzy.com,0,0.00%,174,174,0.00%
ns.hostland.ru,0,0.00%,253,253,0.00%
ns2.firstvds.ru,0,0.00%,323,323,0.00%
ns1.firstvds.ru,0,0.00%,334,334,0.00%
ns2.ukit.com,0,0.00%,184,184,0.00%
ns1.ihc.ru,0,0.00%,229,229,0.00%
ns1.megagroup.ru,0,0.00%,233,233,0.00%
ns2.megagroup.ru,0,0.00%,219,219,0.00%
ns.megagroup.ru,0,0.00%,230,230,0.00%
magali.ns.cloudflare.com,0,0.00%,160,160,0.00%
catcher-in-the-rye.nic.se,0,0.00%,156,156,0.00%
rocco.ns.cloudflare.com,0,0.00%,252,252,0.00%
ns1.platformalp.ru,0,0.00%,186,186,0.00%
ns1.zomro.net,0,0.00%,177,177,0.00%
ns2.zomro.ru,0,0.00%,168,168,0.00%
ns3.zomro.com,0,0.00%,179,179,0.00%
dns1.wfolio.com,0,0.00%,188,188,0.00%
dns2.yandex.net,0,0.00%,245,245,0.00%
ns1.r01.ru,0,0.00%,302,302,0.00%
ns4.insales.ru,0,0.00%,136,136,0.00%
ns2.r01.ru,0,0.00%,295,295,0.00%
ns3.webhost1.org,0,0.00%,177,177,0.00%
ns4.webhost1.org,0,0.00%,177,177,0.00%
ns2.webhost1.com,0,0.00%,178,178,0.00%
ns2.registrant.ru,0,0.00%,113,113,0.00%
ns3.mchost.ru,0,0.00%,135,135,0.00%
ns4.mchost.ru,0,0.00%,131,131,0.00%
ns1.registrant.ru,0,0.00%,110,110,0.00%
cactus.jd.com,0,0.00%,113,113,0.00%
q1.qlogo.cn,0,0.00%,113,113,0.00%
nsp-logservice-hiview-p40-drcn.obs.cn-north-2.myhuaweicloud.com,0,0.00%,159,159,0.00%
zgcalos.mudfwd.xyz,0,0.00%,112,112,0.00%
uz99.v.bsclink.cn,0,0.00%,242,242,0.00%
auth.split.io,0,0.00%,143,143,0.00%
toutiao.com,0,0.00%,434,434,0.00%
tracker.tvunderground.org.ru,0,0.00%,121,121,0.00%
i.sso.sina.com.cn,0,0.00%,107,107,0.00%
nex.163.com,0,0.00%,118,118,0.00%
us.grid.sinaedge.com,0,0.00%,200,200,0.00%
s.qhupdate.com,0,0.00%,123,123,0.00%
cdata.browser.360.cn,0,0.00%,150,150,0.00%
profile.se.360.cn,0,0.00%,155,155,0.00%
tw-07-7F287.ferryhwp8ebm.com,0,0.00%,152,152,0.00%
c.clarity.ms,0,0.00%,113,113,0.00%
api.kuaishouzt.com,0,0.00%,336,336,0.00%
array616.prod.do.dsp.mp.microsoft.com,0,0.00%,210,210,0.00%
amp-api-edge-lb.itunes-apple.com.akadns.net,0,0.00%,151,151,0.00%
weatherapi.market.xiaomi.com,0,0.00%,142,142,0.00%
ort-stsdk.vivo.com.cn,0,0.00%,589,589,0.00%
stdtime.gov.hk,0,0.00%,230,230,0.00%
dc1-st.ksn.kaspersky-labs.com,0,0.00%,243,243,0.00%
p205-contacts.icloud.com.cn,0,0.00%,125,125,0.00%
rq.qb-lbcct.cloud.duba.net,0,0.00%,113,113,0.00%
1D.tlu.dl.delivery.mp.microsoft.com,0,0.00%,238,238,0.00%
wolf.sh,0,0.00%,110,110,0.00%
glacial-ravine-7295.morning-tundra-7160.herokuspace.com,0,0.00%,274,274,0.00%
hivoice-drcn.emui.dbankcloud.com,0,0.00%,165,165,0.00%
edge-skype-com.s-0001.s-msedge.net,0,0.00%,114,114,0.00%
ios.now163.com,0,0.00%,513,513,0.00%
dispatch.integrate.updrv.com,0,0.00%,5063,5063,0.00%
rq.wpscct.cloud.duba.net,0,0.00%,120,120,0.00%
prod-w.nexus.live.com.akadns.net,0,0.00%,159,159,0.00%
dns1.powerdnsserver.com,0,0.00%,168,168,0.00%
dns2.powerdnsserver.com,0,0.00%,168,168,0.00%
syeef.ns.cloudflare.com,0,0.00%,473,473,0.00%
docks20.rzone.de,0,0.00%,213,213,0.00%
ns1115.ui-dns.org,0,0.00%,138,138,0.00%
ns1075.ui-dns.com,0,0.00%,110,110,0.00%
ns1069.ui-dns.de,0,0.00%,143,143,0.00%
rose.ns.cloudflare.com,0,0.00%,272,272,0.00%
darwin.ns.cloudflare.com,0,0.00%,210,210,0.00%
ines.ns.cloudflare.com,0,0.00%,231,231,0.00%
vivienne.ns.cloudflare.com,0,0.00%,161,161,0.00%
ns1.a2phosting.com,0,0.00%,197,197,0.00%
ns2.a2phosting.com,0,0.00%,201,201,0.00%
melody.ns.cloudflare.com,0,0.00%,211,211,0.00%
cartman.ns.cloudflare.com,0,0.00%,169,169,0.00%
ns3.stratoserver.net,0,0.00%,105,105,0.00%
lewis.ns.cloudflare.com,0,0.00%,122,122,0.00%
ns51.domaincontrol.com,0,0.00%,3071,3071,0.00%
ns52.domaincontrol.com,0,0.00%,3072,3072,0.00%
lilith.ns.cloudflare.com,0,0.00%,144,144,0.00%
ns4sxy.name.com,0,0.00%,172,172,0.00%
verification-dad939df.ns3.dan.hosting,0,0.00%,312,312,0.00%
elaine.ns.cloudflare.com,0,0.00%,175,175,0.00%
ns4lrt.name.com,0,0.00%,135,135,0.00%
nelci.ns.cloudflare.com,0,0.00%,180,180,0.00%
sterling.ns.cloudflare.com,0,0.00%,299,299,0.00%
terin.ns.cloudflare.com,0,0.00%,220,220,0.00%
garret.ns.cloudflare.com,0,0.00%,113,113,0.00%
ns45.domaincontrol.com,0,0.00%,6236,6236,0.00%
ns46.domaincontrol.com,0,0.00%,6247,6247,0.00%
ns49.domaincontrol.com,0,0.00%,6895,6895,0.00%
ns50.domaincontrol.com,0,0.00%,6873,6873,0.00%
ns05.gpdns.net,0,0.00%,701,701,0.00%
ns06.gpdns.net,0,0.00%,703,703,0.00%
ns1043.ui-dns.com,0,0.00%,107,107,0.00%
ns1044.ui-dns.de,0,0.00%,148,148,0.00%
ns1026.ui-dns.biz,0,0.00%,126,126,0.00%
ns1081.ui-dns.org,0,0.00%,118,118,0.00%
bjorn.ns.cloudflare.com,0,0.00%,105,105,0.00%
duke.ns.cloudflare.com,0,0.00%,335,335,0.00%
faye.ns.cloudflare.com,0,0.00%,117,117,0.00%
chris.ns.cloudflare.com,0,0.00%,268,268,0.00%
ns1051.ui-dns.biz,0,0.00%,125,125,0.00%
maleah.ns.cloudflare.com,0,0.00%,555,555,0.00%
ns1.irandns.com,0,0.00%,130,130,0.00%
ns2.irandns.com,0,0.00%,129,129,0.00%
donovan.ns.cloudflare.com,0,0.00%,493,493,0.00%
ns1.domain.io,0,0.00%,170,170,0.00%
ns2.domain.io,0,0.00%,163,163,0.00%
kallie.ns.cloudflare.com,0,0.00%,128,128,0.00%
ns4.he.net,0,0.00%,150,150,0.00%
ns3.he.net,0,0.00%,153,153,0.00%
dns101.register.com,0,0.00%,484,484,0.00%
ns2.alastyr.com,0,0.00%,174,174,0.00%
ns5.he.net,0,0.00%,149,149,0.00%
ns2.he.net,0,0.00%,157,157,0.00%
ns3.dns.com,0,0.00%,430,430,0.00%
ns1.he.net,0,0.00%,157,157,0.00%
ns4.dns.com,0,0.00%,428,428,0.00%
ns1028.ui-dns.org,0,0.00%,167,167,0.00%
ns1097.ui-dns.de,0,0.00%,115,115,0.00%
ns1117.ui-dns.biz,0,0.00%,125,125,0.00%
boyd.ns.cloudflare.com,0,0.00%,726,726,0.00%
joan.ns.cloudflare.com,0,0.00%,405,405,0.00%
khalid.ns.cloudflare.com,0,0.00%,519,519,0.00%
millie.ns.cloudflare.com,0,0.00%,229,229,0.00%
ns1.6688dns.com,0,0.00%,420,420,0.00%
ns2.6688dns.com,0,0.00%,414,414,0.00%
ns4.dnsv2.com,0,0.00%,176,176,0.00%
www.edusahoo.com,0,0.00%,219,219,0.00%
hk06.19910501.xyz,0,0.00%,108,108,0.00%
dd.mse.360.cn,0,0.00%,187,187,0.00%
gm.gds.mmstat.com,0,0.00%,114,114,0.00%
music.migu.cn,0,0.00%,100,100,0.00%
update.ydxz.com,0,0.00%,120,120,0.00%
remotedev.oa.com,0,0.00%,159,159,0.00%
imap.mail.yahoo.com,0,0.00%,157,157,0.00%
al04.bb.wdpdk.link,0,0.00%,186,186,0.00%
www.megatorrents.kg,0,0.00%,262,262,0.00%
szdx.txddns.cn,0,0.00%,185,185,0.00%
hk.tcpbbr.net,0,0.00%,280,280,0.00%
openbenchmarking.org,0,0.00%,531,531,0.00%
conn-service-cn-04.allawntech.com,0,0.00%,157,157,0.00%
www.phoronix-test-suite.com,0,0.00%,335,335,0.00%
onrt-stsdk.vivo.com.cn,0,0.00%,470,470,0.00%
c9b086079795c442.jijifun.com,0,0.00%,494,494,0.00%
vsk.cnode.xyz,0,0.00%,682,682,0.00%
minipro.baidu.com,0,0.00%,131,131,0.00%
baikebcs.cdn.bcebos.com,0,0.00%,106,106,0.00%
vcode-api.vivo.com.cn,0,0.00%,269,269,0.00%
u.wwwww.wtf,0,0.00%,263,263,0.00%
app.vssps.visualstudio.com,0,0.00%,136,136,0.00%
ebad288.nf.gladns.com,0,0.00%,128,128,0.00%
get.shouji.sogou.com,0,0.00%,103,103,0.00%
epoch-cn.cdo.heytapmobi.com,0,0.00%,103,103,0.00%
mail.realliferpg.de,0,0.00%,243,243,0.00%
dsp-impr2.youdao.com,0,0.00%,100,100,0.00%
www.cas.cn,0,0.00%,159,159,0.00%
gia.jd.com,0,0.00%,112,112,0.00%
passport.jd.com,0,0.00%,103,103,0.00%
contacts.fe.apple-dns.cn,0,0.00%,338,338,0.00%
5.rlb.router.teamviewer.cn,0,0.00%,292,292,0.00%
vortex-win.data.microsoft.com,0,0.00%,142,142,0.00%
tracker.imgoingto.icu,0,0.00%,224,224,0.00%
ins-gk5vby51.ias.tencent-cloud.net,0,0.00%,157,157,0.00%
asia.roaming1.live.com.akadns.net,0,0.00%,114,114,0.00%
eugen-rx0.pwndns.pw,0,0.00%,3988,3988,0.00%
seal-inner.bytedance.net,0,0.00%,173,173,0.00%
update.nsfocus.com,0,0.00%,859,859,0.00%
update.api.nsfocus.com,0,0.00%,678,678,0.00%
portal.nsfocus.com,0,0.00%,685,685,0.00%
reputation.api.nsfocus.com,0,0.00%,676,676,0.00%
espp.api.nsfocus.com,0,0.00%,691,691,0.00%
hao.360.com,0,0.00%,189,189,0.00%
stappupgrade.vivo.com.cn,0,0.00%,244,244,0.00%
qcloud.gregchan.cn,0,0.00%,142,142,0.00%
xcx.www.gov.cn,0,0.00%,318,318,0.00%
amazon.com,0,0.00%,5283,5283,0.00%
odin.adobe.com,0,0.00%,231,231,0.00%
telemetry-in.battle.net,0,0.00%,1717,1717,0.00%
bs-origin.pull.yximgs.com,0,0.00%,257,257,0.00%
cny-pro.kwd.inkuai.com,0,0.00%,223,223,0.00%
ec.kwd.inkuai.com,0,0.00%,236,236,0.00%
imgx.kwd.inkuai.com,0,0.00%,232,232,0.00%
js-im.xxpkg.com,0,0.00%,205,205,0.00%
hybrid.kwd.inkuai.com,0,0.00%,227,227,0.00%
kkd.kwd.inkuai.com,0,0.00%,247,247,0.00%
v22.kwaicdn.com,0,0.00%,242,242,0.00%
v6-gdvod.kwaicdn.com,0,0.00%,224,224,0.00%
ws.push.yximgs.com,0,0.00%,255,255,0.00%
zt-sup.kwd.inkuai.com,0,0.00%,237,237,0.00%
monitor-stsdk.vivo.com.cn,0,0.00%,285,285,0.00%
t1.leech.ie,0,0.00%,363,363,0.00%
t2.leech.ie,0,0.00%,346,346,0.00%
hubble.netease.com,0,0.00%,218,218,0.00%
rt.tace.ru,0,0.00%,286,286,0.00%
trk.publictracker.xyz,0,0.00%,256,256,0.00%
shu6.y.qq.com,0,0.00%,102,102,0.00%
oases.baidu.com,0,0.00%,135,135,0.00%
free.publictracker.xyz,0,0.00%,246,246,0.00%
retracker.netbynet.ru,0,0.00%,325,325,0.00%
comtrade.un.org,0,0.00%,187,187,0.00%
nzk.woqu365.com,0,0.00%,1476,1476,0.00%
u.zyinfotech.com,0,0.00%,1314,1314,0.00%
api.msn.cn,0,0.00%,168,168,0.00%
push.gifshow.com,0,0.00%,204,204,0.00%
video-bd-drcn.dbankcdn.cn,0,0.00%,438,438,0.00%
vcode-or.vivo.com.cn,0,0.00%,285,285,0.00%
onrt.stsdk.vivo.com.cn,0,0.00%,138,138,0.00%
realtimeweb01.fangcloud.com,0,0.00%,674,674,0.00%
online.b.api.cqttech.com,0,0.00%,135,135,0.00%
pcapp-data-collect.youku.com,0,0.00%,125,125,0.00%
www.zhipin.com,0,0.00%,144,144,0.00%
code.jquery.com,0,0.00%,104,104,0.00%
m.qq.com,0,0.00%,111,111,0.00%
m.jd.com,0,0.00%,113,113,0.00%
dns1.supremepanel.com,0,0.00%,139,139,0.00%
ns1.taoa.com,0,0.00%,2496,2496,0.00%
dns2.supremepanel.com,0,0.00%,139,139,0.00%
ns2.taoa.com,0,0.00%,2585,2585,0.00%
kayden.ns.cloudflare.com,0,0.00%,133,133,0.00%
alexa.ns.cloudflare.com,0,0.00%,216,216,0.00%
ns4232.hostgator.com,0,0.00%,243,243,0.00%
hunts.ns.cloudflare.com,0,0.00%,126,126,0.00%
ns1069.ui-dns.org,0,0.00%,152,152,0.00%
ns1030.ui-dns.com,0,0.00%,126,126,0.00%
ns4231.hostgator.com,0,0.00%,244,244,0.00%
mam.ntes53.netease.com,0,0.00%,103,103,0.00%
ns1100.ui-dns.biz,0,0.00%,146,146,0.00%
ns1.lebodns.com,0,0.00%,100,100,0.00%
shades03.rzone.de,0,0.00%,200,200,0.00%
ns1056.ui-dns.de,0,0.00%,186,186,0.00%
margaret.ns.cloudflare.com,0,0.00%,144,144,0.00%
trevor.ns.cloudflare.com,0,0.00%,399,399,0.00%
ns1016.ui-dns.com,0,0.00%,125,125,0.00%
craig.ns.cloudflare.com,0,0.00%,129,129,0.00%
armando.ns.cloudflare.com,0,0.00%,189,189,0.00%
fsrcn.lenovomm.com,0,0.00%,146,146,0.00%
pantheon-systems.map.fastly.net,0,0.00%,370,370,0.00%
collab.dingtalk.com,0,0.00%,104,104,0.00%
sentry.eulix.xyz,0,0.00%,236,236,0.00%
loki.ams.eulix.xyz,0,0.00%,736,736,0.00%
hashcloud.cz,0,0.00%,188,188,0.00%
ts.eset.com,0,0.00%,230,230,0.00%
ts.gtm.eset.com,0,0.00%,296,296,0.00%
vvb.228.mclqp.link,0,0.00%,203,203,0.00%
inner-all.toutiao-internal-all-v3.lf.bytelb.net,0,0.00%,331,331,0.00%
v11.kwaicdn.com,0,0.00%,303,303,0.00%
aloha.maxhub.vip.wsglb0.com,0,0.00%,866,866,0.00%
v1conf.darwin.kuiniuca.com,0,0.00%,178,178,0.00%
seeds.darwin.kuiniuca.com,0,0.00%,127,127,0.00%
nsdkxyajs.data.kuiniuca.com,0,0.00%,102,102,0.00%
api.my-ip.io,0,0.00%,119,119,0.00%
static-asm-skype.trafficmanager.net,0,0.00%,217,217,0.00%
sa1-authgw.cloudapp.net,0,0.00%,149,149,0.00%
1180c.wpc.azureedge.net,0,0.00%,161,161,0.00%
1180c.ec.azureedge.net,0,0.00%,176,176,0.00%
lb.apr-1180c.edgecastdns.net,0,0.00%,168,168,0.00%
speedtest.snape3058.info,0,0.00%,390,390,0.00%
e57895b9-rh6hs0-rink2v-1d9xe.pccw.alrihla.net,0,0.00%,183,183,0.00%
swdlcdn.eastmoney.com,0,0.00%,127,127,0.00%
ns2-04.azure-dns.net,0,0.00%,112,112,0.00%
wk.baidu.com,0,0.00%,417,417,0.00%
news.so.com,0,0.00%,460,460,0.00%
video.so.com,0,0.00%,431,431,0.00%
t12hz.mail.yeah.net,0,0.00%,409,409,0.00%
t7hz.mail.yeah.net,0,0.00%,421,421,0.00%
szup.btfs.mail.ftn.qq.com,0,0.00%,476,476,0.00%
baike.sogou.com,0,0.00%,362,362,0.00%
wenwen.sogou.com,0,0.00%,368,368,0.00%
user.weiyun.com,0,0.00%,577,577,0.00%
upload.weiyun.com,0,0.00%,488,488,0.00%
upload.zhihu.com,0,0.00%,454,454,0.00%
www.qzone.qq.com,0,0.00%,336,336,0.00%
photo.qzone.qq.com,0,0.00%,336,336,0.00%
club.kdslife.com,0,0.00%,332,332,0.00%
l-0007.l-msedge.net,0,0.00%,223,223,0.00%
ns2.n.shifen.com,0,0.00%,215,215,0.00%
gslb-dsa.zhihu.com,0,0.00%,153,153,0.00%
gz.picupload.weibo.com,0,0.00%,114,114,0.00%
shx.picupload.weibo.com,0,0.00%,121,121,0.00%
videoweibocdn.gslb.sinaedge.com,0,0.00%,145,145,0.00%
p45-mailws.icloud.com.akadns.net,0,0.00%,133,133,0.00%
pv-mailws.icloud.com.akadns.net,0,0.00%,136,136,0.00%
contentws.v.aaplimg.com,0,0.00%,130,130,0.00%
i5.cwip.eset.com,0,0.00%,839,839,0.00%
e-0009.e-msedge.net,0,0.00%,223,223,0.00%
show.re.taobao.com,0,0.00%,135,135,0.00%
www.cnic.cn,0,0.00%,156,156,0.00%
api.axbc.xyz,0,0.00%,241,241,0.00%
feilian-staging.bytedance.com.w.cdngslb.com,0,0.00%,156,156,0.00%
astat-bugly-tgw4l.mig.tencent-cloud.net,0,0.00%,273,273,0.00%
ns-open3.qq.com,0,0.00%,237,237,0.00%
bbs.pku.edu.cn,0,0.00%,162,162,0.00%
4005f8da13f42943.jijifun.com,0,0.00%,203,203,0.00%
www.oschina.net,0,0.00%,261,261,0.00%
expressapisv2.net,0,0.00%,222,222,0.00%
c5bd3904-rh6hs0-rv95kx-1ishw.pccw.alrihla.net,0,0.00%,126,126,0.00%
time.ys7.com,0,0.00%,124,124,0.00%
xmr.remuser.win,0,0.00%,20029,20029,0.00%
kr02.krmanxj.club,0,0.00%,308,308,0.00%
sources.openembedded.org,0,0.00%,40622,40622,0.00%
www.sinfors.com,0,0.00%,542,542,0.00%
item.jd.com,0,0.00%,116,116,0.00%
eugene.ns.cloudflare.com,0,0.00%,154,154,0.00%
gene.ns.cloudflare.com,0,0.00%,222,222,0.00%
ns22.piensasolutions.com,0,0.00%,242,242,0.00%
ns21.piensasolutions.com,0,0.00%,245,245,0.00%
ns.hostpoint.ch,0,0.00%,1529,1529,0.00%
ns2.hostpoint.ch,0,0.00%,1642,1642,0.00%
ns3.alastyr.com,0,0.00%,172,172,0.00%
ns1104.ui-dns.com,0,0.00%,146,146,0.00%
jaziel.ns.cloudflare.com,0,0.00%,156,156,0.00%
val.ns.cloudflare.com,0,0.00%,1072,1072,0.00%
ns1.dns.com.cn,0,0.00%,200,200,0.00%
ns1.omnis.com,0,0.00%,104,104,0.00%
ns3.freeola.net,0,0.00%,123,123,0.00%
miguel.ns.cloudflare.com,0,0.00%,166,166,0.00%
destiny.ns.cloudflare.com,0,0.00%,187,187,0.00%
ns4.freeola.net,0,0.00%,123,123,0.00%
dolly.ns.cloudflare.com,0,0.00%,153,153,0.00%
eric.ns.cloudflare.com,0,0.00%,278,278,0.00%
b.ns36.de,0,0.00%,229,229,0.00%
a.ns36.de,0,0.00%,228,228,0.00%
docks13.rzone.de,0,0.00%,187,187,0.00%
isaac.ns.cloudflare.com,0,0.00%,272,272,0.00%
ns1029.ui-dns.biz,0,0.00%,191,191,0.00%
ns1.ipower.com,0,0.00%,184,184,0.00%
ns2.ipower.com,0,0.00%,185,185,0.00%
aaden.ns.cloudflare.com,0,0.00%,335,335,0.00%
ns4.name.com,0,0.00%,160,160,0.00%
malavika.ns.cloudflare.com,0,0.00%,621,621,0.00%
kiki.ns.cloudflare.com,0,0.00%,314,314,0.00%
ns1.hosttech.ch,0,0.00%,293,293,0.00%
ns2.hosttech.ch,0,0.00%,253,253,0.00%
ns3.hosttech.ch,0,0.00%,287,287,0.00%
ns3fhx.name.com,0,0.00%,142,142,0.00%
ns1064.ui-dns.biz,0,0.00%,197,197,0.00%
jocelyn.ns.cloudflare.com,0,0.00%,212,212,0.00%
dns8.cloudns.net,0,0.00%,146,146,0.00%
dns2.hosterpk.com,0,0.00%,146,146,0.00%
ns2.checkdomain.de,0,0.00%,314,314,0.00%
dns1.hosterpk.com,0,0.00%,147,147,0.00%
ns.checkdomain.de,0,0.00%,313,313,0.00%
grant.ns.cloudflare.com,0,0.00%,155,155,0.00%
sureena.ns.cloudflare.com,0,0.00%,132,132,0.00%
stan.ns.cloudflare.com,0,0.00%,293,293,0.00%
denver.ns.cloudflare.com,0,0.00%,143,143,0.00%
nataly.ns.cloudflare.com,0,0.00%,187,187,0.00%
docks01.rzone.de,0,0.00%,174,174,0.00%
mary.ns.cloudflare.com,0,0.00%,278,278,0.00%
ns1066.ui-dns.org,0,0.00%,151,151,0.00%
ns1074.ui-dns.de,0,0.00%,139,139,0.00%
ns1061.ui-dns.biz,0,0.00%,132,132,0.00%
ns1115.ui-dns.com,0,0.00%,135,135,0.00%
tess.ns.cloudflare.com,0,0.00%,207,207,0.00%
ns1.bigcommerce.com,0,0.00%,116,116,0.00%
ns2.bigcommerce.com,0,0.00%,119,119,0.00%
ns2.name.com,0,0.00%,183,183,0.00%
ns3.name.com,0,0.00%,187,187,0.00%
www.comodo.com,0,0.00%,117,117,0.00%
nolan.ns.cloudflare.com,0,0.00%,103,103,0.00%
ns1.alastyr.com,0,0.00%,174,174,0.00%
dns7.cloudns.net,0,0.00%,146,146,0.00%
uriah.ns.cloudflare.com,0,0.00%,104,104,0.00%
ns3sxz.name.com,0,0.00%,119,119,0.00%
hazel.ns.cloudflare.com,0,0.00%,769,769,0.00%
dns2.freehostia.com,0,0.00%,102,102,0.00%
dns1.freehostia.com,0,0.00%,102,102,0.00%
dns053.b.register.com,0,0.00%,240,240,0.00%
ns1.floripa.servidor.net.br,0,0.00%,103,103,0.00%
ns2.floripa.servidor.net.br,0,0.00%,103,103,0.00%
chelsea.ns.cloudflare.com,0,0.00%,137,137,0.00%
harvey.ns.cloudflare.com,0,0.00%,140,140,0.00%
blakely.ns.cloudflare.com,0,0.00%,251,251,0.00%
emerson.ns.cloudflare.com,0,0.00%,175,175,0.00%
ns1.oray.net,0,0.00%,133,133,0.00%
izabella.ns.cloudflare.com,0,0.00%,250,250,0.00%
dns206.b.register.com,0,0.00%,238,238,0.00%
dylan.ns.cloudflare.com,0,0.00%,241,241,0.00%
ns1036.ui-dns.com,0,0.00%,146,146,0.00%
ns1056.ui-dns.com,0,0.00%,141,141,0.00%
luke.ns.cloudflare.com,0,0.00%,207,207,0.00%
ns1107.ui-dns.org,0,0.00%,172,172,0.00%
bethany.ns.cloudflare.com,0,0.00%,138,138,0.00%
ns1100.ui-dns.com,0,0.00%,144,144,0.00%
cleo.ns.cloudflare.com,0,0.00%,254,254,0.00%
ns1100.ui-dns.de,0,0.00%,135,135,0.00%
ns1041.ui-dns.biz,0,0.00%,122,122,0.00%
ns4.alastyr.com,0,0.00%,174,174,0.00%
ns1077.ui-dns.org,0,0.00%,106,106,0.00%
rudy.ns.cloudflare.com,0,0.00%,205,205,0.00%
lars.ns.cloudflare.com,0,0.00%,293,293,0.00%
megan.ns.cloudflare.com,0,0.00%,275,275,0.00%
54.push2his.eastmoney.com,0,0.00%,105,105,0.00%
ns1090.ui-dns.org,0,0.00%,166,166,0.00%
ns1026.ui-dns.com,0,0.00%,119,119,0.00%
ns1092.ui-dns.com,0,0.00%,162,162,0.00%
dsm04pap002.storage.live.com,0,0.00%,172,172,0.00%
sonny.ns.cloudflare.com,0,0.00%,168,168,0.00%
web.p.qq.com,0,0.00%,166,166,0.00%
nfs.iscas.ac.cn,0,0.00%,229,229,0.00%
cevbnsq7.mirror.aliyuncs.com,0,0.00%,235,235,0.00%
api.cntv.cn,0,0.00%,144,144,0.00%
mermaid.ximalaya.com,0,0.00%,254,254,0.00%
ioav5-policy.ioa.tencent.com,0,0.00%,163,163,0.00%
ioav5-upload.ioa.tencent.com,0,0.00%,154,154,0.00%
ipm-klca.kaspersky.com,0,0.00%,150,150,0.00%
qmzgh5s4613.gameserver.youxigu.com,0,0.00%,110,110,0.00%
slink.gifshow.com,0,0.00%,125,125,0.00%
slink.ksapisrv.com,0,0.00%,131,131,0.00%
kuaishou.com,0,0.00%,121,121,0.00%
torrentsmd.com,0,0.00%,424,424,0.00%
conn-service-cn-05.allawntech.com,0,0.00%,122,122,0.00%
conn-service-cn-03.allawntech.com,0,0.00%,186,186,0.00%
pull-flv-l95.douyincdn.com.ctdns.cn,0,0.00%,150,150,0.00%
accwww15c1.53kf.com,0,0.00%,140,140,0.00%
newtoncity.org,0,0.00%,118,118,0.00%
api.kmovie.gifshow.com,0,0.00%,245,245,0.00%
app.kwaixiaodian.com,0,0.00%,245,245,0.00%
bs-adaptive.pull.yximgs.com,0,0.00%,253,253,0.00%
js-im-simi.xxpkg.com,0,0.00%,213,213,0.00%
keep-so.kwd.inkuai.com,0,0.00%,231,231,0.00%
push.kwd.inkuai.com,0,0.00%,232,232,0.00%
yoda.kwd.inkuai.com,0,0.00%,218,218,0.00%
tdid.m.qq.com,0,0.00%,174,174,0.00%
api.smoot.apple.com,0,0.00%,125,125,0.00%
www.yuque.com,0,0.00%,1222,1222,0.00%
swallow-apple-com.v.aaplimg.com,0,0.00%,108,108,0.00%
eopa.n.shifen.com,0,0.00%,100,100,0.00%
list.lvb.eastmoney.com,0,0.00%,132,132,0.00%
api.51dzt.com,0,0.00%,107,107,0.00%
amp-api-edge.apps.apple.com,0,0.00%,306,306,0.00%
bdstatics.eastmoney.com,0,0.00%,126,126,0.00%
bdwblog.eastmoney.com,0,0.00%,139,139,0.00%
ort.stsdk.vivo.com.cn,0,0.00%,112,112,0.00%
search.kuwo.cn,0,0.00%,877,877,0.00%
pdcweb.micloud.xiaomi.net,0,0.00%,1530,1530,0.00%
yd.9669.me,0,0.00%,162,162,0.00%
runc.myddns.cyou,0,0.00%,124,124,0.00%
ns2jqz.name.com,0,0.00%,150,150,0.00%
ns3fqs.name.com,0,0.00%,108,108,0.00%
drew.ns.cloudflare.com,0,0.00%,297,297,0.00%
shoppingcampaigns-api-drcn.ai.dbankcloud.com,0,0.00%,111,111,0.00%
api.bitbucket.org,0,0.00%,263,263,0.00%
developer.atlassian.com,0,0.00%,251,251,0.00%
bdstatic.eastmoney.com,0,0.00%,109,109,0.00%
myfavor.eastmoney.com,0,0.00%,103,103,0.00%
f20fe36.pf.gladns.com,0,0.00%,202,202,0.00%
www.89ip.cn,0,0.00%,226,226,0.00%
pdns11.domaincontrol.com,0,0.00%,398,398,0.00%
pdns104.ultradns.org,0,0.00%,348,348,0.00%
hydrogen.ns.hetzner.com,0,0.00%,142,142,0.00%
oxygen.ns.hetzner.com,0,0.00%,140,140,0.00%
ns1106.ui-dns.org,0,0.00%,104,104,0.00%
helium.ns.hetzner.de,0,0.00%,139,139,0.00%
f062936a96d3c8bd.jijifun.com,0,0.00%,242,242,0.00%
checkip.digitalocean.synology.com,0,0.00%,207,207,0.00%
dc.trafficmanager.net,0,0.00%,111,111,0.00%
tm2.edgedns-tm.info,0,0.00%,416,416,0.00%
5kong4.com,0,0.00%,236,236,0.00%
xz.wn51.com,0,0.00%,185,185,0.00%
api-accounts.firefox.com.cn,0,0.00%,107,107,0.00%
tracker0.ufibox.com,0,0.00%,267,267,0.00%
valakas.rollo.dnsabr.com,0,0.00%,277,277,0.00%
clt2.sangfor.com.cn,0,0.00%,287,287,0.00%
vibe.community,0,0.00%,247,247,0.00%
xmsj-vip1.omo-m0m.com,0,0.00%,308,308,0.00%
macime.sogou.com,0,0.00%,150,150,0.00%
helpyuanqicleaner1.ksmobile.com,0,0.00%,145,145,0.00%
jillian.ns.cloudflare.com,0,0.00%,1228,1228,0.00%
ns1062.ui-dns.com,0,0.00%,199,199,0.00%
katelyn.ns.cloudflare.com,0,0.00%,121,121,0.00%
ns1124.ui-dns.biz,0,0.00%,174,174,0.00%
ns1116.ui-dns.org,0,0.00%,130,130,0.00%
jasmine.ns.cloudflare.com,0,0.00%,242,242,0.00%
ns2.dns.com.cn,0,0.00%,203,203,0.00%
pranab.ns.cloudflare.com,0,0.00%,175,175,0.00%
ns1082.ui-dns.org,0,0.00%,127,127,0.00%
ns1059.ui-dns.de,0,0.00%,199,199,0.00%
igor.ns.cloudflare.com,0,0.00%,364,364,0.00%
arely.ns.cloudflare.com,0,0.00%,273,273,0.00%
athena.ns.cloudflare.com,0,0.00%,166,166,0.00%
shades10.rzone.de,0,0.00%,211,211,0.00%
ns1125.ui-dns.org,0,0.00%,142,142,0.00%
ns4cpw.name.com,0,0.00%,226,226,0.00%
owen.ns.cloudflare.com,0,0.00%,260,260,0.00%
yoxall.ns.cloudflare.com,0,0.00%,151,151,0.00%
ns2.diymysite.com,0,0.00%,142,142,0.00%
kimora.ns.cloudflare.com,0,0.00%,122,122,0.00%
ns1.turkticaret.net,0,0.00%,104,104,0.00%
jack.ns.cloudflare.com,0,0.00%,602,602,0.00%
ns1027.ui-dns.de,0,0.00%,122,122,0.00%
bjvpn.sugon.com,0,0.00%,289,289,0.00%
autumn.ns.cloudflare.com,0,0.00%,183,183,0.00%
daisy.ns.cloudflare.com,0,0.00%,377,377,0.00%
ns1.diymysite.com,0,0.00%,143,143,0.00%
ns1035.ui-dns.org,0,0.00%,179,179,0.00%
ns1052.ui-dns.org,0,0.00%,164,164,0.00%
ns1099.ui-dns.biz,0,0.00%,105,105,0.00%
ns1024.ui-dns.de,0,0.00%,178,178,0.00%
ns4230.hostgator.com,0,0.00%,190,190,0.00%
ns4247.hostgator.com,0,0.00%,228,228,0.00%
ns4248.hostgator.com,0,0.00%,225,225,0.00%
woz.ns.cloudflare.com,0,0.00%,465,465,0.00%
rosalie.ns.cloudflare.com,0,0.00%,122,122,0.00%
bdns.cs.siteprotect.com,0,0.00%,213,213,0.00%
april.ns.cloudflare.com,0,0.00%,231,231,0.00%
holly.ns.cloudflare.com,0,0.00%,149,149,0.00%
shades17.rzone.de,0,0.00%,150,150,0.00%
ns2.gmxnet.de,0,0.00%,112,112,0.00%
ns4.gmxnet.de,0,0.00%,113,113,0.00%
ns1112.ui-dns.de,0,0.00%,130,130,0.00%
ns1121.ui-dns.biz,0,0.00%,115,115,0.00%
dana.ns.cloudflare.com,0,0.00%,187,187,0.00%
ns3.gmxnet.de,0,0.00%,112,112,0.00%
lily.ns.cloudflare.com,0,0.00%,320,320,0.00%
ns1.gmxnet.de,0,0.00%,113,113,0.00%
ns4cgs.name.com,0,0.00%,133,133,0.00%
ns1080.ui-dns.com,0,0.00%,158,158,0.00%
ns1068.ui-dns.de,0,0.00%,124,124,0.00%
dns3.supremedns.com,0,0.00%,151,151,0.00%
ns21.domaincontrol.com,0,0.00%,5930,5930,0.00%
jacqueline.ns.cloudflare.com,0,0.00%,121,121,0.00%
ns22.domaincontrol.com,0,0.00%,5849,5849,0.00%
ns3gxy.name.com,0,0.00%,125,125,0.00%
ns1088.ui-dns.biz,0,0.00%,120,120,0.00%
ns2.oray.net,0,0.00%,130,130,0.00%
ns1116.ui-dns.de,0,0.00%,122,122,0.00%
ns1086.ui-dns.org,0,0.00%,140,140,0.00%
ns1035.ui-dns.biz,0,0.00%,156,156,0.00%
ns3.combell.net,0,0.00%,184,184,0.00%
ns4.combell.net,0,0.00%,171,171,0.00%
maxim.ns.cloudflare.com,0,0.00%,225,225,0.00%
laura.ns.cloudflare.com,0,0.00%,3298,3298,0.00%
bailey.ns.cloudflare.com,0,0.00%,152,152,0.00%
michael.ns.cloudflare.com,0,0.00%,324,324,0.00%
elliott.ns.cloudflare.com,0,0.00%,198,198,0.00%
troy.ns.cloudflare.com,0,0.00%,388,388,0.00%
dns2.supremedns.com,0,0.00%,153,153,0.00%
ns4bty.name.com,0,0.00%,371,371,0.00%
dns4.supremedns.com,0,0.00%,152,152,0.00%
dns1.supremedns.com,0,0.00%,153,153,0.00%
ns1109.ui-dns.de,0,0.00%,159,159,0.00%
note.ntes53.netease.com,0,0.00%,117,117,0.00%
pdns05.domaincontrol.com,0,0.00%,630,630,0.00%
pdns06.domaincontrol.com,0,0.00%,626,626,0.00%
ns1.smartname.com,0,0.00%,161,161,0.00%
ns2.smartname.com,0,0.00%,162,162,0.00%
ns4240.hostgator.com,0,0.00%,217,217,0.00%
ns4239.hostgator.com,0,0.00%,219,219,0.00%
ns0.thundercloud.uk,0,0.00%,165,165,0.00%
ns1.thundercloud.uk,0,0.00%,160,160,0.00%
dedi.1808.cf,0,0.00%,122,122,0.00%
tracker.tambovnet.org,0,0.00%,144,144,0.00%
access1.tpns.sh.tencent.com,0,0.00%,120,120,0.00%
mall.bilibili.com,0,0.00%,160,160,0.00%
member.bilibili.com,0,0.00%,159,159,0.00%
na61-na62.wagbridge.alibaba.taobao.com.gds.alibabadns.com,0,0.00%,171,171,0.00%
ebad288.ng.gladns.com,0,0.00%,128,128,0.00%
ce3e75d5.jpush.cn,0,0.00%,100,100,0.00%
bf.pinyin.sogou.com,0,0.00%,141,141,0.00%
commnat-cohort-gc.ess.apple.com,0,0.00%,226,226,0.00%
shrouded-wave-5410.morning-tundra-7160.herokuspace.com,0,0.00%,119,119,0.00%
cube.weixinbridge.com,0,0.00%,210,210,0.00%
appbox.qq.com,0,0.00%,179,179,0.00%
inferno.demonoid.pw,0,0.00%,138,138,0.00%
keyvalueservice.icloud.com.cn,0,0.00%,131,131,0.00%
p212-caldav.icloud.com.cn,0,0.00%,124,124,0.00%
office15client.microsoft.com,0,0.00%,104,104,0.00%
vcode-api-fnk.vivo.com.cn,0,0.00%,167,167,0.00%
api.foxitreader.cn,0,0.00%,131,131,0.00%
knicks.jd.com,0,0.00%,132,132,0.00%
uranus.jd.com,0,0.00%,113,113,0.00%
v2.gdt.qq.com,0,0.00%,142,142,0.00%
hk01-vm5.entry.sdjighbiuodrfhgiuo.beauty,0,0.00%,201,201,0.00%
santino.ns.cloudflare.com,0,0.00%,146,146,0.00%
pdns12.domaincontrol.com,0,0.00%,400,400,0.00%
ned.ns.cloudflare.com,0,0.00%,177,177,0.00%
ns1078.ui-dns.de,0,0.00%,133,133,0.00%
ns1085.ui-dns.biz,0,0.00%,163,163,0.00%
ns1.misk.com,0,0.00%,102,102,0.00%
shades07.rzone.de,0,0.00%,203,203,0.00%
ns2.misk.com,0,0.00%,105,105,0.00%
ariella.ns.cloudflare.com,0,0.00%,139,139,0.00%
uqhdkynyqiccr0ff-gzo0ffeun6pvl9od-gebf7khwpyapzzta.prprmoe.xyz,0,0.00%,274,274,0.00%
veda.ns.cloudflare.com,0,0.00%,134,134,0.00%
dara.ns.cloudflare.com,0,0.00%,414,414,0.00%
ns1050.ui-dns.biz,0,0.00%,135,135,0.00%
wgo.mmstat.com,0,0.00%,106,106,0.00%
gspe35-cn-ssl.ls-apple.com.akadns.net,0,0.00%,113,113,0.00%
map.n.shifen.com,0,0.00%,167,167,0.00%
o.andfx.cn,0,0.00%,2351,2351,0.00%
ns-cnc1.qq.com,0,0.00%,164,164,0.00%
lib.iscas.ac.cn,0,0.00%,103,103,0.00%
repo1.maven.org,0,0.00%,104,104,0.00%
static.iqiyi.com,0,0.00%,101,101,0.00%
syncdrive-drcn.cloud.dbankcloud.cn,0,0.00%,122,122,0.00%
sub.rapidcc.cn,0,0.00%,238,238,0.00%
aahk3.yubb12.site,0,0.00%,229,229,0.00%
amdcopen.m.taobao.com,0,0.00%,112,112,0.00%
62.push2his.eastmoney.com,0,0.00%,106,106,0.00%
ns106.ovh.net,0,0.00%,120,120,0.00%
dns106.ovh.net,0,0.00%,120,120,0.00%
white.dnspod.net,0,0.00%,174,174,0.00%
locate.dnspod.net,0,0.00%,172,172,0.00%
ns1022.ui-dns.de,0,0.00%,152,152,0.00%
brady.ns.cloudflare.com,0,0.00%,151,151,0.00%
ns1084.ui-dns.com,0,0.00%,112,112,0.00%
verification-8dfes0h2.ns3.dan.hosting,0,0.00%,290,290,0.00%
ns2.hostns.io,0,0.00%,170,170,0.00%
celine.ns.cloudflare.com,0,0.00%,127,127,0.00%
jewel.ns.cloudflare.com,0,0.00%,200,200,0.00%
shades20.rzone.de,0,0.00%,178,178,0.00%
vicky.ns.cloudflare.com,0,0.00%,315,315,0.00%
ns4229.hostgator.com,0,0.00%,188,188,0.00%
dns4.cloudns.net,0,0.00%,146,146,0.00%
dns3.cloudns.net,0,0.00%,146,146,0.00%
nsany2.infomaniak.com,0,0.00%,430,430,0.00%
ns1112.ui-dns.biz,0,0.00%,167,167,0.00%
nsany1.infomaniak.com,0,0.00%,429,429,0.00%
julian.ns.cloudflare.com,0,0.00%,236,236,0.00%
docks14.rzone.de,0,0.00%,206,206,0.00%
curt.ns.cloudflare.com,0,0.00%,178,178,0.00%
rayne.ns.cloudflare.com,0,0.00%,113,113,0.00%
nancy.ns.cloudflare.com,0,0.00%,138,138,0.00%
ns3qtx.name.com,0,0.00%,194,194,0.00%
dns1.first3guarantee.com,0,0.00%,108,108,0.00%
jakub.ns.cloudflare.com,0,0.00%,261,261,0.00%
dns2.first3guarantee.com,0,0.00%,107,107,0.00%
ns4.gkg.net,0,0.00%,156,156,0.00%
ns3.gkg.net,0,0.00%,154,154,0.00%
fonzie.ns.cloudflare.com,0,0.00%,166,166,0.00%
hasslo.ns.cloudflare.com,0,0.00%,330,330,0.00%
d.ns14.net,0,0.00%,248,248,0.00%
ns1111.ui-dns.biz,0,0.00%,203,203,0.00%
parking2.mdnsservice.com,0,0.00%,305,305,0.00%
parking1.mdnsservice.com,0,0.00%,314,314,0.00%
ns33.guzelhosting.com,0,0.00%,103,103,0.00%
ns32.guzelhosting.com,0,0.00%,103,103,0.00%
cecelia.ns.cloudflare.com,0,0.00%,150,150,0.00%
jarred.ns.cloudflare.com,0,0.00%,184,184,0.00%
randy.ns.cloudflare.com,0,0.00%,139,139,0.00%
ns2.cyon.ch,0,0.00%,198,198,0.00%
portainer-io-assets.sfo2.digitaloceanspaces.com,0,0.00%,138,138,0.00%
ns1121.ui-dns.com,0,0.00%,130,130,0.00%
ns1082.ui-dns.biz,0,0.00%,100,100,0.00%
ns1082.ui-dns.de,0,0.00%,136,136,0.00%
ns1077.ui-dns.de,0,0.00%,128,128,0.00%
ns1051.ui-dns.org,0,0.00%,132,132,0.00%
wss-backup.slack.com,0,0.00%,306,306,0.00%
ebad288.ne.gladns.com,0,0.00%,116,116,0.00%
statwup.huya.com,0,0.00%,114,114,0.00%
pgdt.ugdtimg.com,0,0.00%,132,132,0.00%
connectivitycheck.platform.hihonorcloud.com,0,0.00%,168,168,0.00%
vi.bls.mdt.qq.com,0,0.00%,100,100,0.00%
quillbot.com,0,0.00%,160,160,0.00%
wis.qq.com,0,0.00%,142,142,0.00%
smartgate.oa.tencent.com,0,0.00%,146,146,0.00%
ip-smartgate.oa.tencent.com,0,0.00%,150,150,0.00%
freeconnect.ioa.tencent.com,0,0.00%,101,101,0.00%
api.im.weibo.cn,0,0.00%,102,102,0.00%
www.googleadservices.com,0,0.00%,163,163,0.00%
kernelapi.vivo.com.cn,0,0.00%,146,146,0.00%
ssl.captcha.qq.com,0,0.00%,171,171,0.00%
wren.ns.cloudflare.com,0,0.00%,117,117,0.00%
ns57.domaincontrol.com,0,0.00%,5641,5641,0.00%
ns58.domaincontrol.com,0,0.00%,5401,5401,0.00%
pdns104.ultradns.com,0,0.00%,340,340,0.00%
pdns104.ultradns.net,0,0.00%,340,340,0.00%
pdns104.ultradns.biz,0,0.00%,340,340,0.00%
device.auth.xboxlive.com,0,0.00%,116,116,0.00%
ns1097.ui-dns.org,0,0.00%,101,101,0.00%
ns4.firstfind.nl,0,0.00%,135,135,0.00%
ns1017.ui-dns.biz,0,0.00%,164,164,0.00%
ns3.diymysite.com,0,0.00%,143,143,0.00%
hwvv.yilanvaas.com,0,0.00%,117,117,0.00%
glb.cws.prod.dcat.dsp.trafficmanager.net,0,0.00%,229,229,0.00%
fmt1.link.ac.cn,0,0.00%,125,125,0.00%
people.canonical.com,0,0.00%,321,321,0.00%
down2.abckantu.com,0,0.00%,188,188,0.00%
repository.gtm.eset.com,0,0.00%,166,166,0.00%
apne1-bytedance-cn.sentinelone.net,0,0.00%,103,103,0.00%
ddns-checkip.quickconnect.to,0,0.00%,117,117,0.00%
ns2.netafraz.com,0,0.00%,118,118,0.00%
ns.netafraz.com,0,0.00%,118,118,0.00%
ns2.serveriai.lt,0,0.00%,181,181,0.00%
ns3.serveriai.lt,0,0.00%,181,181,0.00%
ns1.serveriai.lt,0,0.00%,181,181,0.00%
ns4.serveriai.lt,0,0.00%,181,181,0.00%
luciane.ns.cloudflare.com,0,0.00%,136,136,0.00%
ns1075.ui-dns.de,0,0.00%,174,174,0.00%
ns1104.ui-dns.org,0,0.00%,158,158,0.00%
merlin.ns.cloudflare.com,0,0.00%,289,289,0.00%
ns.abdns.info,0,0.00%,116,116,0.00%
paityn.ns.cloudflare.com,0,0.00%,183,183,0.00%
vern.ns.cloudflare.com,0,0.00%,620,620,0.00%
mckinley.ns.cloudflare.com,0,0.00%,126,126,0.00%
ns1055.ui-dns.org,0,0.00%,124,124,0.00%
ns1017.ui-dns.org,0,0.00%,167,167,0.00%
ns1092.ui-dns.de,0,0.00%,163,163,0.00%
ns1069.ui-dns.com,0,0.00%,150,150,0.00%
davina.ns.cloudflare.com,0,0.00%,134,134,0.00%
ximena.ns.cloudflare.com,0,0.00%,164,164,0.00%
ns1088.ui-dns.org,0,0.00%,204,204,0.00%
simon.ns.cloudflare.com,0,0.00%,256,256,0.00%
ns1046.ui-dns.biz,0,0.00%,175,175,0.00%
cullen.ns.cloudflare.com,0,0.00%,102,102,0.00%
adns.cs.siteprotect.com,0,0.00%,212,212,0.00%
ns1067.ui-dns.biz,0,0.00%,137,137,0.00%
ns1038.ui-dns.com,0,0.00%,234,234,0.00%
c.ns14.net,0,0.00%,244,244,0.00%
b.ns14.net,0,0.00%,247,247,0.00%
a.ns14.net,0,0.00%,230,230,0.00%
elisabeth.ns.cloudflare.com,0,0.00%,260,260,0.00%
ns34.guzelhosting.com,0,0.00%,103,103,0.00%
verification-c3ccc9c1.ns3.dan.hosting,0,0.00%,390,390,0.00%
ns1032.ui-dns.biz,0,0.00%,172,172,0.00%
ns1.cyon.ch,0,0.00%,198,198,0.00%
jule.ns.cloudflare.com,0,0.00%,187,187,0.00%
ns31.guzelhosting.com,0,0.00%,101,101,0.00%
ns1058.ui-dns.org,0,0.00%,133,133,0.00%
ns1.dnsbycomodo.net,0,0.00%,196,196,0.00%
ns2.dnsbycomodo.net,0,0.00%,196,196,0.00%
patrick.ns.cloudflare.com,0,0.00%,153,153,0.00%
ns2fgp.name.com,0,0.00%,115,115,0.00%
sky.ns.cloudflare.com,0,0.00%,157,157,0.00%
ns1071.ui-dns.com,0,0.00%,159,159,0.00%
nadia.ns.cloudflare.com,0,0.00%,192,192,0.00%
ns1093.ui-dns.biz,0,0.00%,181,181,0.00%
ns1112.ui-dns.org,0,0.00%,124,124,0.00%
ns104.ovh.net,0,0.00%,108,108,0.00%
dns104.ovh.net,0,0.00%,107,107,0.00%
tr.abir.ga,0,0.00%,167,167,0.00%
gy.brnt.fun,0,0.00%,355,355,0.00%
www.qydaili.com,0,0.00%,551,551,0.00%
upfile1.hicloud.com,0,0.00%,134,134,0.00%
cn-huhehaote.axt.aliyun.com,0,0.00%,394,394,0.00%
sdk.open.phone.igexin.com,0,0.00%,157,157,0.00%
rd.nstrive.com,0,0.00%,190,190,0.00%
www.example.com,0,0.00%,315,315,0.00%
us12.cc,0,0.00%,1109,1109,0.00%
cn-shtele.lfk5s2.ccddns.lol,0,0.00%,138,138,0.00%
d.heinote.com,0,0.00%,108,108,0.00%
ns5.firstfind.net,0,0.00%,139,139,0.00%
ns3.firstfind.nl,0,0.00%,136,136,0.00%
harlee.ns.cloudflare.com,0,0.00%,129,129,0.00%
sub.fnf.one,0,0.00%,227,227,0.00%
kristin.ns.cloudflare.com,0,0.00%,227,227,0.00%
dns4.supremepanel.com,0,0.00%,134,134,0.00%
ns4dfh.name.com,0,0.00%,141,141,0.00%
garrett.ns.cloudflare.com,0,0.00%,141,141,0.00%
event.wps.com,0,0.00%,141,141,0.00%
arangodb.prod.osssc.ac.cn,0,0.00%,248,248,0.00%
us20.cc,0,0.00%,147,147,0.00%
polyester-dead-5f6.notion.site,0,0.00%,175,175,0.00%
torrent-team.net,0,0.00%,130,130,0.00%
doh-sg.blahdns.com,0,0.00%,113,113,0.00%
ns2.123-reg.co.uk,0,0.00%,159,159,0.00%
ns.abdns.biz,0,0.00%,115,115,0.00%
ns.abdns.eu,0,0.00%,114,114,0.00%
jobs.ns.cloudflare.com,0,0.00%,170,170,0.00%
alexia.ns.cloudflare.com,0,0.00%,128,128,0.00%
nash.ns.cloudflare.com,0,0.00%,258,258,0.00%
ns.123-reg.co.uk,0,0.00%,159,159,0.00%
ernest.ns.cloudflare.com,0,0.00%,229,229,0.00%
ns1099.ui-dns.de,0,0.00%,220,220,0.00%
ns1.101domain.com,0,0.00%,271,271,0.00%
ns1033.ui-dns.com,0,0.00%,128,128,0.00%
ns1125.ui-dns.com,0,0.00%,132,132,0.00%
b.dnspod.com,0,0.00%,577,577,0.00%
chan.ns.cloudflare.com,0,0.00%,700,700,0.00%
ns3.dnsv2.com,0,0.00%,183,183,0.00%
ns1102.ui-dns.com,0,0.00%,113,113,0.00%
h5.do889.com,0,0.00%,1330,1330,0.00%
passport.m3guo.com,0,0.00%,140,140,0.00%
dns.hostux.net,0,0.00%,115,115,0.00%
www.360.cn,0,0.00%,101,101,0.00%
hao.360.cn,0,0.00%,103,103,0.00%
repo.openeuler.org,0,0.00%,234,234,0.00%
isecure.vivo.com.cn,0,0.00%,113,113,0.00%
appstoreort-stsdk.vivo.com.cn,0,0.00%,186,186,0.00%
t-haozip.2345.com,0,0.00%,841,841,0.00%
yitihuashujuguanlipingtai.coding.net,0,0.00%,354,354,0.00%
github.githubassets.com,0,0.00%,160,160,0.00%
i.ai.mi.com,0,0.00%,140,140,0.00%
leetcode.cn,0,0.00%,104,104,0.00%
p9-be-pack-sign.pglstatp-toutiao.com,0,0.00%,128,128,0.00%
ns1070.ui-dns.biz,0,0.00%,192,192,0.00%
gigi.ns.cloudflare.com,0,0.00%,159,159,0.00%
dns3.supremepanel.com,0,0.00%,134,134,0.00%
ns1042.ui-dns.com,0,0.00%,164,164,0.00%
ns1077.ui-dns.com,0,0.00%,153,153,0.00%
ns1017.ui-dns.com,0,0.00%,111,111,0.00%
en.mail.qq.com,0,0.00%,101,101,0.00%
benedict.ns.cloudflare.com,0,0.00%,260,260,0.00%
svrsn.phub.sandai.net,0,0.00%,290,290,0.00%
mirror.sjtu.edu.cn,0,0.00%,378,378,0.00%
46a2e5c3c5a64e218b60f2c2ee76b750.pacloudflare.com,0,0.00%,167,167,0.00%
gkaracha.github.io,0,0.00%,122,122,0.00%
qmzgh5s466.gameserver.youxigu.com,0,0.00%,231,231,0.00%
ns20.xincache.com,0,0.00%,162,162,0.00%
ns3bgq.name.com,0,0.00%,146,146,0.00%
ns3gnv.name.com,0,0.00%,127,127,0.00%
c.dnspod.com,0,0.00%,585,585,0.00%
a.dnspod.com,0,0.00%,578,578,0.00%
ns4hmp.name.com,0,0.00%,228,228,0.00%
rosemary.ns.cloudflare.com,0,0.00%,181,181,0.00%
tara.ns.cloudflare.com,0,0.00%,294,294,0.00%
ns1111.ui-dns.de,0,0.00%,172,172,0.00%
ns2.101domain.com,0,0.00%,272,272,0.00%
ns1028.ui-dns.com,0,0.00%,138,138,0.00%
ns1025.ui-dns.org,0,0.00%,142,142,0.00%
ns1073.ui-dns.biz,0,0.00%,137,137,0.00%
ns1019.ui-dns.de,0,0.00%,201,201,0.00%
wapi.kuwo.cn,0,0.00%,228,228,0.00%
api.growingio.com,0,0.00%,199,199,0.00%
tbsone.imtt.qq.com,0,0.00%,165,165,0.00%
ugcup.music.qq.com,0,0.00%,107,107,0.00%
szu6.y.qq.com,0,0.00%,215,215,0.00%
ns1034.ui-dns.de,0,0.00%,168,168,0.00%
kehlani.ns.cloudflare.com,0,0.00%,487,487,0.00%
rub.myddns.cyou,0,0.00%,502,502,0.00%
rua.myddns.cyou,0,0.00%,139,139,0.00%
ns1039.ui-dns.org,0,0.00%,144,144,0.00%
venkat.ns.cloudflare.com,0,0.00%,148,148,0.00%
riya.ns.cloudflare.com,0,0.00%,299,299,0.00%
ns312.inhostedns.org,0,0.00%,107,107,0.00%
ns1110.ui-dns.de,0,0.00%,100,100,0.00%
ns3nrz.name.com,0,0.00%,214,214,0.00%
ns3.eurobyte.ru,0,0.00%,103,103,0.00%
ns2.eurobyte.ru,0,0.00%,102,102,0.00%
ns1.eurobyte.ru,0,0.00%,103,103,0.00%
lakas.ns.cloudflare.com,0,0.00%,391,391,0.00%
ns4.eurobyte.ru,0,0.00%,103,103,0.00%
hub5btmain.v6.shub.sandai.net,0,0.00%,123,123,0.00%
firestore.googleapis.com,0,0.00%,288,288,0.00%
aflzz-hk.meiquankongjian.com,0,0.00%,164,164,0.00%
usstartus2.eucdurl.me,0,0.00%,139,139,0.00%
cnallaz.eucdurl.me,0,0.00%,121,121,0.00%
coraline.ns.cloudflare.com,0,0.00%,147,147,0.00%
ns1061.ui-dns.de,0,0.00%,168,168,0.00%
ns1077.ui-dns.biz,0,0.00%,127,127,0.00%
yevgen.ns.cloudflare.com,0,0.00%,131,131,0.00%
dayana.ns.cloudflare.com,0,0.00%,148,148,0.00%
ns5.101domain.com,0,0.00%,277,277,0.00%
ns2qvz.name.com,0,0.00%,110,110,0.00%
jaxson.ns.cloudflare.com,0,0.00%,262,262,0.00%
ns1018.ui-dns.biz,0,0.00%,104,104,0.00%
2011db66679949cz.greycdn.net,0,0.00%,104,104,0.00%
ns1dns.name.com,0,0.00%,142,142,0.00%
ns1047.ui-dns.org,0,0.00%,117,117,0.00%
ns1043.ui-dns.org,0,0.00%,176,176,0.00%
ns1023.ui-dns.de,0,0.00%,181,181,0.00%
javon.ns.cloudflare.com,0,0.00%,199,199,0.00%
heather.ns.cloudflare.com,0,0.00%,370,370,0.00%
ns1050.ui-dns.de,0,0.00%,141,141,0.00%
ns1095.ui-dns.biz,0,0.00%,129,129,0.00%
s2a.time.edu.cn,0,0.00%,556,556,0.00%
ns1080.ui-dns.de,0,0.00%,134,134,0.00%
armfazh.ns.cloudflare.com,0,0.00%,108,108,0.00%
ns1023.ui-dns.com,0,0.00%,142,142,0.00%
ns1047.ui-dns.com,0,0.00%,151,151,0.00%
quinton.ns.cloudflare.com,0,0.00%,133,133,0.00%
yadiel.ns.cloudflare.com,0,0.00%,114,114,0.00%
ns112.inhostedns.com,0,0.00%,107,107,0.00%
ns212.inhostedns.net,0,0.00%,107,107,0.00%
ns1101.ui-dns.com,0,0.00%,109,109,0.00%
7.rlb.router.teamviewer.cn,0,0.00%,213,213,0.00%
marketplace.opennebula.systems,0,0.00%,155,155,0.00%
cc.push.dc.360.cn,0,0.00%,239,239,0.00%
photo.cctv.com,0,0.00%,436,436,0.00%
www.scottyang8math.cn,0,0.00%,100,100,0.00%
mediator.goodsync.com,0,0.00%,160,160,0.00%
bzt.baidu.com,0,0.00%,363,363,0.00%
ibzt.baidu.com,0,0.00%,181,181,0.00%
proxy.vulgraph.net,0,0.00%,132,132,0.00%
ns3hjx.name.com,0,0.00%,212,212,0.00%
mark.ns.cloudflare.com,0,0.00%,205,205,0.00%
ryleigh.ns.cloudflare.com,0,0.00%,114,114,0.00%
ns2-06.azure-dns.net,0,0.00%,106,106,0.00%
v0n0.nic.live,0,0.00%,512,512,0.00%
ns1095.ui-dns.de,0,0.00%,146,146,0.00%
ns1091.ui-dns.biz,0,0.00%,151,151,0.00%
ns1091.ui-dns.org,0,0.00%,123,123,0.00%
dns4.regway.com,0,0.00%,187,187,0.00%
ns1107.ui-dns.de,0,0.00%,159,159,0.00%
ns1054.ui-dns.org,0,0.00%,143,143,0.00%
monika.ns.cloudflare.com,0,0.00%,134,134,0.00%
ns1089.ui-dns.de,0,0.00%,103,103,0.00%
ns1096.ui-dns.com,0,0.00%,116,116,0.00%
www.scio.gov.cn,0,0.00%,126,126,0.00%
h5-api.appstore.vivo.com.cn,0,0.00%,7947,7947,0.00%
wf.vivo.com.cn,0,0.00%,109,109,0.00%
ns1065.ui-dns.org,0,0.00%,116,116,0.00%
ns1092.ui-dns.biz,0,0.00%,149,149,0.00%
br.666.mapow.link,0,0.00%,174,174,0.00%
pic.people.com.cn,0,0.00%,816,816,0.00%
www.chinanews.com.cn,0,0.00%,381,381,0.00%
alt2-mtalk.google.com,0,0.00%,120,120,0.00%
api.mse.360.cn,0,0.00%,124,124,0.00%
c20s1.jamjams3.net,0,0.00%,639,639,0.00%
discovery-v4-3.verysync.cn,0,0.00%,118,118,0.00%
discovery-v4-2.verysync.cn,0,0.00%,102,102,0.00%
discovery-v4.verysync.cn,0,0.00%,104,104,0.00%
channel2rss.bitmachine.org,0,0.00%,112,112,0.00%
ksc01.baidu.com,0,0.00%,354,354,0.00%
master15.teamviewer.com,0,0.00%,114,114,0.00%
ping.sogou.com,0,0.00%,102,102,0.00%
ns1061.ui-dns.com,0,0.00%,205,205,0.00%
ns1039.ui-dns.com,0,0.00%,126,126,0.00%
08a5cee86y.greycdn.net,0,0.00%,104,104,0.00%
dns3.regway.com,0,0.00%,187,187,0.00%
ns.uniregistry.net,0,0.00%,1064,1064,0.00%
ns2.domainactive.org,0,0.00%,623,623,0.00%
ns1056.ui-dns.biz,0,0.00%,152,152,0.00%
v0n0.nic.life,0,0.00%,206,206,0.00%
ns1.domainactive.org,0,0.00%,713,713,0.00%
n-cwm-device.tplinkcloud.com.cn,0,0.00%,290,290,0.00%
xdcs-collector.ximalaya.com,0,0.00%,126,126,0.00%
qmzgh5s6158.gameserver.youxigu.com,0,0.00%,198,198,0.00%
qmzgh5s3083.gameserver.youxigu.com,0,0.00%,114,114,0.00%
bszs.conac.cn,0,0.00%,105,105,0.00%
c.gj.qq.com,0,0.00%,107,107,0.00%
hao4.qhimg.com,0,0.00%,118,118,0.00%
r.inews.qq.com,0,0.00%,136,136,0.00%
ns02.cloudhost.id,0,0.00%,161,161,0.00%
ns01.cloudhost.id,0,0.00%,161,161,0.00%
dns1.regway.com,0,0.00%,189,189,0.00%
dns2.regway.com,0,0.00%,187,187,0.00%
seth.ns.cloudflare.com,0,0.00%,730,730,0.00%
ns1054.ui-dns.biz,0,0.00%,116,116,0.00%
gemma.ns.cloudflare.com,0,0.00%,121,121,0.00%
paloma.ns.cloudflare.com,0,0.00%,198,198,0.00%
ns.peoplebrowsr.com,0,0.00%,104,104,0.00%
a0.info.afilias-nst.info,0,0.00%,2206,2206,0.00%
ns4bfy.name.com,0,0.00%,121,121,0.00%
giancarlo.ns.cloudflare.com,0,0.00%,152,152,0.00%
lauryn.ns.cloudflare.com,0,0.00%,133,133,0.00%
opendata.baidu.com,0,0.00%,137,137,0.00%
crab.baidu.com,0,0.00%,107,107,0.00%
service.account.weibo.com,0,0.00%,917,917,0.00%
eduall.buzzline.org,0,0.00%,219,219,0.00%
pietro-pezzani.divisare.pro,0,0.00%,122,122,0.00%
master3.teamviewer.com,0,0.00%,107,107,0.00%
push.ksapisrv.com,0,0.00%,231,231,0.00%
ulogjs.ksapisrv.com,0,0.00%,203,203,0.00%
apijs.gifshow.com,0,0.00%,107,107,0.00%
livejs.ksapisrv.com,0,0.00%,114,114,0.00%
apijs.ksapisrv.com,0,0.00%,146,146,0.00%
api.kwaizt.com,0,0.00%,174,174,0.00%
ns1.nameserver.net.au,0,0.00%,201,201,0.00%
ns3.nameserver.net.au,0,0.00%,195,195,0.00%
ns2.nameserver.net.au,0,0.00%,190,190,0.00%
ns1098.ui-dns.de,0,0.00%,107,107,0.00%
mallory.ns.cloudflare.com,0,0.00%,144,144,0.00%
ns1041.ui-dns.org,0,0.00%,137,137,0.00%
ns1086.ui-dns.biz,0,0.00%,149,149,0.00%
ns1114.ui-dns.de,0,0.00%,122,122,0.00%
ns1118.ui-dns.biz,0,0.00%,150,150,0.00%
sdupm.qihucdn.com,0,0.00%,287,287,0.00%
r2---sn-2x3elnee.gvt1.com,0,0.00%,108,108,0.00%
smtp.163.com,0,0.00%,184,184,0.00%
ns3.nina.vn,0,0.00%,230,230,0.00%
master7.teamviewer.com,0,0.00%,104,104,0.00%
ns2dqr.name.com,0,0.00%,121,121,0.00%
info711825.mercury.orderbox-dns.com,0,0.00%,186,186,0.00%
info711825.venus.orderbox-dns.com,0,0.00%,189,189,0.00%
info711825.mars.orderbox-dns.com,0,0.00%,186,186,0.00%
info711825.earth.orderbox-dns.com,0,0.00%,186,186,0.00%
kipp.ns.cloudflare.com,0,0.00%,304,304,0.00%
ns1123.ui-dns.org,0,0.00%,101,101,0.00%
ns1094.ui-dns.biz,0,0.00%,116,116,0.00%
ns1032.ui-dns.com,0,0.00%,108,108,0.00%
ns1037.ui-dns.biz,0,0.00%,131,131,0.00%
jpl.tcpbbr.xyz,0,0.00%,279,279,0.00%
ip.360.cn,0,0.00%,130,130,0.00%
weixin.sogou.com,0,0.00%,211,211,0.00%
c5a999ca-rh7400-rkgz58-1kux.pccw.alrihla.net,0,0.00%,530,530,0.00%
p204-imap.mail.icloud.com.cn,0,0.00%,257,257,0.00%
ulogjs.gifshow.com,0,0.00%,103,103,0.00%
at.idqqimg.com,0,0.00%,107,107,0.00%
mack.ns.cloudflare.com,0,0.00%,156,156,0.00%
tracker3.dler.org,0,0.00%,111,111,0.00%
ursula.ns.cloudflare.com,0,0.00%,164,164,0.00%
ns1122.ui-dns.com,0,0.00%,170,170,0.00%
ns1074.ui-dns.biz,0,0.00%,122,122,0.00%
ns1023.ui-dns.org,0,0.00%,188,188,0.00%
usbbaohe.update.updrv.com,0,0.00%,116,116,0.00%
btrace.play.aiseet.atianqi.com,0,0.00%,144,144,0.00%
server-m.pp.cn,0,0.00%,980,980,0.00%
qmzgh5s5665.gameserver.youxigu.com,0,0.00%,144,144,0.00%
umhn5r.zhs.company,0,0.00%,101,101,0.00%
v0n0.nic.world,0,0.00%,163,163,0.00%
stanley.ns.cloudflare.com,0,0.00%,127,127,0.00%
ns1114.ui-dns.org,0,0.00%,167,167,0.00%
ns-tld1.charlestonroadregistry.com,0,0.00%,309,309,0.00%
v0n0.nic.digital,0,0.00%,100,100,0.00%
sydney.ns.cloudflare.com,0,0.00%,109,109,0.00%
172-104-107-135.ip.linodeusercontent.com,0,0.00%,100,100,0.00%
ipv4.connman.net,0,0.00%,1394,1394,0.00%
imap.mail-aipo.apple-dns.cn,0,0.00%,141,141,0.00%
verification-ueu6xf4j.ns3.dan.hosting,0,0.00%,744,744,0.00%
ns2.md-83.webhostbox.net,0,0.00%,124,124,0.00%
ifconfig.co,0,0.00%,384,384,0.00%
verification-8d1d365f.ns3.dan.hosting,0,0.00%,104,104,0.00%
shane.ns.cloudflare.com,0,0.00%,118,118,0.00%
ns4.alldomains.hosting,0,0.00%,106,106,0.00%
00000000000000000000000000000000000000000000000000000000000031a.rui77.com,0,0.00%,133,133,0.00%
osmar.ns.cloudflare.com,0,0.00%,120,120,0.00%
ns1064.ui-dns.com,0,0.00%,138,138,0.00%
ns1016.ui-dns.biz,0,0.00%,172,172,0.00%
ns3.alldomains.hosting,0,0.00%,106,106,0.00%
ns1.alldomains.hosting,0,0.00%,109,109,0.00%
ns2.alldomains.hosting,0,0.00%,108,108,0.00%
8a78cx75.gus0.buzz,0,0.00%,109,109,0.00%
ns1120.ui-dns.biz,0,0.00%,132,132,0.00%
api.jy.zuishidai.com,0,0.00%,189,189,0.00%
hk3v.acrossgw.info,0,0.00%,573,573,0.00%
tw1v.acrossgw.info,0,0.00%,669,669,0.00%
alb001-pushcl.np.communication.playstation.net,0,0.00%,116,116,0.00%
ns1.md-83.webhostbox.net,0,0.00%,124,124,0.00%
stephane.ns.cloudflare.com,0,0.00%,154,154,0.00%
ns1028.ui-dns.de,0,0.00%,104,104,0.00%
v.j.v4.2.kiki789.com,0,0.00%,112,112,0.00%
hexin.glt.myhexin.com,0,0.00%,102,102,0.00%
ns1102.ui-dns.org,0,0.00%,114,114,0.00%
e44ee7b.pb.gladns.com,0,0.00%,158,158,0.00%
v4.tiamato.com,0,0.00%,301,301,0.00%
ssr7.free4444.xyz,0,0.00%,334,334,0.00%
push.browser.qq.com,0,0.00%,198,198,0.00%
m.jingxi.com,0,0.00%,282,282,0.00%
ns2knz.name.com,0,0.00%,109,109,0.00%
business.bing.com,0,0.00%,127,127,0.00%
a2f3e71d9181a67b.jijifun.com,0,0.00%,1185,1185,0.00%
ins-81eqktfa.ias.tencent-cloud.net,0,0.00%,100,100,0.00%
ns1107.ui-dns.com,0,0.00%,115,115,0.00%
ns2.md-la-1.hostgatorwebservers.com,0,0.00%,282,282,0.00%
ns1.md-la-1.hostgatorwebservers.com,0,0.00%,282,282,0.00%
ns1119.ui-dns.org,0,0.00%,124,124,0.00%
johnny.ns.cloudflare.com,0,0.00%,124,124,0.00%
ns3.monikerdns.net,0,0.00%,305,305,0.00%
ns2.monikerdns.net,0,0.00%,301,301,0.00%
ns5.ezdnscenter.com,0,0.00%,153,153,0.00%
ns2.ezdnscenter.com,0,0.00%,162,162,0.00%
ns1.ezdnscenter.com,0,0.00%,164,164,0.00%
ns4.ezdnscenter.com,0,0.00%,153,153,0.00%
ns6.ezdnscenter.com,0,0.00%,163,163,0.00%
ns3.ezdnscenter.com,0,0.00%,151,151,0.00%
uploads1.ksapisrv.com,0,0.00%,112,112,0.00%
megacrit-metrics.herokuapp.com,0,0.00%,122,122,0.00%
imap.sina.cn,0,0.00%,129,129,0.00%
ns1076.ui-dns.org,0,0.00%,145,145,0.00%
fafae8e6.fyhzks.com,0,0.00%,100,100,0.00%
ele.me,0,0.00%,239,239,0.00%
ns1125.ui-dns.de,0,0.00%,142,142,0.00%
ns9.szhot.com,0,0.00%,1171,1171,0.00%
dns200.b.register.com,0,0.00%,140,140,0.00%
dns059.b.register.com,0,0.00%,100,100,0.00%
ns1037.ui-dns.de,0,0.00%,129,129,0.00%
hostedby.privatelayer.com,0,0.00%,110,110,0.00%
ns1050.ui-dns.org,0,0.00%,138,138,0.00%
ns2.vigbo.site,0,0.00%,102,102,0.00%
ns1.vigbo.site,0,0.00%,103,103,0.00%
ns4.markmonitor.com,0,0.00%,226,226,0.00%
ns6.markmonitor.com,0,0.00%,218,218,0.00%
ns3.markmonitor.com,0,0.00%,221,221,0.00%
ns2.markmonitor.com,0,0.00%,227,227,0.00%
ns7.markmonitor.com,0,0.00%,221,221,0.00%
ns1.markmonitor.com,0,0.00%,218,218,0.00%
ns5.markmonitor.com,0,0.00%,218,218,0.00%
ns1119.ui-dns.biz,0,0.00%,172,172,0.00%
master10.teamviewer.com,0,0.00%,112,112,0.00%
c26s3.jamjams3.net,0,0.00%,131,131,0.00%
api.rollbar.com,0,0.00%,218,218,0.00%
www.zhuanzhi.ai,0,0.00%,143,143,0.00%
qt.gtimg.cn,0,0.00%,595,595,0.00%
bp.335.wdpdk.link,0,0.00%,626,626,0.00%
509b904.pd.gladns.com,0,0.00%,255,255,0.00%
509b904.wy.glados-config.net,0,0.00%,101,101,0.00%
509b904.pf.gladns.com,0,0.00%,188,188,0.00%
509b904.pb.gladns.com,0,0.00%,197,197,0.00%
509b904.ph.gladns.com,0,0.00%,192,192,0.00%
509b904.pe.gladns.com,0,0.00%,195,195,0.00%
509b904.pg.gladns.com,0,0.00%,213,213,0.00%
509b904.pa.gladns.com,0,0.00%,205,205,0.00%
frp.zwlin.store,0,0.00%,946,946,0.00%
ss.hk5.se.sx.cn,0,0.00%,1492,1492,0.00%
ns1.coindomainnames.com,0,0.00%,219,219,0.00%
pop3.mxhichina.com,0,0.00%,102,102,0.00%
509b904.pc.gladns.com,0,0.00%,247,247,0.00%
ny-1.openssl3.com,0,0.00%,342,342,0.00%
wis.ruijie.com.cn,0,0.00%,206,206,0.00%
dns202.b.register.com,0,0.00%,159,159,0.00%
ns1.dns.nic.club,0,0.00%,338,338,0.00%
www.tplink.com,0,0.00%,4228,4228,0.00%
ns1.dnszw.com,0,0.00%,131,131,0.00%
ns2.3dweb.co.uk,0,0.00%,131,131,0.00%
ns1.3dweb.co.uk,0,0.00%,150,150,0.00%
ns3.majordomo.ru,0,0.00%,120,120,0.00%
ns2.majordomo.ru,0,0.00%,120,120,0.00%
ns.majordomo.ru,0,0.00%,114,114,0.00%
ns4.majordomo.ru,0,0.00%,107,107,0.00%
ns2.md-86.webhostbox.net,0,0.00%,179,179,0.00%
ns1.md-86.webhostbox.net,0,0.00%,180,180,0.00%
a.nic.cloud,0,0.00%,278,278,0.00%
ns33.link-host.net,0,0.00%,186,186,0.00%
ns34.link-host.net,0,0.00%,185,185,0.00%
tw01.ipv2.xyz,0,0.00%,142,142,0.00%
dns1.nic.uk,0,0.00%,3041,3041,0.00%
ns4.gbnames.uk,0,0.00%,153,153,0.00%
ns1.gbnames.uk,0,0.00%,177,177,0.00%
ns2.gbnames.uk,0,0.00%,177,177,0.00%
ns3.gbnames.uk,0,0.00%,175,175,0.00%
tuna02.mcddns01.com,0,0.00%,248,248,0.00%
wzhmg.shxusong.com,0,0.00%,127,127,0.00%
36d3af239dc2ead8aaa059a747d643c0c1645cee.u.fdmpkg.org,0,0.00%,209,209,0.00%
ns1.md-74.webhostbox.net,0,0.00%,110,110,0.00%
ns2.md-74.webhostbox.net,0,0.00%,110,110,0.00%
api3.ksapisrv.com,0,0.00%,131,131,0.00%
api-mifit-cn2.huami.com,0,0.00%,107,107,0.00%
ns1.dns.nic.buzz,0,0.00%,1779,1779,0.00%
ss.hk1.se.sx.cn,0,0.00%,103,103,0.00%
models.gazebosim.org,0,0.00%,135,135,0.00%
tw02.ipv2.xyz,0,0.00%,204,204,0.00%
activation-v2.sls.microsoft.com,0,0.00%,119,119,0.00%
mail.digidown.de,0,0.00%,122,122,0.00%
ns2.sigmadns.net,0,0.00%,131,131,0.00%
ns1.sigmadns.net,0,0.00%,132,132,0.00%
site.jwhusb.com,0,0.00%,148,148,0.00%
lochlan.ns.cloudflare.com,0,0.00%,151,151,0.00%
ns1.miyuedns.com,0,0.00%,154,154,0.00%
ns4.miyuedns.com,0,0.00%,148,148,0.00%
ns3.miyuedns.com,0,0.00%,149,149,0.00%
ns2.miyuedns.com,0,0.00%,149,149,0.00%
1c1c50be-rh6hs0-0-1jbu0.us.pyboard.vip,0,0.00%,106,106,0.00%
m.iliveok.com,0,0.00%,122,122,0.00%
verification-d5901584.ns3.dan.hosting,0,0.00%,324,324,0.00%
ns2.niuniu-dns.com,0,0.00%,246,246,0.00%
ns3.pixtel.net,0,0.00%,292,292,0.00%
ns1.pixtel.net,0,0.00%,288,288,0.00%
ns1.niuniu-dns.com,0,0.00%,246,246,0.00%
verification-d0af4f34.ns3.dan.hosting,0,0.00%,156,156,0.00%
cstestarea.leagsoft.net,0,0.00%,755,755,0.00%
edas-beta.console.aliyun.com,0,0.00%,116,116,0.00%
www.soupm25.com,0,0.00%,105,105,0.00%
urlite.ff.avast.com,0,0.00%,550,550,0.00%
ns2.domainservices.co.uk,0,0.00%,268,268,0.00%
verification-dc987700.ns3.dan.hosting,0,0.00%,143,143,0.00%
v0n0.nic.today,0,0.00%,204,204,0.00%
cont603385.venus.orderbox-dns.com,0,0.00%,217,217,0.00%
ns1.domainservices.co.uk,0,0.00%,268,268,0.00%
cont603385.earth.orderbox-dns.com,0,0.00%,217,217,0.00%
ns225.sellvir.com,0,0.00%,146,146,0.00%
ukibm.ptuu.ga,0,0.00%,105,105,0.00%
v0n0.nic.studio,0,0.00%,109,109,0.00%
cont603385.mercury.orderbox-dns.com,0,0.00%,217,217,0.00%
ns227.sellvir.com,0,0.00%,140,140,0.00%
ns229.sellvir.com,0,0.00%,124,124,0.00%
cont603385.mars.orderbox-dns.com,0,0.00%,217,217,0.00%
a0.pro.afilias-nst.info,0,0.00%,280,280,0.00%
a0.org.afilias-nst.info,0,0.00%,4725,4725,0.00%
ns226.sellvir.com,0,0.00%,144,144,0.00%
ns234.sellvir.com,0,0.00%,103,103,0.00%
ns219.sellvir.com,0,0.00%,106,106,0.00%
ns218.sellvir.com,0,0.00%,117,117,0.00%
ns217.sellvir.com,0,0.00%,120,120,0.00%
ns232.sellvir.com,0,0.00%,125,125,0.00%
ns228.sellvir.com,0,0.00%,140,140,0.00%
ns231.sellvir.com,0,0.00%,125,125,0.00%
ns224.sellvir.com,0,0.00%,142,142,0.00%
ns223.sellvir.com,0,0.00%,141,141,0.00%
ns230.sellvir.com,0,0.00%,124,124,0.00%
ns3.thehostingsolutions.com,0,0.00%,114,114,0.00%
ns233.sellvir.com,0,0.00%,103,103,0.00%
ns220.sellvir.com,0,0.00%,105,105,0.00%
ns1.thehostingsolutions.com,0,0.00%,114,114,0.00%
ns4.thehostingsolutions.com,0,0.00%,114,114,0.00%
ns2.thehostingsolutions.com,0,0.00%,114,114,0.00%
v1.skddefi99.cf,0,0.00%,122,122,0.00%
registry.centos.org,0,0.00%,143,143,0.00%
52f36691-rh6hs0-rilj3b-iz5k.pccw.alrihla.net,0,0.00%,152,152,0.00%
asygqhup.n.aliyunddososs.com,0,0.00%,118,118,0.00%
zjusx3mw-u.cacheshore.com,0,0.00%,118,118,0.00%
ws.666liushen.tk,0,0.00%,123,123,0.00%
verification-a2144a0a.ns3.dan.hosting,0,0.00%,250,250,0.00%
tstng.net,0,0.00%,366,366,0.00%
mail.forcemail.de,0,0.00%,122,122,0.00%
app.anjian.com,0,0.00%,117,117,0.00%
text-1251668224.file.myqcloud.com,0,0.00%,141,141,0.00%
ns1.domain-for-sale.se,0,0.00%,180,180,0.00%
ns2.domain-for-sale.se,0,0.00%,180,180,0.00%
gsp3.baidu.com,0,0.00%,310,310,0.00%
ns1.vps.net,0,0.00%,158,158,0.00%
ns2.vps.net,0,0.00%,158,158,0.00%
downloads.skewed.de,0,0.00%,122,122,0.00%
jobs.plenigo.com,0,0.00%,122,122,0.00%
exchange.mercadomedianetwork.do,0,0.00%,122,122,0.00%
z01.zoon.ru,0,0.00%,138,138,0.00%
z03.zoon.ru,0,0.00%,138,138,0.00%
ns2.bee.co.uk,0,0.00%,210,210,0.00%
ns1.bee.co.uk,0,0.00%,210,210,0.00%
shuaitq.github.io,0,0.00%,122,122,0.00%
mail.massimomendola.tk,0,0.00%,122,122,0.00%
us9929.azus.ml,0,0.00%,122,122,0.00%
openway.guance.com,0,0.00%,152,152,0.00%
home.dedejoker.tk,0,0.00%,122,122,0.00%
goya.com.au,0,0.00%,122,122,0.00%
api.14pikpak.cf,0,0.00%,122,122,0.00%
fisher-trails-21.myzeki.com,0,0.00%,122,122,0.00%
04.sendcdn.com,0,0.00%,122,122,0.00%
ccsw.ac.uk,0,0.00%,122,122,0.00%
rr5---sn-aigl6ns6.googlevideo.com,0,0.00%,1916,1916,0.00%
app.d3mnetworks.com,0,0.00%,122,122,0.00%
webmail.flytowardsthehiddensecret.tk,0,0.00%,122,122,0.00%
mail.travtextgentcesscongju.ml,0,0.00%,122,122,0.00%
repo1.coderoot.ml,0,0.00%,122,122,0.00%
oracle-001.kaka123.ml,0,0.00%,122,122,0.00%
