domain,num_a_fail,rate_all,num_a_all,num_a_success,rate_a_fail
rq.r9t1.com,451,15.73%,846,395,53.31%
asia.pool.ntp.org,197,6.87%,390,193,50.51%
cn.pool.ntp.org,191,6.66%,395,204,48.35%
optimizationguide-pa.googleapis.com,184,6.42%,346,162,53.18%
clientservices.googleapis.com,60,2.09%,101,41,59.41%
safebrowsing.googleapis.com,51,1.78%,106,55,48.11%
0.ubuntu.pool.ntp.org,45,1.57%,48,3,93.75%
storage.googleapis.com,36,1.26%,72,36,50.00%
mirrors.aliyun.com,34,1.19%,35,1,97.14%
1hkclu.pronetworklink.net,33,1.15%,72,39,45.83%
clients1.google.com,32,1.12%,73,41,43.84%
d27xxe7juh1us6.cloudfront.net,25,0.87%,53,28,47.17%
registry-1.docker.io,23,0.80%,29,6,79.31%
2.ubuntu.pool.ntp.org,23,0.80%,23,0,100.00%
femetrics.grammarly.io,22,0.77%,47,25,46.81%
android.clients.google.com,22,0.77%,48,26,45.83%
browser.360.cn,21,0.73%,44,23,47.73%
1.ubuntu.pool.ntp.org,21,0.73%,24,3,87.50%
us2.ethermine.org,20,0.70%,20,0,100.00%
asia1.ethermine.org,20,0.70%,20,0,100.00%
data.bilibili.com,19,0.66%,43,24,44.19%
3.ubuntu.pool.ntp.org,18,0.63%,19,1,94.74%
eth.2miners.com,18,0.63%,18,0,100.00%
us1.ethermine.org,18,0.63%,18,0,100.00%
hub5pn.v6.sandai.net,17,0.59%,17,0,100.00%
eu1.ethermine.org,16,0.56%,16,0,100.00%
zyx.qq.com,15,0.52%,42,27,35.71%
gecko-bd.feishu.cn,14,0.49%,31,17,45.16%
update.googleapis.com,13,0.45%,35,22,37.14%
newtab.firefoxchina.cn,12,0.42%,15,3,80.00%
ipv6.msftconnecttest.com,11,0.38%,19,8,57.89%
api2.firefoxchina.cn,11,0.38%,13,2,84.62%
s.safe.360.cn,10,0.35%,23,13,43.48%
content-autofill.googleapis.com,10,0.35%,24,14,41.67%
mimg.127.net,10,0.35%,10,0,100.00%
api.m.jd.com,10,0.35%,20,10,50.00%
ntp.sjtu.edu.cn,10,0.35%,10,0,100.00%
slardar-bd.feishu.cn,9,0.31%,18,9,50.00%
clients4.google.com,8,0.28%,27,19,29.63%
www.taobao.com,8,0.28%,17,9,47.06%
www.google.com.hk,8,0.28%,18,10,44.44%
1.centos.pool.ntp.org,8,0.28%,8,0,100.00%
2.centos.pool.ntp.org,8,0.28%,8,0,100.00%
vconf.f.360.cn,8,0.28%,15,7,53.33%
mask-api.icloud.com,8,0.28%,9,1,88.89%
dss0.bdstatic.com,7,0.24%,16,9,43.75%
www.apple.com,7,0.24%,14,7,50.00%
www.cntv.cn,7,0.24%,16,9,43.75%
ts2.cn.mm.bing.net,7,0.24%,16,9,43.75%
wxapp.tc.qq.com,7,0.24%,15,8,46.67%
h.trace.qq.com,7,0.24%,16,9,43.75%
mainnet.infura.io,7,0.24%,17,10,41.18%
mcs-bd.feishu.cn,7,0.24%,12,5,58.33%
pool.ntp.org,6,0.21%,9,3,66.67%
ts1.cn.mm.bing.net,6,0.21%,17,11,35.29%
gateway.fe.apple-dns.net,6,0.21%,19,13,31.58%
cache.tv.qq.com,6,0.21%,13,7,46.15%
agt.p.qianxin.com,6,0.21%,6,0,100.00%
3.centos.pool.ntp.org,6,0.21%,6,0,100.00%
repo.huaweicloud.com,6,0.21%,12,6,50.00%
liveupdate2.drivergenius.com,6,0.21%,12,6,50.00%
bifrost-v4.getpostman.com,6,0.21%,12,6,50.00%
pss.bdstatic.com,5,0.17%,13,8,38.46%
emoji.qpic.cn,5,0.17%,11,6,45.45%
treatment.grammarly.com,5,0.17%,9,4,55.56%
dtl.update.updrv.com,5,0.17%,12,7,41.67%
broadcast.chat.bilibili.com,5,0.17%,10,5,50.00%
down3.huorong.cn,5,0.17%,10,5,50.00%
upos-sz-mirrorcos.bilivideo.com,5,0.17%,9,4,55.56%
dtapp-pub.dingtalk.com,5,0.17%,10,5,50.00%
translate.google.cn,5,0.17%,9,4,55.56%
ss1.baidu.com,5,0.17%,12,7,41.67%
update.todesk.com,5,0.17%,12,7,41.67%
content-signature-2.cdn.mozilla.net,5,0.17%,10,5,50.00%
ipv6.l.google.com,5,0.17%,5,0,100.00%
www.bytedance.com,5,0.17%,10,5,50.00%
dcldshlupt.alicdn.com,5,0.17%,10,5,50.00%
0.openwrt.pool.ntp.org,5,0.17%,5,0,100.00%
webrd01.is.autonavi.com,5,0.17%,10,5,50.00%
webrd04.is.autonavi.com,5,0.17%,10,5,50.00%
webrd02.is.autonavi.com,5,0.17%,10,5,50.00%
events.launchdarkly.com,5,0.17%,10,5,50.00%
cv.duba.net,4,0.14%,9,5,44.44%
2.android.pool.ntp.org,4,0.14%,10,6,40.00%
registry.npm.taobao.org,4,0.14%,4,0,100.00%
gateway.icloud.com,4,0.14%,8,4,50.00%
mesu.apple.com,4,0.14%,12,8,33.33%
qurl.f.360.cn,4,0.14%,9,5,44.44%
honeycomb.wpscdn.cn,4,0.14%,9,5,44.44%
ini.update.360safe.com,4,0.14%,8,4,50.00%
cdn-file.ludashi.com,4,0.14%,8,4,50.00%
smartdl.lenovo.com.cn,4,0.14%,8,4,50.00%
ocsp.sca1b.amazontrust.com,4,0.14%,8,4,50.00%
internal-api-lark-api.feishu.cn,4,0.14%,9,5,44.44%
api.docer.wpscdn.cn,4,0.14%,8,4,50.00%
software-down.keniu.com,4,0.14%,9,5,44.44%
config.i.duba.net,4,0.14%,6,2,66.67%
webrd03.is.autonavi.com,4,0.14%,8,4,50.00%
registry.npmmirror.com,3,0.10%,3,0,100.00%
s1.hdslb.com,3,0.10%,6,3,50.00%
i2.hdslb.com,3,0.10%,7,4,42.86%
dss1.bdstatic.com,3,0.10%,11,8,27.27%
b.bdstatic.com,3,0.10%,9,6,33.33%
www.zhihu.com,3,0.10%,7,4,42.86%
cdn.jsdelivr.net,3,0.10%,6,3,50.00%
static.hdslb.com,3,0.10%,6,3,50.00%
go.microsoft.com,3,0.10%,8,5,37.50%
kv501.prod.do.dsp.mp.microsoft.com,3,0.10%,6,3,50.00%
dataflow.biliapi.com,3,0.10%,7,4,42.86%
service.fanxing.kugou.com,3,0.10%,7,4,42.86%
bjacshow.kugou.com,3,0.10%,7,4,42.86%
pagead2.googlesyndication.com,3,0.10%,6,3,50.00%
r4.res.office365.com,3,0.10%,7,4,42.86%
notifier-configs.airbrake.io,3,0.10%,6,3,50.00%
fc-ccimage.baidu.com,3,0.10%,9,6,33.33%
t8.baidu.com,3,0.10%,10,7,30.00%
dss2.bdstatic.com,3,0.10%,7,4,42.86%
imap.gmail.com,3,0.10%,7,4,42.86%
img.alicdn.com,3,0.10%,7,4,42.86%
play.google.com,3,0.10%,7,4,42.86%
0.centos.pool.ntp.org,3,0.10%,3,0,100.00%
d2nxq2uap88usk.cloudfront.net,3,0.10%,5,2,60.00%
accounts.google.com,3,0.10%,6,3,50.00%
i.glzip.com,3,0.10%,3,0,100.00%
redirector.gvt1.com,3,0.10%,6,3,50.00%
beacons.gcp.gvt2.com,3,0.10%,6,3,50.00%
ioshost.qtlcdn.com,3,0.10%,6,3,50.00%
gw.alipayobjects.com,3,0.10%,5,2,60.00%
t7.baidu.com,3,0.10%,6,3,50.00%
profile-avatar.csdnimg.cn,3,0.10%,5,2,60.00%
tnc3-bjlgy.zijieapi.com,3,0.10%,6,3,50.00%
filedownload.lenovo.com,3,0.10%,5,2,60.00%
download.windowsupdate.com,3,0.10%,6,3,50.00%
gateway.icloud.com.cn,3,0.10%,4,1,75.00%
upos-sz-staticcos-cmask.bilivideo.com,3,0.10%,6,3,50.00%
SIN-efz.ms-acdc.office.com,3,0.10%,6,3,50.00%
kv601.prod.do.dsp.mp.microsoft.com,3,0.10%,6,3,50.00%
14.tlu.dl.delivery.mp.microsoft.com,3,0.10%,6,3,50.00%
img-xlppc-zhan.xunlei.com,3,0.10%,10,7,30.00%
docs.google.com,3,0.10%,10,7,30.00%
docs2.gtimg.com,3,0.10%,6,3,50.00%
firebaselogging-pa.googleapis.com,3,0.10%,6,3,50.00%
assets.yiban.io,3,0.10%,6,3,50.00%
hicloud.hiwifi.com,3,0.10%,6,3,50.00%
0.pool.ntp.org,3,0.10%,6,3,50.00%
cdn.cvws.apple-dns.net,3,0.10%,4,1,75.00%
steampipe.akamaized.net,3,0.10%,6,3,50.00%
at.alicdn.com,2,0.07%,4,2,50.00%
pic3.zhimg.com,2,0.07%,4,2,50.00%
pic2.zhimg.com,2,0.07%,4,2,50.00%
googleads.g.doubleclick.net,2,0.07%,6,4,33.33%
hotfix.lenovo.com.cn,2,0.07%,4,2,50.00%
mathpix.com,2,0.07%,4,2,50.00%
api.mathpix.com,2,0.07%,4,2,50.00%
iduy64c.qiniudns.com,2,0.07%,2,0,100.00%
get.sogou.com,2,0.07%,73,71,2.74%
assets.msn.com,2,0.07%,9,7,22.22%
pc.ximalaya.com.dsa.dnsv1.com.cn,2,0.07%,2,0,100.00%
storecatalogrevocation.storequality.microsoft.com,2,0.07%,4,2,50.00%
static.geetest.com,2,0.07%,4,2,50.00%
mesu-china.apple.com.akadns.net,2,0.07%,3,1,66.67%
jtypkz2w.sched.d2.tdnsdp1.cn,2,0.07%,3,1,66.67%
firefox.settings.services.mozilla.com,2,0.07%,4,2,50.00%
www.wenxm.cn,2,0.07%,4,2,50.00%
sjy6.stream.qqmusic.qq.com,2,0.07%,5,3,40.00%
16.au.download.windowsupdate.com,2,0.07%,4,2,50.00%
ss0.baidu.com,2,0.07%,9,7,22.22%
ss3.baidu.com,2,0.07%,9,7,22.22%
ss2.baidu.com,2,0.07%,9,7,22.22%
ms.bdimg.com,2,0.07%,9,7,22.22%
fc1tn.baidu.com,2,0.07%,8,6,25.00%
msedge.b.tlu.dl.delivery.mp.microsoft.com,2,0.07%,5,3,40.00%
datarouter.ol.epicgames.com,2,0.07%,5,3,40.00%
wework.qpic.cn,2,0.07%,6,4,33.33%
gimg3.baidu.com,2,0.07%,6,4,33.33%
normandy-cdn.services.mozilla.com,2,0.07%,4,2,50.00%
0.debian.pool.ntp.org,2,0.07%,3,1,66.67%
ipv6.neubt.com,2,0.07%,2,0,100.00%
scholar.google.com.hk,2,0.07%,4,2,50.00%
1.debian.pool.ntp.org,2,0.07%,3,1,66.67%
id.google.com,2,0.07%,3,1,66.67%
contentcenter-drcn.dbankcdn.com,2,0.07%,4,2,50.00%
pgdt.gtimg.cn.sched.legopic2.tdnsv6.com.tpic.vwnti.yrzhcloud.cn,2,0.07%,4,2,50.00%
h5hosting-drcn.dbankcdn.cn,2,0.07%,4,2,50.00%
cdn.ynuf.aliapp.org,2,0.07%,4,2,50.00%
cdn.exp.xiaomi.com,2,0.07%,4,2,50.00%
mini.360.cn,2,0.07%,4,2,50.00%
partner.googleadservices.com,2,0.07%,4,2,50.00%
slardar-bd.feishu.cn.w.cdngslb.com,2,0.07%,4,2,50.00%
auth.docker.io,2,0.07%,4,2,50.00%
mubu.com,2,0.07%,4,2,50.00%
adservice.google.com,2,0.07%,4,2,50.00%
login.msa.msidentity.com,2,0.07%,4,2,50.00%
static.nowcoder.com,2,0.07%,4,2,50.00%
cma-china.itunes-apple.com.akadns.net,2,0.07%,3,1,66.67%
uploadfiles.nowcoder.com,2,0.07%,4,2,50.00%
oneclient.sfx.ms,2,0.07%,5,3,40.00%
pull-lls-spe-l3.douyincdn.com,2,0.07%,4,2,50.00%
static.pddpic.com,2,0.07%,4,2,50.00%
promotion.pddpic.com,2,0.07%,4,2,50.00%
funimg.pddpic.com,2,0.07%,4,2,50.00%
n-devs-sgw.tplinkcloud.com.cn,2,0.07%,4,2,50.00%
avatar2-1.pddpic.com,2,0.07%,4,2,50.00%
avatar2.pddpic.com,2,0.07%,4,2,50.00%
push-resources-1258344701.file.myqcloud.com,2,0.07%,3,1,66.67%
gchat.qpic.cn,2,0.07%,4,2,50.00%
push-resources.sched.dma.tdnsdl1.cn.cdl.cdncloud.idc400.com,2,0.07%,3,1,66.67%
www.vod.lxdns.com,2,0.07%,4,2,50.00%
upos-sz-mirrorali.bilivideo.com,2,0.07%,4,2,50.00%
weread-1258476243.file.myqcloud.com,2,0.07%,4,2,50.00%
v5-e.douyinvod.com,2,0.07%,4,2,50.00%
e673.dsce9.akamaiedge.net,2,0.07%,4,2,50.00%
aapl-maps.qtlcdn.com,2,0.07%,2,0,100.00%
e12919.dscd.akamaiedge.net,2,0.07%,2,0,100.00%
dl.delivery.mp.microsoft.com,2,0.07%,4,2,50.00%
img.alicdn.com.danuoyi.alicdn.com,2,0.07%,4,2,50.00%
qpic.y.qq.com,2,0.07%,4,2,50.00%
signaler-pa.clients6.google.com,2,0.07%,4,2,50.00%
f-log-win-extension.grammarly.io,2,0.07%,4,2,50.00%
drive.google.com,2,0.07%,8,6,25.00%
groups.google.com,2,0.07%,6,4,33.33%
hangouts.google.com,2,0.07%,4,2,50.00%
rc10-g4.oray.com,2,0.07%,4,2,50.00%
bt2.archive.org,2,0.07%,8,6,25.00%
r3.o.lencr.org,2,0.07%,4,2,50.00%
stream.zotero.org,2,0.07%,4,2,50.00%
discovery-v6.verysync.cn,2,0.07%,2,0,100.00%
metrics.icloud.com,2,0.07%,4,2,50.00%
login.feishu.cn,2,0.07%,4,2,50.00%
p3.music.126.net.w.alikunlun.com,2,0.07%,4,2,50.00%
p3.music.126.net.163jiasu.com,2,0.07%,4,2,50.00%
p4.music.126.net,2,0.07%,4,2,50.00%
p4.music.126.net.163jiasu.com,2,0.07%,4,2,50.00%
l2.hiwifi.com,2,0.07%,4,2,50.00%
high-frequency-gray-cdn.duba.net,2,0.07%,4,2,50.00%
btinstall-artifacts.bittorrent.com,2,0.07%,4,2,50.00%
i-5600.b-2372.helper.bench.utorrent.com,2,0.07%,4,2,50.00%
crl.certum.pl,2,0.07%,4,2,50.00%
api.segment.io,2,0.07%,4,2,50.00%
download.game.yy.com,2,0.07%,4,2,50.00%
kinesis.us-east-1.amazonaws.com,2,0.07%,4,2,50.00%
discovery-v6.syncthing.net,2,0.07%,2,0,100.00%
s2.go-mpulse.net,2,0.07%,4,2,50.00%
trial-eum-clientnsv4-s.akamaihd.net,2,0.07%,4,2,50.00%
trial-eum-clienttons-s.akamaihd.net,2,0.07%,4,2,50.00%
assets.adobedtm.com,2,0.07%,4,2,50.00%
684d0d44.akstat.io,2,0.07%,4,2,50.00%
consent.trustarc.com,2,0.07%,4,2,50.00%
hilton.demdex.net,2,0.07%,4,2,50.00%
ssl.gstatic.com,2,0.07%,4,2,50.00%
assets.msn.cn-c.edgekey.net.globalredir.akadns.NET,2,0.07%,2,0,100.00%
3.openwrt.pool.ntp.org,2,0.07%,2,0,100.00%
2.openwrt.pool.ntp.org,2,0.07%,2,0,100.00%
1.openwrt.pool.ntp.org,2,0.07%,2,0,100.00%
6-c-0003.c-msedge.net,2,0.07%,2,0,100.00%
passport.biligame.com,1,0.03%,2,1,50.00%
passport.bigfun.cn,1,0.03%,2,1,50.00%
passport.bigfunapp.cn,1,0.03%,2,1,50.00%
passport.shanghaihuanli.com,1,0.03%,2,1,50.00%
passport.bilibili.cn,1,0.03%,2,1,50.00%
www.icloud.com,1,0.03%,4,3,25.00%
data.bilicdn2.com,1,0.03%,2,1,50.00%
pic1.zhimg.com,1,0.03%,2,1,50.00%
pic4.zhimg.com,1,0.03%,2,1,50.00%
self.events.data.microsoft.com,1,0.03%,101,100,0.99%
ping.pinyin.sogou.com,1,0.03%,56,55,1.79%
info.pinyin.sogou.com,1,0.03%,39,38,2.56%
h-adashx.ut.taobao.com,1,0.03%,69,68,1.45%
gecko-bd.feishu.cn.w.cdngslb.com,1,0.03%,2,1,50.00%
upos-sz-mirrorhw.bilivideo.com,1,0.03%,2,1,50.00%
notice.wps.cn,1,0.03%,8,7,12.50%
le.wps.cn,1,0.03%,4,3,25.00%
qr.wps.cn,1,0.03%,5,4,20.00%
zj-roaming.wps.cn,1,0.03%,4,3,25.00%
wdl1.file.cache.wpscdn.cn,1,0.03%,2,1,50.00%
dl.vas.wpscdn.cn,1,0.03%,7,6,14.29%
x1.c.lencr.org,1,0.03%,16,15,6.25%
assets.msn.cn,1,0.03%,34,33,2.94%
boss.hdslb.com,1,0.03%,2,1,50.00%
bimp.hdslb.com,1,0.03%,2,1,50.00%
ctldl.windowsupdate.com,1,0.03%,96,95,1.04%
config.edge.skype.com,1,0.03%,21,20,4.76%
dev,1,0.03%,1,0,100.00%
ims-na1.adobelogin.com,1,0.03%,3,2,33.33%
www.msftncsi.com,1,0.03%,131,130,0.76%
tp.m-team.cc,1,0.03%,5,4,20.00%
m.qpic.cn,1,0.03%,3,2,33.33%
iduxzj9.qiniudns.com,1,0.03%,1,0,100.00%
crl3.digicert.com,1,0.03%,8,7,12.50%
post.ksosoft.com,1,0.03%,4,3,25.00%
m8.music.126.net.w.kunlungr.com,1,0.03%,2,1,50.00%
ic.wps.cn,1,0.03%,5,4,20.00%
update.wps.cn,1,0.03%,5,4,20.00%
smarthome-drcn.dbankcdn.com,1,0.03%,3,2,33.33%
cdnimg.3g.qq.com,1,0.03%,2,1,50.00%
clients2.google.com,1,0.03%,31,30,3.23%
q-ring.q-9999.q-msedge.NET,1,0.03%,2,1,50.00%
maponline3.bdimg.com,1,0.03%,3,2,33.33%
maponline0.bdimg.com,1,0.03%,3,2,33.33%
maponline1.bdimg.com,1,0.03%,3,2,33.33%
acroipm2.adobe.com,1,0.03%,2,1,50.00%
px.moatads.com,1,0.03%,2,1,50.00%
tool.chinaz.com,1,0.03%,2,1,50.00%
csstools.chinaz.com,1,0.03%,2,1,50.00%
a2put.chinaz.com,1,0.03%,2,1,50.00%
oimageb7.ydstatic.com,1,0.03%,2,1,50.00%
app-measurement.com,1,0.03%,2,1,50.00%
g.alicdn.com,1,0.03%,9,8,11.11%
findermp.video.qq.com,1,0.03%,2,1,50.00%
amp-api-edge-lb-cn.itunes-apple.com.akadns.net,1,0.03%,3,2,33.33%
dldir1v6.qq.com,1,0.03%,3,2,33.33%
api.weathercn.com,1,0.03%,3,2,33.33%
s0.meituan.net,1,0.03%,3,2,33.33%
update.360safe.com,1,0.03%,9,8,11.11%
img-s-msn-com.akamaized.net,1,0.03%,8,7,12.50%
sb.scorecardresearch.com,1,0.03%,10,9,10.00%
assets2.msn.com,1,0.03%,6,5,16.67%
mmbiz.qpic.cn.sched.legopic1.tdnsv6.com,1,0.03%,4,3,25.00%
www.qq.com,1,0.03%,166,165,0.60%
img-s.msn.cn,1,0.03%,4,3,25.00%
t11.baidu.com,1,0.03%,3,2,33.33%
e4518.dscapi7.akamaiedge.net,1,0.03%,3,2,33.33%
ppui-static-pc.cdn.bcebos.com,1,0.03%,3,2,33.33%
updatem.360safe.com,1,0.03%,26,25,3.85%
dl.360safe.com,1,0.03%,1,0,100.00%
aistudio.baidu.com,1,0.03%,1,0,100.00%
safebrowsing-re.aaplimg.com,1,0.03%,1,0,100.00%
t10.baidu.com,1,0.03%,4,3,25.00%
t12.baidu.com,1,0.03%,4,3,25.00%
pic.rmb.bdstatic.com,1,0.03%,4,3,25.00%
helpdubaclient.ksmobile.com,1,0.03%,11,10,9.09%
tracker.darmowy-torrent.pl,1,0.03%,1,0,100.00%
se.360.cn,1,0.03%,3,2,33.33%
recv-wd.gridsumdissector.com,1,0.03%,1,0,100.00%
s1.vip.wpscdn.cn,1,0.03%,3,2,33.33%
img1.pcfg.cache.wpscdn.cn,1,0.03%,2,1,50.00%
api.flash.cn,1,0.03%,1,0,100.00%
tongji.flash.cn,1,0.03%,2,1,50.00%
cd.huoying666.com,1,0.03%,2,1,50.00%
sqimg.qq.com,1,0.03%,2,1,50.00%
h5hosting.dbankcdn.com,1,0.03%,2,1,50.00%
midas.gtimg.cn,1,0.03%,2,1,50.00%
appoptimize-drcn.dbankcdn.com,1,0.03%,1,0,100.00%
res.u-tools.cn,1,0.03%,2,1,50.00%
y.qq.com,1,0.03%,3,2,33.33%
bcp.crwdcntrl.net,1,0.03%,2,1,50.00%
api.onedrive.com,1,0.03%,4,3,25.00%
mdn.alicdn.com,1,0.03%,2,1,50.00%
pgdt.tc.qq.com,1,0.03%,3,2,33.33%
e19240.ca.s.tl88.NET,1,0.03%,2,1,50.00%
img.cdn.mvideo.xiaomi.com,1,0.03%,2,1,50.00%
client-api-cdn-cn.itunes-apple.com.akadns.net,1,0.03%,2,1,50.00%
itunes.apple.com,1,0.03%,2,1,50.00%
play.itunes.apple.com,1,0.03%,2,1,50.00%
is5-ssl.mzstatic.com,1,0.03%,2,1,50.00%
is4-ssl.mzstatic.com,1,0.03%,2,1,50.00%
is1-ssl.mzstatic.com,1,0.03%,2,1,50.00%
cdn.orayimg.com,1,0.03%,2,1,50.00%
pc001.update.lbmini.cmcm.com,1,0.03%,2,1,50.00%
www.belkin.com,1,0.03%,2,1,50.00%
tysdk.95516.com,1,0.03%,2,1,50.00%
upload-cdn.orayimg.com,1,0.03%,2,1,50.00%
adsmind.gdtimg.com.svideolego-dk.sched.dcloudstc.com,1,0.03%,2,1,50.00%
dc.applicationinsights.microsoft.com,1,0.03%,2,1,50.00%
cbjs.baidu.com,1,0.03%,2,1,50.00%
img2.baidu.com,1,0.03%,2,1,50.00%
img0.baidu.com,1,0.03%,2,1,50.00%
img1.baidu.com,1,0.03%,2,1,50.00%
firebaseinstallations.googleapis.com,1,0.03%,2,1,50.00%
pptpluginppt.keniu.com,1,0.03%,1,0,100.00%
search-operate.cdn.bcebos.com,1,0.03%,2,1,50.00%
verdaccio.org,1,0.03%,2,1,50.00%
kjjs.360.cn,1,0.03%,2,1,50.00%
csdnimg.cn,1,0.03%,3,2,33.33%
img-blog.csdnimg.cn,1,0.03%,2,1,50.00%
img-blog.csdn.net,1,0.03%,2,1,50.00%
s3a.pstatp.com,1,0.03%,2,1,50.00%
img-home.csdnimg.cn,1,0.03%,2,1,50.00%
emoji.qpic.cn.sched.legopic1.tdnsv6.com,1,0.03%,2,1,50.00%
pcvideoaliyun.titan.mgtv.com,1,0.03%,2,1,50.00%
pub.idqqimg.com.tc.qq.com,1,0.03%,2,1,50.00%
app2.myzaker.com,1,0.03%,2,1,50.00%
app.myzaker.com,1,0.03%,2,1,50.00%
zkres.myzaker.com,1,0.03%,2,1,50.00%
zkres1.myzaker.com,1,0.03%,2,1,50.00%
dm.toutiao.com,1,0.03%,2,1,50.00%
mssdk-bu.bytedance.com,1,0.03%,2,1,50.00%
fundingchoicesmessages.google.com,1,0.03%,2,1,50.00%
tpc.googlesyndication.com,1,0.03%,2,1,50.00%
s.fhtre.com,1,0.03%,2,1,50.00%
cm.g.doubleclick.net,1,0.03%,2,1,50.00%
qzs.gdtimg.com,1,0.03%,2,1,50.00%
zhanzhang.toutiao.com.w.cdngslb.com,1,0.03%,1,0,100.00%
unpkg.zhimg.com,1,0.03%,2,1,50.00%
vweixinthumb.tc.qq.com,1,0.03%,2,1,50.00%
tracker.ipv6tracker.ru,1,0.03%,1,0,100.00%
beacons3.gvt2.com,1,0.03%,2,1,50.00%
img.y.qq.com,1,0.03%,2,1,50.00%
images.nowcoder.com,1,0.03%,2,1,50.00%
cdn.icloud-content.com,1,0.03%,2,1,50.00%
www.runoob.com,1,0.03%,1,0,100.00%
api.amemv.com,1,0.03%,3,2,33.33%
api3-normal-c-lf.amemv.com,1,0.03%,2,1,50.00%
b0.bdstatic.com,1,0.03%,2,1,50.00%
img.da.mgtv.com,1,0.03%,2,1,50.00%
pub.idqqimg.com.sched.legopic1.tdnsv6.com,1,0.03%,2,1,50.00%
pull-hls-f96.douyincdn.com,1,0.03%,2,1,50.00%
odc-bnz07pap001-meta-geo.onedrive.akadns.NET,1,0.03%,2,1,50.00%
odc-bnz07pap001-meta-brs.onedrive.akadns.NET,1,0.03%,2,1,50.00%
pull-flv-l29.douyincdn.com,1,0.03%,2,1,50.00%
ws-keyboard.shouji.sogou.com,1,0.03%,2,1,50.00%
push-rtmp-f5-enc.douyincdn.com,1,0.03%,2,1,50.00%
pull-hls-vr-l11.douyincdn.com,1,0.03%,2,1,50.00%
vectormap0.bdimg.com,1,0.03%,2,1,50.00%
tlu.dl.delivery.mp.microsoft.com,1,0.03%,2,1,50.00%
pull-f5-hot.flive.douyincdn.com,1,0.03%,2,1,50.00%
pull-rtmp-l6-source.douyincdn.com,1,0.03%,2,1,50.00%
push-rtmp-l11-encryption.douyincdn.com,1,0.03%,2,1,50.00%
push-rtmp-l1-cny.douyincdn.com,1,0.03%,2,1,50.00%
push-rtmp-hs-f5.douyincdn.com,1,0.03%,2,1,50.00%
x2.c.lencr.org,1,0.03%,2,1,50.00%
pull-flv-f13.douyincdn.com,1,0.03%,2,1,50.00%
pull-tsl-vr-l3.douyincdn.com,1,0.03%,2,1,50.00%
pull-hs-f5.flive.ihuoshanlive.com,1,0.03%,2,1,50.00%
pull-hs-f5.flive.huoshanlive.com,1,0.03%,2,1,50.00%
pull-flv-l13.douyincdn.com,1,0.03%,2,1,50.00%
pull-tsl-vr-l11.douyincdn.com,1,0.03%,2,1,50.00%
push-rtmp-hs-spe-f5.douyincdn.com,1,0.03%,2,1,50.00%
pull-hls-hs-f5-tsl.douyincdn.com,1,0.03%,1,0,100.00%
push-rtmp-spe-l1.douyincdn.com,1,0.03%,2,1,50.00%
pull-tsl-spe-l11.douyincdn.com,1,0.03%,2,1,50.00%
push-rtmp-hs-vr-f5.douyincdn.com,1,0.03%,2,1,50.00%
pull-hls-spe-l26.douyincdn.com,1,0.03%,2,1,50.00%
pull-rtmp-l13.douyincdn.com,1,0.03%,2,1,50.00%
pull-tsl-spe-l26.douyincdn.com,1,0.03%,2,1,50.00%
pull-rtmp-f13.douyincdn.com,1,0.03%,2,1,50.00%
push-rtmp-l3.douyincdn.com,1,0.03%,2,1,50.00%
pull-l3-cny.douyincdn.com,1,0.03%,2,1,50.00%
pull-lls-spe-l11.douyincdn.com,1,0.03%,2,1,50.00%
pull-flv-f1-hs.pstatp.com,1,0.03%,2,1,50.00%
pull-rtmp-f6-hs.pstatp.com,1,0.03%,2,1,50.00%
pull-f5-vs.flive.douyincdn.com,1,0.03%,2,1,50.00%
pull-flv-l11-source.douyincdn.com,1,0.03%,2,1,50.00%
push-rtmp-l29.douyincdn.com,1,0.03%,2,1,50.00%
v5-httpdns.douyinvod.com,1,0.03%,2,1,50.00%
graph.facebook.com,1,0.03%,2,1,50.00%
v96.douyinvod.com,1,0.03%,2,1,50.00%
uci.edog.cdn.office.net,1,0.03%,2,1,50.00%
pull-flv-vr-l11.douyincdn.com,1,0.03%,1,0,100.00%
pull-lls-spe-l6.douyincdn.com,1,0.03%,2,1,50.00%
pull-flv-l1-hs.pstatp.com,1,0.03%,2,1,50.00%
pull-rtmp-l1.douyincdn.com,1,0.03%,1,0,100.00%
pull-rtmp-f1-hs.pstatp.com,1,0.03%,2,1,50.00%
pull-l3-source.douyincdn.com,1,0.03%,1,0,100.00%
video-hw-drcn.dbankcdn.cn,1,0.03%,2,1,50.00%
play.googleapis.com,1,0.03%,1,0,100.00%
pull-flv-f29.douyincdn.com,1,0.03%,2,1,50.00%
whoami.akamai.net,1,0.03%,2,1,50.00%
api5-normal-dsa-hl.amemv.com,1,0.03%,2,1,50.00%
v9.toutiaovod.com,1,0.03%,2,1,50.00%
pull-flv-spe-l26.douyincdn.com,1,0.03%,2,1,50.00%
video3.pddpic.com,1,0.03%,2,1,50.00%
img-1.pddpic.com,1,0.03%,2,1,50.00%
video-snapshot.pddpic.com,1,0.03%,2,1,50.00%
v11.sched.v4lego-dk.tdnsvod1.cn,1,0.03%,2,1,50.00%
pull-lls-l3.douyincdn.com,1,0.03%,1,0,100.00%
pull-hs-spe-f5.douyincdn.com,1,0.03%,2,1,50.00%
wos.anjukestatic.com,1,0.03%,2,1,50.00%
pull-rtmp-l1-cny.douyincdn.com,1,0.03%,2,1,50.00%
push-rtmp-l1-hs.pstatp.com,1,0.03%,2,1,50.00%
pic7.ajkimg.com,1,0.03%,2,1,50.00%
xcxcdn.yangkeduo.com,1,0.03%,2,1,50.00%
t16img.yangkeduo.com,1,0.03%,2,1,50.00%
t12img.yangkeduo.com,1,0.03%,2,1,50.00%
pinduoduoimg.yangkeduo.com,1,0.03%,2,1,50.00%
t13img.yangkeduo.com,1,0.03%,2,1,50.00%
v3-default.365yg.com,1,0.03%,2,1,50.00%
v5-h.douyinvod.com,1,0.03%,2,1,50.00%
scc.bytedance.com,1,0.03%,2,1,50.00%
p4-live.a.yximgs.com,1,0.03%,2,1,50.00%
p4.a.yximgs.com,1,0.03%,2,1,50.00%
guide-acs.m.taobao.com,1,0.03%,2,1,50.00%
dorangesource.alicdn.com,1,0.03%,2,1,50.00%
mdike.alicdn.com,1,0.03%,2,1,50.00%
web.m.taobao.com,1,0.03%,2,1,50.00%
zconfig.alibabausercontent.com,1,0.03%,2,1,50.00%
gw.alicdn.com,1,0.03%,2,1,50.00%
heic.alicdn.com,1,0.03%,2,1,50.00%
zres.alicdn.com,1,0.03%,2,1,50.00%
h5.m.taobao.com,1,0.03%,2,1,50.00%
fullscreen-detail.alicdn.com,1,0.03%,2,1,50.00%
miniapp-package-zcache.taobao.com,1,0.03%,2,1,50.00%
frontier-aweme-lf-ipainner.amemv.com,1,0.03%,2,1,50.00%
applog.snssdk.com,1,0.03%,2,1,50.00%
huiji-thumb.huijistatic.com,1,0.03%,1,0,100.00%
gametools.bs2dl.yy.com,1,0.03%,2,1,50.00%
puui.qpic.cn,1,0.03%,2,1,50.00%
gw2.huijiwiki.com,1,0.03%,1,0,100.00%
static-calendar-drcn.dbankcdn.cn,1,0.03%,2,1,50.00%
cfg-1.pddpic.com,1,0.03%,2,1,50.00%
img-2.pddpic.com,1,0.03%,2,1,50.00%
pkg.biligame.com,1,0.03%,2,1,50.00%
e6858.e19.s.tl88.net,1,0.03%,2,1,50.00%
www.qidian.com,1,0.03%,2,1,50.00%
magev6.if.qidian.com,1,0.03%,2,1,50.00%
v5-g.douyinvod.com,1,0.03%,2,1,50.00%
www.cctv.com,1,0.03%,2,1,50.00%
tsbrowser.xiangtatech.com,1,0.03%,2,1,50.00%
news.baidu.com,1,0.03%,2,1,50.00%
stcglobal.beisen.com,1,0.03%,2,1,50.00%
v1.douyinvod.com,1,0.03%,2,1,50.00%
liangcang-material.alicdn.com,1,0.03%,2,1,50.00%
v27-a.douyinvod.com,1,0.03%,2,1,50.00%
cu003.www.duba.net,1,0.03%,1,0,100.00%
upos-sz-mirrorcoso1.bilivideo.com,1,0.03%,2,1,50.00%
f7.baidu.com,1,0.03%,2,1,50.00%
digitalassetlinks.googleapis.com,1,0.03%,2,1,50.00%
main.appstore.vivo.com.cn,1,0.03%,2,1,50.00%
v11.douyinvod.com,1,0.03%,2,1,50.00%
contentcenter-drcn.dbankcdn.cn,1,0.03%,1,0,100.00%
cp501.prod.do.dsp.mp.microsoft.com,1,0.03%,2,1,50.00%
14.au.download.windowsupdate.com,1,0.03%,3,2,33.33%
prod-streaming-video-msn-com.akamaized.net,1,0.03%,2,1,50.00%
szmmsns.qpic.cn,1,0.03%,2,1,50.00%
help.apple.com,1,0.03%,2,1,50.00%
e11408.d.akamaiedge.net,1,0.03%,2,1,50.00%
onedscolprdcus04.centralus.cloudapp.azure.com,1,0.03%,2,1,50.00%
v5-i.douyinvod.com,1,0.03%,1,0,100.00%
jmy-pic.baidu.com,1,0.03%,2,1,50.00%
cp601.prod.do.dsp.mp.microsoft.com,1,0.03%,2,1,50.00%
fsigns.duba.net,1,0.03%,3,2,33.33%
g.y.qq.com,1,0.03%,2,1,50.00%
iris-de-prod-azsc-eas-b.eastasia.cloudapp.azure.com,1,0.03%,2,1,50.00%
internal-api-lark-api.feishu.cn.w.cdngslb.com,1,0.03%,2,1,50.00%
d.dropbox.com,1,0.03%,2,1,50.00%
tracker.cyberia.is,1,0.03%,1,0,100.00%
aeu.alicdn.com,1,0.03%,2,1,50.00%
s1.cn.bing.net,1,0.03%,2,1,50.00%
s4.cn.bing.net,1,0.03%,2,1,50.00%
d7kac1jd1i.feishu.cn,1,0.03%,2,1,50.00%
nat.emule.org.cn,1,0.03%,1,0,100.00%
dl.google.com,1,0.03%,2,1,50.00%
mvgforumtracker.mvgroup.org,1,0.03%,12,11,8.33%
upload.twitter.com,1,0.03%,4,3,25.00%
youtubei.googleapis.com,1,0.03%,2,1,50.00%
upload.youtube.com,1,0.03%,4,3,25.00%
clients6.google.com,1,0.03%,2,1,50.00%
code.bdstatic.com,1,0.03%,2,1,50.00%
sites.google.com,1,0.03%,4,3,25.00%
www.google.com.ag,1,0.03%,5,4,20.00%
www.google.com.au,1,0.03%,4,3,25.00%
onedrive.live.com,1,0.03%,4,3,25.00%
www.google.com.bo,1,0.03%,4,3,25.00%
www.google.co.bw,1,0.03%,4,3,25.00%
www.google.com.bz,1,0.03%,5,4,20.00%
twitter.com,1,0.03%,4,3,25.00%
google.com,1,0.03%,3,2,33.33%
www.google.co.cr,1,0.03%,4,3,25.00%
facebook.com,1,0.03%,4,3,25.00%
upload-oss.vzuu.com,1,0.03%,2,1,50.00%
zhihu-pics-upload.zhimg.com,1,0.03%,2,1,50.00%
youtube.com,1,0.03%,4,3,25.00%
m.youtube.com,1,0.03%,4,3,25.00%
www.google.com.ai,1,0.03%,5,4,20.00%
showcase.dropbox.com,1,0.03%,4,3,25.00%
calendar.google.com,1,0.03%,2,1,50.00%
www.google.com.ar,1,0.03%,5,4,20.00%
upload.docs.google.com,1,0.03%,3,2,33.33%
www.google.com.bd,1,0.03%,5,4,20.00%
plus.google.com,1,0.03%,4,3,25.00%
www.google.com.do,1,0.03%,5,4,20.00%
www.google.com.af,1,0.03%,5,4,20.00%
www.google.com.br,1,0.03%,4,3,25.00%
onenote.com,1,0.03%,2,1,50.00%
www.google.com.co,1,0.03%,4,3,25.00%
dropbox.com,1,0.03%,4,3,25.00%
contacts.google.com,1,0.03%,2,1,50.00%
sf-api.com,1,0.03%,1,0,100.00%
www.google.com.bh,1,0.03%,4,3,25.00%
www.google.com.bn,1,0.03%,4,3,25.00%
www.google.co.ck,1,0.03%,5,4,20.00%
www.google.com.cu,1,0.03%,5,4,20.00%
www.google.com.cy,1,0.03%,4,3,25.00%
search.yahoo.com,1,0.03%,4,3,25.00%
paper.dropbox.com,1,0.03%,4,3,25.00%
m7.music.126.net,1,0.03%,2,1,50.00%
s3plus.meituan.net,1,0.03%,2,1,50.00%
static.youku.com,1,0.03%,2,1,50.00%
upload.jianshu.io,1,0.03%,2,1,50.00%
valipl10.cp31.ott.cibntv.net,1,0.03%,2,1,50.00%
vthumb.ykimg.com,1,0.03%,2,1,50.00%
www.yisu.com,1,0.03%,2,1,50.00%
streamdot.douyucdn.cn,1,0.03%,2,1,50.00%
download.zotero.org,1,0.03%,1,0,100.00%
fanyi-cdn.cdn.bcebos.com,1,0.03%,2,1,50.00%
lf3-cdn-tos.bytegecko.com,1,0.03%,2,1,50.00%
www.tribalmixes.com,1,0.03%,6,5,16.67%
t8.dropbox.com,1,0.03%,2,1,50.00%
m801.music.126.net,1,0.03%,2,1,50.00%
g3.ykimg.com,1,0.03%,2,1,50.00%
i.meituan.com,1,0.03%,2,1,50.00%
upload-images.jianshu.io,1,0.03%,2,1,50.00%
a1887.dscq.akamai.net,1,0.03%,2,1,50.00%
fanyiapp.cdn.bcebos.com,1,0.03%,2,1,50.00%
ocsp.rootg2.amazontrust.com,1,0.03%,2,1,50.00%
qcloud.dpfile.com,1,0.03%,2,1,50.00%
static.dataservices.hp.com,1,0.03%,2,1,50.00%
download.jetbrains.com.cn,1,0.03%,2,1,50.00%
codown.youdao.com,1,0.03%,2,1,50.00%
gspe1-ssl.ls.apple.com,1,0.03%,2,1,50.00%
www.tm.a.prd.aadg.akadns.net,1,0.03%,2,1,50.00%
p3.music.126.net,1,0.03%,2,1,50.00%
api2.firefoxchina.cn.wswebpic.com,1,0.03%,4,3,25.00%
zlxx.v.lxcvc.com,1,0.03%,4,3,25.00%
cdn.ap.bittorrent.com,1,0.03%,2,1,50.00%
googlecn-lopri.l.google.com,1,0.03%,2,1,50.00%
safebrowsing.googleapis-cn.com,1,0.03%,2,1,50.00%
safebrowsing.google.com,1,0.03%,2,1,50.00%
wspeed.qq.com,1,0.03%,3,2,33.33%
update2.sangfor.net,1,0.03%,2,1,50.00%
file.drivergenius.com,1,0.03%,2,1,50.00%
df.cache.wpscdn.cn,1,0.03%,4,3,25.00%
p0.qhimg.com,1,0.03%,2,1,50.00%
dy.xiajunhuagong.cn,1,0.03%,2,1,50.00%
auth.hiwifi.com,1,0.03%,2,1,50.00%
cloud.hiwifi.com,1,0.03%,2,1,50.00%
dotplayer.coldlake1.com.w.cdngslb.com,1,0.03%,2,1,50.00%
api.stellarplayer.com.w.cdngslb.com,1,0.03%,2,1,50.00%
discovery-v6-4.syncthing.net,1,0.03%,1,0,100.00%
1.pool.ntp.org,1,0.03%,2,1,50.00%
2.pool.ntp.org,1,0.03%,2,1,50.00%
3.pool.ntp.org,1,0.03%,2,1,50.00%
3.asia.pool.ntp.org,1,0.03%,2,1,50.00%
0.asia.pool.ntp.org,1,0.03%,2,1,50.00%
0.cn.pool.ntp.org,1,0.03%,2,1,50.00%
instantmessaging-pa.googleapis.com,1,0.03%,2,1,50.00%
netty.yunduoketang.com,1,0.03%,2,1,50.00%
exo.nel.measure.office.net,1,0.03%,2,1,50.00%
atm-fp-direct.office.com,1,0.03%,2,1,50.00%
crl.pki.goog,1,0.03%,2,1,50.00%
client.dropbox.com,1,0.03%,2,1,50.00%
www.catererglobal.com,1,0.03%,1,0,100.00%
images-eu.ssl-images-amazon.com,1,0.03%,1,0,100.00%
helpx.adobe.com,1,0.03%,2,1,50.00%
uz95.v.trpcdn.NET,1,0.03%,2,1,50.00%
pgpstatic.games.wanmei.com,1,0.03%,2,1,50.00%
m701.music.126.net,1,0.03%,2,1,50.00%
clientlog.wanmei.com,1,0.03%,2,1,50.00%
docs.gtimg.com,1,0.03%,2,1,50.00%
public-cdn.cloud.unity3d.com,1,0.03%,2,1,50.00%
public-cdn.cloud.unitychina.cn,1,0.03%,2,1,50.00%
dynamic.t0.tiles.ditu.live.com,1,0.03%,2,1,50.00%
1039909-9.chat.api.drift.com,1,0.03%,2,1,50.00%
ux70.v.trpcdn.NET,1,0.03%,2,1,50.00%
saascdn.lenovo.com.cn,1,0.03%,2,1,50.00%
fa000000064.resources.office.net,1,0.03%,2,1,50.00%
gtm-dyn-direct.office365.com,1,0.03%,2,1,50.00%
cipv6gn.v.trpcdn.NET,1,0.03%,2,1,50.00%
catalog-public-service-prod.ak.epicgames.com,1,0.03%,2,1,50.00%
priceengine-public-service-prod.ak.epicgames.com,1,0.03%,2,1,50.00%
dl.pop.www.duba.net,1,0.03%,2,1,50.00%
res.ldmnq.com,1,0.03%,2,1,50.00%
subca.crl.certum.pl,1,0.03%,2,1,50.00%
appdl.lenovo.com.cn,1,0.03%,2,1,50.00%
help.origin-apple.com.akadns.net,1,0.03%,2,1,50.00%
api.epicgames.dev,1,0.03%,2,1,50.00%
jp04-vm0.entry.srthdw.art,1,0.03%,2,1,50.00%
download.iciba.com,1,0.03%,2,1,50.00%
i-lq.snssdk.com,1,0.03%,2,1,50.00%
down-30005.sz.gfp.tencent-cloud.com,1,0.03%,2,1,50.00%
down.qq.com,1,0.03%,2,1,50.00%
beacons2.gvt2.com,1,0.03%,2,1,50.00%
clientconfig.akamai.steamstatic.com,1,0.03%,2,1,50.00%
steamcdn-a.akamaihd.net,1,0.03%,2,1,50.00%
odc-bl6pap004-meta-geo.onedrive.akadns.NET,1,0.03%,2,1,50.00%
odc-bl6pap004-meta-brs.onedrive.akadns.NET,1,0.03%,3,2,33.33%
o3cf2jk38u.feishu.cn,1,0.03%,2,1,50.00%
iscas-itechs-kg.feishu.cn,1,0.03%,2,1,50.00%
www.163.com,0,0.00%,8286,8286,0.00%
ntp.ubuntu.com,0,0.00%,1222,1222,0.00%
www.baidu.com,0,0.00%,1473,1473,0.00%
www.chinauos.com,0,0.00%,1027,1027,0.00%
teredo.ipv6.microsoft.com,0,0.00%,518,518,0.00%
teredo-debian.remlab.net,0,0.00%,15,15,0.00%
incoming.telemetry.mozilla.org,0,0.00%,35,35,0.00%
api.vc.bilibili.com,0,0.00%,62,62,0.00%
dl.min.io,0,0.00%,62,62,0.00%
x.research.qq.com,0,0.00%,182,182,0.00%
hub.upyun.com,0,0.00%,44,44,0.00%
mv.music.tc.qq.com,0,0.00%,10,10,0.00%
skydrivesync.policies.live.net,0,0.00%,4,4,0.00%
connectivity-check.ubuntu.com,0,0.00%,147,147,0.00%
prod.ingestion-edge.prod.dataops.mozgcp.net,0,0.00%,2,2,0.00%
ocsp.digicert.com,0,0.00%,15,15,0.00%
cs9.wac.phicdn.net,0,0.00%,2,2,0.00%
c.skconf.f.360.cn,0,0.00%,2,2,0.00%
osfsr.lenovomm.com,0,0.00%,40,40,0.00%
dsp.lenovo.com.cn,0,0.00%,26,26,0.00%
ldc.lenovo.com.cn,0,0.00%,21,21,0.00%
rm-bp151dcc75aycqd80to.mysql.rds.aliyuncs.com,0,0.00%,3,3,0.00%
clock.isc.org,0,0.00%,5,5,0.00%
edragent.sangfor.com.cn,0,0.00%,124,124,0.00%
query.hicloud.com,0,0.00%,393,393,0.00%
roaming.officeapps.live.com,0,0.00%,14,14,0.00%
bash.givemexyz.in,0,0.00%,58,58,0.00%
github.com,0,0.00%,6,6,0.00%
up-hl.3g.qq.com,0,0.00%,2,2,0.00%
hsk-embed.oray.com,0,0.00%,121,121,0.00%
mobile.events.data.microsoft.com,0,0.00%,52,52,0.00%
space.bilibili.com,0,0.00%,2,2,0.00%
security.bilibili.com,0,0.00%,2,2,0.00%
i0.hdslb.com,0,0.00%,7,7,0.00%
i1.hdslb.com,0,0.00%,5,5,0.00%
analytics.yinxiang.com,0,0.00%,24,24,0.00%
api.bilibili.com,0,0.00%,9,9,0.00%
passport.bilibili.com,0,0.00%,4,4,0.00%
pan.baidu.com,0,0.00%,109,109,0.00%
diskapi.baidu.com,0,0.00%,25,25,0.00%
nav-edge.smartscreen.microsoft.com,0,0.00%,14,14,0.00%
sp0.baidu.com,0,0.00%,11,11,0.00%
sp1.baidu.com,0,0.00%,13,13,0.00%
ss1.bdstatic.com,0,0.00%,6,6,0.00%
39-courier.push.apple.com,0,0.00%,2,2,0.00%
t13.baidu.com,0,0.00%,5,5,0.00%
t9.baidu.com,0,0.00%,11,11,0.00%
hectorstatic.baidu.com,0,0.00%,14,14,0.00%
10-courier.push.apple.com,0,0.00%,4,4,0.00%
cn.ntp.org.cn,0,0.00%,9,9,0.00%
hpd.baidu.com,0,0.00%,13,13,0.00%
ug.baidu.com,0,0.00%,12,12,0.00%
msedge.api.cdp.microsoft.com,0,0.00%,12,12,0.00%
azwus1-client-s.gateway.messenger.live.com,0,0.00%,2,2,0.00%
sl-tk.oray.com,0,0.00%,94,94,0.00%
log.tailscale.io,0,0.00%,24,24,0.00%
api.miwifi.com,0,0.00%,114,114,0.00%
smtp.qq.com,0,0.00%,36,36,0.00%
pcrec.baidu.com,0,0.00%,8,8,0.00%
wx.qlogo.cn,0,0.00%,47,47,0.00%
zhuanlan.zhihu.com,0,0.00%,4,4,0.00%
bili-dyn-sched.jcloud-cdn.com,0,0.00%,2,2,0.00%
static.zhihu.com,0,0.00%,4,4,0.00%
pica.zhimg.com,0,0.00%,2,2,0.00%
tile-service.weather.microsoft.com,0,0.00%,32,32,0.00%
zz.bdstatic.com,0,0.00%,4,4,0.00%
client.wns.windows.com,0,0.00%,28,28,0.00%
time.pool.aliyun.com,0,0.00%,10,10,0.00%
zhihu-web-analytics.zhihu.com,0,0.00%,4,4,0.00%
sugar.zhihu.com,0,0.00%,4,4,0.00%
wp.safe.360.cn,0,0.00%,66,66,0.00%
alpha-cloud-log.cn-hangzhou.log.aliyuncs.com,0,0.00%,9,9,0.00%
rq.wh.cmcm.com,0,0.00%,52,52,0.00%
config.app.yinxiang.com,0,0.00%,3,3,0.00%
szextshort.weixin.qq.com,0,0.00%,10,10,0.00%
yiyun.n.shifen.com,0,0.00%,2,2,0.00%
rq.drcct.cloud.duba.net,0,0.00%,29,29,0.00%
lp.open.weixin.qq.com,0,0.00%,5,5,0.00%
soup.v.qq.com,0,0.00%,12,12,0.00%
downv6.qq.com,0,0.00%,2,2,0.00%
daisy.ubuntu.com,0,0.00%,121,121,0.00%
cb10bdfbd90f88db560d0ad1e8f78722.dlied1.cdntips.net,0,0.00%,1,1,0.00%
packages.deepin.com,0,0.00%,20,20,0.00%
cgi.ark.qq.com,0,0.00%,3,3,0.00%
checkappexec.microsoft.com,0,0.00%,22,22,0.00%
config.pinyin.sogou.com,0,0.00%,65,65,0.00%
appconf.mail.163.com,0,0.00%,6,6,0.00%
nexusrules.officeapps.live.com,0,0.00%,54,54,0.00%
settings-win.data.microsoft.com,0,0.00%,216,216,0.00%
flbgpi.yixuedianzishu.com,0,0.00%,3,3,0.00%
v10.events.data.microsoft.com,0,0.00%,117,117,0.00%
time.apple.com,0,0.00%,27,27,0.00%
cloud.acrobat.com,0,0.00%,2,2,0.00%
static.asm.skype.com,0,0.00%,6,6,0.00%
duba-defend.zhhainiao.com,0,0.00%,36,36,0.00%
static-asm.secure.skypeassets.com,0,0.00%,6,6,0.00%
ce571486-i.andns.co,0,0.00%,10,10,0.00%
cdn.lever.co,0,0.00%,2,2,0.00%
jobs.lever.co,0,0.00%,2,2,0.00%
autoupdater.updrv.com,0,0.00%,8,8,0.00%
usercount.dockernb.com,0,0.00%,17,17,0.00%
dns.cloudflare.com,0,0.00%,4,4,0.00%
s1a.time.edu.cn,0,0.00%,5,5,0.00%
public.dns.iij.jp,0,0.00%,12,12,0.00%
telemetry-in.battlenet.com.cn,0,0.00%,13,13,0.00%
www.bilibili.com,0,0.00%,6,6,0.00%
controlplane.tailscale.com,0,0.00%,2,2,0.00%
zh.us.to,0,0.00%,5,5,0.00%
api.live.bilibili.com,0,0.00%,8,8,0.00%
cm.bilibili.com,0,0.00%,8,8,0.00%
grafana.com,0,0.00%,29,29,0.00%
raw.githubusercontent.com,0,0.00%,8,8,0.00%
default.exp-tas.com,0,0.00%,30,30,0.00%
bvc.bilivideo.com,0,0.00%,5,5,0.00%
rq.upgrade.drivergenius.com,0,0.00%,24,24,0.00%
update.code.visualstudio.com,0,0.00%,4,4,0.00%
c.go-mpulse.net,0,0.00%,9,9,0.00%
grnh.se,0,0.00%,2,2,0.00%
vortex.data.microsoft.com,0,0.00%,18,18,0.00%
broker.miwifi.com,0,0.00%,37,37,0.00%
rq.upgrade.cmpc.cmcm.com,0,0.00%,24,24,0.00%
pcs-sdk-server.alibaba.com,0,0.00%,59,59,0.00%
dns.msftncsi.com,0,0.00%,216,216,0.00%
geo.prod.do.dsp.mp.microsoft.com,0,0.00%,12,12,0.00%
windows.policies.live.net,0,0.00%,3,3,0.00%
licensing.mp.microsoft.com,0,0.00%,7,7,0.00%
zhidao.baidu.com,0,0.00%,16,16,0.00%
h5.qzone.qq.com,0,0.00%,56,56,0.00%
weboffice.wpsdns.com,0,0.00%,2,2,0.00%
vasapi.wpsdns.com,0,0.00%,2,2,0.00%
proxy.client.163.com,0,0.00%,8,8,0.00%
crl.verisign.com,0,0.00%,11,11,0.00%
geoip.elastic.co,0,0.00%,2,2,0.00%
lbs.mail.163.com,0,0.00%,2,2,0.00%
time.windows.com,0,0.00%,11,11,0.00%
smartscreen-prod.microsoft.com,0,0.00%,56,56,0.00%
api.msn.com,0,0.00%,23,23,0.00%
array811.prod.do.dsp.mp.microsoft.com,0,0.00%,12,12,0.00%
update.huorong.cn,0,0.00%,9,9,0.00%
dns.google,0,0.00%,65,65,0.00%
api.zotero.org,0,0.00%,5,5,0.00%
bugreport.huorong.cn,0,0.00%,8,8,0.00%
www.google-analytics.com,0,0.00%,1,1,0.00%
gstatic.loli.net,0,0.00%,1,1,0.00%
time.nist.gov,0,0.00%,3,3,0.00%
high-frequency-gray.zhhainiao.com,0,0.00%,22,22,0.00%
edge-http.microsoft.com,0,0.00%,2,2,0.00%
authds.todesk.com,0,0.00%,6,6,0.00%
st.todesk.com,0,0.00%,21,21,0.00%
map.baidu.com,0,0.00%,6,6,0.00%
wechat.todesk.com,0,0.00%,5,5,0.00%
www.ximalaya.com,0,0.00%,2,2,0.00%
login.live.com,0,0.00%,32,32,0.00%
rubyfish.cn,0,0.00%,4,4,0.00%
8ehcb38y1u-dsn.algolia.net,0,0.00%,2,2,0.00%
fm.dl.126.net,0,0.00%,2,2,0.00%
crl.comodoca.com,0,0.00%,17,17,0.00%
cn-zjcm2.testfaj.top,0,0.00%,4,4,0.00%
im.dingtalk.com,0,0.00%,6,6,0.00%
rs1.qq.com,0,0.00%,25,25,0.00%
ts1.qq.com,0,0.00%,26,26,0.00%
rs2.qq.com,0,0.00%,30,30,0.00%
ts2.qq.com,0,0.00%,28,28,0.00%
dl-ovh01.amna.shop,0,0.00%,10,10,0.00%
doh.pub,0,0.00%,12,12,0.00%
az700632.vo.msecnd.net,0,0.00%,4,4,0.00%
boards.eu.greenhouse.io,0,0.00%,1,1,0.00%
edge.microsoft.com,0,0.00%,94,94,0.00%
sum.comment.service.kugou.com,0,0.00%,5,5,0.00%
kmrcdn.service.kugou.com,0,0.00%,2,2,0.00%
pc.service.kugou.com,0,0.00%,3,3,0.00%
entitlement-public-service-prod08.ol.epicgames.com,0,0.00%,2,2,0.00%
boards.cdn.greenhouse.io,0,0.00%,2,2,0.00%
s101-recruiting.cdn.greenhouse.io,0,0.00%,1,1,0.00%
www.bing.com,0,0.00%,45,45,0.00%
cn.bing.com,0,0.00%,22,22,0.00%
content.googleapis.com,0,0.00%,2,2,0.00%
www.telecommandsvc.microsoft.com,0,0.00%,2,2,0.00%
crl.sectigo.com,0,0.00%,4,4,0.00%
crl.usertrust.com,0,0.00%,8,8,0.00%
sv.symcb.com,0,0.00%,2,2,0.00%
ocsp.entrust.net,0,0.00%,18,18,0.00%
imap.qq.com,0,0.00%,19,19,0.00%
p3p.sogou.com,0,0.00%,38,38,0.00%
pc-plugin-plg.wpscdn.cn,0,0.00%,17,17,0.00%
hotlist.imtt.qq.com,0,0.00%,2,2,0.00%
qingcenter.wps.cn,0,0.00%,24,24,0.00%
account-public-service-prod03.ol.epicgames.com,0,0.00%,2,2,0.00%
i.163.com,0,0.00%,4,4,0.00%
catalog.gamepass.com,0,0.00%,4,4,0.00%
s.f.360.cn,0,0.00%,202,202,0.00%
stock.adobe.io,0,0.00%,4,4,0.00%
open.weixin.qq.com,0,0.00%,3,3,0.00%
res.wx.qq.com,0,0.00%,13,13,0.00%
tim.qq.com,0,0.00%,1,1,0.00%
switch.pcfg.cache.wpscdn.cn,0,0.00%,25,25,0.00%
shuc-pc-hunt.ksord.com,0,0.00%,33,33,0.00%
1min.pcfg.cache.wpscdn.cn,0,0.00%,5,5,0.00%
mmbiz.qpic.cn,0,0.00%,35,35,0.00%
t-safe.2345.com,0,0.00%,2,2,0.00%
wbapp.uve.weibo.com,0,0.00%,2,2,0.00%
gateway.im.weibo.cn,0,0.00%,1,1,0.00%
dp.im.weibo.cn,0,0.00%,1,1,0.00%
aps.amap.com,0,0.00%,14,14,0.00%
conn4.coloros.com,0,0.00%,3,3,0.00%
apd-pcdnwxlogin.teg.tencent-cloud.net,0,0.00%,14,14,0.00%
data.bilivideo.com,0,0.00%,2,2,0.00%
apd-pcdnwxstat.teg.tencent-cloud.net,0,0.00%,9,9,0.00%
conn3.coloros.com,0,0.00%,2,2,0.00%
android.bugly.qq.com,0,0.00%,8,8,0.00%
adashx.ut.dingtalk.com,0,0.00%,9,9,0.00%
ns01.freenom.com,0,0.00%,1,1,0.00%
am.abc.wdpdk.link,0,0.00%,2,2,0.00%
p.qlogo.cn,0,0.00%,3,3,0.00%
bkvv.video.qq.com,0,0.00%,3,3,0.00%
info.zb.qq.com,0,0.00%,1,1,0.00%
bk.info.zb.qq.com,0,0.00%,1,1,0.00%
rq.upgrade.cloud.duba.net,0,0.00%,11,11,0.00%
wx.mail.qq.com,0,0.00%,5,5,0.00%
sdk.e.qq.com,0,0.00%,3,3,0.00%
sdkapp.uve.weibo.com,0,0.00%,1,1,0.00%
wx4.sinaimg.cn,0,0.00%,1,1,0.00%
az764295.vo.msecnd.net,0,0.00%,11,11,0.00%
fedoraproject.org,0,0.00%,6,6,0.00%
myip.opendns.com,0,0.00%,1,1,0.00%
f.video.weibocdn.com,0,0.00%,3,3,0.00%
array606.prod.do.dsp.mp.microsoft.com,0,0.00%,1,1,0.00%
oth.eve.mdt.qq.com,0,0.00%,26,26,0.00%
f5-ck.zhhainiao.com,0,0.00%,13,13,0.00%
v20.events.data.microsoft.com,0,0.00%,17,17,0.00%
ecs.office.com,0,0.00%,24,24,0.00%
ipv4only.arpa,0,0.00%,11,11,0.00%
mpv6.weixin.qq.com,0,0.00%,1,1,0.00%
badjs.weixinbridge.com,0,0.00%,10,10,0.00%
arc.msn.com,0,0.00%,31,31,0.00%
ris.api.iris.microsoft.com,0,0.00%,21,21,0.00%
m8.music.126.net,0,0.00%,1,1,0.00%
crl4.digicert.com,0,0.00%,5,5,0.00%
ocsp.dcocsp.cn,0,0.00%,2,2,0.00%
123.sogou.com,0,0.00%,8,8,0.00%
docerad.wps.cn,0,0.00%,1,1,0.00%
account.wps.cn,0,0.00%,3,3,0.00%
doc.wps.cn,0,0.00%,1,1,0.00%
docs.wps.cn,0,0.00%,1,1,0.00%
docer.wps.cn,0,0.00%,4,4,0.00%
drive.wps.cn,0,0.00%,10,10,0.00%
home.wps.cn,0,0.00%,4,4,0.00%
qing.wps.cn,0,0.00%,32,32,0.00%
pan.wps.cn,0,0.00%,1,1,0.00%
wdl1.cache.wps.cn,0,0.00%,9,9,0.00%
vip.wps.cn,0,0.00%,6,6,0.00%
vasapi.wps.cn,0,0.00%,3,3,0.00%
roaming.wps.cn,0,0.00%,4,4,0.00%
wdl1.file.cache.docer.com,0,0.00%,5,5,0.00%
vipapi.wps.cn,0,0.00%,17,17,0.00%
app.wpscdn.cn,0,0.00%,2,2,0.00%
zw-roaming.wps.cn,0,0.00%,4,4,0.00%
dyn.wps.cn,0,0.00%,3,3,0.00%
tracker.wps.cn,0,0.00%,1,1,0.00%
ip.sb,0,0.00%,2,2,0.00%
dr.cs3.duba.net,0,0.00%,11,11,0.00%
api.geetest.com,0,0.00%,3,3,0.00%
api.weibo.cn,0,0.00%,1,1,0.00%
api.atlassian.com,0,0.00%,2,2,0.00%
bam.nr-data.net.cdn.cloudflare.net,0,0.00%,1,1,0.00%
resolver.msg.xiaomi.net,0,0.00%,2,2,0.00%
dw-online.ksosoft.com,0,0.00%,2,2,0.00%
contile.services.mozilla.com,0,0.00%,51,51,0.00%
tracker.foreverpirates.co,0,0.00%,4,4,0.00%
tracker.lilithraws.cf,0,0.00%,1,1,0.00%
array609.prod.do.dsp.mp.microsoft.com,0,0.00%,5,5,0.00%
outlookmobile-office365-tas.msedge.net,0,0.00%,1,1,0.00%
tva4.sinaimg.cn,0,0.00%,2,2,0.00%
v2.get.sogou.com,0,0.00%,9,9,0.00%
wx1.sinaimg.cn,0,0.00%,1,1,0.00%
wx3.sinaimg.cn,0,0.00%,2,2,0.00%
mail.google.com,0,0.00%,10,10,0.00%
mini.browser.360.cn,0,0.00%,13,13,0.00%
img.www.duba.net,0,0.00%,1,1,0.00%
detectportal.firefox.com,0,0.00%,72,72,0.00%
bam.nr-data.net,0,0.00%,27,27,0.00%
mail.cstnet.cn,0,0.00%,30,30,0.00%
dns.weixin.qq.com.cn,0,0.00%,59,59,0.00%
www.msftconnecttest.com,0,0.00%,11,11,0.00%
sat02pap002.storage.live.com,0,0.00%,1,1,0.00%
d23iz4esrwkib6.cloudfront.net,0,0.00%,2,2,0.00%
d.skconf.f.360.cn,0,0.00%,27,27,0.00%
short.weixin.qq.com,0,0.00%,14,14,0.00%
updates.logitech.com,0,0.00%,1,1,0.00%
smarthome.hicloud.com,0,0.00%,5,5,0.00%
metrics1.data.hicloud.com,0,0.00%,24,24,0.00%
mp.weixin.qq.com,0,0.00%,17,17,0.00%
example.org,0,0.00%,6,6,0.00%
bitbucket.org,0,0.00%,1,1,0.00%
m.comment.service.kugou.com,0,0.00%,1,1,0.00%
ip.kugou.com,0,0.00%,1,1,0.00%
imge.kugou.com,0,0.00%,1,1,0.00%
p13n.adobe.io,0,0.00%,4,4,0.00%
i.guancha.cn,0,0.00%,2,2,0.00%
nodestore.logitech.io,0,0.00%,3,3,0.00%
win1910.ipv6.microsoft.com,0,0.00%,7,7,0.00%
upext.chrome.360.cn,0,0.00%,2,2,0.00%
ex.qq.com,0,0.00%,9,9,0.00%
www.google.com,0,0.00%,46,46,0.00%
armmf.adobe.com,0,0.00%,2,2,0.00%
lhpay.gzcl999.com,0,0.00%,4,4,0.00%
sns-img-hw.xhscdn.com,0,0.00%,4,4,0.00%
wemeet-log-1256380422.cos.ap-guangzhou.myqcloud.com,0,0.00%,2,2,0.00%
t.khd.2345.cc,0,0.00%,28,28,0.00%
www.expressapisv2.net,0,0.00%,6,6,0.00%
data.ie.sogou.com,0,0.00%,1,1,0.00%
isure.stream.qqmusic.qq.com,0,0.00%,11,11,0.00%
sjy.stream.qqmusic.qq.com,0,0.00%,7,7,0.00%
aqqmusic.tc.qq.com,0,0.00%,7,7,0.00%
yun.tim.qq.com,0,0.00%,4,4,0.00%
r.avlab.qq.com,0,0.00%,2,2,0.00%
isure6.stream.qqmusic.qq.com,0,0.00%,5,5,0.00%
dig.lianjia.com,0,0.00%,10,10,0.00%
map.ke.com,0,0.00%,2,2,0.00%
dns01.bj.chinamobile.com,0,0.00%,2,2,0.00%
wup.imtt.qq.com,0,0.00%,8,8,0.00%
client.mail.163.com,0,0.00%,5,5,0.00%
caldav.163.com,0,0.00%,13,13,0.00%
foundation.youdao.com,0,0.00%,2,2,0.00%
education-certification.youdao.com,0,0.00%,2,2,0.00%
gorgon.youdao.com,0,0.00%,2,2,0.00%
ulogs.umeng.com,0,0.00%,2,2,0.00%
ydpushserver.youdao.com,0,0.00%,2,2,0.00%
events-drcn.op.dbankcloud.cn,0,0.00%,6,6,0.00%
22-courier.push.apple.com,0,0.00%,5,5,0.00%
cidian.youdao.com,0,0.00%,8,8,0.00%
wow.youdao.com,0,0.00%,2,2,0.00%
metrics1-drcn.dt.dbankcloud.cn,0,0.00%,9,9,0.00%
wow-activity.youdao.com,0,0.00%,2,2,0.00%
apple.com,0,0.00%,23,23,0.00%
time.g.aaplimg.com,0,0.00%,12,12,0.00%
mcs.zijieapi.com,0,0.00%,2,2,0.00%
mon.zijieapi.com,0,0.00%,41,41,0.00%
i.snssdk.com,0,0.00%,4,4,0.00%
imgcache.qq.com,0,0.00%,1,1,0.00%
cloud.browser.360.cn,0,0.00%,5,5,0.00%
galaxy.safe.360.cn,0,0.00%,2,2,0.00%
officeclient.microsoft.com,0,0.00%,8,8,0.00%
puv.tt.browser.360.cn,0,0.00%,7,7,0.00%
udpcache.gnvip.net,0,0.00%,1,1,0.00%
tsearch.snssdk.com,0,0.00%,1,1,0.00%
www.toutiao.com,0,0.00%,2,2,0.00%
nexus.officeapps.live.com,0,0.00%,13,13,0.00%
qdun-data.qq.com,0,0.00%,1,1,0.00%
qd-update.qq.com,0,0.00%,1,1,0.00%
www.csdn.net,0,0.00%,65,65,0.00%
finder.video.qq.com,0,0.00%,2,2,0.00%
cd001.www.duba.net,0,0.00%,2,2,0.00%
passport.escience.cn,0,0.00%,5,5,0.00%
bj.lianjia.com,0,0.00%,2,2,0.00%
dlswbr.baidu.com,0,0.00%,4,4,0.00%
s1.ljcdn.com,0,0.00%,1,1,0.00%
api.safe.360.cn,0,0.00%,34,34,0.00%
p14.d.meituan.net,0,0.00%,2,2,0.00%
o3.d.meituan.net,0,0.00%,1,1,0.00%
ajax.api.lianjia.com,0,0.00%,2,2,0.00%
image1.ljcdn.com,0,0.00%,1,1,0.00%
dsum.casalemedia.com,0,0.00%,1,1,0.00%
ex.lianjia.com,0,0.00%,2,2,0.00%
fonts.gstatic.com,0,0.00%,1,1,0.00%
btrace.qq.com,0,0.00%,42,42,0.00%
szlong.weixin.qq.com,0,0.00%,6,6,0.00%
sync.readcube.com.herokudns.com,0,0.00%,3,3,0.00%
services.readcube.com.herokudns.com,0,0.00%,3,3,0.00%
ocsp2-lb.apple.com.akadns.net,0,0.00%,3,3,0.00%
software.drivergenius.com,0,0.00%,4,4,0.00%
wx.gtimg.com,0,0.00%,2,2,0.00%
substrate.office.com,0,0.00%,13,13,0.00%
pconf.f.360.cn,0,0.00%,10,10,0.00%
mobile.pipe.aria.microsoft.com,0,0.00%,7,7,0.00%
u6.y.qq.com,0,0.00%,2,2,0.00%
guzzoni.apple.com,0,0.00%,1,1,0.00%
ocsp2.apple.com,0,0.00%,4,4,0.00%
mesu.g.aaplimg.com,0,0.00%,4,4,0.00%
message-center-statis.chuxingyouhui.com,0,0.00%,1,1,0.00%
wxpaylogo.qpic.cn,0,0.00%,1,1,0.00%
waconafd.officeapps.live.com,0,0.00%,3,3,0.00%
dpmtpush.dianping.com,0,0.00%,2,2,0.00%
acdc-direct.office.com,0,0.00%,4,4,0.00%
npay.meituan.com,0,0.00%,1,1,0.00%
upload.fp.measure.office.com,0,0.00%,5,5,0.00%
alert-cn.battlenet.com.cn,0,0.00%,7,7,0.00%
gsp0.baidu.com,0,0.00%,2,2,0.00%
weather-drcn.music.dbankcloud.cn,0,0.00%,4,4,0.00%
szminorshort.weixin.qq.com,0,0.00%,7,7,0.00%
market-fin.meituan.com,0,0.00%,1,1,0.00%
a2p-s01-drcn.cloud.dbankcloud.cn,0,0.00%,4,4,0.00%
mgm.meituan.com,0,0.00%,1,1,0.00%
1126359.sched.skalego-dk.tdnsstic1.cn,0,0.00%,2,2,0.00%
mlminorshort.weixin.qq.com,0,0.00%,1,1,0.00%
hm.baidu.com,0,0.00%,16,16,0.00%
ipv4-ipv6-phase4.wpt-portm.vip.meituan.com,0,0.00%,2,2,0.00%
res.servicewechat.com,0,0.00%,1,1,0.00%
e10499.dsce9.akamaiedge.net,0,0.00%,2,2,0.00%
dispatcher.is.autonavi.com,0,0.00%,1,1,0.00%
gspe35-ssl.ls.apple.com,0,0.00%,1,1,0.00%
gspe19-cn-ssl.ls.apple.com.download.ks-cdn.com,0,0.00%,1,1,0.00%
vip.foxitreader.cn,0,0.00%,2,2,0.00%
ping-edge.smartscreen.microsoft.com,0,0.00%,3,3,0.00%
metrics-picture.dreport.meituan.net,0,0.00%,1,1,0.00%
4e3fbc91775832759f33b21e514bb29c.dlied1.cdntips.net,0,0.00%,1,1,0.00%
mlextshort.weixin.qq.com,0,0.00%,3,3,0.00%
imapi.lianjia.com,0,0.00%,4,4,0.00%
y.gtimg.cn,0,0.00%,3,3,0.00%
api.apple-cloudkit.com,0,0.00%,3,3,0.00%
api.apple-cloudkit.fe.apple-dns.net,0,0.00%,2,2,0.00%
in1-gw2-02-ce7dd027.eastus2.cloudapp.azure.com,0,0.00%,2,2,0.00%
a.sh.vip.dianping.com,0,0.00%,2,2,0.00%
gitee.com,0,0.00%,6,6,0.00%
wm.xiajunhuagong.cn,0,0.00%,2,2,0.00%
exmail.qq.com,0,0.00%,3,3,0.00%
in.appcenter.ms,0,0.00%,8,8,0.00%
c.gsc.qq.com,0,0.00%,2,2,0.00%
qqadapt.qpic.cn,0,0.00%,2,2,0.00%
cdn.ark.qq.com,0,0.00%,2,2,0.00%
f8ed5d21a44b0e58.jijifun.com,0,0.00%,1,1,0.00%
ugc.qpic.cn,0,0.00%,2,2,0.00%
midinfo.baofeng.com,0,0.00%,2,2,0.00%
agd2.p.360.cn,0,0.00%,2,2,0.00%
v2.shyonghui.xyz,0,0.00%,2,2,0.00%
inappcheck.itunes.apple.com,0,0.00%,3,3,0.00%
gap.work.weixin.qq.com,0,0.00%,3,3,0.00%
wwcdn.weixin.qq.com,0,0.00%,4,4,0.00%
ossimg.hitv.com,0,0.00%,1,1,0.00%
softcenter-all.os.nfschina.com,0,0.00%,5,5,0.00%
tencent-i.work.weixin.qq.com,0,0.00%,3,3,0.00%
srtb.msn.com,0,0.00%,7,7,0.00%
static-xl.a.88cdn.com,0,0.00%,2,2,0.00%
c.msn.cn,0,0.00%,9,9,0.00%
browser.events.data.msn.cn,0,0.00%,9,9,0.00%
i.work.weixin.qq.com,0,0.00%,2,2,0.00%
c.bing.com,0,0.00%,9,9,0.00%
locini.gslb.360safe.com,0,0.00%,1,1,0.00%
www.weather.com.cn,0,0.00%,1,1,0.00%
deff.nelreports.net,0,0.00%,5,5,0.00%
fclick.baidu.com,0,0.00%,14,14,0.00%
functional.events.data.microsoft.com,0,0.00%,6,6,0.00%
i.tq121.com.cn,0,0.00%,1,1,0.00%
hector.baidu.com,0,0.00%,4,4,0.00%
pic.weather.com.cn,0,0.00%,1,1,0.00%
i.weather.com.cn,0,0.00%,1,1,0.00%
translate.google.com,0,0.00%,4,4,0.00%
wgeo.weather.com.cn,0,0.00%,1,1,0.00%
d1.weather.com.cn,0,0.00%,1,1,0.00%
ntp.msn.cn,0,0.00%,8,8,0.00%
c.msn.com,0,0.00%,3,3,0.00%
h-adashx-internal.ut.taobao.com.gds.alibabadns.com,0,0.00%,1,1,0.00%
apd-pcdnwxnat.teg.tencent-cloud.net,0,0.00%,7,7,0.00%
time-ios.g.aaplimg.com,0,0.00%,3,3,0.00%
cgicol.amap.com,0,0.00%,15,15,0.00%
news.sohu.com,0,0.00%,1,1,0.00%
statics.itc.cn,0,0.00%,1,1,0.00%
sucimg.itc.cn,0,0.00%,1,1,0.00%
39d0825d09f05.cdn.sohucs.com,0,0.00%,2,2,0.00%
txt.go.sohu.com,0,0.00%,1,1,0.00%
images.sohu.com,0,0.00%,1,1,0.00%
js.sohu.com,0,0.00%,1,1,0.00%
www.sohu.com,0,0.00%,2,2,0.00%
cpro.baidustatic.com,0,0.00%,3,3,0.00%
acg.sohu.com,0,0.00%,1,1,0.00%
astro.sohu.com,0,0.00%,1,1,0.00%
auto.sohu.com,0,0.00%,1,1,0.00%
p10.d.meituan.net,0,0.00%,1,1,0.00%
baobao.sohu.com,0,0.00%,1,1,0.00%
business.sohu.com,0,0.00%,1,1,0.00%
cul.sohu.com,0,0.00%,1,1,0.00%
fashion.sohu.com,0,0.00%,1,1,0.00%
fun.sohu.com,0,0.00%,1,1,0.00%
dc.services.visualstudio.com,0,0.00%,8,8,0.00%
game.sohu.com,0,0.00%,1,1,0.00%
healthnews.sohu.com,0,0.00%,1,1,0.00%
history.sohu.com,0,0.00%,1,1,0.00%
it.sohu.com,0,0.00%,1,1,0.00%
learning.sohu.com,0,0.00%,1,1,0.00%
track.sohu.com,0,0.00%,1,1,0.00%
mil.sohu.com,0,0.00%,1,1,0.00%
mp.sohu.com,0,0.00%,1,1,0.00%
sports.sohu.com,0,0.00%,1,1,0.00%
pets.sohu.com,0,0.00%,1,1,0.00%
travel.sohu.com,0,0.00%,1,1,0.00%
buy.itunes-apple.com.akadns.net,0,0.00%,2,2,0.00%
yule.sohu.com,0,0.00%,1,1,0.00%
shang.qq.com,0,0.00%,1,1,0.00%
p6.itc.cn,0,0.00%,1,1,0.00%
pv.sohu.com,0,0.00%,10,10,0.00%
www.focus.cn,0,0.00%,1,1,0.00%
v2.sohu.com,0,0.00%,1,1,0.00%
www.microsoft.com,0,0.00%,5,5,0.00%
cis.sohu.com,0,0.00%,1,1,0.00%
search.sohu.com,0,0.00%,1,1,0.00%
api.interaction.sohu.com,0,0.00%,1,1,0.00%
p3.itc.cn,0,0.00%,1,1,0.00%
p2.itc.cn,0,0.00%,2,2,0.00%
fbp.sohu.com,0,0.00%,1,1,0.00%
service.weibo.com,0,0.00%,1,1,0.00%
sns.qzone.qq.com,0,0.00%,1,1,0.00%
imp.optaim.com,0,0.00%,1,1,0.00%
v4.passport.sohu.com,0,0.00%,1,1,0.00%
qpb0.sohu.com,0,0.00%,1,1,0.00%
apiv2.sohu.com,0,0.00%,1,1,0.00%
s.go.sohu.com,0,0.00%,1,1,0.00%
p5.itc.cn,0,0.00%,1,1,0.00%
03e1181bba1cf.cdn.sohucs.com,0,0.00%,1,1,0.00%
p9.itc.cn,0,0.00%,1,1,0.00%
p1.itc.cn,0,0.00%,1,1,0.00%
h5-ol.sns.sohu.com,0,0.00%,1,1,0.00%
p0.itc.cn,0,0.00%,1,1,0.00%
p4.itc.cn,0,0.00%,1,1,0.00%
passport.sohu.com,0,0.00%,1,1,0.00%
zt.pinglun.sohu.com,0,0.00%,1,1,0.00%
imp.go.sohu.com,0,0.00%,1,1,0.00%
i.go.sohu.com,0,0.00%,1,1,0.00%
t.go.sohu.com,0,0.00%,1,1,0.00%
w.irs03.com,0,0.00%,1,1,0.00%
643108e7617ef.cdn.sohucs.com,0,0.00%,1,1,0.00%
push.zhanzhang.baidu.com,0,0.00%,1,1,0.00%
lf1-cdn-tos.bytegoofy.com,0,0.00%,1,1,0.00%
sem.17zhuangxiu.cn,0,0.00%,1,1,0.00%
pos.baidu.com,0,0.00%,2,2,0.00%
api.share.baidu.com,0,0.00%,1,1,0.00%
zhanzhang.toutiao.com,0,0.00%,1,1,0.00%
ssl.ptlogin2.graph.qq.com,0,0.00%,11,11,0.00%
wn.pos.baidu.com,0,0.00%,3,3,0.00%
lupic.cdn.bcebos.com,0,0.00%,1,1,0.00%
tconf.f.360.cn,0,0.00%,20,20,0.00%
user.qzone.qq.com,0,0.00%,2,2,0.00%
ptlogin2.qzone.qq.com,0,0.00%,2,2,0.00%
ssl.ptlogin2.qq.com,0,0.00%,2,2,0.00%
qzonestyle.gtimg.cn,0,0.00%,2,2,0.00%
i.gdt.qq.com,0,0.00%,4,4,0.00%
stdl.qq.com,0,0.00%,2,2,0.00%
eclick.baidu.com,0,0.00%,4,4,0.00%
ssl.ptlogin2.mail.qq.com,0,0.00%,2,2,0.00%
mail.qq.com,0,0.00%,6,6,0.00%
connectivitycheck.platform.hicloud.com,0,0.00%,14,14,0.00%
cdn.content.prod.cms.msn.com,0,0.00%,1,1,0.00%
m.black-unique.com,0,0.00%,1,1,0.00%
rescdn.qqmail.com,0,0.00%,2,2,0.00%
rl.mail.qq.com,0,0.00%,2,2,0.00%
js.aq.qq.com,0,0.00%,2,2,0.00%
sv.aq.qq.com,0,0.00%,2,2,0.00%
connectivitycheck.cbg-app.huawei.com,0,0.00%,5,5,0.00%
img-prod-cms-rt-microsoft-com.akamaized.net,0,0.00%,2,2,0.00%
th.bing.com,0,0.00%,4,4,0.00%
wp.mail.qq.com,0,0.00%,4,4,0.00%
unionsug.baidu.com,0,0.00%,1,1,0.00%
www.notion.so,0,0.00%,6,6,0.00%
itunes.apple.com.edgekey.net,0,0.00%,1,1,0.00%
musicstatus.edge-itunes-apple.com.akadns.net,0,0.00%,1,1,0.00%
xp.apple.com.edgekey.net,0,0.00%,1,1,0.00%
ecn.dev.ditu.live.com,0,0.00%,6,6,0.00%
p0.meituan.net,0,0.00%,1,1,0.00%
www.meituan.com,0,0.00%,1,1,0.00%
o1.d.meituan.net,0,0.00%,1,1,0.00%
p1.meituan.net,0,0.00%,1,1,0.00%
imap.exmail.qq.com,0,0.00%,3,3,0.00%
addonlist.sync.maxthon.cn,0,0.00%,1,1,0.00%
tieba.baidu.com,0,0.00%,3,3,0.00%
mmbiz.qlogo.cn,0,0.00%,2,2,0.00%
tb5.bdstatic.com,0,0.00%,1,1,0.00%
passport.baidu.com,0,0.00%,8,8,0.00%
tb3.bdstatic.com,0,0.00%,1,1,0.00%
nsclick.baidu.com,0,0.00%,3,3,0.00%
tb1.bdstatic.com,0,0.00%,1,1,0.00%
imgsa.baidu.com,0,0.00%,1,1,0.00%
sofire.bdstatic.com,0,0.00%,1,1,0.00%
tbmsg.baidu.com,0,0.00%,1,1,0.00%
ecma.bdimg.com,0,0.00%,1,1,0.00%
tieba-ares.cdn.bcebos.com,0,0.00%,1,1,0.00%
als.baidu.com,0,0.00%,1,1,0.00%
sfp.safe.baidu.com,0,0.00%,2,2,0.00%
tiebapic.baidu.com,0,0.00%,1,1,0.00%
tb2.bdstatic.com,0,0.00%,1,1,0.00%
k5-v6-meituan.gslb.ksyuncdn.com,0,0.00%,1,1,0.00%
ns-strategy.cdn.bcebos.com,0,0.00%,1,1,0.00%
gss0.bdstatic.com,0,0.00%,1,1,0.00%
miao.baidu.com,0,0.00%,6,6,0.00%
sofire.baidu.com,0,0.00%,1,1,0.00%
ada.baidu.com,0,0.00%,1,1,0.00%
music.91q.com,0,0.00%,1,1,0.00%
task.browser.360.cn,0,0.00%,7,7,0.00%
resources.jetbrains.com,0,0.00%,1,1,0.00%
prod.fus.aws.intellij.net,0,0.00%,1,1,0.00%
apiexp.open.kingdee.com,0,0.00%,1,1,0.00%
darkreader.github.io,0,0.00%,3,3,0.00%
darkreader.org,0,0.00%,3,3,0.00%
update100.sangfor.com.cn,0,0.00%,6,6,0.00%
cloud.huawei.com,0,0.00%,2,2,0.00%
anv.duba.net,0,0.00%,5,5,0.00%
passport.bdimg.com,0,0.00%,1,1,0.00%
gomediago.baidu.com,0,0.00%,1,1,0.00%
rm.api.weibo.com,0,0.00%,14,14,0.00%
show-3.mediav.com,0,0.00%,1,1,0.00%
wappass.baidu.com,0,0.00%,2,2,0.00%
api.aliyundrive.com,0,0.00%,11,11,0.00%
s3m4.fenxi.com,0,0.00%,1,1,0.00%
mediago-static.cdn.bcebos.com,0,0.00%,1,1,0.00%
channels.weixin.qq.com,0,0.00%,1,1,0.00%
client.uu.me,0,0.00%,1,1,0.00%
vm.gtimg.cn,0,0.00%,15,15,0.00%
asimov.vortex.data.trafficmanager.net,0,0.00%,1,1,0.00%
bsg.w.bilicdn1.com,0,0.00%,1,1,0.00%
xui.ptlogin2.qq.com,0,0.00%,15,15,0.00%
graph.qq.com,0,0.00%,14,14,0.00%
fanyi.youdao.com,0,0.00%,2,2,0.00%
rq.cct.cloud.duba.net,0,0.00%,14,14,0.00%
node.video.qq.com,0,0.00%,13,13,0.00%
s3.amazonaws.com,0,0.00%,2,2,0.00%
access.video.qq.com,0,0.00%,15,15,0.00%
hp3.mail.netease.com,0,0.00%,7,7,0.00%
cr.file.cloud.duba.net,0,0.00%,3,3,0.00%
sconf.f.360.cn,0,0.00%,20,20,0.00%
cl.vd.f.360.cn,0,0.00%,40,40,0.00%
init.push.apple.com,0,0.00%,1,1,0.00%
stat.sd.360.cn,0,0.00%,6,6,0.00%
iaas.wps.cn,0,0.00%,3,3,0.00%
docer-api.kdocs.cn,0,0.00%,3,3,0.00%
docer.kdocs.cn,0,0.00%,3,3,0.00%
lucky.wps.cn,0,0.00%,3,3,0.00%
sms.wps.cn,0,0.00%,2,2,0.00%
kdocs.cn,0,0.00%,5,5,0.00%
geo.wps.cn,0,0.00%,5,5,0.00%
avatar.qwps.cn,0,0.00%,3,3,0.00%
pay.wps.cn,0,0.00%,9,9,0.00%
common.docer.wps.cn,0,0.00%,2,2,0.00%
33.courier-push-apple.com.akadns.net,0,0.00%,1,1,0.00%
p7.itc.cn,0,0.00%,1,1,0.00%
p8.itc.cn,0,0.00%,1,1,0.00%
assp.sohu.com,0,0.00%,1,1,0.00%
update.pan.baidu.com,0,0.00%,11,11,0.00%
win10.ipv6.microsoft.com,0,0.00%,42,42,0.00%
vinci.ie.sogou.com,0,0.00%,3,3,0.00%
sp2.baidu.com,0,0.00%,4,4,0.00%
wan.sogou.com,0,0.00%,2,2,0.00%
mbd.baidu.com,0,0.00%,3,3,0.00%
pushtrs.push.hicloud.com,0,0.00%,6,6,0.00%
package.dingtalk.com,0,0.00%,2,2,0.00%
www.jos.org.cn,0,0.00%,1,1,0.00%
ovo.cn2.llsmall.com,0,0.00%,11,11,0.00%
ex.exmail.qq.com,0,0.00%,1,1,0.00%
bkssl.bdimg.com,0,0.00%,2,2,0.00%
mapsp0.bdimg.com,0,0.00%,2,2,0.00%
fc4tn.baidu.com,0,0.00%,2,2,0.00%
dss3.baidu.com,0,0.00%,2,2,0.00%
t14.baidu.com,0,0.00%,6,6,0.00%
t15.baidu.com,0,0.00%,6,6,0.00%
cambrian-images.cdn.bcebos.com,0,0.00%,2,2,0.00%
fc5tn.baidu.com,0,0.00%,2,2,0.00%
www.kdocs.cn,0,0.00%,4,4,0.00%
zt.wps.cn,0,0.00%,1,1,0.00%
softbus-device.wps.cn,0,0.00%,5,5,0.00%
aflow.dingtalk.com,0,0.00%,2,2,0.00%
www.atguigu.com,0,0.00%,2,2,0.00%
pcmgrmonitor.3g.qq.com,0,0.00%,1,1,0.00%
cronus.ie.sogou.com,0,0.00%,2,2,0.00%
aqyzmedia.yunaq.com,0,0.00%,2,2,0.00%
tb.53kf.com,0,0.00%,2,2,0.00%
www.gulixueyuan.com,0,0.00%,2,2,0.00%
www.itdachang.com,0,0.00%,2,2,0.00%
www.mobiletrain.org,0,0.00%,2,2,0.00%
s.union.360.cn,0,0.00%,2,2,0.00%
v.yunaq.com,0,0.00%,2,2,0.00%
360fenxi.mediav.com,0,0.00%,2,2,0.00%
e.so.com,0,0.00%,1,1,0.00%
www13.53kf.com,0,0.00%,2,2,0.00%
accwww13.53kf.com,0,0.00%,2,2,0.00%
tjs.sjs.sinajs.cn,0,0.00%,2,2,0.00%
pti.store.microsoft.com,0,0.00%,1,1,0.00%
cpro.baidu.com,0,0.00%,2,2,0.00%
online.user.maxthon.cn,0,0.00%,1,1,0.00%
js1.pcfg.cache.wpscdn.cn,0,0.00%,5,5,0.00%
retcode.alicdn.com,0,0.00%,2,2,0.00%
arms-retcode.aliyuncs.com,0,0.00%,2,2,0.00%
ts3.cn.mm.bing.net,0,0.00%,6,6,0.00%
ts4.cn.mm.bing.net,0,0.00%,2,2,0.00%
login.microsoftonline.com,0,0.00%,6,6,0.00%
bingciservice.koreasouth.cloudapp.azure.com,0,0.00%,2,2,0.00%
gm.mmstat.com,0,0.00%,4,4,0.00%
filesys.53kf.com,0,0.00%,2,2,0.00%
www2.bing.com,0,0.00%,2,2,0.00%
retcode.taobao.com,0,0.00%,2,2,0.00%
wenku.baidu.com,0,0.00%,3,3,0.00%
edu-wenku.bdimg.com,0,0.00%,1,1,0.00%
wkstatic.bdimg.com,0,0.00%,1,1,0.00%
wkretype.bdimg.com,0,0.00%,1,1,0.00%
wkbjcloudbos.bdimg.com,0,0.00%,1,1,0.00%
startpage.ic.ksosoft.com,0,0.00%,1,1,0.00%
wk-journal.cdn.bcebos.com,0,0.00%,1,1,0.00%
wkctj.baidu.com,0,0.00%,1,1,0.00%
wkdsp.baidu.com,0,0.00%,1,1,0.00%
bj.bcebos.com,0,0.00%,1,1,0.00%
aefd.nelreports.net,0,0.00%,4,4,0.00%
openapp.wpscdn.cn,0,0.00%,1,1,0.00%
flow.wps.cn,0,0.00%,1,1,0.00%
pc-plugin.wpscdn.cn,0,0.00%,1,1,0.00%
site.browser.360.cn,0,0.00%,1,1,0.00%
learning.u.wpscdn.cn,0,0.00%,1,1,0.00%
infoc0.duba.net,0,0.00%,6,6,0.00%
tconf.b.qianxin.com,0,0.00%,6,6,0.00%
vip-rec.ksord.com,0,0.00%,3,3,0.00%
loc.map.baidu.com,0,0.00%,17,17,0.00%
openlocation-drcn.platform.dbankcloud.com,0,0.00%,9,9,0.00%
umini.shujupie.com,0,0.00%,1,1,0.00%
s1.url.cn,0,0.00%,2,2,0.00%
iphone-ld.apple.com,0,0.00%,5,5,0.00%
migration-geo-filter-prd.stargate.cse.ss-inf.net,0,0.00%,4,4,0.00%
normandy.cdn.mozilla.net,0,0.00%,12,12,0.00%
classify-client.services.mozilla.com,0,0.00%,12,12,0.00%
prod-classifyclient.normandy.prod.cloudops.mozgcp.net,0,0.00%,4,4,0.00%
repos.os.nfschina.com,0,0.00%,2,2,0.00%
api.snapcraft.io,0,0.00%,42,42,0.00%
xlbrowsersdk.rcv.sandai.net,0,0.00%,2,2,0.00%
vscode-sync.trafficmanager.net,0,0.00%,8,8,0.00%
dldir1.qq.com,0,0.00%,14,14,0.00%
www.dadiyouhui01.cn,0,0.00%,10,10,0.00%
eeth9boh.nodedata.net,0,0.00%,8,8,0.00%
finance.services.appex.cn.bing.com,0,0.00%,4,4,0.00%
weatherredirectionweu01.cloudapp.net,0,0.00%,2,2,0.00%
gateway.lianjia.com,0,0.00%,4,4,0.00%
mail.iie.ac.cn,0,0.00%,6,6,0.00%
www.tnas.online,0,0.00%,2,2,0.00%
32-courier.push.apple.com,0,0.00%,4,4,0.00%
api.live.net,0,0.00%,2,2,0.00%
g.live.com,0,0.00%,8,8,0.00%
secure.wlxrs.com,0,0.00%,1,1,0.00%
bay405-m.hotmail.com,0,0.00%,2,2,0.00%
hub5pnc.sandai.net,0,0.00%,12,12,0.00%
db.local.clamav.net,0,0.00%,46,46,0.00%
www.overleaf.com,0,0.00%,1,1,0.00%
edu.ntp.org.cn,0,0.00%,2,2,0.00%
ntp1.aliyun.com,0,0.00%,2,2,0.00%
time1.cloud.tencent.com,0,0.00%,6,6,0.00%
database.clamav.net,0,0.00%,15,15,0.00%
feelchat2.virbox.com,0,0.00%,2,2,0.00%
rcv4.xldw.n0808.com,0,0.00%,2,2,0.00%
mtalk.google.com,0,0.00%,9,9,0.00%
speed.live.360.cn,0,0.00%,2,2,0.00%
q3.jia.360.cn,0,0.00%,2,2,0.00%
configserver.hicloud.com,0,0.00%,8,8,0.00%
dp.push.dc.360.cn,0,0.00%,2,2,0.00%
p.s.360.cn,0,0.00%,2,2,0.00%
dnkeeper.platform.dbankcloud.cn,0,0.00%,14,14,0.00%
store-drcn.hispace.dbankcloud.cn,0,0.00%,4,4,0.00%
tsms-drcn.platform.dbankcloud.com,0,0.00%,2,2,0.00%
tsms-drcn.security.dbankcloud.cn,0,0.00%,2,2,0.00%
rms-drcn.platform.dbankcloud.cn,0,0.00%,2,2,0.00%
gameplay.intel.com,0,0.00%,4,4,0.00%
mozilla.cloudflare-dns.com,0,0.00%,6,6,0.00%
alt5-mtalk.google.com,0,0.00%,2,2,0.00%
log.caxa.com,0,0.00%,2,2,0.00%
48afe871-i.andns.co,0,0.00%,2,2,0.00%
ipcmaster-sh-7days.shanghai.xstore.qihu.com,0,0.00%,2,2,0.00%
api-drcn.theme.dbankcloud.cn,0,0.00%,1,1,0.00%
yungw.taobao.com,0,0.00%,1,1,0.00%
th-a.pinduoduo.com,0,0.00%,4,4,0.00%
hiboardng.hicloud.com,0,0.00%,2,2,0.00%
dnkeeper.hicloud.com,0,0.00%,2,2,0.00%
app.biliapi.net,0,0.00%,1,1,0.00%
api.biliapi.net,0,0.00%,2,2,0.00%
debug.anuson.com,0,0.00%,8,8,0.00%
ins-j3fgveac.ias.tencent-cloud.net,0,0.00%,2,2,0.00%
sp.sangfor.com.cn,0,0.00%,83,83,0.00%
clientnotification-userprodea1-6.servicebus.windows.net,0,0.00%,1,1,0.00%
applog.uc.cn,0,0.00%,4,4,0.00%
trc.taboola.com,0,0.00%,2,2,0.00%
goldengate.grammarly.com,0,0.00%,8,8,0.00%
dlgzith499dss.cloudfront.net,0,0.00%,1,1,0.00%
images.taboola.com,0,0.00%,2,2,0.00%
boot-01.net.anydesk.com,0,0.00%,20,20,0.00%
policy.ccs.mcafee.com,0,0.00%,4,4,0.00%
www.scumall.com,0,0.00%,26,26,0.00%
www.oray.com,0,0.00%,36,36,0.00%
tkysenwhezsrteagubzihkhhxcbhhsyc.yundunwaf1.com,0,0.00%,33,33,0.00%
skydrive.wns.windows.com,0,0.00%,2,2,0.00%
c2.pcs.baidu.com,0,0.00%,8,8,0.00%
auth.sangfor.com.cn,0,0.00%,75,75,0.00%
a.root-servers.net,0,0.00%,86,86,0.00%
dsm01pap004.storage.live.com,0,0.00%,1,1,0.00%
sdk-open-phone.getui.com,0,0.00%,4,4,0.00%
dns1.registrar-servers.com,0,0.00%,2,2,0.00%
ali-bj-pcdn-10.biliapi.net,0,0.00%,2,2,0.00%
d.pcs.baidu.com,0,0.00%,7,7,0.00%
p.f.360.cn,0,0.00%,18,18,0.00%
agdist-api.cloud.huawei.com,0,0.00%,4,4,0.00%
activity.windows.com,0,0.00%,4,4,0.00%
www.gravatar.com,0,0.00%,1,1,0.00%
mdn.alipay.com,0,0.00%,1,1,0.00%
entphz.alipay.com,0,0.00%,2,2,0.00%
router9.teamviewer.com,0,0.00%,9,9,0.00%
www.doc88.com,0,0.00%,3,3,0.00%
mv6.music.tc.qq.com,0,0.00%,2,2,0.00%
policyorchestration.ccs.mcafee.com,0,0.00%,1,1,0.00%
pcoma.qq.com,0,0.00%,8,8,0.00%
win8.ipv6.microsoft.com,0,0.00%,3,3,0.00%
webpush.wx.qq.com,0,0.00%,6,6,0.00%
connectivity.pod1.avatar.ext.hp.com,0,0.00%,1,1,0.00%
connc.gj.qq.com,0,0.00%,2,2,0.00%
oth.str.mdt.qq.com,0,0.00%,4,4,0.00%
sdkapp.mobile.sina.cn,0,0.00%,4,4,0.00%
weibo.cn,0,0.00%,3,3,0.00%
yun-hl.3g.qq.com,0,0.00%,11,11,0.00%
docs.qq.com,0,0.00%,12,12,0.00%
quay.io,0,0.00%,8,8,0.00%
login.sina.com.cn,0,0.00%,4,4,0.00%
amdc.alipay.com,0,0.00%,1,1,0.00%
sdkaction.biz.weibo.com,0,0.00%,3,3,0.00%
sdkmonitor.biz.weibo.com,0,0.00%,4,4,0.00%
adstrategy.biz.weibo.com,0,0.00%,4,4,0.00%
context-enroll.ccs.mcafee.com,0,0.00%,2,2,0.00%
report.nfa.qq.com,0,0.00%,2,2,0.00%
mtt.eve.mdt.qq.com,0,0.00%,2,2,0.00%
messaging.ccs.mcafee.com,0,0.00%,2,2,0.00%
sdkclick.biz.weibo.com,0,0.00%,2,2,0.00%
3gimg.qq.com,0,0.00%,1,1,0.00%
qqdata.ab.qq.com,0,0.00%,10,10,0.00%
wbapp.mobile.sina.cn,0,0.00%,3,3,0.00%
rmonitor.qq.com,0,0.00%,8,8,0.00%
configsvr.msf.3g.qq.com,0,0.00%,7,7,0.00%
tangram-config.gdt.qq.com,0,0.00%,1,1,0.00%
aeventlog.beacon.qq.com,0,0.00%,2,2,0.00%
extshort.weixin.qq.com,0,0.00%,56,56,0.00%
socm.dmp.360.cn,0,0.00%,13,13,0.00%
ipv4.tracker.harry.lu,0,0.00%,2,2,0.00%
tracker.leechers-paradise.org,0,0.00%,2,2,0.00%
retracker.nts.su,0,0.00%,2,2,0.00%
ssl.look.360.cn,0,0.00%,4,4,0.00%
www.gstatic.com,0,0.00%,4,4,0.00%
pubsub02.oray.net,0,0.00%,21,21,0.00%
fe2cr.update.microsoft.com,0,0.00%,8,8,0.00%
restapi.amap.com,0,0.00%,2,2,0.00%
hkb.cloudnnnn.com,0,0.00%,34,34,0.00%
logbak.hicloud.com,0,0.00%,2,2,0.00%
p204-contacts.icloud.com.cn,0,0.00%,2,2,0.00%
long.weixin.qq.com,0,0.00%,6,6,0.00%
sdkserver-drcn.op.dbankcloud.cn,0,0.00%,4,4,0.00%
pop.qq.com,0,0.00%,4,4,0.00%
softcenter.os3.win.nfschina.com,0,0.00%,15,15,0.00%
api.wandb.ai,0,0.00%,74,74,0.00%
tiebacchunwan.n.shifen.com,0,0.00%,2,2,0.00%
aaid.umeng.com,0,0.00%,8,8,0.00%
maps.windows.com,0,0.00%,2,2,0.00%
28-courier.push.apple.com,0,0.00%,4,4,0.00%
alsg-new.linyeming.pub,0,0.00%,4,4,0.00%
fe3cr.delivery.mp.microsoft.com,0,0.00%,21,21,0.00%
edgedl.me.gvt1.com,0,0.00%,9,9,0.00%
apigate.10jqka.com.cn,0,0.00%,8,8,0.00%
cs.dds.microsoft.com,0,0.00%,2,2,0.00%
isrc.iscas.ac.cn,0,0.00%,14,14,0.00%
d2335eacoaawg9.cloudfront.net,0,0.00%,1,1,0.00%
note.youdao.com,0,0.00%,31,31,0.00%
www.sangfor.com,0,0.00%,26,26,0.00%
ssl.mail.163.com,0,0.00%,6,6,0.00%
router4.teamviewer.com,0,0.00%,10,10,0.00%
slapi.oray.net,0,0.00%,37,37,0.00%
analytics.95516.com,0,0.00%,2,2,0.00%
grs.dbankcloud.com,0,0.00%,6,6,0.00%
weibo.com,0,0.00%,2,2,0.00%
time-ios.apple.com,0,0.00%,2,2,0.00%
42-courier.push.apple.com,0,0.00%,2,2,0.00%
tracking.miui.com,0,0.00%,10,10,0.00%
www.m9ynqi6d.com,0,0.00%,9,9,0.00%
client-api.oray.com,0,0.00%,8,8,0.00%
m.baidu.com,0,0.00%,2,2,0.00%
hwid.platform.hicloud.com,0,0.00%,2,2,0.00%
apis.live.net,0,0.00%,5,5,0.00%
upd2.sangfor.com.cn,0,0.00%,4,4,0.00%
auth2.sangfor.com.cn,0,0.00%,7,7,0.00%
snowplow.trx.gitlab.net,0,0.00%,2,2,0.00%
user-api-v2.oray.com,0,0.00%,2,2,0.00%
dns.twnic.tw,0,0.00%,3,3,0.00%
rq.upgrade.lbmini.cmcm.com,0,0.00%,8,8,0.00%
auth-sl.oray.com,0,0.00%,2,2,0.00%
skl.la1.mclqp.link,0,0.00%,4,4,0.00%
router3.teamviewer.com,0,0.00%,30,30,0.00%
cn.overleaf.com,0,0.00%,4,4,0.00%
report.idqqimg.com,0,0.00%,8,8,0.00%
r1---sn-2x3elnel.gvt1.com,0,0.00%,2,2,0.00%
inference.location.live.net,0,0.00%,8,8,0.00%
v1-play.log.mgtv.com,0,0.00%,4,4,0.00%
log.tbs.qq.com,0,0.00%,2,2,0.00%
web-seminare.beton-webakademie.36chambers.de,0,0.00%,1,1,0.00%
31-courier.push.apple.com,0,0.00%,3,3,0.00%
onetag-sys.com,0,0.00%,2,2,0.00%
log.iflytek.com,0,0.00%,2,2,0.00%
dig.bdurl.net,0,0.00%,8,8,0.00%
dcdn-tracker.n.shifen.com,0,0.00%,2,2,0.00%
34-courier.push.apple.com,0,0.00%,2,2,0.00%
sbeacon.sina.com.cn,0,0.00%,2,2,0.00%
vcl-brain.snssdk.com,0,0.00%,4,4,0.00%
set.gosts.gq,0,0.00%,1,1,0.00%
tvax4.sinaimg.cn,0,0.00%,5,5,0.00%
tvax2.sinaimg.cn,0,0.00%,2,2,0.00%
sns-avatar-qc.xhscdn.com,0,0.00%,6,6,0.00%
s1.symcb.com,0,0.00%,4,4,0.00%
disp-reportnfav6tmp.ias.tencent-cloud.net,0,0.00%,4,4,0.00%
conf.wsm.360.cn,0,0.00%,4,4,0.00%
dnsscan.shadowserver.org,0,0.00%,52,52,0.00%
webrtcpunch.video.qq.com,0,0.00%,4,4,0.00%
btrace.video.qq.com,0,0.00%,2,2,0.00%
pc-store-lb.lenovomm.cn,0,0.00%,3,3,0.00%
errlog.umeng.com,0,0.00%,4,4,0.00%
traffic-v1.souche.com,0,0.00%,2,2,0.00%
cfg.imtt.qq.com,0,0.00%,2,2,0.00%
devlog.ys7.com,0,0.00%,2,2,0.00%
supl.platform.hicloud.com,0,0.00%,4,4,0.00%
r2---sn-2x3elnez.gvt1.com,0,0.00%,2,2,0.00%
wx.qq.com,0,0.00%,4,4,0.00%
geo-drcn.platform.hicloud.com,0,0.00%,4,4,0.00%
api3.gifshow.com,0,0.00%,2,2,0.00%
audid-api.taobao.com,0,0.00%,2,2,0.00%
gsp85-cn-ssl.ls.apple.com,0,0.00%,2,2,0.00%
s-gm.mmstat.com,0,0.00%,6,6,0.00%
dualstack-a.apilocate.amap.com,0,0.00%,4,4,0.00%
dualstack-logs.amap.com,0,0.00%,4,4,0.00%
init.itunes.apple.com,0,0.00%,4,4,0.00%
cloudflare-dns.com,0,0.00%,6,6,0.00%
sadownload.mcafee.com,0,0.00%,2,2,0.00%
api.github.com,0,0.00%,2,2,0.00%
data.pendo.io,0,0.00%,2,2,0.00%
push-rest.zui.com,0,0.00%,3,3,0.00%
roaming.officeapps.partner.office365.cn,0,0.00%,2,2,0.00%
d2kaokxjvx18eu.cloudfront.net,0,0.00%,2,2,0.00%
access.toggle.qq.com,0,0.00%,10,10,0.00%
gimg4.baidu.com,0,0.00%,2,2,0.00%
mp.4dex.io,0,0.00%,2,2,0.00%
loggw.alipay.com.cn,0,0.00%,2,2,0.00%
odc.officeapps.partner.office365.cn,0,0.00%,2,2,0.00%
beacon-api.aliyuncs.com,0,0.00%,4,4,0.00%
centertime.ksyun.com,0,0.00%,4,4,0.00%
infoc2.duba.net,0,0.00%,6,6,0.00%
api.kingdata.ksyun.com,0,0.00%,4,4,0.00%
filehouse.zhhainiao.com,0,0.00%,4,4,0.00%
tz.sec.xiaomi.com,0,0.00%,2,2,0.00%
api.777ppt.com,0,0.00%,2,2,0.00%
relay-b8d08ecc.net.anydesk.com,0,0.00%,14,14,0.00%
mpush-api.aliyun.com,0,0.00%,2,2,0.00%
d.docs.live.net,0,0.00%,2,2,0.00%
collabrtc.officeapps.live.com,0,0.00%,2,2,0.00%
settings-prod-uks-1.uksouth.cloudapp.azure.com,0,0.00%,6,6,0.00%
router16.teamviewer.com,0,0.00%,17,17,0.00%
psg1-collabhubrtc.officeapps.live.com,0,0.00%,2,2,0.00%
api.ad.xiaomi.com,0,0.00%,2,2,0.00%
sdkconfig.ad.xiaomi.com,0,0.00%,4,4,0.00%
d2gatte9o95jao.cloudfront.net,0,0.00%,1,1,0.00%
secclientgw.alipay.com,0,0.00%,2,2,0.00%
dsm01pap003.storage.live.com,0,0.00%,2,2,0.00%
wq.cloud.duba.net,0,0.00%,1,1,0.00%
g.csdnimg.cn,0,0.00%,8,8,0.00%
profile.csdnimg.cn,0,0.00%,2,2,0.00%
silkroad.csdn.net,0,0.00%,2,2,0.00%
alive.github.com,0,0.00%,3,3,0.00%
v.graphics.ac.cn,0,0.00%,2,2,0.00%
minor-api.mihoyo.com,0,0.00%,2,2,0.00%
c.pcs.baidu.com,0,0.00%,4,4,0.00%
ifs.tanx.com,0,0.00%,11,11,0.00%
cloud.dell.com,0,0.00%,2,2,0.00%
edge-268.hkhkg.icloud-content.com,0,0.00%,2,2,0.00%
weather-edge.news.apple-dns.net,0,0.00%,2,2,0.00%
edge-268.hkhkg.ce.apple-dns.net,0,0.00%,2,2,0.00%
ib.adnxs.com,0,0.00%,2,2,0.00%
b1h.zemanta.com,0,0.00%,2,2,0.00%
search.apps.ubuntu.com,0,0.00%,2,2,0.00%
nj.t.bcsp2p.baidu.com,0,0.00%,10,10,0.00%
ww1097.smartadserver.com,0,0.00%,2,2,0.00%
lbs.map.qq.com,0,0.00%,4,4,0.00%
metok.sys.miui.com,0,0.00%,8,8,0.00%
sync.1rx.io,0,0.00%,2,2,0.00%
video.weibo.com,0,0.00%,2,2,0.00%
edge-035.hktko1.ce.apple-dns.net,0,0.00%,10,10,0.00%
msite.baidu.com,0,0.00%,2,2,0.00%
zkres3.myzaker.com,0,0.00%,2,2,0.00%
ae.bdstatic.com,0,0.00%,2,2,0.00%
ggs.myzaker.com,0,0.00%,2,2,0.00%
stat.myzaker.com,0,0.00%,2,2,0.00%
tt.browser.360.cn,0,0.00%,2,2,0.00%
tva2.sinaimg.cn,0,0.00%,2,2,0.00%
healthdata.hicloud.com,0,0.00%,6,6,0.00%
array507.prod.do.dsp.mp.microsoft.com,0,0.00%,4,4,0.00%
95aaa353434f41dba950dc4aea6b8df9.fp.measure.office.com,0,0.00%,2,2,0.00%
grow.nowcoder.com,0,0.00%,2,2,0.00%
wd-prod-ss-as-southeast-2-fe.southeastasia.cloudapp.azure.com,0,0.00%,14,14,0.00%
dd.browser.360.cn,0,0.00%,18,18,0.00%
cm-10-19.getui.com,0,0.00%,2,2,0.00%
c-gtc.getui.net,0,0.00%,2,2,0.00%
agt.p.360.cn,0,0.00%,2,2,0.00%
tr.p.360.cn,0,0.00%,2,2,0.00%
akn.safe.360.cn,0,0.00%,12,12,0.00%
ulog-sdk.gifshow.com,0,0.00%,2,2,0.00%
open.e.kuaishou.cn,0,0.00%,2,2,0.00%
wap.ylxdtww.com,0,0.00%,2,2,0.00%
mobads.baidu.com,0,0.00%,2,2,0.00%
zerossl.ocsp.sectigo.com,0,0.00%,8,8,0.00%
zt.gifshow.com,0,0.00%,2,2,0.00%
newvpn.arp.cn,0,0.00%,2,2,0.00%
cloud-rest.lenovomm.com,0,0.00%,16,16,0.00%
stun.hitv.com,0,0.00%,2,2,0.00%
dns.weixin.qq.com,0,0.00%,6,6,0.00%
hag-drcn.op.hicloud.com,0,0.00%,4,4,0.00%
seupdate.360safe.com,0,0.00%,2,2,0.00%
bizapi.csdn.net,0,0.00%,2,2,0.00%
b-gtc.gepush.com,0,0.00%,2,2,0.00%
syz.phic.org.cn,0,0.00%,2,2,0.00%
kunyu.csdn.net,0,0.00%,4,4,0.00%
beacon.tingyun.com,0,0.00%,4,4,0.00%
seapp.stat.360safe.com,0,0.00%,2,2,0.00%
ap5.agora.io,0,0.00%,2,2,0.00%
hik-alicloud.oss-cn-hangzhou.aliyuncs.com,0,0.00%,4,4,0.00%
olapi7.bizport.cn,0,0.00%,2,2,0.00%
crteam.cn,0,0.00%,4,4,0.00%
gdfp.gifshow.com,0,0.00%,2,2,0.00%
www.googletagservices.com,0,0.00%,2,2,0.00%
odr.mookie1.com,0,0.00%,2,2,0.00%
id.rlcdn.com,0,0.00%,2,2,0.00%
us-u.openx.net,0,0.00%,2,2,0.00%
router5.teamviewer.com,0,0.00%,20,20,0.00%
brxt-research.mendeley.com,0,0.00%,2,2,0.00%
support.weixin.qq.com,0,0.00%,4,4,0.00%
fp.msedge.net,0,0.00%,5,5,0.00%
a-0001.a-msedge.net,0,0.00%,4,4,0.00%
cloudrom-global.emui.dbankcloud.com,0,0.00%,2,2,0.00%
metrics.dt.hicloud.com,0,0.00%,2,2,0.00%
r.img.cctvpic.com,0,0.00%,2,2,0.00%
imap.163.com,0,0.00%,2,2,0.00%
p3.img.cctvpic.com,0,0.00%,2,2,0.00%
p.data.cctv.com,0,0.00%,2,2,0.00%
apm.hexin.cn,0,0.00%,2,2,0.00%
waws-prod-sg1-057-feea.southeastasia.cloudapp.azure.com,0,0.00%,2,2,0.00%
nowcoder.cn-hangzhou.log.aliyuncs.com,0,0.00%,2,2,0.00%
pbjs.e-planning.net,0,0.00%,2,2,0.00%
blog.csdn.net,0,0.00%,3,3,0.00%
py.ucas.ac.cn,0,0.00%,2,2,0.00%
sep.ucas.ac.cn,0,0.00%,2,2,0.00%
c.tmyzer.com,0,0.00%,2,2,0.00%
dns.pub,0,0.00%,6,6,0.00%
s.c-ctrip.com,0,0.00%,2,2,0.00%
m.ctrip.com,0,0.00%,2,2,0.00%
spo-ring.msedge.net,0,0.00%,2,2,0.00%
q.qlogo.cn,0,0.00%,2,2,0.00%
oneocsp.microsoft.com,0,0.00%,4,4,0.00%
smtp.nfschina.com,0,0.00%,6,6,0.00%
k-ring.msedge.net,0,0.00%,2,2,0.00%
static-ecst.licdn.com,0,0.00%,2,2,0.00%
cloud.tgpa.qq.com,0,0.00%,2,2,0.00%
hc.tdm.qq.com,0,0.00%,2,2,0.00%
gimg1.baidu.com,0,0.00%,1,1,0.00%
onedscolprdaus02.australiasoutheast.cloudapp.azure.com,0,0.00%,2,2,0.00%
safebrowsing.urlsec.qq.com,0,0.00%,3,3,0.00%
natdetection.onethingpcs.com,0,0.00%,2,2,0.00%
conf-darwin.xycdn.com,0,0.00%,6,6,0.00%
settings-prod-eus2-1.eastus2.cloudapp.azure.com,0,0.00%,1,1,0.00%
gateway.fe.apple-dns.cn,0,0.00%,2,2,0.00%
author.baidu.com,0,0.00%,1,1,0.00%
settings-ssl.xboxlive.com,0,0.00%,1,1,0.00%
mbdp02.bdstatic.com,0,0.00%,1,1,0.00%
compiles.overleaf.com,0,0.00%,1,1,0.00%
home.baidu.com,0,0.00%,2,2,0.00%
i.baidu.com,0,0.00%,1,1,0.00%
help.baidu.com,0,0.00%,2,2,0.00%
isite.baidu.com,0,0.00%,2,2,0.00%
www.beian.gov.cn,0,0.00%,2,2,0.00%
vd3.bdstatic.com,0,0.00%,1,1,0.00%
stun.services.mozilla.com,0,0.00%,2,2,0.00%
router11.teamviewer.com,0,0.00%,6,6,0.00%
event-drcn.push.dbankcloud.com,0,0.00%,2,2,0.00%
fa000000105.resources.office.net,0,0.00%,2,2,0.00%
tp-b.pinduoduo.com,0,0.00%,6,6,0.00%
captive-cidr.origin-apple.com.akadns.net,0,0.00%,2,2,0.00%
35-courier.push.apple.com,0,0.00%,4,4,0.00%
www.googleapis.com,0,0.00%,14,14,0.00%
v.gdt.qq.com,0,0.00%,2,2,0.00%
otheve.beacon.qq.com,0,0.00%,2,2,0.00%
ios.rqd.qq.com,0,0.00%,2,2,0.00%
checkin.gstatic.com,0,0.00%,1,1,0.00%
web.da.mgtv.com,0,0.00%,2,2,0.00%
v2.da.mgtv.com,0,0.00%,2,2,0.00%
ys.da.mgtv.com,0,0.00%,1,1,0.00%
hunantv.m.cn.miaozhen.com,0,0.00%,2,2,0.00%
vt.ipinyou.com,0,0.00%,2,2,0.00%
bv.lnk0.com,0,0.00%,2,2,0.00%
event.csdn.net,0,0.00%,2,2,0.00%
alfred.ixiacom.com,0,0.00%,13,13,0.00%
router7.teamviewer.com,0,0.00%,21,21,0.00%
a.sox.si,0,0.00%,41,41,0.00%
mail.163.com,0,0.00%,17,17,0.00%
pull-lls-spe-l26.douyincdn.com,0,0.00%,2,2,0.00%
drive.wpsdns.com,0,0.00%,6,6,0.00%
whsmarthome.hwcloudtest.cn,0,0.00%,29,29,0.00%
info.lenovo.com.cn,0,0.00%,4,4,0.00%
newclient.map.baidu.com,0,0.00%,2,2,0.00%
client.map.baidu.com,0,0.00%,2,2,0.00%
resolver.dingtalk.com,0,0.00%,2,2,0.00%
ipm.atm.youku.com,0,0.00%,4,4,0.00%
alt8-mtalk.google.com,0,0.00%,2,2,0.00%
router14.teamviewer.com,0,0.00%,36,36,0.00%
mon.snssdk.com,0,0.00%,2,2,0.00%
push-rtmp-spe-l3.douyincdn.com,0,0.00%,2,2,0.00%
worldwide.sogou.com,0,0.00%,2,2,0.00%
vv.video.qq.com,0,0.00%,8,8,0.00%
icns.zui.lenovomm.com,0,0.00%,2,2,0.00%
o1098464.ingest.sentry.io,0,0.00%,4,4,0.00%
pull-flv-l27.douyincdn.com,0,0.00%,1,1,0.00%
pull-flv-f5-enc.flive.douyincdn.com,0,0.00%,2,2,0.00%
push-rtmp-f5-cny.douyincdn.com,0,0.00%,2,2,0.00%
push-rtmp-l27.douyincdn.com,0,0.00%,2,2,0.00%
can-01.t7n4vxsm.dxs5.xyz,0,0.00%,2,2,0.00%
cc.map.qq.com,0,0.00%,2,2,0.00%
wq.jd.com,0,0.00%,2,2,0.00%
devs-data.dutils.com,0,0.00%,2,2,0.00%
www.msn.cn,0,0.00%,9,9,0.00%
api.share.mob.com,0,0.00%,4,4,0.00%
api-fc.dutils.com,0,0.00%,2,2,0.00%
dfe.mic.mob.com,0,0.00%,2,2,0.00%
api-exc.dutils.com,0,0.00%,2,2,0.00%
api.df.mob.com,0,0.00%,2,2,0.00%
ts.qq.com,0,0.00%,21,21,0.00%
api-fd.dutils.com,0,0.00%,2,2,0.00%
api2.openinstall.io,0,0.00%,2,2,0.00%
cgi.connect.qq.com,0,0.00%,2,2,0.00%
bookcommon.reader.qq.com,0,0.00%,2,2,0.00%
api.walsea.com,0,0.00%,4,4,0.00%
ali-stats.jpush.cn,0,0.00%,4,4,0.00%
sis.jpush.io,0,0.00%,2,2,0.00%
m.mpl.dutils.com,0,0.00%,2,2,0.00%
tsis.jpush.cn,0,0.00%,4,4,0.00%
h.m.mpl.dutils.com,0,0.00%,2,2,0.00%
a.qchannel03.cn,0,0.00%,2,2,0.00%
wanproxy-hz.127.net,0,0.00%,2,2,0.00%
c.sayhi.360.cn,0,0.00%,2,2,0.00%
interface3.music.163.com,0,0.00%,2,2,0.00%
b.qchannel03.cn,0,0.00%,2,2,0.00%
d.qchannel03.cn,0,0.00%,2,2,0.00%
apilocate.amap.com,0,0.00%,4,4,0.00%
loggw.alipay.com,0,0.00%,2,2,0.00%
nsp-contentcenter-h5-drcn.obs.cn-north-2.myhwclouds.com,0,0.00%,2,2,0.00%
yqy2356.melissauvc.com,0,0.00%,2,2,0.00%
pay.weixin.qq.com,0,0.00%,4,4,0.00%
wx.tenpay.com,0,0.00%,4,4,0.00%
vpn.maskvpn.cc,0,0.00%,1,1,0.00%
mobile.yangkeduo.com,0,0.00%,4,4,0.00%
lbs-qiyu.netease.im,0,0.00%,2,2,0.00%
qlbs.map.qq.com,0,0.00%,2,2,0.00%
info.3g.qq.com,0,0.00%,2,2,0.00%
img.pddpic.com,0,0.00%,4,4,0.00%
s.jpush.cn,0,0.00%,2,2,0.00%
easytomessage.com,0,0.00%,2,2,0.00%
hovv.yilanvaas.com,0,0.00%,2,2,0.00%
pmmtk-a.pinduoduo.com,0,0.00%,6,6,0.00%
6zhg.cn.rongnav.com,0,0.00%,2,2,0.00%
pull-rtmp-f29.douyincdn.com,0,0.00%,2,2,0.00%
edge.ivideo.sina.com.cn,0,0.00%,2,2,0.00%
modao.cc,0,0.00%,2,2,0.00%
th.yangkeduo.com,0,0.00%,4,4,0.00%
tne.pinduoduo.com,0,0.00%,2,2,0.00%
api.ivideo.sina.com.cn,0,0.00%,2,2,0.00%
api.pinduoduo.com,0,0.00%,6,6,0.00%
static.walsea.com,0,0.00%,4,4,0.00%
push-rtmp-vr-l3.douyincdn.com,0,0.00%,2,2,0.00%
gd-stats.jpush.cn,0,0.00%,2,2,0.00%
papi.funshion.com,0,0.00%,2,2,0.00%
titan-ws.pinduoduo.com,0,0.00%,4,4,0.00%
ip1880706121.funshion.com,0,0.00%,1,1,0.00%
static.vnpt.vn,0,0.00%,6,6,0.00%
ip1865976387.funshion.com,0,0.00%,1,1,0.00%
windows.msn.cn,0,0.00%,4,4,0.00%
9-courier.push.apple.com,0,0.00%,2,2,0.00%
array503.prod.do.dsp.mp.microsoft.com,0,0.00%,2,2,0.00%
15-courier.push.apple.com,0,0.00%,2,2,0.00%
array513.prod.do.dsp.mp.microsoft.com,0,0.00%,3,3,0.00%
ip1880706122.funshion.com,0,0.00%,2,2,0.00%
pic6.ajkimg.com,0,0.00%,1,1,0.00%
api.map.baidu.com,0,0.00%,6,6,0.00%
ip1865976393.funshion.com,0,0.00%,2,2,0.00%
www.b4p22.com,0,0.00%,1,1,0.00%
reportwpush.58.com,0,0.00%,2,2,0.00%
sec.sginput.qq.com,0,0.00%,2,2,0.00%
nvh6bk7t.mirror.aliyuncs.com,0,0.00%,7,7,0.00%
ip3746756449.funshion.com,0,0.00%,2,2,0.00%
sign.utcsoft.com,0,0.00%,2,2,0.00%
upmobile.v.qq.com,0,0.00%,2,2,0.00%
ip1880706120.funshion.com,0,0.00%,1,1,0.00%
outlook.office365.com,0,0.00%,4,4,0.00%
mstat.tpns.tencent.com,0,0.00%,3,3,0.00%
router13.teamviewer.com,0,0.00%,32,32,0.00%
t.dtscout.com,0,0.00%,1,1,0.00%
qdyn.wps.cn,0,0.00%,10,10,0.00%
dualstack-restsdk.amap.com,0,0.00%,2,2,0.00%
xcxt.pinduoduo.com,0,0.00%,2,2,0.00%
xcxapp.pinduoduo.com,0,0.00%,2,2,0.00%
push.hicloud.com,0,0.00%,2,2,0.00%
jgwdb2.gaox.ml,0,0.00%,1,1,0.00%
pss.alicdn.com,0,0.00%,2,2,0.00%
xg.pinduoduo.com,0,0.00%,2,2,0.00%
home.hicloud.com,0,0.00%,30,30,0.00%
profile.accounts.firefox.com,0,0.00%,6,6,0.00%
token.services.mozilla.com,0,0.00%,3,3,0.00%
gs-loc-cn.apple.com,0,0.00%,6,6,0.00%
shortconn.im.qcloud.com,0,0.00%,8,8,0.00%
commimg.pddpic.com,0,0.00%,2,2,0.00%
messaging.engagement.office.com,0,0.00%,2,2,0.00%
vpn.maskvpn.org,0,0.00%,6,6,0.00%
clientlogvodp2p.haplat.net,0,0.00%,4,4,0.00%
ocws.officeapps.live.com,0,0.00%,2,2,0.00%
transit1.wslog.chinanetcenter.com,0,0.00%,4,4,0.00%
sync-1-us-west1-g.sync.services.mozilla.com,0,0.00%,6,6,0.00%
mmsns.c2c.wechat.com,0,0.00%,2,2,0.00%
api.accounts.firefox.com,0,0.00%,1,1,0.00%
p2pstuntest.haplat.net,0,0.00%,4,4,0.00%
xpgw-xcdn.youku.com,0,0.00%,2,2,0.00%
mambap2pvodh5.8686c.com,0,0.00%,4,4,0.00%
captive.apple.com,0,0.00%,2,2,0.00%
kindleshare.cn,0,0.00%,2,2,0.00%
37-courier.push.apple.com,0,0.00%,2,2,0.00%
ldapi.ldmnq.com,0,0.00%,2,2,0.00%
api.zhihu.com,0,0.00%,2,2,0.00%
jp_62.antchatxj.com,0,0.00%,2,2,0.00%
h-adashx-internal.ut.taobao.com,0,0.00%,1,1,0.00%
stup7.appmeasurements.com,0,0.00%,2,2,0.00%
bae.appmeasurements.com,0,0.00%,2,2,0.00%
shmmsns.qpic.cn,0,0.00%,2,2,0.00%
array506.prod.do.dsp.mp.microsoft.com,0,0.00%,2,2,0.00%
aedns.weixin.qq.com,0,0.00%,2,2,0.00%
game.weixin.qq.com,0,0.00%,2,2,0.00%
t1.appmeasurements.com,0,0.00%,2,2,0.00%
acs.m.taobao.com,0,0.00%,2,2,0.00%
msgacs.m.taobao.com,0,0.00%,2,2,0.00%
atoken.m.taobao.com,0,0.00%,2,2,0.00%
eco.taobao.com,0,0.00%,2,2,0.00%
interface.bilibili.com,0,0.00%,4,4,0.00%
app-site-association.cdn-apple.com,0,0.00%,2,2,0.00%
apoll.m.taobao.com,0,0.00%,2,2,0.00%
trade-acs.m.taobao.com,0,0.00%,1,1,0.00%
u.y.qq.com,0,0.00%,6,6,0.00%
www.ai-start.com,0,0.00%,2,2,0.00%
apiwmda.58.com.cn,0,0.00%,2,2,0.00%
amdc.m.taobao.com,0,0.00%,2,2,0.00%
rhdc-acs.m.taobao.com,0,0.00%,2,2,0.00%
rc.kite.com,0,0.00%,3,3,0.00%
b4bf120.pd.gladns.com,0,0.00%,1,1,0.00%
b4bf120.pc.gladns.com,0,0.00%,2,2,0.00%
b4bf120.pb.gladns.com,0,0.00%,2,2,0.00%
b4bf120.pa.gladns.com,0,0.00%,2,2,0.00%
b4bf120.cw.glados-config.net,0,0.00%,1,1,0.00%
b4bf120.wz.glados-config.net,0,0.00%,2,2,0.00%
b4bf120.pf.gladns.com,0,0.00%,2,2,0.00%
b4bf120.wx.glados-config.net,0,0.00%,2,2,0.00%
b4bf120.nx.glados-config.net,0,0.00%,2,2,0.00%
b4bf120.td.glados-config.net,0,0.00%,2,2,0.00%
b4bf120.wy.glados-config.net,0,0.00%,1,1,0.00%
b4bf120.ts.glados-config.net,0,0.00%,2,2,0.00%
b4bf120.pg.gladns.com,0,0.00%,2,2,0.00%
b4bf120.pe.gladns.com,0,0.00%,2,2,0.00%
b4bf120.ph.gladns.com,0,0.00%,2,2,0.00%
b4bf120.th.glados-config.net,0,0.00%,1,1,0.00%
b4bf120.tt.glados-config.net,0,0.00%,2,2,0.00%
px.ucweb.com,0,0.00%,2,2,0.00%
12qln2t9.g132d6.cq11344.app-http-dns.ictun.com,0,0.00%,2,2,0.00%
ccpce-cn.consumer.huawei.com,0,0.00%,2,2,0.00%
api.account.xiaomi.com,0,0.00%,2,2,0.00%
12qln2t9.g132d6.cq11344.app-rootca.ictun.com,0,0.00%,2,2,0.00%
pecker-app-v1.ictun.com,0,0.00%,2,2,0.00%
logservice.hicloud.com,0,0.00%,3,3,0.00%
logservice1.hicloud.com,0,0.00%,4,4,0.00%
store.hispace.hicloud.com,0,0.00%,2,2,0.00%
nsp-logservice-hiview-p41-drcn.obs.cn-north-2.myhuaweicloud.com,0,0.00%,2,2,0.00%
cq11344-app-https-api-1.ictun.com,0,0.00%,2,2,0.00%
hwid-drcn.platform.hicloud.com,0,0.00%,2,2,0.00%
oauth-login-drcn.platform.dbankcloud.com,0,0.00%,2,2,0.00%
speaker-drcn.things.hicloud.com,0,0.00%,2,2,0.00%
terms1.hicloud.com,0,0.00%,2,2,0.00%
pmmtk.pinduoduo.com,0,0.00%,2,2,0.00%
cmtw.pinduoduo.com,0,0.00%,2,2,0.00%
adashx.m.taobao.com,0,0.00%,4,4,0.00%
loggw-ex.alipay.com,0,0.00%,2,2,0.00%
tracker.iriseden.eu,0,0.00%,2,2,0.00%
www.letpub.com.cn,0,0.00%,4,4,0.00%
sg.bls.mdt.qq.com,0,0.00%,2,2,0.00%
iupdateplf.yy.com,0,0.00%,2,2,0.00%
livebook.manning.com,0,0.00%,2,2,0.00%
www.manning.com,0,0.00%,2,2,0.00%
config.inmobi.com,0,0.00%,2,2,0.00%
web-drcn.hispace.dbankcloud.cn,0,0.00%,2,2,0.00%
readpaper.com,0,0.00%,4,4,0.00%
sdkgw.map.qq.com,0,0.00%,2,2,0.00%
mx3.qq.com,0,0.00%,2,2,0.00%
mx2.qq.com,0,0.00%,2,2,0.00%
mx1.qq.com,0,0.00%,2,2,0.00%
mime.baidu.com,0,0.00%,2,2,0.00%
h5vv6.video.qq.com,0,0.00%,2,2,0.00%
windows.jingyeqian.com,0,0.00%,2,2,0.00%
api-calendar-drcn.music.dbankcloud.cn,0,0.00%,2,2,0.00%
bluedot.is.autonavi.com.gds.alibabadns.com,0,0.00%,7,7,0.00%
mpvideo.qpic.cn,0,0.00%,2,2,0.00%
1-courier.push.apple.com,0,0.00%,2,2,0.00%
1-courier.sandbox.push.apple.com,0,0.00%,2,2,0.00%
ins-8y4ghcjp.ias.tencent-cloud.net,0,0.00%,2,2,0.00%
graph.microsoft.com,0,0.00%,4,4,0.00%
ipv6.google.com,0,0.00%,4,4,0.00%
smarthome.dbankcloud.cn,0,0.00%,2,2,0.00%
bjbgp01.baidupcs.com,0,0.00%,6,6,0.00%
scenario-drcn.things.dbankcloud.cn,0,0.00%,2,2,0.00%
login.wpscdn.cn,0,0.00%,2,2,0.00%
logintcp.wps.cn,0,0.00%,2,2,0.00%
statuse.digitalcertvalidation.com,0,0.00%,2,2,0.00%
mail.nfschina.com,0,0.00%,2,2,0.00%
commimg-1.pddpic.com,0,0.00%,2,2,0.00%
ta.pinduoduo.com,0,0.00%,2,2,0.00%
xfr-ss.getui.com,0,0.00%,2,2,0.00%
jgw-drcn.jos.dbankcloud.cn,0,0.00%,2,2,0.00%
c-ss.getui.com,0,0.00%,2,2,0.00%
th-b.pinduoduo.com,0,0.00%,3,3,0.00%
www.beijing.gov.cn,0,0.00%,2,2,0.00%
grs.hihonorcloud.com,0,0.00%,2,2,0.00%
router8.teamviewer.com,0,0.00%,23,23,0.00%
bugly.qq.com,0,0.00%,2,2,0.00%
unitelogreport.reader.qq.com,0,0.00%,2,2,0.00%
game.eve.mdt.qq.com,0,0.00%,2,2,0.00%
id6.me,0,0.00%,2,2,0.00%
mywap2.icbc.com.cn,0,0.00%,2,2,0.00%
pageviewp.icbc.com.cn,0,0.00%,2,2,0.00%
epass.icbc.com.cn,0,0.00%,2,2,0.00%
blobcollector.events.data.trafficmanager.NET,0,0.00%,4,4,0.00%
gw5.push.mcp.weibo.cn,0,0.00%,2,2,0.00%
mimscmp.icbc.com.cn,0,0.00%,2,2,0.00%
devreaf.icbc.com.cn,0,0.00%,2,2,0.00%
gs-loc-new.ls-apple.com.akadns.net,0,0.00%,2,2,0.00%
addinsinstallation.store.office.com,0,0.00%,2,2,0.00%
wikipedia.firstpartyapps.oaspapps.com,0,0.00%,2,2,0.00%
router6.teamviewer.com,0,0.00%,9,9,0.00%
router15.teamviewer.com,0,0.00%,24,24,0.00%
catchoice.ceping.com,0,0.00%,2,2,0.00%
web.qun.qq.com,0,0.00%,4,4,0.00%
tcbox.baidu.com,0,0.00%,2,2,0.00%
warranty.vivo.com.cn,0,0.00%,2,2,0.00%
servicesupport1.hicloud.com,0,0.00%,2,2,0.00%
abtest.openspeech.cn,0,0.00%,2,2,0.00%
rs-sg.rustdesk.com,0,0.00%,2,2,0.00%
rs-ny.rustdesk.com,0,0.00%,2,2,0.00%
tvax3.sinaimg.cn,0,0.00%,2,2,0.00%
tva1.sinaimg.cn,0,0.00%,2,2,0.00%
v.casmooc.cn,0,0.00%,2,2,0.00%
bag.itunes.apple.com,0,0.00%,4,4,0.00%
fsso.cnki.net,0,0.00%,2,2,0.00%
t.kite.com,0,0.00%,2,2,0.00%
seal.websecurity.norton.com,0,0.00%,1,1,0.00%
ins-r23tsuuf.ias.tencent-cloud.net,0,0.00%,3,3,0.00%
pc-api.300624.com,0,0.00%,6,6,0.00%
tva3.sinaimg.cn,0,0.00%,2,2,0.00%
24-courier.push.apple.com,0,0.00%,1,1,0.00%
iphone-ld.origin-apple.com.akadns.net,0,0.00%,2,2,0.00%
xiaodu.baidu.com,0,0.00%,1,1,0.00%
ali-bj-pcdn-30.biliapi.net,0,0.00%,2,2,0.00%
restlbs.map.qq.com,0,0.00%,2,2,0.00%
md.openapi.360.cn,0,0.00%,5,5,0.00%
versioncheck.graylog.com,0,0.00%,2,2,0.00%
q3.qlogo.cn,0,0.00%,2,2,0.00%
stat.y.qq.com,0,0.00%,6,6,0.00%
agoo-report.m.taobao.com,0,0.00%,2,2,0.00%
report.url.cn,0,0.00%,7,7,0.00%
q4.qlogo.cn,0,0.00%,2,2,0.00%
array504.prod.do.dsp.mp.microsoft.com,0,0.00%,8,8,0.00%
array501.prod.do.dsp.mp.microsoft.com,0,0.00%,2,2,0.00%
meta.pinduoduo.com,0,0.00%,2,2,0.00%
sysupgrade.vivo.com.cn,0,0.00%,2,2,0.00%
tsfe.trafficshaping.dsp.mp.microsoft.com,0,0.00%,6,6,0.00%
vcode-od.vivo.com.cn,0,0.00%,2,2,0.00%
ixav-cse.avlyun.com,0,0.00%,2,2,0.00%
weather-community-drcn.weather.dbankcloud.cn,0,0.00%,2,2,0.00%
msch.f.360.cn,0,0.00%,4,4,0.00%
countly.mail.163.com,0,0.00%,2,2,0.00%
pushmis.bj.bcebos.com,0,0.00%,2,2,0.00%
data.ab.qq.com,0,0.00%,2,2,0.00%
www.bigbigwork.com,0,0.00%,1,1,0.00%
transfer.ceping.com,0,0.00%,2,2,0.00%
citicbank.ceping.com,0,0.00%,2,2,0.00%
stcms.beisen.com,0,0.00%,2,2,0.00%
message.bilibili.com,0,0.00%,4,4,0.00%
mobilegw.alipay.com,0,0.00%,2,2,0.00%
hao.lenovo.com.cn,0,0.00%,14,14,0.00%
s.1688.com,0,0.00%,2,2,0.00%
nsl.lenovo.com.cn,0,0.00%,10,10,0.00%
www.cnki.net,0,0.00%,2,2,0.00%
t.cnki.net,0,0.00%,2,2,0.00%
kns.cnki.net,0,0.00%,2,2,0.00%
track.cnki.net,0,0.00%,2,2,0.00%
proxy.sogou.com,0,0.00%,2,2,0.00%
app.yinxiang.com,0,0.00%,6,6,0.00%
online.ts.api.xiangtatech.com,0,0.00%,4,4,0.00%
ssl.google-analytics.com,0,0.00%,4,4,0.00%
tpstelemetry.tencent.com,0,0.00%,2,2,0.00%
titan.pinduoduo.com,0,0.00%,2,2,0.00%
tconf2.f.360.cn,0,0.00%,6,6,0.00%
tmfsdktcpv4.m.qq.com,0,0.00%,2,2,0.00%
obus-dc20123-cn.heytapmobi.com,0,0.00%,2,2,0.00%
ns1-04.azure-dns.com,0,0.00%,2,2,0.00%
bl.nbmswl.com,0,0.00%,2,2,0.00%
cos.wtaluo.com,0,0.00%,2,2,0.00%
appsec.hicloud.com,0,0.00%,2,2,0.00%
navi.cnki.net,0,0.00%,2,2,0.00%
piccache.cnki.net,0,0.00%,2,2,0.00%
login.cnki.net,0,0.00%,2,2,0.00%
zhifoukeji.datasink.sensorsdata.cn,0,0.00%,2,2,0.00%
music.163.com,0,0.00%,11,11,0.00%
router2.teamviewer.com,0,0.00%,9,9,0.00%
flux.iqiyi.com,0,0.00%,6,6,0.00%
httpdns.n.netease.com,0,0.00%,10,10,0.00%
cf.duba.net,0,0.00%,2,2,0.00%
m.hotmail.com,0,0.00%,2,2,0.00%
26-courier.push.apple.com,0,0.00%,2,2,0.00%
passport.aliyundrive.com,0,0.00%,2,2,0.00%
log.mmstat.com,0,0.00%,2,2,0.00%
3n.1513ke.ga,0,0.00%,61,61,0.00%
weather.kjjs.360.cn,0,0.00%,8,8,0.00%
dispatch.s.xzdesktop.cqttech.com,0,0.00%,12,12,0.00%
sl-collection.oray.net,0,0.00%,4,4,0.00%
docs.nicehash.com,0,0.00%,16,16,0.00%
ca.minexmr.com,0,0.00%,22,22,0.00%
pool.hashvault.pro,0,0.00%,22,22,0.00%
turtlecoin.herominers.com,0,0.00%,18,18,0.00%
ar.hpool.com,0,0.00%,20,20,0.00%
us1.ethpool.org,0,0.00%,22,22,0.00%
www.fullskystar.top,0,0.00%,22,22,0.00%
ckb.antpool.com,0,0.00%,14,14,0.00%
du.testjj.com,0,0.00%,20,20,0.00%
btm.f2pool.com,0,0.00%,16,16,0.00%
jp.sparkpool.com,0,0.00%,20,20,0.00%
api.nicehash.com,0,0.00%,20,20,0.00%
rx.thegov.win,0,0.00%,20,20,0.00%
mail.nicehash.com,0,0.00%,24,24,0.00%
pool.supportxmr.com,0,0.00%,20,20,0.00%
etc.f2pool.com,0,0.00%,22,22,0.00%
pool.flooder.org,0,0.00%,20,20,0.00%
eth.ss.poolin.com,0,0.00%,20,20,0.00%
asia1.ethpool.org,0,0.00%,22,22,0.00%
eth.antpool.com,0,0.00%,18,18,0.00%
miner.nicehash.com,0,0.00%,18,18,0.00%
monerohash.com,0,0.00%,24,24,0.00%
blog.nicehash.com,0,0.00%,16,16,0.00%
www.jvmonline.com,0,0.00%,24,24,0.00%
smtp.nicehash.com,0,0.00%,20,20,0.00%
penef6f8f734.slushpool.com,0,0.00%,18,18,0.00%
dcr.uupool.cn,0,0.00%,18,18,0.00%
eth.uupool.cn,0,0.00%,20,20,0.00%
git.rancher.io,0,0.00%,10,10,0.00%
api.im.qcloud.com,0,0.00%,6,6,0.00%
w.deepl.com,0,0.00%,2,2,0.00%
uapi.mp.360.cn,0,0.00%,4,4,0.00%
juiceside.net,0,0.00%,2,2,0.00%
events.gfe.nvidia.com,0,0.00%,56,56,0.00%
7jmrbtrvkgcqkldzyob4kotpyvsgz546yvik2xv4rpnfmrhe4imxthqd.tor2web.in,0,0.00%,2,2,0.00%
ustc-edu-cn.mirror.aliyuncs.com,0,0.00%,4,4,0.00%
ant.if.iqiyi.com,0,0.00%,1,1,0.00%
api.mymonero.com,0,0.00%,20,20,0.00%
toa.mygametoa.com,0,0.00%,18,18,0.00%
donate.v2.xmrig.com,0,0.00%,16,16,0.00%
fr.minexmr.com,0,0.00%,16,16,0.00%
ns41.hashvault.pro,0,0.00%,18,18,0.00%
nhmws.nicehash.com,0,0.00%,16,16,0.00%
zec.uupool.cn,0,0.00%,16,16,0.00%
sea.wafflepool.com,0,0.00%,18,18,0.00%
de.minexmr.com,0,0.00%,16,16,0.00%
kmd.antpool.com,0,0.00%,20,20,0.00%
pool-fr.supportxmr.com,0,0.00%,20,20,0.00%
k8s.entrypoint.ops.sparkpool.com,0,0.00%,16,16,0.00%
sg.minexmr.com,0,0.00%,16,16,0.00%
verushash.mine.zergpool.com,0,0.00%,16,16,0.00%
sbtc.uupool.cn,0,0.00%,18,18,0.00%
pool.minexmr.com,0,0.00%,20,20,0.00%
donate.ssl.xmrig.com,0,0.00%,20,20,0.00%
awsmx.f2pool.com,0,0.00%,20,20,0.00%
asia2.ethermine.org,0,0.00%,22,22,0.00%
xmr.flooder.org,0,0.00%,18,18,0.00%
eth.f2pool.com,0,0.00%,22,22,0.00%
btc.f2pool.com,0,0.00%,18,18,0.00%
test.nicehash.com,0,0.00%,14,14,0.00%
dcr.f2pool.com,0,0.00%,18,18,0.00%
b4c.f2pool.com,0,0.00%,16,16,0.00%
ss.antpool.com,0,0.00%,16,16,0.00%
cn.sparkpool.com,0,0.00%,22,22,0.00%
ns11.hashvault.pro,0,0.00%,18,18,0.00%
btw.uupool.cn,0,0.00%,18,18,0.00%
raven.f2pool.com,0,0.00%,16,16,0.00%
pool.minergate.com,0,0.00%,22,22,0.00%
tracker.opentrackr.org,0,0.00%,4,4,0.00%
api.pdfxd.com,0,0.00%,2,2,0.00%
dc1.ksn.kaspersky-labs.com,0,0.00%,4,4,0.00%
2-courier.push.apple.com,0,0.00%,2,2,0.00%
connipv6.tencent.com,0,0.00%,6,6,0.00%
sz2.connipv6.qq.com,0,0.00%,8,8,0.00%
sz.connipv6.qq.com,0,0.00%,6,6,0.00%
sh.connipv6.qq.com,0,0.00%,8,8,0.00%
sh2.connipv6.qq.com,0,0.00%,7,7,0.00%
tj.connipv6.qq.com,0,0.00%,6,6,0.00%
tj2.connipv6.qq.com,0,0.00%,7,7,0.00%
www.wodaywo100001.com,0,0.00%,16,16,0.00%
stratum.okpool.me,0,0.00%,16,16,0.00%
i.y.qq.com,0,0.00%,2,2,0.00%
pingfore.qq.com,0,0.00%,2,2,0.00%
c.y.qq.com,0,0.00%,1,1,0.00%
tmead.y.qq.com,0,0.00%,2,2,0.00%
stat6.y.qq.com,0,0.00%,4,4,0.00%
fliplc.getxlx.com,0,0.00%,20,20,0.00%
adstats.tencentmusic.com,0,0.00%,3,3,0.00%
wup.browser.qq.com,0,0.00%,13,13,0.00%
pop.cstnet.cn,0,0.00%,4,4,0.00%
dav.qq.com,0,0.00%,4,4,0.00%
mail.ios.ac.cn,0,0.00%,2,2,0.00%
snz04pap002.storage.live.com,0,0.00%,2,2,0.00%
mailer.nicehash.com,0,0.00%,12,12,0.00%
onedriveclucprodbn20036.blob.core.windows.net,0,0.00%,2,2,0.00%
conna.gj.qq.com,0,0.00%,2,2,0.00%
connb.gj.qq.com,0,0.00%,2,2,0.00%
connect.unity.cn,0,0.00%,8,8,0.00%
developer.unity.cn,0,0.00%,2,2,0.00%
weather2db.cmcm.com,0,0.00%,4,4,0.00%
gitlab.com,0,0.00%,13,13,0.00%
rt-p.kugou.com,0,0.00%,2,2,0.00%
client.teamviewer.com,0,0.00%,4,4,0.00%
cdp.cloud.unity3d.com,0,0.00%,5,5,0.00%
cerebrum.emotivcloud.com,0,0.00%,5,5,0.00%
doh-jp.blahdns.com,0,0.00%,2,2,0.00%
hub5p.sandai.net,0,0.00%,124,124,0.00%
lookup.nextcloud.com,0,0.00%,15,15,0.00%
ping3.teamviewer.com,0,0.00%,9,9,0.00%
ping.dgraph.io,0,0.00%,6,6,0.00%
tracker.1337x.org,0,0.00%,16,16,0.00%
pan.cstcloud.cn,0,0.00%,4,4,0.00%
correctxt.baidu.com,0,0.00%,2,2,0.00%
retracker.lanta-net.ru,0,0.00%,18,18,0.00%
tracker.etree.org,0,0.00%,4,4,0.00%
im.eulix.xyz,0,0.00%,8,8,0.00%
admin.kdsec.org,0,0.00%,4,4,0.00%
cdn.digicertcdn.com,0,0.00%,4,4,0.00%
nseed.minigame.qq.com,0,0.00%,2,2,0.00%
master6.teamviewer.com,0,0.00%,4,4,0.00%
iguvmbs.roygxe.xyz,0,0.00%,2,2,0.00%
60-fps.org,0,0.00%,2,2,0.00%
www.all4nothin.net,0,0.00%,2,2,0.00%
lens.zhihu.com,0,0.00%,5,5,0.00%
t.overflow.biz,0,0.00%,12,12,0.00%
stun.miwifi.com,0,0.00%,2,2,0.00%
qbwup.imtt.qq.com,0,0.00%,2,2,0.00%
tmall.com,0,0.00%,2,2,0.00%
weather-api.extfans.com,0,0.00%,2,2,0.00%
kubernetes-charts.storage.googleapis.com,0,0.00%,4,4,0.00%
6ahddutb1ucc3cp.ru,0,0.00%,16,16,0.00%
pub.idqqimg.com,0,0.00%,12,12,0.00%
go.minigame.qq.com,0,0.00%,2,2,0.00%
ptlogin2.qq.com,0,0.00%,2,2,0.00%
www.bitseduce.com,0,0.00%,2,2,0.00%
tracker.fixr.pro,0,0.00%,4,4,0.00%
stun1.douyucdn.cn,0,0.00%,2,2,0.00%
tracker.pow7.com,0,0.00%,7,7,0.00%
seed.minigame.qq.com,0,0.00%,2,2,0.00%
www.yuwabits.net,0,0.00%,4,4,0.00%
t2.pow7.com,0,0.00%,12,12,0.00%
www.biztorrents.com,0,0.00%,2,2,0.00%
torrents.hikarinokiseki.com,0,0.00%,2,2,0.00%
t.sina.com.cn,0,0.00%,2,2,0.00%
fileplatform.api.weibo.com,0,0.00%,2,2,0.00%
picupload.weibo.com,0,0.00%,2,2,0.00%
mail.sina.com.cn,0,0.00%,4,4,0.00%
t.showone.com.cn,0,0.00%,2,2,0.00%
tianya.cn,0,0.00%,2,2,0.00%
my.tianya.cn,0,0.00%,2,2,0.00%
sohu.com,0,0.00%,2,2,0.00%
3g.tianya.cn,0,0.00%,2,2,0.00%
bbs.tianya.cn,0,0.00%,2,2,0.00%
msg.baidu.com,0,0.00%,2,2,0.00%
upload.tieba.baidu.com,0,0.00%,2,2,0.00%
clubajax.autohome.com.cn,0,0.00%,2,2,0.00%
www.youtube.com,0,0.00%,6,6,0.00%
www.youtube-nocookie.com,0,0.00%,4,4,0.00%
icloud.com,0,0.00%,2,2,0.00%
p45-contentws.icloud.com,0,0.00%,2,2,0.00%
dns.baidu.com,0,0.00%,2,2,0.00%
pcsdata.baidu.com,0,0.00%,2,2,0.00%
weiyun.com,0,0.00%,2,2,0.00%
yinxiang.com,0,0.00%,2,2,0.00%
docin.com,0,0.00%,2,2,0.00%
outlook.live.com,0,0.00%,2,2,0.00%
login.yahoo.com,0,0.00%,2,2,0.00%
yeah.net,0,0.00%,2,2,0.00%
sina.com.cn,0,0.00%,2,2,0.00%
m0.mail.sina.cn,0,0.00%,2,2,0.00%
qiye.163.com,0,0.00%,2,2,0.00%
mail.10086.cn,0,0.00%,2,2,0.00%
appmail.mail.10086.cn,0,0.00%,2,2,0.00%
chat.google.com,0,0.00%,2,2,0.00%
news.google.com,0,0.00%,2,2,0.00%
www.google.ae,0,0.00%,4,4,0.00%
www.google.al,0,0.00%,2,2,0.00%
www.google.co.ao,0,0.00%,3,3,0.00%
www.google.as,0,0.00%,5,5,0.00%
www.google.ba,0,0.00%,4,4,0.00%
www.google.be,0,0.00%,4,4,0.00%
www.google.bg,0,0.00%,4,4,0.00%
video.weibocdn.com,0,0.00%,2,2,0.00%
picupload.service.weibo.com,0,0.00%,2,2,0.00%
upload.video.sina.com.cn,0,0.00%,2,2,0.00%
api.t.sina.com.cn,0,0.00%,2,2,0.00%
www.google.bi,0,0.00%,5,5,0.00%
www.google.bj,0,0.00%,3,3,0.00%
www.google.bs,0,0.00%,5,5,0.00%
www.google.cd,0,0.00%,5,5,0.00%
sinaapp.com,0,0.00%,2,2,0.00%
t.p4p.sina.com.cn,0,0.00%,2,2,0.00%
www.tianya.cn,0,0.00%,2,2,0.00%
wireless.tianya.cn,0,0.00%,2,2,0.00%
www.google.cg,0,0.00%,5,5,0.00%
www.google.ci,0,0.00%,5,5,0.00%
www.google.cl,0,0.00%,4,4,0.00%
www.google.cn,0,0.00%,2,2,0.00%
www.google.cv,0,0.00%,3,3,0.00%
www.google.cz,0,0.00%,2,2,0.00%
www.google.dj,0,0.00%,5,5,0.00%
www.google.dm,0,0.00%,5,5,0.00%
baidu.com,0,0.00%,2,2,0.00%
skype.com,0,0.00%,2,2,0.00%
photo.tianya.cn,0,0.00%,2,2,0.00%
blog.tianya.cn,0,0.00%,2,2,0.00%
m.tianya.cn,0,0.00%,2,2,0.00%
wapp.baidu.com,0,0.00%,2,2,0.00%
uploadphotos.baidu.com,0,0.00%,2,2,0.00%
autohome.com.cn,0,0.00%,2,2,0.00%
youtube.googleapis.com,0,0.00%,2,2,0.00%
youtu.be,0,0.00%,2,2,0.00%
sharepoint.com,0,0.00%,4,4,0.00%
web.wechat.com,0,0.00%,2,2,0.00%
file2.wx.qq.com,0,0.00%,2,2,0.00%
office.com,0,0.00%,2,2,0.00%
login.microsoft.com,0,0.00%,2,2,0.00%
bing.com,0,0.00%,4,4,0.00%
fanyi.baidu.com,0,0.00%,2,2,0.00%
www.dropbox.com,0,0.00%,4,4,0.00%
p45-mailws.icloud.com,0,0.00%,2,2,0.00%
sharefile.com,0,0.00%,2,2,0.00%
c3.pcs.baidu.com,0,0.00%,2,2,0.00%
www.google.cf,0,0.00%,3,3,0.00%
www.google.cm,0,0.00%,3,3,0.00%
www.google.am,0,0.00%,4,4,0.00%
www.google.at,0,0.00%,4,4,0.00%
www.google.az,0,0.00%,4,4,0.00%
www.google.ca,0,0.00%,4,4,0.00%
pcs.baidu.com,0,0.00%,2,2,0.00%
wiz.cn,0,0.00%,2,2,0.00%
doc88.com,0,0.00%,2,2,0.00%
gmail.com,0,0.00%,2,2,0.00%
outlook.office.com,0,0.00%,4,4,0.00%
mail.126.com,0,0.00%,4,4,0.00%
up.sinastorage.com,0,0.00%,2,2,0.00%
mail.263.net,0,0.00%,2,2,0.00%
www.google.de,0,0.00%,4,4,0.00%
jamboard.google.com,0,0.00%,2,2,0.00%
meet.google.com,0,0.00%,2,2,0.00%
photos.google.com,0,0.00%,2,2,0.00%
www.google.ad,0,0.00%,2,2,0.00%
www.google.bf,0,0.00%,3,3,0.00%
www.google.bt,0,0.00%,3,3,0.00%
www.google.by,0,0.00%,3,3,0.00%
www.google.ch,0,0.00%,4,4,0.00%
comm.weixinbridge.com,0,0.00%,2,2,0.00%
login.windows.net,0,0.00%,2,2,0.00%
www.getdropbox.com,0,0.00%,2,2,0.00%
www.google.dk,0,0.00%,4,4,0.00%
wx2.qq.com,0,0.00%,2,2,0.00%
file.wx.qq.com,0,0.00%,2,2,0.00%
live.com,0,0.00%,2,2,0.00%
t1.pow7.com,0,0.00%,6,6,0.00%
retracker.mgts.by,0,0.00%,16,16,0.00%
www.mvgroup.org,0,0.00%,2,2,0.00%
onedriveclucprodbn20014.blob.core.windows.net,0,0.00%,2,2,0.00%
paint.ludashi.com,0,0.00%,2,2,0.00%
report.meituan.com,0,0.00%,2,2,0.00%
s.w.org,0,0.00%,2,2,0.00%
s2.symcb.com,0,0.00%,2,2,0.00%
sat02pap005.storage.live.com,0,0.00%,2,2,0.00%
sealine.youku.com,0,0.00%,2,2,0.00%
sf.symcd.com,0,0.00%,3,3,0.00%
sharkwsbj.sankuai.com,0,0.00%,2,2,0.00%
sl-log.oray.net,0,0.00%,4,4,0.00%
slp2p-east-std1033.oray.net,0,0.00%,2,2,0.00%
slp2p-east-std61.oray.net,0,0.00%,2,2,0.00%
slp2px-east-std31.oray.net,0,0.00%,4,4,0.00%
spinfo.wps.cn,0,0.00%,2,2,0.00%
tip.soku.com,0,0.00%,2,2,0.00%
umwatson.events.data.microsoft.com,0,0.00%,8,8,0.00%
user.youku.com,0,0.00%,2,2,0.00%
v.youku.com,0,0.00%,2,2,0.00%
v2.reachmax.cn,0,0.00%,2,2,0.00%
vip.youku.com,0,0.00%,2,2,0.00%
web.meituan.com,0,0.00%,2,2,0.00%
www.sogou.com,0,0.00%,2,2,0.00%
www.urbandictionary.com,0,0.00%,2,2,0.00%
www.youku.com,0,0.00%,2,2,0.00%
share.camoe.cn,0,0.00%,2,2,0.00%
frp.zwlin.top,0,0.00%,4,4,0.00%
open.acgtracker.com,0,0.00%,4,4,0.00%
online.s.xzdesktop.cqttech.com,0,0.00%,12,12,0.00%
i.gridsumdissector.com,0,0.00%,3,3,0.00%
mediaclub.tv,0,0.00%,2,2,0.00%
sdk1xyajs.data.kuiniuca.com,0,0.00%,2,2,0.00%
tracker.files.fm,0,0.00%,4,4,0.00%
nodestore-kiros-prod-lb-132549143.us-east-1.elb.amazonaws.com,0,0.00%,2,2,0.00%
tracker.frozen-layer.net,0,0.00%,2,2,0.00%
api.network.apm.miwifi.com,0,0.00%,1,1,0.00%
configsvr.openmsf.3g.qq.com,0,0.00%,2,2,0.00%
onedriveclucprodbn20010.blob.core.windows.net,0,0.00%,2,2,0.00%
skyapi.live.net,0,0.00%,2,2,0.00%
sv.symcd.com,0,0.00%,2,2,0.00%
yk-ssp.ad.youku.com,0,0.00%,2,2,0.00%
ynuf.aliapp.org,0,0.00%,2,2,0.00%
ynuf.alipay.com,0,0.00%,4,4,0.00%
youku.com,0,0.00%,2,2,0.00%
api-kos.wps.cn,0,0.00%,2,2,0.00%
wsgo.minigame.qq.com,0,0.00%,2,2,0.00%
12-courier.push.apple.com,0,0.00%,2,2,0.00%
secure.pow7.com,0,0.00%,6,6,0.00%
denis.stalker.upeer.me,0,0.00%,4,4,0.00%
www.tvnihon.com,0,0.00%,4,4,0.00%
tracker.gbitt.info,0,0.00%,2,2,0.00%
filehelper.weixin.qq.com,0,0.00%,8,8,0.00%
tracker.tfile.co,0,0.00%,1,1,0.00%
tracker.publicbt.com,0,0.00%,1,1,0.00%
shiyd.cn,0,0.00%,2,2,0.00%
www.zotero.org,0,0.00%,2,2,0.00%
r4---sn-2x3elnez.gvt1.com,0,0.00%,2,2,0.00%
d3ra9679oeq3gx.cloudfront.net,0,0.00%,2,2,0.00%
tracker.minglong.org,0,0.00%,2,2,0.00%
www.tg5tj2cu.com,0,0.00%,2,2,0.00%
h4.trakx.nibba.trade,0,0.00%,3,3,0.00%
nvidia.github.io,0,0.00%,2,2,0.00%
warehouse.leapmotion.com,0,0.00%,2,2,0.00%
apphub.aliyuncs.com,0,0.00%,4,4,0.00%
www.bit-hdtv.com,0,0.00%,2,2,0.00%
www.jetbrains.com,0,0.00%,4,4,0.00%
tracker.anirena.com,0,0.00%,2,2,0.00%
tracker.nucozer-tracker.ml,0,0.00%,2,2,0.00%
ccm-frontier.feishu.cn,0,0.00%,1,1,0.00%
r4---sn-2x3elnel.gvt1.com,0,0.00%,2,2,0.00%
onedriveclucproddm20018.blob.core.windows.net,0,0.00%,2,2,0.00%
gzc-download.weiyun.com,0,0.00%,2,2,0.00%
odoooacnz-my.sharepoint.com,0,0.00%,1,1,0.00%
tr.abirxo.cf,0,0.00%,6,6,0.00%
app-b04.lp1.npns.srv.nintendo.net,0,0.00%,2,2,0.00%
tracker.tasvideos.org,0,0.00%,4,4,0.00%
yapi.kdsec.org,0,0.00%,44,44,0.00%
array611.prod.do.dsp.mp.microsoft.com,0,0.00%,2,2,0.00%
saladict.crimx.com,0,0.00%,2,2,0.00%
www.legittorrents.info,0,0.00%,2,2,0.00%
www.blackcats-games.net,0,0.00%,2,2,0.00%
atrack.pow7.com,0,0.00%,4,4,0.00%
tunnel.cfw.trustedsource.org,0,0.00%,2,2,0.00%
seeds-darwin.xycdn.com,0,0.00%,2,2,0.00%
dx.doi.org,0,0.00%,2,2,0.00%
gaea.meituan.com,0,0.00%,2,2,0.00%
ic-business.ks3-cn-beijing.ksyun.com,0,0.00%,2,2,0.00%
bt.firebit.org,0,0.00%,2,2,0.00%
iframe.videodelivery.net,0,0.00%,3,3,0.00%
www.lixiangdao.vip,0,0.00%,2,2,0.00%
tracker.trancetraffic.com,0,0.00%,2,2,0.00%
rq.lbcct.cloud.duba.net,0,0.00%,6,6,0.00%
www.freerainbowtables.com,0,0.00%,2,2,0.00%
tracker.openzim.org,0,0.00%,2,2,0.00%
home.yxgz.vip,0,0.00%,2,2,0.00%
sh-download.weiyun.com,0,0.00%,2,2,0.00%
tracker.internetwarriors.net,0,0.00%,2,2,0.00%
cqc-download.weiyun.com,0,0.00%,2,2,0.00%
ww3.mediaclub.tv,0,0.00%,2,2,0.00%
pc-diffpack.wps.cn,0,0.00%,2,2,0.00%
push.thanos.ams.eulix.xyz,0,0.00%,2,2,0.00%
api.ultimaker.com,0,0.00%,6,6,0.00%
tracker.filepit.to,0,0.00%,2,2,0.00%
tr.cili001.com,0,0.00%,2,2,0.00%
0d.kebhana.mx,0,0.00%,2,2,0.00%
a.tampermonkey.net,0,0.00%,2,2,0.00%
cloudflarestream.com,0,0.00%,3,3,0.00%
mq.dataservices.hp.com,0,0.00%,2,2,0.00%
onedriveclucproddm20040.blob.core.windows.net,0,0.00%,4,4,0.00%
beertracker.ml,0,0.00%,2,2,0.00%
bluebird-hd.org,0,0.00%,2,2,0.00%
push.zhihu.com,0,0.00%,2,2,0.00%
aegis.qq.com,0,0.00%,2,2,0.00%
irrenhaus.dyndns.dk,0,0.00%,2,2,0.00%
all4nothin.net,0,0.00%,2,2,0.00%
cache.yisu.com,0,0.00%,2,2,0.00%
tracker.nanoha.org,0,0.00%,2,2,0.00%
openbittorrent.com,0,0.00%,2,2,0.00%
tracker.frozen-layer.com,0,0.00%,2,2,0.00%
xtremewrestlingtorrents.net,0,0.00%,2,2,0.00%
dmd.metaservices.microsoft.com,0,0.00%,1,1,0.00%
embed.cloudflarestream.com,0,0.00%,2,2,0.00%
filters.adtidy.org,0,0.00%,4,4,0.00%
onedriveclucproddm20007.blob.core.windows.net,0,0.00%,2,2,0.00%
tracker.moeking.me,0,0.00%,2,2,0.00%
q.soft.360.cn,0,0.00%,4,4,0.00%
q.cnblogs.com,0,0.00%,14,14,0.00%
recycle.i5.cn,0,0.00%,7,7,0.00%
update-drcn.platform.hicloud.com,0,0.00%,4,4,0.00%
hub5u.hz.sandai.net,0,0.00%,6,6,0.00%
app4.i4.cn,0,0.00%,6,6,0.00%
custom-cursor.com,0,0.00%,2,2,0.00%
api.dida365.com,0,0.00%,4,4,0.00%
serviceplus.phytium.com.cn,0,0.00%,14,14,0.00%
bgpv4.music.ntes53.netease.com,0,0.00%,2,2,0.00%
api.yiban.io,0,0.00%,6,6,0.00%
thunderx.rcv.sandai.net,0,0.00%,4,4,0.00%
hub5pnc.hz.sandai.net,0,0.00%,6,6,0.00%
app.huabao.360.cn,0,0.00%,7,7,0.00%
download.jetbrains.com,0,0.00%,2,2,0.00%
domainask.weibanio.cn,0,0.00%,8,8,0.00%
color.docer.wps.cn,0,0.00%,4,4,0.00%
onedscolprdcus02.centralus.cloudapp.azure.com,0,0.00%,2,2,0.00%
rm-2zelg248g7y2034w7do.mysql.rds.aliyuncs.com,0,0.00%,13,13,0.00%
feedback.youdao.com,0,0.00%,2,2,0.00%
url.i4.cn,0,0.00%,2,2,0.00%
d-updater.i4.cn,0,0.00%,2,2,0.00%
ios.pclog.i4.cn,0,0.00%,5,5,0.00%
mam.netease.com,0,0.00%,4,4,0.00%
array801.prod.do.dsp.mp.microsoft.com,0,0.00%,4,4,0.00%
array812.prod.do.dsp.mp.microsoft.com,0,0.00%,2,2,0.00%
hxhvnih.nyjvbs.xyz,0,0.00%,4,4,0.00%
www.tm.lg.prod.aadmsa.akadns.net,0,0.00%,4,4,0.00%
api.shoptoit.net,0,0.00%,2,2,0.00%
cdn.onenote.net,0,0.00%,2,2,0.00%
minorshort.weixin.qq.com,0,0.00%,4,4,0.00%
array810.prod.do.dsp.mp.microsoft.com,0,0.00%,2,2,0.00%
array809.prod.do.dsp.mp.microsoft.com,0,0.00%,2,2,0.00%
array806.prod.do.dsp.mp.microsoft.com,0,0.00%,4,4,0.00%
kv801.prod.do.dsp.mp.microsoft.com,0,0.00%,2,2,0.00%
1582937130534912.mqrest.cn-qingdao-public.aliyuncs.com,0,0.00%,2,2,0.00%
v2.cs3.duba.net,0,0.00%,5,5,0.00%
appleimap.163.com,0,0.00%,4,4,0.00%
pds.ess.apple.com,0,0.00%,2,2,0.00%
imhub5pr.hz.sandai.net,0,0.00%,2,2,0.00%
hub5pr.hz.sandai.net,0,0.00%,2,2,0.00%
onedscolprdeus01.eastus.cloudapp.azure.com,0,0.00%,2,2,0.00%
www.microvirt.com,0,0.00%,2,2,0.00%
nstool.netease.com,0,0.00%,2,2,0.00%
only-982678-124-16-140-6.nstool.netease.com,0,0.00%,1,1,0.00%
yiban.io,0,0.00%,4,4,0.00%
configuration.apple.com,0,0.00%,2,2,0.00%
ac.dun.163.com,0,0.00%,2,2,0.00%
update.client.163.com,0,0.00%,2,2,0.00%
www.update.microsoft.com,0,0.00%,2,2,0.00%
watson.microsoft.com,0,0.00%,2,2,0.00%
orcid.org,0,0.00%,2,2,0.00%
web.push.126.net,0,0.00%,2,2,0.00%
notify.adobe.io,0,0.00%,4,4,0.00%
ac.dun.163yun.com,0,0.00%,2,2,0.00%
cdn.fwupd.org,0,0.00%,6,6,0.00%
ppa.launchpad.net,0,0.00%,2,2,0.00%
archive.ubuntukylin.com,0,0.00%,2,2,0.00%
packages.microsoft.com,0,0.00%,1,1,0.00%
teams.events.data.microsoft.com,0,0.00%,2,2,0.00%
security.ubuntu.com,0,0.00%,2,2,0.00%
cn.archive.ubuntu.com,0,0.00%,1,1,0.00%
lenovo.archive.canonical.com,0,0.00%,2,2,0.00%
dashboard.snapcraft.io,0,0.00%,5,5,0.00%
dss3.bdstatic.com,0,0.00%,1,1,0.00%
odrs.gnome.org,0,0.00%,2,2,0.00%
array813.prod.do.dsp.mp.microsoft.com,0,0.00%,1,1,0.00%
tools.google.com,0,0.00%,1,1,0.00%
account.jetbrains.com,0,0.00%,3,3,0.00%
forum.qt.io,0,0.00%,2,2,0.00%
cdn-ali-file-shc.shanhutech.cn,0,0.00%,1,1,0.00%
ditu.baidu.com,0,0.00%,3,3,0.00%
api.naea1.uds.lenovo.com,0,0.00%,7,7,0.00%
ksn-file-geo.kaspersky-labs.com,0,0.00%,2,2,0.00%
sourcegraph.com,0,0.00%,2,2,0.00%
eo.dbpedia.org,0,0.00%,1,1,0.00%
d21wlyhffxxqkt.cloudfront.net,0,0.00%,4,4,0.00%
doh.zjurl.cn,0,0.00%,4,4,0.00%
slack.com,0,0.00%,7,7,0.00%
msg.qy.net,0,0.00%,3,3,0.00%
kns.duba.net,0,0.00%,2,2,0.00%
boot-02.net.anydesk.com,0,0.00%,12,12,0.00%
uptime.sangfor.net,0,0.00%,1,1,0.00%
api2.gettoby.com,0,0.00%,1,1,0.00%
dev.ditu.live.com,0,0.00%,7,7,0.00%
d15wdfb2rw9n2y.cloudfront.net,0,0.00%,2,2,0.00%
api.distill.io,0,0.00%,6,6,0.00%
ocsp.verisign.com,0,0.00%,4,4,0.00%
dl.fedoraproject.org,0,0.00%,2,2,0.00%
fedora.riscv.rocks,0,0.00%,2,2,0.00%
pc-api.wondershare.cc,0,0.00%,2,2,0.00%
dgapi.zhhainiao.com,0,0.00%,2,2,0.00%
udp.cloud.duba.net,0,0.00%,2,2,0.00%
consumerapps.mcafee.com,0,0.00%,2,2,0.00%
dsm01pap002.storage.live.com,0,0.00%,1,1,0.00%
pcw-api.iqiyi.com,0,0.00%,2,2,0.00%
onedriveclucproddm20008.blob.core.windows.net,0,0.00%,2,2,0.00%
bubble.ic.ksosoft.com,0,0.00%,4,4,0.00%
servicediscovery.ccs.mcafee.com,0,0.00%,2,2,0.00%
basic-enroll.ccs.mcafee.com,0,0.00%,2,2,0.00%
microsoftgraph.chinacloudapi.cn,0,0.00%,2,2,0.00%
p3n9w31.cloud,0,0.00%,2,2,0.00%
c-uaa.if.iqiyi.com,0,0.00%,2,2,0.00%
msg.video.qiyi.com,0,0.00%,2,2,0.00%
gates.grammarly.com,0,0.00%,2,2,0.00%
bleisure.ba.com,0,0.00%,1,1,0.00%
api-std.sunlogin.oray.com,0,0.00%,4,4,0.00%
rgmb.classic.kicksite.net,0,0.00%,1,1,0.00%
router12.teamviewer.com,0,0.00%,4,4,0.00%
hsk-api.oray.com,0,0.00%,2,2,0.00%
wm.xiajunhuagong.cn.w.cdngslb.com,0,0.00%,2,2,0.00%
dy.xiajunhuagong.cn.w.cdngslb.com,0,0.00%,2,2,0.00%
t-safe.2345.cc,0,0.00%,2,2,0.00%
app.smartmailcloud.com,0,0.00%,2,2,0.00%
imap.mail.me.com.akadns.net,0,0.00%,2,2,0.00%
imap-mail.outlook.com,0,0.00%,4,4,0.00%
newvip.duba.net,0,0.00%,4,4,0.00%
broadcast2.distill.io,0,0.00%,4,4,0.00%
array612.prod.do.dsp.mp.microsoft.com,0,0.00%,2,2,0.00%
ledger.bt.co,0,0.00%,4,4,0.00%
acc.qq.com,0,0.00%,4,4,0.00%
data.hicloud.com,0,0.00%,2,2,0.00%
g.msn.com,0,0.00%,2,2,0.00%
open.u-tools.cn,0,0.00%,2,2,0.00%
o137163.ingest.sentry.io,0,0.00%,4,4,0.00%
azwcus1-client-s.gateway.messenger.live.com,0,0.00%,2,2,0.00%
imap.sina.com,0,0.00%,2,2,0.00%
go.ie.sogou.com,0,0.00%,6,6,0.00%
mail.triinnboc.com,0,0.00%,2,2,0.00%
notify3.note.youdao.com,0,0.00%,4,4,0.00%
s00.upd.kaspersky.com,0,0.00%,4,4,0.00%
visualstudio-devdiv-c2s.msedge.net,0,0.00%,2,2,0.00%
litedev.ys7.com,0,0.00%,2,2,0.00%
inversine.elseway.tk,0,0.00%,61,61,0.00%
vcityteam.github.io,0,0.00%,1,1,0.00%
ct.duba.net,0,0.00%,2,2,0.00%
www.ztb.im,0,0.00%,2,2,0.00%
jrebel.npegeek.com,0,0.00%,1,1,0.00%
dlied6.qq.com,0,0.00%,6,6,0.00%
stun.qqlive.qq.com,0,0.00%,4,4,0.00%
d3e5zkjv0mw5t1.cloudfront.net,0,0.00%,1,1,0.00%
onedscolprduks00.uksouth.cloudapp.azure.com,0,0.00%,2,2,0.00%
wsus.f.360.cn,0,0.00%,5,5,0.00%
jtwlgl.nm.chinamobile.com,0,0.00%,2,2,0.00%
www.a.shifen.com,0,0.00%,4,4,0.00%
tracker4.itzmx.com,0,0.00%,2,2,0.00%
watson.telemetry.microsoft.com,0,0.00%,3,3,0.00%
ntemp01.boom.skin,0,0.00%,2,2,0.00%
jp17.boom.skin,0,0.00%,2,2,0.00%
edge-microsoft-com.dual-a-0036.a-msedge.NET,0,0.00%,2,2,0.00%
hq.sinajs.cn,0,0.00%,2,2,0.00%
sec23summer.usenix.hotcrp.com,0,0.00%,3,3,0.00%
dsm01pap008.storage.live.com,0,0.00%,2,2,0.00%
onedriveclucproddm20021.blob.core.windows.net,0,0.00%,2,2,0.00%
deault-exp-tas-com.e-0014.e-msedge.NET,0,0.00%,2,2,0.00%
doh-fi.blahdns.com,0,0.00%,2,2,0.00%
www.w3.org,0,0.00%,110,110,0.00%
435749f6f4f748a5821bee8bcb13087c.fp.measure.office.com,0,0.00%,1,1,0.00%
ataprod.remarqable.com,0,0.00%,2,2,0.00%
tuna05.mcddns01.com,0,0.00%,10,10,0.00%
dict.youdao.com,0,0.00%,4,4,0.00%
news.qhstatic.com,0,0.00%,4,4,0.00%
mcafee-sustainability.azurewebsites.net,0,0.00%,19,19,0.00%
clientstream.launchdarkly.com,0,0.00%,2,2,0.00%
dr.ime.baidu.com,0,0.00%,10,10,0.00%
config.mobile.kugou.com,0,0.00%,2,2,0.00%
router10.teamviewer.com,0,0.00%,4,4,0.00%
shdf01-iopq.cgroads.com,0,0.00%,2,2,0.00%
api.weixin.qq.com,0,0.00%,2,2,0.00%
817beb9c-rh6hs0-rrfsly-dmr0.pccw.alrihla.net,0,0.00%,2,2,0.00%
update.drivergenius.com,0,0.00%,4,4,0.00%
report.meeting.tencent.com,0,0.00%,2,2,0.00%
userweatherapi-xzdesktop.cqttech.com,0,0.00%,2,2,0.00%
conn.wemeet.tencent.com,0,0.00%,2,2,0.00%
onedriveclucprodbn20040.blob.core.windows.net,0,0.00%,2,2,0.00%
hello-sherlock.github.io,0,0.00%,1,1,0.00%
contentsec.ac.cn,0,0.00%,2,2,0.00%
www.gsd92gov.com,0,0.00%,3,3,0.00%
todolist.redirect.xzdesktop.cqttech.com,0,0.00%,2,2,0.00%
marketplace.visualstudio.com,0,0.00%,2,2,0.00%
learn.unity.com,0,0.00%,2,2,0.00%
report.51nwt.com,0,0.00%,8,8,0.00%
clients.config.office.net,0,0.00%,2,2,0.00%
config.push.sogou.com,0,0.00%,1,1,0.00%
slscr.update.microsoft.com,0,0.00%,8,8,0.00%
update.khd.2345.cc,0,0.00%,4,4,0.00%
push.khd.2345.cc,0,0.00%,6,6,0.00%
mhxzxhd.wmupd.com,0,0.00%,2,2,0.00%
browser.events.data.msn.com,0,0.00%,2,2,0.00%
max-l.mediav.com,0,0.00%,4,4,0.00%
gtm-sg-6wr2u201t05.gtm-i2d4.com,0,0.00%,11,11,0.00%
api.300624.com,0,0.00%,2,2,0.00%
ts.helper.2345.cc,0,0.00%,4,4,0.00%
yj.52pcfree.com,0,0.00%,2,2,0.00%
searchrecommend.kugou.com,0,0.00%,6,6,0.00%
www.codota.com,0,0.00%,4,4,0.00%
cloudconfig.jetbrains.com,0,0.00%,2,2,0.00%
trans.hiido.com,0,0.00%,4,4,0.00%
yeconfig.game.yy.com,0,0.00%,4,4,0.00%
config.hiido.com,0,0.00%,2,2,0.00%
ylog.hiido.com,0,0.00%,2,2,0.00%
u.jia.mn,0,0.00%,2,2,0.00%
presence.api.drift.com,0,0.00%,4,4,0.00%
apis-mix-pub.maxhub.vip,0,0.00%,3,3,0.00%
stat.game.yy.com,0,0.00%,4,4,0.00%
dsm01pap005.storage.live.com,0,0.00%,2,2,0.00%
onedriveclucprodbn20007.blob.core.windows.net,0,0.00%,2,2,0.00%
identify.zhhainiao.com,0,0.00%,2,2,0.00%
edgeassetservice.azureedge.net,0,0.00%,2,2,0.00%
onedriveclucprodbn20020.blob.core.windows.net,0,0.00%,2,2,0.00%
be59399.pd.gladns.com,0,0.00%,4,4,0.00%
be59399.pf.gladns.com,0,0.00%,4,4,0.00%
be59399.pb.gladns.com,0,0.00%,4,4,0.00%
be59399.pc.gladns.com,0,0.00%,4,4,0.00%
be59399.ph.gladns.com,0,0.00%,4,4,0.00%
be59399.pa.gladns.com,0,0.00%,4,4,0.00%
be59399.pg.gladns.com,0,0.00%,4,4,0.00%
be59399.pe.gladns.com,0,0.00%,4,4,0.00%
interface.music.163.com,0,0.00%,2,2,0.00%
huggingface.co,0,0.00%,4,4,0.00%
article.cnjournals.com,0,0.00%,2,2,0.00%
dns.rubyfish.cn,0,0.00%,4,4,0.00%
dns.alidns.com,0,0.00%,4,4,0.00%
array615.prod.do.dsp.mp.microsoft.com,0,0.00%,2,2,0.00%
disc601.prod.do.dsp.mp.microsoft.com,0,0.00%,2,2,0.00%
www.cloudflare.com,0,0.00%,4,4,0.00%
ide.liuyingyong.cn,0,0.00%,4,4,0.00%
syzs.qq.com,0,0.00%,2,2,0.00%
service-cn.hwccpc.com,0,0.00%,2,2,0.00%
yybadaccess.3g.qq.com,0,0.00%,2,2,0.00%
license.unity.cn,0,0.00%,2,2,0.00%
list.wallpaper.cloud.duba.net,0,0.00%,2,2,0.00%
wh.vipguanjia.net,0,0.00%,2,2,0.00%
ss-prod-an1-notif-19.aws.adobess.com,0,0.00%,2,2,0.00%
pop3.nfschina.com,0,0.00%,4,4,0.00%
update-khd.2345.cc,0,0.00%,10,10,0.00%
mcs.snssdk.com,0,0.00%,4,4,0.00%
discuss.pytorch.org,0,0.00%,3,3,0.00%
stat.lianmeng.360.cn,0,0.00%,2,2,0.00%
sfstat.lianmeng.360.cn,0,0.00%,2,2,0.00%
sp4.tf.360.cn,0,0.00%,2,2,0.00%
o1224273.ingest.sentry.io,0,0.00%,2,2,0.00%
repo.hortonworks.com,0,0.00%,2,2,0.00%
wns2-sg2p.wns.windows.com,0,0.00%,2,2,0.00%
array604.prod.do.dsp.mp.microsoft.com,0,0.00%,2,2,0.00%
tips.ime.baidu.com,0,0.00%,2,2,0.00%
www.hilton.com,0,0.00%,3,3,0.00%
fast.fonts.net,0,0.00%,4,4,0.00%
hilton.cdn-v3.conductrics.net,0,0.00%,2,2,0.00%
www.figma.com,0,0.00%,4,4,0.00%
91920a6655024c3bbbad50d3958e724c.nrb.footprintdns.com,0,0.00%,1,1,0.00%
szcloud.baidu.com,0,0.00%,2,2,0.00%
pop.ym.163.com,0,0.00%,4,4,0.00%
mobilelog.kugou.com,0,0.00%,2,2,0.00%
cbwh5s4.i3zmbs.com,0,0.00%,1,1,0.00%
fpc.msedge.net,0,0.00%,2,2,0.00%
bf08412nhq.bf.dynatrace.com,0,0.00%,4,4,0.00%
mailhz.qiye.163.com,0,0.00%,2,2,0.00%
f10.baidu.com,0,0.00%,2,2,0.00%
159-226-5-174_s-23-32-236-243_ts-1661277004-clienttons-s.akamaihd.net,0,0.00%,1,1,0.00%
t7rallqxzodvuyyfcnga-pttdjv-2ec39af8f-clientnsv4-s.akamaihd.net,0,0.00%,1,1,0.00%
dpm.demdex.net,0,0.00%,4,4,0.00%
4dc2aa82bc5e.cdn4.forter.com,0,0.00%,4,4,0.00%
smetric.hilton.com,0,0.00%,4,4,0.00%
cm.everesttech.net,0,0.00%,4,4,0.00%
cdnjs.cloudflare.com,0,0.00%,4,4,0.00%
onedriveclucprodbn20024.blob.core.windows.net,0,0.00%,2,2,0.00%
prt.jss.com.cn,0,0.00%,2,2,0.00%
time.asia.apple.com,0,0.00%,2,2,0.00%
xfer.10jqka.com.cn,0,0.00%,2,2,0.00%
s.thsi.cn,0,0.00%,2,2,0.00%
help-tower.2345.cc,0,0.00%,4,4,0.00%
array605.prod.do.dsp.mp.microsoft.com,0,0.00%,2,2,0.00%
onedriveclucproddm20046.blob.core.windows.net,0,0.00%,2,2,0.00%
analytics.getpostman.com,0,0.00%,6,6,0.00%
activation.unity.cn,0,0.00%,2,2,0.00%
11-courier.push.apple.com,0,0.00%,2,2,0.00%
pop.exmail.qq.com,0,0.00%,4,4,0.00%
e10370.d.akamaiedge.NET,0,0.00%,1,1,0.00%
nexus-websocket-a.intercom.io,0,0.00%,2,2,0.00%
newxmp.rcv.sandai.net,0,0.00%,2,2,0.00%
onedriveclucprodbn20002.blob.core.windows.net,0,0.00%,2,2,0.00%
onedriveclucproddm20027.blob.core.windows.net,0,0.00%,2,2,0.00%
paradromic.info,0,0.00%,2,2,0.00%
p2pupgrade.gamedl.qq.com,0,0.00%,2,2,0.00%
stat.gamedl.qq.com,0,0.00%,2,2,0.00%
ps2.gamedl.qq.com,0,0.00%,2,2,0.00%
config.gamedl.qq.com,0,0.00%,2,2,0.00%
p2pupdate.gamedl.qq.com,0,0.00%,2,2,0.00%
data.vipguanjia.net,0,0.00%,2,2,0.00%
router1.teamviewer.com,0,0.00%,4,4,0.00%
array601.prod.do.dsp.mp.microsoft.com,0,0.00%,2,2,0.00%
jp05-vm0.entry.srthdw.art,0,0.00%,2,2,0.00%
jp01-vm0.entry.srthdw.art,0,0.00%,2,2,0.00%
localhost,0,0.00%,31,31,0.00%
server.reverse.ac.cn,0,0.00%,24,24,0.00%
wspri.coinall.ltd,0,0.00%,6,6,0.00%
gzyd.lanyunshi.cc,0,0.00%,3,3,0.00%
rsync.deepin.com,0,0.00%,2,2,0.00%
musicps.p2p.qq.com,0,0.00%,4,4,0.00%
wd-prod-ss-as-southeast-3-fe.southeastasia.cloudapp.azure.com,0,0.00%,4,4,0.00%
23-92-30-53.3f5ffcbecff340969874c9eb90a37eeb.plex.direct,0,0.00%,1,1,0.00%
ntp.aliyun.com,0,0.00%,4,4,0.00%
g.ceipmsn.com,0,0.00%,2,2,0.00%
mirror.iscas.ac.cn,0,0.00%,14,14,0.00%
weather-data.apple.com.akadns.net,0,0.00%,4,4,0.00%
downloads.yoctoproject.org,0,0.00%,174,174,0.00%
az575602.vo.msecnd.net,0,0.00%,2,2,0.00%
dhupdateprod.blob.core.windows.net,0,0.00%,2,2,0.00%
chat.api.autohome.com.cn,0,0.00%,2,2,0.00%
33aef1e.ne.gladns.com,0,0.00%,2,2,0.00%
beacons4.gvt2.com,0,0.00%,2,2,0.00%
a2p-s01-drcn.xcm.xyx-xylo.com,0,0.00%,10,10,0.00%
mirrors.163.com,0,0.00%,2,2,0.00%
update.cs2c.com.cn,0,0.00%,2,2,0.00%
7195c67.ph.gladns.com,0,0.00%,2,2,0.00%
mirrors.rit.edu,0,0.00%,2,2,0.00%
array505.prod.do.dsp.mp.microsoft.com,0,0.00%,2,2,0.00%
onedscolprdwus09.westus.cloudapp.azure.com,0,0.00%,2,2,0.00%
rsync.repo.almalinux.org,0,0.00%,2,2,0.00%
static-api.monknow.com,0,0.00%,2,2,0.00%
socc2022.hotcrp.com,0,0.00%,2,2,0.00%
mirror.us.leaseweb.net,0,0.00%,2,2,0.00%
baoku-safe.2345.cc,0,0.00%,2,2,0.00%
update-ruanjian.2345.cc,0,0.00%,2,2,0.00%
rj-ts.2345.cc,0,0.00%,2,2,0.00%
mixv4-2.194610.xyz,0,0.00%,2,2,0.00%
api.raese.top,0,0.00%,2,2,0.00%
meeting.tencent.com,0,0.00%,2,2,0.00%
localhost.localdomain,0,0.00%,5,5,0.00%
mirrors.tuna.tsinghua.edu.cn,0,0.00%,2,2,0.00%
mirrorz.org,0,0.00%,2,2,0.00%
windows.kite.com,0,0.00%,1,1,0.00%
zhushou.huihui.cn,0,0.00%,2,2,0.00%
a.w.bilicdn1.com,0,0.00%,2,2,0.00%
r2---sn-ni5eln7l.gvt1.com,0,0.00%,2,2,0.00%
k8s.gcr.io,0,0.00%,7,7,0.00%
comet.jianguoyun.com,0,0.00%,2,2,0.00%
settings-prod-sea-2.southeastasia.cloudapp.azure.com,0,0.00%,2,2,0.00%
88dsf5l.003.1.mclqp.link,0,0.00%,2,2,0.00%
t-ruanjian.2345.cc,0,0.00%,2,2,0.00%
msg.video.dns.iqiyi.com,0,0.00%,2,2,0.00%
cmonitor.iqiyi.com,0,0.00%,2,2,0.00%
is.snssdk.com,0,0.00%,2,2,0.00%
cpan-rsync.perl.org,0,0.00%,2,2,0.00%
