domain,num_aaaa_fail,rate_all,num_aaaa_all,num_aaaa_success,rate_aaaa_fail
sources.openembedded.org,2910,5.11%,2910,0,100.00%
www.chinauos.com,2767,4.86%,2767,0,100.00%
www.baidu.com,2765,4.85%,4851,2086,57.00%
note.youdao.com,1492,2.62%,1492,0,100.00%
hub5p.sandai.net,1446,2.54%,1446,0,100.00%
xgpolardb.mysql.polardb.rds.aliyuncs.com,1210,2.12%,1210,0,100.00%
connectivity-check.ubuntu.com,1100,1.93%,1100,0,100.00%
rq.r9t1.com,920,1.61%,920,0,100.00%
optimizationguide-pa.googleapis.com,736,1.29%,760,24,96.84%
hsk-embed.oray.com,734,1.29%,734,0,100.00%
api.miwifi.com,594,1.04%,594,0,100.00%
yapi.kdsec.org,585,1.03%,585,0,100.00%
daisy.ubuntu.com,583,1.02%,1267,684,46.01%
i5.cwip.eset.com,546,0.96%,546,0,100.00%
settings-win.data.microsoft.com,505,0.89%,505,0,100.00%
git.rancher.io,503,0.88%,1039,536,48.41%
us-v20.events.data.microsoft.com,496,0.87%,594,98,83.50%
assets.contentstack.io,449,0.79%,449,0,100.00%
www.msftncsi.com,447,0.78%,447,0,100.00%
edragent.sangfor.com.cn,396,0.70%,396,0,100.00%
v10.events.data.microsoft.com,370,0.65%,419,49,88.31%
github.com,352,0.62%,352,0,100.00%
ip.42.pl,352,0.62%,352,0,100.00%
osfsr.lenovomm.com,337,0.59%,337,0,100.00%
x.research.qq.com,334,0.59%,334,0,100.00%
safebrowsing.googleapis.com,265,0.47%,274,9,96.72%
www.expressapisv2.net,257,0.45%,473,216,54.33%
ipv4only.arpa,251,0.44%,251,0,100.00%
browser.360.cn,249,0.44%,252,3,98.81%
es.proj217.app.kdsec.org,224,0.39%,224,0,100.00%
mail.cstnet.cn,223,0.39%,425,202,52.47%
watson.telemetry.microsoft.com,221,0.39%,221,0,100.00%
allall01.baidupcs.com,214,0.38%,389,175,55.01%
shuc-pc-hunt.ksord.com,212,0.37%,212,0,100.00%
vortex.data.microsoft.com,211,0.37%,211,0,100.00%
analytics.yinxiang.com,199,0.35%,199,0,100.00%
tunnel.cfw.trustedsource.org,192,0.34%,192,0,100.00%
ctldl.windowsupdate.com,189,0.33%,197,8,95.94%
self.events.data.microsoft.com,184,0.32%,208,24,88.46%
h5.do889.com,174,0.31%,174,0,100.00%
get.sogou.com,169,0.30%,169,0,100.00%
incoming.telemetry.mozilla.org,168,0.29%,168,0,100.00%
duba-defend.zhhainiao.com,165,0.29%,165,0,100.00%
retracker.lanta-net.ru,162,0.28%,162,0,100.00%
alfred.ixiacom.com,154,0.27%,154,0,100.00%
retracker.mgts.by,151,0.27%,151,0,100.00%
ping.pinyin.sogou.com,149,0.26%,149,0,100.00%
stun.douyucdn.cn,144,0.25%,260,116,55.38%
stun1.douyucdn.cn,144,0.25%,144,0,100.00%
nj.t.bcsp2p.baidu.com,140,0.25%,140,0,100.00%
pool.ntp.org,139,0.24%,139,0,100.00%
mobile.events.data.microsoft.com,136,0.24%,152,16,89.47%
ntp.sjtu.edu.cn,131,0.23%,131,0,100.00%
locprod2-elb-us-west-2.prod.mozaws.net,131,0.23%,131,0,100.00%
contile.services.mozilla.com,125,0.22%,125,0,100.00%
clientservices.googleapis.com,123,0.22%,132,9,93.18%
dedi.1808.cf,122,0.21%,122,0,100.00%
api.vc.bilibili.com,121,0.21%,138,17,87.68%
config.pinyin.sogou.com,116,0.20%,224,108,51.79%
cu1pehnswss01.servicebus.windows.net,116,0.20%,116,0,100.00%
mvgforumtracker.mvgroup.org,106,0.19%,106,0,100.00%
login.live.com,106,0.19%,106,0,100.00%
rscloud.rising.net.cn,100,0.18%,100,0,100.00%
update1.sangfor.net,98,0.17%,98,0,100.00%
2.ubuntu.pool.ntp.org,97,0.17%,100,3,97.00%
mon.zijieapi.com,96,0.17%,96,0,100.00%
zw-roaming.wps.cn,95,0.17%,95,0,100.00%
roaming.wps.cn,94,0.16%,94,0,100.00%
default.exp-tas.com,92,0.16%,188,96,48.94%
content-autofill.googleapis.com,92,0.16%,98,6,93.88%
sl-tk.oray.com,88,0.15%,88,0,100.00%
android.clients.google.com,87,0.15%,87,0,100.00%
88dsf5l.003.1.mclqp.link,85,0.15%,85,0,100.00%
www.belkin.com,82,0.14%,82,0,100.00%
www.microsoft.com,80,0.14%,80,0,100.00%
qing.wps.cn,79,0.14%,144,65,54.86%
arc.msn.com,78,0.14%,78,0,100.00%
cloud.browser.360.cn,78,0.14%,78,0,100.00%
account.wps.cn,78,0.14%,78,0,100.00%
usa1v2.jsssline.top,77,0.14%,77,0,100.00%
nk1.boom.skin,77,0.14%,77,0,100.00%
e-0014.e-msedge.net,76,0.13%,76,0,100.00%
wup.browser.qq.com,76,0.13%,76,0,100.00%
h-adashx.ut.taobao.com,74,0.13%,74,0,100.00%
clients2.google.com,73,0.13%,78,5,93.59%
2.centos.pool.ntp.org,69,0.12%,69,0,100.00%
update.googleapis.com,69,0.12%,81,12,85.19%
packages.deepin.com,69,0.12%,69,0,100.00%
winatp-gw-cus3.microsoft.com,69,0.12%,69,0,100.00%
iplc-ji.mielink-dns2.com,68,0.12%,68,0,100.00%
load-balancing-system.cmy-dns.com,68,0.12%,68,0,100.00%
pan.baidu.com,68,0.12%,241,173,28.22%
e6858.e19.s.tl88.net,68,0.12%,68,0,100.00%
open.tracker.cl,68,0.12%,68,0,100.00%
www.bit-hdtv.com,68,0.12%,68,0,100.00%
d27xxe7juh1us6.cloudfront.net,68,0.12%,136,68,50.00%
www.tribalmixes.com,68,0.12%,68,0,100.00%
docer.wps.cn,67,0.12%,67,0,100.00%
home.wps.cn,66,0.12%,66,0,100.00%
qr.wps.cn,66,0.12%,66,0,100.00%
www.bing.com,65,0.11%,71,6,91.55%
vip.wps.cn,65,0.11%,65,0,100.00%
clients1.google.com,65,0.11%,65,0,100.00%
tile-service.weather.microsoft.com,64,0.11%,64,0,100.00%
api.apple-cloudkit.com,63,0.11%,63,0,100.00%
drive.wps.cn,62,0.11%,146,84,42.47%
pcs-sdk-server.alibaba.com,62,0.11%,105,43,59.05%
t.overflow.biz,62,0.11%,62,0,100.00%
api.goco.io,61,0.11%,61,0,100.00%
listen1.myradio24.com,61,0.11%,61,0,100.00%
api.aquamedian.com,61,0.11%,61,0,100.00%
mail.pnpitalia.it,61,0.11%,61,0,100.00%
w.isoleader.com.tw,61,0.11%,61,0,100.00%
test.memryplus.no,61,0.11%,61,0,100.00%
ebook-discount-checker.herokuapp.com,61,0.11%,61,0,100.00%
srv01.got-skills.de,61,0.11%,61,0,100.00%
icu.wjwblog.ml,61,0.11%,61,0,100.00%
ivdu.herokuapp.com,61,0.11%,61,0,100.00%
sklep.architekci.pl,61,0.11%,61,0,100.00%
d1w2n8w3obm3k0.cloudfront.net,61,0.11%,61,0,100.00%
botfuel-hermes-backend-bo.herokuapp.com,61,0.11%,61,0,100.00%
hicbrnuxnyozpgtj.ggyy99.tk,61,0.11%,61,0,100.00%
ldc.lenovo.com.cn,60,0.11%,60,0,100.00%
mirrors.aliyun.com,60,0.11%,63,3,95.24%
s.360.cn,60,0.11%,60,0,100.00%
apac-china-courier-4.push-apple.com.akadns.net,59,0.10%,59,0,100.00%
ris.api.iris.microsoft.com,59,0.10%,59,0,100.00%
sms.wps.cn,59,0.10%,59,0,100.00%
vasapi.wps.cn,59,0.10%,59,0,100.00%
global.quickconnect.cn,58,0.10%,58,0,100.00%
le.wps.cn,58,0.10%,58,0,100.00%
zt.wps.cn,58,0.10%,58,0,100.00%
mirror.iscas.ac.cn,58,0.10%,58,0,100.00%
v20.events.data.microsoft.com,57,0.10%,67,10,85.07%
notice.wps.cn,57,0.10%,57,0,100.00%
zj-roaming.wps.cn,57,0.10%,57,0,100.00%
slapi.oray.net,57,0.10%,57,0,100.00%
store-us-uat.motorola.com,57,0.10%,57,0,100.00%
bugly.qq.com,56,0.10%,56,0,100.00%
client.wns.windows.com,56,0.10%,103,47,54.37%
lucky.wps.cn,56,0.10%,56,0,100.00%
diskapi.baidu.com,56,0.10%,90,34,62.22%
atm-settingsfe-prod-geo2.trafficmanager.net,56,0.10%,56,0,100.00%
p3p.sogou.com,55,0.10%,55,0,100.00%
geo.wps.cn,55,0.10%,55,0,100.00%
avatar.qwps.cn,55,0.10%,55,0,100.00%
tracker.tasvideos.org,55,0.10%,88,33,62.50%
e13678.ca2.s.tl88.net,54,0.09%,54,0,100.00%
array504.prod.do.dsp.mp.microsoft.com,54,0.09%,54,0,100.00%
location.services.mozilla.com,54,0.09%,54,0,100.00%
beacons.gcp.gvt2.com,54,0.09%,58,4,93.10%
matomo.360eol.com,54,0.09%,54,0,100.00%
1-courier.sandbox.push.apple.com,53,0.09%,53,0,100.00%
iaas.wps.cn,53,0.09%,53,0,100.00%
nexusrules.officeapps.live.com,53,0.09%,98,45,54.08%
www.tvnihon.com,52,0.09%,52,0,100.00%
data.bilibili.com,52,0.09%,89,37,58.43%
docer-api.kdocs.cn,52,0.09%,52,0,100.00%
docer.kdocs.cn,52,0.09%,52,0,100.00%
www.apple.com,51,0.09%,52,1,98.08%
dldir1.qq.com,51,0.09%,51,0,100.00%
play.googleapis.com,51,0.09%,54,3,94.44%
asimov.vortex.data.trafficmanager.net,51,0.09%,51,0,100.00%
update.pan.baidu.com,51,0.09%,51,0,100.00%
pagead2.googlesyndication.com,50,0.09%,57,7,87.72%
1-courier.push.apple.com,50,0.09%,50,0,100.00%
vipapi.wps.cn,50,0.09%,50,0,100.00%
tuna05.mcddns01.com,50,0.09%,50,0,100.00%
global.asimov.events.data.trafficmanager.net,50,0.09%,50,0,100.00%
info.pinyin.sogou.com,49,0.09%,92,43,53.26%
femetrics.grammarly.io,49,0.09%,49,0,100.00%
qingcenter.wps.cn,49,0.09%,95,46,51.58%
cn.bing.com,49,0.09%,55,6,89.09%
router4.teamviewer.com,49,0.09%,49,0,100.00%
hk.tcpbbr.net,48,0.08%,95,47,50.53%
hk4.v2u9.top,48,0.08%,48,0,100.00%
hk1-7.nigirocloud.com,48,0.08%,48,0,100.00%
switch.pcfg.cache.wpscdn.cn,47,0.08%,108,61,43.52%
us1-2.nigirocloud.com,47,0.08%,47,0,100.00%
update.wps.cn,46,0.08%,46,0,100.00%
tracker2.itzmx.com,46,0.08%,46,0,100.00%
us-sandbox-courier-4.push-apple.com.akadns.net,45,0.08%,45,0,100.00%
agt.p.qianxin.com,45,0.08%,45,0,100.00%
chpm.sangfor.com.cn,45,0.08%,45,0,100.00%
tr.abirxo.cf,45,0.08%,69,24,65.22%
dd.browser.360.cn,44,0.08%,44,0,100.00%
assets.msn.cn,44,0.08%,44,0,100.00%
visualstudio-devdiv-c2s.msedge.net,44,0.08%,44,0,100.00%
imap.gmail.com,43,0.08%,59,16,72.88%
drive.wpsdns.com,42,0.07%,78,36,53.85%
db-safe.2345.cc,42,0.07%,42,0,100.00%
tracker4.itzmx.com,41,0.07%,82,41,50.00%
gitee.com,40,0.07%,40,0,100.00%
api.apple-cloudkit.fe.apple-dns.net,40,0.07%,40,0,100.00%
www.a.shifen.com,40,0.07%,79,39,50.63%
dc1.ksn.kaspersky-labs.com,40,0.07%,40,0,100.00%
mobile.events.data.trafficmanager.net,40,0.07%,45,5,88.89%
router11.teamviewer.com,40,0.07%,44,4,90.91%
checkappexec.microsoft.com,39,0.07%,39,0,100.00%
dw-online.ksosoft.com,39,0.07%,39,0,100.00%
vscode-sync.trafficmanager.net,39,0.07%,39,0,100.00%
alive.github.com,39,0.07%,39,0,100.00%
pay.wps.cn,38,0.07%,38,0,100.00%
d9caa6e02c990b0a.jijifun.com,38,0.07%,38,0,100.00%
apple.com,37,0.06%,37,0,100.00%
monorepo-production-edge-alb-985829473.us-east-1.elb.amazonaws.com,37,0.06%,37,0,100.00%
mini.browser.360.cn,37,0.06%,37,0,100.00%
2.openwrt.pool.ntp.org,37,0.06%,38,1,97.37%
console.cloud.google.com,37,0.06%,37,0,100.00%
share.camoe.cn,36,0.06%,36,0,100.00%
wu-bg-shim.trafficmanager.net,36,0.06%,36,0,100.00%
router13.teamviewer.com,36,0.06%,37,1,97.30%
socm.dmp.360.cn,35,0.06%,35,0,100.00%
rs1.qq.com,35,0.06%,35,0,100.00%
api.zotero.org,35,0.06%,35,0,100.00%
tracker.ccp.ovh,35,0.06%,35,0,100.00%
api2.firefoxchina.cn.wswebpic.com,35,0.06%,35,0,100.00%
init.push.apple.com,35,0.06%,60,25,58.33%
cdn.fwupd.org,35,0.06%,35,0,100.00%
www.mvgroup.org,34,0.06%,34,0,100.00%
opencdnmsdl1.jomodns.com,34,0.06%,34,0,100.00%
hub5pnc.sandai.net,34,0.06%,34,0,100.00%
nowpick.nowcoder.com,34,0.06%,34,0,100.00%
1min.pcfg.cache.wpscdn.cn,33,0.06%,33,0,100.00%
fanghu.qianxin.com,33,0.06%,33,0,100.00%
az764295.vo.msecnd.net,33,0.06%,33,0,100.00%
router6.teamviewer.com,33,0.06%,34,1,97.06%
gtm-sg-6wr2n62gk0f.gtm-i1d1.com,32,0.06%,32,0,100.00%
tlu.dl.delivery.mp.microsoft.com.w.alikunlun.com,32,0.06%,32,0,100.00%
www.yuwabits.net,32,0.06%,32,0,100.00%
mmbiz.qpic.cn,32,0.06%,35,3,91.43%
pc-plugin-plg.wpscdn.cn,32,0.06%,70,38,45.71%
time.windows.com,32,0.06%,32,0,100.00%
tracker1.itzmx.com,32,0.06%,32,0,100.00%
push.thanos.ams.eulix.xyz,32,0.06%,32,0,100.00%
fanyi-bfe.n.shifen.com,32,0.06%,32,0,100.00%
ins-mfa9hirw.ias.tencent-cloud.net,31,0.05%,31,0,100.00%
hotfix.lenovo.com.cn,31,0.05%,31,0,100.00%
googleads.g.doubleclick.net,31,0.05%,32,1,96.88%
ts1.qq.com,31,0.05%,31,0,100.00%
v2.get.sogou.com,31,0.05%,31,0,100.00%
client.dropbox.com,31,0.05%,62,31,50.00%
api.snapcraft.io,30,0.05%,30,0,100.00%
dsp.lenovo.com.cn,30,0.05%,30,0,100.00%
v1.go2yd.com,30,0.05%,30,0,100.00%
mtalk.google.com,30,0.05%,131,101,22.90%
download.windowsupdate.com.a.bdydns.com,30,0.05%,30,0,100.00%
1.courier-push-apple.com.akadns.net,30,0.05%,30,0,100.00%
shortconn.im.qcloud.com,30,0.05%,30,0,100.00%
passport.m3guo.com,30,0.05%,30,0,100.00%
uz95.v.trpcdn.net,29,0.05%,29,0,100.00%
puv.tt.browser.360.cn,29,0.05%,29,0,100.00%
gateway.fe.apple-dns.net,29,0.05%,58,29,50.00%
ping.avast.com,29,0.05%,60,31,48.33%
mail.google.com,29,0.05%,66,37,43.94%
firefox.settings.services.mozilla.com,29,0.05%,29,0,100.00%
mubu.com,29,0.05%,29,0,100.00%
inews.gtimg.com,28,0.05%,28,0,100.00%
router15.teamviewer.com,28,0.05%,28,0,100.00%
zlxx.v.lxcvc.com,28,0.05%,55,27,50.91%
router1.teamviewer.com,28,0.05%,32,4,87.50%
api2.firefoxchina.cn,28,0.05%,28,0,100.00%
update1.sangfor.net.cdn20.com,28,0.05%,28,0,100.00%
jtypkz2w.sched.d2.tdnsdp1.cn,28,0.05%,28,0,100.00%
shdf01-iopq.cgroads.com,28,0.05%,28,0,100.00%
treatment.grammarly.com,28,0.05%,28,0,100.00%
dc.services.visualstudio.com,28,0.05%,28,0,100.00%
rq.wh.cmcm.com,27,0.05%,27,0,100.00%
api.msn.com,27,0.05%,43,16,62.79%
dyn.wps.cn,27,0.05%,27,0,100.00%
api.mathpix.com,27,0.05%,27,0,100.00%
ue.lenovomm.cn,27,0.05%,27,0,100.00%
ocsp2-lb.apple.com.akadns.net,27,0.05%,28,1,96.43%
x1.c.lencr.org,27,0.05%,68,41,39.71%
interface.music.163.com,27,0.05%,27,0,100.00%
res.wx.qq.com,27,0.05%,28,1,96.43%
loki.ams.eulix.xyz,27,0.05%,27,0,100.00%
ns-eh2-prod-dm2-511.cloudapp.net,27,0.05%,27,0,100.00%
assets.msn.com,27,0.05%,27,0,100.00%
lz4hlmtcf5.feishu.cn,27,0.05%,27,0,100.00%
btrace.qq.com,26,0.05%,47,21,55.32%
ww62.uatracker.net,26,0.05%,26,0,100.00%
rs2.qq.com,26,0.05%,26,0,100.00%
ts2.qq.com,26,0.05%,26,0,100.00%
ic.wps.cn,26,0.05%,26,0,100.00%
zephir.monocul.us,26,0.05%,26,0,100.00%
init.push-apple.com.akadns.net,26,0.05%,52,26,50.00%
mumu.nie.netease.com,26,0.05%,51,25,50.98%
tsfe.trafficshaping.dsp.mp.microsoft.com,26,0.05%,26,0,100.00%
rm-2zelg248g7y2034w7do.mysql.rds.aliyuncs.com,26,0.05%,26,0,100.00%
wss.rest.gti.mcafee.com,26,0.05%,26,0,100.00%
ioshost.qtlcdn.com,25,0.04%,48,23,52.08%
e11290.dspg.akamaiedge.net,25,0.04%,51,26,49.02%
filetracker.xyz,25,0.04%,51,26,49.02%
update100.sangfor.com.cn,25,0.04%,44,19,56.82%
tracker.hama3.net,25,0.04%,47,22,53.19%
router2.teamviewer.com,25,0.04%,25,0,100.00%
router8.teamviewer.com,25,0.04%,27,2,92.59%
code.osssc.ac.cn,25,0.04%,25,0,100.00%
array808.prod.do.dsp.mp.microsoft.com,24,0.04%,24,0,100.00%
tr.cili001.com,24,0.04%,24,0,100.00%
tracker.files.fm,24,0.04%,24,0,100.00%
tracker.nitrix.me,24,0.04%,48,24,50.00%
tracker.uw0.xyz,24,0.04%,24,0,100.00%
router16.teamviewer.com,24,0.04%,24,0,100.00%
developer.unity.cn,24,0.04%,24,0,100.00%
ts.eset.com,24,0.04%,24,0,100.00%
clients4.google.com,24,0.04%,29,5,82.76%
usercount.dockernb.com,24,0.04%,24,0,100.00%
comet.jianguoyun.com,24,0.04%,24,0,100.00%
download.visualstudio.microsoft.com,24,0.04%,24,0,100.00%
tracker.fixr.pro,24,0.04%,24,0,100.00%
router9.teamviewer.com,24,0.04%,24,0,100.00%
www.tg5tj2cu.com,24,0.04%,24,0,100.00%
outlook.ha.office365.com,23,0.04%,46,23,50.00%
mathpix.com,23,0.04%,44,21,52.27%
deault-exp-tas-com.e-0014.e-msedge.net,23,0.04%,42,19,54.76%
router5.teamviewer.com,23,0.04%,26,3,88.46%
sg02.ipv2.xyz,23,0.04%,23,0,100.00%
outlook.office365.com,22,0.04%,45,23,48.89%
tracker.bt4g.com,22,0.04%,44,22,50.00%
9.rarbg.me,22,0.04%,22,0,100.00%
thetracker.org,22,0.04%,22,0,100.00%
udp-tracker.shittyurl.org,22,0.04%,22,0,100.00%
arc.trafficmanager.net,22,0.04%,22,0,100.00%
cloud.dell.com,22,0.04%,22,0,100.00%
www.googleapis.com,21,0.04%,24,3,87.50%
t2.pow7.com,21,0.04%,42,21,50.00%
msgsrv01.oray.net,21,0.04%,21,0,100.00%
poll.exmail.qq.com,21,0.04%,21,0,100.00%
9.rarbg.to,21,0.04%,21,0,100.00%
edu.uifr.ru,21,0.04%,21,0,100.00%
engplus.ru,21,0.04%,21,0,100.00%
opentor.org,21,0.04%,41,20,51.22%
tracker0.ufibox.com,21,0.04%,21,0,100.00%
torrentclub.online,21,0.04%,21,0,100.00%
tracker.shkinev.me,21,0.04%,21,0,100.00%
tracker.zerobytes.xyz,21,0.04%,21,0,100.00%
tracker.v6speed.org,21,0.04%,21,0,100.00%
dev.ditu.live.com,21,0.04%,21,0,100.00%
nexus.officeapps.live.com,21,0.04%,21,0,100.00%
ocsp2-cn-lb.apple.com.akadns.net,21,0.04%,22,1,95.45%
bt.okmp3.ru,20,0.04%,20,0,100.00%
stream.zotero.org,20,0.04%,38,18,52.63%
www.wshifen.com,20,0.04%,20,0,100.00%
cdn-file.ludashi.com,20,0.04%,20,0,100.00%
accounts.google.com,20,0.04%,27,7,74.07%
free.publictracker.xyz,20,0.04%,20,0,100.00%
mail.realliferpg.de,20,0.04%,20,0,100.00%
newtoncity.org,20,0.04%,20,0,100.00%
honeycomb.wpscdn.cn,20,0.04%,38,18,52.63%
valakas.rollo.dnsabr.com,20,0.04%,20,0,100.00%
vibe.community,20,0.04%,20,0,100.00%
account.jetbrains.com,20,0.04%,20,0,100.00%
push.services.mozilla.com,20,0.04%,20,0,100.00%
ocsp.digicert.com,20,0.04%,33,13,60.61%
k256.gslb.ksyuncdn.com,20,0.04%,20,0,100.00%
ins-qw3q8ofk.ias.tencent-cloud.net,20,0.04%,20,0,100.00%
dcldshlupt.alicdn.com,20,0.04%,20,0,100.00%
c9b086079795c442.jijifun.com,20,0.04%,20,0,100.00%
shavar.services.mozilla.com,20,0.04%,20,0,100.00%
router7.teamviewer.com,20,0.04%,20,0,100.00%
android.l.google.com,19,0.03%,19,0,100.00%
bsg.w.bilicdn1.com,19,0.03%,19,0,100.00%
mcs-bd.feishu.cn,19,0.03%,19,0,100.00%
pub.idqqimg.com,19,0.03%,42,23,45.24%
app.huabao.360.cn,19,0.03%,32,13,59.38%
pico.eset.com,19,0.03%,19,0,100.00%
caldav.163.com,19,0.03%,19,0,100.00%
mail.163.com,19,0.03%,19,0,100.00%
go.microsoft.com,19,0.03%,48,29,39.58%
router12.teamviewer.com,19,0.03%,24,5,79.17%
officeclient.microsoft.com,19,0.03%,19,0,100.00%
q.cnblogs.com,19,0.03%,19,0,100.00%
www.microvirt.com,19,0.03%,19,0,100.00%
china.bing123.com,18,0.03%,18,0,100.00%
broadcast.chat.bilibili.com,18,0.03%,18,0,100.00%
tracker.1337x.org,18,0.03%,295,277,6.10%
licensing.mp.microsoft.com,18,0.03%,18,0,100.00%
tracker.coalition.space,18,0.03%,34,16,52.94%
ts2.cn.mm.bing.net,18,0.03%,18,0,100.00%
torrentsmd.com,18,0.03%,18,0,100.00%
tracker.trackerfix.com,18,0.03%,18,0,100.00%
plussvr.wps.cn,18,0.03%,18,0,100.00%
mobile.pipe.aria.microsoft.com,18,0.03%,20,2,90.00%
todolist.redirect.xzdesktop.cqttech.com,18,0.03%,18,0,100.00%
ntp4.aliyun.com,18,0.03%,18,0,100.00%
vscode-sync-ase-01.azurewebsites.net,18,0.03%,18,0,100.00%
waws-prod-sg1-051.sip.azurewebsites.windows.net,18,0.03%,18,0,100.00%
6fe97759aa27a0c9.jijifun.com,18,0.03%,18,0,100.00%
prom-monitorproxy1.fastsdwan.com,18,0.03%,18,0,100.00%
t1.pow7.com,18,0.03%,31,13,58.06%
api.ultimaker.com,18,0.03%,18,0,100.00%
router3.teamviewer.com,18,0.03%,20,2,90.00%
self-events-data.trafficmanager.net,18,0.03%,18,0,100.00%
helpdubaclient.ksmobile.com,18,0.03%,18,0,100.00%
advanced-cm-1.nodesub.com,18,0.03%,18,0,100.00%
outlook.ms-acdc.office.com,17,0.03%,34,17,50.00%
mainnet.infura.io,17,0.03%,34,17,50.00%
aapl-maps.qtlcdn.com,17,0.03%,32,15,53.12%
nleditor.osi.office.net,17,0.03%,17,0,100.00%
download.windowsupdate.com,17,0.03%,20,3,85.00%
crl4.digicert.com,17,0.03%,29,12,58.62%
onetag-sys.com,17,0.03%,17,0,100.00%
www.google.com,17,0.03%,146,129,11.64%
ts1.cn.mm.bing.net,17,0.03%,17,0,100.00%
bt.nfshost.com,17,0.03%,17,0,100.00%
crl.verisign.com,17,0.03%,27,10,62.96%
5kong4.com,17,0.03%,17,0,100.00%
fs.microsoft.com,17,0.03%,17,0,100.00%
lax.link.ac.cn,17,0.03%,17,0,100.00%
miserupdate.aliyun.com,17,0.03%,17,0,100.00%
a.w.bilicdn1.com,17,0.03%,18,1,94.44%
router14.teamviewer.com,17,0.03%,17,0,100.00%
prebid-us.creativecdn.com,16,0.03%,16,0,100.00%
hw-web-player-tracker.biliapi.net,16,0.03%,16,0,100.00%
t.acg.rip,16,0.03%,16,0,100.00%
catalog.gamepass.com,16,0.03%,37,21,43.24%
tt.browser.360.cn,16,0.03%,16,0,100.00%
ksopush.kdocs.cn,16,0.03%,16,0,100.00%
clientnotification-userprodscus1-0.servicebus.windows.net,16,0.03%,16,0,100.00%
msedge.api.cdp.microsoft.com,16,0.03%,21,5,76.19%
wdl1.file.cache.docer.com,16,0.03%,23,7,69.57%
hm.baidu.com,16,0.03%,34,18,47.06%
download.pinyin.sogou.com,16,0.03%,16,0,100.00%
video-hw-drcn.dbankcdn.cn,16,0.03%,36,20,44.44%
dss0.bdstatic.com,16,0.03%,16,0,100.00%
www.gsd92gov.com,16,0.03%,16,0,100.00%
router10.teamviewer.com,16,0.03%,20,4,80.00%
pss.bdstatic.com,16,0.03%,18,2,88.89%
vpn.oceanum.cn,16,0.03%,16,0,100.00%
erickson514-my.sharepoint.com,16,0.03%,16,0,100.00%
upos-sz-mirrorali.bilivideo.com,16,0.03%,16,0,100.00%
targetednotifications-tm.trafficmanager.net,16,0.03%,16,0,100.00%
honeycomb.wps.cn,16,0.03%,16,0,100.00%
gspe35-ssl.ls-apple.com.akadns.net,16,0.03%,16,0,100.00%
gspe35-cn-ssl.ls-apple.com.akadns.net,16,0.03%,16,0,100.00%
isrc.iscas.ac.cn,16,0.03%,16,0,100.00%
substrate.office.com,15,0.03%,35,20,42.86%
rinkeby.infura.io,15,0.03%,15,0,100.00%
st.pinyin.sogou.com,15,0.03%,15,0,100.00%
pss.alicdn.com,15,0.03%,15,0,100.00%
p0.qhimg.com,15,0.03%,19,4,78.95%
s.f.360.cn,15,0.03%,21,6,71.43%
task.browser.360.cn,15,0.03%,15,0,100.00%
123.sogou.com,15,0.03%,15,0,100.00%
cs22.wpc.v0cdn.net,15,0.03%,15,0,100.00%
datarouter.ol.epicgames.com,15,0.03%,15,0,100.00%
device.sangfor.com.cn,15,0.03%,15,0,100.00%
atrack.pow7.com,15,0.03%,30,15,50.00%
tracker.pow7.com,15,0.03%,30,15,50.00%
h4.trakx.nibba.trade,15,0.03%,15,0,100.00%
e6913.dscx.akamaiedge.net,15,0.03%,30,15,50.00%
pr.x.hub.sandai.net,15,0.03%,15,0,100.00%
e8652.dscx.akamaiedge.net,15,0.03%,30,15,50.00%
down.anticheatexpert.com,15,0.03%,15,0,100.00%
cn-bing-com.cn.a-0001.a-msedge.net,14,0.02%,14,0,100.00%
umwatson.events.data.microsoft.com,14,0.02%,14,0,100.00%
HND-efz.ms-acdc.office.com,14,0.02%,28,14,50.00%
normandy.cdn.mozilla.net,14,0.02%,14,0,100.00%
wdl1.cache.wps.cn,14,0.02%,25,11,56.00%
e-0009.e-msedge.net,14,0.02%,14,0,100.00%
mini.360.cn,14,0.02%,16,2,87.50%
c.go-mpulse.net,14,0.02%,32,18,43.75%
cloud-rest.lenovomm.com,14,0.02%,14,0,100.00%
df.cache.wpscdn.cn,14,0.02%,20,6,70.00%
www.jetbrains.com,14,0.02%,36,22,38.89%
edge.ivideo.sina.com.cn,14,0.02%,29,15,48.28%
hectorstatic.baidu.com,14,0.02%,16,2,87.50%
weather-data.apple.com,14,0.02%,27,13,51.85%
d2nxq2uap88usk.cloudfront.net,14,0.02%,28,14,50.00%
fsrcn.lenovomm.com,14,0.02%,14,0,100.00%
www.tm.a.prd.aadg.trafficmanager.net,14,0.02%,14,0,100.00%
functional.events.data.microsoft.com,14,0.02%,14,0,100.00%
reswx.tc.qq.com,14,0.02%,14,0,100.00%
res.wx.qq.com.sched.legopic1.tdnsv6.com,14,0.02%,14,0,100.00%
a1961.g2.akamai.net,14,0.02%,14,0,100.00%
e10499.dsce9.akamaiedge.net,14,0.02%,28,14,50.00%
gecko-bd.feishu.cn.w.cdngslb.com,14,0.02%,14,0,100.00%
outlook.gogo66.cloud,14,0.02%,24,10,58.33%
clients.l.google.com,14,0.02%,26,12,53.85%
newtab.firefoxchina.cn,14,0.02%,27,13,51.85%
g.live.com,14,0.02%,19,5,73.68%
post.ksosoft.com,14,0.02%,14,0,100.00%
f062936a96d3c8bd.jijifun.com,14,0.02%,14,0,100.00%
ocsp.entrust.net.edgekey.net,14,0.02%,28,14,50.00%
client.teamviewer.com,14,0.02%,14,0,100.00%
adservice.google.com,14,0.02%,15,1,93.33%
api.bilibili.com,14,0.02%,17,3,82.35%
cn2888.v2free.xyz,14,0.02%,14,0,100.00%
security.bilibili.com,14,0.02%,14,0,100.00%
s1.biz.xunlei.com,14,0.02%,14,0,100.00%
www-www.bing.com.trafficmanager.net,13,0.02%,14,1,92.86%
pico.gtm.eset.com,13,0.02%,13,0,100.00%
visualstudio-devdiv-c2s-msedge-net.e-0009.e-msedge.net,13,0.02%,13,0,100.00%
as-tlx.3lift.com,13,0.02%,13,0,100.00%
ime.sogou.com,13,0.02%,13,0,100.00%
tconf.b.qianxin.com,13,0.02%,13,0,100.00%
c.tmyzer.com,13,0.02%,13,0,100.00%
adashx.ut.dingtalk.com,13,0.02%,13,0,100.00%
gimg3.baidu.com,13,0.02%,14,1,92.86%
hpd.baidu.com,13,0.02%,13,0,100.00%
connect.unity.cn,13,0.02%,13,0,100.00%
bluedot.is.autonavi.com.gds.alibabadns.com,13,0.02%,13,0,100.00%
prod.nexusrules.live.com.akadns.net,13,0.02%,26,13,50.00%
blades.aliyun.com,13,0.02%,13,0,100.00%
array511.prod.do.dsp.mp.microsoft.com,13,0.02%,13,0,100.00%
settings-prod-uks-2.uksouth.cloudapp.azure.com,13,0.02%,13,0,100.00%
14.tlu.dl.delivery.mp.microsoft.com,13,0.02%,13,0,100.00%
jp9.boom.skin,13,0.02%,13,0,100.00%
jp10.boom.skin,13,0.02%,13,0,100.00%
wd-prod-ss.trafficmanager.net,12,0.02%,12,0,100.00%
al04.bb.wdpdk.link,12,0.02%,12,0,100.00%
1595096.sched.d0-dk.tdnsdp1.cn,12,0.02%,25,13,48.00%
clients6.google.com,12,0.02%,15,3,80.00%
infoc2.duba.net,12,0.02%,12,0,100.00%
pis-pcdn.youku.com,12,0.02%,12,0,100.00%
d.skconf.f.360.cn,12,0.02%,12,0,100.00%
max-l.mediav.com,12,0.02%,12,0,100.00%
api.atlassian.com,12,0.02%,12,0,100.00%
ss1.baidu.com,12,0.02%,18,6,66.67%
plus.wps.cn,12,0.02%,12,0,100.00%
dss1.bdstatic.com,12,0.02%,12,0,100.00%
mail.126.com,12,0.02%,12,0,100.00%
prod.ingestion-edge.prod.dataops.mozgcp.net,12,0.02%,12,0,100.00%
afdo-tas-offload.trafficmanager.net,12,0.02%,12,0,100.00%
datarouter-weighted.ol.epicgames.com,12,0.02%,12,0,100.00%
browser.360.cn.ucloud.com.cn,12,0.02%,12,0,100.00%
browser.360.cn.ucloudnaming.cn,12,0.02%,12,0,100.00%
4005f8da13f42943.jijifun.com,12,0.02%,12,0,100.00%
ds.kaspersky.com,12,0.02%,12,0,100.00%
translate.googleapis.com,12,0.02%,16,4,75.00%
mbd.n.shifen.com,12,0.02%,12,0,100.00%
papi.funshion.com,12,0.02%,12,0,100.00%
sadownload.mcafee.com,12,0.02%,12,0,100.00%
hashcloud.cz,12,0.02%,12,0,100.00%
goldengate.grammarly.com,12,0.02%,12,0,100.00%
update.todesk.com,12,0.02%,12,0,100.00%
safebrowsing.urlsec.qq.com,12,0.02%,12,0,100.00%
cv.duba.net,12,0.02%,12,0,100.00%
omg.wtftrackr.pw,12,0.02%,24,12,50.00%
ntemp18.boom.skin,12,0.02%,12,0,100.00%
googlehosted.l.googleusercontent.com,11,0.02%,21,10,52.38%
eas.outlook.com,11,0.02%,16,5,68.75%
weather-data.apple.com.akadns.net,11,0.02%,23,12,47.83%
qurl.f.360.cn,11,0.02%,11,0,100.00%
uapi.mp.360.cn,11,0.02%,11,0,100.00%
opentracker.xyz,11,0.02%,648,637,1.70%
classify-client.services.mozilla.com,11,0.02%,11,0,100.00%
onedscolprdwus02.westus.cloudapp.azure.com,11,0.02%,11,0,100.00%
dl.vas.wpscdn.cn,11,0.02%,24,13,45.83%
dashenga.com,11,0.02%,11,0,100.00%
pos.baidu.com,11,0.02%,11,0,100.00%
passport.escience.cn,11,0.02%,11,0,100.00%
k128-mzstatic.gslb.ksyuncdn.com,11,0.02%,11,0,100.00%
ssp.ads.betweendigital.com,11,0.02%,11,0,100.00%
200-service-tang-1544055741.us-east-1.elb.amazonaws.com,11,0.02%,11,0,100.00%
pubsub02.oray.net,11,0.02%,11,0,100.00%
ss0.baidu.com,11,0.02%,20,9,55.00%
contentsec.ac.cn,11,0.02%,11,0,100.00%
sentry.eulix.xyz,11,0.02%,11,0,100.00%
imap.163.com,11,0.02%,11,0,100.00%
signaler-pa.clients6.google.com,11,0.02%,22,11,50.00%
push.hicloud.com,11,0.02%,11,0,100.00%
secure.pow7.com,11,0.02%,22,11,50.00%
imap.cstnet.cn,11,0.02%,11,0,100.00%
client-api.oray.com,11,0.02%,11,0,100.00%
dotbeats.douyucdn.cn,11,0.02%,11,0,100.00%
ocsp.entrust.net,11,0.02%,25,14,44.00%
update.eset.com,11,0.02%,11,0,100.00%
l-rcd.iqiyi.com,11,0.02%,16,5,68.75%
download.docker.com,11,0.02%,13,2,84.62%
hk1-4.nigirocloud.com,11,0.02%,11,0,100.00%
ntp.aliyun.com,11,0.02%,11,0,100.00%
aka.ms,11,0.02%,11,0,100.00%
2.cn.pool.ntp.org,11,0.02%,11,0,100.00%
cc-api-data.adobe.io,11,0.02%,11,0,100.00%
api.dropbox.com,11,0.02%,22,11,50.00%
bvc.bilivideo.com,11,0.02%,12,1,91.67%
downloads.yoctoproject.org,11,0.02%,11,0,100.00%
jp14.boom.skin,11,0.02%,11,0,100.00%
opt18.boom.skin,11,0.02%,11,0,100.00%
opt17.boom.skin,11,0.02%,11,0,100.00%
nke.boom.skin,11,0.02%,11,0,100.00%
jp8.boom.skin,11,0.02%,11,0,100.00%
opt19.boom.skin,11,0.02%,11,0,100.00%
www.nowcoder.com,11,0.02%,11,0,100.00%
gspe1-ssl.ls.apple.com,10,0.02%,10,0,100.00%
ncc.avast.com,10,0.02%,20,10,50.00%
normandy-cdn.services.mozilla.com,10,0.02%,10,0,100.00%
prod-classifyclient.normandy.prod.cloudops.mozgcp.net,10,0.02%,10,0,100.00%
dig.feishu.cn,10,0.02%,10,0,100.00%
www.bilibili.com,10,0.02%,10,0,100.00%
adashx.m.taobao.com,10,0.02%,10,0,100.00%
cn-hangzhou.axt.aliyun.com,10,0.02%,10,0,100.00%
gateway.icloud.com,10,0.02%,15,5,66.67%
login.microsoftonline.com,10,0.02%,10,0,100.00%
ocsp2.apple.com,10,0.02%,12,2,83.33%
prebid.smilewanted.com,10,0.02%,10,0,100.00%
activity.windows.com,10,0.02%,10,0,100.00%
eqx.smartadserver.com,10,0.02%,19,9,52.63%
sl-log.oray.net,10,0.02%,10,0,100.00%
emoji.qpic.cn,10,0.02%,11,1,90.91%
softbus-device.wps.cn,10,0.02%,10,0,100.00%
up.ijinshan.com,10,0.02%,10,0,100.00%
mmbiz.qlogo.cn,10,0.02%,10,0,100.00%
tracker.tfile.co,10,0.02%,10,0,100.00%
video-tx-drcn.dbankcdn.cn,10,0.02%,22,12,45.45%
t8.baidu.com,10,0.02%,12,2,83.33%
cs.dds.microsoft.com,10,0.02%,10,0,100.00%
vtnt.cnode.xyz,10,0.02%,10,0,100.00%
www.microsoft.com-c-3.edgekey.net,10,0.02%,10,0,100.00%
ris-prod.trafficmanager.net,10,0.02%,10,0,100.00%
46.courier-push-apple.com.akadns.net,10,0.02%,10,0,100.00%
ts.gtm.eset.com,10,0.02%,10,0,100.00%
play.google.com,10,0.02%,20,10,50.00%
dldir1.legao.sched.dcloudstc.com,10,0.02%,10,0,100.00%
iris-de-prod-azsc-eas-b.eastasia.cloudapp.azure.com,10,0.02%,10,0,100.00%
client-office365-tas.msedge.net,10,0.02%,10,0,100.00%
wns.notify.trafficmanager.net,10,0.02%,20,10,50.00%
na61-na62.wagbridge.alibaba.alibaba.com.gds.alibabadns.com,10,0.02%,10,0,100.00%
browser.360.cn.qh-cdn.com,10,0.02%,10,0,100.00%
wildcard.weather.microsoft.com.edgekey.net,10,0.02%,10,0,100.00%
e15275.g.akamaiedge.net,10,0.02%,10,0,100.00%
softcenter-all.os.nfschina.com,10,0.02%,10,0,100.00%
ios.ac.cn,10,0.02%,10,0,100.00%
ztxdjj-my.sharepoint.com,10,0.02%,10,0,100.00%
www.msftconnecttest.com,10,0.02%,11,1,90.91%
pic3.zhimg.com,10,0.02%,10,0,100.00%
cmonitor.iqiyi.com,10,0.02%,17,7,58.82%
dlied6.qq.com,10,0.02%,10,0,100.00%
oth.eve.mdt.qq.com,10,0.02%,10,0,100.00%
api.tabnine.com,10,0.02%,10,0,100.00%
tm-sdk.platinumai.net,10,0.02%,10,0,100.00%
onedscolprdwus14.westus.cloudapp.azure.com,10,0.02%,10,0,100.00%
feilian-staging.bytedance.com,10,0.02%,10,0,100.00%
ocsp.apple.com.download.ks-cdn.com,10,0.02%,10,0,100.00%
array601.prod.do.dsp.mp.microsoft.com,10,0.02%,10,0,100.00%
info.wps.cn,10,0.02%,10,0,100.00%
lls-douyin.cloudrtc.myhuaweicloud.com,10,0.02%,10,0,100.00%
pull-lls-l26.douyincdn.com.c.cdnhwc3.com,10,0.02%,10,0,100.00%
webrtc.liveplay.myqcloud.com,10,0.02%,10,0,100.00%
pull-fcdn-douyin-base3.s.bytefcdn.com,10,0.02%,10,0,100.00%
k1.gslb.ksyuncdn.com,10,0.02%,19,9,52.63%
2.debian.pool.ntp.org,10,0.02%,22,12,45.45%
uqhdkynyqiccr0ff-gzo0ffeun6pvl9od-gebf7khwpyapzzta.prprmoe.xyz,10,0.02%,10,0,100.00%
ksn-file-geo.kaspersky-labs.com,10,0.02%,10,0,100.00%
batch-rgeo.is.autonavi.com,10,0.02%,10,0,100.00%
internal-api-lark-api.feishu.cn,10,0.02%,10,0,100.00%
clientnotification-userprodscus1-7.servicebus.windows.net,10,0.02%,10,0,100.00%
api.live.bilibili.com,10,0.02%,13,3,76.92%
n119.boom.skin,10,0.02%,10,0,100.00%
s100.boom.skin,10,0.02%,10,0,100.00%
n23.boom.skin,10,0.02%,10,0,100.00%
n04.boom.skin,10,0.02%,10,0,100.00%
n28.boom.skin,10,0.02%,10,0,100.00%
n54.boom.skin,10,0.02%,10,0,100.00%
ntemp16.boom.skin,10,0.02%,10,0,100.00%
ntemp17.boom.skin,10,0.02%,10,0,100.00%
ntemp20.boom.skin,10,0.02%,10,0,100.00%
jp18.boom.skin,10,0.02%,10,0,100.00%
nj2.boom.skin,10,0.02%,10,0,100.00%
repo.openeuler.org,10,0.02%,10,0,100.00%
hdweb.mail.split.netease.com,9,0.02%,9,0,100.00%
prod-w.nexus.live.com.akadns.net,9,0.02%,9,0,100.00%
mcs-bd.feishu.cn.w.cdngslb.com,9,0.02%,9,0,100.00%
gateway.bitrenren.com,9,0.02%,16,7,56.25%
www.taobao.com,9,0.02%,18,9,50.00%
mbsug.ssl.so.com,9,0.02%,9,0,100.00%
t.undefined-site.top,9,0.02%,9,0,100.00%
ssl.gstatic.com,9,0.02%,33,24,27.27%
shuc-other.ksord.com,9,0.02%,9,0,100.00%
cn-beijing.axt.aliyun.com,9,0.02%,9,0,100.00%
cn-hongkong.axt.aliyun.com,9,0.02%,9,0,100.00%
5.rlb.router.teamviewer.cn,9,0.02%,9,0,100.00%
shb.richaudience.com,9,0.02%,9,0,100.00%
prebid.a-mo.net,9,0.02%,9,0,100.00%
apa.vap.lijit.com,9,0.02%,9,0,100.00%
input.shouji.sogou.com,9,0.02%,9,0,100.00%
ssxd.mediav.com,9,0.02%,9,0,100.00%
c2shb.ssp.yahoo.com,9,0.02%,9,0,100.00%
ss3.baidu.com,9,0.02%,17,8,52.94%
ug.baidu.com,9,0.02%,16,7,56.25%
pcfg.wps.cn,9,0.02%,9,0,100.00%
sp1.baidu.com,9,0.02%,16,7,56.25%
hovv.yilanvaas.com,9,0.02%,19,10,47.37%
s.bbm0v.cn,9,0.02%,9,0,100.00%
app.jianguoyun.com,9,0.02%,9,0,100.00%
os1-3.nigirocloud.com,9,0.02%,9,0,100.00%
waws-prod-sg1-051.cloudapp.net,9,0.02%,9,0,100.00%
ins-59d1h3tv.ias.tencent-cloud.net,9,0.02%,18,9,50.00%
jp04.v2netapp.com,9,0.02%,9,0,100.00%
na61-na62.wagbridge.alibaba.alibaba.com,9,0.02%,18,9,50.00%
docs.google.com,9,0.02%,18,9,50.00%
bugreport.huorong.cn,9,0.02%,28,19,32.14%
cipv6gn.v.trpcdn.net,9,0.02%,18,9,50.00%
translate.google.cn,9,0.02%,17,8,52.94%
cip.cc,9,0.02%,9,0,100.00%
gateway.icloud.com.cn,9,0.02%,9,0,100.00%
gateway.fe.apple-dns.cn,9,0.02%,9,0,100.00%
searchrecommend.kugou.com,9,0.02%,9,0,100.00%
api1.origin.com,9,0.02%,9,0,100.00%
boss.hdslb.com,9,0.02%,11,2,81.82%
www.m9ynqi6d.com,9,0.02%,9,0,100.00%
fsrhk.lenovomm.com,9,0.02%,9,0,100.00%
settings-prod-cin-2.centralindia.cloudapp.azure.com,9,0.02%,9,0,100.00%
update.gtm.eset.com,9,0.02%,9,0,100.00%
dataflow.biliapi.com.dy.galileo.jcloud-cdn.com,9,0.02%,9,0,100.00%
diskapi.n.shifen.com,9,0.02%,17,8,52.94%
16.tlu.dl.delivery.mp.microsoft.com,9,0.02%,9,0,100.00%
blog.csdn.net,9,0.02%,9,0,100.00%
v6-default.365yg.com,9,0.02%,9,0,100.00%
o.andfx.cn,9,0.02%,9,0,100.00%
cm.bilibili.com,9,0.02%,9,0,100.00%
nk6.boom.skin,9,0.02%,9,0,100.00%
n21.boom.skin,9,0.02%,9,0,100.00%
n24.boom.skin,9,0.02%,9,0,100.00%
nkb.boom.skin,9,0.02%,9,0,100.00%
jp13.boom.skin,9,0.02%,9,0,100.00%
nm7.boom.skin,9,0.02%,9,0,100.00%
opt22.boom.skin,9,0.02%,9,0,100.00%
nn2.boom.skin,9,0.02%,9,0,100.00%
nn3.boom.skin,9,0.02%,9,0,100.00%
nn4.boom.skin,9,0.02%,9,0,100.00%
nn5.boom.skin,9,0.02%,9,0,100.00%
nn6.boom.skin,9,0.02%,9,0,100.00%
nn1.boom.skin,9,0.02%,9,0,100.00%
jp2.boom.skin,9,0.02%,9,0,100.00%
jp3.boom.skin,9,0.02%,9,0,100.00%
jp5.boom.skin,9,0.02%,9,0,100.00%
nn7.boom.skin,9,0.02%,9,0,100.00%
jp1.boom.skin,9,0.02%,9,0,100.00%
nn12.boom.skin,9,0.02%,9,0,100.00%
jp4.boom.skin,9,0.02%,9,0,100.00%
nn14.boom.skin,9,0.02%,9,0,100.00%
nn13.boom.skin,9,0.02%,9,0,100.00%
nn8.boom.skin,9,0.02%,9,0,100.00%
opt14.boom.skin,9,0.02%,9,0,100.00%
nn9.boom.skin,9,0.02%,9,0,100.00%
opt23.boom.skin,9,0.02%,9,0,100.00%
opt24.boom.skin,9,0.02%,9,0,100.00%
opt25.boom.skin,9,0.02%,9,0,100.00%
opt26.boom.skin,9,0.02%,9,0,100.00%
opt7.boom.skin,9,0.02%,9,0,100.00%
opt8.boom.skin,9,0.02%,9,0,100.00%
nna.boom.skin,9,0.02%,9,0,100.00%
opt9.boom.skin,9,0.02%,9,0,100.00%
opt15.boom.skin,9,0.02%,9,0,100.00%
nn11.boom.skin,9,0.02%,9,0,100.00%
opt6.boom.skin,9,0.02%,9,0,100.00%
opt21.boom.skin,9,0.02%,9,0,100.00%
opt10.boom.skin,9,0.02%,9,0,100.00%
opt13.boom.skin,9,0.02%,9,0,100.00%
opt11.boom.skin,9,0.02%,9,0,100.00%
opt12.boom.skin,9,0.02%,9,0,100.00%
opt5.boom.skin,9,0.02%,9,0,100.00%
opt1.boom.skin,9,0.02%,9,0,100.00%
opt2.boom.skin,9,0.02%,9,0,100.00%
opt20.boom.skin,9,0.02%,9,0,100.00%
opt3.boom.skin,9,0.02%,9,0,100.00%
n32.boom.skin,9,0.02%,9,0,100.00%
opt4.boom.skin,9,0.02%,9,0,100.00%
ntemp15.boom.skin,9,0.02%,9,0,100.00%
ntemp10.boom.skin,9,0.02%,9,0,100.00%
n43.boom.skin,9,0.02%,9,0,100.00%
ntemp19.boom.skin,9,0.02%,9,0,100.00%
n62.boom.skin,9,0.02%,9,0,100.00%
n06.boom.skin,9,0.02%,9,0,100.00%
ntemp02.boom.skin,9,0.02%,9,0,100.00%
ntemp04.boom.skin,9,0.02%,9,0,100.00%
ntemp06.boom.skin,9,0.02%,9,0,100.00%
n57.boom.skin,9,0.02%,9,0,100.00%
ntemp07.boom.skin,9,0.02%,9,0,100.00%
ntemp03.boom.skin,9,0.02%,9,0,100.00%
ntemp05.boom.skin,9,0.02%,9,0,100.00%
jp15.boom.skin,9,0.02%,9,0,100.00%
nm8.boom.skin,9,0.02%,9,0,100.00%
nm9.boom.skin,9,0.02%,9,0,100.00%
nmb.boom.skin,9,0.02%,9,0,100.00%
nma.boom.skin,9,0.02%,9,0,100.00%
nmc.boom.skin,9,0.02%,9,0,100.00%
nmd.boom.skin,9,0.02%,9,0,100.00%
n111.boom.skin,9,0.02%,9,0,100.00%
n115.boom.skin,9,0.02%,9,0,100.00%
n93.boom.skin,9,0.02%,9,0,100.00%
s01.boom.skin,9,0.02%,9,0,100.00%
n117.boom.skin,9,0.02%,9,0,100.00%
jp6.boom.skin,9,0.02%,9,0,100.00%
n30.boom.skin,9,0.02%,9,0,100.00%
opt16.boom.skin,9,0.02%,9,0,100.00%
jp7.boom.skin,9,0.02%,9,0,100.00%
jp16.boom.skin,9,0.02%,9,0,100.00%
jp17.boom.skin,9,0.02%,9,0,100.00%
jp19.boom.skin,9,0.02%,9,0,100.00%
jp20.boom.skin,9,0.02%,9,0,100.00%
nl9.boom.skin,9,0.02%,9,0,100.00%
nkc.boom.skin,9,0.02%,9,0,100.00%
nkd.boom.skin,9,0.02%,9,0,100.00%
nl1.boom.skin,9,0.02%,9,0,100.00%
nl2.boom.skin,9,0.02%,9,0,100.00%
nl3.boom.skin,9,0.02%,9,0,100.00%
nl4.boom.skin,9,0.02%,9,0,100.00%
nl6.boom.skin,9,0.02%,9,0,100.00%
nl7.boom.skin,9,0.02%,9,0,100.00%
nl5.boom.skin,9,0.02%,9,0,100.00%
nl8.boom.skin,9,0.02%,9,0,100.00%
nla.boom.skin,9,0.02%,9,0,100.00%
n61.boom.skin,9,0.02%,9,0,100.00%
n67.boom.skin,9,0.02%,9,0,100.00%
nm1.boom.skin,9,0.02%,9,0,100.00%
n74.boom.skin,9,0.02%,9,0,100.00%
s101.boom.skin,9,0.02%,9,0,100.00%
nj6.boom.skin,9,0.02%,9,0,100.00%
n170.boom.skin,9,0.02%,9,0,100.00%
nj1.boom.skin,9,0.02%,9,0,100.00%
nj3.boom.skin,9,0.02%,9,0,100.00%
nj4.boom.skin,9,0.02%,9,0,100.00%
nj5.boom.skin,9,0.02%,9,0,100.00%
njc.boom.skin,9,0.02%,9,0,100.00%
nj7.boom.skin,9,0.02%,9,0,100.00%
nj8.boom.skin,9,0.02%,9,0,100.00%
nj9.boom.skin,9,0.02%,9,0,100.00%
nja.boom.skin,9,0.02%,9,0,100.00%
njb.boom.skin,9,0.02%,9,0,100.00%
njd.boom.skin,9,0.02%,9,0,100.00%
nje.boom.skin,9,0.02%,9,0,100.00%
nk8.boom.skin,9,0.02%,9,0,100.00%
nka.boom.skin,9,0.02%,9,0,100.00%
jp11.boom.skin,9,0.02%,9,0,100.00%
jp12.boom.skin,9,0.02%,9,0,100.00%
nk9.boom.skin,9,0.02%,9,0,100.00%
nm4.boom.skin,9,0.02%,9,0,100.00%
nm2.boom.skin,9,0.02%,9,0,100.00%
nm3.boom.skin,9,0.02%,9,0,100.00%
nm6.boom.skin,9,0.02%,9,0,100.00%
nm5.boom.skin,9,0.02%,9,0,100.00%
sp1.sangfor.com.cn,9,0.02%,9,0,100.00%
onedsblobprdwus15.westus.cloudapp.azure.com,9,0.02%,9,0,100.00%
a-0001.a-msedge.net,8,0.01%,16,8,50.00%
SIN-efz.ms-acdc.office.com,8,0.01%,16,8,50.00%
tsfe.trafficmanager.net,8,0.01%,8,0,100.00%
settings-prod-scus-2.southcentralus.cloudapp.azure.com,8,0.01%,8,0,100.00%
d20wxjqjgi3st.cloudfront.net,8,0.01%,16,8,50.00%
e6603.g.akamaiedge.net,8,0.01%,8,0,100.00%
shavar.prod.mozaws.net,8,0.01%,8,0,100.00%
internal-api.feishu.cn,8,0.01%,8,0,100.00%
info.lenovo.com.cn,8,0.01%,8,0,100.00%
wxapp.tc.qq.com,8,0.01%,23,15,34.78%
c.urs.microsoft.com,8,0.01%,8,0,100.00%
cn-qingdao.axt.aliyun.com,8,0.01%,8,0,100.00%
bubble.ic.ksosoft.com,8,0.01%,8,0,100.00%
www.zhihu.com,8,0.01%,21,13,38.10%
gm.mmstat.com,8,0.01%,8,0,100.00%
10.rarbg.me,8,0.01%,8,0,100.00%
venus.douyucdn.cn,8,0.01%,8,0,100.00%
onedscolprdcus13.centralus.cloudapp.azure.com,8,0.01%,8,0,100.00%
ib.sin1.geoadnxs.com,8,0.01%,8,0,100.00%
high-frequency-gray.zhhainiao.com,8,0.01%,8,0,100.00%
flux.hcdn.qiyi.com,8,0.01%,8,0,100.00%
roaming.officeapps.live.com,8,0.01%,8,0,100.00%
ss2.baidu.com,8,0.01%,15,7,53.33%
video-bd-drcn.dbankcdn.cn,8,0.01%,22,14,36.36%
www.mysmth.net,8,0.01%,8,0,100.00%
b.bdstatic.com,8,0.01%,9,1,88.89%
update.code.visualstudio.com,8,0.01%,8,0,100.00%
dldir1.qq.com.tcdn.qq.com,8,0.01%,8,0,100.00%
dldir1.qq.com.mid.dcloudstc.com,8,0.01%,8,0,100.00%
init-china.itunes-apple.com.akadns.net,8,0.01%,16,8,50.00%
be01mr9s.sched.d2.tdnsdp1.cn,8,0.01%,8,0,100.00%
array607.prod.do.dsp.mp.microsoft.com,8,0.01%,8,0,100.00%
2csvr-basic.wpsdns.com,8,0.01%,8,0,100.00%
mirrors.163.com,8,0.01%,8,0,100.00%
stdtime.gov.hk,8,0.01%,8,0,100.00%
mx.cstnet.cn,8,0.01%,8,0,100.00%
dotserver.douyucdn.cn,8,0.01%,8,0,100.00%
cloud.google.com,8,0.01%,8,0,100.00%
4532841.pack.tcdnlive.com,8,0.01%,8,0,100.00%
webquotestaticpic.dfcfw.com,8,0.01%,8,0,100.00%
webquotepic.eastmoney.com,8,0.01%,8,0,100.00%
accscdn.m.taobao.com,8,0.01%,8,0,100.00%
gs-loc-cn.apple.com,8,0.01%,8,0,100.00%
appledownload.qtlcdn.com,8,0.01%,8,0,100.00%
f5-ck.zhhainiao.com,8,0.01%,8,0,100.00%
jp1.gmdns.net,8,0.01%,8,0,100.00%
pic4.zhimg.com,8,0.01%,8,0,100.00%
pic1.zhimg.com,8,0.01%,8,0,100.00%
pic2.zhimg.com,8,0.01%,8,0,100.00%
zz.bdstatic.com,8,0.01%,8,0,100.00%
ac.dun.163.com,8,0.01%,16,8,50.00%
cs9.wac.phicdn.net,8,0.01%,16,8,50.00%
appvolcanoedc.jianguoyun.com,8,0.01%,8,0,100.00%
ai1.acciff.com,8,0.01%,8,0,100.00%
qbwup.imtt.qq.com,8,0.01%,8,0,100.00%
www.hostbuf.com,8,0.01%,8,0,100.00%
s1.url.cn,8,0.01%,8,0,100.00%
api.docer.wpscdn.cn,8,0.01%,18,10,44.44%
bt2.archive.org,8,0.01%,16,8,50.00%
path1.xtracloud.net,8,0.01%,8,0,100.00%
pop.ie.sogou.com,8,0.01%,8,0,100.00%
assets.msn.com.edgekey.net,8,0.01%,8,0,100.00%
e28578.d.akamaiedge.net,8,0.01%,8,0,100.00%
all.feishu.cn.w.kunluncan.com,8,0.01%,8,0,100.00%
checkip.synology.com,8,0.01%,8,0,100.00%
sadownload-new.mcafee.com.edgekey.net,8,0.01%,8,0,100.00%
dig.bdurl.net,8,0.01%,8,0,100.00%
tp.m-team.cc,8,0.01%,16,8,50.00%
push-fcdn-base.s.bytefcdn.com,8,0.01%,8,0,100.00%
static.nvidiagrid.net,8,0.01%,9,1,88.89%
account.sogou.com,8,0.01%,8,0,100.00%
download.visualstudio.microsoft.com.mwcname.com,8,0.01%,8,0,100.00%
geo.prod.do.dsp.mp.microsoft.com,8,0.01%,8,0,100.00%
t13.baidu.com,8,0.01%,9,1,88.89%
tpc.googlesyndication.com,8,0.01%,10,2,80.00%
gsp85-cn-ssl.ls.apple.com,8,0.01%,8,0,100.00%
down.anticheatexpert.com.cdn.ettdnsv.com,8,0.01%,8,0,100.00%
spatialsearch.is.autonavi.com,8,0.01%,8,0,100.00%
advanced-cm-2.nodesub.com,8,0.01%,8,0,100.00%
onedsblobprdeus17.eastus.cloudapp.azure.com,8,0.01%,8,0,100.00%
keyvalueservice.icloud.com.cn,8,0.01%,8,0,100.00%
internal-api-lark-api.feishu.cn.w.cdngslb.com,8,0.01%,8,0,100.00%
c.pcs.baidu.com,8,0.01%,16,8,50.00%
t14.baidu.com,8,0.01%,8,0,100.00%
realprotect1.mcafee.com,8,0.01%,8,0,100.00%
appsso.oh.isrc.ac.cn,8,0.01%,8,0,100.00%
www.bitseduce.com,8,0.01%,8,0,100.00%
www.biztorrents.com,8,0.01%,8,0,100.00%
cstm.baidu.com,8,0.01%,8,0,100.00%
ntemp08.boom.skin,8,0.01%,8,0,100.00%
n47.boom.skin,8,0.01%,8,0,100.00%
n05.boom.skin,8,0.01%,8,0,100.00%
us5.edge.boom.skin,8,0.01%,8,0,100.00%
s104.boom.skin,8,0.01%,8,0,100.00%
nf7.boom.skin,8,0.01%,8,0,100.00%
apphub.aliyuncs.com,8,0.01%,8,0,100.00%
tracker.ai.xiaomi.com,8,0.01%,8,0,100.00%
array509.prod.do.dsp.mp.microsoft.com,7,0.01%,7,0,100.00%
ocsp-lb.apple.com.akadns.net,7,0.01%,8,1,87.50%
gm.gds.mmstat.com,7,0.01%,7,0,100.00%
www.update.microsoft.com,7,0.01%,7,0,100.00%
fa000000105.resources.office.net,7,0.01%,15,8,46.67%
long.iwifi.360.cn,7,0.01%,7,0,100.00%
pgw-tel-cld-sl.alicdn.com,7,0.01%,7,0,100.00%
upos-sz-mirrorcoso1.bilivideo.com,7,0.01%,20,13,35.00%
array506.prod.do.dsp.mp.microsoft.com,7,0.01%,13,6,53.85%
beacons3.gvt2.com,7,0.01%,7,0,100.00%
miao.baidu.com,7,0.01%,7,0,100.00%
data.hicloud.com,7,0.01%,7,0,100.00%
spinfo.wps.cn,7,0.01%,7,0,100.00%
notifier-configs.airbrake.io,7,0.01%,17,10,41.18%
t9.baidu.com,7,0.01%,8,1,87.50%
sp0.baidu.com,7,0.01%,13,6,53.85%
us3-6.nigirocloud.com,7,0.01%,7,0,100.00%
us3-7.nigirocloud.com,7,0.01%,7,0,100.00%
us3-8.nigirocloud.com,7,0.01%,7,0,100.00%
ty2-4.nigirocloud.com,7,0.01%,7,0,100.00%
ty2-6.nigirocloud.com,7,0.01%,7,0,100.00%
os1-2.nigirocloud.com,7,0.01%,7,0,100.00%
os1-1.nigirocloud.com,7,0.01%,7,0,100.00%
os1-4.nigirocloud.com,7,0.01%,7,0,100.00%
os1-5.nigirocloud.com,7,0.01%,7,0,100.00%
os1-8.nigirocloud.com,7,0.01%,7,0,100.00%
os2-1.nigirocloud.com,7,0.01%,7,0,100.00%
os2-2.nigirocloud.com,7,0.01%,7,0,100.00%
os2-3.nigirocloud.com,7,0.01%,7,0,100.00%
os2-4.nigirocloud.com,7,0.01%,7,0,100.00%
os2-6.nigirocloud.com,7,0.01%,7,0,100.00%
os2-7.nigirocloud.com,7,0.01%,7,0,100.00%
nl1-1.nigirocloud.com,7,0.01%,7,0,100.00%
nl1-2.nigirocloud.com,7,0.01%,7,0,100.00%
nl1-5.nigirocloud.com,7,0.01%,7,0,100.00%
nl1-6.nigirocloud.com,7,0.01%,7,0,100.00%
nl1-7.nigirocloud.com,7,0.01%,7,0,100.00%
nl3-1.nigirocloud.com,7,0.01%,7,0,100.00%
nl3-2.nigirocloud.com,7,0.01%,7,0,100.00%
nl3-7.nigirocloud.com,7,0.01%,7,0,100.00%
uk1-1.nigirocloud.com,7,0.01%,7,0,100.00%
uk1-3.nigirocloud.com,7,0.01%,7,0,100.00%
uk1-4.nigirocloud.com,7,0.01%,7,0,100.00%
public-treatment.prod-experimentation.grammarlyaws.com,7,0.01%,7,0,100.00%
gates.grammarly.com,7,0.01%,7,0,100.00%
havfw69955.lithium.com,7,0.01%,14,7,50.00%
d28139t0r7hg1k.cloudfront.net,7,0.01%,14,7,50.00%
sz-ucloud-ipv4.ucloudnaming.info,7,0.01%,7,0,100.00%
www.google.com.hk,7,0.01%,14,7,50.00%
img.alicdn.com.danuoyi.alicdn.com,7,0.01%,14,7,50.00%
s.ludashi.com,7,0.01%,7,0,100.00%
zhushou.huihui.cn,7,0.01%,7,0,100.00%
st.todesk.com,7,0.01%,7,0,100.00%
update.360safe.com,7,0.01%,7,0,100.00%
ini.update.360safe.com,7,0.01%,7,0,100.00%
dcagent.mecdn.synacast.com,7,0.01%,7,0,100.00%
array615.prod.do.dsp.mp.microsoft.com,7,0.01%,7,0,100.00%
0.debian.pool.ntp.org,7,0.01%,7,0,100.00%
help-tower.2345.cc,7,0.01%,7,0,100.00%
music.163.com,7,0.01%,7,0,100.00%
miserupdate.aliyun.com.danuoyi.tbcache.com,7,0.01%,7,0,100.00%
am.abc.wdpdk.link,7,0.01%,7,0,100.00%
dynsrv.wps.cn,7,0.01%,7,0,100.00%
go.ie.sogou.com,7,0.01%,7,0,100.00%
ins-g4ztq7u7.ias.tencent-cloud.net,7,0.01%,7,0,100.00%
opencdnbd.jomodns.com,7,0.01%,8,1,87.50%
msnzlxxglobal.v.lxcvc.com,7,0.01%,7,0,100.00%
fonts.googleapis.com,7,0.01%,7,0,100.00%
ios.now163.com,7,0.01%,7,0,100.00%
array810.prod.do.dsp.mp.microsoft.com,7,0.01%,7,0,100.00%
kv601.prod.do.dsp.mp.microsoft.com,7,0.01%,7,0,100.00%
msedge.b.tlu.dl.delivery.mp.microsoft.com,7,0.01%,8,1,87.50%
www36oo.com,7,0.01%,7,0,100.00%
n11.boom.skin,7,0.01%,7,0,100.00%
ntemp01.boom.skin,7,0.01%,7,0,100.00%
ntemp09.boom.skin,7,0.01%,7,0,100.00%
n22.boom.skin,7,0.01%,7,0,100.00%
n116.boom.skin,7,0.01%,7,0,100.00%
n48.boom.skin,7,0.01%,7,0,100.00%
us6.edge.boom.skin,7,0.01%,7,0,100.00%
us7.edge.boom.skin,7,0.01%,7,0,100.00%
us9.edge.boom.skin,7,0.01%,7,0,100.00%
us10.edge.boom.skin,7,0.01%,7,0,100.00%
us2.edge.boom.skin,7,0.01%,7,0,100.00%
us8.edge.boom.skin,7,0.01%,7,0,100.00%
us1.edge.boom.skin,7,0.01%,7,0,100.00%
us3.edge.boom.skin,7,0.01%,7,0,100.00%
us4.edge.boom.skin,7,0.01%,7,0,100.00%
n37.boom.skin,7,0.01%,7,0,100.00%
s102.boom.skin,7,0.01%,7,0,100.00%
s103.boom.skin,7,0.01%,7,0,100.00%
s105.boom.skin,7,0.01%,7,0,100.00%
n17.boom.skin,7,0.01%,7,0,100.00%
n96.boom.skin,7,0.01%,7,0,100.00%
nf6.boom.skin,7,0.01%,7,0,100.00%
n110.boom.skin,7,0.01%,7,0,100.00%
n09.boom.skin,7,0.01%,7,0,100.00%
n13.boom.skin,7,0.01%,7,0,100.00%
n27.boom.skin,7,0.01%,7,0,100.00%
n92.boom.skin,7,0.01%,7,0,100.00%
n77.boom.skin,7,0.01%,7,0,100.00%
n60.boom.skin,7,0.01%,7,0,100.00%
ntemp25.boom.skin,7,0.01%,7,0,100.00%
n100.boom.skin,7,0.01%,7,0,100.00%
n114.boom.skin,7,0.01%,7,0,100.00%
n63.boom.skin,7,0.01%,7,0,100.00%
nk2.boom.skin,7,0.01%,7,0,100.00%
nk3.boom.skin,7,0.01%,7,0,100.00%
nk5.boom.skin,7,0.01%,7,0,100.00%
nk7.boom.skin,7,0.01%,7,0,100.00%
nf1.boom.skin,7,0.01%,7,0,100.00%
nf2.boom.skin,7,0.01%,7,0,100.00%
nf4.boom.skin,7,0.01%,7,0,100.00%
nf5.boom.skin,7,0.01%,7,0,100.00%
nk4.boom.skin,7,0.01%,7,0,100.00%
nf3.boom.skin,7,0.01%,7,0,100.00%
nf8.boom.skin,7,0.01%,7,0,100.00%
nf10.boom.skin,7,0.01%,7,0,100.00%
nf9.boom.skin,7,0.01%,7,0,100.00%
nf11.boom.skin,7,0.01%,7,0,100.00%
fe2cr.update.msft.com.trafficmanager.net,6,0.01%,12,6,50.00%
ocsp.apple.com,6,0.01%,6,0,100.00%
ocsp-cn-lb.apple.com.akadns.net,6,0.01%,6,0,100.00%
cn.patch.battle.net,6,0.01%,6,0,100.00%
pull-flv-f29.douyincdn.com.ucloud.com.cn,6,0.01%,6,0,100.00%
push-rtmp-l1.douyincdn.com,6,0.01%,6,0,100.00%
pull-flv-l3-encryption.douyincdn.com.w.alikunlun.net,6,0.01%,6,0,100.00%
push-rtmp-vr-l6.douyincdn.com,6,0.01%,6,0,100.00%
push-rtmp-vr-l6.douyincdn.com.upvcloud.ks-cdn.com,6,0.01%,6,0,100.00%
u01.gslb.ksyuncdn.com,6,0.01%,6,0,100.00%
pull-rtmp-f96.douyincdn.com.d.live.cdn.chinamobile.com,6,0.01%,6,0,100.00%
pull-rtmp-f13.douyincdn.com.a.bcelive.com,6,0.01%,6,0,100.00%
pull-hls-f11.douyincdn.com.tcdnlive.com,6,0.01%,6,0,100.00%
bcelive.jomodns.com,6,0.01%,6,0,100.00%
pull-hls-f11.douyincdn.com.sched.l8.tdnsv5.com,6,0.01%,6,0,100.00%
push-rtmp-l6-enc.douyincdn.com.upvcloud.ks-cdn.com,6,0.01%,6,0,100.00%
push-vol-base.s.volcfcdndvs.com,6,0.01%,6,0,100.00%
pull-f5-hs.pstatp.com,6,0.01%,6,0,100.00%
edge.microsoft.com,6,0.01%,165,159,3.64%
f-log-extension.grammarly.io,6,0.01%,6,0,100.00%
steamcdn-a.akamaihd.net,6,0.01%,6,0,100.00%
resources.jetbrains.com,6,0.01%,8,2,75.00%
beacons.gvt2.com,6,0.01%,17,11,35.29%
onedscolprdcus03.centralus.cloudapp.azure.com,6,0.01%,12,6,50.00%
wn.pos.baidu.com,6,0.01%,6,0,100.00%
eu-west-1.axt.aliyun.com,6,0.01%,6,0,100.00%
chidc2.outbrain.org,6,0.01%,6,0,100.00%
tracker.xfsub.com,6,0.01%,6,0,100.00%
clk.lenovo.com.cn,6,0.01%,6,0,100.00%
ts4.cn.mm.bing.net,6,0.01%,6,0,100.00%
onedscolprdfrc01.francecentral.cloudapp.azure.com,6,0.01%,6,0,100.00%
wdcp.microsoft.com,6,0.01%,6,0,100.00%
pbjs.e-planning.net,6,0.01%,6,0,100.00%
s1.vip.wpscdn.cn,6,0.01%,12,6,50.00%
tracker.vanitycore.co,6,0.01%,12,6,50.00%
t7.baidu.com,6,0.01%,6,0,100.00%
vdwmto3.bdstatic.com,6,0.01%,14,8,42.86%
baijiahao.baidu.com,6,0.01%,6,0,100.00%
browser6.qhimg.com,6,0.01%,6,0,100.00%
dldir1v6.qq.com,6,0.01%,12,6,50.00%
t.helper.2345.cc,6,0.01%,6,0,100.00%
home.firefoxchina.cn,6,0.01%,6,0,100.00%
img.yiqikan8.com,6,0.01%,6,0,100.00%
k-static.xsfaya.com,6,0.01%,6,0,100.00%
c.msn.cn,6,0.01%,6,0,100.00%
ty1-2.nigirocloud.com,6,0.01%,6,0,100.00%
ty1-4.nigirocloud.com,6,0.01%,6,0,100.00%
ty2-2.nigirocloud.com,6,0.01%,6,0,100.00%
ty2-8.nigirocloud.com,6,0.01%,6,0,100.00%
os2-8.nigirocloud.com,6,0.01%,6,0,100.00%
nl1-3.nigirocloud.com,6,0.01%,6,0,100.00%
nl1-8.nigirocloud.com,6,0.01%,6,0,100.00%
nl3-3.nigirocloud.com,6,0.01%,6,0,100.00%
nl3-4.nigirocloud.com,6,0.01%,6,0,100.00%
nl3-6.nigirocloud.com,6,0.01%,6,0,100.00%
cs-geo-dds.trafficmanager.net,6,0.01%,6,0,100.00%
go.microsoft.com.edgekey.net,6,0.01%,13,7,46.15%
www.microsoft.com-c-3.edgekey.net.globalredir.akadns.net,6,0.01%,6,0,100.00%
keyvalueservice.fe.apple-dns.cn,6,0.01%,6,0,100.00%
www.download.windowsupdate.com.download.ks-cdn.com,6,0.01%,6,0,100.00%
easylist-downloads.adblockplus.org,6,0.01%,12,6,50.00%
bolt.dropbox.com,6,0.01%,12,6,50.00%
aoufnebg.dayugslb.com,6,0.01%,6,0,100.00%
api.insight.synology.com,6,0.01%,6,0,100.00%
cdn.jsdelivr.net,6,0.01%,11,5,54.55%
iduxzj9.qiniudns.com,6,0.01%,12,6,50.00%
pmpcdn1.wmupd.com,6,0.01%,6,0,100.00%
pmpcdn1.wmupd.com.cdn.dnsv1.com,6,0.01%,6,0,100.00%
k53k6ler.sched.sma.tdnsstic1.cn,6,0.01%,6,0,100.00%
pub.idqqimg.com.sched.legopic1.tdnsv6.com,6,0.01%,6,0,100.00%
22.courier-push-apple.com.akadns.net,6,0.01%,6,0,100.00%
kjk3jf40.sched.sma-dk.tdnsstic1.cn,6,0.01%,12,6,50.00%
dcache.hub.sandai.net,6,0.01%,6,0,100.00%
data.unistream.io,6,0.01%,6,0,100.00%
www.mi.com,6,0.01%,14,8,42.86%
v10.vortex-win.data.microsoft.com,6,0.01%,7,1,85.71%
h-adashx.ut.taobao.com.gds.alibabadns.com,6,0.01%,6,0,100.00%
h-adashx-internal.ut.taobao.com,6,0.01%,6,0,100.00%
pull-rtmp-l1-hs.pstatp.com,6,0.01%,6,0,100.00%
pull-rtmp-l1-hs.pstatp.com.wsdvs.com,6,0.01%,6,0,100.00%
push-rtmp-spe-l6.douyincdn.com,6,0.01%,6,0,100.00%
pull-hs-f5.flive.huoshanlive.com.c.volcfcdndvs.com,6,0.01%,6,0,100.00%
push-rtmp-spe-l6.douyincdn.com.upvcloud.ks-cdn.com,6,0.01%,6,0,100.00%
pull-vol-base.s.volcfcdndvs.com,6,0.01%,6,0,100.00%
pull-hs-f5.flive.ihuoshanlive.com,6,0.01%,6,0,100.00%
pull-hls-vr-l26.douyincdn.com,6,0.01%,6,0,100.00%
pull-hs-f5.flive.ihuoshanlive.com.c.volcfcdndvs.com,6,0.01%,6,0,100.00%
hcdnl.pulldyin.iptv.gslb.c.cdnhwc2.com,6,0.01%,6,0,100.00%
push-rtmp-l6.ixigua.com,6,0.01%,6,0,100.00%
push-rtmp-l6.ixigua.com.upvcloud.ks-cdn.com,6,0.01%,6,0,100.00%
u01-ml.gslb.ksyuncdn.com,6,0.01%,6,0,100.00%
pull-flv-vr-l26.douyincdn.com.c.cdnhwc3.com,6,0.01%,6,0,100.00%
pull-rtmp-l27.douyincdn.com,6,0.01%,6,0,100.00%
pull-rtmp-l27.douyincdn.com.live-play.galileo.jcloud-cdn.com,6,0.01%,6,0,100.00%
pull-rtmp-l11-source.douyincdn.com,6,0.01%,6,0,100.00%
7223175.l2.sched.dcloudlive.com,6,0.01%,6,0,100.00%
pull-f5.douyincdn.com.c.bytefcdn.com,6,0.01%,6,0,100.00%
pull-rtmp-f1.douyincdn.com.wsdvs.com,6,0.01%,6,0,100.00%
pull-f5-io.flive.douyincdn.com.c.bytefcdn.com,6,0.01%,6,0,100.00%
pull-rtmp-l1.ixigua.com.wsdvs.com,6,0.01%,6,0,100.00%
pull-fcdn-douyin-base2.s.bytefcdn.com,6,0.01%,6,0,100.00%
pull-hls-spe-l11.douyincdn.com.sched.l9.tdnsv5.com,6,0.01%,6,0,100.00%
pull-flv-l13.douyincdn.com,6,0.01%,6,0,100.00%
pull-flv-l13.douyincdn.com.a.bcelive.com,6,0.01%,6,0,100.00%
bcedyflvq.jomodns.com,6,0.01%,6,0,100.00%
pull-rtmp-l11-cny.douyincdn.com,6,0.01%,6,0,100.00%
pull-rtmp-l26-cny.douyincdn.com,6,0.01%,6,0,100.00%
pull-rtmp-l11-cny.douyincdn.com.tcdnlive.com,6,0.01%,6,0,100.00%
pull-rtmp-l26-cny.douyincdn.com.c.cdnhwc3.com,6,0.01%,6,0,100.00%
pull-rtmp-l11-cny.douyincdn.com.sched.l9.tdnsv5.com,6,0.01%,6,0,100.00%
push-rtmp-l1.douyincdn.com.wsdvs.com,6,0.01%,6,0,100.00%
pull-rtmp-l11.douyincdn.com.livecdn.liveplay.myqcloud.com,6,0.01%,6,0,100.00%
pull-f3-proxy.douyincdn.com,6,0.01%,6,0,100.00%
pull-rtmp-l11.douyincdn.com.tcdnlive.com,6,0.01%,6,0,100.00%
pull-f3-proxy.douyincdn.com.w.alikunlun.net,6,0.01%,6,0,100.00%
pull-rtmp-l11.douyincdn.com.sched.l8.tdnsv5.com,6,0.01%,6,0,100.00%
pull-rtmp-l1-source.douyincdn.com.wsdvs.com,6,0.01%,6,0,100.00%
stock2.finance.sina.com.cn,6,0.01%,6,0,100.00%
92.push2his.eastmoney.com,6,0.01%,6,0,100.00%
hk1-2.nigirocloud.com,6,0.01%,6,0,100.00%
29.push2his.eastmoney.com,6,0.01%,6,0,100.00%
64.push2his.eastmoney.com,6,0.01%,6,0,100.00%
alpha-cloud-log.cn-hangzhou.log.aliyuncs.com,6,0.01%,6,0,100.00%
imap-mail.outlook.com,6,0.01%,12,6,50.00%
hp3.mail.netease.com,6,0.01%,6,0,100.00%
ipm-klca.kaspersky.com,6,0.01%,6,0,100.00%
cn2.gmdns.net,6,0.01%,6,0,100.00%
sg1.gmdns.net,6,0.01%,6,0,100.00%
cn9.gmdns.net,6,0.01%,6,0,100.00%
cn14.gmdns.net,6,0.01%,6,0,100.00%
cn5.gmdns.net,6,0.01%,6,0,100.00%
dotcounter.douyucdn.cn,6,0.01%,6,0,100.00%
s.cn.bing.net,6,0.01%,6,0,100.00%
acstatic-dun.126.net,6,0.01%,6,0,100.00%
se.360.cn,6,0.01%,10,4,60.00%
onedscolprdcus08.centralus.cloudapp.azure.com,6,0.01%,6,0,100.00%
array805.prod.do.dsp.mp.microsoft.com,6,0.01%,6,0,100.00%
array611.prod.do.dsp.mp.microsoft.com,6,0.01%,6,0,100.00%
hkg03.bch.baidu-itm.com,6,0.01%,6,0,100.00%
mssdk-bu.bytedance.com,6,0.01%,6,0,100.00%
toblog.ctobsnssdk.com,6,0.01%,6,0,100.00%
pdcweb.micloud.xiaomi.net,6,0.01%,6,0,100.00%
frp.zwlin.top,6,0.01%,6,0,100.00%
i1.hdslb.com,6,0.01%,12,6,50.00%
d.docs.live.net,6,0.01%,7,1,85.71%
dl.google.com,6,0.01%,6,0,100.00%
bgpv4.music.ntes53.netease.com,6,0.01%,6,0,100.00%
securityapi.d3-pr-tm.com,6,0.01%,6,0,100.00%
beacons-handoff.gcp.gvt2.com,6,0.01%,6,0,100.00%
dc.applicationinsights.microsoft.com,6,0.01%,6,0,100.00%
dc.applicationinsights.azure.com,6,0.01%,6,0,100.00%
global.in.ai.monitor.azure.com,6,0.01%,6,0,100.00%
global.in.ai.privatelink.monitor.azure.com,6,0.01%,6,0,100.00%
dc.trafficmanager.net,6,0.01%,6,0,100.00%
pancake.cdn-apple.com.akadns.net,6,0.01%,6,0,100.00%
pancake-cn.cdn-apple.com.akadns.net,6,0.01%,6,0,100.00%
htydhd.wmupd.com,6,0.01%,6,0,100.00%
settings-prod-eus-1.eastus.cloudapp.azure.com,6,0.01%,6,0,100.00%
d.dropbox.com,6,0.01%,12,6,50.00%
service.weather.msn.cn,6,0.01%,6,0,100.00%
ocsp.verisign.com,6,0.01%,12,6,50.00%
us3-1.nigirocloud.com,6,0.01%,6,0,100.00%
us3-3.nigirocloud.com,6,0.01%,6,0,100.00%
au1-1.nigirocloud.com,6,0.01%,6,0,100.00%
au1-2.nigirocloud.com,6,0.01%,6,0,100.00%
au1-4.nigirocloud.com,6,0.01%,6,0,100.00%
au2-2.nigirocloud.com,6,0.01%,6,0,100.00%
au2-4.nigirocloud.com,6,0.01%,6,0,100.00%
de1-3.nigirocloud.com,6,0.01%,6,0,100.00%
us3-4.nigirocloud.com,6,0.01%,6,0,100.00%
de1-4.nigirocloud.com,6,0.01%,6,0,100.00%
de2-1.nigirocloud.com,6,0.01%,6,0,100.00%
de2-3.nigirocloud.com,6,0.01%,6,0,100.00%
ee1-1.nigirocloud.com,6,0.01%,6,0,100.00%
ee1-2.nigirocloud.com,6,0.01%,6,0,100.00%
ee1-3.nigirocloud.com,6,0.01%,6,0,100.00%
os1-6.nigirocloud.com,6,0.01%,6,0,100.00%
ee1-4.nigirocloud.com,6,0.01%,6,0,100.00%
us1-1.nigirocloud.com,6,0.01%,6,0,100.00%
us1-3.nigirocloud.com,6,0.01%,6,0,100.00%
us1-4.nigirocloud.com,6,0.01%,6,0,100.00%
us2-3.nigirocloud.com,6,0.01%,6,0,100.00%
us2-4.nigirocloud.com,6,0.01%,6,0,100.00%
ty2-3.nigirocloud.com,6,0.01%,6,0,100.00%
pull-flv-f11-proxy.douyincdn.com.sched.l8.tdnsv5.com,6,0.01%,6,0,100.00%
pull-hls-hs-f5-tsl.douyincdn.com.w.cdngslb.com,6,0.01%,6,0,100.00%
pull-flv-l11-encryption.douyincdn.com.tcdnlive.com,6,0.01%,6,0,100.00%
pull-flv-l11-encryption.douyincdn.com.sched.l9.tdnsv5.com,6,0.01%,6,0,100.00%
pull-flv-f96.douyincdn.com.d.live.cdn.chinamobile.com,6,0.01%,6,0,100.00%
pull-flv-f13.douyincdn.com.a.bcelive.com,6,0.01%,6,0,100.00%
bcefdyflvq.jomodns.com,6,0.01%,6,0,100.00%
pull-rtmp-l13.douyincdn.com.a.bcelive.com,6,0.01%,6,0,100.00%
pull-hls-spe-l26.douyincdn.com,6,0.01%,6,0,100.00%
push-rtmp-l26.douyincdn.com,6,0.01%,6,0,100.00%
push-rtmp-hs-f5.huoshanlive.com.c.volcfcdndvs.com,6,0.01%,6,0,100.00%
hcdnl.push.gslb.c.cdnhwc2.com,6,0.01%,6,0,100.00%
toutiao.uplive.ks-cdn.com,6,0.01%,6,0,100.00%
pull-l3-hs.pstatp.com.w.alikunlun.net,6,0.01%,6,0,100.00%
push-rtmp-l1-cny.douyincdn.com,6,0.01%,6,0,100.00%
pull-tsl-l3.douyincdn.com,6,0.01%,6,0,100.00%
push-rtmp-l1-cny.douyincdn.com.wsdvs.com,6,0.01%,6,0,100.00%
push-rtmp-l11-cny.douyincdn.com.livepush.myqcloud.com,6,0.01%,6,0,100.00%
push-rtmp-l27.douyincdn.com.live-publish.galileo.jcloud-cdn.com,6,0.01%,6,0,100.00%
yun.livepush.myqcloud.com,6,0.01%,6,0,100.00%
push-rtmp-l26-cny.douyincdn.com.c.cdnhwc3.com,6,0.01%,6,0,100.00%
pull-lls-l26.douyincdn.com,6,0.01%,6,0,100.00%
pull-f3.douyincdn.com.m.alikunlun.net,6,0.01%,6,0,100.00%
pull-lls-l11.douyincdn.com,6,0.01%,6,0,100.00%
webrtc.liveplay.myqcloud.com.sched.webrtc.tdnsv5.com,6,0.01%,6,0,100.00%
push-rtmp-l3-cny.douyincdn.com,6,0.01%,6,0,100.00%
push-rtmp-vr-l11.douyincdn.com.tlivepush.com,6,0.01%,6,0,100.00%
pull-l3.douyincdn.com,6,0.01%,6,0,100.00%
pull-l3.douyincdn.com.w.alikunlun.net,6,0.01%,6,0,100.00%
pull-flv-l1-cny.douyincdn.com.wsdvs.com,6,0.01%,6,0,100.00%
push-rtmp-l11.douyincdn.com.livepush.myqcloud.com,6,0.01%,6,0,100.00%
jt.tlivepush3soct1douyin.tcdn.qq.com,6,0.01%,6,0,100.00%
pull-f5-vs.flive.douyincdn.com,6,0.01%,6,0,100.00%
pull-f5-vs.flive.douyincdn.com.c.bytefcdn.com,6,0.01%,6,0,100.00%
hcdnl.pulldyin.f26.gslb.c.cdnhwc2.com,6,0.01%,6,0,100.00%
push-rtmp-f5-hs.pstatp.com,6,0.01%,6,0,100.00%
push-rtmp-l1.ixigua.com.wsdvs.com,6,0.01%,6,0,100.00%
pull-flv-l27.douyincdn.com.live-play.galileo.jcloud-cdn.com,6,0.01%,6,0,100.00%
pull-flv-f11.douyincdn.com.sched.l8.tdnsv5.com,6,0.01%,6,0,100.00%
pull-flv-spe-l11.douyincdn.com.tlivecdn.com,6,0.01%,6,0,100.00%
pull-hls-f6.douyincdn.com.hlsvcloud.ks-cdn.com,6,0.01%,6,0,100.00%
pull-flv-spe-l11.douyincdn.com.sched.l9.tdnsv5.com,6,0.01%,6,0,100.00%
k5-toutiao-ml.gslb.ksyuncdn.com,6,0.01%,6,0,100.00%
pull-hls-f13.douyincdn.com,6,0.01%,6,0,100.00%
pull-hls-f5-enc.flive.douyincdn.com,6,0.01%,6,0,100.00%
pull-hls-f13.douyincdn.com.a.bdydns.com,6,0.01%,6,0,100.00%
pull-hls-f5-enc.flive.douyincdn.com.w.kunluncan.com,6,0.01%,6,0,100.00%
push-rtmp-l13.douyincdn.com.b.bcelive.com,6,0.01%,6,0,100.00%
pull-l3-cny.douyincdn.com.w.alikunlun.com,6,0.01%,6,0,100.00%
push-rtmp-hs-f5.douyincdn.com.c.volcfcdndvs.com,6,0.01%,6,0,100.00%
pull-hls-f29.douyincdn.com.ucloud.com.cn,6,0.01%,6,0,100.00%
play.ulive.ugslb.com,6,0.01%,6,0,100.00%
pull-hs-f5.flive.douyincdn.com.c.volcfcdndvs.com,6,0.01%,6,0,100.00%
push-rtmp-f5-cny.douyincdn.com.c.bytefcdn.com,6,0.01%,6,0,100.00%
pull-rtmp-l29.douyincdn.com,6,0.01%,6,0,100.00%
pull-rtmp-l29.douyincdn.com.ucloud.com.cn,6,0.01%,6,0,100.00%
pull-tsl-l11.douyincdn.com.cdn.dnsv1.com,6,0.01%,6,0,100.00%
2852517.sched.v1lego.tdnsvod1.cn,6,0.01%,6,0,100.00%
pull-rtmp-f11.douyincdn.com.tcdnlive.com,6,0.01%,6,0,100.00%
pull-rtmp-f11.douyincdn.com.sched.l8.tdnsv5.com,6,0.01%,6,0,100.00%
push-rtmp-vr-l1.douyincdn.com.wsdvs.com,6,0.01%,6,0,100.00%
pull-lls-f5.flive.douyincdn.com.c.bytefcdn.com,6,0.01%,6,0,100.00%
pull-tsl-vr-l3.douyincdn.com.bytedns1.com,6,0.01%,6,0,100.00%
push-rtmp-f5.douyincdn.com,6,0.01%,6,0,100.00%
pull-f5-mptcp.flive.douyincdn.com,6,0.01%,6,0,100.00%
pull-fcdn-mptcpdouyin.s.bytefcdn.com,6,0.01%,6,0,100.00%
pull-fcdn-douyin-base1.s.bytefcdn.com,6,0.01%,6,0,100.00%
push-rtmp-hs-vr-f5.douyincdn.com.c.volcfcdndvs.com,6,0.01%,6,0,100.00%
pull-f3-hs.pstatp.com.w.alikunlun.net,6,0.01%,6,0,100.00%
pull-lls-spe-l11.douyincdn.com,6,0.01%,6,0,100.00%
push-rtmp-l6-encryption.douyincdn.com,6,0.01%,6,0,100.00%
pull-tsl-hs-spe-f5.douyincdn.com.bytedns1.com,6,0.01%,6,0,100.00%
push-rtmp-l6-encryption.douyincdn.com.upvcloud.ks-cdn.com,6,0.01%,6,0,100.00%
pull-flv-l1.ixigua.com.wsdvs.com,6,0.01%,6,0,100.00%
push-rtmp-l29.douyincdn.com,6,0.01%,6,0,100.00%
push-rtmp-l3-hs.pstatp.com,6,0.01%,6,0,100.00%
pull-hls-f5-tsl.douyincdn.com.w.cdngslb.com,6,0.01%,6,0,100.00%
pull-f5-hs.flive.pstatp.com,6,0.01%,6,0,100.00%
pull-f5-hs.flive.pstatp.com.c.bytefcdn.com,6,0.01%,6,0,100.00%
pull-hls-f5-vs-tsl.douyincdn.com.w.kunluncan.com,6,0.01%,6,0,100.00%
pull-hls-f96.douyincdn.com.d.live.cdn.chinamobile.com,6,0.01%,6,0,100.00%
pull-lls-spe-l3.douyincdn.com,6,0.01%,6,0,100.00%
pull-flv-l29.douyincdn.com.ucloud.com.cn,6,0.01%,6,0,100.00%
pull-hls-vr-l11.douyincdn.com.sched.l9.tdnsv5.com,6,0.01%,6,0,100.00%
pull-f5-hot.flive.douyincdn.com.c.bytefcdn.com,6,0.01%,6,0,100.00%
push-rtmp-spe-l3.douyincdn.com,6,0.01%,6,0,100.00%
pull-flv-f5-enc.flive.douyincdn.com.c.bytefcdn.com,6,0.01%,6,0,100.00%
pull-fcdn-base.s.bytefcdn.com,6,0.01%,6,0,100.00%
pull-flv-vr-l11.douyincdn.com.tlivecdn.com,6,0.01%,6,0,100.00%
pull-flv-vr-l11.douyincdn.com.sched.l9.tdnsv5.com,6,0.01%,6,0,100.00%
pull-flv-l1-hs.pstatp.com.wsdvs.com,6,0.01%,6,0,100.00%
pull-rtmp-l1.douyincdn.com,6,0.01%,6,0,100.00%
pull-rtmp-l1.douyincdn.com.wsdvs.com,6,0.01%,6,0,100.00%
pull-rtmp-f1-hs.pstatp.com.wsdvs.com,6,0.01%,6,0,100.00%
pull-rtmp-f29.douyincdn.com.ucloud.com.cn,6,0.01%,6,0,100.00%
pull-flv-spe-l26.douyincdn.com.c.cdnhwc3.com,6,0.01%,6,0,100.00%
pull-lls-l3.douyincdn.com.w.cdngslb.com,6,0.01%,6,0,100.00%
pull-rtmp-l1-cny.douyincdn.com.wsdvs.com,6,0.01%,6,0,100.00%
push-rtmp-l1-hs.pstatp.com,6,0.01%,6,0,100.00%
push-rtmp-l1-hs.pstatp.com.wsdvs.com,6,0.01%,6,0,100.00%
cdn-file.ludashi.com.m.alikunlun.net,6,0.01%,6,0,100.00%
v1.douyinvod.com,6,0.01%,6,0,100.00%
v1.douyinvod.com.wsdvs.com,6,0.01%,6,0,100.00%
smp-device-content.apple.com,6,0.01%,6,0,100.00%
smp-device-content.lb-apple.com.akadns.net,6,0.01%,6,0,100.00%
smp-device-content-cn.lb-apple.com.akadns.net,6,0.01%,6,0,100.00%
www.msn.cn,6,0.01%,6,0,100.00%
dc1-st.ksn.kaspersky-labs.com,6,0.01%,6,0,100.00%
ow1.res.office365.com,6,0.01%,6,0,100.00%
vi.xiaohongshu.com,6,0.01%,6,0,100.00%
img-s-msn-com.akamaized.net,6,0.01%,17,11,35.29%
live.github.com,6,0.01%,6,0,100.00%
opencdnbdimgtn.jomodns.com,6,0.01%,6,0,100.00%
sp.10jqka.com.cn,6,0.01%,6,0,100.00%
vmss-clarity-ingest-eus.eastus.cloudapp.azure.com,6,0.01%,6,0,100.00%
37.push2his.eastmoney.com,6,0.01%,6,0,100.00%
p111-fmip.icloud.com,6,0.01%,6,0,100.00%
i3.cwip.eset.com,6,0.01%,6,0,100.00%
color.docer.wps.cn,6,0.01%,6,0,100.00%
ipv6-static.dns.iqiyi.com,6,0.01%,12,6,50.00%
e19240.ca.s.tl88.net,6,0.01%,6,0,100.00%
cfw.gti.mcafee.akadns.net,6,0.01%,6,0,100.00%
wcdn.17win.com,6,0.01%,6,0,100.00%
weather-api.extfans.com,6,0.01%,6,0,100.00%
search.apps.ubuntu.com,6,0.01%,6,0,100.00%
partner.googleadservices.com,6,0.01%,6,0,100.00%
list.wallpaper.cloud.duba.net,6,0.01%,6,0,100.00%
redirector.gvt1.com,6,0.01%,6,0,100.00%
s1.hdslb.com,6,0.01%,6,0,100.00%
c.msn.com,6,0.01%,6,0,100.00%
i2.hdslb.com,6,0.01%,13,7,46.15%
onedscolprdcus01.centralus.cloudapp.azure.com,6,0.01%,6,0,100.00%
t15.baidu.com,6,0.01%,6,0,100.00%
bkssl.bdimg.com,6,0.01%,6,0,100.00%
fclick.baidu.com,6,0.01%,6,0,100.00%
baikebcs.bdimg.com,6,0.01%,6,0,100.00%
seapp.stat.360safe.com,6,0.01%,6,0,100.00%
ddns-checkip.quickconnect.to,6,0.01%,6,0,100.00%
63.push2his.eastmoney.com,6,0.01%,6,0,100.00%
odoooacnz-my.sharepoint.com,6,0.01%,6,0,100.00%
qb5x4edlyistb6qd2xzmaoe97c1s2aoo.yundunwaf5.com,6,0.01%,6,0,100.00%
pc-store-lb.lenovomm.cn,6,0.01%,6,0,100.00%
smartscreen-prod.microsoft.com,6,0.01%,6,0,100.00%
d3ra9679oeq3gx.cloudfront.net,6,0.01%,6,0,100.00%
www.i0rp1l2j.com,6,0.01%,6,0,100.00%
pc001.download.wh.cmcm.com,6,0.01%,6,0,100.00%
s.search.bilibili.com,6,0.01%,6,0,100.00%
m.hotmail.com,5,0.01%,10,5,50.00%
hcdnl.pulldyin.hls.gslb.c.cdnhwc2.com,5,0.01%,10,5,50.00%
fm.dl.126.net,5,0.01%,5,0,100.00%
gameplay.intel.com,5,0.01%,13,8,38.46%
channel-account-ssl.xunlei.com,5,0.01%,5,0,100.00%
skydrive.wns.windows.com,5,0.01%,10,5,50.00%
api.onedrive.com,5,0.01%,11,6,45.45%
vpn1.bjfu.edu.cn,5,0.01%,5,0,100.00%
www.tm.ak.prd.aadg.trafficmanager.net,5,0.01%,5,0,100.00%
tracker.coppersurfer.tk,5,0.01%,5,0,100.00%
tracker.torrenty.org,5,0.01%,5,0,100.00%
newvpn.arp.cn,5,0.01%,5,0,100.00%
apidata.googleusercontent.com,5,0.01%,5,0,100.00%
ts3.cn.mm.bing.net,5,0.01%,5,0,100.00%
events.gfe.nvidia.com,5,0.01%,5,0,100.00%
b1h.zemanta.com,5,0.01%,5,0,100.00%
vweixinf.tc.qq.com,5,0.01%,12,7,41.67%
retracker.netbynet.ru,5,0.01%,5,0,100.00%
access.video.qq.com,5,0.01%,5,0,100.00%
static.mysmth.net,5,0.01%,6,1,83.33%
pic.rmb.bdstatic.com,5,0.01%,6,1,83.33%
t10.baidu.com,5,0.01%,6,1,83.33%
ss1.bdstatic.com,5,0.01%,5,0,100.00%
autopush.prod.mozaws.net,5,0.01%,5,0,100.00%
crl3.digicert.com,5,0.01%,10,5,50.00%
dfzximg02.dftoutiao.com,5,0.01%,5,0,100.00%
3wabxy9b.sched.sma.tdnsstic1.cn,5,0.01%,5,0,100.00%
ty1-1.nigirocloud.com,5,0.01%,5,0,100.00%
ty1-3.nigirocloud.com,5,0.01%,5,0,100.00%
nl3-8.nigirocloud.com,5,0.01%,5,0,100.00%
uk1-2.nigirocloud.com,5,0.01%,5,0,100.00%
asf-ris-prod-easia-azsc.eastasia.cloudapp.azure.com,5,0.01%,5,0,100.00%
l5.gslb.ksyuncdn.com,5,0.01%,10,5,50.00%
array811.prod.do.dsp.mp.microsoft.com,5,0.01%,5,0,100.00%
onedscolprdwus06.westus.cloudapp.azure.com,5,0.01%,5,0,100.00%
a1992.dscd.akamai.net,5,0.01%,10,5,50.00%
onedscolprdcus00.centralus.cloudapp.azure.com,5,0.01%,5,0,100.00%
qt010.china.line.qiniudns.com,5,0.01%,10,5,50.00%
ipv6.china.qiniu.com.trpcdn.net,5,0.01%,10,5,50.00%
ocsp.sca1b.amazontrust.com,5,0.01%,5,0,100.00%
hao.lenovo.com.cn,5,0.01%,5,0,100.00%
nsl.lenovo.com.cn,5,0.01%,5,0,100.00%
yunlivepush.msf.tencent-cloud.com,5,0.01%,5,0,100.00%
wd-prod-ss-as-southeast-4-fe.southeastasia.cloudapp.azure.com,5,0.01%,5,0,100.00%
www.163.com,5,0.01%,12,7,41.67%
hubble.netease.com,5,0.01%,5,0,100.00%
ynote-statistic.lx.netease.com,5,0.01%,5,0,100.00%
upos-sz-mirrorhw.bilivideo.com,5,0.01%,8,3,62.50%
cn6.gmdns.net,5,0.01%,5,0,100.00%
kv501.prod.do.dsp.mp.microsoft.com,5,0.01%,5,0,100.00%
tlu.dl.delivery.mp.microsoft.com,5,0.01%,5,0,100.00%
sslbaiduv6.jomodns.com,5,0.01%,6,1,83.33%
hpd.a.shifen.com,5,0.01%,5,0,100.00%
onedscolprdeus05.eastus.cloudapp.azure.com,5,0.01%,10,5,50.00%
pubgw.api.ddxq.mobi,5,0.01%,10,5,50.00%
torrent.centos.org,5,0.01%,5,0,100.00%
1.debian.pool.ntp.org,5,0.01%,5,0,100.00%
pc-store.lenovomm.cn,5,0.01%,5,0,100.00%
ssl.google-analytics.com,5,0.01%,5,0,100.00%
pushtrs.push.hicloud.com,5,0.01%,5,0,100.00%
cl3-cdn.origin-apple.com.akadns.net,5,0.01%,8,3,62.50%
array612.prod.do.dsp.mp.microsoft.com,5,0.01%,10,5,50.00%
data.bilicdn2.com,5,0.01%,10,5,50.00%
bili-dyn-sched.jcloud-cdn.com,5,0.01%,5,0,100.00%
settings-prod-sea-2.southeastasia.cloudapp.azure.com,5,0.01%,5,0,100.00%
r3.o.lencr.org,5,0.01%,11,6,45.45%
array606.prod.do.dsp.mp.microsoft.com,5,0.01%,5,0,100.00%
software.drivergenius.com,5,0.01%,5,0,100.00%
hk1-8.nigirocloud.com,5,0.01%,5,0,100.00%
hk1-3.nigirocloud.com,5,0.01%,5,0,100.00%
hk1-6.nigirocloud.com,5,0.01%,5,0,100.00%
au2-3.nigirocloud.com,5,0.01%,5,0,100.00%
de1-1.nigirocloud.com,5,0.01%,5,0,100.00%
de2-2.nigirocloud.com,5,0.01%,5,0,100.00%
us2-1.nigirocloud.com,5,0.01%,5,0,100.00%
us2-2.nigirocloud.com,5,0.01%,5,0,100.00%
ty2-1.nigirocloud.com,5,0.01%,5,0,100.00%
ty2-5.nigirocloud.com,5,0.01%,5,0,100.00%
ty2-7.nigirocloud.com,5,0.01%,5,0,100.00%
os2-5.nigirocloud.com,5,0.01%,5,0,100.00%
ieonlinews.microsoft.com,5,0.01%,9,4,55.56%
waconatm.officeapps.live.com,5,0.01%,5,0,100.00%
upload.fp.measure.office.com,5,0.01%,8,3,62.50%
s6110-ml.gslb.ksyuncdn.com,5,0.01%,10,5,50.00%
hcdnv.zjv6.zjtd.c.cdnhwc2.com,5,0.01%,10,5,50.00%
match.deepintent.com,5,0.01%,5,0,100.00%
a1887.dscq.akamai.net,5,0.01%,10,5,50.00%
googleads4.g.doubleclick.net,5,0.01%,5,0,100.00%
package-search.services.jetbrains.com,5,0.01%,9,4,55.56%
time-ios.g.aaplimg.com,5,0.01%,5,0,100.00%
googlecode.l.googleusercontent.com,5,0.01%,10,5,50.00%
onedscolprdeus14.eastus.cloudapp.azure.com,5,0.01%,5,0,100.00%
webrtcice.video.qq.com,5,0.01%,5,0,100.00%
sslbaidu.jomodns.com,5,0.01%,10,5,50.00%
opencdnbdcharon.jomodns.com,5,0.01%,8,3,62.50%
v1-hwllqv.onewsvod.com,5,0.01%,5,0,100.00%
batch-rgeo.is.autonavi.com.gds.alibabadns.com,5,0.01%,5,0,100.00%
gspe35-ssl.ls.apple.com.download.ks-cdn.com,5,0.01%,10,5,50.00%
spatialsearch.is.autonavi.com.gds.alibabadns.com,5,0.01%,5,0,100.00%
opencdnqiniustaticv6.jomodns.com,5,0.01%,10,5,50.00%
checkip.digitalocean.synology.com,5,0.01%,5,0,100.00%
vconf.f.360.cn,5,0.01%,5,0,100.00%
smtp.nfschina.com,5,0.01%,5,0,100.00%
res.ldmnq.com,5,0.01%,5,0,100.00%
th.bing.com,5,0.01%,5,0,100.00%
sb.scorecardresearch.com,5,0.01%,5,0,100.00%
i0.hdslb.com,5,0.01%,11,6,45.45%
assets2.msn.com,5,0.01%,5,0,100.00%
helpdesktop1.ksmobile.com,5,0.01%,5,0,100.00%
firebaselogging-pa.googleapis.com,5,0.01%,6,1,83.33%
fc1tn.baidu.com,5,0.01%,5,0,100.00%
api.crossref.org,5,0.01%,5,0,100.00%
array609.prod.do.dsp.mp.microsoft.com,5,0.01%,5,0,100.00%
usage.projectcalico.org,5,0.01%,5,0,100.00%
filedownload.lenovo.com,5,0.01%,5,0,100.00%
connectivitycheck.platform.hicloud.com,5,0.01%,10,5,50.00%
update.os.nfschina.com,5,0.01%,5,0,100.00%
zconfig.alibabausercontent.com,5,0.01%,13,8,38.46%
stun.services.mozilla.com,5,0.01%,5,0,100.00%
s-0001.s-msedge.net,4,0.01%,8,4,50.00%
login.im.qcloud.com,4,0.01%,4,0,100.00%
s-ring.msedge.net,4,0.01%,4,0,100.00%
data.bilivideo.com,4,0.01%,4,0,100.00%
pull-flv-l3-enc.douyincdn.com.w.alikunlun.net,4,0.01%,4,0,100.00%
api.github.com,4,0.01%,4,0,100.00%
shcuac.aag436.ccddns.lol,4,0.01%,4,0,100.00%
tracker.moeblog.cn,4,0.01%,6,2,66.67%
content-signature-2.cdn.mozilla.net,4,0.01%,12,8,33.33%
tracker1.myporn.club,4,0.01%,6,2,66.67%
onedscolprdwus05.westus.cloudapp.azure.com,4,0.01%,8,4,50.00%
grpc.biliapi.net,4,0.01%,4,0,100.00%
app.bilibili.com,4,0.01%,4,0,100.00%
docs2.gtimg.com,4,0.01%,4,0,100.00%
tj.psvr.wps.cn,4,0.01%,4,0,100.00%
js1.pcfg.cache.wpscdn.cn,4,0.01%,8,4,50.00%
beacons2.gvt2.com,4,0.01%,4,0,100.00%
array806.prod.do.dsp.mp.microsoft.com,4,0.01%,4,0,100.00%
open.qurl.f.360.cn,4,0.01%,4,0,100.00%
server1.9sheng.cn,4,0.01%,4,0,100.00%
henbt.com,4,0.01%,4,0,100.00%
gorgon.youdao.com,4,0.01%,4,0,100.00%
reports.baidu.com,4,0.01%,4,0,100.00%
ms-ceintl.gallerycdn.azure.cn,4,0.01%,4,0,100.00%
yuri-websocket-serve.app.kdsec.org,4,0.01%,4,0,100.00%
moneytizer-d.openx.net,4,0.01%,4,0,100.00%
ads.themoneytizer.com,4,0.01%,12,8,33.33%
anisaishuu.de,4,0.01%,4,0,100.00%
array803.prod.do.dsp.mp.microsoft.com,4,0.01%,4,0,100.00%
mst.vip.com,4,0.01%,4,0,100.00%
vis.vip.com,4,0.01%,4,0,100.00%
glb-db52c2cf8be544.github.com,4,0.01%,4,0,100.00%
telemetry-in.battle.net,4,0.01%,4,0,100.00%
tracker.internetwarriors.net,4,0.01%,4,0,100.00%
cloudservice22.kingsoft-office-service.com,4,0.01%,4,0,100.00%
nzk.woqu365.com,4,0.01%,4,0,100.00%
learnreport.xiaoeknow.com,4,0.01%,4,0,100.00%
bdimg.share.baidu.com,4,0.01%,4,0,100.00%
qdyn.wps.cn,4,0.01%,4,0,100.00%
ts.qq.com,4,0.01%,35,31,11.43%
sp2.baidu.com,4,0.01%,7,3,57.14%
e673.dsce9.akamaiedge.net,4,0.01%,8,4,50.00%
shortv.cdp.qq.com,4,0.01%,4,0,100.00%
news.qhstatic.com,4,0.01%,4,0,100.00%
mcs.snssdk.com,4,0.01%,9,5,44.44%
addons.g-fox.cn,4,0.01%,4,0,100.00%
bookmarks-ssl.firefoxchina.cn,4,0.01%,4,0,100.00%
p0.qhimgs4.com,4,0.01%,4,0,100.00%
lqimg.dftoutiao.com,4,0.01%,4,0,100.00%
eo91y88m.sched.sma.tdnsstic1.cn,4,0.01%,4,0,100.00%
k-static.xsfaya.com.wswebcdn.com,4,0.01%,4,0,100.00%
offlintab.firefoxchina.cn,4,0.01%,4,0,100.00%
browser.events.data.msn.cn,4,0.01%,6,2,66.67%
download.amd.com,4,0.01%,4,0,100.00%
t11.baidu.com,4,0.01%,5,1,80.00%
os1-7.nigirocloud.com,4,0.01%,4,0,100.00%
nl1-4.nigirocloud.com,4,0.01%,4,0,100.00%
nl3-5.nigirocloud.com,4,0.01%,4,0,100.00%
vscode-update.trafficmanager.net,4,0.01%,4,0,100.00%
vscode-update-sea.azurewebsites.net,4,0.01%,4,0,100.00%
waws-prod-sg1-057.sip.azurewebsites.windows.net,4,0.01%,4,0,100.00%
ak.privatelink.msidentity.com,4,0.01%,4,0,100.00%
feilian-staging.bytedance.com.w.cdngslb.com,4,0.01%,4,0,100.00%
api.cdp.microsoft.com,4,0.01%,8,4,50.00%
glb.api.prod.dcat.dsp.trafficmanager.net,4,0.01%,8,4,50.00%
e15203.dscb.akamaiedge.net,4,0.01%,8,4,50.00%
init.itunes.apple.com,4,0.01%,14,10,28.57%
dcldshlupt.alicdn.com.danuoyi.tbcache.com,4,0.01%,4,0,100.00%
configuration.ls.apple.com,4,0.01%,8,4,50.00%
wp.safe.360.cn,4,0.01%,4,0,100.00%
prod.configsvc1.live.com.akadns.net,4,0.01%,4,0,100.00%
pub.idqqimg.com.tc.qq.com,4,0.01%,8,4,50.00%
msg.video.dns.iqiyi.com,4,0.01%,4,0,100.00%
expressapisv2.net,4,0.01%,8,4,50.00%
time.ys7.com,4,0.01%,4,0,100.00%
settings-prod-wus2-2.westus2.cloudapp.azure.com,4,0.01%,4,0,100.00%
settings-prod-wjp-1.japanwest.cloudapp.azure.com,4,0.01%,4,0,100.00%
wss.im.qcloud.com,4,0.01%,4,0,100.00%
update.cs2c.com.cn,4,0.01%,4,0,100.00%
repo.zotero.org,4,0.01%,4,0,100.00%
mirrors.huaweicloud.com,4,0.01%,4,0,100.00%
h-adashx-internal.ut.taobao.com.gds.alibabadns.com,4,0.01%,4,0,100.00%
k5-toutiao-ipv6-ml.gslb.ksyuncdn.com,4,0.01%,8,4,50.00%
live-df-sched.jcloudimg.com,4,0.01%,4,0,100.00%
s03.gslb.ksyuncdn.com,4,0.01%,8,4,50.00%
tim.qq.com,4,0.01%,4,0,100.00%
webquoteklinepic.eastmoney.com,4,0.01%,4,0,100.00%
89.push2his.eastmoney.com,4,0.01%,4,0,100.00%
packages.microsoft.com,4,0.01%,4,0,100.00%
52.push2his.eastmoney.com,4,0.01%,4,0,100.00%
73.push2his.eastmoney.com,4,0.01%,4,0,100.00%
54.push2his.eastmoney.com,4,0.01%,4,0,100.00%
12.push2his.eastmoney.com,4,0.01%,4,0,100.00%
15.push2his.eastmoney.com,4,0.01%,4,0,100.00%
49.push2his.eastmoney.com,4,0.01%,4,0,100.00%
push2.eastmoney.com,4,0.01%,8,4,50.00%
downloads.upd.kaspersky.com,4,0.01%,4,0,100.00%
imap.sina.com,4,0.01%,4,0,100.00%
0.cn.pool.ntp.org,4,0.01%,4,0,100.00%
img0yjvjvvuvw.cdn.cache102.xyz,4,0.01%,4,0,100.00%
mm.ilovescholar.xyz,4,0.01%,4,0,100.00%
apple-finance.query.yahoo.com,4,0.01%,4,0,100.00%
proxy.client.163.com,4,0.01%,4,0,100.00%
weather2db.cmcm.com,4,0.01%,4,0,100.00%
mrodevicemgr.officeapps.live.com,4,0.01%,6,2,66.67%
oneclient.sfx.ms,4,0.01%,11,7,36.36%
onedscolprdneu02.northeurope.cloudapp.azure.com,4,0.01%,4,0,100.00%
cn12.gmdns.net,4,0.01%,4,0,100.00%
apic.douyucdn.cn,4,0.01%,4,0,100.00%
apiv2.douyucdn.cn,4,0.01%,4,0,100.00%
gift.douyucdn.cn,4,0.01%,4,0,100.00%
mapm.douyucdn.cn,4,0.01%,4,0,100.00%
gfs-op.douyucdn.cn,4,0.01%,4,0,100.00%
apm.douyucdn.cn,4,0.01%,4,0,100.00%
rtbapi.douyucdn.cn,4,0.01%,4,0,100.00%
static.zhihu.com,4,0.01%,8,4,50.00%
newvip.duba.net,4,0.01%,4,0,100.00%
zhihu-web-analytics.zhihu.com,4,0.01%,4,0,100.00%
cstaticdun.126.net,4,0.01%,4,0,100.00%
c.dun.163.com,4,0.01%,4,0,100.00%
storage.live.com,4,0.01%,4,0,100.00%
cdn2.ime.sogou.com,4,0.01%,4,0,100.00%
wpsfile.ks3-cn-beijing.ksyun.com,4,0.01%,4,0,100.00%
tracker.istole.it,4,0.01%,4,0,100.00%
api.weibo.cn,4,0.01%,7,3,57.14%
fe3cr.delivery.mp.microsoft.com,4,0.01%,35,31,11.43%
species.missionsec.io,4,0.01%,4,0,100.00%
eopa.n.shifen.com,4,0.01%,8,4,50.00%
pcrec.baidu.com,4,0.01%,8,4,50.00%
opencdn.jomodns.com,4,0.01%,4,0,100.00%
sf3-fe-tos.pglstatp-toutiao.com,4,0.01%,4,0,100.00%
t.khd.2345.cc,4,0.01%,4,0,100.00%
v3-be-pack.pglstatp-toutiao.com,4,0.01%,4,0,100.00%
pc.lenovomm.cn,4,0.01%,4,0,100.00%
cdn.onenote.net,4,0.01%,8,4,50.00%
openapp.wpscdn.cn,4,0.01%,9,5,44.44%
wework.qpic.cn,4,0.01%,4,0,100.00%
aladin.wxqcloud.qq.com,4,0.01%,4,0,100.00%
runc.myddns.cyou,4,0.01%,4,0,100.00%
trakx.herokuapp.com,4,0.01%,4,0,100.00%
bjbgp01.baidupcs.com,4,0.01%,4,0,100.00%
fb98ab9159f51fd0.jijifun.com,4,0.01%,4,0,100.00%
upos-sz-mirrorcos.bilivideo.com,4,0.01%,9,5,44.44%
interface.bilibili.com,4,0.01%,4,0,100.00%
upos-sz-mirrorhwo1.bilivideo.com,4,0.01%,8,4,50.00%
plugins.jetbrains.com,4,0.01%,4,0,100.00%
onedriveclucprodbn20011.blob.core.windows.net,4,0.01%,4,0,100.00%
developer.atlassian.com,4,0.01%,4,0,100.00%
bdstatics.eastmoney.com,4,0.01%,4,0,100.00%
bdstatic.eastmoney.com,4,0.01%,4,0,100.00%
bdwblog.eastmoney.com,4,0.01%,4,0,100.00%
list.lvb.eastmoney.com,4,0.01%,4,0,100.00%
6.push2his.eastmoney.com,4,0.01%,4,0,100.00%
82.push2his.eastmoney.com,4,0.01%,4,0,100.00%
appdl.lenovo.com.cn,4,0.01%,4,0,100.00%
cdp.cloud.unity3d.com,4,0.01%,4,0,100.00%
dtapp-pub.dingtalk.com,4,0.01%,4,0,100.00%
glacial-ravine-7295.morning-tundra-7160.herokuspace.com,4,0.01%,4,0,100.00%
usa4.666670.xyz,4,0.01%,4,0,100.00%
slardar-bd.feishu.cn.w.cdngslb.com,4,0.01%,4,0,100.00%
p208-caldav.icloud.com.cn,4,0.01%,4,0,100.00%
p208-contacts.icloud.com.cn,4,0.01%,4,0,100.00%
caldav.fe.apple-dns.cn,4,0.01%,4,0,100.00%
caldav.126.com,4,0.01%,4,0,100.00%
36-courier.push.apple.com,4,0.01%,4,0,100.00%
36.courier-push-apple.com.akadns.net,4,0.01%,4,0,100.00%
report.im.qcloud.com,4,0.01%,4,0,100.00%
skydrivesync.policies.live.net,4,0.01%,4,0,100.00%
gce-beacons.gcp.gvt2.com,4,0.01%,4,0,100.00%
prod.odcsm1.live.com.akadns.net,4,0.01%,4,0,100.00%
c.apple.news,4,0.01%,8,4,50.00%
dcbrowser.cqttech.com,4,0.01%,4,0,100.00%
e11271.dscg.akamaiedge.net,4,0.01%,8,4,50.00%
xycrx.net,4,0.01%,4,0,100.00%
emimpcpf.trafficmanager.cn,4,0.01%,4,0,100.00%
p218-caldav.icloud.com.cn,4,0.01%,4,0,100.00%
array605.prod.do.dsp.mp.microsoft.com,4,0.01%,4,0,100.00%
hk1-1.nigirocloud.com,4,0.01%,4,0,100.00%
hk1-5.nigirocloud.com,4,0.01%,4,0,100.00%
au1-3.nigirocloud.com,4,0.01%,4,0,100.00%
au2-1.nigirocloud.com,4,0.01%,4,0,100.00%
de1-2.nigirocloud.com,4,0.01%,4,0,100.00%
us3-5.nigirocloud.com,4,0.01%,4,0,100.00%
de2-4.nigirocloud.com,4,0.01%,4,0,100.00%
cu010.www.duba.net,4,0.01%,4,0,100.00%
s6130-ml.gslb.ksyuncdn.com,4,0.01%,8,4,50.00%
hcdnl.pulldyin.rtm.gslb.c.cdnhwc2.com,4,0.01%,4,0,100.00%
hcdnl.pulldyin.gslb.c.cdnhwc2.com,4,0.01%,8,4,50.00%
pull-flv-l27.douyincdn.com,4,0.01%,4,0,100.00%
push-rtmp-l13.douyincdn.com,4,0.01%,4,0,100.00%
push-rtmp-l3-enc.douyincdn.com,4,0.01%,4,0,100.00%
19.courier-push-apple.com.akadns.net,4,0.01%,4,0,100.00%
s0-2mdn-net.l.google.com,4,0.01%,5,1,80.00%
onedscolprdeus00.eastus.cloudapp.azure.com,4,0.01%,4,0,100.00%
e7479.g.akamaiedge.net,4,0.01%,4,0,100.00%
messaging.ccs.mcafee.com,4,0.01%,4,0,100.00%
array503.prod.do.dsp.mp.microsoft.com,4,0.01%,8,4,50.00%
na61-na62.wagbridge.alibaba.aliyun.com,4,0.01%,4,0,100.00%
onedscolprdwus09.westus.cloudapp.azure.com,4,0.01%,4,0,100.00%
zqnweb.v.trpcdn.net,4,0.01%,4,0,100.00%
steamstore-a.akamaihd.net,4,0.01%,4,0,100.00%
aus5.mozilla.org,4,0.01%,4,0,100.00%
prod.balrog.prod.cloudops.mozgcp.net,4,0.01%,4,0,100.00%
tags.tiqcdn.com,4,0.01%,4,0,100.00%
profile.pinyin.sogou.com,4,0.01%,4,0,100.00%
yuri.app.kdsec.org,4,0.01%,4,0,100.00%
report.idqqimg.com,4,0.01%,4,0,100.00%
r4.res.office365.com,4,0.01%,12,8,33.33%
storage.googleapis.com,4,0.01%,4,0,100.00%
v.xiaohongshu.com,4,0.01%,5,1,80.00%
sns-video-bd.xhscdn.com,4,0.01%,8,4,50.00%
ftp.ext.hp.com,4,0.01%,4,0,100.00%
array604.prod.do.dsp.mp.microsoft.com,4,0.01%,4,0,100.00%
opencdnglobalv6.jomodns.com,4,0.01%,6,2,66.67%
opencdnbdsimage.jomodns.com,4,0.01%,4,0,100.00%
zhanzhang.toutiao.com.w.cdngslb.com,4,0.01%,4,0,100.00%
pwo4tgrz.slt.sched.tdnsv8.com,4,0.01%,4,0,100.00%
pki-goog.l.google.com,4,0.01%,4,0,100.00%
inference.location.live.net,4,0.01%,4,0,100.00%
csdnimg.cn,4,0.01%,4,0,100.00%
g.csdnimg.cn,4,0.01%,4,0,100.00%
yl.zh.cmbchina.com,4,0.01%,4,0,100.00%
log.cmbchina.com,4,0.01%,4,0,100.00%
fantuantanshu.datasink.sensorsdata.cn,4,0.01%,4,0,100.00%
jkcloud.net,4,0.01%,8,4,50.00%
support.mozilla.org,4,0.01%,4,0,100.00%
50.push2his.eastmoney.com,4,0.01%,4,0,100.00%
hk4e-api.mihoyo.com,4,0.01%,4,0,100.00%
16.push2his.eastmoney.com,4,0.01%,4,0,100.00%
2.push2his.eastmoney.com,4,0.01%,4,0,100.00%
77.push2his.eastmoney.com,4,0.01%,4,0,100.00%
l7-online-self-max.s.dsa.cdnbuild.net,4,0.01%,4,0,100.00%
disc801.prod.do.dsp.mp.microsoft.com,4,0.01%,4,0,100.00%
diana.ie.sogou.com,4,0.01%,4,0,100.00%
tile-service.weather.msn.cn,4,0.01%,4,0,100.00%
i3.c.eset.com,4,0.01%,4,0,100.00%
onedscolprdwus12.westus.cloudapp.azure.com,4,0.01%,8,4,50.00%
ts2.cn.mm.bing.chinacache.net,4,0.01%,4,0,100.00%
down.anticheatexpert.com.akamaized.net,4,0.01%,4,0,100.00%
a1904.v.akamai.net,4,0.01%,4,0,100.00%
pgpstatic.games.wanmei.com,4,0.01%,8,4,50.00%
pgpstatic.games.wanmei.com.cdn.dnsv1.com,4,0.01%,8,4,50.00%
2v21nxa7.sched.sma-dk.tdnsstic1.cn,4,0.01%,8,4,50.00%
sns.synology.com,4,0.01%,4,0,100.00%
myou.cvte.com,4,0.01%,4,0,100.00%
settings-prod-wus3-1.westus3.cloudapp.azure.com,4,0.01%,4,0,100.00%
msn-cn.a-0032.a-msedge.net,4,0.01%,4,0,100.00%
ts1.cn.mm.bing.chinacache.net,4,0.01%,4,0,100.00%
ts2.cn.mm.bing.net.lxcvc.com,4,0.01%,4,0,100.00%
ts1.cn.mm.bing.net.lxcvc.com,4,0.01%,4,0,100.00%
zmptxy.v.trpcdn.net,4,0.01%,4,0,100.00%
gspe35-ssl.ls.apple.com.w.alikunlun.com,4,0.01%,4,0,100.00%
repper-lb-tokyo.gtinative.cloudplatform.mcafee.com,4,0.01%,4,0,100.00%
wss.tim.qq.com,4,0.01%,4,0,100.00%
p2.shared.global.fastly.net,4,0.01%,4,0,100.00%
cseupdate.360safe.com,4,0.01%,4,0,100.00%
mail.nfschina.com,4,0.01%,4,0,100.00%
d.pcs.baidu.com,4,0.01%,11,7,36.36%
onedscolprdneu06.northeurope.cloudapp.azure.com,4,0.01%,4,0,100.00%
push-rtmp-f5-vs.douyincdn.com.c.bytefcdn.com,4,0.01%,4,0,100.00%
wmgp-update.wmupd.com,4,0.01%,4,0,100.00%
inappcheck-lb.itunes-apple.com.akadns.net,4,0.01%,6,2,66.67%
launches.appsflyer.com,4,0.01%,4,0,100.00%
pull-flv-l3-encryption.douyincdn.com,4,0.01%,4,0,100.00%
pull-hls-f11.douyincdn.com,4,0.01%,4,0,100.00%
pull-f5-hs.pstatp.com.c.bytefcdn.com,4,0.01%,4,0,100.00%
pull-hs-f5.flive.huoshanlive.com,4,0.01%,4,0,100.00%
pull-hls-vr-l26.douyincdn.com.c.cdnhwc3.com,4,0.01%,4,0,100.00%
pull-f5-io.flive.douyincdn.com,4,0.01%,4,0,100.00%
push-rtmp-spe-l11.douyincdn.com,4,0.01%,4,0,100.00%
push-rtmp-spe-l11.douyincdn.com.tlivepush.com,4,0.01%,4,0,100.00%
pull-rtmp-l11.douyincdn.com,4,0.01%,4,0,100.00%
pull-flv-f11-proxy.douyincdn.com,4,0.01%,4,0,100.00%
pull-flv-f11-proxy.douyincdn.com.tcdnlive.com,4,0.01%,4,0,100.00%
pull-hls-hs-f5-tsl.douyincdn.com,4,0.01%,4,0,100.00%
pull-hls-hs-f5-tsl.douyincdn.com.bytedns1.com,4,0.01%,4,0,100.00%
push-rtmp-f5-vs.douyincdn.com,4,0.01%,4,0,100.00%
pull-rtmp-l13.douyincdn.com,4,0.01%,4,0,100.00%
pull-hls-spe-l26.douyincdn.com.c.cdnhwc3.com,4,0.01%,4,0,100.00%
push-rtmp-l26.douyincdn.com.c.cdnhwc3.com,4,0.01%,4,0,100.00%
push-rtmp-l6-hs.pstatp.com,4,0.01%,4,0,100.00%
pull-l3-hs.pstatp.com,4,0.01%,4,0,100.00%
push-rtmp-l26-cny.douyincdn.com,4,0.01%,4,0,100.00%
push-rtmp-l6-cny.douyincdn.com.upvcloud.ks-cdn.com,4,0.01%,4,0,100.00%
push-rtmp-vr-l11.douyincdn.com,4,0.01%,4,0,100.00%
push-rtmp-f5-io.flive.douyincdn.com,4,0.01%,4,0,100.00%
push-rtmp-f5-io.flive.douyincdn.com.c.bytefcdn.com,4,0.01%,4,0,100.00%
pull-flv-l1-cny.douyincdn.com,4,0.01%,4,0,100.00%
push-rtmp-l11.douyincdn.com,4,0.01%,4,0,100.00%
pull-f5.flive.douyincdn.com,4,0.01%,4,0,100.00%
pull-f5.flive.douyincdn.com.c.bytefcdn.com,4,0.01%,4,0,100.00%
push-rtmp-f5-hs.pstatp.com.c.bytefcdn.com,4,0.01%,4,0,100.00%
push-rtmp-l1.ixigua.com,4,0.01%,4,0,100.00%
pull-flv-f11.douyincdn.com,4,0.01%,4,0,100.00%
pull-flv-f11.douyincdn.com.live.qcloudcdn.com,4,0.01%,4,0,100.00%
pull-flv-spe-l11.douyincdn.com,4,0.01%,4,0,100.00%
push-rtmp-vr-l26.douyincdn.com,4,0.01%,4,0,100.00%
pull-hls-f29.douyincdn.com,4,0.01%,4,0,100.00%
push-rtmp-vr-l26.douyincdn.com.c.cdnhwc3.com,4,0.01%,4,0,100.00%
push-rtmp-f5-cny.douyincdn.com,4,0.01%,4,0,100.00%
pull-tsl-spe-l3.douyincdn.com,4,0.01%,4,0,100.00%
pull-rtmp-f11.douyincdn.com,4,0.01%,4,0,100.00%
pull-tsl-spe-l3.douyincdn.com.bytedns1.com,4,0.01%,4,0,100.00%
pull-lls-f5.flive.douyincdn.com,4,0.01%,4,0,100.00%
push-rtmp-l3.douyincdn.com,4,0.01%,4,0,100.00%
push-rtmp-spe-l26.douyincdn.com,4,0.01%,4,0,100.00%
push-rtmp-spe-l26.douyincdn.com.c.cdnhwc3.com,4,0.01%,4,0,100.00%
push-rtmp-f5.douyincdn.com.c.bytefcdn.com,4,0.01%,4,0,100.00%
pull-tsl-hs-spe-f5.douyincdn.com.volcgslb.com,4,0.01%,4,0,100.00%
pull-flv-l1.ixigua.com,4,0.01%,4,0,100.00%
push-rtmp-spe-l1.douyincdn.com,4,0.01%,4,0,100.00%
push-rtmp-l29.douyincdn.com.ucloud.com.cn,4,0.01%,4,0,100.00%
push-rtmp-l11-encryption.douyincdn.com,4,0.01%,4,0,100.00%
push-rtmp-l11-encryption.douyincdn.com.tlivepush.com,4,0.01%,4,0,100.00%
pull-rtmp-f26.douyincdn.com.c.cdnhwc3.com,4,0.01%,4,0,100.00%
pull-hls-f96.douyincdn.com,4,0.01%,4,0,100.00%
pull-lls-spe-l26.douyincdn.com,4,0.01%,4,0,100.00%
pull-l3-source.douyincdn.com,4,0.01%,4,0,100.00%
pull-rtmp-f29.douyincdn.com,4,0.01%,4,0,100.00%
push-rtmp-vr-l3.douyincdn.com,4,0.01%,4,0,100.00%
pull-rtmp-l1-cny.douyincdn.com,4,0.01%,4,0,100.00%
62.push2his.eastmoney.com,4,0.01%,4,0,100.00%
13.push2his.eastmoney.com,4,0.01%,4,0,100.00%
9.push2his.eastmoney.com,4,0.01%,4,0,100.00%
61.push2his.eastmoney.com,4,0.01%,4,0,100.00%
25.push2his.eastmoney.com,4,0.01%,4,0,100.00%
cf.iadsdk.apple.com,4,0.01%,4,0,100.00%
cn15.gmdns.net,4,0.01%,4,0,100.00%
cn1.gmdns.net,4,0.01%,4,0,100.00%
als.baidu.com,4,0.01%,4,0,100.00%
APAC01.azure-devices.net,4,0.01%,4,0,100.00%
APAC03.azure-devices.net,4,0.01%,4,0,100.00%
clientnotification-userprodea1-11.servicebus.windows.net,4,0.01%,4,0,100.00%
r2---sn-2x3elnez.gvt1.com,4,0.01%,4,0,100.00%
static.hdslb.com,4,0.01%,4,0,100.00%
ntp.msn.cn,4,0.01%,5,1,80.00%
shuc-pc-snow.ksord.com,4,0.01%,4,0,100.00%
srtb.msn.com,4,0.01%,5,1,80.00%
wpvip.duba.net,4,0.01%,4,0,100.00%
clientnotification-userprodea1-2.servicebus.windows.net,4,0.01%,4,0,100.00%
shift.is.autonavi.com,4,0.01%,4,0,100.00%
pay.bilibili.com,4,0.01%,4,0,100.00%
fd.api.iris.microsoft.com,4,0.01%,4,0,100.00%
dss2.bdstatic.com,4,0.01%,4,0,100.00%
ms.bdimg.com,4,0.01%,4,0,100.00%
services.zotero.org,4,0.01%,4,0,100.00%
array614.prod.do.dsp.mp.microsoft.com,4,0.01%,4,0,100.00%
fc-ccimage.baidu.com,4,0.01%,4,0,100.00%
69-46-75-53.nhost.00cdn.com,4,0.01%,4,0,100.00%
d2us8jqsezvhge.cloudfront.net,4,0.01%,4,0,100.00%
path2.xtracloud.net,4,0.01%,4,0,100.00%
path3.xtracloud.net,4,0.01%,4,0,100.00%
hwvv.yilanvaas.com,4,0.01%,8,4,50.00%
play2.cp21.ott.cibntv.net,4,0.01%,4,0,100.00%
sqimg.qq.com,4,0.01%,4,0,100.00%
sqimg.qq.com.cloud.tcdn.qq.com,4,0.01%,4,0,100.00%
sqimg.qq.com.sched.legopic2.tdnsv6.com,4,0.01%,4,0,100.00%
visualstudio.download.prss.trafficmanager.net,4,0.01%,4,0,100.00%
gsp64-ssl.ls-apple.com.akadns.net,4,0.01%,4,0,100.00%
www.apple.com.edgekey.net,4,0.01%,4,0,100.00%
1.courier-sandbox-push-apple.com.akadns.net,4,0.01%,4,0,100.00%
www.apple.com.edgekey.net.globalredir.akadns.net,4,0.01%,4,0,100.00%
p212-contacts.icloud.com.cn,4,0.01%,4,0,100.00%
settings-prod-eus2-1.eastus2.cloudapp.azure.com,4,0.01%,4,0,100.00%
6qnz2sy8.sched.d2.tdnsdp1.cn,4,0.01%,4,0,100.00%
28.courier-push-apple.com.akadns.net,4,0.01%,4,0,100.00%
feed.wan.360.cn,4,0.01%,4,0,100.00%
cmrelay-basic-2.nodesub.com,4,0.01%,4,0,100.00%
in.appcenter.ms,4,0.01%,4,0,100.00%
activity-geo.trafficmanager.net,4,0.01%,4,0,100.00%
e12437.d.akamaiedge.net,4,0.01%,4,0,100.00%
v5-j.douyinvod.com,4,0.01%,4,0,100.00%
v5-j.douyinvod.com.zjgslb.com,4,0.01%,4,0,100.00%
ecn.dev.ditu.live.com,4,0.01%,4,0,100.00%
11.push2his.eastmoney.com,4,0.01%,4,0,100.00%
97.push2his.eastmoney.com,4,0.01%,4,0,100.00%
70.push2his.eastmoney.com,4,0.01%,4,0,100.00%
storecatalogrevocation.storequality.microsoft.com,4,0.01%,4,0,100.00%
gimg4.baidu.com,4,0.01%,4,0,100.00%
dmpstatic.cdn.bcebos.com,4,0.01%,4,0,100.00%
open.e.kuaishou.com,4,0.01%,4,0,100.00%
time.asia.apple.com,4,0.01%,4,0,100.00%
ovv.alllook.tv,4,0.01%,4,0,100.00%
message.bilibili.com,4,0.01%,5,1,80.00%
dcs.foxitreader.cn,4,0.01%,4,0,100.00%
gecko-pangle-lf.snssdk.com,4,0.01%,4,0,100.00%
iplc-ji.cmy-dns.com,4,0.01%,4,0,100.00%
41.push2his.eastmoney.com,4,0.01%,4,0,100.00%
addons-pa.clients6.google.com,4,0.01%,8,4,50.00%
pc-plugin.wpscdn.cn,4,0.01%,4,0,100.00%
cdn.mysql.com,4,0.01%,4,0,100.00%
wu-bg-shim.trafficmanager.NET,4,0.01%,4,0,100.00%
windows.msn.cn,4,0.01%,6,2,66.67%
38.push2his.eastmoney.com,4,0.01%,4,0,100.00%
d11.baidupcs.com,4,0.01%,4,0,100.00%
xpgw-xcdn.youku.com,4,0.01%,4,0,100.00%
m.ykimg.com,4,0.01%,7,3,57.14%
nplserver.kuwo.cn,4,0.01%,4,0,100.00%
cdnpcwallpaper.zhhainiao.com,4,0.01%,4,0,100.00%
moiawsorigin.clo.footprintdns.com,4,0.01%,4,0,100.00%
www.douban.com,4,0.01%,4,0,100.00%
vinci.ie.sogou.com,4,0.01%,4,0,100.00%
client05.pdl.wow.battlenet.com.cn,4,0.01%,4,0,100.00%
telemetry-in.battlenet.com.cn,4,0.01%,4,0,100.00%
notify.tabnine.com,4,0.01%,4,0,100.00%
mirrors163.ntes53.netease.com,4,0.01%,4,0,100.00%
edge-skype-com.s-0001.s-msedge.net,3,0.01%,6,3,50.00%
ins-8y4ghcjp.ias.tencent-cloud.net,3,0.01%,3,0,100.00%
wd-prod-ss-as-southeast-1-fe.southeastasia.cloudapp.azure.com,3,0.01%,3,0,100.00%
onedscolprdcus12.centralus.cloudapp.azure.com,3,0.01%,6,3,50.00%
pull-flv-f1-proxy.douyincdn.com.wsdvs.com,3,0.01%,6,3,50.00%
xp.apple.com,3,0.01%,5,2,60.00%
onedscolprdfrc04.francecentral.cloudapp.azure.com,3,0.01%,3,0,100.00%
dsum-sec.casalemedia.com.cdn.cloudflare.net,3,0.01%,3,0,100.00%
pull-rtmp-l6-hs.pstatp.com,3,0.01%,6,3,50.00%
toutiao.rtmplive.ks-cdn.com,3,0.01%,6,3,50.00%
s107.gslb.ksyuncdn.com,3,0.01%,6,3,50.00%
pull-hls-f26.douyincdn.com,3,0.01%,6,3,50.00%
pull-hls-f26.douyincdn.com.c.cdnhwc1.com,3,0.01%,6,3,50.00%
zjcdnl.pullcmcc.gslb.d.live.cdn.chinamobile.com,3,0.01%,3,0,100.00%
pull-flv-l6-encryption.douyincdn.com.hdlvcloud.ks-cdn.com,3,0.01%,6,3,50.00%
pull-flv-vr-l1.douyincdn.com.wsdvs.com,3,0.01%,6,3,50.00%
push-rtmp-vr-f5.s.bytefcdn.com,3,0.01%,3,0,100.00%
x8.x9.client.api.vpngate2.jp,3,0.01%,4,1,75.00%
sf.symcb.com,3,0.01%,4,1,75.00%
dl.360safe.com,3,0.01%,14,11,21.43%
bl6pap003.storage.live.com,3,0.01%,6,3,50.00%
safebrowsing.google.com,3,0.01%,3,0,100.00%
dsm01pap006.storage.live.com,3,0.01%,6,3,50.00%
ns-sb2-prod-sn3-010.cloudapp.net,3,0.01%,3,0,100.00%
is.iscas.ac.cn,3,0.01%,3,0,100.00%
pgyapi.oray.net,3,0.01%,3,0,100.00%
octopus.jovcloud.com,3,0.01%,3,0,100.00%
zhidao.baidu.com,3,0.01%,4,1,75.00%
cpro.baidustatic.com,3,0.01%,4,1,75.00%
kstj.baidu.com,3,0.01%,3,0,100.00%
ali2.a.yximgs.com,3,0.01%,3,0,100.00%
eclick.baidu.com,3,0.01%,3,0,100.00%
geo-eu-us-sticky.delivery-prod-sas.akadns.net,3,0.01%,4,1,75.00%
fr01.xiaocloud.info,3,0.01%,3,0,100.00%
www.gstatic.com,3,0.01%,4,1,75.00%
9.rarbg.com,3,0.01%,3,0,100.00%
shadowshq.yi.org,3,0.01%,3,0,100.00%
tracker.leechers-paradise.org,3,0.01%,3,0,100.00%
dl.pinyin.sogou.com,3,0.01%,3,0,100.00%
restapi.amap.com,3,0.01%,3,0,100.00%
wlog.ksapisrv.com,3,0.01%,3,0,100.00%
newtab.browser.qq.com,3,0.01%,3,0,100.00%
fe2.update.microsoft.com,3,0.01%,6,3,50.00%
c-pay.lingkou.com,3,0.01%,3,0,100.00%
tracker3.torrentino.com,3,0.01%,3,0,100.00%
midinfo.baofeng.com,3,0.01%,3,0,100.00%
www.vip.com,3,0.01%,3,0,100.00%
mapi.vip.com,3,0.01%,3,0,100.00%
a.safe.360.cn,3,0.01%,3,0,100.00%
maxineapi.razersynapse.com,3,0.01%,3,0,100.00%
drive.kdocs.cn,3,0.01%,6,3,50.00%
nyaa.tracker.wf,3,0.01%,3,0,100.00%
captcha.gtimg.com,3,0.01%,4,1,75.00%
tracker.open-internet.nl,3,0.01%,3,0,100.00%
puui.qpic.cn,3,0.01%,4,1,75.00%
learning.u.wpscdn.cn,3,0.01%,6,3,50.00%
v9-hwllqv.onewsvod.com,3,0.01%,3,0,100.00%
mbd.baidu.com,3,0.01%,3,0,100.00%
passport.baidu.com,3,0.01%,7,4,42.86%
img-prod-cms-rt-microsoft-com.akamaized.net,3,0.01%,7,4,42.86%
appct.jianguoyun.com,3,0.01%,3,0,100.00%
tracking.firefox.com.cn,3,0.01%,5,2,60.00%
adu.g-fox.cn,3,0.01%,3,0,100.00%
yxdt.game.keniub.com,3,0.01%,4,1,75.00%
t12.baidu.com,3,0.01%,4,1,75.00%
contacts.fe.apple-dns.cn,3,0.01%,3,0,100.00%
crteam.cn,3,0.01%,3,0,100.00%
p0.qhimg.com.webcdn.360qhcdn.com,3,0.01%,6,3,50.00%
www3.l.google.com,3,0.01%,6,3,50.00%
telemetry.dropbox.com,3,0.01%,6,3,50.00%
honeycomb.wpscdn.cn.download.ks-cdn.com,3,0.01%,6,3,50.00%
array801.prod.do.dsp.mp.microsoft.com,3,0.01%,3,0,100.00%
asia.odcsm1.live.com.akadns.net,3,0.01%,3,0,100.00%
oneocsp.microsoft.com,3,0.01%,4,1,75.00%
evoke-windowsservices-tas.msedge.net,3,0.01%,3,0,100.00%
yd-02.paofunlink.com,3,0.01%,3,0,100.00%
tsbrowser.xiangtatech.com,3,0.01%,3,0,100.00%
dns.rubyfish.cn,3,0.01%,3,0,100.00%
array513.prod.do.dsp.mp.microsoft.com,3,0.01%,5,2,60.00%
smarthome-drcn.dbankcdn.com,3,0.01%,3,0,100.00%
res.u-tools.cn,3,0.01%,3,0,100.00%
pull-fcdn-douyin-base.s.bytefcdn.com,3,0.01%,3,0,100.00%
pull-hls-spe-l6.douyincdn.com.hlsvcloud.ks-cdn.com,3,0.01%,6,3,50.00%
push-rtmp-l6.douyincdn.com.upvcloud.ks-cdn.com,3,0.01%,6,3,50.00%
u104-ml.gslb.ksyuncdn.com,3,0.01%,6,3,50.00%
pull-flv-spe-l6.douyincdn.com,3,0.01%,6,3,50.00%
pull-flv-spe-l6.douyincdn.com.hdlvcloud.ks-cdn.com,3,0.01%,6,3,50.00%
pull-rtmp-l6.douyincdn.com,3,0.01%,6,3,50.00%
profile.accounts.firefox.com,3,0.01%,3,0,100.00%
datacluster3.cipsup.cn,3,0.01%,3,0,100.00%
mail.bjtu.edu.cn,3,0.01%,3,0,100.00%
service.fanxing.kugou.com,3,0.01%,6,3,50.00%
2.pool.ntp.org,3,0.01%,5,2,60.00%
mqtt-web.zhihu.com,3,0.01%,3,0,100.00%
onedscolprdwus03.westus.cloudapp.azure.com,3,0.01%,3,0,100.00%
update.qnap.com,3,0.01%,3,0,100.00%
filehouse.zhhainiao.com,3,0.01%,3,0,100.00%
jp3.gmdns.net,3,0.01%,3,0,100.00%
tw2.gmdns.net,3,0.01%,3,0,100.00%
in1.gmdns.net,3,0.01%,3,0,100.00%
gb.gmdns.net,3,0.01%,3,0,100.00%
ss.wlmnzf.xyz,3,0.01%,5,2,60.00%
rpic.douyucdn.cn,3,0.01%,3,0,100.00%
yuba.douyu.com,3,0.01%,3,0,100.00%
pica.zhimg.com,3,0.01%,6,3,50.00%
sugar.zhihu.com,3,0.01%,6,3,50.00%
ww1097.smartadserver.com,3,0.01%,6,3,50.00%
trackers.ibzu.me,3,0.01%,6,3,50.00%
siambit.org,3,0.01%,6,3,50.00%
tracker.publichd.eu,3,0.01%,3,0,100.00%
api.vip.iqiyi.com,3,0.01%,3,0,100.00%
t13.baidu.com.a.bdydns.com,3,0.01%,4,1,75.00%
t14.baidu.com.a.bdydns.com,3,0.01%,4,1,75.00%
t8.baidu.com.a.bdydns.com,3,0.01%,4,1,75.00%
t7.baidu.com.a.bdydns.com,3,0.01%,4,1,75.00%
anti-bot.n.shifen.com,3,0.01%,3,0,100.00%
pu-kos.ks3-cn-beijing.ksyun.com,3,0.01%,3,0,100.00%
conf.wsm.360.cn,3,0.01%,5,2,60.00%
adashx.ut.amap.com,3,0.01%,3,0,100.00%
sv.symcd.com,3,0.01%,6,3,50.00%
bt1.archive.org,3,0.01%,6,3,50.00%
www.xilinx.com,3,0.01%,3,0,100.00%
discovery-v4-3.verysync.cn,3,0.01%,3,0,100.00%
emres.dfcfw.com,3,0.01%,6,3,50.00%
fe2cr.update.microsoft.com,3,0.01%,6,3,50.00%
stocks-sparkline-lb.apple.com.akadns.net,3,0.01%,6,3,50.00%
2.android.pool.ntp.org,3,0.01%,6,3,50.00%
XSP-efz.ms-acdc.office.com,3,0.01%,6,3,50.00%
query.hicloud.com,3,0.01%,3,0,100.00%
cdn.icloud-content.com,3,0.01%,6,3,50.00%
cdn.cvws.apple-dns.net,3,0.01%,7,4,42.86%
c.apple.news.edgekey.net,3,0.01%,6,3,50.00%
e12919.dscd.akamaiedge.net,3,0.01%,6,3,50.00%
htydhd.wmupd.com.w.kunluncan.com,3,0.01%,3,0,100.00%
onedscolprdcus04.centralus.cloudapp.azure.com,3,0.01%,3,0,100.00%
array807.prod.do.dsp.mp.microsoft.com,3,0.01%,3,0,100.00%
settings-prod-scus-1.southcentralus.cloudapp.azure.com,3,0.01%,3,0,100.00%
ntes53.mail.yeah.net,3,0.01%,3,0,100.00%
bgp.netarch-bjlgy-edge-lb-v3.bjlgy.bytedns.net,3,0.01%,3,0,100.00%
dl-debug.dropbox.com,3,0.01%,6,3,50.00%
onedscolprdcus14.centralus.cloudapp.azure.com,3,0.01%,6,3,50.00%
www.tnas.online,3,0.01%,3,0,100.00%
cdn.content.prod.cms.msn.com,3,0.01%,8,5,37.50%
doc.wps.cn,3,0.01%,3,0,100.00%
dls2.bigdata.samsung.com.cn,3,0.01%,3,0,100.00%
onedscolprdwus11.westus.cloudapp.azure.com,3,0.01%,4,1,75.00%
rs-cn.rustdesk.com,3,0.01%,3,0,100.00%
pull-rtmp-l6.douyincdn.com.rtmpvcloud.ks-cdn.com,3,0.01%,6,3,50.00%
pull-flv-f6-hs.pstatp.com.hdlvcloud.ks-cdn.com,3,0.01%,6,3,50.00%
pull-tsl-vr-l26.douyincdn.com,3,0.01%,6,3,50.00%
pull-tsl-vr-l26.douyincdn.com.51296c5e.c.cdnhwc1.com,3,0.01%,6,3,50.00%
pull-rtmp-f6-hs.pstatp.com.rtmpvcloud.ks-cdn.com,3,0.01%,6,3,50.00%
s03-ml.gslb.ksyuncdn.com,3,0.01%,6,3,50.00%
source-fcdn-spe-push.s.bytefcdn.com,3,0.01%,3,0,100.00%
bcedyrtmp.jomodns.com,3,0.01%,3,0,100.00%
pull-flv-f26-proxy.douyincdn.com.c.cdnhwc3.com,3,0.01%,6,3,50.00%
pull-tsl-vr-l6.douyincdn.com.hlsvcloud.ks-cdn.com,3,0.01%,6,3,50.00%
pull-tsl-l3.douyincdn.com.w.alikunlun.net,3,0.01%,3,0,100.00%
push-rtmp-l3-encryption.douyincdn.com.w.kunlunso.com,3,0.01%,3,0,100.00%
pull-flv-vr-l6.douyincdn.com.hdlvcloud.ks-cdn.com,3,0.01%,6,3,50.00%
pull-flv-l6-enc.douyincdn.com.hdlvcloud.ks-cdn.com,3,0.01%,6,3,50.00%
push-rtmp-l3-cny.douyincdn.com.w.kunlunso.com,3,0.01%,3,0,100.00%
pull-flv-l6-source.douyincdn.com,3,0.01%,6,3,50.00%
pull-rtmp-l6-source.douyincdn.com.rtmpvcloud.ks-cdn.com,3,0.01%,6,3,50.00%
pull-rtmp-l6-cny.douyincdn.com,3,0.01%,6,3,50.00%
pull-rtmp-l6-cny.douyincdn.com.rtmpvcloud.ks-cdn.com,3,0.01%,6,3,50.00%
tlivepush3soct1douyin.tcdn.qq.com,3,0.01%,3,0,100.00%
pull-tsl-vr-l11.douyincdn.com.cdn.dnsv1.com,3,0.01%,6,3,50.00%
48l6nsax.sched.v1lego-dk.tdnsvod1.cn,3,0.01%,6,3,50.00%
pull-flv-f1.douyincdn.com.gccdn.net,3,0.01%,6,3,50.00%
pull-rtmp-f6.douyincdn.com.rtmpvcloud.ks-cdn.com,3,0.01%,6,3,50.00%
push-rtmp-l95.douyincdn.com,3,0.01%,6,3,50.00%
push-rtmp-l95.douyincdn.com.ctdns.cn,3,0.01%,6,3,50.00%
pull-flv-l1-source.douyincdn.com.wsdvs.com,3,0.01%,6,3,50.00%
pull-flv-l95.douyincdn.com.ctdns.cn,3,0.01%,6,3,50.00%
bcedyhls.jomodns.com,3,0.01%,3,0,100.00%
pull-lls-spe-l1.douyincdn.com.wsdvs.com,3,0.01%,3,0,100.00%
bceliveup2.jomodns.com,3,0.01%,3,0,100.00%
pull-flv-l6-cny.douyincdn.com,3,0.01%,6,3,50.00%
pull-hls-f1.douyincdn.com.wsdvs.com,3,0.01%,6,3,50.00%
pull-tsl-spe-l3.douyincdn.com.230b2a2545cfa773.queniubg.com,3,0.01%,3,0,100.00%
pull-spe-l3.douyincdn.com.230b2a2545cfa773.queniucf.com,3,0.01%,3,0,100.00%
pull-fcdn-rts.s.bytefcdn.com,3,0.01%,3,0,100.00%
pull-rtmp-l95.douyincdn.com.ctdns.cn,3,0.01%,6,3,50.00%
push-rtmp-l3.douyincdn.com.w.kunlunso.com,3,0.01%,3,0,100.00%
pull-tsl-spe-l6.douyincdn.com,3,0.01%,6,3,50.00%
pull-tsl-vr-l3.douyincdn.com.230b2a2545cfa773.queniubg.com,3,0.01%,3,0,100.00%
pull-tsl-spe-l6.douyincdn.com.hlsvcloud.ks-cdn.com,3,0.01%,6,3,50.00%
pull-vr-l3.douyincdn.com.230b2a2545cfa773.queniucf.com,3,0.01%,3,0,100.00%
pull-tsl-vr-l1.douyincdn.com.wsdvs.com,3,0.01%,6,3,50.00%
pull-flv-l1.douyincdn.com.gccdn.net,3,0.01%,6,3,50.00%
push-rtmp-l3-enc.douyincdn.com.w.kunlunso.com,3,0.01%,3,0,100.00%
pull-flv-f1-hs.pstatp.com.wsdvs.com,3,0.01%,6,3,50.00%
pull-flv-l11-cny.douyincdn.com.tcdnlive.com,3,0.01%,6,3,50.00%
pull-flv-l11-cny.douyincdn.com.sched.l9-dk.tdnsv5.com,3,0.01%,6,3,50.00%
pull-flv-spe-l1.douyincdn.com.wsdvs.com,3,0.01%,6,3,50.00%
sx-common-v4.volcgtm.com,3,0.01%,3,0,100.00%
pull-hls-vr-l6.douyincdn.com.hlsvcloud.ks-cdn.com,3,0.01%,6,3,50.00%
push-rtmp-spe-l1.douyincdn.com.wsdvs.com,3,0.01%,3,0,100.00%
pull-flv-f1-proxy.douyincdn.com,3,0.01%,6,3,50.00%
erh4gbw3.sched.v1lego-dk.tdnsvod1.cn,3,0.01%,6,3,50.00%
push.ulive.ugslb.com,3,0.01%,3,0,100.00%
push-rtmp-l3-hs.pstatp.com.w.kunlunso.com,3,0.01%,3,0,100.00%
pull-rtmp-l6.ixigua.com,3,0.01%,6,3,50.00%
pull-rtmp-l6.ixigua.com.rtmpvcloud.ks-cdn.com,3,0.01%,6,3,50.00%
s6120-ml.gslb.ksyuncdn.com,3,0.01%,6,3,50.00%
pull-fcdn-huoshan-base.s.bytefcdn.com,3,0.01%,3,0,100.00%
pull-flv-l6.ixigua.com,3,0.01%,6,3,50.00%
pull-flv-l6.ixigua.com.hdlvcloud.ks-cdn.com,3,0.01%,6,3,50.00%
toutiao.hdllive.ks-cdn.com,3,0.01%,6,3,50.00%
pull-lls-spe-l3.douyincdn.com.230b2a2545cfa773.queniucf.com,3,0.01%,3,0,100.00%
pull-fcdn-douyin-hot3.s.bytefcdn.com,3,0.01%,3,0,100.00%
push-rtmp-spe-l3.douyincdn.com.230b2a2545cfa773.queniufm.com,3,0.01%,3,0,100.00%
pull-tsl-spe-l26.douyincdn.com,3,0.01%,6,3,50.00%
pull-tsl-spe-l26.douyincdn.com.51296c5e.c.cdnhwc1.com,3,0.01%,6,3,50.00%
pull-lls-spe-l6.douyincdn.com.hdlvcloud.ks-cdn.com,3,0.01%,6,3,50.00%
pull-l3-source.douyincdn.com.w.cdngslb.com,3,0.01%,3,0,100.00%
push-rtmp-vr-l3.douyincdn.com.230b2a2545cfa773.queniufm.com,3,0.01%,3,0,100.00%
v11.douyinvod.com,3,0.01%,6,3,50.00%
v11.douyinvod.com.cdn.dnsv1.com,3,0.01%,6,3,50.00%
v11.sched.v4lego-dk.tdnsvod1.cn,3,0.01%,6,3,50.00%
onedscolprdcus09.centralus.cloudapp.azure.com,3,0.01%,3,0,100.00%
ins-5i86z7w2.ias.tencent-cloud.net,3,0.01%,3,0,100.00%
study.huixiangtiandi.com,3,0.01%,3,0,100.00%
pc-plugin-plg-wpscdn-cn-idvh11c.qiniudns.com,3,0.01%,6,3,50.00%
chinaweb292.china.line.qiniudns.com,3,0.01%,6,3,50.00%
ext.henzanapp.com,3,0.01%,3,0,100.00%
na61-na62.wagbridge.alibaba.aliyun.com.gds.alibabadns.com,3,0.01%,3,0,100.00%
www.ieee.org,3,0.01%,3,0,100.00%
stream.cadmore.media,3,0.01%,3,0,100.00%
sv.symcb.com,3,0.01%,4,1,75.00%
xueshu.baidu.com,3,0.01%,5,2,60.00%
onedscolprdneu05.northeurope.cloudapp.azure.com,3,0.01%,3,0,100.00%
mesu-china.apple.com.akadns.net,3,0.01%,6,3,50.00%
t7z.cupid.iqiyi.com,3,0.01%,3,0,100.00%
tracker.pimp4003.net,3,0.01%,3,0,100.00%
store.xiaohongshu.com,3,0.01%,6,3,50.00%
nydc1.outbrain.org,3,0.01%,3,0,100.00%
array501.prod.do.dsp.mp.microsoft.com,3,0.01%,3,0,100.00%
ftp.hp.com,3,0.01%,3,0,100.00%
geover.prod.do.dsp.mp.microsoft.com,3,0.01%,3,0,100.00%
dl.delivery.mp.microsoft.com,3,0.01%,3,0,100.00%
bkclick.n.shifen.com,3,0.01%,3,0,100.00%
dart.l.doubleclick.net,3,0.01%,3,0,100.00%
nfs.iscas.ac.cn,3,0.01%,3,0,100.00%
cxcs.microsoft.net,3,0.01%,3,0,100.00%
selfstock.10jqka.com.cn,3,0.01%,3,0,100.00%
v3-default.365yg.com,3,0.01%,11,8,27.27%
t-safe.2345.com,3,0.01%,3,0,100.00%
bingciservice.koreasouth.cloudapp.azure.com,3,0.01%,3,0,100.00%
ajax.googleapis.com,3,0.01%,3,0,100.00%
www.googletagservices.com,3,0.01%,3,0,100.00%
prod-tp.sumo.mozit.cloud,3,0.01%,3,0,100.00%
clientlogvodp2p.haplat.net,3,0.01%,3,0,100.00%
services.addons.mozilla.org,3,0.01%,3,0,100.00%
alps.51y5.net,3,0.01%,3,0,100.00%
bag.itunes.apple.com,3,0.01%,7,4,42.86%
3.debian.pool.ntp.org,3,0.01%,3,0,100.00%
onedscolprdeus04.eastus.cloudapp.azure.com,3,0.01%,3,0,100.00%
klbv2.wpsdns.com,3,0.01%,3,0,100.00%
onedscolprdeus11.eastus.cloudapp.azure.com,3,0.01%,3,0,100.00%
e11.dsca.akamaiedge.net,3,0.01%,6,3,50.00%
fe2.update.msft.com.trafficmanager.net,3,0.01%,6,3,50.00%
us3-2.nigirocloud.com,3,0.01%,3,0,100.00%
down1.xinshuru.com,3,0.01%,3,0,100.00%
update-drcn.platform.hicloud.com,3,0.01%,3,0,100.00%
ac.dun.163yun.com,3,0.01%,6,3,50.00%
nstool.netease.com,3,0.01%,6,3,50.00%
sslzz.jomodns.com,3,0.01%,3,0,100.00%
l5-global.gslb.ksyuncdn.com,3,0.01%,3,0,100.00%
onedscolprduks02.uksouth.cloudapp.azure.com,3,0.01%,3,0,100.00%
f7.baidu.com,3,0.01%,3,0,100.00%
bimp.hdslb.com,3,0.01%,10,7,30.00%
hcdnw.bili.c.cdnhwc2.com,3,0.01%,6,3,50.00%
kns.duba.net,3,0.01%,3,0,100.00%
snowplow-elb-prod1-clarivate-470512675.us-west-2.elb.amazonaws.com,3,0.01%,3,0,100.00%
search-operate.cdn.bcebos.com,3,0.01%,3,0,100.00%
adsmind.ugdtimg.com,3,0.01%,9,6,33.33%
ws12.gti.mcafee.com,3,0.01%,3,0,100.00%
beacon.tingyun.com,3,0.01%,3,0,100.00%
pull-flv-l11-encryption.douyincdn.com,3,0.01%,3,0,100.00%
onedscolprdeus06.eastus.cloudapp.azure.com,3,0.01%,3,0,100.00%
cdn.ark.qq.com,3,0.01%,3,0,100.00%
ntes53.mail.163.com,3,0.01%,3,0,100.00%
astivysauran.com,3,0.01%,3,0,100.00%
oauth.account.jetbrains.com,3,0.01%,3,0,100.00%
download.proxmox.com,3,0.01%,12,9,25.00%
whoami.akamai.net,3,0.01%,3,0,100.00%
onedscolprdeus10.eastus.cloudapp.azure.com,3,0.01%,3,0,100.00%
tracker.bitsearch.to,3,0.01%,5,2,60.00%
api.lsplayer.com,3,0.01%,3,0,100.00%
fonts.gstatic.com,3,0.01%,3,0,100.00%
cache.video.iqiyi.com,3,0.01%,3,0,100.00%
cn-huhehaote.axt.aliyun.com,3,0.01%,3,0,100.00%
cn-shenzhen.axt.aliyun.com,3,0.01%,3,0,100.00%
passport.csdn.net,3,0.01%,3,0,100.00%
wallpaper-redirect-api.cqttech.com,3,0.01%,3,0,100.00%
omnatuor.com,3,0.01%,3,0,100.00%
admin.kdsec.org,3,0.01%,3,0,100.00%
api.wondercv.com,3,0.01%,3,0,100.00%
cl3.apple.com,3,0.01%,4,1,75.00%
telecommand.telemetry.microsoft.com,3,0.01%,3,0,100.00%
i0.hdslb.com.w.kunlunno.com,3,0.01%,6,3,50.00%
xpis-xcdn.youku.com,3,0.01%,3,0,100.00%
match.prod.bidr.io,3,0.01%,3,0,100.00%
video.yidianzixun.com,3,0.01%,3,0,100.00%
team-speed-cdn-vip.xunlei.com,3,0.01%,3,0,100.00%
o1013tn36u32026o.aliyunddos1010.com,3,0.01%,3,0,100.00%
soup.v.qq.com,3,0.01%,3,0,100.00%
www.wegame.com.cn,3,0.01%,6,3,50.00%
blobcollector.events.data.trafficmanager.NET,3,0.01%,6,3,50.00%
discovery-v4.verysync.cn,3,0.01%,3,0,100.00%
get.skype.com,2,0.00%,2,0,100.00%
prod.msgsearch.trafficmanager.net,2,0.00%,2,0,100.00%
ios.rqd.qq.com,2,0.00%,4,2,50.00%
liveget.trafficmanager.net,2,0.00%,2,0,100.00%
openmsf.msf.tencent-cloud.com,2,0.00%,2,0,100.00%
k-ring.msedge.net,2,0.00%,2,0,100.00%
people.skype.com,2,0.00%,2,0,100.00%
k-ring.k-9999.k-msedge.net,2,0.00%,2,0,100.00%
people-service-prod.trafficmanager.net,2,0.00%,2,0,100.00%
init-p01st.push.apple.com,2,0.00%,4,2,50.00%
init-p01st-lb.push-apple.com.akadns.net,2,0.00%,4,2,50.00%
s-ring.s-9999.s-msedge.net,2,0.00%,2,0,100.00%
s-9999.s-msedge.net,2,0.00%,2,0,100.00%
16.courier-push-apple.com.akadns.net,2,0.00%,2,0,100.00%
azeus1-client-s.gateway.messenger.live.com,2,0.00%,2,0,100.00%
azeus1-client-s.msnmessenger.msn.com.akadns.net,2,0.00%,2,0,100.00%
b-0008.b-msedge.net,2,0.00%,4,2,50.00%
api.aps.skype.com,2,0.00%,2,0,100.00%
api-aps-teams.trafficmanager.net,2,0.00%,2,0,100.00%
broadcast.chat.biliapi.com,2,0.00%,2,0,100.00%
e6987.a.akamaiedge.net,2,0.00%,2,0,100.00%
onedscolprduks03.uksouth.cloudapp.azure.com,2,0.00%,2,0,100.00%
xp.itunes-apple.com.akadns.net,2,0.00%,4,2,50.00%
gsas.apple.com,2,0.00%,2,0,100.00%
hm.e.shifen.com,2,0.00%,23,21,8.70%
token.rubiconproject.com,2,0.00%,2,0,100.00%
pixel.rubiconproject.net.akadns.net,2,0.00%,2,0,100.00%
ic3.events.data.microsoft.com,2,0.00%,4,2,50.00%
gitea.com,2,0.00%,2,0,100.00%
stat.y.qq.com,2,0.00%,2,0,100.00%
onedriveclucprodbn20039.blob.core.windows.net,2,0.00%,2,0,100.00%
p218-quota.icloud.com.cn,2,0.00%,2,0,100.00%
onedscolprdwus08.westus.cloudapp.azure.com,2,0.00%,2,0,100.00%
onedscolprdwus04.westus.cloudapp.azure.com,2,0.00%,2,0,100.00%
array608.prod.do.dsp.mp.microsoft.com,2,0.00%,2,0,100.00%
nexus-websocket-a.intercom.io,2,0.00%,2,0,100.00%
www.letv.com,2,0.00%,2,0,100.00%
www.ifeng.com,2,0.00%,2,0,100.00%
www.ifeng.com.cdn.dnsv1.com,2,0.00%,2,0,100.00%
q8daiuc5.sched.sma.tdnsstic1.cn,2,0.00%,2,0,100.00%
fyzbgp.a.sohu.com,2,0.00%,4,2,50.00%
www.chinaz.com,2,0.00%,2,0,100.00%
www.chinaz.com.cdn20.com,2,0.00%,2,0,100.00%
www.csdn.net,2,0.00%,2,0,100.00%
bn1305.storage.live.com,2,0.00%,4,2,50.00%
puncher.dcdn.baidu.com,2,0.00%,2,0,100.00%
docs.gtimg.com,2,0.00%,4,2,50.00%
array809.prod.do.dsp.mp.microsoft.com,2,0.00%,4,2,50.00%
open.qurl.f.qh-lb.com,2,0.00%,2,0,100.00%
iknow-pic.cdn.bcebos.com,2,0.00%,2,0,100.00%
c2shb.one-mobile-prod.aws.oath.cloud,2,0.00%,2,0,100.00%
eddie4.nl,2,0.00%,2,0,100.00%
mgtracker.org,2,0.00%,2,0,100.00%
tracker.openbittorrent.com,2,0.00%,2,0,100.00%
update.pan.n.shifen.com,2,0.00%,2,0,100.00%
img14.360buyimg.com,2,0.00%,5,3,40.00%
gfwsl.geforce.com,2,0.00%,2,0,100.00%
gfwsl.geforce.cn,2,0.00%,2,0,100.00%
r.bing.com,2,0.00%,2,0,100.00%
alb-wy5mqfy1o52wprnwel.cn-hangzhou.alb.aliyuncs.com,2,0.00%,2,0,100.00%
rc09-fc01.oray.com,2,0.00%,2,0,100.00%
vortex-win.data.microsoft.com,2,0.00%,4,2,50.00%
img-xlppc-zhan.xunlei.com,2,0.00%,6,4,33.33%
cs.weishi.ijinshan.com,2,0.00%,2,0,100.00%
messaging.engagement.office.com,2,0.00%,2,0,100.00%
objects.githubusercontent.com,2,0.00%,2,0,100.00%
qcloud.gregchan.cn,2,0.00%,2,0,100.00%
mar.vip.com,2,0.00%,2,0,100.00%
captcha.vip.com,2,0.00%,2,0,100.00%
bootstrap.vipstatic.com,2,0.00%,2,0,100.00%
common.vip.com,2,0.00%,2,0,100.00%
cart.vip.com,2,0.00%,2,0,100.00%
fav.vip.com,2,0.00%,2,0,100.00%
myi.vip.com,2,0.00%,2,0,100.00%
list.vip.com,2,0.00%,2,0,100.00%
feedback.vip.com,2,0.00%,2,0,100.00%
commerce.safe.360.cn,2,0.00%,2,0,100.00%
rule.vip.com,2,0.00%,2,0,100.00%
stock.vip.com,2,0.00%,2,0,100.00%
h5charity.vip.com,2,0.00%,2,0,100.00%
api.game.360.cn,2,0.00%,2,0,100.00%
sug.so.360.cn,2,0.00%,2,0,100.00%
vibe.sleepyinternetfun.xyz,2,0.00%,2,0,100.00%
tracker.tiny-vps.com,2,0.00%,2,0,100.00%
vtmhz.ys7.com,2,0.00%,2,0,100.00%
tracker3.itzmx.com,2,0.00%,2,0,100.00%
movies.zsw.ca,2,0.00%,2,0,100.00%
etax.shenzhen.chinatax.gov.cn,2,0.00%,2,0,100.00%
isee.weishi.qq.com,2,0.00%,2,0,100.00%
opentracker.i2p.rocks,2,0.00%,2,0,100.00%
p4p.arenabg.com,2,0.00%,2,0,100.00%
vamd.cnode.xyz,2,0.00%,2,0,100.00%
s3m6.fenxi.com,2,0.00%,2,0,100.00%
cloudtips.1360.com,2,0.00%,2,0,100.00%
asst-api.ksord.com,2,0.00%,2,0,100.00%
dlswbr.baidu.com,2,0.00%,4,2,50.00%
asst-stat.ksord.com,2,0.00%,2,0,100.00%
img.qwps.cn,2,0.00%,4,2,50.00%
pptsgs.officeapps.live.com,2,0.00%,2,0,100.00%
browser5.qhimg.com,2,0.00%,2,0,100.00%
outlookmobile-office365-tas.msedge.net,2,0.00%,2,0,100.00%
mscareers.b2clogin.com,2,0.00%,2,0,100.00%
recruitapi.microsoft.com,2,0.00%,2,0,100.00%
spoprod-a.akamaihd.net,2,0.00%,2,0,100.00%
addinsinstallation.store.office.com,2,0.00%,2,0,100.00%
careers.microsoft.com,2,0.00%,2,0,100.00%
alog.iclick.com.cn,2,0.00%,2,0,100.00%
static-xl.a.88cdn.com,2,0.00%,6,4,33.33%
zip.update.360safe.com,2,0.00%,2,0,100.00%
clients2.googleusercontent.com,2,0.00%,2,0,100.00%
hcdndyn.zjtd01.gslb.c.cdnhwc2.com,2,0.00%,4,2,50.00%
tracking.firefox.com.cn.wswebpic.com,2,0.00%,3,1,66.67%
home.firefoxchina.cn.wswebpic.com,2,0.00%,2,0,100.00%
static.firefoxchina.cn,2,0.00%,4,2,50.00%
minipc.eastday.com,2,0.00%,5,3,40.00%
0i4k7t9l.sched.sma-dk.tdnsstic1.cn,2,0.00%,5,3,40.00%
hcdnw101.gslb.c.cdnhwc2.com,2,0.00%,2,0,100.00%
p0.qhimgs4.com.webcdn.360qhcdn.com,2,0.00%,2,0,100.00%
hp.sched.legohp-dk.tdnsstic1.cn,2,0.00%,4,2,50.00%
img1.wywyx.com,2,0.00%,2,0,100.00%
px.ads.linkedin.com,2,0.00%,2,0,100.00%
home.360game.360.cn,2,0.00%,2,0,100.00%
v5.360game.360.cn,2,0.00%,2,0,100.00%
cispa-de.zoom.us,2,0.00%,2,0,100.00%
news-bos.cdn.bcebos.com,2,0.00%,2,0,100.00%
recruit.nimte.ac.cn,2,0.00%,2,0,100.00%
www.amss.cas.cn,2,0.00%,2,0,100.00%
i3.ytimg.com,2,0.00%,4,2,50.00%
cbjs.baidu.com,2,0.00%,2,0,100.00%
submit.sb.avast.com,2,0.00%,2,0,100.00%
s3.nzbdw.com,2,0.00%,2,0,100.00%
vv.video.qq.com,2,0.00%,2,0,100.00%
28-courier.push.apple.com,2,0.00%,2,0,100.00%
download.comodo.com,2,0.00%,4,2,50.00%
cdn.download.comodo.com,2,0.00%,4,2,50.00%
c.gj.qq.com,2,0.00%,2,0,100.00%
p209-contacts.icloud.com.cn,2,0.00%,2,0,100.00%
guzzoni.apple.com,2,0.00%,2,0,100.00%
guzzoni-apple-com.v.aaplimg.com,2,0.00%,2,0,100.00%
www.tm.lg.prod.aadmsa.trafficmanager.net,2,0.00%,2,0,100.00%
prda.aadg.msidentity.com,2,0.00%,2,0,100.00%
wd-prod-cp.trafficmanager.net,2,0.00%,2,0,100.00%
waws-prod-sg1-057-feea.southeastasia.cloudapp.azure.com,2,0.00%,2,0,100.00%
alert-cn.battlenet.com.cn,2,0.00%,2,0,100.00%
wd-prod-ss-as-southeast-2-fe.southeastasia.cloudapp.azure.com,2,0.00%,2,0,100.00%
24-courier.push.apple.com,2,0.00%,2,0,100.00%
24.courier-push-apple.com.akadns.net,2,0.00%,2,0,100.00%
extensions.gnome.org,2,0.00%,6,4,33.33%
onedscolprdwus10.westus.cloudapp.azure.com,2,0.00%,4,2,50.00%
l-0003.l-msedge.net,2,0.00%,4,2,50.00%
onedscolprdcus10.centralus.cloudapp.azure.com,2,0.00%,2,0,100.00%
appsforoffice.microsoft.com,2,0.00%,2,0,100.00%
asia.configsvc1.live.com.akadns.net,2,0.00%,2,0,100.00%
a-0003.a-msedge.net,2,0.00%,4,2,50.00%
tw13.clashcloud.tech,2,0.00%,2,0,100.00%
odrs.gnome.org,2,0.00%,6,4,33.33%
e4518.dscapi7.akamaiedge.net,2,0.00%,5,3,40.00%
gfe.nvidia.com,2,0.00%,12,10,16.67%
restlbs.map.qq.com,2,0.00%,2,0,100.00%
notify.adobe.io,2,0.00%,2,0,100.00%
h-adashx.dingtalkapps.com,2,0.00%,2,0,100.00%
pull-fcdn-douyin-base4.s.bytefcdn.com,2,0.00%,2,0,100.00%
dc1-pp.ksn.kaspersky-labs.com,2,0.00%,2,0,100.00%
token.services.mozilla.com,2,0.00%,2,0,100.00%
token.r53-2.services.mozilla.com,2,0.00%,2,0,100.00%
19.push2his.eastmoney.com,2,0.00%,2,0,100.00%
23.push2his.eastmoney.com,2,0.00%,2,0,100.00%
47.push2his.eastmoney.com,2,0.00%,2,0,100.00%
57.push2his.eastmoney.com,2,0.00%,2,0,100.00%
58.push2his.eastmoney.com,2,0.00%,2,0,100.00%
65.push2his.eastmoney.com,2,0.00%,2,0,100.00%
a1488.dscd.akamai.net,2,0.00%,4,2,50.00%
66.push2his.eastmoney.com,2,0.00%,2,0,100.00%
90.push2his.eastmoney.com,2,0.00%,2,0,100.00%
51.push2his.eastmoney.com,2,0.00%,2,0,100.00%
39-courier.push.apple.com,2,0.00%,2,0,100.00%
stocks-sparkline.apple.com,2,0.00%,4,2,50.00%
geo-applefinance-cache.internal.query.g03.yahoodns.net,2,0.00%,2,0,100.00%
login.wpscdn.cn,2,0.00%,2,0,100.00%
qiniustaticopencdn.jomodns.com,2,0.00%,2,0,100.00%
26-courier.push.apple.com,2,0.00%,2,0,100.00%
valid.apple.com,2,0.00%,2,0,100.00%
krgame03.graniterapids.com,2,0.00%,2,0,100.00%
m0.mail.sina.com.cn,2,0.00%,2,0,100.00%
www.sohu.com,2,0.00%,8,6,25.00%
appcdcbjpip2.jianguoyun.com,2,0.00%,2,0,100.00%
f.c2r.ts.cdn.office.net,2,0.00%,2,0,100.00%
edge.api.myqnapcloud.cn,2,0.00%,6,4,33.33%
shark.douyucdn.cn,2,0.00%,2,0,100.00%
s.deepl.com,2,0.00%,2,0,100.00%
tw1ssltide.gmdns.net,2,0.00%,2,0,100.00%
us3.gmdns.net,2,0.00%,2,0,100.00%
in2.gmdns.net,2,0.00%,2,0,100.00%
cn13.gmdns.net,2,0.00%,2,0,100.00%
www.focustodo.net,2,0.00%,2,0,100.00%
weather.noaa.gov,2,0.00%,2,0,100.00%
ocsp.thawte.com,2,0.00%,4,2,50.00%
playclient.douyucdn.cn,2,0.00%,2,0,100.00%
crl.thawte.com,2,0.00%,4,2,50.00%
webconf.douyucdn.cn,2,0.00%,4,2,50.00%
alt4-mtalk.google.com,2,0.00%,2,0,100.00%
capi.douyucdn.cn,2,0.00%,4,2,50.00%
www.douyu.com,2,0.00%,4,2,50.00%
sta-op.douyucdn.cn,2,0.00%,4,2,50.00%
zhuanlan.zhihu.com,2,0.00%,4,2,50.00%
video.leetcode-cn.com,2,0.00%,2,0,100.00%
captcha.zhihu.com,2,0.00%,4,2,50.00%
center.lanxin.cn,2,0.00%,2,0,100.00%
ocsp.globalsign.com,2,0.00%,2,0,100.00%
onedriveclubprodbn20029.blob.core.windows.net,2,0.00%,2,0,100.00%
ocsp.crlocsp.cn,2,0.00%,2,0,100.00%
urs.microsoft.com,2,0.00%,2,0,100.00%
img.bq233.com,2,0.00%,2,0,100.00%
tRAnsiT1.WSLOg.chiNAneTCENTEr.coM,2,0.00%,2,0,100.00%
CLieNTlogVODp2P.hapLaT.NET,2,0.00%,2,0,100.00%
mambap2PVoDh5.8686C.com,2,0.00%,2,0,100.00%
crl.certum.pl,2,0.00%,3,1,66.67%
bt.mp4ba.com,2,0.00%,4,2,50.00%
conn.meeting.work.weixin.qq.com,2,0.00%,2,0,100.00%
ss.gb1.se.sx.cn,2,0.00%,2,0,100.00%
gh.bdstatic.com,2,0.00%,2,0,100.00%
sploit-edge.smartscreen.microsoft.com,2,0.00%,2,0,100.00%
mbdp01.bdstatic.com,2,0.00%,2,0,100.00%
qszhang.com,2,0.00%,2,0,100.00%
osupdateservice.yunos.com,2,0.00%,2,0,100.00%
api-game.flash.cn,2,0.00%,2,0,100.00%
download.ffnews.cn,2,0.00%,2,0,100.00%
stats.norton.com,2,0.00%,2,0,100.00%
api.flash.cn,2,0.00%,2,0,100.00%
c.s.360.cn,2,0.00%,3,1,66.67%
search.namequery.com,2,0.00%,2,0,100.00%
lsw-fast.lenovo.com.cn,2,0.00%,2,0,100.00%
docteamapi.wps.cn,2,0.00%,2,0,100.00%
pcmgrmonitor.3g.qq.com,2,0.00%,2,0,100.00%
c.pc.qq.com,2,0.00%,2,0,100.00%
gaode-jmacs.m.taobao.com,2,0.00%,2,0,100.00%
cloudfont.docer.wps.cn,2,0.00%,2,0,100.00%
client.docer.wps.cn,2,0.00%,2,0,100.00%
unpkg.zhimg.com,2,0.00%,4,2,50.00%
tracker.army,2,0.00%,2,0,100.00%
tracker.pomf.se,2,0.00%,2,0,100.00%
ort.stsdk.vivo.com.cn,2,0.00%,2,0,100.00%
shcu1.myddns.cyou,2,0.00%,2,0,100.00%
array613.prod.do.dsp.mp.microsoft.com,2,0.00%,2,0,100.00%
nsp-hicloud-cloudbackupnorth4-p01-drcn.obs.cn-north-4.myhuaweicloud.cn,2,0.00%,2,0,100.00%
nsp-hicloud-cloudphotonorth4-p03-drcn.obs.cn-north-4.myhuaweicloud.com,2,0.00%,2,0,100.00%
nsp-hicloud-cloudphotonorth4-p02-drcn.obs.cn-north-4.myhuaweicloud.cn,2,0.00%,2,0,100.00%
e191.b.akamaiedge.net,2,0.00%,2,0,100.00%
hq.cjsc.com.cn,2,0.00%,2,0,100.00%
vpn.xidian.edu.cn,2,0.00%,2,0,100.00%
update-khd.2345.cc,2,0.00%,2,0,100.00%
quote.eastmoney.com,2,0.00%,4,2,50.00%
same.eastmoney.com,2,0.00%,2,0,100.00%
gbfek.eastmoney.com,2,0.00%,4,2,50.00%
emres.eastmoney.com,2,0.00%,4,2,50.00%
emcharts.dftzj.com,2,0.00%,4,2,50.00%
emcharts.eastmoney.com,2,0.00%,4,2,50.00%
emcharts.dfcfw.com,2,0.00%,4,2,50.00%
cmsjs.eastmoney.com,2,0.00%,4,2,50.00%
32.newspush.eastmoney.com,2,0.00%,2,0,100.00%
cnc.quickconnect.cn,2,0.00%,2,0,100.00%
datacenter-web.eastmoney.com,2,0.00%,4,2,50.00%
wp.mail.qq.com,2,0.00%,2,0,100.00%
setup.icloud.com,2,0.00%,4,2,50.00%
setup.fe.apple-dns.net,2,0.00%,4,2,50.00%
p205-contacts.icloud.com.cn,2,0.00%,2,0,100.00%
stocks-data-service.lb-apple.com.akadns.net,2,0.00%,4,2,50.00%
a1091.dscb.akamai.net,2,0.00%,4,2,50.00%
common-geo.ha.1drv.com,2,0.00%,2,0,100.00%
common-geo.onedrive.trafficmanager.net,2,0.00%,2,0,100.00%
dsm01pcor005-com.be.1drv.com,2,0.00%,2,0,100.00%
3scpuqeq.sched.sma.tdnsstic1.cn,2,0.00%,2,0,100.00%
weu010-breeziest-in.cloudapp.net,2,0.00%,2,0,100.00%
mail.arubafin.com,2,0.00%,2,0,100.00%
settings-prod-uks-1.uksouth.cloudapp.azure.com,2,0.00%,2,0,100.00%
array610.prod.do.dsp.mp.microsoft.com,2,0.00%,2,0,100.00%
kt-prod.ess.apple.com,2,0.00%,2,0,100.00%
dcbrowser.cqttech.com.w.kunlungr.com,2,0.00%,2,0,100.00%
array802.prod.do.dsp.mp.microsoft.com,2,0.00%,2,0,100.00%
29-courier.push.apple.com,2,0.00%,2,0,100.00%
29.courier-push-apple.com.akadns.net,2,0.00%,2,0,100.00%
api.vps315.com,2,0.00%,4,2,50.00%
api.ipify.org,2,0.00%,2,0,100.00%
clientconfig.passport.net,2,0.00%,4,2,50.00%
hsk-api.oray.com,2,0.00%,2,0,100.00%
array510.prod.do.dsp.mp.microsoft.com,2,0.00%,2,0,100.00%
wechat.todesk.com,2,0.00%,2,0,100.00%
pan.wps.cn,2,0.00%,2,0,100.00%
l2.hiwifi.com,2,0.00%,2,0,100.00%
s.symcb.com,2,0.00%,3,1,66.67%
3.ubuntu.pool.ntp.org,2,0.00%,2,0,100.00%
pull-hls-hs-f5-tsl.douyincdn.com.yangyi19.com,2,0.00%,2,0,100.00%
hcdnl.pulldouyincmccssp.gslb.d.live.cdn.chinamobile.com,2,0.00%,2,0,100.00%
pull-flv-l11.douyincdn.com.sched.l10.tdnsv5.com.clive.vwnti.yrzhcloud.cn,2,0.00%,2,0,100.00%
onedscolprdeus09.eastus.cloudapp.azure.com,2,0.00%,2,0,100.00%
api.smoot.apple.com,2,0.00%,2,0,100.00%
prod.registrar.skype.com,2,0.00%,2,0,100.00%
desktop.docker.com,2,0.00%,4,2,50.00%
client-teamviewer-com.trafficmanager.net,2,0.00%,2,0,100.00%
cde-prod-eastasia.azurewebsites.net,2,0.00%,2,0,100.00%
waws-prod-hk1-037.sip.azurewebsites.windows.net,2,0.00%,2,0,100.00%
waws-prod-hk1-037-8347.eastasia.cloudapp.azure.com,2,0.00%,2,0,100.00%
s.f.qh-lb.com,2,0.00%,4,2,50.00%
40-courier.push.apple.com,2,0.00%,2,0,100.00%
40.courier-push-apple.com.akadns.net,2,0.00%,2,0,100.00%
748049e45d87b8c7.jijifun.com,2,0.00%,2,0,100.00%
5a880faf6fb5e608.jijifun.com,2,0.00%,2,0,100.00%
dcat-tlu-fg-shim.trafficmanager.net,2,0.00%,2,0,100.00%
tlu.dl.delivery.mp.microsoft.com.a.bdydns.com,2,0.00%,2,0,100.00%
opencdnmsdl3.jomodns.com,2,0.00%,2,0,100.00%
www.google-analytics.com,2,0.00%,7,5,28.57%
emp-api.baidu.com,2,0.00%,2,0,100.00%
mail.116bestwork.cf,2,0.00%,2,0,100.00%
ade.googlesyndication.com,2,0.00%,2,0,100.00%
messaging.awsmcafeeccs.mcafee.com,2,0.00%,2,0,100.00%
config.safedog.cn,2,0.00%,2,0,100.00%
down.safedog.cn,2,0.00%,2,0,100.00%
queipo3w.nodedata.net,2,0.00%,2,0,100.00%
e7248.dscb.akamaiedge.net,2,0.00%,4,2,50.00%
sz-qiniu-all.volcgtm.com,2,0.00%,4,2,50.00%
accountv2.wpsdns.com,2,0.00%,2,0,100.00%
1min.pcfg.cache.wpscdn.cn.qiniudns.com,2,0.00%,2,0,100.00%
tiny009.china.line.qiniudns.com,2,0.00%,2,0,100.00%
tiny.china.qiniu.com.trpcdn.net,2,0.00%,2,0,100.00%
datacluster4.cipsup.cn,2,0.00%,2,0,100.00%
w.deepl.com,2,0.00%,2,0,100.00%
krgame06.graniterapids.com,2,0.00%,2,0,100.00%
8-courier.push.apple.com,2,0.00%,2,0,100.00%
app.cadmoremedia.com,2,0.00%,2,0,100.00%
securepubads.g.doubleclick.net,2,0.00%,2,0,100.00%
dpm.demdex.net,2,0.00%,2,0,100.00%
ieeexplore.demdex.net,2,0.00%,2,0,100.00%
cm.everesttech.net,2,0.00%,2,0,100.00%
smetrics-ieeexplore.ieee.org,2,0.00%,2,0,100.00%
rum8.perf.linkedin.com,2,0.00%,2,0,100.00%
onedscolprdjpe05.japaneast.cloudapp.azure.com,2,0.00%,2,0,100.00%
btrace.video.qq.com,2,0.00%,2,0,100.00%
vweixinthumb.tc.qq.com,2,0.00%,4,2,50.00%
snz04pap002.storage.live.com,2,0.00%,2,0,100.00%
bam.nr-data.net,2,0.00%,2,0,100.00%
data.pendo.io,2,0.00%,2,0,100.00%
app.mcafee.com,2,0.00%,2,0,100.00%
instruaccess.mcafee.com,2,0.00%,2,0,100.00%
sdk.iad-05.braze.com,2,0.00%,2,0,100.00%
lf-cdn-tos.bytescm.com,2,0.00%,2,0,100.00%
kunpeng-sc.csdnimg.cn.w.cdngslb.com,2,0.00%,2,0,100.00%
static.googleadsserving.cn,2,0.00%,3,1,66.67%
zhannei-dm.csdn.net,2,0.00%,2,0,100.00%
statistic.csdn.net,2,0.00%,2,0,100.00%
dashboard.snapcraft.io,2,0.00%,2,0,100.00%
www.yuque.com,2,0.00%,2,0,100.00%
p13n.adobe.io,2,0.00%,2,0,100.00%
assets.leetcode-cn.com.w.kunlungr.com,2,0.00%,2,0,100.00%
apm.hexin.cn,2,0.00%,2,0,100.00%
report.fantuants.com,2,0.00%,2,0,100.00%
webappcfg.paas.cmbchina.com,2,0.00%,2,0,100.00%
hqstats.10jqka.com.cn,2,0.00%,2,0,100.00%
mbads.paas.cmbchina.com,2,0.00%,2,0,100.00%
appinfocdn.cmbimg.com,2,0.00%,2,0,100.00%
s3gw.cmbimg.com,2,0.00%,2,0,100.00%
entitlement.auth.adobe.com,2,0.00%,2,0,100.00%
sp.auth.adobe.com,2,0.00%,2,0,100.00%
img.mb.cmbimg.com,2,0.00%,2,0,100.00%
hiya.browser.360.cn,2,0.00%,2,0,100.00%
update-windows.grammarly.com,2,0.00%,2,0,100.00%
log-api.pangolin-sdk-toutiao-b.com,2,0.00%,4,2,50.00%
hcfy.app,2,0.00%,4,2,50.00%
partnerad.l.doubleclick.net,2,0.00%,2,0,100.00%
cdn.sstatic.net,2,0.00%,2,0,100.00%
www.vod.lxdns.com,2,0.00%,4,2,50.00%
serviceplus.phytium.com.cn,2,0.00%,2,0,100.00%
github.githubassets.com,2,0.00%,2,0,100.00%
1251524319.vod2.myqcloud.com,2,0.00%,2,0,100.00%
lbs.mail.163.com,2,0.00%,2,0,100.00%
c-ring.msedge.net,2,0.00%,2,0,100.00%
96.push2his.eastmoney.com,2,0.00%,2,0,100.00%
34.push2his.eastmoney.com,2,0.00%,2,0,100.00%
87.push2his.eastmoney.com,2,0.00%,2,0,100.00%
80.push2his.eastmoney.com,2,0.00%,2,0,100.00%
hk4e-sdk.mihoyo.com,2,0.00%,2,0,100.00%
shee9noh.nodedata.net,2,0.00%,2,0,100.00%
17-courier.push.apple.com,2,0.00%,2,0,100.00%
blog.jobfie.es,2,0.00%,2,0,100.00%
cn-hbcd-cu-02-07.bilivideo.com,2,0.00%,2,0,100.00%
upext.chrome.360.cn,2,0.00%,2,0,100.00%
config.i.duba.net,2,0.00%,2,0,100.00%
4.courier-push-apple.com.akadns.net,2,0.00%,2,0,100.00%
13-courier.push.apple.com,2,0.00%,2,0,100.00%
13.courier-push-apple.com.akadns.net,2,0.00%,2,0,100.00%
appleimap.126.com,2,0.00%,2,0,100.00%
api.docer.wpscdn.cn.qiniudns.com,2,0.00%,4,2,50.00%
api.docer.wpscdn.china.line.qiniudns.com,2,0.00%,4,2,50.00%
global.sns.cs.quickconnect.to,2,0.00%,2,0,100.00%
subscription.iqiyi.com,2,0.00%,4,2,50.00%
44-courier.push.apple.com,2,0.00%,2,0,100.00%
44.courier-push-apple.com.akadns.net,2,0.00%,2,0,100.00%
pop3.163.idns.yeah.net,2,0.00%,2,0,100.00%
dotplayer.coldlake1.com,2,0.00%,4,2,50.00%
dotplayer.coldlake1.com.w.cdngslb.com,2,0.00%,4,2,50.00%
assets.msn.cn-c.edgekey.net.globalredir.akadns.net,2,0.00%,2,0,100.00%
msn-china.bing123.com,2,0.00%,2,0,100.00%
a1834.dscg2.akamai.net,2,0.00%,4,2,50.00%
21-courier.push.apple.com,2,0.00%,2,0,100.00%
21.courier-push-apple.com.akadns.net,2,0.00%,2,0,100.00%
intel11.cn.edgekey.net,2,0.00%,4,2,50.00%
lib.iscas.ac.cn,2,0.00%,2,0,100.00%
drive.google.com,2,0.00%,4,2,50.00%
web.sdk.qcloud.com,2,0.00%,4,2,50.00%
s1.symcb.com,2,0.00%,4,2,50.00%
17hs.servyou.com.cn,2,0.00%,2,0,100.00%
newdoc.docer.wps.cn,2,0.00%,2,0,100.00%
userinfo.docer.wps.cn,2,0.00%,2,0,100.00%
u.zhugeapi.net,2,0.00%,2,0,100.00%
secfsr.lenovomm.com,2,0.00%,2,0,100.00%
pcmgr.lenovo.com.cn,2,0.00%,2,0,100.00%
scholar.l.google.com,2,0.00%,2,0,100.00%
data.mistat.xiaomi.com,2,0.00%,2,0,100.00%
query.ess.apple.com,2,0.00%,2,0,100.00%
wmgp-update.wmupd.com.w.alikunlun.com,2,0.00%,2,0,100.00%
api.segment.io,2,0.00%,2,0,100.00%
services.gfe.nvidia.com,2,0.00%,2,0,100.00%
inappcheck-cn.itunes-apple.com.akadns.net,2,0.00%,4,2,50.00%
link.netease.im,2,0.00%,2,0,100.00%
lbs.netease.im,2,0.00%,2,0,100.00%
conversions.appsflyer.com,2,0.00%,2,0,100.00%
g-msn-com-nsatc.trafficmanager.net,2,0.00%,4,2,50.00%
oneclient.sfx.ms.edgekey.net,2,0.00%,4,2,50.00%
e9659.dspg.akamaiedge.net,2,0.00%,4,2,50.00%
pull-rtmp-f6-hs.pstatp.com,2,0.00%,4,2,50.00%
pull-flv-f26-proxy.douyincdn.com,2,0.00%,4,2,50.00%
push-rtmp-l27.douyincdn.com,2,0.00%,2,0,100.00%
push-rtmp-l3-encryption.douyincdn.com,2,0.00%,2,0,100.00%
pull-flv-l6-enc.douyincdn.com,2,0.00%,4,2,50.00%
pull-flv-l6-source.douyincdn.com.hdlvcloud.ks-cdn.com,2,0.00%,4,2,50.00%
mailn2sk.message.cmbchina.com,2,0.00%,2,0,100.00%
mailn3qh.message.cmbchina.com,2,0.00%,2,0,100.00%
mailn7sh.message.cmbchina.com,2,0.00%,2,0,100.00%
mailn6sk.message.cmbchina.com,2,0.00%,2,0,100.00%
mailn3sh.message.cmbchina.com,2,0.00%,2,0,100.00%
mailn5qh.message.cmbchina.com,2,0.00%,2,0,100.00%
mailn7qh.message.cmbchina.com,2,0.00%,2,0,100.00%
pull-flv-l6-encryption.douyincdn.com,2,0.00%,4,2,50.00%
mailn1qh.message.cmbchina.com,2,0.00%,2,0,100.00%
mailn5sh.message.cmbchina.com,2,0.00%,2,0,100.00%
mailn4sh.message.cmbchina.com,2,0.00%,2,0,100.00%
mailn8sk.message.cmbchina.com,2,0.00%,2,0,100.00%
pull-tsl-vr-l11.douyincdn.com,2,0.00%,4,2,50.00%
mail1.message.cmbchina.com,2,0.00%,2,0,100.00%
mail2.message.cmbchina.com,2,0.00%,2,0,100.00%
mailn3sz.message.cmbchina.com,2,0.00%,2,0,100.00%
mailh1.message.cmbchina.com,2,0.00%,2,0,100.00%
mailh2.message.cmbchina.com,2,0.00%,2,0,100.00%
mailn4sz.message.cmbchina.com,2,0.00%,2,0,100.00%
pull-flv-l6-cny.douyincdn.com.hdlvcloud.ks-cdn.com,2,0.00%,4,2,50.00%
pull-flv-f1.douyincdn.com,2,0.00%,4,2,50.00%
mailn1sz.message.cmbchina.com,2,0.00%,2,0,100.00%
mail.message.cmbchina.com,2,0.00%,2,0,100.00%
pull-rtmp-f6.douyincdn.com,2,0.00%,4,2,50.00%
pull-flv-l95.douyincdn.com,2,0.00%,4,2,50.00%
pull-flv-l1-source.douyincdn.com,2,0.00%,4,2,50.00%
pull-flv-l6.douyincdn.com,2,0.00%,4,2,50.00%
pull-flv-l6.douyincdn.com.hdlvcloud.ks-cdn.com,2,0.00%,4,2,50.00%
play-dy.ulive.ugslb.com,2,0.00%,2,0,100.00%
wx-love-img.afunapp.com,2,0.00%,2,0,100.00%
pull-tsl-vr-l1.douyincdn.com,2,0.00%,4,2,50.00%
25.courier-push-apple.com.akadns.net,2,0.00%,2,0,100.00%
pull-tsl-spe-l11.douyincdn.com.cdn.dnsv1.com,2,0.00%,4,2,50.00%
pull-flv-l6-hs.pstatp.com,2,0.00%,4,2,50.00%
pull-lls-spe-l6.douyincdn.com,2,0.00%,4,2,50.00%
v3-cold4.douyinvod.com,2,0.00%,2,0,100.00%
v3-cold4.douyinvod.com.w.kunluncan.com,2,0.00%,2,0,100.00%
statistic.live.126.net,2,0.00%,2,0,100.00%
21.push2his.eastmoney.com,2,0.00%,2,0,100.00%
93.push2his.eastmoney.com,2,0.00%,2,0,100.00%
eihie4vi.nodedata.net,2,0.00%,2,0,100.00%
thu0thei.nodedata.net,2,0.00%,2,0,100.00%
portainer-io-assets.sfo2.digitaloceanspaces.com,2,0.00%,2,0,100.00%
cn-sh.sasg4e.ccddns.lol,2,0.00%,2,0,100.00%
94.push2his.eastmoney.com,2,0.00%,2,0,100.00%
85.push2his.eastmoney.com,2,0.00%,2,0,100.00%
array616.prod.do.dsp.mp.microsoft.com,2,0.00%,2,0,100.00%
public-cdn.cloud.unity3d.com,2,0.00%,2,0,100.00%
partiality.itunes.apple.com,2,0.00%,4,2,50.00%
profile.firefox.com.cn,2,0.00%,2,0,100.00%
sync.firefox.com.cn,2,0.00%,2,0,100.00%
krgame08.graniterapids.com,2,0.00%,2,0,100.00%
api-accounts.firefox.com.cn,2,0.00%,2,0,100.00%
s14-sync.firefox.com.cn,2,0.00%,2,0,100.00%
qtx4xi8lzc.feishu.cn,2,0.00%,2,0,100.00%
cn4.gmdns.net,2,0.00%,2,0,100.00%
gimg3.baidu.com.a.bdydns.com,2,0.00%,2,0,100.00%
pss.bdstatic.com.a.bdydns.com,2,0.00%,2,0,100.00%
dup.baidustatic.com,2,0.00%,2,0,100.00%
ecomcbjs.jomodns.com,2,0.00%,2,0,100.00%
img-blog.csdnimg.cn,2,0.00%,2,0,100.00%
profile.csdnimg.cn,2,0.00%,2,0,100.00%
gsp0.baidu.com,2,0.00%,2,0,100.00%
img-home.csdnimg.cn,2,0.00%,2,0,100.00%
delegation.a.shifen.com,2,0.00%,2,0,100.00%
cdn.wwads.cn,2,0.00%,2,0,100.00%
kunyu.csdn.net,2,0.00%,2,0,100.00%
event.csdn.net,2,0.00%,5,3,40.00%
profile-avatar.csdnimg.cn,2,0.00%,2,0,100.00%
zhanzhang.toutiao.com,2,0.00%,2,0,100.00%
cn3.gmdns.net,2,0.00%,2,0,100.00%
cb.e.shifen.com,2,0.00%,2,0,100.00%
c2.pcs.baidu.com,2,0.00%,4,2,50.00%
r4---sn-ni5eln7l.gvt1.com,2,0.00%,2,0,100.00%
APAC04.azure-devices.net,2,0.00%,2,0,100.00%
ns-sb2-prod-hk2-005.cloudapp.net,2,0.00%,2,0,100.00%
r2---sn-ni5een7l.gvt1.com,2,0.00%,2,0,100.00%
gstaticadssl.l.google.com,2,0.00%,2,0,100.00%
mmbiz.qpic.cn.sched.legopic1.tdnsv6.com,2,0.00%,2,0,100.00%
www.tm.ak.prd.aadg.akadns.net,2,0.00%,2,0,100.00%
zlxxglobal.v.lxcvc.com,2,0.00%,2,0,100.00%
clientnotification-userprodcus1-6.servicebus.windows.net,2,0.00%,2,0,100.00%
inappcheck.itunes.apple.com,2,0.00%,2,0,100.00%
dss3.bdstatic.com,2,0.00%,2,0,100.00%
www2.bing.com,2,0.00%,2,0,100.00%
aefd.nelreports.net,2,0.00%,5,3,40.00%
api.k.163.com,2,0.00%,2,0,100.00%
api.crush.163.com,2,0.00%,2,0,100.00%
sat02pap003.storage.live.com,2,0.00%,4,2,50.00%
onedriveclucprodbn20003.blob.core.windows.net,2,0.00%,2,0,100.00%
weather-edge.apple.com,2,0.00%,2,0,100.00%
cl4-cn.apple.com,2,0.00%,2,0,100.00%
p216-fmf.icloud.com.cn,2,0.00%,2,0,100.00%
fmf.fe.apple-dns.cn,2,0.00%,2,0,100.00%
shift.is.autonavi.com.gds.alibabadns.com,2,0.00%,2,0,100.00%
ocsp.pki.goog,2,0.00%,2,0,100.00%
passport.bilibili.com,2,0.00%,2,0,100.00%
dataflow.biliapi.com,2,0.00%,3,1,66.67%
ca.iadsdk.apple.com,2,0.00%,2,0,100.00%
member.bilibili.com,2,0.00%,2,0,100.00%
ah.yd01.paopaocloud.cyou,2,0.00%,2,0,100.00%
img0.baidu.com,2,0.00%,2,0,100.00%
metrics.hub.caaws.services,2,0.00%,2,0,100.00%
security.ie.sogou.com,2,0.00%,2,0,100.00%
res.browser.qq.com,2,0.00%,2,0,100.00%
skin.browser.qq.com,2,0.00%,2,0,100.00%
feeds.qq.com,2,0.00%,2,0,100.00%
skeyword.browser.qq.com,2,0.00%,2,0,100.00%
stdl.qq.com,2,0.00%,2,0,100.00%
baas.browser.qq.com,2,0.00%,2,0,100.00%
wis.qq.com,2,0.00%,2,0,100.00%
mat1.gtimg.com,2,0.00%,4,2,50.00%
ad.browser.qq.com,2,0.00%,2,0,100.00%
img2.baidu.com,2,0.00%,2,0,100.00%
mam.netease.com,2,0.00%,2,0,100.00%
transit1.wslog.chinanetcenter.com,2,0.00%,2,0,100.00%
mambap2pvodh5.8686c.com,2,0.00%,2,0,100.00%
v18.toutiaovod.com,2,0.00%,2,0,100.00%
transit2.wslog.chinanetcenter.com,2,0.00%,2,0,100.00%
vasvip-pub.wpscdn.cn,2,0.00%,4,2,50.00%
apifox.cn-hangzhou.log.aliyuncs.com,2,0.00%,2,0,100.00%
img1.baidu.com,2,0.00%,2,0,100.00%
su.ff.avast.com,2,0.00%,2,0,100.00%
webrtcpunch.video.qq.com,2,0.00%,2,0,100.00%
p26-be-pack-sign.pglstatp-toutiao.com,2,0.00%,4,2,50.00%
pcdownaliyun.titan.mgtv.com,2,0.00%,2,0,100.00%
code.aliyun.com,2,0.00%,2,0,100.00%
minor-api.mihoyo.com,2,0.00%,2,0,100.00%
wap.sogou.com,2,0.00%,2,0,100.00%
ldc-open.lenovo.com.cn,2,0.00%,2,0,100.00%
ip1880706120.funshion.com,2,0.00%,2,0,100.00%
cinema-pics-drcn.dbankcdn.com,2,0.00%,4,2,50.00%
play4.cp21.ott.cibntv.net,2,0.00%,4,2,50.00%
download.jetbrains.com.cn,2,0.00%,4,2,50.00%
d2lfklupjnai2b.cloudfront.cn,2,0.00%,4,2,50.00%
tools.l.google.com,2,0.00%,4,2,50.00%
prdwss-prod-nlb-wss-b8099ab1e72f69ce.elb.us-west-2.amazonaws.com,2,0.00%,2,0,100.00%
hw-prod-pub-alb-245537193.us-west-2.elb.amazonaws.com,2,0.00%,2,0,100.00%
swallow.apple.com,2,0.00%,2,0,100.00%
appleimap.163.com,2,0.00%,2,0,100.00%
e2820.g.akamaiedge.net,2,0.00%,2,0,100.00%
mesu.apple.com,2,0.00%,4,2,50.00%
mesu-cdn.apple.com.akadns.net,2,0.00%,4,2,50.00%
42.courier-push-apple.com.akadns.net,2,0.00%,2,0,100.00%
e7695.dscg.akamaiedge.net,2,0.00%,4,2,50.00%
9-courier.push.apple.com,2,0.00%,2,0,100.00%
9.courier-push-apple.com.akadns.net,2,0.00%,2,0,100.00%
onedscolprdwus00.westus.cloudapp.azure.com,2,0.00%,2,0,100.00%
cdn.content.prod.cms.msn.com.edgekey.net,2,0.00%,4,2,50.00%
e10663.dscg.akamaiedge.net,2,0.00%,4,2,50.00%
cdn.ark.qq.com.cloud.tc.qq.com,2,0.00%,2,0,100.00%
cdn.ark.qq.com.sched.legopic1.tdnsv6.com,2,0.00%,2,0,100.00%
sqm.telemetry.microsoft.com,2,0.00%,2,0,100.00%
p209-quota.icloud.com.cn,2,0.00%,2,0,100.00%
quota.fe.apple-dns.cn,2,0.00%,2,0,100.00%
iadsdk.apple.com,2,0.00%,2,0,100.00%
iadsdk.apple.com.akadns.net,2,0.00%,2,0,100.00%
prod.ingestion-edge.prod.dataops.mozgcp.NET,2,0.00%,2,0,100.00%
0.pool.ntp.org,2,0.00%,2,0,100.00%
1.pool.ntp.org,2,0.00%,2,0,100.00%
3.pool.ntp.org,2,0.00%,2,0,100.00%
3.asia.pool.ntp.org,2,0.00%,2,0,100.00%
0.asia.pool.ntp.org,2,0.00%,2,0,100.00%
mail.persbywepocad.tk,2,0.00%,2,0,100.00%
cp601.prod.do.dsp.mp.microsoft.com,2,0.00%,2,0,100.00%
271509e17755a70d683b7f40cdb3eec6df604067.u.fdmpkg.org,2,0.00%,2,0,100.00%
onedriveclucprodbn20005.blob.core.windows.net,2,0.00%,2,0,100.00%
iplc.a.hellossr.com,2,0.00%,2,0,100.00%
iplc.b.hellossr.com,2,0.00%,2,0,100.00%
cdn-cn.nekocloud.cn,2,0.00%,2,0,100.00%
beacons5.gvt3.com,2,0.00%,6,4,33.33%
down1.abckantu.com,2,0.00%,2,0,100.00%
report.uchiha.ltd,2,0.00%,2,0,100.00%
down2.abckantu.com,2,0.00%,2,0,100.00%
telemetry.rancher.io,2,0.00%,2,0,100.00%
launcher-public-service-prod06.ol.epicgames.com,2,0.00%,2,0,100.00%
api.ghostery.net,2,0.00%,2,0,100.00%
wechat.intelcupid.com,2,0.00%,2,0,100.00%
mssdk-bu.bytedance.com.w.cdngslb.com,2,0.00%,2,0,100.00%
api-access.pangolin-sdk-toutiao.com.bytedns1.com,2,0.00%,2,0,100.00%
api-access.pangolin-sdk-toutiao.com.w.cdngslb.com,2,0.00%,2,0,100.00%
dsp-x.jd.com,2,0.00%,2,0,100.00%
xlog.jd.com,2,0.00%,2,0,100.00%
nex.163.com,2,0.00%,2,0,100.00%
static-dxospf.split.netease.com,2,0.00%,2,0,100.00%
tnc3-aliec2.snssdk.com,2,0.00%,2,0,100.00%
janapi.jd.com,2,0.00%,2,0,100.00%
tnc3-aliec2.snssdk.com.w.cdngslb.com,2,0.00%,2,0,100.00%
yp.ws.126.net,2,0.00%,2,0,100.00%
e-p4p.163.com,2,0.00%,2,0,100.00%
repository.gtm.eset.com,2,0.00%,2,0,100.00%
in2-prod-east-us2-23fa330.trafficmanager.net,2,0.00%,2,0,100.00%
in1-gw2-01-ce7dd027.eastus2.cloudapp.azure.com,2,0.00%,4,2,50.00%
p218-contacts.icloud.com.cn,2,0.00%,2,0,100.00%
sconf.f.360.cn,2,0.00%,2,0,100.00%
cl.vd.f.360.cn,2,0.00%,2,0,100.00%
up.f.360.cn,2,0.00%,2,0,100.00%
de756e7cb5050f7a-cl2.qcloudcjgj.com,2,0.00%,2,0,100.00%
apne1-bytedance-cn.sentinelone.net,2,0.00%,2,0,100.00%
i-resv.meituan.com,2,0.00%,2,0,100.00%
toblog.ctobsnssdk.com.bytedns1.com,2,0.00%,2,0,100.00%
toblog.ctobsnssdk.com.c.dsa.cdnbuild.net,2,0.00%,2,0,100.00%
toblog.ctobsnssdk.com.w.cdngslb.com,2,0.00%,2,0,100.00%
dispatcher.is.autonavi.com,2,0.00%,2,0,100.00%
gspe35-ssl.ls.apple.com,2,0.00%,2,0,100.00%
p47-fmf.icloud.com.cn,2,0.00%,2,0,100.00%
beacons6.gvt2.com,2,0.00%,4,2,50.00%
weather-analytics-events.apple.com,2,0.00%,2,0,100.00%
v5-colde.douyinvod.com.yangyi19.com,2,0.00%,4,2,50.00%
47-courier.push.apple.com,2,0.00%,2,0,100.00%
47.courier-push-apple.com.akadns.net,2,0.00%,2,0,100.00%
v5-coldb.douyinvod.com,2,0.00%,2,0,100.00%
v5-coldb.douyinvod.com.yangyi19.com,2,0.00%,2,0,100.00%
dy-vod-j.bytegslb.com,2,0.00%,2,0,100.00%
v5-colde.douyinvod.com,2,0.00%,4,2,50.00%
dy-vod-colde.bytegslb.com,2,0.00%,4,2,50.00%
baidu-cn-north-00001.bj-a.bcebos.com,2,0.00%,2,0,100.00%
bj-a.bcebos.com,2,0.00%,2,0,100.00%
connect.rom.miui.com,2,0.00%,2,0,100.00%
settings-bd.feishu.cn.w.cdngslb.com,2,0.00%,2,0,100.00%
k1-ipv6.gslb.ksyuncdn.com,2,0.00%,4,2,50.00%
assets.msn.cn-c.edgekey.net,2,0.00%,2,0,100.00%
ecn.dev.ditu.live.com.lxcvc.com,2,0.00%,2,0,100.00%
a-0032.a-msedge.net,2,0.00%,4,2,50.00%
36.push2his.eastmoney.com,2,0.00%,2,0,100.00%
24.push2his.eastmoney.com,2,0.00%,2,0,100.00%
98.push2his.eastmoney.com,2,0.00%,2,0,100.00%
71.push2his.eastmoney.com,2,0.00%,2,0,100.00%
46.push2his.eastmoney.com,2,0.00%,2,0,100.00%
95.push2his.eastmoney.com,2,0.00%,2,0,100.00%
76.push2his.eastmoney.com,2,0.00%,2,0,100.00%
pc.profile.pinyin.sogou.com,2,0.00%,2,0,100.00%
pinyin.sogou.com,2,0.00%,2,0,100.00%
sgp11.graniterapids.com,2,0.00%,2,0,100.00%
ip1865110026.funshion.com,2,0.00%,2,0,100.00%
upload-va.synacast.com,2,0.00%,2,0,100.00%
gss0.baidu.com,2,0.00%,2,0,100.00%
bkimg.cdn.bcebos.com,2,0.00%,2,0,100.00%
baikebcs.cdn.bcebos.com,2,0.00%,2,0,100.00%
tangram-config.gdt.qq.com,2,0.00%,2,0,100.00%
photocdn.hd.sohu.com,2,0.00%,5,3,40.00%
idp.springer.com,2,0.00%,2,0,100.00%
any.cdn-go.cn.sched.legopic1-dk.tdnsv6.com,2,0.00%,4,2,50.00%
api.geetest.com,2,0.00%,2,0,100.00%
o1069899.ingest.sentry.io,2,0.00%,2,0,100.00%
s2.hdslb.com,2,0.00%,2,0,100.00%
vcode-od.vivo.com.cn,2,0.00%,2,0,100.00%
db.auto.sina.com.cn,2,0.00%,2,0,100.00%
help.apple.com,2,0.00%,2,0,100.00%
e11408.d.akamaiedge.net,2,0.00%,2,0,100.00%
s.auto.sina.com.cn,2,0.00%,2,0,100.00%
pcstat.kugou.com,2,0.00%,2,0,100.00%
msg.csw.lenovo.com,2,0.00%,2,0,100.00%
download.api.bsb.baidu.com,2,0.00%,2,0,100.00%
dasheng03.com,2,0.00%,2,0,100.00%
startpage.foxitsoftware.com,2,0.00%,2,0,100.00%
ad.foxitreader.cn,2,0.00%,2,0,100.00%
globe-request.foxitservice.com,2,0.00%,2,0,100.00%
tv.360.cn,2,0.00%,2,0,100.00%
lookup-api.apple.com.edgekey.net,2,0.00%,2,0,100.00%
e16991.b.akamaiedge.net,2,0.00%,2,0,100.00%
app.wpscdn.cn,2,0.00%,4,2,50.00%
g1xd.mediav.com,2,0.00%,2,0,100.00%
xmpp007.hpeprint.com,2,0.00%,2,0,100.00%
ping-edge.smartscreen.microsoft.com,2,0.00%,2,0,100.00%
s19.cnzz.com,2,0.00%,2,0,100.00%
img.nga.178.com,2,0.00%,2,0,100.00%
www.baomi.org.cn,2,0.00%,2,0,100.00%
www.nsstec.org.cn,2,0.00%,2,0,100.00%
predownload-admin.g.mi.com,2,0.00%,2,0,100.00%
cloudcontrol.ai.xiaomi.com,2,0.00%,2,0,100.00%
pdc.micloud.xiaomi.net,2,0.00%,2,0,100.00%
galleryapi.micloud.xiaomi.net,2,0.00%,2,0,100.00%
api.ad.xiaomi.com,2,0.00%,2,0,100.00%
wifiapi.micloud.xiaomi.net,2,0.00%,2,0,100.00%
smsapi.micloud.xiaomi.net,2,0.00%,2,0,100.00%
bkvv.video.qq.com,2,0.00%,2,0,100.00%
33.push2his.eastmoney.com,2,0.00%,2,0,100.00%
softcenter.os3.win.nfschina.com,2,0.00%,2,0,100.00%
3.push2his.eastmoney.com,2,0.00%,2,0,100.00%
27.push2his.eastmoney.com,2,0.00%,2,0,100.00%
17.push2his.eastmoney.com,2,0.00%,2,0,100.00%
91.push2his.eastmoney.com,2,0.00%,2,0,100.00%
public-cdn.cloud.unitychina.cn,2,0.00%,2,0,100.00%
pc.ximalaya.com,2,0.00%,2,0,100.00%
ldc-fast.lenovo.com.cn,2,0.00%,2,0,100.00%
e8203.g.akamaiedge.net,2,0.00%,2,0,100.00%
ws.mmstat.com,2,0.00%,2,0,100.00%
38.courier-push-apple.com.akadns.net,2,0.00%,2,0,100.00%
onedscolprdneu03.northeurope.cloudapp.azure.com,2,0.00%,2,0,100.00%
3463d06de0ca9a15.jijifun.com,2,0.00%,2,0,100.00%
p36-imap.mail.me.com,2,0.00%,2,0,100.00%
p36-imap.mail.me.com.akadns.net,2,0.00%,2,0,100.00%
go.trouter.skype.com,2,0.00%,2,0,100.00%
oauth.intservices.aws.intellij.net,2,0.00%,2,0,100.00%
www.zybuluo.com,2,0.00%,2,0,100.00%
APAC05.azure-devices.net,2,0.00%,2,0,100.00%
telemetry.influxdata.com,2,0.00%,2,0,100.00%
archive.kylinos.cn,2,0.00%,2,0,100.00%
archive2.kylinos.cn,2,0.00%,2,0,100.00%
dl.ijinshan.com,2,0.00%,2,0,100.00%
cache.tv.qq.com,2,0.00%,3,1,66.67%
vm.gtimg.cn,2,0.00%,3,1,66.67%
grafana.net,2,0.00%,2,0,100.00%
33-courier.push.apple.com,2,0.00%,2,0,100.00%
stun.ekiga.net,2,0.00%,2,0,100.00%
firefox-settings-attachments.cdn.mozilla.net,2,0.00%,2,0,100.00%
tracker.openzim.org,2,0.00%,4,2,50.00%
signalings.verysync.cn,2,0.00%,2,0,100.00%
registry-1.docker.io,2,0.00%,2,0,100.00%
1.ubuntu.pool.ntp.org,2,0.00%,2,0,100.00%
s.xinshuru.com,2,0.00%,2,0,100.00%
mccontacts.mail.163.com,2,0.00%,2,0,100.00%
ccc.hpeprint.com,2,0.00%,2,0,100.00%
sp3.sangfor.com.cn,2,0.00%,2,0,100.00%
ocsp.digicert.cn,2,0.00%,2,0,100.00%
35-courier.push.apple.com,2,0.00%,2,0,100.00%
35.courier-push-apple.com.akadns.net,2,0.00%,2,0,100.00%
p213-quota.icloud.com.cn,2,0.00%,2,0,100.00%
api.appcues.net,2,0.00%,2,0,100.00%
mail.consearchgiffipic.ml,2,0.00%,2,0,100.00%
stun.chat.bilibili.com,2,0.00%,4,2,50.00%
pull-flv-l3-enc.douyincdn.com,2,0.00%,2,0,100.00%
pull-rtmp-f96.douyincdn.com,2,0.00%,2,0,100.00%
pull-rtmp-f13.douyincdn.com,2,0.00%,2,0,100.00%
push-rtmp-l6-enc.douyincdn.com,2,0.00%,2,0,100.00%
push-rtmp-hs-spe-f5.douyincdn.com,2,0.00%,2,0,100.00%
push-rtmp-hs-spe-f5.douyincdn.com.c.volcfcdndvs.com,2,0.00%,2,0,100.00%
push-rtmp-hs-f5-encryption.douyincdn.com,2,0.00%,2,0,100.00%
push-rtmp-hs-f5-encryption.douyincdn.com.c.volcfcdndvs.com,2,0.00%,2,0,100.00%
push-rtmp-f5.ihuoshanlive.com,2,0.00%,2,0,100.00%
push-rtmp-f5.ihuoshanlive.com.c.volcfcdndvs.com,2,0.00%,2,0,100.00%
pull-flv-vr-l26.douyincdn.com,2,0.00%,2,0,100.00%
pull-f5.douyincdn.com,2,0.00%,2,0,100.00%
pull-rtmp-f1.douyincdn.com,2,0.00%,2,0,100.00%
pull-rtmp-l1.ixigua.com,2,0.00%,2,0,100.00%
pull-hls-spe-l11.douyincdn.com,2,0.00%,2,0,100.00%
pull-hls-spe-l11.douyincdn.com.tlivecdn.com,2,0.00%,2,0,100.00%
pull-rtmp-l1-source.douyincdn.com,2,0.00%,2,0,100.00%
pull-flv-f96.douyincdn.com,2,0.00%,2,0,100.00%
pull-flv-f13.douyincdn.com,2,0.00%,2,0,100.00%
push-rtmp-hs-f5.huoshanlive.com,2,0.00%,2,0,100.00%
push-rtmp-l11-cny.douyincdn.com,2,0.00%,2,0,100.00%
push-rtmp-l6-cny.douyincdn.com,2,0.00%,2,0,100.00%
pull-flv-l11.douyincdn.com,2,0.00%,2,0,100.00%
pull-flv-l11.douyincdn.com.live.qcloudcdn.com,2,0.00%,2,0,100.00%
pull-flv-l11.douyincdn.com.sched.l10.tdnsv5.com,2,0.00%,2,0,100.00%
pull-hs-f5-encryption.flive.douyincdn.com,2,0.00%,2,0,100.00%
pull-hs-f5-encryption.flive.douyincdn.com.c.volcfcdndvs.com,2,0.00%,2,0,100.00%
pull-flv-f26.douyincdn.com,2,0.00%,2,0,100.00%
pull-hls-f6.douyincdn.com,2,0.00%,2,0,100.00%
pull-lls-spe-l1.douyincdn.com,2,0.00%,2,0,100.00%
pull-l3-cny.douyincdn.com,2,0.00%,2,0,100.00%
push-rtmp-hs-f5.douyincdn.com,2,0.00%,2,0,100.00%
pull-hs-f5.flive.douyincdn.com,2,0.00%,2,0,100.00%
pull-tsl-l11.douyincdn.com,2,0.00%,2,0,100.00%
pull-spe-l3.douyincdn.com,2,0.00%,2,0,100.00%
push-rtmp-vr-l1.douyincdn.com,2,0.00%,2,0,100.00%
pull-tsl-vr-l3.douyincdn.com,2,0.00%,2,0,100.00%
pull-vr-l3.douyincdn.com,2,0.00%,2,0,100.00%
push-rtmp-hs-vr-f5.douyincdn.com,2,0.00%,2,0,100.00%
pull-f3-hs.pstatp.com,2,0.00%,2,0,100.00%
pull-tsl-hs-spe-f5.douyincdn.com,2,0.00%,2,0,100.00%
id.rlcdn.com,2,0.00%,2,0,100.00%
pull-flv-l11-source.douyincdn.com,2,0.00%,2,0,100.00%
image6v2.pubmnet.com,2,0.00%,2,0,100.00%
pull-f3.douyincdn.com,2,0.00%,2,0,100.00%
pull-hls-f5-tsl.douyincdn.com,2,0.00%,2,0,100.00%
pull-hls-f5-vs-tsl.douyincdn.com,2,0.00%,2,0,100.00%
pull-rtmp-f26.douyincdn.com,2,0.00%,2,0,100.00%
pull-flv-l29.douyincdn.com,2,0.00%,2,0,100.00%
push-rtmp-f5-enc.douyincdn.com,2,0.00%,2,0,100.00%
push-rtmp-f5-enc.douyincdn.com.c.bytefcdn.com,2,0.00%,2,0,100.00%
pull-hls-vr-l11.douyincdn.com,2,0.00%,2,0,100.00%
pull-hls-vr-l11.douyincdn.com.tlivecdn.com,2,0.00%,2,0,100.00%
pull-f5-hot.flive.douyincdn.com,2,0.00%,2,0,100.00%
pull-flv-f5-enc.flive.douyincdn.com,2,0.00%,2,0,100.00%
pull-flv-vr-l11.douyincdn.com,2,0.00%,2,0,100.00%
pull-flv-l1-hs.pstatp.com,2,0.00%,2,0,100.00%
pull-rtmp-f1-hs.pstatp.com,2,0.00%,2,0,100.00%
pull-flv-spe-l26.douyincdn.com,2,0.00%,2,0,100.00%
pull-lls-l3.douyincdn.com,2,0.00%,2,0,100.00%
pull-hs-spe-f5.douyincdn.com,2,0.00%,2,0,100.00%
pull-hs-spe-f5.douyincdn.com.c.volcfcdndvs.com,2,0.00%,2,0,100.00%
onedscolprdeus13.eastus.cloudapp.azure.com,2,0.00%,2,0,100.00%
40.push2his.eastmoney.com,2,0.00%,2,0,100.00%
45.push2his.eastmoney.com,2,0.00%,2,0,100.00%
7.push2his.eastmoney.com,2,0.00%,2,0,100.00%
auth.hiwifi.com,2,0.00%,2,0,100.00%
18.push2his.eastmoney.com,2,0.00%,2,0,100.00%
14.push2his.eastmoney.com,2,0.00%,2,0,100.00%
55.push2his.eastmoney.com,2,0.00%,2,0,100.00%
48.push2his.eastmoney.com,2,0.00%,2,0,100.00%
kr10.graniterapids.com,2,0.00%,2,0,100.00%
adashx.ut.youku.com,2,0.00%,2,0,100.00%
odin.adobe.com,2,0.00%,2,0,100.00%
gasprice-proxy.herokuapp.com,2,0.00%,2,0,100.00%
fsigns.duba.net,2,0.00%,2,0,100.00%
manga.bilibili.com,2,0.00%,2,0,100.00%
search.bilibili.com,2,0.00%,4,2,50.00%
le3-api.game.bilibili.com,2,0.00%,2,0,100.00%
signlr-prod.core.vsengsaas.visualstudio.com,2,0.00%,2,0,100.00%
res-scanner.zhhainiao.com,2,0.00%,4,2,50.00%
api.my.avira.com,2,0.00%,2,0,100.00%
c124a10e0db5e4b9.jijifun.com,2,0.00%,2,0,100.00%
hub5pn.sandai.net,2,0.00%,2,0,100.00%
mail.ios.ac.cn,2,0.00%,2,0,100.00%
s1.cn.bing.net,2,0.00%,2,0,100.00%
e6e8c2dbaa69376ff90536bbc0eec4a0.clo.footprintdns.com,2,0.00%,2,0,100.00%
d3661cdf4a1387e40907d880475ef37e.nrb.footprintdns.com,2,0.00%,4,2,50.00%
upos-sz-mirrorali.bilivideo.com.w.kunluncan.com,2,0.00%,2,0,100.00%
spt.service.kugou.com,2,0.00%,2,0,100.00%
union-click.jd.com,2,0.00%,2,0,100.00%
cloud.tenable.com,2,0.00%,2,0,100.00%
hivoice-drcn.emui.dbankcloud.com,2,0.00%,2,0,100.00%
common.docer.wps.cn,2,0.00%,2,0,100.00%
gecko-pangle-hl.snssdk.com,2,0.00%,2,0,100.00%
movie.douban.com,2,0.00%,2,0,100.00%
m.douban.com,2,0.00%,2,0,100.00%
fundin.douban.com,2,0.00%,2,0,100.00%
api.health.comm.miui.com,2,0.00%,2,0,100.00%
vip-rec.ksord.com,2,0.00%,2,0,100.00%
nav.smartscreen.microsoft.com,2,0.00%,2,0,100.00%
fp.msedge.net,2,0.00%,2,0,100.00%
www.aminer.cn,2,0.00%,2,0,100.00%
www.ict.ac.cn,2,0.00%,2,0,100.00%
filedownload.csw.lenovo.com,2,0.00%,2,0,100.00%
data.ie.sogou.com,2,0.00%,2,0,100.00%
v9-default.365yg.com,2,0.00%,2,0,100.00%
extie.sogoucdn.com,2,0.00%,2,0,100.00%
infoc0.duba.net,2,0.00%,2,0,100.00%
nd-static.bdstatic.com,2,0.00%,2,0,100.00%
webpush.pan.baidu.com,2,0.00%,2,0,100.00%
xlab.baidu.com,2,0.00%,2,0,100.00%
m.xinminweekly.com.cn,2,0.00%,2,0,100.00%
contentcenter-videovali-drcn.dbankcdn.cn,2,0.00%,4,2,50.00%
misc.xinmin.cn,2,0.00%,2,0,100.00%
tongji.xinmin.cn,2,0.00%,2,0,100.00%
rb122n.jomodns.com,2,0.00%,2,0,100.00%
qd.baidupcs.com,2,0.00%,2,0,100.00%
www.baidupcs.com,2,0.00%,2,0,100.00%
vp.hexin.cn,2,0.00%,2,0,100.00%
cdn.ghostery.com,2,0.00%,4,2,50.00%
configsvr.msf.3g.qq.com,2,0.00%,2,0,100.00%
clickstream-data.srcgsre.com,2,0.00%,2,0,100.00%
81.push2his.eastmoney.com,2,0.00%,2,0,100.00%
59.push2his.eastmoney.com,2,0.00%,2,0,100.00%
disc601.prod.do.dsp.mp.microsoft.com,2,0.00%,2,0,100.00%
disc601.prod.do.dsp.mp.microsoft.com.edgekey.net,2,0.00%,2,0,100.00%
e12358.g.akamaiedge.net,2,0.00%,2,0,100.00%
20.courier-push-apple.com.akadns.net,2,0.00%,2,0,100.00%
prod.mrodevicemgr.live.com.akadns.net,2,0.00%,4,2,50.00%
fa000000005.resources.office.net,2,0.00%,4,2,50.00%
10.courier-push-apple.com.akadns.net,2,0.00%,2,0,100.00%
gateway.battlenet.com.cn,2,0.00%,2,0,100.00%
a1737.b.akamai.net,2,0.00%,2,0,100.00%
api.webtest.net.edgekey.net,2,0.00%,2,0,100.00%
e96286.i.akamaiedge.net,2,0.00%,2,0,100.00%
down.anticheatexpert.com.wsdvs.com,2,0.00%,2,0,100.00%
seupdate.360qhcdn.com,2,0.00%,2,0,100.00%
8.courier-push-apple.com.akadns.net,2,0.00%,2,0,100.00%
33.courier-push-apple.com.akadns.net,2,0.00%,2,0,100.00%
valid.origin-apple.com.akadns.net,2,0.00%,2,0,100.00%
valid-cn.origin-apple.com.akadns.net,2,0.00%,2,0,100.00%
12-courier.push.apple.com,2,0.00%,2,0,100.00%
dc1-file.ksn.kaspersky-labs.com,2,0.00%,2,0,100.00%
onedriveclucprodbn20027.blob.core.windows.net,2,0.00%,2,0,100.00%
beta.audiobro.com,2,0.00%,2,0,100.00%
ocws.officeapps.live.com,2,0.00%,2,0,100.00%
ichannel.snssdk.com,2,0.00%,2,0,100.00%
tracker.pussytorrents.org,2,0.00%,3,1,66.67%
discovery-v4-2.verysync.cn,2,0.00%,2,0,100.00%
opentracker.acgnx.se,2,0.00%,4,2,50.00%
www.kanjiantu.com,2,0.00%,2,0,100.00%
ccm-frontier-hl.feishu.cn,2,0.00%,2,0,100.00%
umdc.alibaba-inc.com,2,0.00%,2,0,100.00%
mozilla.org,1,0.00%,1,0,100.00%
livegetwesteurope.cloudapp.net,1,0.00%,1,0,100.00%
sa2-prod-msgsearch-1.cloudapp.net,1,0.00%,1,0,100.00%
sconsentit911.cloudapp.net,1,0.00%,1,0,100.00%
k-9999.k-msedge.net,1,0.00%,1,0,100.00%
people-service-prod-asse-arm-a.southeastasia.cloudapp.azure.com,1,0.00%,1,0,100.00%
ip.azeus1-client-s.msnmessenger.msn.com.akadns.net,1,0.00%,1,0,100.00%
fpc.msedge.net,1,0.00%,2,1,50.00%
4.perf.msedge.net,1,0.00%,2,1,50.00%
b-aps-asea-01-skype.cloudapp.net,1,0.00%,1,0,100.00%
cn-sdyt-cu-01-26.bilivideo.com,1,0.00%,1,0,100.00%
gsas.idms-apple.com.akadns.net,1,0.00%,1,0,100.00%
browser.pipe.aria.microsoft.com,1,0.00%,2,1,50.00%
browser.events.data.trafficmanager.net,1,0.00%,2,1,50.00%
teams-events-data.trafficmanager.net,1,0.00%,2,1,50.00%
onedscolprdeus12.eastus.cloudapp.azure.com,1,0.00%,1,0,100.00%
e11294.g.akamaiedge.net,1,0.00%,1,0,100.00%
jnn-pa.googleapis.com,1,0.00%,2,1,50.00%
lcs-cops.adobe.io,1,0.00%,1,0,100.00%
frenchofengland.ace.fordham.edu,1,0.00%,1,0,100.00%
gsp64-ssl.ls.apple.com,1,0.00%,1,0,100.00%
edifice.opencityapps.org,1,0.00%,1,0,100.00%
www.blackcats-games.net,1,0.00%,1,0,100.00%
tracker.lelux.fi,1,0.00%,1,0,100.00%
silk.lx.netease.com,1,0.00%,1,0,100.00%
bigdata.g60.letvlb.com,1,0.00%,1,0,100.00%
notify3.note.youdao.com,1,0.00%,2,1,50.00%
onedscolprdfrc06.francecentral.cloudapp.azure.com,1,0.00%,1,0,100.00%
www.cntv.cn,1,0.00%,2,1,50.00%
tv.sohu.com,1,0.00%,2,1,50.00%
gs.a.sohu.com,1,0.00%,2,1,50.00%
bl3301.storage.live.com,1,0.00%,2,1,50.00%
www.126.com,1,0.00%,1,0,100.00%
any.edge.bing.com,1,0.00%,1,0,100.00%
mms-voice.cdn.bcebos.com,1,0.00%,1,0,100.00%
openlocation-drcn.platform.dbankcloud.com,1,0.00%,2,1,50.00%
onedscolprdeus08.eastus.cloudapp.azure.com,1,0.00%,2,1,50.00%
bn02pap001.storage.live.com,1,0.00%,2,1,50.00%
biociclo.agri.cl,1,0.00%,1,0,100.00%
cainiao-app-logs.cn-zhangjiakou.log.aliyuncs.com,1,0.00%,1,0,100.00%
iknowpc.bdimg.com,1,0.00%,1,0,100.00%
gss0.bdstatic.com,1,0.00%,1,0,100.00%
himg.bdimg.com,1,0.00%,3,2,33.33%
31-courier.push.apple.com,1,0.00%,1,0,100.00%
p3.a.yximgs.com,1,0.00%,3,2,33.33%
www.kuaishou.com,1,0.00%,1,0,100.00%
hq.sinajs.cn,1,0.00%,1,0,100.00%
onedscolprdgwc05.germanywestcentral.cloudapp.azure.com,1,0.00%,1,0,100.00%
ib.anycast.adnxs.com,1,0.00%,1,0,100.00%
dnkeeper.platform.dbankcloud.cn,1,0.00%,1,0,100.00%
hag-drcn.op.hicloud.com,1,0.00%,1,0,100.00%
metrics1.data.hicloud.com,1,0.00%,1,0,100.00%
ac-mqgidvz-shard-00-00.nmmxpgl.mongodb.net,1,0.00%,1,0,100.00%
ac-mqgidvz-shard-00-01.nmmxpgl.mongodb.net,1,0.00%,1,0,100.00%
ac-mqgidvz-shard-00-02.nmmxpgl.mongodb.net,1,0.00%,1,0,100.00%
genuine.adobe.com,1,0.00%,1,0,100.00%
gocart-web-prod-ue1-477818442.us-east-1.elb.amazonaws.com,1,0.00%,1,0,100.00%
api.im.qcloud.com,1,0.00%,1,0,100.00%
zn_0pxrmhobblncaad-hpsupport.siteintercept.qualtrics.com,1,0.00%,1,0,100.00%
udc-neb.kampyle.com,1,0.00%,1,0,100.00%
siteintercept.qualtrics.com,1,0.00%,1,0,100.00%
rc10-g5.oray.com,1,0.00%,1,0,100.00%
wx1.sinaimg.cn,1,0.00%,7,6,14.29%
h5.sinaimg.cn,1,0.00%,6,5,16.67%
www.amap.com,1,0.00%,1,0,100.00%
a.amap.com,1,0.00%,1,0,100.00%
log.mmstat.com,1,0.00%,1,0,100.00%
w.cnzz.com,1,0.00%,1,0,100.00%
p5.a.yximgs.com,1,0.00%,1,0,100.00%
oimagec1.ydstatic.com,1,0.00%,1,0,100.00%
dsp-impr2.youdao.com,1,0.00%,1,0,100.00%
ws-keyboard.shouji.sogou.com,1,0.00%,1,0,100.00%
mercury.jd.com,1,0.00%,1,0,100.00%
cd.jd.com,1,0.00%,1,0,100.00%
club.jd.com,1,0.00%,1,0,100.00%
question.jd.com,1,0.00%,1,0,100.00%
img30.360buyimg.com,1,0.00%,1,0,100.00%
fts.jd.com,1,0.00%,1,0,100.00%
www.iie.cas.cn,1,0.00%,1,0,100.00%
iie.arp.cn,1,0.00%,1,0,100.00%
cdn1.ime.sogou.com,1,0.00%,1,0,100.00%
gia.jd.com,1,0.00%,1,0,100.00%
mall.jd.com,1,0.00%,1,0,100.00%
chat1.jd.com,1,0.00%,1,0,100.00%
passport.jd.com,1,0.00%,1,0,100.00%
misc.360buyimg.com,1,0.00%,1,0,100.00%
jscss.360buyimg.com,1,0.00%,1,0,100.00%
prod.roaming1.live.com.akadns.net,1,0.00%,1,0,100.00%
asia.roaming1.live.com.akadns.net,1,0.00%,1,0,100.00%
gias.jd.com,1,0.00%,1,0,100.00%
img20.360buyimg.com,1,0.00%,1,0,100.00%
cds.3.cn,1,0.00%,1,0,100.00%
wl.jd.com,1,0.00%,1,0,100.00%
blackhole-m.m.jd.com,1,0.00%,1,0,100.00%
f-mall.jd.com,1,0.00%,1,0,100.00%
module-jshop.jd.com,1,0.00%,1,0,100.00%
jscss.jd.com,1,0.00%,1,0,100.00%
cart.jd.com,1,0.00%,1,0,100.00%
static.360buyimg.com,1,0.00%,1,0,100.00%
qrimg.jd.com,1,0.00%,1,0,100.00%
wd-prod-cp-as-southeast-4-fe.southeastasia.cloudapp.azure.com,1,0.00%,1,0,100.00%
v1.kwaicdn.com,1,0.00%,2,1,50.00%
cn-zjk-ali-r001.router.teamviewer.cn,1,0.00%,1,0,100.00%
search.ecnu.cf,1,0.00%,1,0,100.00%
1266287590.rsc.cdn77.org,1,0.00%,2,1,50.00%
images.ppa030cjklwmlkkluiiah3nddnc.com,1,0.00%,1,0,100.00%
cf.aliyun.com,1,0.00%,2,1,50.00%
aeis.alicdn.com,1,0.00%,2,1,50.00%
static.ppa030cjklwmlkkluiiah3nddnc.com,1,0.00%,1,0,100.00%
linux.kite.com,1,0.00%,1,0,100.00%
t.vip.com,1,0.00%,1,0,100.00%
ms.vipstatic.com,1,0.00%,1,0,100.00%
a.vpimg1.com,1,0.00%,1,0,100.00%
sc.appvipshop.com,1,0.00%,1,0,100.00%
a.vpimg2.com,1,0.00%,1,0,100.00%
acs.vip.com,1,0.00%,1,0,100.00%
blog.vip.com,1,0.00%,1,0,100.00%
detail.vip.com,1,0.00%,1,0,100.00%
h5rsc.vip.com,1,0.00%,1,0,100.00%
help.vip.com,1,0.00%,1,0,100.00%
iclub.vip.com,1,0.00%,1,0,100.00%
ips.corp.vipshop.com,1,0.00%,1,0,100.00%
m.vip.com,1,0.00%,1,0,100.00%
order.vip.com,1,0.00%,1,0,100.00%
b.appsimg.com,1,0.00%,1,0,100.00%
h2.appsimg.com,1,0.00%,1,0,100.00%
skin.se.360.cn,1,0.00%,1,0,100.00%
pcapi.vip.com,1,0.00%,1,0,100.00%
s2.vipstatic.com,1,0.00%,1,0,100.00%
jr.vip.com,1,0.00%,1,0,100.00%
myvpal.vip.com,1,0.00%,1,0,100.00%
passport.vip.com,1,0.00%,1,0,100.00%
category.vip.com,1,0.00%,1,0,100.00%
pgdt.gtimg.cn,1,0.00%,1,0,100.00%
stackoverflow.com,1,0.00%,1,0,100.00%
job.vip.com,1,0.00%,1,0,100.00%
xyt.xinchacha.com,1,0.00%,1,0,100.00%
lapp.corp.vipshop.com,1,0.00%,1,0,100.00%
weiquan.vip.com,1,0.00%,1,0,100.00%
www.12377.cn,1,0.00%,2,1,50.00%
www.beian.gov.cn,1,0.00%,1,0,100.00%
www.gdjubao.cn,1,0.00%,1,0,100.00%
400.vip.com,1,0.00%,1,0,100.00%
xms.17win.com,1,0.00%,1,0,100.00%
184-15-25-249.dr01.chtn.wv.frontiernet.net,1,0.00%,1,0,100.00%
site.browser.360.cn,1,0.00%,1,0,100.00%
conf.cipsup.cn,1,0.00%,1,0,100.00%
log.ys7.com,1,0.00%,1,0,100.00%
tracker.zemoj.com,1,0.00%,1,0,100.00%
vps02.net.orel.ru,1,0.00%,1,0,100.00%
bubu.mapfactor.com,1,0.00%,1,0,100.00%
fe.dealclub.de,1,0.00%,1,0,100.00%
mts.tvbit.co,1,0.00%,1,0,100.00%
comtrade.un.org,1,0.00%,1,0,100.00%
u.zyinfotech.com,1,0.00%,1,0,100.00%
www.81.cn,1,0.00%,2,1,50.00%
mp.360.cn,1,0.00%,1,0,100.00%
msgcenter.wps.cn,1,0.00%,1,0,100.00%
log.u.wps.cn,1,0.00%,1,0,100.00%
update2.sangfor.net,1,0.00%,1,0,100.00%
update3.sangfor.net,1,0.00%,1,0,100.00%
smtp.cstnet.cn,1,0.00%,1,0,100.00%
wxsnsdy.wxs.qq.com,1,0.00%,2,1,50.00%
uhf.microsoft.com,1,0.00%,2,1,50.00%
static.bshare.cn,1,0.00%,1,0,100.00%
apps.mzstatic.com,1,0.00%,2,1,50.00%
www.bangkokbank.com,1,0.00%,1,0,100.00%
d33vwaa6rdensn.cloudfront.net,1,0.00%,1,0,100.00%
www.360kuai.com,1,0.00%,1,0,100.00%
www.amazon.co,1,0.00%,1,0,100.00%
data.osdknw.com,1,0.00%,1,0,100.00%
addons.g-fox.cn.w.kunlunca.com,1,0.00%,1,0,100.00%
bookmarks-ssl.firefoxchina.cn.wswebpic.com,1,0.00%,1,0,100.00%
www.download.windowsupdate.com,1,0.00%,2,1,50.00%
offlintab.firefoxchina.cn.wscdns.com,1,0.00%,1,0,100.00%
img1.wywyx.com.w.kunlunca.com,1,0.00%,1,0,100.00%
c.bing.com,1,0.00%,10,9,10.00%
zoom.us,1,0.00%,1,0,100.00%
sp3.baidu.com,1,0.00%,2,1,50.00%
api.wallpaper.xzdesktop.cqttech.com,1,0.00%,1,0,100.00%
darwin.qianxin.com,1,0.00%,1,0,100.00%
wd-prod-cp-as-southeast-1-fe.southeastasia.cloudapp.azure.com,1,0.00%,1,0,100.00%
fg.download.windowsupdate.com.mwcname.com,1,0.00%,2,1,50.00%
onedscolprdjpe04.japaneast.cloudapp.azure.com,1,0.00%,1,0,100.00%
blob.dsm07prdstr09a.store.core.windows.net,1,0.00%,1,0,100.00%
init-cdn.itunes-apple.com.akadns.net,1,0.00%,2,1,50.00%
settings-prod-eus2-2.eastus2.cloudapp.azure.com,1,0.00%,1,0,100.00%
oneocsp-microsoft-com.a-0003.a-msedge.net,1,0.00%,2,1,50.00%
wd-prod-ss-as-southeast-3-fe.southeastasia.cloudapp.azure.com,1,0.00%,1,0,100.00%
dailyupdate.wangwang.taobao.com.danuoyi.tbcache.com,1,0.00%,1,0,100.00%
configuration-server-lb-1105093370.us-east-1.elb.amazonaws.com,1,0.00%,1,0,100.00%
autodiscover.ios.ac.cn,1,0.00%,1,0,100.00%
tracker.opentrackr.org,1,0.00%,1,0,100.00%
anv.duba.net,1,0.00%,1,0,100.00%
shop.darickpay.com,1,0.00%,1,0,100.00%
swupmf.adobe.com,1,0.00%,2,1,50.00%
teams.events.data.microsoft.com,1,0.00%,2,1,50.00%
ac-dun.security.ntes53.netease.com,1,0.00%,2,1,50.00%
loc.map.baidu.com,1,0.00%,4,3,25.00%
mcs.zijieapi.com,1,0.00%,2,1,50.00%
driverupdate.lenovo.com.cn,1,0.00%,2,1,50.00%
wildcard46.go-mpulse.net.edgekey.net,1,0.00%,2,1,50.00%
dm2306.storage.live.com,1,0.00%,1,0,100.00%
onedriveclucproddm20009.blob.core.windows.net,1,0.00%,1,0,100.00%
ieonlinews.trafficmanager.NET,1,0.00%,2,1,50.00%
smartdl.lenovo.com.cn,1,0.00%,1,0,100.00%
8.push2his.eastmoney.com,1,0.00%,1,0,100.00%
softm.update.360safe.com,1,0.00%,1,0,100.00%
docs.live.net,1,0.00%,2,1,50.00%
common-afd.fe.1drv.com,1,0.00%,2,1,50.00%
logintcp.wps.cn,1,0.00%,1,0,100.00%
www.meituan.com,1,0.00%,16,15,6.25%
w3.wild2home.ga,1,0.00%,1,0,100.00%
twct09.graniterapids.com,1,0.00%,1,0,100.00%
chihaya-heroku.120181311.xyz,1,0.00%,2,1,50.00%
onedscolprdeus03.eastus.cloudapp.azure.com,1,0.00%,2,1,50.00%
onedscolprdjpw00.japanwest.cloudapp.azure.com,1,0.00%,1,0,100.00%
basictransl.wps.cn,1,0.00%,1,0,100.00%
p.clkservice.youdao.com,1,0.00%,1,0,100.00%
bingwallpaper.microsoft.com,1,0.00%,1,0,100.00%
cn-pek-ali-r009.router.teamviewer.cn,1,0.00%,1,0,100.00%
pop.cstnet.cn,1,0.00%,1,0,100.00%
cdn.jwplayer.com,1,0.00%,2,1,50.00%
mq.focustodo.net,1,0.00%,1,0,100.00%
msg-push.duba.net,1,0.00%,1,0,100.00%
armmf.adobe.com,1,0.00%,3,2,33.33%
www2.deepl.com,1,0.00%,1,0,100.00%
service.lx.qianxin.com,1,0.00%,1,0,100.00%
mylittleslaveponny.club,1,0.00%,1,0,100.00%
p3-sign.toutiaoimg.com,1,0.00%,2,1,50.00%
p3-sign.toutiaoimg.com.w.alikunlun.com,1,0.00%,2,1,50.00%
globalsign.com.w.kunlunar.com,1,0.00%,1,0,100.00%
slink.gifshow.com,1,0.00%,1,0,100.00%
slink.ksapisrv.com,1,0.00%,1,0,100.00%
kuaishou.com,1,0.00%,1,0,100.00%
google.com,1,0.00%,2,1,50.00%
apps.arp.cn,1,0.00%,1,0,100.00%
wWw.vod.LxdNS.Com,1,0.00%,2,1,50.00%
mobile-gtalk.l.google.com,1,0.00%,3,2,33.33%
apd-vlive.apdcdn.tc.qq.com,1,0.00%,2,1,50.00%
latexlive-resourse.oss-cn-beijing.aliyuncs.com,1,0.00%,1,0,100.00%
tls-eleme.dingtalk.com,1,0.00%,1,0,100.00%
adashx.ut.ele.me,1,0.00%,1,0,100.00%
www.overleaf.com,1,0.00%,1,0,100.00%
wx.conn.wemeet.tencent.com,1,0.00%,1,0,100.00%
supl.bd-caict.com,1,0.00%,1,0,100.00%
t9.baidu.com.a.bdydns.com,1,0.00%,2,1,50.00%
t15.baidu.com.a.bdydns.com,1,0.00%,2,1,50.00%
hectorstatic.baidu.com.a.bdydns.com,1,0.00%,2,1,50.00%
bcstobos.jomodns.com,1,0.00%,2,1,50.00%
baijiahao.n.shifen.com,1,0.00%,1,0,100.00%
pics7.baidu.com,1,0.00%,2,1,50.00%
pic.rmb.bdstatic.com.a.bdydns.com,1,0.00%,2,1,50.00%
pics3.baidu.com,1,0.00%,2,1,50.00%
t11.baidu.com.a.bdydns.com,1,0.00%,2,1,50.00%
t12.baidu.com.a.bdydns.com,1,0.00%,2,1,50.00%
t10.baidu.com.a.bdydns.com,1,0.00%,2,1,50.00%
a.goscreenshotting.com,1,0.00%,1,0,100.00%
pcsdata.baidu.com,1,0.00%,6,5,16.67%
mobilegw.alipaydns.com,1,0.00%,1,0,100.00%
www.as.com,1,0.00%,1,0,100.00%
xy6hjm0xw4.feishu.cn,1,0.00%,1,0,100.00%
galaxy.safe.360.cn,1,0.00%,1,0,100.00%
browser-api.2345.cc,1,0.00%,1,0,100.00%
lc.tencent.com,1,0.00%,1,0,100.00%
ip2100177538.funshion.com,1,0.00%,1,0,100.00%
market.wsskj520.cn,1,0.00%,1,0,100.00%
api.msn.cn,1,0.00%,2,1,50.00%
img.4hou.com,1,0.00%,2,1,50.00%
tracker.torrentsnows.com,1,0.00%,1,0,100.00%
bigfoot1942.sektori.org,1,0.00%,2,1,50.00%
public.tracker.vraphim.com,1,0.00%,1,0,100.00%
vcode-or.vivo.com.cn,1,0.00%,1,0,100.00%
fanyi.baidu.com,1,0.00%,6,5,16.67%
nsp-hicloud-cloudbackupnorth4-p03-drcn.obs.cn-north-4.myhuaweicloud.com,1,0.00%,1,0,100.00%
nsp-hicloud-cloudphotonorth4-p03-drcn.obs.cn-north-4.myhuaweicloud.cn,1,0.00%,1,0,100.00%
metok.sys.miui.com,1,0.00%,1,0,100.00%
na1e.services.adobe.com,1,0.00%,1,0,100.00%
xtremewrestlingtorrents.net,1,0.00%,1,0,100.00%
jgw-drcn.jos.dbankcloud.cn,1,0.00%,1,0,100.00%
tracker.vectahosting.eu,1,0.00%,4,3,25.00%
gy.bzcv.cn,1,0.00%,1,0,100.00%
appcdcbjpip1.jianguoyun.com,1,0.00%,1,0,100.00%
beertracker.ml,1,0.00%,1,0,100.00%
analysis.leetcode.cn,1,0.00%,1,0,100.00%
apis.google.com,1,0.00%,1,0,100.00%
dblp.uni-trier.de,1,0.00%,1,0,100.00%
push.zhihu.com,1,0.00%,1,0,100.00%
e4094fc1d98c915a.ksyunad.com,1,0.00%,2,1,50.00%
google.cn,1,0.00%,2,1,50.00%
pan.cstcloud.cn,1,0.00%,1,0,100.00%
38.newspush.eastmoney.com,1,0.00%,1,0,100.00%
84.newspush.eastmoney.com,1,0.00%,1,0,100.00%
11.newspush.eastmoney.com,1,0.00%,1,0,100.00%
17.push2.eastmoney.com,1,0.00%,2,1,50.00%
43.push2.eastmoney.com,1,0.00%,2,1,50.00%
78.push2.eastmoney.com,1,0.00%,2,1,50.00%
14.newspush.eastmoney.com,1,0.00%,1,0,100.00%
86.push2.eastmoney.com,1,0.00%,2,1,50.00%
47.push2.eastmoney.com,1,0.00%,2,1,50.00%
83.newspush.eastmoney.com,1,0.00%,1,0,100.00%
73.newspush.eastmoney.com,1,0.00%,1,0,100.00%
63.newspush.eastmoney.com,1,0.00%,1,0,100.00%
7.newspush.eastmoney.com,1,0.00%,1,0,100.00%
80.newspush.eastmoney.com,1,0.00%,1,0,100.00%
27.newspush.eastmoney.com,1,0.00%,1,0,100.00%
41.newspush.eastmoney.com,1,0.00%,1,0,100.00%
nsclick.baidu.com,1,0.00%,5,4,20.00%
outlook-com.olc.protection.outlook.com,1,0.00%,1,0,100.00%
dl.360safe.com.qh-cdn.com,1,0.00%,2,1,50.00%
dl.360safe.com.dl.360qhcdn.com,1,0.00%,2,1,50.00%
stocks-data-service.apple.com,1,0.00%,2,1,50.00%
i-dsm01p-cor005.api.p001.1drv.com,1,0.00%,1,0,100.00%
onedscolprdweu00.westeurope.cloudapp.azure.com,1,0.00%,1,0,100.00%
kt-prod.v.aaplimg.com,1,0.00%,1,0,100.00%
publicassets.cdn-apple.com,1,0.00%,2,1,50.00%
publicassets.lb-apple.com.akadns.net,1,0.00%,2,1,50.00%
publicassets-cn.lb-apple.com.akadns.net,1,0.00%,2,1,50.00%
k128.gslb.ksyuncdn.com,1,0.00%,2,1,50.00%
akn.safe.360.cn,1,0.00%,1,0,100.00%
resources.office.net.edgekey.net,1,0.00%,2,1,50.00%
hkt.test.gotochinatown.net,1,0.00%,1,0,100.00%
us2.test.gotochinatown.net,1,0.00%,1,0,100.00%
pccw.test.gotochinatown.net,1,0.00%,1,0,100.00%
static.dataservices.hp.com,1,0.00%,2,1,50.00%
nine.littlenetwork.ml,1,0.00%,1,0,100.00%
g.api.mega.co.nz,1,0.00%,4,3,25.00%
mail.14alledufreee.ml,1,0.00%,1,0,100.00%
imgcache.qq.com,1,0.00%,2,1,50.00%
cr.file.cloud.duba.net,1,0.00%,1,0,100.00%
newonboarding.socialacademy.me,1,0.00%,1,0,100.00%
maps.metager.de,1,0.00%,1,0,100.00%
map.baidu.com,1,0.00%,8,7,12.50%
ee15ba61-wschat-wschatalb-6fcf-2062696737.us-east-1.elb.amazonaws.com,1,0.00%,1,0,100.00%
p2p.hd.sohu.com.cn,1,0.00%,1,0,100.00%
rc10-linux.oray.com,1,0.00%,1,0,100.00%
docerad.wps.cn,1,0.00%,1,0,100.00%
1.openwrt.pool.ntp.org,1,0.00%,1,0,100.00%
yb-safe.2345.cc,1,0.00%,1,0,100.00%
bdns-dy-vod.bytegslb.com,1,0.00%,1,0,100.00%
push-fcdn-base3.s.bytefcdn.com,1,0.00%,1,0,100.00%
pull-fcdn-douyin-hot2.s.bytefcdn.com,1,0.00%,1,0,100.00%
ns5-65.akam.net,1,0.00%,1,0,100.00%
bag-smoot.v.aaplimg.com,1,0.00%,1,0,100.00%
production.skype-registar.akadns.net,1,0.00%,1,0,100.00%
v5-coldc.douyinvod.com,1,0.00%,2,1,50.00%
v5-coldc.douyinvod.com.zjgslb.com,1,0.00%,2,1,50.00%
dy-vod-coldc.bytegslb.com,1,0.00%,2,1,50.00%
bl6pcor003-meta.fe.1drv.com,1,0.00%,2,1,50.00%
sub1.bgp.netarch-alisc1-edge-lb.l.bytedns.net,1,0.00%,1,0,100.00%
aidc.origin-apple.com.akadns.net,1,0.00%,1,0,100.00%
safebrowsing.googleapis-cn.com,1,0.00%,4,3,25.00%
onedscolprduks05.uksouth.cloudapp.azure.com,1,0.00%,1,0,100.00%
user-data-apac-jp.bidswitch.net,1,0.00%,1,0,100.00%
inv-nets-sg-s1.admixer.net,1,0.00%,1,0,100.00%
rightmentalattitude.classic.kicksite.net,1,0.00%,1,0,100.00%
sync.adotmob.com,1,0.00%,1,0,100.00%
cookiesyncing-1395500543.us-east-1.elb.amazonaws.com,1,0.00%,1,0,100.00%
eu-u.openx.net,1,0.00%,1,0,100.00%
stocks-edge.news.apple-dns.net,1,0.00%,1,0,100.00%
api.openweathermap.org,1,0.00%,1,0,100.00%
mail.mydomain.com,1,0.00%,1,0,100.00%
mail.on101.co.uk,1,0.00%,1,0,100.00%
ipcdn.apple.com,1,0.00%,2,1,50.00%
ipcdn-lb.apple.com.akadns.net,1,0.00%,2,1,50.00%
onedscolprdneu04.northeurope.cloudapp.azure.com,1,0.00%,1,0,100.00%
jtypkz2w.sched.d2.tdnsdp1.cn.cjt.vwnti.yrzhcloud.cn,1,0.00%,1,0,100.00%
kjk3jf40.sched.sma-dk.tdnsstic1.cn.cjt.krcdn.idatacube.com,1,0.00%,2,1,50.00%
1610340737.D4EE073396E8.device.hiwifi.com,1,0.00%,1,0,100.00%
1610340758.D4EE073396E8.device.hiwifi.com,1,0.00%,1,0,100.00%
1610340779.D4EE073396E8.device.hiwifi.com,1,0.00%,1,0,100.00%
m.weibo.cn,1,0.00%,2,1,50.00%
weibo.cn,1,0.00%,2,1,50.00%
twct01.graniterapids.com,1,0.00%,1,0,100.00%
hd-084.stpl.net.pl,1,0.00%,1,0,100.00%
subca.crl.certum.pl,1,0.00%,2,1,50.00%
us02.graniterapids.com,1,0.00%,1,0,100.00%
ieeexplore.ieee.org,1,0.00%,2,1,50.00%
ml314.com,1,0.00%,1,0,100.00%
instantmessaging-pa.googleapis.com,1,0.00%,2,1,50.00%
w.usabilla.com,1,0.00%,1,0,100.00%
tx-nat.videojj.com,1,0.00%,1,0,100.00%
weu09-breeziest-in.cloudapp.net,1,0.00%,1,0,100.00%
speed.gsdk.qq.com,1,0.00%,1,0,100.00%
tools.tmga.qq.com,1,0.00%,1,0,100.00%
control.mna.qq.com,1,0.00%,1,0,100.00%
speed.ino.qq.com,1,0.00%,1,0,100.00%
m702.music.126.net,1,0.00%,2,1,50.00%
upos-sz-staticcos.bilivideo.com,1,0.00%,3,2,33.33%
sns-video-hw.xhscdn.com,1,0.00%,7,6,14.29%
sns-video-qc.xhscdn.com,1,0.00%,5,4,20.00%
array812.prod.do.dsp.mp.microsoft.com,1,0.00%,1,0,100.00%
music.cliggo.com,1,0.00%,1,0,100.00%
suggestion.baidu.com,1,0.00%,1,0,100.00%
csm.sg1.vip.prod.criteo.net,1,0.00%,1,0,100.00%
sourcegraph.com,1,0.00%,2,1,50.00%
home.mcafee.com,1,0.00%,1,0,100.00%
windows.policies.live.net,1,0.00%,1,0,100.00%
cohort.ccs.mcafee.com,1,0.00%,1,0,100.00%
cp501.prod.do.dsp.mp.microsoft.com,1,0.00%,1,0,100.00%
disc501.prod.do.dsp.mp.microsoft.com,1,0.00%,1,0,100.00%
p63-caldav.icloud.com,1,0.00%,2,1,50.00%
hector.baidu.com,1,0.00%,1,0,100.00%
remind.api.weibo.com,1,0.00%,2,1,50.00%
ryrc.ruijienetworks.com,1,0.00%,1,0,100.00%
jp.cloudss.online,1,0.00%,1,0,100.00%
ags.privatelink.msidentity.com,1,0.00%,2,1,50.00%
fclick.e.shifen.com,1,0.00%,1,0,100.00%
a-0005.a-msedge.net,1,0.00%,1,0,100.00%
appstream.ubuntu.com,1,0.00%,1,0,100.00%
kns.cnki.net,1,0.00%,1,0,100.00%
piccache.cnki.net,1,0.00%,1,0,100.00%
search.cnki.net,1,0.00%,1,0,100.00%
ishufang.cnki.net,1,0.00%,1,0,100.00%
t.cnki.net,1,0.00%,1,0,100.00%
recsys.cnki.net,1,0.00%,1,0,100.00%
a.cnki.net,1,0.00%,1,0,100.00%
tracker1.bt.moack.co.kr,1,0.00%,1,0,100.00%
bclearning.top,1,0.00%,1,0,100.00%
softwareupdate.vmware.com,1,0.00%,2,1,50.00%
gzjg.casholdings.com.cn,1,0.00%,1,0,100.00%
ipv6.open-internet.nl,1,0.00%,1,0,100.00%
qa.sockets.stackexchange.com,1,0.00%,1,0,100.00%
mirrorcoso1.acglego-dk.sched.tdnsv2.com,1,0.00%,2,1,50.00%
camera.lei001.com,1,0.00%,1,0,100.00%
mbmodule-openapi.paas.cmbchina.com,1,0.00%,1,0,100.00%
sodefaultwordapi.paas.cmbchina.com,1,0.00%,1,0,100.00%
ai.cmbchina.com,1,0.00%,1,0,100.00%
aegis.qq.com,1,0.00%,8,7,12.50%
ebank.sz1.cmbchina.com,1,0.00%,1,0,100.00%
netpay.cmbchina.com,1,0.00%,1,0,100.00%
settings-ssl.xboxlive.com,1,0.00%,2,1,50.00%
static.m.cmbchina.com,1,0.00%,1,0,100.00%
open.facedatabg.net,1,0.00%,1,0,100.00%
tracker.monitorit4.me,1,0.00%,1,0,100.00%
retracker.hotplug.ru,1,0.00%,2,1,50.00%
torr.ws,1,0.00%,1,0,100.00%
gameplayapi.intel.com,1,0.00%,2,1,50.00%
radarsubmissions.apple.com.akadns.net,1,0.00%,1,0,100.00%
tracker.ddunlimited.net,1,0.00%,1,0,100.00%
tracker.leech.ie,1,0.00%,1,0,100.00%
tracker.swateam.org.uk,1,0.00%,1,0,100.00%
klone-mobile-12.vapp-servers.com,1,0.00%,1,0,100.00%
lynxbee.com,1,0.00%,1,0,100.00%
askubuntu.com,1,0.00%,1,0,100.00%
pagead-googlehosted.l.google.com,1,0.00%,1,0,100.00%
pb-server.ezoic.com,1,0.00%,1,0,100.00%
sjc-direct-bgp.contextweb.com,1,0.00%,1,0,100.00%
prebid.media.net,1,0.00%,1,0,100.00%
bidder.sg1.vip.prod.criteo.com,1,0.00%,1,0,100.00%
rw-yieldmo-com-1673518954.ap-southeast-1.elb.amazonaws.com,1,0.00%,1,0,100.00%
g2.gumgum.com,1,0.00%,1,0,100.00%
096j513y4u62dz90.aliyunddos1017.com,1,0.00%,1,0,100.00%
log-upload.mihoyo.com,1,0.00%,1,0,100.00%
c.jia.mn,1,0.00%,1,0,100.00%
uf-api6-client.ksord.com,1,0.00%,1,0,100.00%
newsie.2345.com,1,0.00%,1,0,100.00%
E.ROOT-SERVERS.NET,1,0.00%,6,5,16.67%
G.ROOT-SERVERS.NET,1,0.00%,6,5,16.67%
6qnz2sy8.sched.d2.tdnsdp1.cn.cjt.vwnti.yrzhcloud.cn,1,0.00%,1,0,100.00%
settings-prod-cin-1.centralindia.cloudapp.azure.com,1,0.00%,1,0,100.00%
onedscolprduks00.uksouth.cloudapp.azure.com,1,0.00%,2,1,50.00%
launcher-public-service-prod.ak.epicgames.com,1,0.00%,2,1,50.00%
ak.epicgames.com.edgekey.net,1,0.00%,2,1,50.00%
cma.itunes.apple.com,1,0.00%,2,1,50.00%
cma-china.itunes-apple.com.akadns.net,1,0.00%,2,1,50.00%
cma-china-cdn.itunes-apple.com.akadns.net,1,0.00%,2,1,50.00%
maskells.luxuryrealestate.com,1,0.00%,1,0,100.00%
dev.sissai.com,1,0.00%,1,0,100.00%
js-agent.newrelic.com,1,0.00%,1,0,100.00%
stats.use-snip.com,1,0.00%,1,0,100.00%
fortimail.flashentertainment.com,1,0.00%,1,0,100.00%
ns3-38.azure-dns.org,1,0.00%,2,1,50.00%
sec23summer.usenix.hotcrp.com,1,0.00%,1,0,100.00%
ts-helper.2345.cc,1,0.00%,1,0,100.00%
wcdn.servyou.com.cn,1,0.00%,2,1,50.00%
sn.webrootcloudav.com,1,0.00%,1,0,100.00%
baileywood.co.uk,1,0.00%,1,0,100.00%
prod.fs.microsoft.com.akadns.NET,1,0.00%,1,0,100.00%
push.ynote.youdao.com,1,0.00%,1,0,100.00%
test.schoene-karten.com,1,0.00%,1,0,100.00%
uptime.sangfor.net,1,0.00%,1,0,100.00%
array512.prod.do.dsp.mp.microsoft.com,1,0.00%,1,0,100.00%
configserver.hicloud.com,1,0.00%,1,0,100.00%
v6-cold1.douyinvod.com,1,0.00%,2,1,50.00%
v6-cold1.douyinvod.com.download.ks-cdn.com,1,0.00%,2,1,50.00%
k2-dy-cold1-ml.gslb.ksyuncdn.com,1,0.00%,2,1,50.00%
v3-cold1.douyinvod.com,1,0.00%,2,1,50.00%
v3-cold1.douyinvod.com.w.kunluncan.com,1,0.00%,2,1,50.00%
link-dit3la5z.gaapqcloud.com,1,0.00%,1,0,100.00%
onedscolprdfrc05.francecentral.cloudapp.azure.com,1,0.00%,1,0,100.00%
iphone-ld.apple.com,1,0.00%,2,1,50.00%
iphone-ld.origin-apple.com.akadns.net,1,0.00%,2,1,50.00%
v6-cold2.douyinvod.com,1,0.00%,2,1,50.00%
v6-cold2.douyinvod.com.download.ks-cdn.com,1,0.00%,2,1,50.00%
query.ess-apple.com.akadns.net,1,0.00%,1,0,100.00%
v26-cold.douyinvod.com,1,0.00%,2,1,50.00%
v26-cold.douyinvod.com.c.cdnhwc1.com,1,0.00%,2,1,50.00%
hcdnv.zjtd04.v6.c.cdnhwc1.com,1,0.00%,2,1,50.00%
link-yqsx02.netease.im,1,0.00%,1,0,100.00%
inappcheck.itunes.apple.com.download.ks-cdn.com,1,0.00%,2,1,50.00%
k128-inapp.gslb.ksyuncdn.com,1,0.00%,2,1,50.00%
link.ntes53.netease.com,1,0.00%,1,0,100.00%
link-yqsx01.netease.im,1,0.00%,1,0,100.00%
outsea.yun-app.net,1,0.00%,1,0,100.00%
onedscolprdneu00.northeurope.cloudapp.azure.com,1,0.00%,1,0,100.00%
wx-love-ws.afunapp.com,1,0.00%,1,0,100.00%
wx-love-api.afunapp.com,1,0.00%,1,0,100.00%
onedscolprdfrc00.francecentral.cloudapp.azure.com,1,0.00%,1,0,100.00%
xmrj002.xmrth-node.xyz,1,0.00%,1,0,100.00%
pull-fcdn-douyin-base5.s.bytefcdn.com,1,0.00%,1,0,100.00%
wx-love-img.afunapp.com.w.alikunlun.com,1,0.00%,1,0,100.00%
push-fcdn-base2.s.bytefcdn.com,1,0.00%,1,0,100.00%
v11-cold1.douyinvod.com,1,0.00%,2,1,50.00%
v11-cold1.douyinvod.com.cdn.dnsv1.com,1,0.00%,2,1,50.00%
v11-cold1.sched.v4lego-dk.tdnsvod1.cn,1,0.00%,2,1,50.00%
pull-fcdn-douyin-hot1.s.bytefcdn.com,1,0.00%,1,0,100.00%
v27.douyinvod.com,1,0.00%,2,1,50.00%
v27.douyinvod.com.vod.galileo.jcloud-cdn.com,1,0.00%,2,1,50.00%
tt-vod-sched.jcloudimg.com,1,0.00%,2,1,50.00%
yunxin-data-live-126-net-yq.ntes53.netease.com,1,0.00%,1,0,100.00%
downloadapi.n.shifen.com,1,0.00%,1,0,100.00%
array507.prod.do.dsp.mp.microsoft.com,1,0.00%,1,0,100.00%
krgame02.graniterapids.com,1,0.00%,1,0,100.00%
pccw02.graniterapids.com,1,0.00%,1,0,100.00%
au02.graniterapids.com,1,0.00%,1,0,100.00%
fr02.graniterapids.com,1,0.00%,1,0,100.00%
krgame04.graniterapids.com,1,0.00%,1,0,100.00%
tw02.graniterapids.com,1,0.00%,1,0,100.00%
be01mr9s.sched.d2.tdnsdp1.cn.cjt.vwnti.yrzhcloud.cn,1,0.00%,1,0,100.00%
ca.gmdns.net,1,0.00%,1,0,100.00%
s3a.pstatp.com,1,0.00%,2,1,50.00%
silkroad.csdn.net,1,0.00%,1,0,100.00%
kunpeng.csdn.net,1,0.00%,1,0,100.00%
position.csdnimg.cn,1,0.00%,1,0,100.00%
msg.csdn.net,1,0.00%,1,0,100.00%
us1.gmdns.net,1,0.00%,1,0,100.00%
au.gmdns.net,1,0.00%,1,0,100.00%
de.gmdns.net,1,0.00%,1,0,100.00%
us2.gmdns.net,1,0.00%,1,0,100.00%
csdn.log-global.aliyuncs.com,1,0.00%,2,1,50.00%
redisdatarecall.csdn.net,1,0.00%,1,0,100.00%
wwads.cn,1,0.00%,1,0,100.00%
ipv46.fanyi-bfe.n.shifen.com,1,0.00%,2,1,50.00%
builds.parsecgaming.com,1,0.00%,2,1,50.00%
passport.n.shifen.com,1,0.00%,2,1,50.00%
qd-update.qq.com,1,0.00%,1,0,100.00%
bing.cn,1,0.00%,1,0,100.00%
c0.wp.com,1,0.00%,1,0,100.00%
s0.wp.com,1,0.00%,1,0,100.00%
stats.wp.com,1,0.00%,1,0,100.00%
i0.wp.com,1,0.00%,1,0,100.00%
pixel.wp.com,1,0.00%,1,0,100.00%
s8.files.wordpress.com,1,0.00%,1,0,100.00%
cn-0001.cn-msedge.net,1,0.00%,1,0,100.00%
geo-drcn.platform.hicloud.com,1,0.00%,1,0,100.00%
findermp.video.qq.com,1,0.00%,2,1,50.00%
ups.ksmobile.net,1,0.00%,2,1,50.00%
prod-streaming-video-msn-com.akamaized.net,1,0.00%,2,1,50.00%
deff.nelreports.net,1,0.00%,4,3,25.00%
nim-lbs-netease-im.ntes53.netease.com,1,0.00%,1,0,100.00%
crush.ntes53.netease.com,1,0.00%,1,0,100.00%
p1.music.126.net,1,0.00%,2,1,50.00%
weu014-breeziest-in.cloudapp.net,1,0.00%,1,0,100.00%
001.jiang2020.ga,1,0.00%,1,0,100.00%
v9-cold.douyinvod.com,1,0.00%,2,1,50.00%
v6.douyinvod.com,1,0.00%,2,1,50.00%
weather-edge.news.apple-dns.net,1,0.00%,1,0,100.00%
client-api.itunes.apple.com,1,0.00%,2,1,50.00%
i.w.bilicdn1.com,1,0.00%,2,1,50.00%
ipv6.msftncsi.com,1,0.00%,2,1,50.00%
e4805.dsca.akamaiedge.net,1,0.00%,2,1,50.00%
api.sobot.com,1,0.00%,1,0,100.00%
amp-api-edge.apps.apple.com,1,0.00%,2,1,50.00%
easyscholar.cc,1,0.00%,1,0,100.00%
i0.hdslb.com.04f6a54d.c.cdnhwc1.com,1,0.00%,2,1,50.00%
www-wide.l.google.com,1,0.00%,2,1,50.00%
crossmark.crossref.org,1,0.00%,1,0,100.00%
sl-collection.oray.net,1,0.00%,1,0,100.00%
tracker.sjtu.edu.cn,1,0.00%,1,0,100.00%
v2.sohu.com,1,0.00%,2,1,50.00%
share.jomodns.com,1,0.00%,1,0,100.00%
e2581.dscx.akamaiedge.net,1,0.00%,1,0,100.00%
onedscolprdeus01.eastus.cloudapp.azure.com,1,0.00%,2,1,50.00%
mam.ntes53.netease.com,1,0.00%,1,0,100.00%
onedscolprdweu05.westeurope.cloudapp.azure.com,1,0.00%,2,1,50.00%
ltzproxy.zhxcshop.com,1,0.00%,1,0,100.00%
cdn.apifox.cn,1,0.00%,2,1,50.00%
mambap2pvodmobile.8686c.com,1,0.00%,2,1,50.00%
sis.jpush.io,1,0.00%,1,0,100.00%
s-adashx.ut.taobao.com,1,0.00%,1,0,100.00%
a.shentonggo.cn,1,0.00%,1,0,100.00%
offline.specialcdnstatus.com,1,0.00%,1,0,100.00%
d2kaokxjvx18eu.cloudfront.net,1,0.00%,1,0,100.00%
kae.wpsdns.com,1,0.00%,1,0,100.00%
qing.wpsdns.com,1,0.00%,1,0,100.00%
startpage.ic.ksosoft.com,1,0.00%,1,0,100.00%
antispam.wanmei.com,1,0.00%,1,0,100.00%
apigtwb2c.us.dell.com,1,0.00%,1,0,100.00%
www.zotero.org,1,0.00%,1,0,100.00%
a1887.dscq.akamai.net.0.1.cn.akamaitech.net,1,0.00%,2,1,50.00%
ustc-edu-cn.mirror.aliyuncs.com,1,0.00%,1,0,100.00%
www.rndlgch.com,1,0.00%,1,0,100.00%
cloudconfig.jetbrains.com,1,0.00%,1,0,100.00%
cloudconfig-prod-alb-280729742.eu-west-1.elb.amazonaws.com,1,0.00%,1,0,100.00%
schemastore.org,1,0.00%,1,0,100.00%
canonical-bos01.cdn.snapcraftcontent.com,1,0.00%,1,0,100.00%
cdn.ap.bittorrent.com,1,0.00%,2,1,50.00%
195.sammentik.cf,1,0.00%,1,0,100.00%
tools.google.com,1,0.00%,2,1,50.00%
swallow-apple-com.v.aaplimg.com,1,0.00%,1,0,100.00%
naz.com.sa,1,0.00%,1,0,100.00%
15.expertcoach.ml,1,0.00%,1,0,100.00%
edge.skype.com,1,0.00%,2,1,50.00%
g.msn.com,1,0.00%,2,1,50.00%
sqm.telemetry.microsoft.com.nsatc.net,1,0.00%,1,0,100.00%
cl5.apple.com,1,0.00%,2,1,50.00%
cl5-cdn.origin-apple.com.akadns.net,1,0.00%,2,1,50.00%
fm.dl.126.net.w.cdngslb.com,1,0.00%,1,0,100.00%
iadsdk.qtlcdn.com,1,0.00%,1,0,100.00%
partiality.itunes-apple.com.akadns.net,1,0.00%,2,1,50.00%
um04.eset.com,1,0.00%,1,0,100.00%
um02.eset.com,1,0.00%,1,0,100.00%
um10.eset.com,1,0.00%,1,0,100.00%
safebrowsing.clients.google.com,1,0.00%,2,1,50.00%
um01.eset.com,1,0.00%,1,0,100.00%
um16.eset.com,1,0.00%,1,0,100.00%
um06.eset.com,1,0.00%,1,0,100.00%
um12.eset.com,1,0.00%,1,0,100.00%
docs.axisrooms.com,1,0.00%,1,0,100.00%
migration-geo-filter-prd.stargate.cse.ss-inf.net,1,0.00%,1,0,100.00%
livepatch.canonical.com,1,0.00%,1,0,100.00%
ns1-proddns.glbdns.o365filtering.com,1,0.00%,1,0,100.00%
ns2-proddns.glbdns.o365filtering.com,1,0.00%,1,0,100.00%
subscription.rhsm.redhat.com,1,0.00%,1,0,100.00%
access.fluidx.ai,1,0.00%,1,0,100.00%
ham-staging-oracle.redant.cloud,1,0.00%,1,0,100.00%
weather.ubuntukylin.com,1,0.00%,1,0,100.00%
jksb.v.zzu.edu.cn,1,0.00%,1,0,100.00%
autopush.prod.mozaws.NET,1,0.00%,1,0,100.00%
crl.apple.com,1,0.00%,2,1,50.00%
enterprise.proxmox.com,1,0.00%,2,1,50.00%
account-public-service-prod03.ol.epicgames.com,1,0.00%,1,0,100.00%
qinfo.wps.cn,1,0.00%,1,0,100.00%
array502.prod.do.dsp.mp.microsoft.com,1,0.00%,1,0,100.00%
alb-krmaiwe3bwhbkec015.cn-beijing.alb.aliyuncs.com,1,0.00%,1,0,100.00%
weu011-breeziest-in.cloudapp.net,1,0.00%,1,0,100.00%
api-access.pangolin-sdk-toutiao.com,1,0.00%,2,1,50.00%
dsp-x.jd.com.gslb.qianxun.com,1,0.00%,1,0,100.00%
xlog.jd.com.gslb.qianxun.com,1,0.00%,1,0,100.00%
ad.ntes53.netease.com,1,0.00%,1,0,100.00%
janapi.jd.com.gslb.qianxun.com,1,0.00%,1,0,100.00%
firebaseinstallations.googleapis.com,1,0.00%,2,1,50.00%
yqws126-dxospf.split.netease.com,1,0.00%,1,0,100.00%
p26-be-pack-sign.pglstatp-toutiao.com.51296c5e.c.cdnhwc1.com,1,0.00%,2,1,50.00%
hcdnw.zjtd01.gslb.c.cdnhwc2.com,1,0.00%,2,1,50.00%
log-api.pangolin-sdk-toutiao-b.com.bytedns1.com,1,0.00%,2,1,50.00%
blob.dz5prdstr06a.store.core.windows.net,1,0.00%,1,0,100.00%
nocdn-repository.gtm.eset.com,1,0.00%,1,0,100.00%
configuration.apple.com,1,0.00%,2,1,50.00%
configuration.apple.com.akadns.net,1,0.00%,2,1,50.00%
sconf.f.qh-lb.com,1,0.00%,1,0,100.00%
up-q.qh-lb.com,1,0.00%,1,0,100.00%
deepviz-nlb-prod-ap-southeast-1-f64fb66f5d07c49a.elb.ap-southeast-1.amazonaws.com,1,0.00%,1,0,100.00%
daodian.vip.meituan.com,1,0.00%,1,0,100.00%
toutiao.com,1,0.00%,1,0,100.00%
dispatcher.is.autonavi.com.gds.alibabadns.com,1,0.00%,1,0,100.00%
s.mzstatic.com,1,0.00%,2,1,50.00%
s.mzstatic.itunes-apple.com.akadns.net,1,0.00%,2,1,50.00%
s-china.mzstatic.itunes-apple.com.akadns.net,1,0.00%,2,1,50.00%
play.itunes.apple.com,1,0.00%,2,1,50.00%
play-cdn.itunes-apple.com.akadns.net,1,0.00%,2,1,50.00%
play-china.itunes-apple.com.akadns.net,1,0.00%,2,1,50.00%
weather-analytics-events.news.apple-dns.net,1,0.00%,1,0,100.00%
inappcheck.itunes.apple.com.w.alikunlun.com,1,0.00%,1,0,100.00%
v3-cold2.douyinvod.com.w.kunluncan.com,1,0.00%,2,1,50.00%
dy-vod-coldb.bytegslb.com,1,0.00%,1,0,100.00%
111-20-12-242.volcsiriusbd.com,1,0.00%,1,0,100.00%
v3-cold2.douyinvod.com,1,0.00%,2,1,50.00%
me.apple-dns.net,1,0.00%,2,1,50.00%
bj-a.bcebos.com.n.shifen.com,1,0.00%,1,0,100.00%
extranet-alllines-pub-c3-c4.alb.xiaomi.com,1,0.00%,1,0,100.00%
ocsp.digicert.cn.w.cdngslb.com,1,0.00%,1,0,100.00%
oauthaccountmanager.googleapis.com,1,0.00%,2,1,50.00%
7.rlb.router.teamviewer.cn,1,0.00%,1,0,100.00%
tracker.publicbt.com,1,0.00%,1,0,100.00%
mixfiend.com,1,0.00%,1,0,100.00%
12.rarbg.me,1,0.00%,1,0,100.00%
themaninashed.com,1,0.00%,1,0,100.00%
sukebei.tracker.wf,1,0.00%,1,0,100.00%
torrent.unix-ag.uni-kl.de,1,0.00%,1,0,100.00%
tracker.shittyurl.org,1,0.00%,2,1,50.00%
torrents.hikarinokiseki.com,1,0.00%,1,0,100.00%
tracker.xdvdz.com,1,0.00%,1,0,100.00%
mediaclub.tv,1,0.00%,2,1,50.00%
irrenhaus.dyndns.dk,1,0.00%,1,0,100.00%
tracker.theempire.bz,1,0.00%,1,0,100.00%
sc.icodef.com,1,0.00%,1,0,100.00%
j4501229.iavs9x.u.avast.com,1,0.00%,2,1,50.00%
k9290131.iavs9x.u.avast.com,1,0.00%,2,1,50.00%
s-iavs9x.avcdn.net,1,0.00%,2,1,50.00%
b1477563.iavs9x.u.avast.com,1,0.00%,2,1,50.00%
b3156325.iavs9x.u.avast.com,1,0.00%,2,1,50.00%
t7758057.iavs9x.u.avast.com,1,0.00%,2,1,50.00%
demo17.tool-box.io,1,0.00%,1,0,100.00%
heraeus.safi.ai,1,0.00%,1,0,100.00%
hr15.graniterapids.com,1,0.00%,1,0,100.00%
torrents.linuxmint.com,1,0.00%,1,0,100.00%
www.theplace.bz,1,0.00%,1,0,100.00%
torrents-nn.cn,1,0.00%,1,0,100.00%
pccw08.graniterapids.com,1,0.00%,1,0,100.00%
cd.file.myqcloud.com,1,0.00%,1,0,100.00%
oedlyege.slt.sched.tdnsv8.com,1,0.00%,1,0,100.00%
busuanzi.ibruce.info,1,0.00%,1,0,100.00%
api-ucloud.leancloud.cn,1,0.00%,1,0,100.00%
upos-sz-staticcos-cmask.bilivideo.com,1,0.00%,4,3,25.00%
pdf.update.wps.cn,1,0.00%,1,0,100.00%
weather.kjjs.360.cn,1,0.00%,1,0,100.00%
youjia.baidu.com,1,0.00%,2,1,50.00%
youjia.cdn.bcebos.com,1,0.00%,2,1,50.00%
youjia-video.cdn.bcebos.com,1,0.00%,2,1,50.00%
baike.baidu.com,1,0.00%,2,1,50.00%
show.chuangyi.taobao.com,1,0.00%,2,1,50.00%
rentals.lofteystaging.info,1,0.00%,1,0,100.00%
skyapi.live.net,1,0.00%,1,0,100.00%
link.springer.com,1,0.00%,1,0,100.00%
bilibili.com,1,0.00%,1,0,100.00%
www.newsmth.net,1,0.00%,1,0,100.00%
tam.cdn-go.cn,1,0.00%,4,3,25.00%
compiles.overleaf.com,1,0.00%,1,0,100.00%
dellupdater.dell.com,1,0.00%,1,0,100.00%
ada.baidu.com,1,0.00%,1,0,100.00%
down.qq.com,1,0.00%,1,0,100.00%
image6.pubmatic.com,1,0.00%,1,0,100.00%
med-fe.cdn.bcebos.com,1,0.00%,1,0,100.00%
selfpage-gips.cdn.bcebos.com,1,0.00%,1,0,100.00%
zhuanjia.cdn.bcebos.com,1,0.00%,1,0,100.00%
gdmf.apple.com,1,0.00%,1,0,100.00%
gdmf.v.aaplimg.com,1,0.00%,1,0,100.00%
vip24-ws-tls.jsssline.top,1,0.00%,1,0,100.00%
swscan.apple.com,1,0.00%,1,0,100.00%
swdist.apple.com,1,0.00%,1,0,100.00%
wbapp.uve.weibo.com,1,0.00%,1,0,100.00%
www.xbooktxt.net,1,0.00%,1,0,100.00%
s.jpush.cn,1,0.00%,1,0,100.00%
report.banyunjuhe.com,1,0.00%,1,0,100.00%
api.banyunjuhe.com,1,0.00%,1,0,100.00%
sbeacon.sina.com.cn,1,0.00%,1,0,100.00%
yupao-prod.54xiaoshuo.com,1,0.00%,1,0,100.00%
madx.flyme.cn,1,0.00%,1,0,100.00%
api-dandelion.flyme.cn,1,0.00%,1,0,100.00%
aeu.alicdn.com,1,0.00%,2,1,50.00%
collect.kugou.com,1,0.00%,2,1,50.00%
app.compendium.com,1,0.00%,1,0,100.00%
jtrn.is.autonavi.com.gds.alibabadns.com,1,0.00%,1,0,100.00%
image.mybank.icbc.com.cn,1,0.00%,2,1,50.00%
papi.look.360.cn,1,0.00%,1,0,100.00%
ssl.look.360.cn,1,0.00%,1,0,100.00%
res.qhupdate.com,1,0.00%,1,0,100.00%
s3.ssl.qhres2.com,1,0.00%,2,1,50.00%
s0.ssl.qhres2.com,1,0.00%,2,1,50.00%
polo.feathr.co,1,0.00%,1,0,100.00%
2022.ieeeicassp.org,1,0.00%,1,0,100.00%
chi01pap002.storage.live.com,1,0.00%,2,1,50.00%
www.gjbmj.gov.cn,1,0.00%,2,1,50.00%
cl2.webterren.com,1,0.00%,1,0,100.00%
yjfk.gjbmj.gov.cn,1,0.00%,1,0,100.00%
www.gov.cn,1,0.00%,2,1,50.00%
d.webterren.com,1,0.00%,1,0,100.00%
www.jccb.com.cn,1,0.00%,1,0,100.00%
cl0.webterren.com,1,0.00%,1,0,100.00%
search.gjbmj.gov.cn,1,0.00%,1,0,100.00%
zgbmxh.cn,1,0.00%,1,0,100.00%
pc.589s.cn,1,0.00%,1,0,100.00%
app.market.xiaomi.com,1,0.00%,2,1,50.00%
cnac.account.xiaomi.com,1,0.00%,1,0,100.00%
www.thefreedictionary.com,1,0.00%,1,0,100.00%
appportal2.cmy.network,1,0.00%,1,0,100.00%
newdefault2.go2https.com,1,0.00%,1,0,100.00%
7fi.ukzcyp.ga,1,0.00%,1,0,100.00%
goldendict.org,1,0.00%,1,0,100.00%
ocsp2.globalsign.com,1,0.00%,2,1,50.00%
oth.ludashi.com,1,0.00%,1,0,100.00%
s2.symcb.com,1,0.00%,2,1,50.00%
s.symcd.com,1,0.00%,2,1,50.00%
ts-ocsp.ws.symantec.com,1,0.00%,2,1,50.00%
sec.cmbchina.com,1,0.00%,1,0,100.00%
onedscolprdaus00.australiasoutheast.cloudapp.azure.com,1,0.00%,1,0,100.00%
ws.mmstat.com.gds.alibabadns.com,1,0.00%,1,0,100.00%
jira.qero.io,1,0.00%,1,0,100.00%
onedscolprdwus01.westus.cloudapp.azure.com,1,0.00%,2,1,50.00%
alfonsino.top,1,0.00%,1,0,100.00%
ad-maven.xml.ak-is2.net,1,0.00%,1,0,100.00%
static.realtime-bid.com,1,0.00%,2,1,50.00%
realtime-bid.xs.ak-is2.net,1,0.00%,2,1,50.00%
r2z5g8w6.stackpathcdn.com,1,0.00%,2,1,50.00%
linux-updatepro.wps.cn,1,0.00%,1,0,100.00%
newtab.firefoxchina.cn.lxcvc.com,1,0.00%,2,1,50.00%
report.meeting.tencent.com,1,0.00%,2,1,50.00%
imap.mail.me.com.akadns.net,1,0.00%,1,0,100.00%
guce.yahoo.com,1,0.00%,1,0,100.00%
vconf.f.qh-lb.com,1,0.00%,1,0,100.00%
root.skype-edf.akadns.net,1,0.00%,1,0,100.00%
prod-oauth-public-alb-939786626.eu-west-1.elb.amazonaws.com,1,0.00%,1,0,100.00%
settings-prod-wus2-1.westus2.cloudapp.azure.com,1,0.00%,1,0,100.00%
zybuluo.com,1,0.00%,1,0,100.00%
files.fireinthehole.cf,1,0.00%,1,0,100.00%
account-public-service-prod.ak.epicgames.com,1,0.00%,2,1,50.00%
web.push.126.net,1,0.00%,1,0,100.00%
api.b.qianxin.com,1,0.00%,1,0,100.00%
archive1.kylinos.cn,1,0.00%,1,0,100.00%
selectcarpetcleaninginc.rk3t.com,1,0.00%,1,0,100.00%
download.virtualbox.org,1,0.00%,1,0,100.00%
download.oracle.com.edgekey.net,1,0.00%,1,0,100.00%
e2875.d.akamaiedge.net,1,0.00%,1,0,100.00%
webmail.up4net.net,1,0.00%,1,0,100.00%
cf45.herokuapp.com,1,0.00%,1,0,100.00%
doh.pub,1,0.00%,1,0,100.00%
api.accounts.firefox.com,1,0.00%,1,0,100.00%
cntr.wps.cn,1,0.00%,1,0,100.00%
appstore.ldmnq.com,1,0.00%,1,0,100.00%
ali-pc-x-speed-auth-vip.xunlei.com,1,0.00%,1,0,100.00%
stun.callwithus.com,1,0.00%,1,0,100.00%
track.plop.pm,1,0.00%,1,0,100.00%
consul-kv.app.kdsec.org,1,0.00%,1,0,100.00%
auth.docker.io,1,0.00%,1,0,100.00%
www.skeimg.com,1,0.00%,1,0,100.00%
direwolf-cdbae92306.herokuapp.com,1,0.00%,1,0,100.00%
sp2.sangfor.com.cn,1,0.00%,1,0,100.00%
www.gstatic.cn,1,0.00%,1,0,100.00%
crl-symcprod.digicert.com,1,0.00%,2,1,50.00%
x2.c.lencr.org,1,0.00%,2,1,50.00%
proxy-detection.eset.com,1,0.00%,1,0,100.00%
v11-x.douyinvod.com,1,0.00%,2,1,50.00%
v11-x.douyinvod.com.cdn.dnsv1.com,1,0.00%,2,1,50.00%
v11-x.sched.v4lego-dk.tdnsvod1.cn,1,0.00%,2,1,50.00%
suggestion.a.shifen.com,1,0.00%,2,1,50.00%
wwwlb.newsmth.net,1,0.00%,1,0,100.00%
push-fcdn-base1.s.bytefcdn.com,1,0.00%,1,0,100.00%
pull-flv-vr-l1.douyincdn.com,1,0.00%,2,1,50.00%
pull-hls-spe-l6.douyincdn.com,1,0.00%,2,1,50.00%
pull-flv-spe-l1.douyincdn.com,1,0.00%,2,1,50.00%
push-rtmp-l6.douyincdn.com,1,0.00%,2,1,50.00%
pull-flv-f6-hs.pstatp.com,1,0.00%,2,1,50.00%
pull-tsl-vr-l6.douyincdn.com,1,0.00%,2,1,50.00%
any.cdn-go.cn.cloud.tc.qq.com,1,0.00%,2,1,50.00%
any.cdn-go.cn.mid.tdnsv6.com,1,0.00%,2,1,50.00%
pull-flv-vr-l6.douyincdn.com,1,0.00%,2,1,50.00%
pull-flv-l26.douyincdn.com,1,0.00%,2,1,50.00%
pull-flv-l26.douyincdn.com.c.cdnhwc3.com,1,0.00%,2,1,50.00%
pull-rtmp-l6-source.douyincdn.com,1,0.00%,2,1,50.00%
pull-fcdn-douyin-base7.s.bytefcdn.com,1,0.00%,1,0,100.00%
pull-fcdn-douyin-base6.s.bytefcdn.com,1,0.00%,1,0,100.00%
pull-fcdn-douyin-b1.b.bytefcdn.com,1,0.00%,1,0,100.00%
pull-flv-f26.douyincdn.com.c.cdnhwc3.com,1,0.00%,2,1,50.00%
pull-hls-f1.douyincdn.com,1,0.00%,2,1,50.00%
pull-rtmp-l95.douyincdn.com,1,0.00%,2,1,50.00%
pull-flv-l1.douyincdn.com,1,0.00%,2,1,50.00%
pull-flv-f1-hs.pstatp.com,1,0.00%,2,1,50.00%
pull-flv-l11-cny.douyincdn.com,1,0.00%,2,1,50.00%
pull-tsl-hs-spe-f5.douyincdn.com.230b2a2545cfa773.queniubg.com,1,0.00%,1,0,100.00%
us-u.openx.net,1,0.00%,1,0,100.00%
odr.mookie1.com,1,0.00%,2,1,50.00%
tagr-gcp-lb1-ase1.mookie1.com,1,0.00%,1,0,100.00%
a.svtrd.com,1,0.00%,1,0,100.00%
pull-hls-vr-l6.douyincdn.com,1,0.00%,2,1,50.00%
pull-flv-l26-cny.douyincdn.com,1,0.00%,2,1,50.00%
pull-flv-l26-cny.douyincdn.com.c.cdnhwc3.com,1,0.00%,2,1,50.00%
pugm-sgc.pubmnet.com,1,0.00%,1,0,100.00%
pull-tsl-spe-l11.douyincdn.com,1,0.00%,2,1,50.00%
pixel-a.sitescout.com,1,0.00%,1,0,100.00%
captcha.gtimg.com.sched.legopic1.tdnsv6.com,1,0.00%,1,0,100.00%
hw-sh-live-comet-05.chat.bilibili.com,1,0.00%,1,0,100.00%
ums.acuityplatform.com,1,0.00%,1,0,100.00%
j.mrpdata.net,1,0.00%,1,0,100.00%
ocsp.godaddy.com.akadns.net,1,0.00%,1,0,100.00%
77.newspush.eastmoney.com,1,0.00%,1,0,100.00%
57.newspush.eastmoney.com,1,0.00%,1,0,100.00%
26.push2.eastmoney.com,1,0.00%,2,1,50.00%
70.push2.eastmoney.com,1,0.00%,2,1,50.00%
91.newspush.eastmoney.com,1,0.00%,1,0,100.00%
85.push2.eastmoney.com,1,0.00%,2,1,50.00%
35.push2.eastmoney.com,1,0.00%,2,1,50.00%
92.newspush.eastmoney.com,1,0.00%,1,0,100.00%
28.newspush.eastmoney.com,1,0.00%,1,0,100.00%
98.push2.eastmoney.com,1,0.00%,2,1,50.00%
73.push2.eastmoney.com,1,0.00%,2,1,50.00%
95.newspush.eastmoney.com,1,0.00%,1,0,100.00%
44.newspush.eastmoney.com,1,0.00%,1,0,100.00%
72.newspush.eastmoney.com,1,0.00%,1,0,100.00%
21.newspush.eastmoney.com,1,0.00%,1,0,100.00%
94.newspush.eastmoney.com,1,0.00%,1,0,100.00%
65.newspush.eastmoney.com,1,0.00%,1,0,100.00%
www.xwt-classics.net,1,0.00%,1,0,100.00%
torrent.resonatingmedia.com,1,0.00%,1,0,100.00%
tr.highstar.shop,1,0.00%,2,1,50.00%
www.freerainbowtables.com,1,0.00%,1,0,100.00%
o4175vz27.qnssl.com,1,0.00%,2,1,50.00%
tracker.kali.org,1,0.00%,1,0,100.00%
tracker.msm8916.com,1,0.00%,2,1,50.00%
retracker.sevstar.net,1,0.00%,1,0,100.00%
www.megatorrents.kg,1,0.00%,1,0,100.00%
krsk01.graniterapids.com,1,0.00%,1,0,100.00%
3.rlb.router.teamviewer.cn,1,0.00%,1,0,100.00%
rc10-fc01.oray.com,1,0.00%,1,0,100.00%
liangcang-material.alicdn.com,1,0.00%,2,1,50.00%
c.statcounter.com,1,0.00%,1,0,100.00%
keke.re,1,0.00%,1,0,100.00%
mail.zasaonsk.ga,1,0.00%,1,0,100.00%
discovery-v4-4.syncthing.net,1,0.00%,1,0,100.00%
oe2203.oepkgs.cn,1,0.00%,1,0,100.00%
submit.acsac.org,1,0.00%,1,0,100.00%
swr.cn-north-4.myhuaweicloud.com,1,0.00%,1,0,100.00%
baidubox-emoji.cdn.bcebos.com,1,0.00%,1,0,100.00%
chipmunk.grammarly.com,1,0.00%,1,0,100.00%
ilce.alicdn.com,1,0.00%,2,1,50.00%
mamasearchad.cloudvideocdn.taobao.com,1,0.00%,2,1,50.00%
signal-prod-signal-prod-rel-asse-signalr-primary-2.service.signalr.net,1,0.00%,1,0,100.00%
signal-prod-signal-prod-rel-asse-signalr-primary-3.service.signalr.net,1,0.00%,1,0,100.00%
api.mixpanel.com,1,0.00%,1,0,100.00%
hubciddata.sandai.net,1,0.00%,1,0,100.00%
hub5u.sandai.net,1,0.00%,1,0,100.00%
static.xbase.cloud,1,0.00%,1,0,100.00%
mqtt.xbase.cloud,1,0.00%,1,0,100.00%
log.kuwo.cn,1,0.00%,1,0,100.00%
wapi.kuwo.cn,1,0.00%,1,0,100.00%
artistpicserver.kuwo.cn,1,0.00%,1,0,100.00%
iepl-node-gab.wowvip.xyz,1,0.00%,1,0,100.00%
beacons4.gvt2.com,1,0.00%,2,1,50.00%
api-cname.growingio.com,1,0.00%,1,0,100.00%
ext.se.360.cn,1,0.00%,1,0,100.00%
p5.qhimg.com,1,0.00%,2,1,50.00%
api.fantuants.com,1,0.00%,1,0,100.00%
m.eyagu.com,1,0.00%,1,0,100.00%
p6-be-pack-sign.pglstatp-toutiao.com,1,0.00%,2,1,50.00%
img3.doubanio.com,1,0.00%,2,1,50.00%
img9.doubanio.com,1,0.00%,2,1,50.00%
erebor.douban.com,1,0.00%,1,0,100.00%
ad.doubanio.com,1,0.00%,1,0,100.00%
ic-business.ks3-cn-beijing.ksyun.com,1,0.00%,1,0,100.00%
dl.dropbox.com,1,0.00%,2,1,50.00%
www.shichuan.org,1,0.00%,1,0,100.00%
p2.shared.global.fastly.NET,1,0.00%,1,0,100.00%
conference.cipsc.org.cn,1,0.00%,1,0,100.00%
arxiv.org,1,0.00%,1,0,100.00%
dl.acm.org,1,0.00%,1,0,100.00%
www.cil.pku.edu.cn,1,0.00%,1,0,100.00%
www.sciencedirect.com,1,0.00%,1,0,100.00%
www.springerprofessional.de,1,0.00%,1,0,100.00%
p9-be-pack-sign.pglstatp-toutiao.com,1,0.00%,2,1,50.00%
staticiot.cdn.bcebos.com,1,0.00%,2,1,50.00%
pcs.baidu.com,1,0.00%,2,1,50.00%
yun.baidu.com,1,0.00%,2,1,50.00%
staticwx.cdn.bcebos.com,1,0.00%,2,1,50.00%
jzed1uig.sched.sma.tdnsstic1.cn,1,0.00%,1,0,100.00%
jzed1uig.sched.sma.tdnsstic1.cn.cjt.krcdn.idatacube.com,1,0.00%,1,0,100.00%
staticsns.cdn.bcebos.com,1,0.00%,2,1,50.00%
thumbnail0.baidupcs.com,1,0.00%,2,1,50.00%
dgss0.bdstatic.com,1,0.00%,2,1,50.00%
4xbn6851.sched.sma.tdnsstic1.cn,1,0.00%,1,0,100.00%
rq1jxvp7.sched.sma.tdnsstic1.cn,1,0.00%,1,0,100.00%
nv1.baidupcs.com,1,0.00%,2,1,50.00%
bj.baidupcs.com,1,0.00%,2,1,50.00%
ied-tqos-tgp.qq.com,1,0.00%,1,0,100.00%
flowcontroll.dcdn.sandai.net,1,0.00%,1,0,100.00%
wppkg.baidupcs.com,1,0.00%,2,1,50.00%
china-img.soulapp.cn,1,0.00%,2,1,50.00%
study.163.com,1,0.00%,1,0,100.00%
acdc-direct.office.com,1,0.00%,2,1,50.00%
atm-fp-direct.office.com,1,0.00%,2,1,50.00%
api.steampowered.com,1,0.00%,1,0,100.00%
cdn.pcsoftconfig.eastmoney.com.w.kunlunpi.com,1,0.00%,1,0,100.00%
blob.dsm08prdstr14a.store.core.windows.net,1,0.00%,1,0,100.00%
www.homecookedgadgets.com,1,0.00%,1,0,100.00%
socwxsns.video.qq.com,1,0.00%,2,1,50.00%
r.edtd.eset.com,1,0.00%,1,0,100.00%
gspe79-cn-ssl.ls.apple.com,1,0.00%,2,1,50.00%
gspe79-cn-ssl.ls-apple.com.akadns.net,1,0.00%,2,1,50.00%
gspe79-cn-ssl.ls.apple.com.download.ks-cdn.com,1,0.00%,2,1,50.00%
k128-gspe.gslb.ksyuncdn.com,1,0.00%,2,1,50.00%
library-service.beee.live.use1a.on.epicgames.com,1,0.00%,1,0,100.00%
prod.fus.aws.intellij.net,1,0.00%,1,0,100.00%
ftp.riken.jp,1,0.00%,1,0,100.00%
ue.mbgstore.lenovo.com.cn,1,0.00%,1,0,100.00%
1608223790.D4EE071FA772.device.hiwifi.com,1,0.00%,1,0,100.00%
nat-office-christian-gasparini-architetto.divisare.pro,1,0.00%,1,0,100.00%
community.adobe.com,1,0.00%,2,1,50.00%
proxy-sub.vulgraph.org,1,0.00%,1,0,100.00%
1.cn.pool.ntp.org,1,0.00%,1,0,100.00%
cheng.vpn.rndto.com,1,0.00%,1,0,100.00%
dsm01pap005.storage.live.com,1,0.00%,2,1,50.00%
rm-bp151dcc75aycqd80to.mysql.rds.aliyuncs.com,1,0.00%,1,0,100.00%
api.ldmnq.com,1,0.00%,1,0,100.00%
slp2p-east-std1061.oray.net,1,0.00%,1,0,100.00%
fp-as.azureedge.net,1,0.00%,2,1,50.00%
appexorch.bestsdwan.com,1,0.00%,1,0,100.00%
torrentzilla.org,1,0.00%,1,0,100.00%
o.arkcn.tk,1,0.00%,1,0,100.00%
stun.voipstunt.com,1,0.00%,1,0,100.00%
www.liebao.cn,1,0.00%,1,0,100.00%
discovery-v4-1.verysync.cn,1,0.00%,1,0,100.00%
stun.sipgate.net,1,0.00%,1,0,100.00%
tracker2.dler.org,1,0.00%,1,0,100.00%
tracker.vraphim.com,1,0.00%,1,0,100.00%
kanjiantu.com,1,0.00%,1,0,100.00%
t.publictracker.xyz,1,0.00%,2,1,50.00%
home.penza.com.ru,1,0.00%,1,0,100.00%
denis.stalker.upeer.me,1,0.00%,1,0,100.00%
retracker.akado-ural.ru,1,0.00%,1,0,100.00%
itera.bz,1,0.00%,1,0,100.00%
detectportal.firefox.com,0,0.00%,600,600,0.00%
detectportal.prod.mozaws.net,0,0.00%,429,429,0.00%
prod.detectportal.prod.cloudops.mozgcp.net,0,0.00%,438,438,0.00%
dns.msftncsi.com,0,0.00%,1017,1017,0.00%
ntp.ubuntu.com,0,0.00%,8289,8289,0.00%
glb.cws.prod.dcat.dsp.trafficmanager.net,0,0.00%,16,16,0.00%
api.opensubtitles.com,0,0.00%,8,8,0.00%
imap.qq.com,0,0.00%,24,24,0.00%
dual-a-0036.a-msedge.net,0,0.00%,76,76,0.00%
dav.qq.com,0,0.00%,2,2,0.00%
ins-2n7ixenz.ias.tencent-cloud.net,0,0.00%,5,5,0.00%
grafana.com,0,0.00%,89,89,0.00%
example.org,0,0.00%,96,96,0.00%
www.cordcloud.one,0,0.00%,1,1,0.00%
localhost,0,0.00%,305,305,0.00%
localhost.localdomain,0,0.00%,2,2,0.00%
time.apple.com,0,0.00%,80,80,0.00%
dns.google,0,0.00%,421,421,0.00%
potuk.com,0,0.00%,38,38,0.00%
siambit.com,0,0.00%,233,233,0.00%
config.edge.skype.com,0,0.00%,47,47,0.00%
szextshort.weixin.qq.com,0,0.00%,27,27,0.00%
h5.qzone.qq.com,0,0.00%,135,135,0.00%
peersteers.org,0,0.00%,40,40,0.00%
api.aliyundrive.com,0,0.00%,7,7,0.00%
api.blockcypher.com,0,0.00%,11,11,0.00%
db.local.clamav.net,0,0.00%,93,93,0.00%
szdx.txddns.cn,0,0.00%,10,10,0.00%
slscr.update.microsoft.com,0,0.00%,25,25,0.00%
k8s.gcr.io,0,0.00%,277,277,0.00%
dns.weixin.qq.com.cn,0,0.00%,123,123,0.00%
az700632.vo.msecnd.net,0,0.00%,16,16,0.00%
analysis-acc-ssl.xunlei.com,0,0.00%,14,14,0.00%
0d.kebhana.mx,0,0.00%,2,2,0.00%
tracker.nanoha.org,0,0.00%,8,8,0.00%
all4nothin.net,0,0.00%,2,2,0.00%
www.qq.com,0,0.00%,25,25,0.00%
www.21cn.com,0,0.00%,2,2,0.00%
edgedl.me.gvt1.com,0,0.00%,12,12,0.00%
w.wwwww.wtf,0,0.00%,30,30,0.00%
swh.app,0,0.00%,7,7,0.00%
news.qq.com,0,0.00%,2,2,0.00%
wx.qlogo.cn,0,0.00%,132,132,0.00%
dns.weixin.qq.com,0,0.00%,19,19,0.00%
voice.baidu.com,0,0.00%,1,1,0.00%
mmsvg.n.shifen.com,0,0.00%,1,1,0.00%
badjs.weixinbridge.com,0,0.00%,25,25,0.00%
mp.weixin.qq.com,0,0.00%,16,16,0.00%
kdocs.cn,0,0.00%,30,30,0.00%
www.kdocs.cn,0,0.00%,34,34,0.00%
u.wwwww.wtf,0,0.00%,20,20,0.00%
api.vstsusers.visualstudio.com,0,0.00%,2,2,0.00%
api.1e2ea27c13e7d7dff999bc904d79a0a8.pw,0,0.00%,8,8,0.00%
doh.dns.apple.com,0,0.00%,2,2,0.00%
docs.joern.io,0,0.00%,2,2,0.00%
cgi.ark.qq.com,0,0.00%,5,5,0.00%
app.vssps.visualstudio.com,0,0.00%,2,2,0.00%
1337.abcvg.info,0,0.00%,15,15,0.00%
iecvlist.microsoft.com,0,0.00%,1,1,0.00%
ins-r23tsuuf.ias.tencent-cloud.net,0,0.00%,6,6,0.00%
v4-vod.kwaicdn.com,0,0.00%,1,1,0.00%
sns-avatar-qc.xhscdn.com,0,0.00%,3,3,0.00%
sns-img-hw.xhscdn.com,0,0.00%,1,1,0.00%
p4.a.yximgs.com,0,0.00%,1,1,0.00%
ping.manjaro.org,0,0.00%,46,46,0.00%
szminorshort.weixin.qq.com,0,0.00%,8,8,0.00%
weixin.qq.com,0,0.00%,2,2,0.00%
ipv6.msftconnecttest.com,0,0.00%,17,17,0.00%
surl.amap.com,0,0.00%,1,1,0.00%
wx2.sinaimg.cn,0,0.00%,4,4,0.00%
wx4.sinaimg.cn,0,0.00%,5,5,0.00%
wb.amap.com,0,0.00%,1,1,0.00%
tracker.ipv6tracker.ru,0,0.00%,15,15,0.00%
wx3.sinaimg.cn,0,0.00%,6,6,0.00%
tvax2.sinaimg.cn,0,0.00%,7,7,0.00%
tvax1.sinaimg.cn,0,0.00%,5,5,0.00%
tvax4.sinaimg.cn,0,0.00%,8,8,0.00%
webapi.amap.com,0,0.00%,1,1,0.00%
g.alicdn.com,0,0.00%,2,2,0.00%
short.weixin.qq.com,0,0.00%,11,11,0.00%
at.alicdn.com,0,0.00%,1,1,0.00%
vdata.amap.com,0,0.00%,1,1,0.00%
vdata02.amap.com,0,0.00%,1,1,0.00%
vdata01.amap.com,0,0.00%,1,1,0.00%
fourier.taobao.com,0,0.00%,1,1,0.00%
i5df1.tdum.alibaba.com,0,0.00%,1,1,0.00%
ynuf.aliapp.org,0,0.00%,3,3,0.00%
vdata03.amap.com,0,0.00%,1,1,0.00%
vdata04.amap.com,0,0.00%,1,1,0.00%
store.is.autonavi.com,0,0.00%,1,1,0.00%
httpdns.alicdn.com,0,0.00%,1,1,0.00%
img.t.sinajs.cn,0,0.00%,1,1,0.00%
www.notion.so,0,0.00%,16,16,0.00%
dm.video.weibocdn.com,0,0.00%,1,1,0.00%
www.cas.cn,0,0.00%,4,4,0.00%
tracker.lilithraws.cf,0,0.00%,17,17,0.00%
tracker.imgoingto.icu,0,0.00%,17,17,0.00%
h5.360buyimg.com,0,0.00%,1,1,0.00%
img10.360buyimg.com,0,0.00%,1,1,0.00%
img12.360buyimg.com,0,0.00%,1,1,0.00%
img13.360buyimg.com,0,0.00%,1,1,0.00%
img11.360buyimg.com,0,0.00%,1,1,0.00%
client.mail.163.com,0,0.00%,9,9,0.00%
time.g.aaplimg.com,0,0.00%,24,24,0.00%
otheve.beacon.qq.com,0,0.00%,13,13,0.00%
tracker-cdn.moeking.me,0,0.00%,13,13,0.00%
update.bjca.org.cn,0,0.00%,4,4,0.00%
tagged-by.rubiconproject.net.akadns.net,0,0.00%,2,2,0.00%
tracker.iriseden.eu,0,0.00%,10,10,0.00%
countly.mail.163.com,0,0.00%,6,6,0.00%
gchat.qpic.cn,0,0.00%,18,18,0.00%
cgicol.amap.com,0,0.00%,8,8,0.00%
cgicol.amap.com.gds.alibabadns.com,0,0.00%,2,2,0.00%
www.bt.cn,0,0.00%,7,7,0.00%
bk.n.shifen.com,0,0.00%,8,8,0.00%
apd-ef1d4e4c1ea9898e441fef0017ad517108632f5a868c5ce6.v.smtcdns.com,0,0.00%,1,1,0.00%
minorshort.weixin.qq.com,0,0.00%,20,20,0.00%
shop.vipstatic.com,0,0.00%,1,1,0.00%
d.vpimg1.com,0,0.00%,1,1,0.00%
c.vpimg1.com,0,0.00%,1,1,0.00%
beian.miit.gov.cn,0,0.00%,4,4,0.00%
ir.vip.com,0,0.00%,1,1,0.00%
ss.knet.cn,0,0.00%,1,1,0.00%
shmmsns.qpic.cn,0,0.00%,26,26,0.00%
wx.mail.qq.com,0,0.00%,2,2,0.00%
t2.leech.ie,0,0.00%,5,5,0.00%
graph.qq.com,0,0.00%,5,5,0.00%
ecs.office.com,0,0.00%,31,31,0.00%
www.torrent.eu.org,0,0.00%,2,2,0.00%
tracker.anirena.com,0,0.00%,28,28,0.00%
t.nyaatracker.com,0,0.00%,10,10,0.00%
tracker.gbitt.info,0,0.00%,18,18,0.00%
tracker.0o.is,0,0.00%,3,3,0.00%
tracker.ds.is,0,0.00%,3,3,0.00%
trk.publictracker.xyz,0,0.00%,6,6,0.00%
6rt.tace.ru,0,0.00%,3,3,0.00%
discord.heihachi.pw,0,0.00%,5,5,0.00%
exodus.desync.com,0,0.00%,4,4,0.00%
ipv6.tracker.zerobytes.xyz,0,0.00%,5,5,0.00%
node.video.qq.com,0,0.00%,5,5,0.00%
extshort.weixin.qq.com,0,0.00%,28,28,0.00%
open.demonii.com,0,0.00%,2,2,0.00%
ratings-wrs.norton.com,0,0.00%,2,2,0.00%
h.trace.qq.com,0,0.00%,15,15,0.00%
shasta-rrs.norton.com,0,0.00%,2,2,0.00%
recruitprod.azurefd.net,0,0.00%,2,2,0.00%
recruit.microsoft.com,0,0.00%,2,2,0.00%
wcpstatic.microsoft.com,0,0.00%,2,2,0.00%
libs.baidu.com,0,0.00%,2,2,0.00%
acs-ui.azureedge.net,0,0.00%,2,2,0.00%
consentreceiverfd-prod.azurefd.net,0,0.00%,2,2,0.00%
api.ivideo.sina.com.cn,0,0.00%,24,24,0.00%
wwfile.work.weixin.qq.com,0,0.00%,24,24,0.00%
apd-bf858887be56629f5e8387983960b23dd6420ff9a7f7b03b.v.smtcdns.com,0,0.00%,2,2,0.00%
www.dropbox.com,0,0.00%,2,2,0.00%
stat.download.xunlei.com,0,0.00%,2,2,0.00%
excashier.alipay.com,0,0.00%,2,2,0.00%
lab.alipay.com,0,0.00%,2,2,0.00%
kcart.alipay.com,0,0.00%,2,2,0.00%
collect.alipay.com,0,0.00%,2,2,0.00%
apd-6dc2592165268630e5e81885b161ea9094fb91d1cf4b7b4b.v.smtcdns.com,0,0.00%,2,2,0.00%
yangzhangalmo.github.io,0,0.00%,4,4,0.00%
23a72c571eab6919.cdn.jiashule.com,0,0.00%,2,2,0.00%
apd-7a3c059307d194c1953157782742893b1193182453d495c0.v.smtcdns.com,0,0.00%,2,2,0.00%
lookup.nextcloud.com,0,0.00%,82,82,0.00%
raw.githubusercontent.com,0,0.00%,44,44,0.00%
captive.apple.com,0,0.00%,34,34,0.00%
v6-1.nigirocloud.com,0,0.00%,14,14,0.00%
v6-2.nigirocloud.com,0,0.00%,14,14,0.00%
v6-3.nigirocloud.com,0,0.00%,14,14,0.00%
astat.bugly.qq.com,0,0.00%,18,18,0.00%
security.ubuntu.com,0,0.00%,265,265,0.00%
cn.archive.ubuntu.com,0,0.00%,280,280,0.00%
fedoraproject.org,0,0.00%,50,50,0.00%
config.teams.microsoft.com,0,0.00%,5,5,0.00%
edge-microsoft-com.dual-a-0036.a-msedge.net,0,0.00%,18,18,0.00%
wx1.qq.com,0,0.00%,42,42,0.00%
inner-all.toutiao-internal-all-v3.lf.bytelb.net,0,0.00%,16,16,0.00%
aloha.maxhub.vip.wsglb0.com,0,0.00%,80,80,0.00%
ins-diu1q33u.ias.tencent-cloud.net,0,0.00%,6,6,0.00%
crl.sectigo.com,0,0.00%,8,8,0.00%
crl.comodoca.com.cdn.cloudflare.net,0,0.00%,6,6,0.00%
yiyun.n.shifen.com,0,0.00%,28,28,0.00%
speedtest.snape3058.info,0,0.00%,42,42,0.00%
swdlcdn.eastmoney.com.w.cdngslb.com,0,0.00%,6,6,0.00%
mpv6.weixin.qq.com,0,0.00%,16,16,0.00%
aloha.maxhub.vip,0,0.00%,16,16,0.00%
config.edge.skype.com.trafficmanager.net,0,0.00%,30,30,0.00%
config-edge-skype.l-0007.l-msedge.net,0,0.00%,14,14,0.00%
l-0007.l-msedge.net,0,0.00%,32,32,0.00%
premium.eastmoney.com,0,0.00%,2,2,0.00%
jsdelivr.map.fastly.net,0,0.00%,4,4,0.00%
time-ios.apple.com,0,0.00%,6,6,0.00%
esm.ubuntu.com,0,0.00%,2,2,0.00%
ntes53v6.mail.yeah.net,0,0.00%,4,4,0.00%
b1.nel.goog,0,0.00%,6,6,0.00%
hub.upyun.com,0,0.00%,94,94,0.00%
smtp.qq.com,0,0.00%,86,86,0.00%
log.tailscale.io,0,0.00%,63,63,0.00%
controlplane.tailscale.com,0,0.00%,8,8,0.00%
haiwenzhang.github.io,0,0.00%,61,61,0.00%
gitlab.com,0,0.00%,26,26,0.00%
tpstelemetry.tencent.com,0,0.00%,41,41,0.00%
pypi.org,0,0.00%,11185,11185,0.00%
time.nist.gov,0,0.00%,15,15,0.00%
cbs-i.sports.cctv.com,0,0.00%,19,19,0.00%
aps.amap.com,0,0.00%,5,5,0.00%
win10-trt.msedge.net,0,0.00%,11,11,0.00%
pull-hls-vr-l1.douyincdn.com.wsdvs.com,0,0.00%,6,6,0.00%
pull-tsl-spe-l1.douyincdn.com.wsdvs.com,0,0.00%,6,6,0.00%
open.weixin.qq.com,0,0.00%,10,10,0.00%
support.weixin.qq.com,0,0.00%,2,2,0.00%
hub.docker.com,0,0.00%,4,4,0.00%
dstore-metadata.deepin.cn,0,0.00%,10,10,0.00%
access.toggle.qq.com,0,0.00%,7,7,0.00%
event.toggle.qq.com,0,0.00%,2,2,0.00%
ping.dgraph.io,0,0.00%,105,105,0.00%
web.p.qq.com,0,0.00%,6,6,0.00%
hub5pn.v6.sandai.net,0,0.00%,35,35,0.00%
appconf.mail.163.com,0,0.00%,8,8,0.00%
tracker.m-team.cc,0,0.00%,4,4,0.00%
tracker.lilithraws.org,0,0.00%,2,2,0.00%
torrent.fedoraproject.org,0,0.00%,3,3,0.00%
motd.ubuntu.com,0,0.00%,10,10,0.00%
az667904.vo.msecnd.net,0,0.00%,14,14,0.00%
msgacs.youku.com,0,0.00%,4,4,0.00%
az667904-pme.azureedge.net,0,0.00%,5,5,0.00%
osint.bambenekconsulting.com,0,0.00%,11,11,0.00%
graph.microsoft.com,0,0.00%,6,6,0.00%
dict.youdao.com,0,0.00%,15,15,0.00%
time.android.com,0,0.00%,4,4,0.00%
mp.4dex.io,0,0.00%,4,4,0.00%
yandex.com,0,0.00%,2,2,0.00%
px.ucweb.com,0,0.00%,2,2,0.00%
P2pSTUnTEST.HAplAT.NEt,0,0.00%,2,2,0.00%
cs9.wpc.v0cdn.net,0,0.00%,8,8,0.00%
tvax3.sinaimg.cn,0,0.00%,4,4,0.00%
tva3.sinaimg.cn,0,0.00%,1,1,0.00%
tracker.beeimg.com,0,0.00%,3,3,0.00%
image.sinajs.cn,0,0.00%,1,1,0.00%
tracker.tamersunion.org,0,0.00%,14,14,0.00%
natdetection.onethingpcs.com,0,0.00%,8,8,0.00%
ipv6.neubt.com,0,0.00%,2,2,0.00%
edd.e4.nl,0,0.00%,2,2,0.00%
glb.sls.prod.dcat.dsp.trafficmanager.net,0,0.00%,12,12,0.00%
obsetear.github.io,0,0.00%,1,1,0.00%
app.any.run,0,0.00%,2,2,0.00%
cdnjs.cloudflare.com,0,0.00%,6,6,0.00%
i.work.weixin.qq.com,0,0.00%,4,4,0.00%
vscodeexperiments.azureedge.net,0,0.00%,2,2,0.00%
marketplace.visualstudio.com,0,0.00%,4,4,0.00%
apd-bf4bf622660164946c9b3d949a013ccc6751373c355ddeac.v.smtcdns.com,0,0.00%,2,2,0.00%
apd-2ff18d8c533b6c71309e9b084360f9ee2daa5b201ce1a95b.v.smtcdns.com,0,0.00%,2,2,0.00%
apd-55aa056d36dd2a21510c7aba402054b61c3d0af5f3be64c2.v.smtcdns.com,0,0.00%,2,2,0.00%
api-kos.wps.cn,0,0.00%,6,6,0.00%
commentowebd.vps.webdock.io,0,0.00%,1,1,0.00%
mkt-advertisement.tuhu.cn,0,0.00%,2,2,0.00%
apd-8a3283388c9bfd480603732ee18cc09b3d9e120b00d43d9b.v.smtcdns.com,0,0.00%,2,2,0.00%
apd-05ace3e5be3ccfeb4cd6c4b264d896b1b4d7c42810ee4d50.v.smtcdns.com,0,0.00%,2,2,0.00%
apd-f54a02b4deb41d61066bebac717aaa296872e03e66079304.v.smtcdns.com,0,0.00%,2,2,0.00%
stat6.y.qq.com,0,0.00%,2,2,0.00%
ipv6.torrent.centos.org,0,0.00%,3,3,0.00%
rpt.gdt.qq.com,0,0.00%,6,6,0.00%
ii.gdt.qq.com,0,0.00%,2,2,0.00%
apd-126387a827c29b32acbd735ba8c082df93686f8d74a07da2.v.smtcdns.com,0,0.00%,2,2,0.00%
long.weixin.qq.com,0,0.00%,4,4,0.00%
p.guanjia.qq.com,0,0.00%,2,2,0.00%
apd-d8e293bbd0ec700474ea78f11975a93435add3499c7989b7.v.smtcdns.com,0,0.00%,2,2,0.00%
ulogs.umeng.com,0,0.00%,6,6,0.00%
channels.weixin.qq.com,0,0.00%,5,5,0.00%
apis.map.qq.com,0,0.00%,4,4,0.00%
apd-8b1cfd726ba9ef1a0fcbd0cf7f43d30b1e573b1aeeb564ce.v.smtcdns.com,0,0.00%,2,2,0.00%
tracker1.520.jp,0,0.00%,2,2,0.00%
concen.org,0,0.00%,2,2,0.00%
seedbay.net,0,0.00%,2,2,0.00%
tr.greenhat.be,0,0.00%,2,2,0.00%
open.stealth.si,0,0.00%,2,2,0.00%
bank.pingan.com,0,0.00%,2,2,0.00%
tracker.loligirl.cn,0,0.00%,4,4,0.00%
opentracker.cc,0,0.00%,3,3,0.00%
ipv4announce.sktorrent.eu,0,0.00%,2,2,0.00%
filehelper.weixin.qq.com,0,0.00%,28,28,0.00%
lbs.map.qq.com,0,0.00%,2,2,0.00%
ping3.teamviewer.com,0,0.00%,9,9,0.00%
quay.io,0,0.00%,11,11,0.00%
tracker.exorditech.com.tr,0,0.00%,2,2,0.00%
gslb.xcloud.sandai.net,0,0.00%,4,4,0.00%
api.bitbucket.org,0,0.00%,4,4,0.00%
newsinfo.eastmoney.com,0,0.00%,2,2,0.00%
myfavor.eastmoney.com,0,0.00%,4,4,0.00%
searchapi.eastmoney.com,0,0.00%,4,4,0.00%
np-listapi.eastmoney.com,0,0.00%,4,4,0.00%
huaxiang.eastmoney.com,0,0.00%,4,4,0.00%
recommend.eastmoney.com,0,0.00%,4,4,0.00%
vote.eastmoney.com,0,0.00%,4,4,0.00%
reportapi.eastmoney.com,0,0.00%,4,4,0.00%
b32f015b18b6bf83cdb52b1aa3f2d0f3.clo.footprintdns.com,0,0.00%,2,2,0.00%
mirrors.ustc.edu.cn,0,0.00%,10,10,0.00%
mailhz.qiye.163.com,0,0.00%,6,6,0.00%
report.url.cn,0,0.00%,30,30,0.00%
speeddials.opera.com,0,0.00%,4,4,0.00%
im.dingtalk.com,0,0.00%,4,4,0.00%
updatem.360safe.com,0,0.00%,2,2,0.00%
cname.dict.ntes53.netease.com,0,0.00%,10,10,0.00%
dict.ntes53.netease.com,0,0.00%,16,16,0.00%
s-0005.s-msedge.net,0,0.00%,10,10,0.00%
pancake.g.aaplimg.com,0,0.00%,2,2,0.00%
ace.pgp.wanmei.com,0,0.00%,6,6,0.00%
myfavor1.eastmoney.com,0,0.00%,6,6,0.00%
astat-bugly-tgw4l.mig.tencent-cloud.net,0,0.00%,24,24,0.00%
hdwebv6.mail.split.netease.com,0,0.00%,10,10,0.00%
today.org.ua,0,0.00%,1,1,0.00%
ns-1471.awsdns-55.org,0,0.00%,2,2,0.00%
hj5k.nomade.ga,0,0.00%,1,1,0.00%
public.dns.iij.jp,0,0.00%,2,2,0.00%
v6-4.nigirocloud.com,0,0.00%,12,12,0.00%
hub5sr.v6.shub.sandai.net,0,0.00%,4,4,0.00%
tracker.foreverpirates.co,0,0.00%,13,13,0.00%
hub5pr.v6.phub.sandai.net,0,0.00%,14,14,0.00%
wassermann.online,0,0.00%,2,2,0.00%
hk-proxy.isrc.ac.cn,0,0.00%,42,42,0.00%
cacerts.digicert.com,0,0.00%,3,3,0.00%
aks.jdpay.com,0,0.00%,5,5,0.00%
tracker-public.tjupt.org,0,0.00%,8,8,0.00%
www.weiyun.com,0,0.00%,3,3,0.00%
user.weiyun.com,0,0.00%,1,1,0.00%
ui.ptlogin2.qq.com,0,0.00%,5,5,0.00%
docs.wps.cn,0,0.00%,1,1,0.00%
890a3c996d534bf19f8ed08103f71d66.fp.measure.office.com,0,0.00%,1,1,0.00%
outlook.office.com,0,0.00%,1,1,0.00%
stun-h5.qvb.qcloud.com,0,0.00%,14,14,0.00%
kb.vmware.com,0,0.00%,1,1,0.00%
p4-gdmgknw2leoey-43h5anlkzty335p5-146801-i2-bogus-dnssec-bd.gexperiments3.com,0,0.00%,1,1,0.00%
p4-gdmgknw2leoey-43h5anlkzty335p5-146801-i1-bogus-dnssec-vd.gexperiments2.com,0,0.00%,1,1,0.00%
pull-flv-f6.douyincdn.com.hdlvcloud.ks-cdn.com,0,0.00%,6,6,0.00%
s6110-flv-ml.gslb.ksyuncdn.com,0,0.00%,6,6,0.00%
pull-hls-spe-l1.douyincdn.com.wsdvs.com,0,0.00%,6,6,0.00%
crl.comodoca.com,0,0.00%,8,8,0.00%
trouter-azsc-asse-0-a.trouter.skype.com,0,0.00%,4,4,0.00%
trouter-azsc-asse-0-a.cloudapp.net,0,0.00%,4,4,0.00%
ocsp.comodoca.com.cdn.cloudflare.net,0,0.00%,8,8,0.00%
hd-v6.mmstat.com.gds.alibabadns.com,0,0.00%,4,4,0.00%
csync.loopme.me,0,0.00%,2,2,0.00%
gbapi.eastmoney.com,0,0.00%,10,10,0.00%
database.clamav.net,0,0.00%,54,54,0.00%
ocsp.comodoca.com,0,0.00%,2,2,0.00%
ocsp.usertrust.com,0,0.00%,2,2,0.00%
ocsp.sectigo.com,0,0.00%,2,2,0.00%
hide.likeafaieog.tk,0,0.00%,1,1,0.00%
crl.usertrust.com,0,0.00%,2,2,0.00%
1d83e3e8e6b57a65f526e888e184d335.clo.footprintdns.com,0,0.00%,1,1,0.00%
teams-ring.msedge.net,0,0.00%,2,2,0.00%
nj.cschannel.anticheatexpert.com,0,0.00%,2,2,0.00%
16827d4fc6e54507858a3f783fc81b82.fp.measure.office.com,0,0.00%,2,2,0.00%
apd-01fe2cea10604cc0d5743de4947f01b13dccda98d5b74beb.v.smtcdns.com,0,0.00%,1,1,0.00%
s.go-mpulse.net,0,0.00%,1,1,0.00%
clientlog.music.163.com,0,0.00%,2,2,0.00%
oss.hpconnected.com,0,0.00%,5,5,0.00%
servicediscovery.ccs.mcafee.com,0,0.00%,1,1,0.00%
szmmsns.qpic.cn,0,0.00%,4,4,0.00%
baoxian.pingan.com,0,0.00%,2,2,0.00%
baoxian.pingan.com.paxdn.com,0,0.00%,2,2,0.00%
bfdmirrors.s.tuna.tsinghua.edu.cn,0,0.00%,2,2,0.00%
s3a.pstatp.com.w.kunlungr.com,0,0.00%,4,4,0.00%
ipv6.tracker.harry.lu,0,0.00%,1,1,0.00%
apd-b701c984eb510c61fccb849afda812752d35cb4386286a96.v.smtcdns.com,0,0.00%,2,2,0.00%
vd6.l.qq.com,0,0.00%,3,3,0.00%
mariadb.org,0,0.00%,4,4,0.00%
trouter-azsc-asse-0-b.trouter.skype.com,0,0.00%,2,2,0.00%
apd-d620662384bfa659a4ddcf61b25545de329185f90ef5d08b.v.smtcdns.com,0,0.00%,2,2,0.00%
mirror.aptus.co.tz,0,0.00%,2,2,0.00%
run.publictracker.xyz,0,0.00%,2,2,0.00%
pbaccess.video.qq.com,0,0.00%,4,4,0.00%
tr.bangumi.moe,0,0.00%,4,4,0.00%
tracker.cyberia.is,0,0.00%,3,3,0.00%
tracker.publictracker.xyz,0,0.00%,2,2,0.00%
tracker.nrx.me,0,0.00%,6,6,0.00%
zecircle.xyz,0,0.00%,2,2,0.00%
tracker.theoks.net,0,0.00%,1,1,0.00%
q-client.cn-hongkong.log.aliyuncs.com,0,0.00%,2,2,0.00%
i.stack.imgur.com,0,0.00%,1,1,0.00%
go.ezodn.com,0,0.00%,1,1,0.00%
time1.google.com,0,0.00%,2,2,0.00%
time2.google.com,0,0.00%,2,2,0.00%
time3.google.com,0,0.00%,2,2,0.00%
time4.google.com,0,0.00%,2,2,0.00%
fp-vp.azureedge.net,0,0.00%,2,2,0.00%
static-ecst.licdn.com,0,0.00%,2,2,0.00%
t-ring.msedge.net,0,0.00%,4,4,0.00%
ocsps.ssl.com,0,0.00%,2,2,0.00%
platform.bing.com,0,0.00%,5,5,0.00%
wup.imtt.qq.com,0,0.00%,8,8,0.00%
ipv6check-udp.steamcontent.com,0,0.00%,32,32,0.00%
l-0007.config.skype.com,0,0.00%,6,6,0.00%
udp.ipv6check.akadns.net,0,0.00%,22,22,0.00%
east-asia.udp.ipv6check.akadns.net,0,0.00%,20,20,0.00%
http.ipv6check.akadns.net,0,0.00%,10,10,0.00%
east-asia.http.ipv6check.akadns.net,0,0.00%,8,8,0.00%
az700632-pme.azureedge.net,0,0.00%,2,2,0.00%
az700632-pme.ec.azureedge.net,0,0.00%,2,2,0.00%
api.languagetoolplus.com,0,0.00%,4,4,0.00%
map.n.shifen.com,0,0.00%,18,18,0.00%
download.jetbrains.com,0,0.00%,5,5,0.00%
downloads-aws-prod-alb-134617303.eu-west-1.elb.amazonaws.com,0,0.00%,6,6,0.00%
hax.peakgg.ml,0,0.00%,1,1,0.00%
hub5btmain.v6.shub.sandai.net,0,0.00%,4,4,0.00%
fashionpedia.github.io,0,0.00%,1,1,0.00%
mozilla.cloudflare-dns.com,0,0.00%,6,6,0.00%
mirrors.tuna.tsinghua.edu.cn,0,0.00%,12,12,0.00%
mirrorz.org,0,0.00%,6,6,0.00%
macxmp.rcv.sandai.net,0,0.00%,2,2,0.00%
5c705f0af0ed4765a700cdca6800c147.fp.measure.office.com,0,0.00%,1,1,0.00%
ulogs.umeng.com.gds.alibabadns.com,0,0.00%,4,4,0.00%
k2-dy-cold2-ml.gslb.ksyuncdn.com,0,0.00%,2,2,0.00%
v6ncsi.msedge.net,0,0.00%,4,4,0.00%
ncsi.6-c-0003.c-msedge.net,0,0.00%,8,8,0.00%
6-c-0003.c-msedge.net,0,0.00%,12,12,0.00%
tracker-campus.tjupt.org,0,0.00%,2,2,0.00%
tracker.tongyifan.me,0,0.00%,2,2,0.00%
lab-a.tongyifan.me,0,0.00%,2,2,0.00%
ios.bugly.qq.com,0,0.00%,4,4,0.00%
alog-default.umeng.com,0,0.00%,4,4,0.00%
think.afunapp.com,0,0.00%,5,5,0.00%
edge-misc-env.dropbox-dns.com,0,0.00%,4,4,0.00%
pull-hls-vr-l1.douyincdn.com,0,0.00%,4,4,0.00%
pull-tsl-spe-l1.douyincdn.com,0,0.00%,4,4,0.00%
pull-flv-f6.douyincdn.com,0,0.00%,4,4,0.00%
seal-inner.bytedance.net,0,0.00%,4,4,0.00%
board.rellek.org,0,0.00%,1,1,0.00%
dual-a-0001.a-msedge.net,0,0.00%,2,2,0.00%
bing.com,0,0.00%,6,6,0.00%
dualstack-logs.amap.com,0,0.00%,2,2,0.00%
lng.xiaohongshu.com,0,0.00%,2,2,0.00%
acs.m.taobao.com,0,0.00%,2,2,0.00%
thirdwx.qlogo.cn,0,0.00%,2,2,0.00%
ts4.mm.bing.net,0,0.00%,2,2,0.00%
ts1.mm.bing.net,0,0.00%,2,2,0.00%
drive.weixin.qq.com,0,0.00%,2,2,0.00%
python-world.github.io,0,0.00%,1,1,0.00%
interface3.music.163.com.163jiasu.com,0,0.00%,2,2,0.00%
quillbot.com,0,0.00%,2,2,0.00%
doi.org,0,0.00%,6,6,0.00%
szshort.weixin.qq.com,0,0.00%,4,4,0.00%
trpcpb.imtt.qq.com,0,0.00%,2,2,0.00%
searchsuggest.browser.qq.com,0,0.00%,2,2,0.00%
p2pstuntest.haplat.net,0,0.00%,2,2,0.00%
amisfile.bj.bcebos.com,0,0.00%,1,1,0.00%
secclientgw.alipay.com,0,0.00%,1,1,0.00%
img1.pcfg.cache.wpscdn.cn,0,0.00%,1,1,0.00%
apd-af717b152965a30ab140455f8a8f6e67d6420ff9a7f7b03b.v.smtcdns.com,0,0.00%,1,1,0.00%
turingapi-rapiddeploy.microsoft.com,0,0.00%,1,1,0.00%
docker.mirrors.ustc.edu.cn,0,0.00%,2,2,0.00%
registry.npmjs.org,0,0.00%,6,6,0.00%
account.aliyun.com,0,0.00%,2,2,0.00%
sh.wagbridge.acceleration.aliyun.com.gds.alibabadns.com,0,0.00%,2,2,0.00%
debian.map.fastlydns.net,0,0.00%,11,11,0.00%
globalconfig.flashlightproxy.com,0,0.00%,2,2,0.00%
update.client.163.com,0,0.00%,2,2,0.00%
caldavhz.qiye.163.com,0,0.00%,2,2,0.00%
bvvfsx.herlpyo.ga,0,0.00%,1,1,0.00%
lp.open.weixin.qq.com,0,0.00%,4,4,0.00%
cwx.qlogo.cn,0,0.00%,2,2,0.00%
autosoga.ggga.ga,0,0.00%,1,1,0.00%
dns.twnic.tw,0,0.00%,2,2,0.00%
littlecdn.com,0,0.00%,2,2,0.00%
download.se.360.cn,0,0.00%,4,4,0.00%
stage.www.kooliruum.ee,0,0.00%,1,1,0.00%
exp.notion.so,0,0.00%,2,2,0.00%
ns2-35.azure-dns.net,0,0.00%,2,2,0.00%
ns3-35.azure-dns.org,0,0.00%,1,1,0.00%
B.ROOT-SERVERS.NET,0,0.00%,1,1,0.00%
platform.cn.bing.com,0,0.00%,2,2,0.00%
static.deepl.com,0,0.00%,4,4,0.00%
nvidia.github.io,0,0.00%,2,2,0.00%
releases.turnkeylinux.org,0,0.00%,8,8,0.00%
tracker.byr.pt,0,0.00%,4,4,0.00%
sdk.e.qq.com,0,0.00%,2,2,0.00%
mi.gdt.qq.com,0,0.00%,2,2,0.00%
app-measurement.com,0,0.00%,4,4,0.00%
fe3.delivery.mp.microsoft.com,0,0.00%,2,2,0.00%
wxjnj.readvi.cf,0,0.00%,1,1,0.00%
languagetool.org,0,0.00%,2,2,0.00%
qb-extension.firebaseio.com,0,0.00%,6,6,0.00%
h3o2.me,0,0.00%,4,4,0.00%
v6-zb-alibaba-clould.tengine.alibaba.com,0,0.00%,2,2,0.00%
tr.abir.ga,0,0.00%,2,2,0.00%
release-75570.gzc.vod.tencent-cloud.com,0,0.00%,6,6,0.00%
blackz.ro,0,0.00%,2,2,0.00%
tracker.corpscorp.online,0,0.00%,4,4,0.00%
tracker.torrentleech.org,0,0.00%,4,4,0.00%
laobameishijia.github.io,0,0.00%,1,1,0.00%
cdn.globalsigncdn.com.cdn.cloudflare.net,0,0.00%,2,2,0.00%
wstatic-hb.bj.bcebos.com,0,0.00%,2,2,0.00%
appdownload.deepl.com,0,0.00%,4,4,0.00%
ssl.captcha.qq.com,0,0.00%,6,6,0.00%
clients.config.office.net,0,0.00%,1,1,0.00%
t.captcha.qq.com,0,0.00%,2,2,0.00%
bj.bcebos.com,0,0.00%,1,1,0.00%
www.latex-tables.com,0,0.00%,2,2,0.00%
captcha.gtimg.com.sched.legopic1-dk.tdnsv6.com,0,0.00%,2,2,0.00%
voipfinderliveplay.wxqcloud.qq.com,0,0.00%,1,1,0.00%
static.geetest.com,0,0.00%,1,1,0.00%
static.geetest.com.w.cdngslb.com,0,0.00%,2,2,0.00%
v-2a384bf7.71edge.com,0,0.00%,3,3,0.00%
jingyan.baidu.com,0,0.00%,1,1,0.00%
pti.store.microsoft.com,0,0.00%,1,1,0.00%
auto.sina.com.cn,0,0.00%,2,2,0.00%
i.sso.sina.com.cn,0,0.00%,2,2,0.00%
www.sinaimg.cn,0,0.00%,2,2,0.00%
auto4.sinaimg.cn,0,0.00%,2,2,0.00%
auto.sinaimg.cn,0,0.00%,2,2,0.00%
auto3.sinaimg.cn,0,0.00%,2,2,0.00%
n.sinaimg.cn,0,0.00%,2,2,0.00%
auto1.sinaimg.cn,0,0.00%,2,2,0.00%
auto5.sinaimg.cn,0,0.00%,2,2,0.00%
auto2.sinaimg.cn,0,0.00%,2,2,0.00%
i3.sinaimg.cn,0,0.00%,2,2,0.00%
i0.sinaimg.cn,0,0.00%,2,2,0.00%
i1.sinaimg.cn,0,0.00%,2,2,0.00%
www.example.com,0,0.00%,79,79,0.00%
pypi.python.org,0,0.00%,2,2,0.00%
szlong.weixin.qq.com,0,0.00%,2,2,0.00%
mybank.icbc.com.cn,0,0.00%,2,2,0.00%
tools.people.com.cn,0,0.00%,2,2,0.00%
ipv6.ts.qq.com,0,0.00%,2,2,0.00%
hd.mmstat.com,0,0.00%,4,4,0.00%
hd.mmstat.com.gds.alibabadns.com,0,0.00%,2,2,0.00%
hd-v6.mmstat.com,0,0.00%,2,2,0.00%
dashi.163.com,0,0.00%,2,2,0.00%
dashiwebv6.mail.split.netease.com,0,0.00%,2,2,0.00%
tracker.birkenwald.de,0,0.00%,2,2,0.00%
1qw2cd.qqscml.ga,0,0.00%,1,1,0.00%
mirrors.fedoraproject.org,0,0.00%,15,15,0.00%
wildcard.fedoraproject.org,0,0.00%,9,9,0.00%
mirrors.bfsu.edu.cn,0,0.00%,1,1,0.00%
debuginfo.centos.org,0,0.00%,1,1,0.00%
d2h67oheeuigaw.cloudfront.net,0,0.00%,1,1,0.00%
repo.zabbix.com,0,0.00%,1,1,0.00%
arch.ver.input.yunbiaosoft.com,0,0.00%,2,2,0.00%
conf.wifi.360.cn,0,0.00%,3,3,0.00%
api.free.wifi.360.cn,0,0.00%,3,3,0.00%
ssl.ptlogin2.graph.qq.com,0,0.00%,3,3,0.00%
xui.ptlogin2.qq.com,0,0.00%,3,3,0.00%
sls.update.microsoft.com,0,0.00%,2,2,0.00%
discovery-v6-4.syncthing.net,0,0.00%,2,2,0.00%
polyester-dead-5f6.notion.site,0,0.00%,2,2,0.00%
trackme.theom.nz,0,0.00%,2,2,0.00%
open.nyap2p.com,0,0.00%,2,2,0.00%
tracker.electro-torrent.pl,0,0.00%,2,2,0.00%
tracker.nucozer-tracker.ml,0,0.00%,2,2,0.00%
tracker.xn--vzyr4p.top,0,0.00%,2,2,0.00%
tr.abiir.top,0,0.00%,2,2,0.00%
cdp1.pca.dfn.de,0,0.00%,2,2,0.00%
pull-hls-spe-l1.douyincdn.com,0,0.00%,2,2,0.00%
code.jquery.com,0,0.00%,3,3,0.00%
securepubads46.g.doubleclick.net,0,0.00%,2,2,0.00%
gpdream.github.io,0,0.00%,1,1,0.00%
qwer1231232020.github.io,0,0.00%,1,1,0.00%
nk5x-jj46gxz.autbxpcje.gq,0,0.00%,1,1,0.00%
kinorun.com,0,0.00%,2,2,0.00%
tr.burnabyhighstar.com,0,0.00%,2,2,0.00%
thekushagra.github.io,0,0.00%,1,1,0.00%
download-ib01.fedoraproject.org,0,0.00%,2,2,0.00%
tva2.sinaimg.cn,0,0.00%,1,1,0.00%
liveng.alicdn.com,0,0.00%,1,1,0.00%
d1--cn-gotcha208.bilivideo.com,0,0.00%,1,1,0.00%
ifs.tanx.com,0,0.00%,2,2,0.00%
hc.tdm.qq.com,0,0.00%,1,1,0.00%
pcapp-push.youku.com,0,0.00%,1,1,0.00%
xmlconf.rcv.sandai.net,0,0.00%,1,1,0.00%
media.info.client.xunlei.com,0,0.00%,1,1,0.00%
download.code.lixian.vip.xunlei.com,0,0.00%,2,2,0.00%
api-shoulei-ssl.xunlei.com,0,0.00%,1,1,0.00%
plugin.xl7.xunlei.com,0,0.00%,1,1,0.00%
etl-xlmc-ssl.xunlei.com,0,0.00%,1,1,0.00%
conf-m-ssl.xunlei.com,0,0.00%,1,1,0.00%
static-xl9-ssl.xunlei.com,0,0.00%,1,1,0.00%
pctest.v6.shub.sandai.net,0,0.00%,1,1,0.00%
hub5u.v6.phub.sandai.net,0,0.00%,2,2,0.00%
detection.v6.shub.sandai.net,0,0.00%,1,1,0.00%
xluser-ssl.xunlei.com,0,0.00%,1,1,0.00%
dlcfg.client.v6.chub.sandai.net,0,0.00%,1,1,0.00%
soa-vip-ssl.xunlei.com,0,0.00%,1,1,0.00%
pcdownsdk.rcv.sandai.net,0,0.00%,1,1,0.00%
advertpay.vip.xunlei.com,0,0.00%,1,1,0.00%
adsp.xunlei.com,0,0.00%,1,1,0.00%
images.client.vip.xunlei.com,0,0.00%,1,1,0.00%
upgrade.xl9.xunlei.com,0,0.00%,1,1,0.00%
c15facffece596ece87eca186c33c3a2.clo.footprintdns.com,0,0.00%,2,2,0.00%
moiafdazure.clo.footprintdns.com,0,0.00%,2,2,0.00%
spo-ring.msedge.net,0,0.00%,4,4,0.00%
fp-afd-nocache-ccp.azureedge.net,0,0.00%,4,4,0.00%
oss.mail.qq.com,0,0.00%,4,4,0.00%
web.hb.ad.cpe.dotomi.com,0,0.00%,2,2,0.00%
q4.qlogo.cn,0,0.00%,2,2,0.00%
web.qun.qq.com,0,0.00%,2,2,0.00%
q3.qlogo.cn,0,0.00%,2,2,0.00%
q1.qlogo.cn,0,0.00%,2,2,0.00%
img2.doubanio.com,0,0.00%,2,2,0.00%
img1.doubanio.com,0,0.00%,2,2,0.00%
dualstack-restapi.amap.com,0,0.00%,2,2,0.00%
o-ring-fallback.msedge.net,0,0.00%,2,2,0.00%
cdn.clustrmaps.com,0,0.00%,2,2,0.00%
clustrmaps.com,0,0.00%,3,3,0.00%
graph-neural-networks.github.io,0,0.00%,2,2,0.00%
www.bupt.edu.cn,0,0.00%,2,2,0.00%
www.jlu.edu.cn,0,0.00%,2,2,0.00%
www.whu.edu.cn,0,0.00%,2,2,0.00%
www.gravatar.com,0,0.00%,2,2,0.00%
acs.youku.com,0,0.00%,2,2,0.00%
explodie.org,0,0.00%,2,2,0.00%
ssl.ptlogin2.qq.com,0,0.00%,2,2,0.00%
tva4.sinaimg.cn,0,0.00%,2,2,0.00%
256f3f107fde425bb220c976fdcadd3f.fp.measure.office.com,0,0.00%,1,1,0.00%
professionalsly.com,0,0.00%,2,2,0.00%
zone1-services-cdn.com,0,0.00%,2,2,0.00%
v6-data.video.dns.iqiyi.com,0,0.00%,2,2,0.00%
ftp.sjtu.edu.cn,0,0.00%,2,2,0.00%
mirrorlist.centos.org,0,0.00%,2,2,0.00%
ftp.postgresql.org,0,0.00%,2,2,0.00%
code2chicken.nl,0,0.00%,4,4,0.00%
psytester.github.io,0,0.00%,1,1,0.00%
fp-vs-nocache.azureedge.net,0,0.00%,2,2,0.00%
18ad87839a385ab34d95d0cb4cb02cf0.clo.footprintdns.com,0,0.00%,1,1,0.00%
fp-vs.azureedge.net,0,0.00%,2,2,0.00%
btracker.top,0,0.00%,2,2,0.00%
s2.xoimg.com,0,0.00%,1,1,0.00%
xbtrutor.com,0,0.00%,2,2,0.00%
masters-tb.com,0,0.00%,2,2,0.00%
t.btcland.xyz,0,0.00%,2,2,0.00%
kubernetes-charts.storage.googleapis.com,0,0.00%,4,4,0.00%
ns-166.awsdns-20.com,0,0.00%,2,2,0.00%
p.qlogo.cn,0,0.00%,1,1,0.00%
tr.fuckbitcoin.xyz,0,0.00%,2,2,0.00%
gkaracha.github.io,0,0.00%,122,122,0.00%
theodoric.fr,0,0.00%,1,1,0.00%
docs.qq.com,0,0.00%,2,2,0.00%
